period,mktsize,entries,exits,surviv,entryrate,exitrate,survivrate,firms,totresinv,totinninv,totimiinv,costshareinn,firmsres,firmsinn,firmsimi,hindex,div,gini,pcm,cs,totprofits,ts,maxage,minage,avgage,actfirms,inactfirms,profitablefirms,wmc,avgproxopt,price,totoutput,avgoutput,magtechshock
1,4,40,24,16,1.0,0.6,0.4,40,0,0,0,0,0,0,0,391.5373998688612,0.5003872863247864,0.10808351177730247,0.16775042728326414,118320.85503472202,2265.4079861110868,120586.2630208331,0,0,0.0,35,5,16,47.24750178443967,0.5017857142857144,56.77083333333332,972.9166666666649,27.797619047618998,0
2,4,37,39,14,0.6981132075471698,0.7358490566037735,0.26415094339622647,53,300,300,0,1.0,3,3,0,330.00220013548824,0.4988358732462506,-0.09098860654527241,0.15440384631691406,122188.60721371855,-135.49815759639415,122053.10905612216,1,0,0.3018867924528302,41,12,9,44.67063014248445,0.5320121951219513,52.82738095238094,988.690476190474,24.114401858304245,0
3,4,38,35,17,0.7307692307692307,0.6730769230769231,0.32692307692307687,52,400,200,200,0.5,6,2,4,342.9595664142984,0.4976197209653092,-0.28195377998692783,0.16454119509952214,123261.2969292534,654.7281901041622,123916.02511935755,2,0,0.46153846153846156,39,13,14,43.23064180565754,0.546207264957265,51.744791666666664,993.0208333333327,25.462072649572633,0
4,4,29,29,17,0.6304347826086957,0.6304347826086957,0.3695652173913043,46,350,200,150,0.5714285714285714,5,2,3,330.80246773948903,0.49555152979066025,-0.2263547060075186,0.16222553017944524,124188.31383435772,216.3601361623239,124404.67397052005,3,0,0.8043478260869565,40,6,14,42.569840946166394,0.5541666666666667,50.81300813008129,996.7479674796737,24.91869918699184,0
5,4,21,18,20,0.5526315789473685,0.47368421052631576,0.5263157894736843,38,350,200,150,0.5714285714285714,5,2,3,366.1507751448081,0.4928579895685159,-0.17333260081309776,0.1808105374168693,124479.70920138896,2515.6684027777833,126995.37760416674,4,0,1.263157894736842,33,5,18,41.38613430758523,0.5703914141414141,50.520833333333336,997.9166666666673,30.23989898989901,0
6,4,19,19,20,0.48717948717948717,0.48717948717948717,0.5128205128205128,39,750,500,250,0.6666666666666666,10,5,5,320.24231617184694,0.4877136752136752,-0.12665120714431788,0.16557574065382105,126384.0182834202,294.7021484375093,126678.72043185771,5,0,1.641025641025641,39,0,14,40.569533651023875,0.5782585470085471,48.61979166666667,1005.5208333333339,25.782585470085486,0
7,4,13,10,23,0.3939393939393939,0.30303030303030304,0.696969696969697,33,700,400,300,0.5714285714285714,10,4,6,352.229522361745,0.4853219696969697,-0.11834476948487416,0.18156092475730193,126259.2831633267,2294.449400470985,128553.73256379769,6,0,2.303030303030303,33,0,22,39.89388997276757,0.5886994949494948,48.74387254901961,1005.0245098039223,30.455288175876433,0
8,4,10,8,25,0.30303030303030304,0.24242424242424243,0.7575757575757576,33,950,700,250,0.7368421052631579,12,7,5,335.6403305785125,0.47944286616161613,-0.008492194674012854,0.17957410682702524,127772.558931661,1977.1247837370381,129749.68371539803,7,0,3.0,33,0,19,38.75909090909091,0.6041666666666665,47.242647058823536,1011.0294117647067,30.63725490196081,0
9,4,3,2,26,0.10714285714285714,0.07142857142857142,0.9285714285714286,28,600,200,400,0.3333333333333333,10,2,8,380.03557843454297,0.4739583333333333,0.026117884110475886,0.20011025694163959,127128.2353390474,4062.6504904875123,131190.8858295349,8,0,4.214285714285714,28,0,23,38.299318516407844,0.6112351190476191,47.88074712643678,1008.4770114942526,36.017036124794735,0
10,4,2,2,26,0.07142857142857142,0.07142857142857142,0.9285714285714286,28,1100,900,200,0.8181818181818182,13,9,4,379.54640386880516,0.47260802469135804,0.017694435405141595,0.20074803770892224,127309.42000264232,4063.9665081252433,131373.38651076757,9,0,5.142857142857143,28,0,24,38.125237281700834,0.6130952380952381,47.701149425287355,1009.1954022988502,36.04269293924465,0
11,4,2,1,27,0.07142857142857142,0.03571428571428571,0.9642857142857143,28,1200,1000,200,0.8333333333333334,14,10,4,375.8373481664641,0.47194664902998235,0.03211745580166636,0.1998590436921513,127527.01190712104,3985.882794953081,131512.89470207412,10,0,6.071428571428571,28,0,21,37.99519914651494,0.6153273809523812,47.48563218390804,1010.0574712643668,36.073481116584524,0
12,4,4,2,29,0.12903225806451613,0.06451612903225806,0.935483870967742,31,800,500,300,0.625,11,5,6,343.1824920636931,0.47325268817204297,0.019629216696439133,0.1863914400371054,128375.34798516154,2611.2343682182964,130986.58235337984,11,0,6.354838709677419,31,0,19,37.9525086727483,0.6152553763440862,46.64713541666666,1013.4114583333322,32.69069220430104,0
13,4,4,6,27,0.12121212121212122,0.18181818181818182,0.8181818181818181,33,1000,600,400,0.6,14,6,8,325.50499299090745,0.47328756313131315,0.00770831276442463,0.17923321441300005,128921.21006644079,1792.8995158112275,130714.10958225201,12,0,6.848484848484849,33,0,19,37.84479204376333,0.6158459595959596,46.10906862745098,1015.5637254901961,30.77465834818776,0
14,4,3,4,26,0.1,0.13333333333333333,0.8666666666666667,30,500,100,400,0.2,9,1,8,355.19456707951974,0.4698515325670498,0.024789043516677767,0.19377751327657097,128553.1225611342,3132.2741429644984,131685.3967040987,13,0,8.0,30,0,20,37.46658935277225,0.6197916666666666,46.471774193548384,1014.1129032258061,33.8037634408602,0
15,4,3,3,26,0.10344827586206896,0.10344827586206896,0.896551724137931,29,550,300,250,0.5454545454545454,8,3,5,365.100681258299,0.4662869458128079,0.002549731569926328,0.19942634818469396,128601.97000385805,3590.533371913587,132192.50337577163,14,0,8.310344827586206,29,0,21,37.16551987767585,0.6232040229885056,46.423611111111114,1014.3055555555558,34.976053639846754,0
16,4,2,2,26,0.07142857142857142,0.07142857142857142,0.9285714285714286,28,400,200,200,0.5,6,2,4,373.9192193180269,0.4679232804232804,0.017310805341966606,0.2043242792867857,128617.75829039516,4018.530354075855,132636.288644471,15,0,9.071428571428571,28,0,22,36.9257554296506,0.6264880952380951,46.408045977011504,1014.3678160919551,36.22742200328411,0
17,4,0,0,26,0.0,0.0,1.0,26,700,300,400,0.42857142857142855,11,3,8,401.952703325872,0.46618589743589745,0.022936317300368936,0.21790416988722955,128300.82887993452,5114.173001447961,133415.0018813825,16,1,10.192307692307692,26,0,25,36.5400482355928,0.6302083333333333,46.720679012345684,1013.1172839506177,38.966049382716065,0
18,4,4,5,25,0.13333333333333333,0.16666666666666666,0.8333333333333334,30,1150,800,350,0.6956521739130435,15,8,7,358.36219875913895,0.4677442528735632,-0.0012280470091112772,0.20028612038398214,129509.03148124058,3282.2282561567813,132791.25973739737,17,0,9.7,30,0,17,36.41170386020513,0.6295138888888889,45.530913978494624,1017.8763440860214,33.929211469534046,0
19,4,2,2,25,0.07407407407407407,0.07407407407407407,0.9259259259259259,27,1100,800,300,0.7272727272727273,14,8,6,390.0161246976615,0.4620132953466287,0.018214936247722857,0.21628166915052158,129201.38888888895,4678.125000000004,133879.51388888896,18,0,10.962962962962964,27,0,24,35.92042349726776,0.6358024691358024,45.833333333333336,1016.6666666666672,37.65432098765434,0
20,4,1,1,25,0.038461538461538464,0.038461538461538464,0.9615384615384616,26,1050,600,450,0.5714285714285714,15,6,9,402.74179127686835,0.4620192307692308,-0.002680104167883446,0.2231169200286568,129162.1686147309,5203.800630620312,134365.9692453512,19,0,11.653846153846153,26,0,25,35.6371135064015,0.6390224358974359,45.871913580246904,1016.5123456790116,39.09662867996198,0
21,4,1,1,25,0.038461538461538464,0.038461538461538464,0.9615384615384616,26,1000,700,300,0.7,13,7,6,400.4012250362435,0.4580128205128205,-0.0059844613984740835,0.223371038738493,129436.83556241402,5165.33350480106,134602.1690672151,20,0,12.615384615384615,26,0,22,35.41571883530483,0.6418269230769231,45.60185185185183,1017.5925925925907,39.13817663817657,0
22,4,2,0,27,0.07407407407407407,0.0,1.0,27,1100,900,200,0.8181818181818182,13,9,4,396.9867951832247,0.4589268755935423,-0.017025527433032428,0.21805506576006103,128823.44148596934,4828.241035997723,133651.68252196707,21,0,13.074074074074074,27,0,22,36.130044952604315,0.6319444444444444,46.20535714285714,1015.178571428571,37.599206349206334,5
23,4,2,4,25,0.06896551724137931,0.13793103448275862,0.8620689655172413,29,750,500,250,0.6666666666666666,10,5,5,376.492194674013,0.45946223316912976,-0.03473693128865518,0.20990729209907305,129413.28125000007,3944.6180555555707,133357.89930555565,22,0,13.10344827586207,29,0,22,36.047979797979814,0.6314655172413792,45.62500000000001,1017.5000000000006,35.086206896551744,0
24,4,2,3,24,0.07407407407407407,0.1111111111111111,0.8888888888888888,27,750,400,350,0.5333333333333333,11,4,7,419.0620084397338,0.4555436847103514,-0.023228651581141735,0.2225160241996894,127467.41470025494,5283.350162981838,132750.76486323678,23,0,14.407407407407407,27,0,18,36.96519795657728,0.6180555555555556,47.54464285714285,1009.8214285714272,37.4007936507936,5
25,4,3,4,23,0.1111111111111111,0.14814814814814814,0.8518518518518519,27,750,600,150,0.8,9,6,3,418.5164489307669,0.4591642924976258,-0.000610380834041635,0.2243089737329251,127843.36911848067,5300.910572562352,133144.27969104302,24,0,15.148148148148149,27,0,19,36.591377280753385,0.6219135802469136,47.172619047619044,1011.3095238095233,37.455908289241606,0
26,4,2,1,24,0.08,0.04,0.96,25,500,200,300,0.4,8,2,6,433.27699096596604,0.45729166666666665,0.005274167987321388,0.2320864017822789,127820.21747616699,6076.3118425378,133896.5293187048,25,0,15.64,25,0,20,36.24207606973059,0.6291666666666667,47.19551282051282,1011.2179487179486,40.44871794871794,0
27,4,2,1,25,0.07692307692307693,0.038461538461538464,0.9615384615384616,26,400,100,300,0.25,7,1,6,421.54867072904403,0.45814102564102566,-0.009178721309169635,0.22785851543031188,128183.59672687089,5607.124961896049,133790.72168876693,26,0,15.961538461538462,26,0,21,36.164342680077205,0.6290064102564104,46.83641975308642,1012.6543209876543,38.94824311490978,0
28,4,3,1,27,0.10714285714285714,0.03571428571428571,0.9642857142857143,28,650,500,150,0.7692307692307693,8,5,3,409.58533538016377,0.4613095238095238,-0.013852752256281242,0.21741433059303558,127454.46062888094,4840.695600475618,132295.15622935657,27,0,15.714285714285714,28,0,19,37.21779548472773,0.6145833333333334,47.55747126436781,1009.7701149425286,36.06321839080459,5
29,4,2,3,26,0.06896551724137931,0.10344827586206896,0.896551724137931,29,800,500,300,0.625,11,5,6,398.45142775556366,0.46120689655172414,-0.01619709304803707,0.21347497023460302,127828.32031249987,4386.675347222208,132214.99565972207,28,0,16.06896551724138,29,0,19,37.11414984205466,0.615301724137931,47.18749999999999,1011.249999999999,34.87068965517238,0
30,4,4,4,26,0.13333333333333333,0.13333333333333333,0.8666666666666667,30,300,200,100,0.6666666666666666,4,2,2,388.05707620823,0.4630028735632184,-0.02785376001416373,0.209195264203592,128076.4959279974,3940.198108162786,132016.6940361602,29,0,16.3,30,0,19,37.122117470012846,0.6149305555555555,46.942204301075265,1012.2311827956985,33.74103942652328,0
31,4,1,0,27,0.037037037037037035,0.0,1.0,27,850,400,450,0.47058823529411764,13,4,9,433.7046538454918,0.45922364672364674,0.019671123405563318,0.22238898207822017,126043.83680555549,5533.1597222222135,131576.9965277777,30,0,19.074074074074073,27,0,20,38.070539419087126,0.6033950617283951,48.95833333333333,1004.1666666666661,37.19135802469133,8
32,4,1,1,27,0.03571428571428571,0.03571428571428571,0.9642857142857143,28,750,600,150,0.8,9,6,3,421.9352805254186,0.4622464726631393,0.02933782955242159,0.2165438774502698,126079.9085909631,5039.512319989423,131119.42091095253,31,0,19.357142857142858,28,0,21,38.32856461611827,0.6004464285714286,48.922413793103445,1004.3103448275858,35.86822660098521,1
33,4,5,3,29,0.15625,0.09375,0.90625,32,900,800,100,0.8888888888888888,10,8,2,373.7273673257027,0.46900201612903225,0.006991935483871448,0.19757074329974036,127289.03028700077,3118.324944849823,130407.3552318506,32,0,17.21875,31,1,20,38.293010752688176,0.6041666666666667,47.721354166666664,1009.1145833333326,32.55208333333331,0
34,4,3,5,27,0.09375,0.15625,0.84375,32,750,600,150,0.8,9,6,3,371.6334988486526,0.4702410954301075,0.017072915324139792,0.1979069538480917,127584.84098646384,3082.9601711697155,130667.80115763356,33,0,17.34375,31,1,17,38.0419781329209,0.6071908602150538,47.42838541666667,1010.286458333334,32.5898857526882,0
35,4,3,1,29,0.1,0.03333333333333333,0.9666666666666667,30,750,600,150,0.8,9,6,3,397.6508384591952,0.4646551724137931,0.04736359468133866,0.2110161748611934,127442.37075617291,4135.513117283962,131577.88387345689,34,0,19.233333333333334,29,1,19,37.531522237505726,0.6113505747126435,47.56944444444445,1009.7222222222229,34.81800766283527,0
36,4,3,2,30,0.09375,0.0625,0.9375,32,1150,900,250,0.782608695652174,14,9,5,377.23339573098343,0.4636676747311828,0.035367344312918325,0.20303725426739655,128012.7292209203,3258.1353081597426,131270.86452908005,35,0,18.9375,31,1,20,37.46139989706639,0.6115591397849462,47.00520833333334,1011.979166666668,32.644489247311874,0
37,4,4,4,30,0.11764705882352941,0.11764705882352941,0.8823529411764706,34,1300,1100,200,0.8461538461538461,15,11,4,360.60413346609636,0.4664661319073084,0.03858030337399376,0.19787690299890442,128784.53290799409,2488.1147954649155,131272.647703459,36,0,18.705882352941178,32,2,17,37.093129327860034,0.6168619791666666,46.24368686868687,1015.0252525252525,31.719539141414142,0
38,4,2,1,31,0.0625,0.03125,0.96875,32,800,500,300,0.625,11,5,6,380.1788342180186,0.45892137096774194,0.06320825049701773,0.20740775879789936,128553.1225611341,3374.6352540755965,131927.7578152097,37,0,20.65625,30,2,18,36.833167660702436,0.6197916666666667,46.47177419354838,1014.1129032258054,33.80376344086018,0
39,4,0,1,30,0.0,0.03225806451612903,0.967741935483871,31,1150,800,350,0.6956521739130435,15,8,7,388.96407075196737,0.4581989247311828,0.07375349073911752,0.2118379773055659,128484.97884509759,3795.2080804139064,132280.1869255115,38,1,22.322580645161292,30,1,18,36.680255424455346,0.6190972222222222,46.53897849462365,1013.8440860215045,33.79480286738348,0
40,4,1,1,30,0.03225806451612903,0.03225806451612903,0.967741935483871,31,1200,800,400,0.6666666666666666,16,8,8,386.55680782731247,0.45497311827956993,0.08840213231273886,0.21215675964475747,128791.76783443171,3757.066929702851,132548.83476413458,39,0,23.096774193548388,30,1,20,36.42716057556496,0.6222222222222222,46.236559139784944,1015.0537634408602,33.83512544802867,0
41,4,4,5,29,0.11764705882352941,0.14705882352941177,0.8529411764705882,34,850,700,150,0.8235294117647058,10,7,3,355.80706644111007,0.4595959595959596,0.044822311298707174,0.19887843161910237,129513.05537533645,2416.3320597847055,131929.38743512117,40,0,20.91176470588235,33,1,18,36.47263022714503,0.6218434343434343,45.52696078431373,1017.8921568627454,30.845216874628647,0
42,4,1,1,29,0.03333333333333333,0.03333333333333333,0.9666666666666667,30,900,700,200,0.7777777777777778,11,7,4,394.0347442980364,0.45272988505747125,0.08314176245210714,0.2161866299797335,128778.12500000009,4148.611111111125,132926.7361111112,41,0,24.466666666666665,29,1,20,36.25136836343732,0.625,46.25000000000001,1015.0000000000007,35.00000000000002,0
43,4,3,3,29,0.09375,0.09375,0.90625,32,750,500,250,0.6666666666666666,10,5,5,377.7199945482507,0.4557501680107527,0.05533095299090496,0.20928743771740213,129168.29639010971,3357.8896416558255,132526.18603176554,42,0,23.84375,31,1,20,36.266731779172524,0.6233198924731183,45.86588541666667,1016.5364583333344,32.79149865591401,0
44,4,3,2,30,0.09375,0.0625,0.9375,32,950,800,150,0.8421052631578947,11,8,3,377.80936985675623,0.45703125,0.07475051177072656,0.21092557391431496,129466.281467014,3382.714843750009,132848.99631076402,43,0,24.75,31,1,19,35.96042306380074,0.6263440860215054,45.57291666666667,1017.7083333333343,32.829301075268845,0
45,4,2,0,32,0.0625,0.0,1.0,32,1100,900,200,0.8181818181818182,13,9,4,380.8580809877709,0.45438508064516125,0.10300689479060265,0.21552604698672106,129996.88042534716,3502.0724826388787,133498.95290798604,44,0,25.6875,31,1,21,35.34218590398365,0.631720430107527,45.05208333333333,1019.7916666666661,32.89650537634407,0
46,4,0,1,31,0.0,0.03125,0.96875,32,1150,800,350,0.6956521739130435,15,8,7,377.61805940022657,0.45320900537634407,0.09937962490431262,0.21478739837292993,130196.13477918827,3432.882351345477,133629.01713053376,45,1,26.6875,31,1,21,35.222101726630946,0.633736559139785,44.85677083333333,1020.5729166666658,32.921706989247284,0
47,4,0,0,31,0.0,0.0,1.0,31,750,600,150,0.8,9,6,3,388.9025955023611,0.45174731182795697,0.10073317644660063,0.22138877887893027,130228.28686842402,3929.2237541912273,134157.51062261526,46,2,27.64516129032258,30,1,21,34.90145729084365,0.6368055555555556,44.8252688172043,1020.6989247311822,34.02329749103941,0
48,4,2,4,29,0.06060606060606061,0.12121212121212122,0.8787878787878788,33,550,300,250,0.5454545454545454,8,3,5,368.2255466940886,0.45565025252525254,0.09061886906351191,0.2082003073040729,129963.6862013076,2975.8146924881125,132939.50089379572,47,0,26.90909090909091,31,2,17,35.69800046822456,0.6313844086021505,45.08463541666667,1019.6614583333342,32.89230510752691,2
49,4,0,0,29,0.0,0.0,1.0,29,750,400,350,0.5333333333333333,11,4,7,397.20274583219367,0.44914819376026277,0.07055536479475455,0.22245174405621182,129589.99083719144,4494.700038580256,134084.6908757717,48,1,28.0,29,0,17,35.340648160778436,0.6332614942528736,45.45138888888889,1018.194444444445,35.110153256705004,0
50,4,2,0,31,0.06451612903225806,0.0,1.0,31,700,300,400,0.42857142857142855,11,3,8,374.28441375464786,0.4484767025089606,0.0595280231132036,0.2128912362125494,130196.13477918843,3546.0767957899366,133742.21157497837,49,0,27.129032258064516,31,0,20,35.30715743812197,0.6337365591397849,44.856770833333336,1020.5729166666672,32.921706989247326,0
51,4,0,0,31,0.0,0.0,1.0,31,850,600,250,0.7058823529411765,11,6,5,373.772496319534,0.448163082437276,0.05787426319455036,0.21315134249573423,130296.8912591051,3540.2958159281875,133837.1870750333,50,1,28.129032258064516,30,1,22,35.21782297700545,0.6375,44.75806451612903,1020.9677419354839,34.03225806451613,0
52,4,1,1,31,0.03125,0.03125,0.96875,32,1050,700,350,0.6666666666666666,14,7,7,363.9316689242542,0.44688760080645157,0.05440699006875516,0.20986191833561613,130728.22570800781,3115.2282714843745,133843.4539794922,51,0,28.21875,31,1,18,35.031512605042025,0.6391129032258065,44.3359375,1022.65625,32.988911290322584,0
53,4,2,3,30,0.06060606060606061,0.09090909090909091,0.9090909090909091,33,900,700,200,0.7777777777777778,11,7,4,352.43159569009094,0.4502840909090909,0.04341233740324024,0.20474364050034916,131014.28086553258,2634.7144127258853,133648.99527825846,52,0,28.303030303030305,33,0,19,35.0361104460937,0.6369949494949494,44.05637254901961,1023.7745098039223,31.023469994058253,0
54,4,2,1,31,0.0625,0.03125,0.96875,32,500,300,200,0.6,7,3,4,365.094960022917,0.4476226478494623,0.062322705969412695,0.21204798967520144,131004.77629833695,3165.836713090505,134170.61301142746,53,0,30.03125,32,0,20,34.72162267719125,0.6393229166666666,44.06565656565657,1023.7373737373741,31.99179292929294,0
55,4,0,0,31,0.0,0.0,1.0,31,1450,1000,450,0.6896551724137931,19,10,9,375.363892168906,0.44623655913978494,0.07587044268696919,0.21833296213138134,131061.33355034718,3639.138454861106,134700.47200520828,54,1,32.0,31,0,20,34.401492031197016,0.64247311827957,44.010416666666664,1023.9583333333329,33.03091397849461,0
56,4,0,1,30,0.0,0.03225806451612903,0.967741935483871,31,1000,400,600,0.4,16,4,12,376.9750450299798,0.44534050179211465,0.08186693343391771,0.22003261530384882,131194.69536675353,3691.425238715282,134886.1206054688,55,2,33.0,31,0,20,34.22513133367225,0.6438172043010753,43.880208333333336,1024.479166666667,33.04771505376345,0
57,4,0,1,29,0.0,0.03333333333333333,0.9666666666666667,30,850,400,450,0.47058823529411764,13,4,9,385.1175664119548,0.44236111111111115,0.08772689498316044,0.22455860548014606,131155.9704337207,4102.093630766569,135258.0640644873,56,3,34.833333333333336,30,0,21,34.055843502602464,0.6461805555555555,43.918010752688176,1024.3279569892477,34.144265232974924,0
58,4,1,0,30,0.03333333333333333,0.0,1.0,30,900,400,500,0.4444444444444444,14,4,10,384.5687100128328,0.4431752873563219,0.0995543321536243,0.22585640405603571,131431.47193678468,4108.88632356343,135540.35826034812,57,0,35.233333333333334,30,0,22,33.7907436536025,0.6489583333333333,43.6491935483871,1025.4032258064522,34.18010752688174,0
59,4,1,1,30,0.03225806451612903,0.03225806451612903,0.967741935483871,31,650,500,150,0.7692307692307693,8,5,3,374.5833149587231,0.44475806451612904,0.08723307587460227,0.22113041986439674,131628.58963012695,3661.174689398871,135289.76431952583,58,0,35.064516129032256,31,0,18,33.84735968362729,0.6481854838709677,43.45703125,1026.171875,33.102318548387096,0
60,4,0,0,30,0.0,0.0,1.0,30,950,700,250,0.7368421052631579,12,7,5,383.97809990640354,0.4420737547892721,0.09566147265505642,0.2271449069701938,131707.2624906058,4114.540879003343,135821.80336960914,59,2,37.233333333333334,30,0,21,33.526744795076596,0.6517361111111111,43.38037634408602,1026.4784946236555,34.215949820788516,0
61,4,0,0,30,0.0,0.0,1.0,30,1400,1100,300,0.7857142857142857,17,11,6,384.1211241973745,0.44056513409961684,0.09030176173033322,0.22867771599413786,131948.81633714875,4136.865533587688,136085.68187073644,60,3,38.233333333333334,30,0,21,33.278824350252926,0.6541666666666666,43.14516129032258,1027.419354838709,34.24731182795697,0
62,4,0,0,30,0.0,0.0,1.0,30,1250,800,450,0.64,17,8,9,384.2432621102572,0.4398946360153257,0.09268654114365416,0.2295853491108787,132086.9464677997,4150.703838594052,136237.65030639374,61,4,39.233333333333334,30,0,22,33.1361140167364,0.6555555555555556,43.01075268817204,1027.9569892473114,34.26523297491038,0
63,4,0,1,29,0.0,0.03333333333333333,0.9666666666666667,30,950,700,250,0.7368421052631579,12,7,5,393.18277182143277,0.4403256704980843,0.12438020148926854,0.2270197946556224,130777.62783269736,4283.9020406983345,135061.5298733957,62,5,40.233333333333334,30,0,21,34.23346473937801,0.6423611111111112,44.287634408602145,1022.8494623655909,34.09498207885303,6
64,4,2,0,31,0.06451612903225806,0.0,1.0,31,950,600,350,0.631578947368421,13,6,7,376.2061285990008,0.44336917562724015,0.1029347313757436,0.20757851593560134,129002.89747450077,3506.336127387143,132509.2336018879,63,0,38.096774193548384,31,0,19,36.474087840724614,0.6216397849462366,46.02864583333333,1015.8854166666658,32.77049731182793,7
65,4,0,0,31,0.0,0.0,1.0,31,900,700,200,0.7777777777777778,11,7,4,385.3130878796022,0.4421146953405018,0.11422527763088297,0.21367362146050664,129201.38888888882,3756.597222222212,132957.98611111104,64,1,39.096774193548384,31,0,19,36.03995901639344,0.6236559139784946,45.83333333333333,1016.6666666666661,32.79569892473116,0
66,4,1,2,30,0.03125,0.0625,0.9375,32,600,400,200,0.6666666666666666,8,4,4,373.62348785708076,0.44470346102150543,0.09965807592110121,0.20871648895467268,129490.37606175388,3276.1291896235034,132766.50525137738,65,0,38.84375,32,0,17,36.04236447090931,0.6240234375,45.54924242424242,1017.8030303030301,31.806344696969692,0
67,4,1,0,31,0.03225806451612903,0.0,1.0,31,1350,1100,250,0.8148148148148148,16,11,5,379.9490073203175,0.4420250896057348,0.09422555076253047,0.21319663811043948,129665.12891981353,3653.227403428842,133318.35632324236,66,0,39.096774193548384,31,0,18,35.70325151282707,0.6283602150537633,45.37760416666668,1018.4895833333347,32.85450268817209,0
68,4,0,0,31,0.0,0.0,1.0,31,1050,800,250,0.7619047619047619,13,8,5,381.044555264062,0.4416218637992832,0.09417739050147156,0.21453630859687417,129797.77865939675,3691.7473687066026,133489.52602810334,67,1,40.096774193548384,31,0,18,35.54018655762842,0.6297043010752688,45.247395833333336,1019.0104166666671,32.87130376344087,0
69,4,2,1,32,0.06060606060606061,0.030303030303030304,0.9696969696969697,33,1050,600,450,0.5714285714285714,15,6,9,361.1310785309913,0.4445628156565657,0.08987221613727625,0.20089731580477402,129326.0104286813,2740.728325643982,132066.73875432528,68,0,38.60606060606061,33,0,21,36.52761044176706,0.619949494949495,45.71078431372549,1017.1568627450982,30.822935234699948,2
70,4,2,2,32,0.058823529411764705,0.058823529411764705,0.9411764705882353,34,1100,700,400,0.6363636363636364,15,7,8,352.092744672726,0.44511289364230544,0.09281778583893341,0.1985914413628378,129867.92091836719,2345.110544217676,132213.03146258486,69,0,38.088235294117645,34,0,19,36.20649380985754,0.6231617647058825,45.17857142857142,1019.285714285713,29.97899159663862,0
71,4,0,2,30,0.0,0.0625,0.9375,32,1100,600,500,0.5454545454545454,16,6,10,371.06314020169214,0.44006216397849457,0.11123078353582949,0.2081359728001982,129651.06398581782,3221.7461866136177,132872.81017243143,70,1,41.4375,32,0,20,35.94382800231424,0.6256510416666666,45.391414141414145,1018.4343434343438,31.826073232323242,0
72,4,1,1,30,0.03225806451612903,0.03225806451612903,0.967741935483871,31,750,500,250,0.6666666666666666,10,5,5,378.34317313928995,0.4415322580645162,0.10219592503651653,0.21157989467832397,129532.54699707028,3601.5509711371515,133134.09796820744,71,0,41.74193548387097,31,0,20,35.87927432420909,0.627016129032258,45.5078125,1017.9687499999998,32.83770161290322,0
73,4,0,0,30,0.0,0.0,1.0,30,900,700,200,0.7777777777777778,11,7,4,384.82339221236293,0.4385536398467433,0.10917415037858746,0.2148881066247797,129474.83090530704,3964.9887270204736,133439.8196323275,72,3,44.13333333333333,30,0,21,35.77324352879027,0.6291666666666667,45.56451612903226,1017.7419354838715,33.92473118279572,0
74,4,2,2,30,0.0625,0.0625,0.9375,32,1050,400,650,0.38095238095238093,17,4,13,389.17833612282675,0.44146925403225806,0.08139760720944711,0.2145949084378439,128976.8442792828,3638.9987309968465,132615.84301027964,73,0,42.3125,32,0,18,36.171276154961674,0.6188151041666666,46.054292929292934,1015.7828282828289,31.743213383838402,7
75,4,1,2,29,0.03225806451612903,0.06451612903225806,0.935483870967742,31,1200,800,400,0.6666666666666666,16,8,8,395.8778909526346,0.4413082437275986,0.07142739042013191,0.21879823378147045,129069.04432508688,4019.11621093751,133088.1605360244,74,0,42.45161290322581,31,0,18,35.90679993165898,0.6223118279569892,45.96354166666667,1016.145833333334,32.77889784946239,0
76,4,1,0,30,0.03333333333333333,0.0,1.0,30,950,600,350,0.631578947368421,13,6,7,402.78151034668065,0.43821839080459773,0.08879781420764976,0.22336065573770486,129201.38888888896,4407.986111111118,133609.3750000001,75,0,44.56666666666667,30,0,19,35.59596994535517,0.6263888888888889,45.833333333333336,1016.6666666666673,33.88888888888891,0
77,4,3,1,32,0.09090909090909091,0.030303030303030304,0.9696969696969697,33,1050,700,350,0.6666666666666666,14,7,7,372.70422941893577,0.44393150252525254,0.07303601920927405,0.2111652349526073,130043.75007509124,3093.571132497105,133137.32120758833,76,0,41.42424242424242,33,0,19,35.50239797348712,0.627209595959596,45.00612745098039,1019.9754901960779,30.908348187759938,0
78,4,0,0,32,0.0,0.0,1.0,32,900,600,300,0.6666666666666666,12,6,6,380.53977554981026,0.44014616935483875,0.08044669390787518,0.21521283104623717,129972.73875114777,3491.9593663911746,133464.69811753894,77,1,43.71875,32,0,19,35.374876176324904,0.62890625,45.07575757575757,1019.6969696969691,31.865530303030283,0
79,4,1,1,32,0.030303030303030304,0.030303030303030304,0.9696969696969697,33,750,300,450,0.4,12,3,9,369.5423711071859,0.4431818181818182,0.06867034152885965,0.20754298571911642,129700.23548635117,2985.946510957297,132686.18199730848,78,0,43.36363636363637,33,0,17,35.932487167147904,0.6237373737373739,45.34313725490195,1018.6274509803902,30.86749851455728,2
80,4,3,3,32,0.08571428571428572,0.08571428571428572,0.9142857142857143,35,1050,700,350,0.6666666666666666,14,7,7,353.5299838465594,0.4479341736694678,0.05318387248311285,0.20127701275292464,130233.05047850203,2208.25764639058,132441.30812489262,79,0,41.8,35,0,19,35.799245001322895,0.6247023809523811,44.82060185185184,1020.717592592591,29.16335978835974,0
81,4,0,0,32,0.0,0.0,1.0,32,1150,700,450,0.6086956521739131,16,7,9,381.51171773907555,0.44067120295698925,0.07956269349845213,0.21558482300511078,129940.55333958259,3514.7687417100155,133455.3220812926,80,1,46.59375,32,0,21,35.38286893704849,0.6285807291666667,45.107323232323225,1019.5707070707061,31.861584595959567,0
82,4,1,2,31,0.030303030303030304,0.06060606060606061,0.9393939393939394,33,750,600,150,0.8,9,6,3,382.90516221057,0.4416035353535353,0.03238457245425885,0.20960666781499612,128688.43102744634,3255.4914677073966,131943.92249515373,81,0,46.15151515151515,32,1,14,36.62554961008794,0.6158854166666665,46.33838383838385,1014.6464646464658,31.707702020202056,8
83,4,4,5,30,0.11428571428571428,0.14285714285714285,0.8571428571428572,35,700,300,400,0.42857142857142855,11,3,8,368.4168336603209,0.4504201680672269,-0.009301844152707517,0.20190998011522965,128734.59314025873,2512.397161035997,131246.99030129472,82,0,41.6,33,2,15,36.94589522199412,0.6139520202020201,46.292892156862756,1014.8284313725504,30.752376708259103,3
84,4,1,1,30,0.03225806451612903,0.03225806451612903,0.967741935483871,31,850,400,450,0.47058823529411764,13,4,9,401.8319990443606,0.44112903225806455,0.027249845900965797,0.2175435305171195,128246.61810613952,4106.718984853754,132353.33709099327,83,0,47.645161290322584,30,1,17,36.5987703467799,0.6166666666666666,46.7741935483871,1012.9032258064523,33.76344086021508,0
85,4,0,0,30,0.0,0.0,1.0,30,950,600,350,0.631578947368421,13,6,7,413.38549340378313,0.43908045977011495,0.03936899862825771,0.22322816643804305,128144.53125000012,4594.61805555557,132739.14930555568,84,2,50.233333333333334,29,1,17,36.41117969821673,0.6185344827586207,46.87500000000001,1012.5000000000009,34.913793103448306,0
86,4,2,3,29,0.0625,0.09375,0.90625,32,900,600,300,0.6666666666666666,12,6,6,391.914626279151,0.44249831989247307,0.02406314168377799,0.21445216067185016,128672.4175347223,3685.720486111121,132358.13802083343,85,0,48.03125,31,1,15,36.41341546885695,0.618279569892473,46.35416666666667,1014.583333333334,32.72849462365594,0
87,4,1,2,28,0.03333333333333333,0.06666666666666667,0.9333333333333333,30,1050,700,350,0.6666666666666666,14,7,7,398.050188370239,0.44066091954022985,0.04190299496421934,0.2173434675428238,128587.20119377972,4236.831931437173,132824.0331252169,86,0,51.13333333333333,30,0,15,36.3451387048326,0.6201388888888888,46.43817204301076,1014.2473118279577,33.80824372759859,0
88,4,2,2,28,0.06666666666666667,0.06666666666666667,0.9333333333333333,30,450,100,350,0.2222222222222222,8,1,7,392.1859645827936,0.44006226053639846,0.04035923915441941,0.21543131567227955,128825.87808200384,4104.740251763224,132930.61833376705,87,0,50.63333333333333,30,0,15,36.24939317710401,0.6225694444444443,46.20295698924732,1015.188172043012,33.83960573476706,0
89,4,0,0,28,0.0,0.0,1.0,28,500,200,300,0.4,8,2,6,413.40284220217706,0.43697641093474426,0.0676774324187508,0.22486947199200918,128435.64467317348,5019.132109591762,133454.77678276523,88,6,55.25,28,0,15,36.11150484290101,0.624627976190476,46.58764367816092,1013.6494252873564,36.20176518883416,0
90,4,1,1,28,0.034482758620689655,0.034482758620689655,0.9655172413793104,29,1100,900,200,0.8181818181818182,13,9,4,399.6221887455094,0.44001436781609193,0.0002844329828484149,0.21280027825291617,127582.64853395057,4396.971450617271,131979.61998456783,89,0,54.310344827586206,29,0,20,37.33732013564291,0.6127873563218391,47.43055555555555,1010.2777777777774,34.83716475095784,6
91,4,4,2,30,0.125,0.0625,0.9375,32,850,700,150,0.8235294117647058,10,7,3,363.1450553574781,0.4477906586021505,-0.001027397260273899,0.19783275403802897,128496.33487654311,2932.5617283950482,131428.89660493817,90,0,49.84375,32,0,18,37.32305936073059,0.6139322916666667,46.52777777777777,1013.8888888888881,31.684027777777754,0
92,4,0,0,30,0.0,0.0,1.0,30,1400,1100,300,0.7857142857142857,17,11,6,384.1084854577922,0.44609674329501914,0.013295308838484177,0.20848048033594643,128348.7456100416,3859.9684573361064,132208.7140673777,91,1,54.166666666666664,30,0,22,36.942896935933156,0.6177083333333333,46.67338709677419,1013.3064516129031,33.776881720430104,0
93,4,3,3,30,0.09090909090909091,0.09090909090909091,0.9090909090909091,33,950,800,150,0.8421052631578947,11,8,3,355.4152109647946,0.452020202020202,0.016393442622950838,0.1970938897168404,129201.3888888887,2584.027777777753,131785.41666666645,92,0,50.15151515151515,33,0,20,36.79986338797814,0.6186868686868687,45.83333333333332,1016.6666666666652,30.808080808080764,0
94,4,0,0,30,0.0,0.0,1.0,30,700,500,200,0.7142857142857143,9,5,4,382.78985522509316,0.4456896551724138,0.029844550432785555,0.20936940777094212,128655.37200832464,3849.5942449994154,132504.96625332406,93,1,56.06666666666667,30,0,21,36.662305688040966,0.6208333333333333,46.37096774193548,1014.5161290322579,33.817204301075265,0
95,4,1,0,31,0.03225806451612903,0.0,1.0,31,1200,800,400,0.6666666666666666,16,8,8,374.0199731977795,0.44623655913978494,0.025131859592268935,0.20671755459174712,129069.04432508672,3454.880099826384,132523.9244249131,94,0,55.225806451612904,31,0,22,36.462070732957464,0.6223118279569892,45.963541666666664,1016.1458333333327,32.778897849462346,0
96,4,1,0,32,0.03125,0.0,1.0,32,650,200,450,0.3076923076923077,11,2,9,364.046943211275,0.44699260752688175,0.02712468982630245,0.2032007176096175,129458.25043362919,3025.776068768485,132484.02650239767,95,0,54.46875,32,0,19,36.31875516956161,0.6236979166666667,45.580808080808076,1017.6767676767674,31.802398989898983,0
97,4,1,3,30,0.030303030303030304,0.09090909090909091,0.9090909090909091,33,1350,1000,350,0.7407407407407407,17,10,7,355.35848138303544,0.4487058080808081,0.015364711456112623,0.2000545546851687,129793.87622849393,2624.6709498750615,132418.547178369,96,0,53.78787878787879,33,0,19,36.19851172579675,0.6246843434343433,45.251225490196084,1018.9950980392164,30.878639334521708,0
98,4,0,0,30,0.0,0.0,1.0,30,1200,900,300,0.75,15,9,6,381.6938597457229,0.4426484674329502,0.03563218390804512,0.2125857854610286,129372.2562760147,3876.119168400983,133248.3754444157,97,2,59.0,30,0,23,35.957524111507446,0.6281249999999999,45.66532258064517,1017.3387096774204,33.91129032258068,0
99,4,1,1,30,0.03225806451612903,0.03225806451612903,0.967741935483871,31,500,300,200,0.6,7,3,4,370.5240453916122,0.44493727598566307,0.020853698273053167,0.20773251319052338,129631.97708129893,3406.3529120551348,133038.32999335407,98,0,58.064516129032256,31,0,19,35.97699036781315,0.628024193548387,45.41015625000001,1018.3593750000008,32.85030241935486,0
100,4,0,0,30,0.0,0.0,1.0,30,700,400,300,0.5714285714285714,10,4,6,380.80073136243885,0.4423850574712644,0.029477020602218573,0.21264182432716727,129474.83090530704,3860.8220603538084,133335.65296566085,99,4,61.0,30,0,19,35.875594294770195,0.6291666666666667,45.56451612903226,1017.7419354838715,33.92473118279572,0
101,4,1,1,30,0.03225806451612903,0.03225806451612903,0.967741935483871,31,1150,700,450,0.6086956521739131,16,7,9,370.89723316568046,0.44399641577060933,0.03532692648324898,0.20971091934443653,129963.68620130768,3440.6343248155613,133404.32052612325,100,0,60.0,31,0,21,35.62989507512876,0.6313844086021504,45.08463541666668,1019.6614583333347,32.89230510752693,0
102,4,0,0,30,0.0,0.0,1.0,30,1350,900,450,0.6666666666666666,18,9,9,380.19585262082364,0.44375000000000003,0.05025701858442044,0.2151040964827884,129988.31376821034,3884.2035567695866,133872.51732497994,101,1,61.96666666666667,30,0,21,35.36778920082597,0.6343749999999999,45.06048387096775,1019.7580645161302,33.991935483871,0
103,4,0,0,30,0.0,0.0,1.0,30,1050,800,250,0.7619047619047619,13,8,5,377.52258501212395,0.4431273946360153,0.05023053616124362,0.21434360080980053,130125.41415553825,3825.056545554406,133950.47070109265,102,2,62.96666666666667,30,0,22,35.2964585254468,0.6357638888888888,44.92607526881721,1020.2956989247315,34.00985663082438,0
104,4,1,0,31,0.03225806451612903,0.0,1.0,31,1150,600,550,0.5217391304347826,17,6,11,368.3479248651059,0.44193548387096776,0.05864803780562955,0.21167871231267088,130595.10125054259,3420.886908637157,134015.98815917975,103,0,61.903225806451616,31,0,20,35.053609341825904,0.637768817204301,44.466145833333336,1022.1354166666671,32.972110215053775,0
105,4,1,0,32,0.03125,0.0,1.0,32,750,400,350,0.5333333333333333,11,4,7,358.2654879459426,0.44409442204301075,0.059808427936821396,0.2073845367367084,130875.5484134272,2977.638442505864,133853.18685593305,104,0,60.9375,32,0,21,35.02719850279698,0.6380208333333334,44.19191919191919,1023.2323232323232,31.9760101010101,0
106,4,1,1,32,0.030303030303030304,0.030303030303030304,0.9696969696969697,33,1050,700,350,0.6666666666666666,14,7,7,350.3205763764955,0.4438525883838384,0.06775067750677533,0.20518776616337592,131328.125,2602.1700591776344,133930.29505917765,105,0,60.06060606060606,32,1,23,34.773035230352306,0.642578125,43.75,1025.0,32.03125,0
107,4,0,0,32,0.0,0.0,1.0,32,950,700,250,0.7368421052631579,12,7,5,359.0395524140959,0.44195228494623656,0.07140986939378946,0.20993984203118182,131263.42337516588,3025.7521553923116,134289.1755305582,106,1,62.625,32,0,23,34.61500944636108,0.6419270833333334,43.813131313131315,1024.7474747474753,32.0233585858586,0
108,4,0,0,32,0.0,0.0,1.0,32,800,600,200,0.75,10,6,4,360.0765286223514,0.441385248655914,0.07167296456242878,0.21108581607176255,131361.49300469283,3060.0540214066023,134421.54702609943,107,2,63.625,31,1,23,34.48931474660233,0.645497311827957,43.717447916666664,1025.1302083333328,33.06871639784944,0
109,4,1,1,32,0.030303030303030304,0.030303030303030304,0.9696969696969697,33,650,300,350,0.46153846153846156,10,3,7,351.6231849948321,0.4417613636363636,0.06494746895893022,0.2079940534969431,131705.23356401385,2662.122741253365,134367.35630526723,108,0,62.666666666666664,33,0,20,34.359081502706154,0.6439393939393939,43.38235294117647,1026.4705882352941,31.10516934046346,0
110,4,0,1,31,0.0,0.03125,0.96875,32,1000,700,300,0.7,13,7,6,377.8710153541507,0.44002016129032256,0.059147095179233444,0.2161935300010665,130423.75299714321,3456.6711942658994,133880.4241914091,109,4,65.625,32,0,21,34.98429130613927,0.6334635416666666,44.63383838383839,1021.464646464647,31.92077020202022,4
111,4,0,1,30,0.0,0.03225806451612903,0.967741935483871,31,800,400,400,0.5,12,4,8,386.5050584961804,0.43848566308243725,0.06738698572386337,0.22078362518467162,130362.29663425016,3877.13741726345,134239.4340515136,110,5,68.54838709677419,31,0,22,34.82630477283353,0.6354166666666667,44.694010416666664,1021.2239583333328,32.942708333333314,0
112,4,0,0,30,0.0,0.0,1.0,30,600,400,200,0.6666666666666666,8,4,4,397.667638483965,0.4379549808429119,0.05619047619047568,0.22657807308970113,130262.58680555562,4360.243055555564,134622.82986111118,111,6,68.53333333333333,30,0,22,34.642857142857146,0.6371527777777778,44.79166666666667,1020.8333333333339,34.0277777777778,0
113,4,0,0,30,0.0,0.0,1.0,30,750,500,250,0.6666666666666666,10,5,5,390.22729894182663,0.4381465517241379,0.07747617165195231,0.22116766031885898,130056.85492903802,4150.347041565498,134207.20197060352,112,7,69.53333333333333,30,0,21,35.04222119734703,0.6350694444444445,44.99327956989247,1020.02688172043,34.00089605734767,1
114,4,0,0,30,0.0,0.0,1.0,30,1100,900,200,0.8181818181818182,13,9,4,390.864414679893,0.438338122605364,0.0730997233566062,0.2219186067191524,130125.41415553816,4172.278767776615,134297.69292331478,113,8,70.53333333333333,30,0,21,34.95614323980153,0.6357638888888889,44.9260752688172,1020.2956989247308,34.00985663082436,0
115,4,0,0,30,0.0,0.0,1.0,30,850,700,150,0.8235294117647058,10,7,3,390.66585813251396,0.43807471264367814,0.06941517386722884,0.2220011373459615,130159.70054341538,4169.790221412877,134329.49076482825,114,9,71.53333333333333,30,0,21,34.92629302774851,0.6361111111111111,44.89247311827957,1020.4301075268813,34.01433691756271,0
116,4,0,0,30,0.0,0.0,1.0,30,1050,900,150,0.8571428571428571,12,9,3,389.42851493857404,0.4376436781609196,0.07182727751448126,0.22207950446497038,130296.89125910499,4148.2649728292145,134445.1562319342,115,10,72.53333333333333,30,0,22,34.81821572757592,0.6375000000000001,44.758064516129025,1020.967741935483,34.0322580645161,0
117,4,0,0,30,0.0,0.0,1.0,30,950,800,150,0.8421052631578947,11,8,3,385.6397392381696,0.4380028735632184,0.06839935079177062,0.22050236105875465,130399.83171826212,4057.471420106355,134457.30313836847,116,11,73.53333333333333,30,0,22,34.81022722288019,0.6385416666666668,44.65725806451612,1021.3709677419347,34.045698924731155,0
118,4,0,0,30,0.0,0.0,1.0,30,800,600,200,0.75,10,6,4,386.0557750374598,0.43785919540229884,0.06375915449721536,0.22113111876863062,130468.48127312385,4073.622131171212,134542.10340429505,117,12,74.53333333333333,30,0,22,34.72980528877782,0.6392361111111112,44.59005376344085,1021.6397849462348,34.054659498207826,0
119,4,0,0,30,0.0,0.0,1.0,30,800,400,400,0.5,12,4,8,387.03549962085987,0.4357998084291188,0.07131589325621124,0.22287502237818918,130674.53833174348,4115.1370461903,134789.67537793377,118,13,75.53333333333333,30,0,22,34.49536611016169,0.6413194444444446,44.38844086021505,1022.4462365591392,34.08154121863797,0
120,4,0,0,30,0.0,0.0,1.0,30,850,700,150,0.8235294117647058,10,7,3,384.3942371601775,0.4351532567049809,0.07004729374671581,0.22234110435131219,130846.37674875703,4059.3186351023205,134905.69538385936,119,14,76.53333333333333,30,0,22,34.38841084252934,0.6430555555555555,44.22043010752688,1023.118279569892,34.103942652329735,0
121,4,0,0,30,0.0,0.0,1.0,30,750,600,150,0.8,9,6,3,382.7464972414658,0.4342193486590038,0.06608448238126474,0.22198130818688205,130949.53399598216,4024.095090472882,134973.62908645504,120,15,77.53333333333333,30,0,22,34.325891880061285,0.6440972222222222,44.119623655913976,1023.5215053763438,34.1173835125448,0
122,4,1,1,30,0.03225806451612903,0.03225806451612903,0.967741935483871,31,1200,1000,200,0.8333333333333334,14,10,4,374.4087934656079,0.43660394265232977,0.055875722424888474,0.21891509692231295,131261.40170627163,3629.0846082899257,134890.48631456157,121,0,76.0,31,0,22,34.2233163913596,0.644489247311828,43.815104166666664,1024.7395833333328,33.056115591397834,0
123,4,0,1,29,0.0,0.03333333333333333,0.9666666666666667,30,1200,1000,200,0.8333333333333334,14,10,4,386.57620867269486,0.43213601532567053,0.069141957491472,0.22561132178432453,131190.39231414022,4143.016895016747,135333.40920915696,122,17,79.53333333333333,30,0,22,33.98358917169597,0.6465277777777778,43.88440860215053,1024.4623655913967,34.14874551971322,0
124,4,1,1,29,0.03333333333333333,0.03333333333333333,0.9666666666666667,30,950,600,350,0.631578947368421,13,6,7,386.0934175783316,0.43527298850574714,0.06001922992876141,0.22634392743043313,131362.5694625101,4143.6446771302935,135506.2141396404,123,0,77.9,30,0,22,33.821456667103696,0.648263888888889,43.71639784946236,1025.1344086021502,34.17114695340501,0
125,4,0,0,29,0.0,0.0,1.0,29,1050,700,350,0.6666666666666666,14,7,7,397.2445316499618,0.43134236453201974,0.06730167039006907,0.2322401073306988,131256.95408950624,4628.221450617297,135885.17554012354,124,19,81.58620689655173,29,0,22,33.642811963495085,0.6501436781609196,43.81944444444445,1024.7222222222229,35.33524904214561,0
126,4,0,0,29,0.0,0.0,1.0,29,400,200,200,0.5,6,2,4,405.0375099358986,0.43134236453201974,0.07137270696445897,0.2335388555722805,130723.78713348774,4789.607445987672,135513.39457947543,125,20,82.58620689655173,29,0,20,33.98510004979855,0.6447557471264367,44.340277777777786,1022.6388888888896,35.263409961685845,1
127,4,0,0,29,0.0,0.0,1.0,29,750,600,150,0.8,9,6,3,402.2200910037968,0.4314449917898194,0.071905399458837,0.23255519547362385,130830.33371913583,4724.517746913587,135554.8514660494,126,21,83.58620689655173,29,0,21,33.948773644673736,0.6458333333333333,44.236111111111114,1023.0555555555558,35.277777777777786,0
128,4,0,0,29,0.0,0.0,1.0,29,700,600,100,0.8571428571428571,8,6,2,405.60245843623034,0.4305213464696223,0.07440302104342011,0.23516007208627723,130936.92370756181,4821.6676311728515,135758.59133873467,127,22,84.58620689655173,29,0,21,33.7538732075813,0.6469109195402298,44.13194444444445,1023.472222222223,35.292145593869755,0
129,4,1,1,29,0.03333333333333333,0.03333333333333333,0.9666666666666667,30,900,600,300,0.6666666666666666,12,6,6,394.714388816556,0.4322557471264368,0.0635918295936666,0.23015442671545328,131155.97043372074,4353.829741877682,135509.80017559842,128,0,82.73333333333333,30,0,21,33.81008616542012,0.6461805555555555,43.918010752688176,1024.327956989248,34.14426523297493,0
130,4,0,0,29,0.0,0.0,1.0,29,850,400,450,0.47058823529411764,13,4,9,405.60245843623034,0.4305213464696223,0.07440302104342011,0.23516007208627723,130936.92370756181,4821.6676311728515,135758.59133873467,129,24,86.58620689655173,29,0,21,33.7538732075813,0.6469109195402298,44.13194444444445,1023.472222222223,35.292145593869755,0
131,4,0,0,29,0.0,0.0,1.0,29,800,600,200,0.75,10,6,4,404.5707990434099,0.4301621510673235,0.07381143936984302,0.23521261281924447,131043.55709876557,4803.27932098767,135846.83641975324,130,25,87.58620689655173,29,0,21,33.67188913004159,0.6479885057471263,44.027777777777786,1023.8888888888899,35.306513409961724,0
132,4,0,0,29,0.0,0.0,1.0,29,900,700,200,0.7777777777777778,11,7,4,403.7690318873886,0.42959770114942525,0.0760257159555815,0.23539894151537488,131150.23389274697,4790.88059413581,135941.11448688278,131,26,88.58620689655173,29,0,21,33.5840395480226,0.649066091954023,43.923611111111114,1024.3055555555559,35.32088122605365,0
133,4,0,0,29,0.0,0.0,1.0,29,700,400,300,0.5714285714285714,10,4,6,402.5166864268182,0.4293924466338259,0.07488325784240857,0.23510416435238626,131221.37586805562,4763.758680555567,135985.13454861118,132,27,89.58620689655173,29,0,21,33.54386945912972,0.6497844827586207,43.85416666666667,1024.583333333334,35.33045977011496,0
134,4,0,0,29,0.0,0.0,1.0,29,1050,700,350,0.6666666666666666,14,7,7,403.9665242915489,0.4282635467980296,0.04928108418385202,0.23860181039090772,131648.6328125,4836.328125,136484.9609375,133,28,90.58620689655173,29,0,20,33.07323386114495,0.6540948275862069,43.4375,1026.25,35.38793103448276,1
135,4,0,0,29,0.0,0.0,1.0,29,850,600,250,0.7058823529411765,11,6,5,405.8836861190757,0.42764778325123154,0.05178011643528868,0.2404080294705296,131755.55555555565,4895.486111111131,136651.04166666677,134,29,91.58620689655173,29,0,21,32.91565205627707,0.6551724137931034,43.33333333333334,1026.6666666666677,35.402298850574745,0
136,4,1,1,29,0.03333333333333333,0.03333333333333333,0.9666666666666667,30,1200,900,300,0.75,15,9,6,397.54066450741004,0.4298132183908046,0.04040364413059594,0.2373140875478663,132052.40716051002,4499.240338478457,136551.6474989885,135,0,89.5,30,0,21,32.82932304607471,0.6552083333333333,43.04435483870969,1027.8225806451624,34.260752688172076,0
137,4,0,1,28,0.0,0.034482758620689655,0.9655172413793104,29,650,500,150,0.7692307692307693,8,5,3,406.55052120458924,0.42790435139573074,0.05173112862409179,0.24239059680844116,132005.21074459868,4933.357445987642,136938.56819058632,136,31,93.58620689655173,29,0,21,32.64559963058071,0.6576867816091954,43.09027777777777,1027.6388888888882,35.43582375478925,0
138,4,0,0,28,0.0,0.0,1.0,28,650,300,350,0.46153846153846156,10,3,7,415.1197613575237,0.4280753968253968,0.05794205794205798,0.2469306400753988,131917.8660490157,5352.342614612236,137270.2086636279,137,32,95.67857142857143,28,0,22,32.51398601398601,0.6599702380952381,43.17528735632184,1027.2988505747126,36.68924466338259,0
139,4,0,0,28,0.0,0.0,1.0,28,500,300,200,0.6,7,3,4,413.1848258837191,0.427744708994709,0.05416067433684901,0.24625815622669653,131991.67657550535,5307.39158079007,137299.06815629543,138,33,96.67857142857143,28,0,22,32.4888725764355,0.6607142857142858,43.10344827586207,1027.5862068965519,36.69950738916257,0
140,4,2,2,28,0.06666666666666667,0.06666666666666667,0.9333333333333333,30,1000,700,300,0.7,13,7,6,390.49611145281244,0.42950191570881224,0.03155833985904466,0.23633342859016174,132570.9709937565,4353.6897329171,136924.66072667358,139,0,91.16666666666667,30,0,22,32.48662229182981,0.6604166666666667,42.54032258064516,1029.8387096774193,34.32795698924731,0
141,4,0,0,28,0.0,0.0,1.0,28,1050,800,250,0.7619047619047619,13,8,5,412.34919068112225,0.4244378306878307,0.05206047791917667,0.2481718406435457,132361.0388591622,5315.793450257602,137676.83230941978,140,35,98.67857142857143,28,0,22,32.136332960997855,0.664434523809524,42.744252873563205,1029.0229885057456,36.75082101806235,0
142,4,0,0,28,0.0,0.0,1.0,28,750,600,150,0.8,9,6,3,412.76314571180876,0.42432760141093473,0.0526242322724737,0.2489086848383331,132434.9732461355,5332.855231866819,137767.8284780023,141,36,99.67857142857143,28,0,22,32.05087939698492,0.6651785714285714,42.672413793103445,1029.3103448275856,36.76108374384234,0
143,4,1,1,28,0.034482758620689655,0.034482758620689655,0.9655172413793104,29,500,300,200,0.6,7,3,4,399.5796660546247,0.4262110016420361,0.03932652169466633,0.24255989875558132,132684.03742283944,4803.568672839496,137487.60609567893,142,0,97.20689655172414,29,0,20,32.13860429585693,0.6645114942528736,42.43055555555555,1030.2777777777771,35.526819923371626,0
144,4,0,0,28,0.0,0.0,1.0,28,500,400,100,0.8,6,4,2,438.0542864821286,0.4243551587301588,0.12119437939110078,0.24292101341281658,129201.38888888883,5751.871141975299,134953.26003086413,143,38,101.67857142857143,27,1,20,34.69945355191257,0.6358024691358024,45.83333333333333,1016.6666666666662,37.6543209876543,7
145,4,2,1,29,0.06666666666666667,0.03333333333333333,0.9666666666666667,30,450,200,250,0.4444444444444444,7,2,5,413.09980770515773,0.4305316091954023,0.11071752951861935,0.23324250681198913,129908.37191358031,4733.024691358033,134641.39660493835,144,0,95.83333333333333,29,1,20,34.61058128973661,0.6364942528735632,45.13888888888889,1019.4444444444449,35.15325670498086,0
146,4,2,1,30,0.06451612903225806,0.03225806451612903,0.967741935483871,31,750,400,350,0.5333333333333333,11,4,7,401.16377177144784,0.43270609318996417,0.1045743863239732,0.2289737921974223,130331.20022907275,4256.831172678926,134588.03140175168,145,0,93.6774193548387,30,1,21,34.483732613751044,0.6378472222222221,44.7244623655914,1021.1021505376347,34.03673835125449,0
147,4,1,0,31,0.03225806451612903,0.0,1.0,31,900,700,200,0.7777777777777778,11,7,4,398.39680609540875,0.43019713261648745,0.11229862575468985,0.22860459749006723,130537.14889365812,4201.116639206833,134738.26553286496,146,0,94.64516129032258,30,1,19,34.34472138191066,0.6399305555555556,44.522849462365585,1021.9086021505367,34.063620071684554,0
148,4,1,2,30,0.03125,0.0625,0.9375,32,900,700,200,0.7777777777777778,11,7,4,388.45562511432144,0.43315272177419356,0.08319159178433888,0.21220682465922625,128606.37240939683,3591.5737575955045,132197.94616699233,147,0,92.65625,31,1,16,36.56878476679503,0.6176075268817203,46.41927083333334,1014.3229166666678,32.72009408602154,4
149,4,2,2,30,0.0625,0.0625,0.9375,32,850,700,150,0.8235294117647058,10,7,3,389.242541298904,0.43623991935483875,0.08042073014243556,0.2131670501997441,128705.4464552138,3619.527011447487,132324.9734666613,148,0,93.5,31,1,17,36.44737264211471,0.6186155913978495,46.321614583333336,1014.713541666667,32.73269489247313,0
150,4,0,0,30,0.0,0.0,1.0,30,600,200,400,0.3333333333333333,10,2,8,407.8974420013847,0.43019636015325674,0.10504385964912233,0.22143003994360896,128355.55555555565,4471.180555555565,132826.7361111112,149,2,100.73333333333333,29,1,20,36.33326480263157,0.6206896551724137,46.66666666666667,1013.3333333333342,34.942528735632216,0
151,4,6,6,30,0.16666666666666666,0.16666666666666666,0.8333333333333334,36,700,400,300,0.5714285714285714,10,4,6,353.68777804094213,0.4467261904761905,0.049167645535725724,0.19805164757645893,129584.09857521013,1966.4623789009022,131550.56095411102,150,0,84.77777777777777,35,1,16,36.45430733962336,0.6181547619047618,45.45717592592593,1018.1712962962969,29.090608465608483,0
152,4,1,0,31,0.03225806451612903,0.0,1.0,31,1350,1000,350,0.7407407407407407,17,10,7,398.3506787419501,0.43091397849462365,0.11740142183130153,0.21919441936601852,128894.11212640196,4069.0114102786533,132963.12353668062,151,0,99.41935483870968,30,1,18,36.02305316567394,0.6232638888888888,46.13575268817205,1015.4569892473123,33.84856630824375,0
153,4,1,0,32,0.03125,0.0,1.0,32,1100,700,400,0.6363636363636364,15,7,8,385.81724293259714,0.4314516129032258,0.1186604057340328,0.21485318025890104,129366.9149610732,3582.397291395408,132949.3122524686,152,0,97.28125,31,1,19,35.8581050812748,0.6253360215053763,45.67057291666667,1017.3177083333339,32.81670026881722,0
154,4,1,2,31,0.030303030303030304,0.06060606060606061,0.9393939393939394,33,800,500,300,0.625,11,5,6,376.75416347245323,0.43402777777777773,0.10326924088391976,0.21132816985874878,129651.06398581782,3169.3156310580616,132820.37961687587,153,0,95.3030303030303,32,1,18,35.798929663608554,0.6256510416666666,45.391414141414145,1018.4343434343438,31.826073232323242,0
155,4,0,0,31,0.0,0.0,1.0,31,450,300,150,0.6666666666666666,6,3,3,393.539157387199,0.4300179211469534,0.10668336656271848,0.21975505160294018,129474.83090530681,3990.683171464892,133465.5140767717,154,2,97.6774193548387,30,1,18,35.551483535833775,0.6291666666666667,45.56451612903225,1017.7419354838697,33.92473118279566,0
156,4,3,2,32,0.08823529411764706,0.058823529411764705,0.9411764705882353,34,1150,700,450,0.6086956521739131,16,7,9,346.46016297057645,0.43685011883541297,0.09821789910894974,0.19047262443339252,128858.98940611785,2128.9012939734753,130987.89070009133,155,0,89.97058823529412,33,1,21,37.37615670891171,0.6152146464646464,46.1703431372549,1015.3186274509806,30.767231134878198,4
157,4,2,1,33,0.058823529411764705,0.029411764705882353,0.9705882352941176,34,700,400,300,0.5714285714285714,10,4,6,346.9281041299684,0.4393010992275698,0.10454322880074951,0.19132981072077918,128983.44574502605,2149.596459294515,131133.04220432058,156,0,90.91176470588235,33,1,22,37.23747838500824,0.6164772727272727,46.047794117647065,1015.8088235294126,30.782085561497354,0
158,4,1,1,33,0.029411764705882353,0.029411764705882353,0.9705882352941176,34,1150,800,350,0.6956521739130435,15,8,7,346.0391044141989,0.4364787581699346,0.11695597626928844,0.1923495329895138,129294.8494118851,2148.214779171503,131443.0641910566,157,0,91.88235294117646,33,1,23,36.943080491625494,0.6196338383838382,45.741421568627466,1017.0343137254921,30.819221628045216,0
159,4,0,1,32,0.0,0.030303030303030304,0.9696969696969697,33,750,300,450,0.4,12,3,9,347.82518231848763,0.4371054292929293,0.10572766773884057,0.19335623489133355,129297.68207644658,2394.5979683195947,131692.28004476617,158,1,91.72727272727273,32,1,24,36.89478584729981,0.6220703124999998,45.73863636363638,1017.0454545454569,31.782670454545528,0
160,4,2,1,33,0.058823529411764705,0.029411764705882353,0.9705882352941176,34,1250,900,350,0.72,16,9,7,334.6004742368922,0.44282902554961373,0.08655118489113356,0.18806854241590892,129731.4453125004,1881.640625000043,131613.08593750044,159,0,85.52941176470588,33,1,21,36.79064417177912,0.62405303030303,45.31250000000002,1018.7500000000032,30.871212121212217,0
161,4,1,1,33,0.029411764705882353,0.029411764705882353,0.9705882352941176,34,1050,800,250,0.7619047619047619,13,8,5,335.9475759214042,0.44253193701723115,0.0856466910438578,0.1894288806059879,129856.32216275009,1924.9833297289754,131781.30549247906,160,0,86.5,33,1,22,36.62966915153703,0.6253156565656565,45.18995098039217,1019.2401960784329,30.886066547831298,0
162,4,0,0,33,0.0,0.0,1.0,33,400,300,100,0.75,5,3,2,342.3086180368259,0.4395123106060606,0.09128839516743814,0.19248001665081188,129747.52456700857,2282.7391656463733,132030.26373265494,161,2,90.12121212121212,32,1,22,36.57800429627794,0.6266276041666666,45.29671717171718,1018.8131313131321,31.837910353535378,0
163,4,2,1,34,0.05714285714285714,0.02857142857142857,0.9714285714285714,35,1050,900,150,0.8571428571428571,12,9,3,323.6984589754269,0.4426470588235294,0.0739358600583091,0.1844328429046039,130262.58680555574,1433.159722222246,131695.74652777798,162,0,85.91428571428571,34,1,24,36.53061224489796,0.6271446078431371,44.79166666666668,1020.8333333333348,30.024509803921614,0
164,4,0,0,34,0.0,0.0,1.0,34,1400,1100,300,0.7857142857142857,17,11,6,331.9279707940111,0.439263963161022,0.08218834549551812,0.1886664991673535,130168.77710796325,1841.3316092368304,132010.10871720008,163,1,89.44117647058823,33,1,24,36.41555081862216,0.6284722222222222,44.88357843137255,1020.4656862745095,30.923202614379075,0
165,4,0,0,34,0.0,0.0,1.0,34,850,600,250,0.7058823529411765,11,6,5,332.0377144858986,0.43826128936423053,0.07219700552727981,0.18964155413372136,130356.43029423783,1856.650236687818,132213.08053092565,164,2,90.44117647058823,33,1,24,36.222823912956514,0.6303661616161615,44.69975490196079,1021.2009803921571,30.945484254307793,0
166,4,0,0,34,0.0,0.0,1.0,34,1300,1000,300,0.7692307692307693,16,10,6,333.03659230888644,0.43709150326797386,0.07926364790520468,0.19128961293774882,130575.52984429068,1897.285899653977,132472.81574394467,165,3,91.44117647058823,33,1,18,35.97571942446042,0.6325757575757576,44.48529411764706,1022.0588235294119,30.97147950089127,0
167,4,0,0,34,0.0,0.0,1.0,34,600,300,300,0.5,9,3,6,333.8477635620497,0.43679441473559116,0.07953375548253305,0.1920660719748014,130638.1635068244,1922.6517445213478,132560.81525134575,166,4,92.44117647058823,33,1,18,35.89167266043313,0.6332070707070707,44.42401960784314,1022.3039215686283,30.978906714200857,0
168,4,0,0,34,0.0,0.0,1.0,34,400,300,100,0.75,5,3,2,334.0718797119471,0.4365530303030303,0.08314472858542965,0.19235070341178562,130669.48596993937,1930.6001597943045,132600.08612973368,167,5,93.44117647058823,33,1,18,35.8542840305246,0.6335227272727273,44.393382352941174,1022.4264705882347,30.982620320855595,0
169,4,0,1,33,0.0,0.029411764705882353,0.9705882352941176,34,650,200,450,0.3076923076923077,11,2,9,335.19854322821004,0.43577317290552586,0.07984904756199906,0.19362645261770695,130794.81336805543,1968.4461805555466,132763.25954861098,168,6,94.44117647058823,33,1,18,35.69882892057027,0.6347853535353536,44.27083333333333,1022.9166666666656,30.997474747474715,0
170,4,0,0,33,0.0,0.0,1.0,33,650,500,150,0.7692307692307693,8,5,3,346.35605167886314,0.4353693181818182,0.08912788043437647,0.19948729064690113,130681.82615294337,2452.488266503396,133134.31441944677,169,10,98.12121212121212,32,1,18,35.52780521939576,0.6360677083333335,44.38131313131312,1022.4747474747458,31.952335858585805,0
171,4,0,0,33,0.0,0.0,1.0,33,1050,600,450,0.5714285714285714,15,6,9,346.06447379988373,0.4341066919191919,0.08911072476772675,0.2004898184523271,130907.84940631047,2460.5112042138426,133368.3606105243,170,11,99.12121212121212,32,1,18,35.306652272259925,0.6383463541666667,44.16035353535353,1023.358585858585,31.97995580808078,0
172,4,0,0,33,0.0,0.0,1.0,33,1300,1000,300,0.7692307692307693,16,10,6,348.5768399215716,0.43402777777777773,0.09501075847229701,0.2031361584370537,131134.06795224972,2542.0598025711624,133676.1277548209,171,12,100.12121212121212,32,1,21,35.013714250493095,0.640625,43.93939393939394,1024.2424242424238,32.007575757575744,0
173,4,0,0,33,0.0,0.0,1.0,33,1000,500,500,0.5,15,5,10,346.4198424031052,0.4334359217171717,0.09471330279510659,0.20273178520447035,131295.7721948015,2496.6921423834247,133792.46433718494,172,13,101.12121212121212,32,1,22,34.90565069196339,0.6422526041666667,43.781565656565654,1024.873737373737,32.02730429292928,0
174,4,0,0,33,0.0,0.0,1.0,33,1050,800,250,0.7619047619047619,13,8,5,348.0789519543866,0.43292297979797983,0.10043545913512664,0.204392564629181,131425.20732897156,2549.2696854912774,133974.47701446284,173,14,102.12121212121212,32,1,22,34.732483684275344,0.6435546875,43.65530303030303,1025.378787878788,32.043087121212125,0
175,4,1,1,33,0.029411764705882353,0.029411764705882353,0.9705882352941176,34,1300,900,400,0.6923076923076923,17,9,8,338.8992820226228,0.43376782531194297,0.09111260825017209,0.20146480722791646,131893.99059256038,2139.7557429834465,134033.74633554384,174,0,100.08823529411765,33,1,20,34.495546011294046,0.6458333333333335,43.198529411764696,1027.2058823529399,31.127450980392116,0
176,4,0,0,33,0.0,0.0,1.0,33,850,700,150,0.8235294117647058,10,7,3,349.7438812679085,0.432449494949495,0.09814113097034549,0.20747388667774624,131813.89534550055,2620.220672635454,134434.116018136,175,16,104.12121212121212,32,1,20,34.29776835116194,0.6474609375,43.276515151515156,1026.89393939394,32.09043560606062,0
177,4,0,0,33,0.0,0.0,1.0,33,950,700,250,0.7368421052631579,12,7,5,352.31267566415175,0.4323311237373737,0.09363546974166459,0.20953332815815356,131911.15702479347,2694.7945362718183,134605.9515610653,176,17,105.12121212121212,32,1,20,34.133788102261555,0.6484375,43.18181818181819,1027.272727272728,32.10227272727275,0
178,4,1,1,33,0.029411764705882353,0.029411764705882353,0.9705882352941176,34,600,400,200,0.6666666666666666,8,4,4,345.2997985956023,0.4338420974450386,0.08817923166407393,0.2073280764958143,132271.9101427335,2334.692786428291,134606.6029291618,177,0,103.0,33,1,20,33.950837900087365,0.6496212121212122,42.830882352941174,1028.676470588235,31.172014260249544,0
179,4,0,0,33,0.0,0.0,1.0,33,950,800,150,0.8421052631578947,11,8,3,356.09680347500756,0.43035827020202017,0.10005542103246734,0.21378928945548184,132268.09007052865,2820.048815171933,135088.13888570058,178,19,107.12121212121212,32,1,22,33.677018125281286,0.6520182291666666,42.834595959595966,1028.661616161617,32.145675505050534,0
180,4,0,0,33,0.0,0.0,1.0,33,850,500,350,0.5882352941176471,12,5,7,357.48823944008257,0.42996369949494945,0.09839283523494058,0.21536486619926945,132398.00347222236,2866.145833333352,135264.1493055557,179,20,108.12121212121212,32,1,22,33.51045883940622,0.6533203125,42.70833333333334,1029.1666666666679,32.16145833333337,0
181,4,1,1,33,0.029411764705882353,0.029411764705882353,0.9705882352941176,34,900,500,400,0.5555555555555556,13,5,8,350.79522848768744,0.431131164587047,0.09577533748338829,0.21347234960791978,132776.6438989812,2515.4826268742854,135292.12652585548,180,0,105.91176470588235,33,1,19,33.302120491478405,0.6546717171717171,42.34068627450981,1030.6372549019611,31.231431966726095,0
182,4,0,0,33,0.0,0.0,1.0,33,850,700,150,0.8235294117647058,10,7,3,371.82912039343114,0.4289378156565657,0.10834139673470689,0.22163711617409043,131996.2904188367,3217.830122053408,135214.12054089012,181,22,110.12121212121212,31,2,20,33.546629498226054,0.6518817204301076,43.09895833333333,1027.6041666666658,33.148521505376316,2
183,4,0,0,33,0.0,0.0,1.0,33,900,600,300,0.6666666666666666,12,6,6,372.15532568364654,0.4289378156565657,0.11952090007900318,0.21935610818094758,131569.33108235046,3193.4558033488192,134762.7868856993,182,23,111.12121212121212,30,3,18,33.96955107209921,0.6503472222222222,43.51478494623655,1025.940860215053,34.1980286738351,1
184,4,0,0,33,0.0,0.0,1.0,33,850,700,150,0.8235294117647058,10,7,3,370.82280427881375,0.428543244949495,0.11841040049526175,0.2191643137363019,131672.7728639148,3165.4533761128296,134838.22624002764,183,24,112.12121212121212,30,3,18,33.89918369128688,0.6513888888888889,43.41397849462365,1026.3440860215046,34.21146953405015,0
185,4,0,0,33,0.0,0.0,1.0,33,1150,800,350,0.6956521739130435,15,8,7,372.55689533733914,0.42716224747474746,0.11762699630779738,0.22118937352545515,131845.26616155042,3223.9726052144683,135069.23876676487,184,25,113.12121212121212,30,3,19,33.68041922959473,0.653125,43.24596774193548,1027.0161290322576,34.23387096774192,0
186,4,0,0,33,0.0,0.0,1.0,33,1600,1100,500,0.6875,21,11,10,373.07111767125923,0.42645202020202017,0.11594237352605563,0.22290999280857746,132086.9464677998,3255.5649497051772,135342.51141750498,185,26,114.12121212121212,30,3,22,33.423226115760116,0.6555555555555554,43.01075268817205,1027.9569892473123,34.26523297491041,0
187,4,0,0,33,0.0,0.0,1.0,33,950,700,250,0.7368421052631579,12,7,5,372.06145896262433,0.4253866792929293,0.11490442536276957,0.22295458292009168,132197.0706515843,3237.086995442727,135434.15764702702,186,27,115.12121212121212,31,2,23,33.33808137081119,0.6538978494623655,42.90364583333334,1028.3854166666677,33.173723118279604,0
188,4,0,0,33,0.0,0.0,1.0,33,1200,900,300,0.75,15,9,6,371.50713026758524,0.42514993686868685,0.11479861910241662,0.22301719826093663,132264.0313042536,3227.40614149308,135491.4374457467,187,28,116.12121212121212,31,2,23,33.28481012658228,0.6545698924731183,42.83854166666668,1028.6458333333346,33.18212365591402,0
189,4,0,0,33,0.0,0.0,1.0,33,1200,900,300,0.75,15,9,6,372.58864510030077,0.42514993686868685,0.1500607556128839,0.21585639517783708,130907.84940631072,3154.955648658318,134062.80505496904,188,29,117.12121212121212,32,1,17,34.62805881143326,0.6383463541666665,44.16035353535354,1023.358585858587,31.979955808080845,7
190,4,1,0,34,0.029411764705882353,0.0,1.0,34,900,600,300,0.6666666666666666,12,6,6,366.1841496463743,0.42606209150326796,0.15590626494500248,0.2144792876500194,131328.12500000015,2818.055555555571,134146.1805555557,189,0,114.6470588235294,33,1,18,34.36653116531164,0.6401515151515151,43.75000000000001,1025.0000000000011,31.060606060606094,0
191,4,0,0,34,0.0,0.0,1.0,34,1050,600,450,0.5714285714285714,15,6,9,364.5123023080623,0.42609922756981583,0.15281039501624183,0.21385062560373433,131390.93888168028,2778.7227268358465,134169.66160851612,190,1,115.6470588235294,33,1,18,34.34586421228782,0.6407828282828282,43.688725490196084,1025.2450980392168,31.06803327391566,0
192,4,0,0,34,0.0,0.0,1.0,34,950,300,650,0.3157894736842105,16,3,13,364.353546902589,0.4251522578728461,0.15355260383723368,0.21446126494899237,131516.61169982707,2783.708789888514,134300.32048971558,191,2,116.6470588235294,33,1,18,34.222919155714855,0.6420454545454545,43.56617647058824,1025.7352941176478,31.08288770053478,0
193,4,1,1,34,0.02857142857142857,0.02857142857142857,0.9714285714285714,35,750,600,150,0.8,9,6,3,359.39890678590564,0.42766106442577034,0.14540396429813374,0.2133884630999319,131847.2381661,2477.15065192747,134324.38881802745,192,0,114.28571428571429,34,1,16,34.0162667593988,0.6430759803921566,43.244047619047635,1027.0238095238115,30.206582633053277,0
194,4,0,0,34,0.0,0.0,1.0,34,850,600,250,0.7058823529411765,11,6,5,370.804277091025,0.4242795603089721,0.16291267043938618,0.21970284536553097,131768.13755526723,2972.0377979623217,134740.17535322954,193,4,118.6470588235294,33,1,16,33.80331423569666,0.6445707070707071,43.32107843137255,1026.7156862745098,31.112596553773024,0
195,4,0,0,34,0.0,0.0,1.0,34,600,300,300,0.5,9,3,6,369.64674436339396,0.4234811348781937,0.1591210503048892,0.21992538381819232,131925.4632382977,2953.163596933866,134878.62683523155,194,5,119.6470588235294,33,1,17,33.67417690564237,0.6461489898989898,43.16789215686274,1027.3284313725485,31.131164587046925,0
196,4,0,0,34,0.0,0.0,1.0,34,1150,900,250,0.782608695652174,14,9,5,372.18621238097273,0.4222742127153892,0.16868635866363757,0.2223574038070938,132082.88278546702,3031.8855728565827,135114.7683583236,195,6,120.6470588235294,33,1,17,33.45006755682722,0.6477272727272728,43.014705882352935,1027.9411764705874,31.14973262032083,0
197,4,1,2,33,0.02857142857142857,0.05714285714285714,0.9428571428571428,35,550,400,150,0.7272727272727273,7,4,3,363.5754106991952,0.4257002801120448,0.15846349647113245,0.21867656747899394,132336.75063775512,2622.8776927437566,134959.62833049888,196,0,118.17142857142858,34,1,17,33.41552894442514,0.6479779411764706,42.76785714285714,1028.9285714285713,30.262605042016805,0
198,4,0,0,33,0.0,0.0,1.0,33,850,600,250,0.7058823529411765,11,6,5,410.5995257471163,0.4215593434343434,0.1733787935050466,0.23278832059726,130069.31889921954,4081.280130854001,134150.59903007353,197,8,121.0909090909091,32,1,16,34.50999504889218,0.6298828125,44.98106060606061,1020.0757575757582,31.877367424242443,6
199,4,0,1,32,0.0,0.030303030303030304,0.9696969696969697,33,950,500,450,0.5263157894736842,14,5,9,412.5117324704628,0.42104640151515155,0.1752491507502647,0.2344528707332125,130165.93491735542,4138.995064279164,134304.92998163457,198,9,122.0909090909091,32,1,16,34.36262682504331,0.630859375,44.88636363636364,1020.4545454545458,31.889204545454557,0
200,4,0,0,32,0.0,0.0,1.0,32,800,700,100,0.875,9,7,2,421.75564197850883,0.4205939180107527,0.18990139137094708,0.23907624451951068,130063.28158908417,4570.984564887149,134634.26615397132,199,10,125.625,31,1,17,34.23166113522253,0.6323924731182796,44.986979166666664,1020.052083333333,32.90490591397848,0
201,4,0,0,32,0.0,0.0,1.0,32,750,500,250,0.6666666666666666,10,5,5,423.9903334936542,0.42032090053763443,0.19296825143586482,0.24054773808275032,130096.48852878151,4631.930711534294,134728.4192403158,200,11,126.625,31,1,17,34.140741331631574,0.632728494623656,44.954427083333336,1020.1822916666671,32.90910618279571,0
202,4,1,1,32,0.030303030303030304,0.030303030303030304,0.9696969696969697,33,850,700,150,0.8235294117647058,10,7,3,411.9382342450253,0.4213620580808081,0.17936067311762693,0.2354889312231809,130391.51178770028,4142.649825272934,134534.1616129732,201,0,123.75757575757575,32,1,17,34.147195780277734,0.6331380208333334,44.66540404040404,1021.3383838383842,31.916824494949505,0
203,4,0,1,31,0.0,0.03125,0.96875,32,800,600,200,0.75,10,6,4,423.14505172431376,0.4195858534946237,0.19349167623421337,0.24088845755024657,130229.35867309572,4621.18174235026,134850.54041544598,202,13,128.625,31,1,17,34.026581834417655,0.6340725806451613,44.82421875,1020.7031250000001,32.92590725806452,0
204,4,0,0,31,0.0,0.0,1.0,31,850,500,350,0.5882352941176471,12,5,7,427.89661993524555,0.41801075268817206,0.2105312343361061,0.24358672652085853,130228.28686842402,4944.848754191227,135173.13562261526,203,14,132.1290322580645,30,1,17,33.90642832060398,0.6368055555555556,44.8252688172043,1020.6989247311822,34.02329749103941,0
205,4,1,1,31,0.03125,0.03125,0.96875,32,1100,900,200,0.8181818181818182,13,9,4,416.0496944493801,0.4200688844086022,0.19912716615698245,0.23868114049990757,130528.56445312501,4461.273871527777,134989.83832465278,204,0,128.96875,31,1,16,33.90248046211349,0.6370967741935484,44.53125,1021.8750000000001,32.96370967741936,0
206,4,2,2,31,0.06060606060606061,0.06060606060606061,0.9393939393939394,33,1000,800,200,0.8,12,8,4,406.287467954126,0.42211174242424243,0.17670223149675213,0.2349855355340674,130843.25140610659,4031.9946625344405,134875.24606864102,205,0,126.0,32,1,17,33.83160557818092,0.6376953125,44.22348484848485,1023.1060606060611,31.97206439393941,0
207,4,1,0,32,0.03125,0.0,1.0,32,1100,800,300,0.7272727272727273,14,8,6,417.3954062828491,0.41931283602150543,0.19889762025960778,0.24152379253097414,130861.41798231343,4524.190945095496,135385.60892740893,206,0,130.90625,31,1,18,33.52899380673624,0.6404569892473118,44.20572916666667,1023.1770833333339,33.005712365591414,0
208,4,1,0,33,0.030303030303030304,0.0,1.0,33,1100,800,300,0.7272727272727273,14,8,6,405.59232825204276,0.4220722853535353,0.18785116160993942,0.23736070140027618,131295.77219480154,4050.511586827871,135346.2837816294,207,0,127.9090909090909,32,1,19,33.389542523920994,0.6422526041666667,43.781565656565654,1024.8737373737372,32.02730429292929,0
209,4,0,0,33,0.0,0.0,1.0,33,700,500,200,0.7142857142857143,9,5,4,407.853655281379,0.4215593434343434,0.18884821618475067,0.23949237415329577,131425.20732897162,4120.450241046835,135545.65757001846,208,1,128.9090909090909,32,1,19,33.20019086319418,0.6435546875,43.65530303030303,1025.3787878787884,32.04308712121214,0
210,4,0,0,33,0.0,0.0,1.0,33,800,700,100,0.875,9,7,2,406.813824280867,0.42104640151515155,0.1924313277992824,0.23989616372324582,131587.0909218448,4106.2895367819765,135693.38045862678,209,2,129.9090909090909,32,1,17,33.062597423906816,0.6451822916666666,43.497474747474755,1026.0101010101018,32.06281565656568,0
211,4,0,0,33,0.0,0.0,1.0,33,1050,600,450,0.5714285714285714,15,6,9,412.19802937444274,0.42017834595959597,0.19502193791774292,0.2436914749661704,131684.2689043209,4255.99922839505,135940.26813271595,210,3,130.9090909090909,32,1,17,32.82589084348217,0.6461588541666667,43.40277777777777,1026.3888888888882,32.07465277777776,0
212,4,0,0,33,0.0,0.0,1.0,33,550,400,150,0.7272727272727273,7,4,3,411.7783749592609,0.4199810606060606,0.19551808827420647,0.2438579728181902,131749.07415378533,4250.283931486581,135999.3580852719,211,4,131.9090909090909,32,1,17,32.77092813512071,0.6468098958333334,43.339646464646464,1026.6414141414143,32.0825441919192,0
213,4,0,1,32,0.0,0.030303030303030304,0.9696969696969697,33,750,500,250,0.6666666666666666,10,5,5,410.8945512666194,0.4197048611111111,0.19392150725156143,0.24354187251458786,131781.48275686146,4229.658644526057,136011.14140138752,212,5,132.9090909090909,32,1,17,32.76074971306771,0.6471354166666667,43.3080808080808,1026.7676767676762,32.08648989898988,0
214,4,0,0,32,0.0,0.0,1.0,32,850,500,350,0.5882352941176471,12,5,7,417.8397411038911,0.41593161962365593,0.19718187008373533,0.24688252169271863,131661.9957817924,4602.722846137134,136264.7186279295,213,7,137.90625,31,1,17,32.70373424680707,0.6485215053763442,43.42447916666666,1026.3020833333321,33.10651881720426,0
215,4,0,0,32,0.0,0.0,1.0,32,650,600,50,0.9230769230769231,7,6,1,418.87870154285656,0.4155535954301075,0.19819944817962765,0.24771348869184814,131695.40617201052,4632.880147298169,136328.28631930868,214,8,138.90625,31,1,17,32.64316144445854,0.6488575268817205,43.39192708333333,1026.4322916666658,33.110719086021476,0
216,4,0,0,32,0.0,0.0,1.0,32,950,800,150,0.8421052631578947,11,8,3,418.3137469733228,0.41576360887096775,0.19998494357803986,0.24824985119477783,131829.0901184082,4629.184129503038,136458.27424791123,215,9,139.90625,31,1,18,32.52200350788216,0.6502016129032258,43.26171875,1026.953125,33.12752016129032,0
217,4,0,0,32,0.0,0.0,1.0,32,1050,800,250,0.7619047619047619,13,8,5,418.9307669942059,0.4157006048387097,0.1992316223067172,0.24927328443320382,131929.39758300773,4653.856743706582,136583.25432671432,216,10,140.90625,31,1,18,32.404414871144915,0.651209677419355,43.16406249999999,1027.3437499999993,33.140120967741915,0
218,4,0,1,31,0.0,0.03125,0.96875,32,950,800,150,0.8421052631578947,11,8,3,417.0838733564294,0.4145665322580645,0.2000015834811253,0.24905144449891473,132063.2002088758,4616.2862141927035,136679.4864230685,217,11,141.90625,31,1,18,32.316210624102695,0.6525537634408602,43.033854166666664,1027.8645833333328,33.15692204301074,0
219,4,0,0,31,0.0,0.0,1.0,31,850,300,550,0.35294117647058826,14,3,11,416.3498033282789,0.4136648745519713,0.17624874869762475,0.24883283098234338,132096.66146172397,4799.683803982179,136896.34526570616,218,12,140.5483870967742,31,0,18,32.30116635001056,0.6528897849462367,43.00130208333332,1027.994791666665,33.1611223118279,0
220,4,1,1,31,0.03125,0.03125,0.96875,32,550,200,350,0.36363636363636365,9,2,7,407.73472844292223,0.41788474462365593,0.16753067484662587,0.2454237841070764,132365.51914345467,4394.003800632573,136759.52294408725,219,0,137.125,32,0,18,32.250511247443754,0.6529947916666667,42.73989898989898,1029.0404040404032,32.1575126262626,0
221,4,0,0,31,0.0,0.0,1.0,31,500,400,100,0.8,6,4,2,416.71280977307526,0.4131272401433692,0.17670459650871284,0.24971151529497293,132197.07065158398,4817.64255099824,137014.71320258224,220,14,142.5483870967742,31,0,18,32.19011142061281,0.6538978494623657,42.90364583333332,1028.385416666665,33.17372311827951,0
222,4,0,0,31,0.0,0.0,1.0,31,550,500,50,0.9090909090909091,6,5,1,420.20427507357607,0.41317204301075267,0.17903450416345068,0.2520268465304613,132230.5488586425,4912.768385145383,137143.31724378787,221,15,143.5483870967742,31,0,18,32.06642718487572,0.654233870967742,42.87109374999999,1028.5156249999993,33.177923387096754,0
223,4,2,0,33,0.06060606060606061,0.0,1.0,33,650,400,250,0.6153846153846154,9,4,5,360.569838381085,0.41785037878787884,0.0776187983481651,0.20643613823796164,130450.30757400986,2807.2892637447017,133257.59683775457,222,0,135.78787878787878,33,0,20,35.399172264875254,0.6313131313131313,44.607843137254896,1021.5686274509793,30.9566250742721,7
224,4,0,0,33,0.0,0.0,1.0,33,800,600,200,0.75,10,6,4,359.6282686081353,0.41729797979797983,0.0785698713756271,0.20656334436582954,130575.5298442905,2791.730344098407,133367.2601883889,223,1,136.78787878787878,33,0,17,35.296262989608316,0.6325757575757576,44.48529411764705,1022.0588235294105,30.971479500891228,0
225,4,0,0,33,0.0,0.0,1.0,33,900,500,400,0.5555555555555556,13,5,8,358.5371881080053,0.41714015151515155,0.07534886086618497,0.20610328642376774,130606.84479827457,2765.482176326395,133372.32697460096,224,2,137.78787878787878,33,0,17,35.292405986492426,0.6328914141414143,44.45465686274509,1022.1813725490185,30.975193107546016,0
226,4,0,0,33,0.0,0.0,1.0,33,800,700,100,0.875,9,7,2,361.5161663061691,0.41753472222222227,0.07828524942618875,0.20832119417532285,130700.81218762012,2850.091311034211,133550.90349865434,225,3,138.78787878787878,33,0,18,35.12104506232022,0.6338383838383839,44.36274509803921,1022.549019607843,30.986333927510394,0
227,4,1,1,33,0.029411764705882353,0.029411764705882353,0.9705882352941176,34,850,800,50,0.9411764705882353,9,8,1,353.5488194449111,0.4211415626856803,0.06787724974860221,0.20527794047311204,130992.77388038544,2462.4681122448906,133455.24199263033,226,0,135.6764705882353,34,0,19,35.0292669690274,0.6344975490196079,44.07738095238095,1023.6904761904759,30.10854341736694,0
228,4,0,0,33,0.0,0.0,1.0,33,1350,1200,150,0.8888888888888888,15,12,3,364.4156090350974,0.4166666666666667,0.03691124976963356,0.2029092302692316,129361.89746263139,2851.5451034255193,132213.4425660569,227,5,140.78787878787878,32,1,23,36.407523478548676,0.6227213541666666,45.67550505050505,1017.29797979798,31.790561868686876,4
229,4,4,2,35,0.10810810810810811,0.05405405405405406,0.9459459459459459,37,950,700,250,0.7368421052631579,12,7,5,331.4996197844191,0.4278653653653654,0.029896916433469256,0.18943730635317566,130377.57087746536,1244.0230348591886,131621.59391232455,228,0,126.45945945945945,36,1,20,36.21517440364613,0.6241319444444444,44.679054054054056,1021.2837837837843,28.36899399399401,0
230,4,0,2,33,0.0,0.05714285714285714,0.9428571428571428,35,1050,800,250,0.7619047619047619,13,8,5,347.1392964796964,0.4226890756302521,0.03850579369581131,0.19704010936693625,130114.93866008645,2033.6016535922402,132148.5403136787,229,1,134.68571428571428,35,0,20,36.08208073359804,0.6235119047619049,44.93634259259259,1020.2546296296285,29.150132275132243,0
231,4,0,0,33,0.0,0.0,1.0,33,700,300,400,0.42857142857142855,11,3,8,364.5540164608403,0.41796875,0.0465953739949414,0.20506780059914936,129762.6588932142,2861.099697231846,132623.75859044606,230,2,143.42424242424244,33,0,20,35.99601074492825,0.6243686868686869,45.281862745098046,1018.8725490196083,30.87492572786692,0
232,4,1,0,34,0.029411764705882353,0.0,1.0,34,850,500,350,0.5882352941176471,12,5,7,358.14603873107575,0.4200460487225193,0.06126021003500548,0.20326566569041854,130110.7213718821,2519.727891156461,132630.44926303855,231,0,140.1764705882353,34,0,21,35.80562038117463,0.6256127450980392,44.94047619047619,1020.2380952380954,30.007002801120453,0
233,4,1,0,35,0.02857142857142857,0.0,1.0,35,800,400,400,0.5,12,4,8,341.53226134632536,0.4206232492997199,0.038255066172063756,0.19444628875489003,130233.05047850241,1895.7576463906253,132128.80812489302,232,0,137.14285714285714,35,0,19,36.10540216199871,0.6247023809523808,44.82060185185186,1020.717592592594,29.163359788359827,1
234,4,0,1,34,0.0,0.02857142857142857,0.9714285714285714,35,1200,900,300,0.75,15,9,6,344.0048150615122,0.41929271708683474,0.036830433023067544,0.19674935145287417,130410.3186755188,1972.3555116169557,132382.67418713577,233,1,138.14285714285714,35,0,21,35.862724268177516,0.6264880952380951,44.64699074074075,1021.4120370370381,29.18320105820109,0
235,4,0,0,34,0.0,0.0,1.0,34,800,500,300,0.625,11,5,6,356.8318539395314,0.4162396019013666,0.04500750982449686,0.20362919569124166,130323.3577806123,2500.705073696154,132824.06285430846,234,2,143.05882352941177,34,0,21,35.62337258559715,0.6277573529411764,44.73214285714286,1021.0714285714291,30.031512605042032,0
236,4,0,0,34,0.0,0.0,1.0,34,900,600,300,0.6666666666666666,12,6,6,356.69520370227417,0.41521836007130125,0.05133864312445979,0.20434968212102272,130475.34722222232,2507.9861111111168,132983.33333333343,235,3,144.05882352941177,34,0,22,35.47274333877107,0.6292892156862745,44.583333333333336,1021.6666666666674,30.04901960784316,0
237,4,0,0,34,0.0,0.0,1.0,34,1150,1000,150,0.8695652173913043,13,10,3,356.69547289786675,0.4143085264408794,0.04664428380554253,0.2048314805905142,130566.583404195,2514.501842403617,133081.0852465986,236,4,145.05882352941177,34,0,15,35.38026596777323,0.6302083333333334,44.49404761904761,1022.0238095238094,30.059523809523807,0
238,4,0,0,34,0.0,0.0,1.0,34,900,700,200,0.7777777777777778,11,7,4,358.21960254501926,0.41356580510992275,0.055251929622704754,0.20635467245198982,130688.28124999988,2563.02083333332,133251.3020833332,237,5,146.05882352941177,34,0,15,35.218011409942946,0.6314338235294118,44.37499999999999,1022.4999999999991,30.073529411764678,0
239,4,0,0,34,0.0,0.0,1.0,34,750,600,150,0.8,9,6,3,358.8247969523543,0.41369578134284013,0.05656371978360619,0.20686610777320277,130718.71456916087,2581.0232426303714,133299.73781179124,238,6,147.05882352941177,34,0,15,35.17171129220024,0.6317401960784315,44.34523809523809,1022.6190476190466,30.0770308123249,0
240,4,0,1,33,0.0,0.029411764705882353,0.9705882352941176,34,750,600,150,0.8,9,6,3,361.0369138543625,0.4134172608437314,0.0609622557574514,0.2089637895338883,130870.93431122434,2649.847647392272,133520.7819586166,239,7,148.05882352941177,34,0,16,34.96097537327904,0.6332720588235294,44.19642857142856,1023.2142857142844,30.094537815126014,0
241,4,0,1,32,0.0,0.030303030303030304,0.9696969696969697,33,800,500,300,0.625,11,5,6,370.0133653508218,0.4125631313131313,0.06222561141674432,0.2133905690292056,130732.14215986621,3074.527976018817,133806.67013588504,240,9,153.33333333333334,33,0,16,34.87205412422608,0.6341540404040404,44.332107843137244,1022.6715686274495,30.990047534165136,0
242,4,0,1,31,0.0,0.03125,0.96875,32,600,300,300,0.5,9,3,6,374.82578875171464,0.40990423387096775,0.06136574074074086,0.21624564735675839,130746.38429752059,3401.423324150587,134147.80762167118,241,10,153.75,32,0,16,34.73456790123458,0.63671875,44.31818181818181,1022.7272727272722,31.960227272727256,0
243,4,0,1,30,0.0,0.03225806451612903,0.967741935483871,31,750,500,250,0.6666666666666666,10,5,5,383.0415167373233,0.40721326164874555,0.06758128202283631,0.22031201083551094,130628.37600707999,3807.2182549370527,134435.59426201705,242,11,158.58064516129033,31,0,16,34.644339362289294,0.6381048387096775,44.43359374999999,1022.2656249999993,32.97631048387095,0
244,4,0,0,30,0.0,0.0,1.0,30,350,200,150,0.5714285714285714,5,2,3,396.4018439802268,0.4053879310344828,0.0844008943837955,0.22745986564389922,130537.14889365825,4349.033305873513,134886.18219953176,243,12,162.0,30,0,16,34.395688105572354,0.6399305555555554,44.52284946236559,1021.9086021505378,34.063620071684596,0
245,4,1,1,30,0.03225806451612903,0.03225806451612903,0.967741935483871,31,900,600,300,0.6666666666666666,12,6,6,385.555062406411,0.40815412186379924,0.07988962617436446,0.22271474781358572,130794.8133680556,3885.720486111116,134680.53385416672,244,0,157.74193548387098,31,0,17,34.41106585200271,0.6397849462365591,44.270833333333336,1022.9166666666671,32.997311827957006,0
246,4,2,1,31,0.0625,0.03125,0.96875,32,700,600,100,0.8571428571428571,8,6,2,368.4975874148986,0.41574260752688175,0.05614837398374006,0.21583430120015484,131328.125,3278.8194444444434,134606.94444444444,245,0,146.28125,32,0,18,34.307249322493234,0.642578125,43.75,1025.0,32.03125,0
247,4,0,0,31,0.0,0.0,1.0,31,900,500,400,0.5555555555555556,13,5,8,375.2008138219502,0.4112455197132616,0.061917118623918244,0.21918746874275616,131228.04641723633,3647.3739624023433,134875.42037963867,246,1,152.0,31,0,19,34.23679946626002,0.6441532258064516,43.84765625,1024.609375,33.05191532258065,0
248,4,1,1,31,0.03125,0.03125,0.96875,32,650,500,150,0.7692307692307693,8,5,3,366.20800778480077,0.41284442204301075,0.05026772525849332,0.21558506197418278,131522.32552800738,3232.905762167129,134755.2312901745,247,0,148.21875,32,0,19,34.16959010339735,0.64453125,43.56060606060606,1025.757575757576,32.05492424242425,0
249,4,0,0,31,0.0,0.0,1.0,31,750,500,250,0.6666666666666666,10,5,5,377.08397997441136,0.4112455197132616,0.057420501937778035,0.2212488269983991,131394.86524793843,3709.379747178824,135104.24499511725,248,3,154.0,31,0,19,34.01966387266107,0.6458333333333333,43.684895833333336,1025.2604166666672,33.072916666666686,0
250,4,0,0,31,0.0,0.0,1.0,31,1000,800,200,0.8,12,8,4,376.16937924718457,0.4104838709677419,0.054777690868064166,0.2212909783666972,131495.00740898988,3692.8790622287374,135187.88647121863,249,4,155.0,31,0,20,33.94177669163387,0.6468413978494623,43.587239583333336,1025.6510416666672,33.085517473118294,0
251,4,0,0,31,0.0,0.0,1.0,31,950,700,250,0.7368421052631579,12,7,5,378.61102878727445,0.41057347670250893,0.05317137454878851,0.22370405763877774,131661.99578179242,3769.7367350260356,135431.73251681845,250,5,156.0,31,0,17,33.71024697623278,0.648521505376344,43.424479166666664,1026.3020833333326,33.106518817204275,0
252,4,1,1,31,0.03125,0.03125,0.96875,32,1250,800,450,0.64,17,8,9,371.2891315480363,0.41187836021505375,0.053449705232129885,0.22195566145845175,132105.7879935722,3409.8886593204907,135515.67665289267,251,0,152.09375,32,0,18,33.45001228199461,0.650390625,42.99242424242425,1028.030303030304,32.125946969697,0
253,4,0,0,31,0.0,0.0,1.0,31,1000,800,200,0.8,12,8,4,381.6468745975586,0.4078853046594982,0.06042103456308778,0.22769000613745502,132029.74319458008,3877.7477688259546,135907.49096340605,252,7,158.0,31,0,19,33.26061594661937,0.6522177419354838,43.06640625,1027.734375,33.15272177419355,0
254,4,1,1,31,0.03125,0.03125,0.96875,32,500,300,200,0.6,7,3,4,375.6722960254873,0.4098412298387097,0.058592311940115716,0.22593015057650886,132333.03880024987,3542.771305223951,135875.81010547382,253,0,154.03125,32,0,20,33.10810119851108,0.6526692708333334,42.77146464646464,1028.9141414141407,32.153566919191896,0
255,4,0,0,31,0.0,0.0,1.0,31,550,300,250,0.5454545454545454,8,3,5,385.522527956951,0.40698924731182795,0.07292985565966026,0.231021011062519,132197.07065158428,3992.989773220491,136190.06042480477,254,1,159.70967741935485,31,0,20,32.992002194648435,0.6538978494623656,42.903645833333336,1028.3854166666672,33.17372311827959,0
256,4,0,0,31,0.0,0.0,1.0,31,650,500,150,0.7692307692307693,8,5,3,385.522527956951,0.40698924731182795,0.07292985565966026,0.231021011062519,132197.07065158428,3992.989773220491,136190.06042480477,255,2,160.70967741935485,31,0,20,32.992002194648435,0.6538978494623656,42.903645833333336,1028.3854166666672,33.17372311827959,0
257,4,0,0,31,0.0,0.0,1.0,31,1050,500,550,0.47619047619047616,16,5,11,384.0416987657558,0.40627240143369175,0.07287449392712553,0.23136170632961395,132398.00347222228,3969.270833333338,136367.27430555562,256,3,161.70967741935485,31,0,21,32.82726045883941,0.6559139784946236,42.708333333333336,1029.166666666667,33.19892473118281,0
258,4,0,0,31,0.0,0.0,1.0,31,900,600,300,0.6666666666666666,12,6,6,377.45414847182644,0.4058691756272401,0.010203539352713342,0.22479174985593808,131962.84188164596,3761.9844224717835,135724.82630411774,257,4,162.70967741935485,31,0,19,33.43590271617454,0.6515456989247312,43.131510416666664,1027.4739583333328,33.14432123655912,6
259,4,2,1,32,0.06060606060606061,0.030303030303030304,0.9696969696969697,33,1000,800,200,0.8,12,8,4,391.6756768923775,0.4129971590909091,0.04539855030488393,0.22450540807702613,130495.30241224504,3731.7642211914103,134227.06663343645,258,0,153.78787878787878,31,2,17,34.55898751115076,0.636760752688172,44.563802083333336,1021.744791666667,32.95950940860216,8
260,4,0,1,31,0.0,0.03125,0.96875,32,1250,1000,250,0.8,15,10,5,400.6558852089799,0.4106602822580645,0.057008251561105894,0.22965279263950816,130495.30241224506,4056.7421807183205,134552.0445929634,259,1,159.4375,31,1,17,34.3296004842615,0.636760752688172,44.563802083333336,1021.7447916666671,32.959509408602166,0
261,4,0,0,31,0.0,0.0,1.0,31,800,600,200,0.75,10,6,4,404.2065431231037,0.40837813620071683,0.0715712958318604,0.23148938228787372,130462.04460991747,4346.72241210937,134808.76702202685,260,2,165.1290322580645,31,0,20,34.27277168833377,0.6364247311827957,44.596354166666664,1021.6145833333328,32.95530913978493,0
262,4,0,0,31,0.0,0.0,1.0,31,900,600,300,0.6666666666666666,12,6,6,404.8304666882475,0.40784050179211473,0.0689136483381898,0.2324443550136106,130561.83073255757,4371.081373426659,134932.91210598423,261,3,166.1290322580645,31,0,17,34.155226780481584,0.6374327956989246,44.49869791666667,1022.0052083333339,32.96790994623658,0
263,4,0,0,31,0.0,0.0,1.0,31,1000,800,200,0.8,12,8,4,409.622435281653,0.4075716845878136,0.06915905514399268,0.23560042046859012,130628.37600707995,4501.662699381496,135130.03870646143,262,4,167.1290322580645,31,0,17,33.96502037956948,0.6381048387096775,44.43359374999999,1022.265624999999,32.97631048387093,0
264,4,0,1,30,0.0,0.03225806451612903,0.967741935483871,31,1200,900,300,0.75,15,9,6,413.75954483840457,0.4067204301075269,0.06463929842712757,0.23921329976418998,130828.11355590806,4626.276143391914,135454.38969929997,263,5,168.1290322580645,31,0,18,33.65589601629121,0.6401209677419356,44.23828124999999,1023.0468749999989,33.00151209677416,0
265,4,0,0,30,0.0,0.0,1.0,30,750,500,250,0.6666666666666666,10,5,5,418.07394309652057,0.4057950191570881,0.056487078405606406,0.24139170766043394,130777.62783269736,4934.943707365002,135712.57154006234,264,6,167.16666666666666,30,0,18,33.59696671046868,0.6423611111111112,44.287634408602145,1022.8494623655909,34.09498207885303,0
266,4,0,0,30,0.0,0.0,1.0,30,900,600,300,0.6666666666666666,12,6,6,418.65443768752925,0.40605842911877393,0.05688696185345732,0.24194221148365858,130812.00003251818,4953.004863278986,135765.00489579717,265,7,168.16666666666666,30,0,18,33.54711382647921,0.6427083333333334,44.25403225806451,1022.9838709677416,34.099462365591386,0
267,4,0,0,30,0.0,0.0,1.0,30,900,600,300,0.6666666666666666,12,6,6,417.21694361225946,0.40543582375478926,0.0595710221054937,0.24197311695410165,130949.53399598213,4926.872868250662,135876.4068642328,266,8,169.16666666666666,30,0,18,33.44386080105056,0.6440972222222222,44.119623655913976,1023.5215053763436,34.117383512544784,0
268,4,1,2,29,0.03225806451612903,0.06451612903225806,0.935483870967742,31,650,500,150,0.7692307692307693,8,5,3,405.4907494563016,0.4098118279569893,0.05141615772431063,0.2370885734191005,131261.40170627166,4445.056830512147,135706.45853678382,267,0,164.67741935483872,31,0,19,33.427043625582385,0.644489247311828,43.815104166666664,1024.739583333333,33.05611559139784,0
269,4,1,0,30,0.03333333333333333,0.0,1.0,30,950,600,350,0.631578947368421,13,6,7,407.2230973345626,0.40632183908045977,0.0599783373950713,0.23985245589418472,131541.7534722221,4713.385009765606,136255.1384819877,268,0,163.86666666666667,29,1,21,33.09809098294069,0.6530172413793104,43.54166666666666,1025.8333333333323,35.37356321839077,0
270,4,0,0,30,0.0,0.0,1.0,30,800,600,200,0.75,10,6,4,407.92276236410976,0.4056273946360153,0.06218703478143195,0.24093855244671486,131648.63281249977,4740.494791666638,136389.1276041664,269,1,164.86666666666667,29,1,16,32.97173162809582,0.6540948275862071,43.437499999999986,1026.2499999999982,35.3879310344827,0
271,4,0,0,30,0.0,0.0,1.0,30,750,600,150,0.8,9,6,3,408.0022434376221,0.40557950191570885,0.06212510711225394,0.24143671587249507,131719.90981867278,4748.403742283941,136468.3135609567,270,2,165.86666666666667,29,1,17,32.8974146484463,0.6548132183908046,43.36805555555555,1026.5277777777771,35.39750957854404,0
272,4,0,0,30,0.0,0.0,1.0,30,500,400,100,0.8,6,4,2,408.3655343214855,0.4049090038314176,0.062063212949186264,0.2421047630504201,131791.20611496895,4763.797260802448,136555.0033757714,271,3,166.86666666666667,29,1,17,32.81581112764327,0.6555316091954024,43.2986111111111,1026.805555555554,35.407088122605316,0
273,4,0,0,30,0.0,0.0,1.0,30,600,300,300,0.5,9,3,6,407.14667705024317,0.40478927203065135,0.07110587824873527,0.24238545166449016,131948.81633714857,4744.504422476551,136693.32075962512,272,4,167.86666666666667,30,0,18,32.687401883830454,0.6541666666666668,43.14516129032256,1027.4193548387077,34.24731182795692,0
274,4,0,0,30,0.0,0.0,1.0,30,700,600,100,0.8571428571428571,8,6,2,405.4289468118782,0.404382183908046,0.06580794211237517,0.24202304108278147,132052.40716050976,4707.573671811748,136759.9808323215,273,5,168.86666666666667,30,0,19,32.62662917919881,0.6552083333333334,43.044354838709666,1027.82258064516,34.260752688172005,0
275,4,0,0,30,0.0,0.0,1.0,30,800,400,400,0.5,12,4,8,407.55640992780576,0.40392720306513413,0.07050980392156836,0.24395982284410878,132156.0386316335,4772.208130997778,136928.2467626313,274,6,169.86666666666667,30,0,19,32.46704793028323,0.6562500000000002,42.94354838709676,1028.2258064516113,34.274193548387046,0
276,4,0,0,30,0.0,0.0,1.0,30,550,400,150,0.7272727272727273,7,4,3,408.35237387888907,0.4034243295019157,0.074417287500544,0.24465967208671704,132190.5914881777,4796.068367730352,136986.65985590807,275,7,170.86666666666667,30,0,19,32.41161286106391,0.6565972222222223,42.90994623655913,1028.3602150537624,34.27867383512542,0
277,4,0,0,30,0.0,0.0,1.0,30,1100,700,400,0.6363636363636364,15,7,8,411.50615439881454,0.4032088122605364,0.06991466388018108,0.24768011934570172,132363.4235171696,4893.67267892242,137257.09619609202,276,8,171.86666666666667,30,0,20,32.15560780215953,0.6583333333333334,42.74193548387097,1029.032258064516,34.3010752688172,0
278,4,0,0,30,0.0,0.0,1.0,30,800,700,100,0.875,9,7,2,411.39369236265094,0.402705938697318,0.06883373797320402,0.2487824498512799,132540.9818672838,4905.309300368682,137446.29116765247,277,9,172.86666666666667,29,1,20,31.978913766747603,0.6630747126436782,42.569444444444436,1029.722222222221,35.507662835249,0
279,4,0,0,30,0.0,0.0,1.0,30,550,400,150,0.7272727272727273,7,4,3,414.59307985444406,0.40277777777777773,0.07028545740615844,0.25095572956087353,132576.73852237643,4993.079668209861,137569.8181905863,278,10,173.86666666666667,29,1,20,31.86038997527534,0.6634339080459771,42.534722222222214,1029.8611111111102,35.512452107279664,0
280,4,0,0,30,0.0,0.0,1.0,30,500,200,300,0.4,8,2,6,414.59307985444406,0.40277777777777773,0.07028545740615844,0.25095572956087353,132576.73852237643,4993.079668209861,137569.8181905863,279,11,174.86666666666667,29,1,20,31.86038997527534,0.6634339080459771,42.534722222222214,1029.8611111111102,35.512452107279664,0
281,4,0,0,30,0.0,0.0,1.0,30,1250,1000,250,0.8,15,10,5,415.5397551328107,0.40229885057471265,0.07467547051161127,0.2529713308318775,132791.3797260802,5036.0194830246855,137827.3992091049,280,12,175.86666666666667,29,1,18,31.619025962359068,0.6655890804597702,42.326388888888886,1030.6944444444441,35.54118773946359,0
282,4,1,1,30,0.03225806451612903,0.03225806451612903,0.967741935483871,31,1000,800,200,0.8,12,8,4,408.45817581384165,0.4040770609318996,0.06898579704178576,0.2511249265071648,133159.90513715448,4678.050388773252,137837.95552592774,281,0,171.16129032258064,30,1,18,31.429602378781958,0.6663194444444445,41.96908602150537,1032.1236559139775,34.40412186379925,0
283,4,0,0,30,0.0,0.0,1.0,30,1000,700,300,0.7,13,7,6,415.62836395867134,0.4000718390804598,0.08493335070122865,0.2550582693933428,133090.55102107176,5063.241595849221,138153.79261692098,282,14,177.86666666666667,30,0,18,31.31458686118709,0.6656250000000001,42.03629032258064,1031.854838709677,34.39516129032257,0
284,4,0,0,30,0.0,0.0,1.0,30,850,700,150,0.8235294117647058,10,7,3,414.47245279947913,0.3996168582375479,0.08691840277777785,0.25505997095352567,133194.58896982312,5041.097597988211,138235.68656781132,283,15,178.86666666666667,30,0,18,31.23942057291667,0.6666666666666666,41.935483870967744,1032.2580645161293,34.40860215053764,0
285,4,0,0,30,0.0,0.0,1.0,30,750,400,350,0.5333333333333333,11,4,7,416.67207790146233,0.3992097701149426,0.09264367816091945,0.25761262418927894,133368.07587943683,5114.150660480961,138482.22653991778,284,16,179.86666666666667,30,0,19,31.0076447625244,0.6684027777777779,41.76747311827956,1032.9301075268809,34.431003584229366,0
286,4,0,0,30,0.0,0.0,1.0,30,1100,800,300,0.7272727272727273,14,8,6,415.21619493227576,0.3988745210727969,0.09311024503874932,0.25768337835621863,133508.10426311716,5086.986056713346,138595.09031983052,285,17,180.86666666666667,29,1,21,30.904084352461584,0.6727729885057472,41.631944444444436,1033.4722222222213,35.636973180076595,0
287,4,0,0,30,0.0,0.0,1.0,30,900,700,200,0.7777777777777778,11,7,4,413.1015093385284,0.3980603448275862,0.09762616417587178,0.2578115259010523,133715.38843002074,5047.605756445828,138762.99418646656,286,18,181.86666666666667,30,0,17,30.749945852285038,0.671875,41.431451612903224,1034.2741935483866,34.47580645161289,0
288,4,0,0,30,0.0,0.0,1.0,30,600,300,300,0.5,9,3,6,412.0651661678271,0.39825191570881224,0.09921181412671598,0.25764951941460307,133784.90513715448,5025.619833217704,138810.52497037218,287,19,182.86666666666667,30,0,17,30.706768870988704,0.6725694444444446,41.36424731182795,1034.5430107526875,34.48476702508958,0
289,4,0,0,30,0.0,0.0,1.0,30,1000,800,200,0.8,12,8,4,413.4309790772681,0.3975814176245211,0.09835519196641118,0.2594810081396936,133923.992748439,5073.665488784811,138997.6582372238,288,20,183.86666666666667,30,0,19,30.531478595853347,0.6739583333333334,41.22983870967741,1035.0806451612893,34.50268817204298,0
290,4,0,0,30,0.0,0.0,1.0,30,500,300,200,0.6,7,3,4,414.95998604469366,0.39760536398467433,0.10223318618540622,0.2606869341367233,133958.77594230536,5117.506359116644,139076.282301422,289,21,184.86666666666667,30,0,19,30.456915952566437,0.6743055555555557,41.19623655913978,1035.21505376344,34.50716845878133,0
291,4,1,0,31,0.03225806451612903,0.0,1.0,31,1000,600,400,0.6,14,6,8,405.03485532821554,0.39910394265232974,0.09822390320150953,0.258120612603565,134483.24415418826,4694.080268012132,139177.32442220039,290,0,179.8709677419355,31,0,21,30.187149552263772,0.676747311827957,40.69010416666666,1037.2395833333323,33.45934139784943,0
292,4,0,0,31,0.0,0.0,1.0,31,800,500,300,0.625,11,5,6,409.0746782276962,0.39874551971326166,0.10300821993506926,0.2616957188114164,134622.83950617275,4814.192859037411,139437.03236521015,291,1,180.8709677419355,29,2,21,29.942340292648097,0.6839080459770115,40.55555555555555,1037.7777777777771,35.7854406130268,0
293,4,0,0,31,0.0,0.0,1.0,31,900,900,0,1.0,9,9,0,410.1117437165131,0.3982974910394265,0.09947135613334757,0.26314036774943644,134730.96305941357,4850.95003858024,139581.91309799382,292,2,181.8709677419355,29,2,21,29.806995540691176,0.6849856321839081,40.451388888888886,1038.1944444444443,35.79980842911877,0
294,4,0,0,31,0.0,0.0,1.0,31,700,500,200,0.7142857142857143,9,5,4,411.1759679440652,0.3977598566308244,0.09288700401661876,0.2643476106894046,134803.0695408951,4885.556520061739,139688.62606095686,293,3,182.8709677419355,29,2,19,29.707073915563303,0.6857040229885057,40.38194444444445,1038.4722222222226,35.80938697318009,0
295,4,0,0,31,0.0,0.0,1.0,31,500,200,300,0.4,8,2,6,408.9766629354008,0.39690860215053764,0.0919995341795734,0.26345705961187443,134875.19531250003,4832.161458333333,139707.35677083337,294,4,183.8709677419355,29,2,19,29.69188728439631,0.6864224137931034,40.3125,1038.7500000000002,35.81896551724139,0
296,4,0,0,31,0.0,0.0,1.0,31,900,700,200,0.7777777777777778,11,7,4,407.86124853441623,0.3967741935483871,0.09297912713472489,0.26300018439977885,134911.26543209885,4805.015432098781,139716.28086419764,295,5,184.8709677419355,29,2,19,29.68471479500891,0.6867816091954022,40.277777777777786,1038.8888888888896,35.82375478927206,0
297,4,0,0,31,0.0,0.0,1.0,31,750,500,250,0.6666666666666666,10,5,5,405.1174262083425,0.39623655913978495,0.09258656789876318,0.2624102323530419,135074.22281477618,4744.184298762855,139818.40711353903,296,6,185.8709677419355,30,1,19,29.5928152745453,0.6854166666666667,40.12096774193548,1039.5161290322574,34.65053763440858,0
298,4,0,0,31,0.0,0.0,1.0,31,500,300,200,0.6,7,3,4,405.1174262083425,0.39623655913978495,0.09258656789876318,0.2624102323530419,135074.22281477618,4744.184298762855,139818.40711353903,297,7,186.8709677419355,30,1,19,29.5928152745453,0.6854166666666667,40.12096774193548,1039.5161290322574,34.65053763440858,0
299,4,0,0,31,0.0,0.0,1.0,31,950,900,50,0.9473684210526315,10,9,1,408.53080529113845,0.3960573476702509,0.09385074128907167,0.2648772656267356,135109.15505043932,4839.25038299225,139948.40543343156,298,8,187.8709677419355,30,1,19,29.469133807369108,0.685763888888889,40.08736559139785,1039.6505376344082,34.65501792114694,0
300,4,0,0,31,0.0,0.0,1.0,31,700,500,200,0.7142857142857143,9,5,4,403.6094608107962,0.3948028673835125,0.08859503580987016,0.26244789981125555,135213.97885593705,4714.728220025432,139928.70707596248,299,9,188.8709677419355,30,1,19,29.492170672869822,0.6868055555555556,39.986559139784944,1040.05376344086,34.668458781362,0
301,4,0,0,31,0.0,0.0,1.0,31,850,600,250,0.7058823529411765,11,6,5,403.6094608107962,0.3948028673835125,0.08859503580987016,0.26244789981125555,135213.97885593705,4714.728220025432,139928.70707596248,300,10,189.8709677419355,30,1,19,29.492170672869822,0.6868055555555556,39.986559139784944,1040.05376344086,34.668458781362,0
302,4,0,0,31,0.0,0.0,1.0,31,1150,800,350,0.6956521739130435,15,8,7,409.50481167682295,0.3942204301075269,0.09574490250905332,0.2670578557026357,135318.84330919755,4882.743489131685,140201.58679832923,301,11,190.8709677419355,30,1,19,29.23394910218318,0.6878472222222223,39.88575268817204,1040.4569892473114,34.68189964157705,0
303,4,0,0,31,0.0,0.0,1.0,31,1050,700,350,0.6666666666666666,14,7,7,410.151643043959,0.39381720430107525,0.09605808783119918,0.2693097398563215,135563.68510810498,4920.333636836626,140484.0187449416,302,12,191.8709677419355,30,1,21,28.972261658922736,0.6902777777777778,39.6505376344086,1041.3978494623655,34.713261648745515,0
304,4,0,1,30,0.0,0.03225806451612903,0.967741935483871,31,900,600,300,0.6666666666666666,12,6,6,411.16141670422485,0.3934587813620072,0.09473855107214657,0.27023662578804386,135598.6805736212,4950.58912157475,140549.26969519595,303,13,192.8709677419355,30,1,21,28.910988514647055,0.690625,39.61693548387097,1041.532258064516,34.71774193548387,0
305,4,0,0,30,0.0,0.0,1.0,30,850,700,150,0.8235294117647058,10,7,3,419.64604969638924,0.39171455938697314,0.08743497398959588,0.2752481570055844,135525.1953125,5374.522569444446,140899.71788194444,304,14,191.1,29,1,22,28.763588768840876,0.6928879310344827,39.6875,1041.25,35.9051724137931,0
306,4,0,1,29,0.0,0.03333333333333333,0.9666666666666667,30,650,400,250,0.6153846153846154,9,4,5,418.0142000701386,0.3916906130268199,0.0835333866808925,0.2744545071914099,135561.35223765444,5333.3140432098935,140894.66628086433,305,15,192.1,29,1,22,28.7698941940073,0.6932471264367815,39.652777777777786,1041.3888888888898,35.90996168582379,0
307,4,0,0,29,0.0,0.0,1.0,29,1200,900,300,0.75,15,9,6,429.2201757936551,0.3878284072249589,0.08719566597069539,0.28181198582318984,135561.35223765444,5837.133487654339,141398.48572530877,306,16,194.17241379310346,29,0,22,28.478149728816575,0.6932471264367815,39.652777777777786,1041.3888888888898,35.90996168582379,0
308,4,0,0,29,0.0,0.0,1.0,29,600,300,300,0.5,9,3,6,430.72000000000025,0.3874178981937602,0.08772413793103451,0.28336842105263155,135633.68055555547,5884.047067901225,141517.7276234567,307,17,195.17241379310346,28,1,22,28.366666666666667,0.6971726190476191,39.58333333333333,1041.666666666666,37.20238095238093,0
309,4,0,0,29,0.0,0.0,1.0,29,850,600,250,0.7058823529411765,11,6,5,432.1150840391638,0.3869047619047619,0.08018560690701126,0.2851802278922706,135745.9523426145,5931.574720901028,141677.52706351553,308,18,196.17241379310346,28,1,22,28.217921319913597,0.6982886904761905,39.47557471264367,1042.0977011494244,37.21777504105087,0
310,4,0,0,29,0.0,0.0,1.0,29,700,500,200,0.7142857142857143,9,5,4,432.87640888964296,0.3864429392446634,0.07684701900497237,0.2859822832500428,135783.38659334127,5955.484955079934,141738.87154842122,309,19,197.17241379310346,28,1,22,28.160612535612533,0.6986607142857144,39.439655172413794,1042.2413793103449,37.22290640394089,0
311,4,0,0,29,0.0,0.0,1.0,29,650,500,150,0.7692307692307693,8,5,3,428.2361480919181,0.38608374384236455,0.07552578626753736,0.2834515456417935,135850.78125,5835.243055555557,141686.02430555556,310,20,198.17241379310346,29,0,22,28.214095390354384,0.6961206896551724,39.375,1042.5,35.94827586206897,0
312,4,0,0,29,0.0,0.0,1.0,29,600,500,100,0.8333333333333334,7,5,2,426.044575716643,0.3857245484400657,0.07219884996233916,0.2825744412085294,135923.186728395,5781.867283950607,141705.05401234562,311,21,199.17241379310346,29,0,18,28.19881015805363,0.6968390804597702,39.30555555555555,1042.7777777777771,35.957854406130245,0
313,4,0,0,29,0.0,0.0,1.0,29,750,500,250,0.6666666666666666,10,5,5,424.40721044412004,0.3851600985221675,0.06114354963093538,0.28263714227448844,136068.05555555553,5749.652777777774,141817.7083333333,312,22,200.17241379310346,29,0,20,28.096711927582525,0.6982758620689655,39.166666666666664,1043.3333333333333,35.97701149425287,0
314,4,0,0,29,0.0,0.0,1.0,29,850,600,250,0.7058823529411765,11,6,5,423.2347610533045,0.38469827586206895,0.0657906810298945,0.28301000570076823,136213.0015432098,5730.015432098753,141943.01697530856,313,23,201.17241379310346,29,0,21,27.982526166400564,0.6997126436781609,39.02777777777777,1043.8888888888882,35.996168582375454,0
315,4,0,0,29,0.0,0.0,1.0,29,800,500,300,0.625,11,5,6,424.1172476233588,0.3833641215106733,0.07235876742479785,0.2847644376899697,136358.0246913581,5766.358024691366,142124.38271604947,314,24,202.17241379310346,29,0,21,27.81471631205674,0.7011494252873562,38.88888888888889,1044.444444444445,36.01532567049811,0
316,4,0,0,29,0.0,0.0,1.0,29,650,500,150,0.7692307692307693,8,5,3,421.95930353438354,0.38254310344827586,0.0704047816580875,0.2841897798110265,136466.8426890431,5716.690779320971,142183.53346836407,315,25,203.17241379310346,29,0,21,27.76250055385706,0.7022270114942528,38.784722222222214,1044.8611111111102,36.029693486590006,0
317,4,0,0,29,0.0,0.0,1.0,29,950,700,250,0.7368421052631579,12,7,5,421.6129058911657,0.3819273399014778,0.0626792636102893,0.28483471541623995,136575.70408950618,5716.415895061732,142292.11998456792,316,26,204.17241379310346,29,0,22,27.66299052174683,0.7033045977011494,38.68055555555556,1045.2777777777778,36.044061302681996,0
318,4,0,0,29,0.0,0.0,1.0,29,700,600,100,0.8571428571428571,8,6,2,422.49212574860445,0.381876026272578,0.061013595221517836,0.28601805059671714,136648.30246913584,5746.566358024697,142394.86882716054,317,27,205.17241379310346,29,0,22,27.56763637973787,0.7040229885057472,38.611111111111114,1045.5555555555559,36.05363984674331,0
319,4,0,0,29,0.0,0.0,1.0,29,800,600,200,0.75,10,6,4,427.82525505854665,0.3805931855500821,0.06591686235735161,0.2911298686861819,136829.88281250012,5907.855902777792,142737.7387152779,318,28,206.17241379310346,29,0,22,27.247195672374875,0.7058189655172413,38.43750000000001,1046.250000000001,36.077586206896584,0
320,4,0,0,29,0.0,0.0,1.0,29,400,400,0,1.0,4,4,0,428.90630802331333,0.3790024630541872,0.06478384795926306,0.2930794962440357,136975.23389274697,5949.908371913587,142925.14226466056,319,29,207.17241379310346,29,0,20,27.07407345982044,0.7072557471264368,38.298611111111114,1046.8055555555559,36.09674329501917,0
321,4,0,0,29,0.0,0.0,1.0,29,750,600,150,0.8,9,6,3,430.02004665703305,0.3786432676518883,0.06697102496774954,0.2941461988839126,137011.58371913587,5983.545524691368,142995.12924382725,320,30,208.17241379310346,29,0,20,27.00871141770584,0.7076149425287357,38.26388888888889,1046.944444444445,36.10153256704983,0
322,4,0,0,29,0.0,0.0,1.0,29,750,600,150,0.8,9,6,3,424.55012471132227,0.37792487684729065,0.0655638767728306,0.29161721680990826,137157.03125,5846.006944444443,143003.03819444444,321,31,209.17241379310346,29,0,20,27.007093609122244,0.709051724137931,38.125,1047.5,36.12068965517241,0
323,4,0,0,29,0.0,0.0,1.0,29,850,600,250,0.7058823529411765,11,6,5,426.11132410309517,0.3767959770114942,0.06910262562555691,0.29360821373131085,137266.16753472228,5898.13368055556,143164.30121527784,322,32,210.17241379310346,29,0,20,26.857604373757457,0.7101293103448276,38.020833333333336,1047.916666666667,36.135057471264375,0
324,4,0,0,29,0.0,0.0,1.0,29,900,600,300,0.6666666666666666,12,6,6,420.9823501163001,0.37618021346469627,0.0742733680186003,0.29129200376058223,137411.7500964507,5769.584297839518,143181.33439429023,323,33,211.17241379310346,29,0,20,26.847236940875177,0.711566091954023,37.88194444444445,1048.4722222222229,36.15421455938699,0
325,4,0,0,29,0.0,0.0,1.0,29,600,400,200,0.6666666666666666,8,4,4,421.67137126656735,0.37592364532019706,0.07069171016398812,0.29238204999392553,137484.5703125,5794.661458333334,143279.23177083334,324,34,212.17241379310346,29,0,20,26.75680373460468,0.7122844827586208,37.8125,1048.75,36.16379310344828,0
326,4,0,0,29,0.0,0.0,1.0,29,900,600,300,0.6666666666666666,12,6,6,420.70919587704714,0.3744355500821018,0.07448823569684371,0.29294543547014656,137630.2686149691,5780.463927469129,143410.73254243823,325,35,213.17241379310346,29,0,20,26.6372986984337,0.7137212643678161,37.67361111111111,1049.3055555555552,36.18295019157087,0
327,4,0,0,29,0.0,0.0,1.0,29,900,700,200,0.7777777777777778,11,7,4,430.2154335388186,0.37423029556650245,0.060860063349793325,0.2771387792796575,134875.19531249997,5805.078125000002,140680.27343749997,326,36,214.17241379310346,29,0,18,29.140342960288812,0.6864224137931034,40.3125,1038.7499999999998,35.818965517241374,7
328,4,0,0,29,0.0,0.0,1.0,29,950,700,250,0.7368421052631579,12,7,5,426.75470006778727,0.3733579638752052,0.05999004773401628,0.2762830601476922,135055.59413580253,5727.121913580255,140782.71604938278,327,37,215.17241379310346,29,0,18,29.04919383573846,0.6882183908045977,40.13888888888889,1039.444444444445,35.842911877394656,0
329,4,0,0,29,0.0,0.0,1.0,29,800,400,400,0.5,12,4,8,426.8657555592147,0.3731527093596059,0.05749429894271296,0.2766311844468157,135091.6883680555,5733.2031249999945,140824.8914930555,328,38,216.17241379310346,29,0,18,29.010103540414157,0.6885775862068966,40.104166666666664,1039.583333333333,35.847701149425276,0
330,4,0,0,29,0.0,0.0,1.0,29,1100,1100,0,1.0,11,11,0,424.48556349905914,0.37258825944170776,0.05057041400496476,0.2756394981715054,135163.89130015433,5675.02411265432,140838.91541280865,329,39,217.17241379310346,29,0,18,28.999571479453273,0.6892959770114941,40.03472222222222,1039.861111111111,35.85727969348659,0
331,4,0,1,28,0.0,0.034482758620689655,0.9655172413793104,29,800,700,100,0.875,9,7,2,422.8422044913399,0.3715106732348112,0.043080435222858204,0.2759524212586341,135344.4830246914,5645.871913580254,140990.35493827166,330,40,218.17241379310346,29,0,19,28.86134098594057,0.6910919540229885,39.861111111111114,1040.5555555555559,35.88122605363986,0
332,4,0,0,28,0.0,0.0,1.0,28,850,600,250,0.7058823529411765,11,6,5,434.3311918387455,0.36990189594356265,0.03877311388707949,0.28249088029835395,135222.41472205712,6146.262509908844,141368.67723196596,331,41,216.03571428571428,28,0,19,28.68490122945158,0.6930803571428572,39.97844827586207,1040.086206896552,37.145935960591146,0
333,4,0,0,28,0.0,0.0,1.0,28,950,700,250,0.7368421052631579,12,7,5,436.16750592065944,0.36924052028218696,0.04419772328210381,0.28427442937637226,135297.14388046644,6202.4435609063385,141499.58744137277,332,42,217.03571428571428,28,0,19,28.56218063803341,0.6938244047619048,39.906609195402304,1040.3735632183914,37.15619868637112,0
334,4,0,0,28,0.0,0.0,1.0,28,900,700,200,0.7777777777777778,11,7,4,435.3064635680899,0.36954365079365076,0.04661000236649038,0.28459927997177303,135409.27632448156,6188.906642224883,141598.18296670643,333,43,218.03571428571428,28,0,21,28.472126357445244,0.694940476190476,39.79885057471265,1040.8045977011504,37.171592775041084,0
335,4,0,0,28,0.0,0.0,1.0,28,650,400,250,0.6153846153846154,9,4,5,437.9863248334678,0.3697641093474427,0.05031347344347603,0.2869483643529212,135484.05709142558,6268.0328478002475,141752.0899392258,334,44,219.03571428571428,28,0,21,28.32741052534732,0.6956845238095237,39.72701149425288,1041.0919540229888,37.18185550082103,0
336,4,0,0,28,0.0,0.0,1.0,28,850,300,550,0.35294117647058826,14,3,11,440.22033821227575,0.36962632275132273,0.02776242212914326,0.2798335338172453,134390.7208552432,6252.226611935193,140642.9474671784,335,45,220.03571428571428,26,2,20,29.367899489011265,0.6919070512820512,40.77932098765433,1036.8827160493836,39.88010446343783,4
337,4,0,0,28,0.0,0.0,1.0,28,850,800,50,0.9411764705882353,9,8,1,441.51387117346934,0.3697089947089947,0.027742346938774975,0.28096337256493503,134430.72702331963,6270.6061385459525,140701.3331618656,336,46,221.03571428571428,26,2,20,29.294084821428573,0.6923076923076923,40.74074074074074,1037.0370370370372,39.88603988603989,0
338,4,0,1,27,0.0,0.03571428571428571,0.9642857142857143,28,750,600,150,0.8,9,6,3,444.87612688032704,0.3697089947089947,0.028117628243572668,0.2636057050320745,131770.30692627825,6124.292756638925,137894.59968291718,337,47,222.03571428571428,28,0,20,31.89983907080884,0.6584821428571428,43.31896551724138,1026.7241379310346,36.66871921182267,5
339,4,0,0,27,0.0,0.0,1.0,27,450,200,250,0.4444444444444444,7,2,5,450.898613697618,0.3682336182336183,0.02345285267871544,0.26674945431270763,131709.72620819169,6477.546591553302,138187.272799745,338,48,222.11111111111111,27,0,21,31.80692471247705,0.6612654320987654,43.3779761904762,1026.4880952380959,38.01807760141096,0
340,4,0,0,27,0.0,0.0,1.0,27,600,500,100,0.8333333333333334,7,5,2,452.1571098508715,0.3676400759734093,0.028856682769726083,0.26803127645799085,131786.11288265302,6517.6055839002165,138303.71846655323,339,49,223.11111111111111,27,0,21,31.696859903381625,0.662037037037037,43.30357142857142,1026.785714285714,38.02910052910052,0
341,4,1,1,27,0.03571428571428571,0.03571428571428571,0.9642857142857143,28,500,400,100,0.8,6,4,2,439.0707013014441,0.37340167548500885,0.02228898826159842,0.262708188838891,132139.3595587265,6003.704254194758,138143.06381292123,340,0,216.10714285714286,28,0,21,31.673886715110868,0.6622023809523809,42.959770114942536,1028.160919540231,36.72003284072253,0
342,4,0,0,27,0.0,0.0,1.0,27,850,600,250,0.7058823529411765,11,6,5,447.74104018473554,0.3681149097815764,0.037240831912132455,0.26702069287701063,132015.40577168364,6421.743020124709,138437.14879180834,341,51,225.11111111111111,27,0,21,31.577010329182357,0.6643518518518519,43.08035714285714,1027.678571428571,38.0621693121693,0
343,4,0,0,27,0.0,0.0,1.0,27,650,300,350,0.46153846153846156,10,3,7,448.4751028405762,0.36882716049382713,0.03572883827660944,0.26799878982895303,132091.88102324252,6447.983985260754,138539.86500850326,342,52,226.11111111111111,27,0,21,31.48040918741557,0.6651234567901234,43.00595238095237,1027.9761904761895,38.07319223985887,0
344,4,0,0,27,0.0,0.0,1.0,27,500,200,300,0.4,8,2,6,449.48804245613996,0.3684710351377018,0.04202176126922885,0.26914751935631925,132168.3784190759,6481.621138038538,138649.99955711444,343,53,227.11111111111111,27,0,21,31.37662807525326,0.6658950617283951,42.93154761904761,1028.2738095238087,38.08421516754847,0
345,4,0,2,25,0.0,0.07407407407407407,0.9259259259259259,27,800,700,100,0.875,9,7,2,448.1537744341565,0.36752136752136755,0.04441015089163258,0.2688922646604938,132244.89795918364,6453.2100340136,138698.10799319725,344,54,228.11111111111111,27,0,21,31.33318865740741,0.6666666666666666,42.857142857142854,1028.5714285714282,38.09523809523808,0
346,4,0,0,25,0.0,0.0,1.0,25,650,300,350,0.46153846153846156,10,3,7,458.17035085875233,0.3603472222222222,0.07258451472191929,0.27511650908908597,132274.33444793714,7120.835644723853,139395.170092661,345,55,233.28,25,0,21,31.04569117723425,0.6745833333333333,42.828525641025635,1028.6858974358968,41.14743589743587,0
347,4,0,0,25,0.0,0.0,1.0,25,600,500,100,0.8333333333333334,7,5,2,460.6902098210146,0.3603472222222222,0.07164552998277762,0.267250533163199,130958.79368528118,7066.28682815584,138025.08051343702,346,56,234.28,25,0,20,32.322001722248324,0.6612499999999999,44.110576923076934,1023.5576923076933,40.94230769230773,2
348,4,1,0,26,0.038461538461538464,0.0,1.0,26,800,500,300,0.625,11,5,6,446.8710937499999,0.3680128205128205,0.0737740384615384,0.26286534926470606,131492.439184747,6552.55408653848,138044.99327128546,347,0,226.23076923076923,25,1,21,32.131510416666664,0.6666666666666665,43.5897435897436,1025.6410256410265,41.025641025641065,0
349,4,0,0,26,0.0,0.0,1.0,26,600,500,100,0.8333333333333334,7,5,2,448.0047629645821,0.36759615384615385,0.07345607056589709,0.2638158682370096,131533.5337822569,6585.529924802795,138119.06370705971,348,1,227.23076923076923,25,1,21,32.06058298182577,0.6670833333333333,43.5496794871795,1025.8012820512836,41.03205128205134,0
350,4,1,0,27,0.037037037037037035,0.0,1.0,27,900,600,300,0.6666666666666666,12,6,6,433.00739818383227,0.3723884140550808,0.07756540689593838,0.2589493076032935,132120.2108100899,6041.805746075287,138162.01655616518,349,0,219.77777777777777,26,1,21,31.849169418593004,0.6690705128205128,42.97839506172839,1028.0864197530861,39.5417853751187,0
351,4,1,0,28,0.03571428571428571,0.0,1.0,28,500,300,200,0.6,7,3,4,421.00505130694785,0.3767361111111111,0.06230772407242968,0.254404711789762,132512.89073572148,5557.719272604888,138070.61000832636,350,0,212.89285714285714,27,1,22,31.75991834080068,0.6693672839506173,42.5967261904762,1029.613095238096,38.133818342151706,0
352,4,0,0,28,0.0,0.0,1.0,28,1000,800,200,0.8,12,8,4,419.17946297376784,0.37590939153439157,0.06200726462211592,0.25407707904592136,132627.8278238379,5518.972328514747,138146.80015235263,351,1,213.89285714285714,27,1,19,31.69062409708177,0.6705246913580246,42.48511904761905,1030.059523809524,38.15035273368608,0
353,4,0,1,27,0.0,0.03571428571428571,0.9642857142857143,28,950,600,350,0.631578947368421,13,6,7,419.195740224471,0.3761298500881834,0.05852687595396233,0.2551273898765105,132781.1547796203,5532.258893140611,138313.41367276091,352,2,214.89285714285714,27,1,19,31.535157377995965,0.6720679012345678,42.33630952380953,1030.6547619047628,38.17239858906529,0
354,4,0,0,27,0.0,0.0,1.0,27,650,300,350,0.46153846153846156,10,3,7,432.24643353112003,0.3710826210826211,0.07164377861007076,0.26205676147322665,132636.34366426614,6066.3173010974015,138702.66096536355,353,4,223.77777777777777,26,1,19,31.34550561797753,0.674278846153846,42.476851851851855,1030.0925925925928,39.61894586894588,0
355,4,0,0,27,0.0,0.0,1.0,27,750,500,250,0.6666666666666666,10,5,5,430.61297142566536,0.3706671415004748,0.06758510532095441,0.26189739737528167,132755.59413580244,6033.2561728394985,138788.85030864194,354,5,224.77777777777777,26,1,19,31.266846361185987,0.6754807692307692,42.36111111111111,1030.5555555555552,39.63675213675212,0
356,4,1,1,27,0.03571428571428571,0.03571428571428571,0.9642857142857143,28,700,500,200,0.7142857142857143,9,5,4,417.12782475125243,0.3802358906525573,0.053022810162576484,0.25569825013266423,133049.69009088006,5499.7455622874095,138549.43565316746,355,0,217.71428571428572,27,1,19,31.317160680801962,0.6747685185185185,42.075892857142854,1031.6964285714282,38.21097883597882,0
357,4,0,0,27,0.0,0.0,1.0,27,400,100,300,0.25,7,1,6,430.1529369349141,0.3703703703703704,0.06623302446030421,0.2618953022596438,132795.35620046488,6024.462496189608,138819.8186966545,356,7,226.77777777777777,26,1,19,31.23845885112542,0.6758814102564102,42.32253086419753,1030.70987654321,39.64268755935423,0
358,4,1,1,27,0.03571428571428571,0.03571428571428571,0.9642857142857143,28,700,500,200,0.7142857142857143,9,5,4,418.64831450083267,0.3739803791887126,0.04465573365198394,0.2568944613052013,133088.0744224774,5543.419607426316,138631.49402990373,357,0,219.64285714285714,27,1,20,31.23918373233342,0.6751543209876543,42.03869047619048,1031.8452380952388,38.216490299823654,0
359,4,0,0,27,0.0,0.0,1.0,27,650,400,250,0.6153846153846154,9,4,5,430.47511301933935,0.370014245014245,0.06262434812487205,0.2632081592230782,132954.46399653255,6046.717583066604,139001.18157959916,358,9,228.77777777777777,26,1,21,31.069192977205844,0.6774839743589742,42.16820987654321,1031.327160493827,39.66642924976258,0
360,4,0,0,27,0.0,0.0,1.0,27,900,700,200,0.7777777777777778,11,7,4,430.47511301933935,0.370014245014245,0.06262434812487205,0.2632081592230782,132954.46399653255,6046.717583066604,139001.18157959916,359,10,229.77777777777777,26,1,21,31.069192977205844,0.6774839743589742,42.16820987654321,1031.327160493827,39.66642924976258,0
361,4,0,0,27,0.0,0.0,1.0,27,800,700,100,0.875,9,7,2,435.53700533914275,0.370014245014245,0.074237438446638,0.24252534297305958,129364.36760355037,5878.119839620718,135242.4874431711,360,11,230.77777777777777,25,2,23,34.596198277672755,0.645,45.67307692307693,1017.307692307693,40.692307692307715,8
362,4,0,0,27,0.0,0.0,1.0,27,550,400,150,0.7272727272727273,7,4,3,436.3844415902722,0.37031101614434947,0.07283736721443423,0.2432488867126109,129405.12833353879,5894.0769333497665,135299.20526688854,361,12,231.77777777777777,25,2,23,34.532833254580765,0.6454166666666667,45.63301282051282,1017.4679487179486,40.69871794871794,0
363,4,2,0,29,0.06896551724137931,0.0,1.0,29,250,200,50,0.8,3,2,1,407.37341871253153,0.3839798850574712,0.0660282460869912,0.23120464889843642,130110.72137188191,4800.729875283418,134911.45124716533,362,0,216.72413793103448,27,2,22,34.55002917152859,0.6450617283950617,44.940476190476176,1020.2380952380938,37.7865961199294,0
364,4,1,0,30,0.03333333333333333,0.0,1.0,30,700,200,500,0.2857142857142857,12,2,10,392.64891241436413,0.38678160919540233,0.06282704723071686,0.22525648133245108,130528.56445312503,4250.468351403062,134779.03280452808,363,0,210.46666666666667,27,3,21,34.50029731566428,0.6493055555555556,44.53125,1021.8750000000002,37.84722222222223,0
365,4,0,0,30,0.0,0.0,1.0,30,850,700,150,0.8235294117647058,10,7,3,392.1191686941308,0.3868534482758621,0.05864943336143158,0.22618348806846209,130739.70512947536,4253.108898137126,134992.81402761248,364,1,211.46666666666667,28,2,22,34.299194530298784,0.6480654761904763,44.324712643678154,1022.7011494252863,36.525041050903084,0
366,4,1,2,29,0.03225806451612903,0.06451612903225806,0.935483870967742,31,1150,700,450,0.6086956521739131,16,7,9,382.12984870126604,0.39157706093189965,0.05025310308317632,0.2223712213476269,131079.11120756165,3817.8481867283854,134896.95939429005,365,0,205.61290322580646,29,2,22,34.21026606085265,0.6483477011494253,43.99305555555555,1024.0277777777771,35.311302681992316,0
367,4,0,0,29,0.0,0.0,1.0,29,900,600,300,0.6666666666666666,12,6,6,405.02465844763594,0.38110632183908044,0.07775681425876124,0.23350079302450957,130718.7145691611,4788.860544217701,135507.57511337879,366,3,220.68965517241378,27,2,22,33.99058983313931,0.6512345679012345,44.3452380952381,1022.6190476190484,37.87477954144624,0
368,4,1,0,30,0.03333333333333333,0.0,1.0,30,900,700,200,0.7777777777777778,11,7,4,394.36208008505065,0.3875478927203065,0.07261503928170598,0.22965791722600012,131107.31272294893,4340.750511956678,135448.0632349056,367,0,214.3,28,2,23,33.868488121960354,0.6517857142857142,43.96551724137932,1024.1379310344832,36.576354679802975,0
369,4,0,1,29,0.0,0.03333333333333333,0.9666666666666667,30,900,500,400,0.5555555555555556,13,5,8,393.93944162606283,0.3874521072796935,0.07280037400654504,0.22985173639884057,131180.89617188546,4335.465797991827,135516.36196987727,368,1,215.3,28,2,23,33.80464001870033,0.6525297619047619,43.89367816091955,1024.4252873563228,36.586617405582956,0
370,4,1,0,30,0.03333333333333333,0.0,1.0,30,600,500,100,0.8333333333333334,7,5,2,382.54792112923604,0.39102011494252875,0.05935574229691842,0.22536238918009444,131549.12306777647,4064.8512848460846,135613.97435262255,369,0,207.0,28,2,24,33.723447712418306,0.65625,43.53448275862069,1025.8620689655174,36.63793103448277,0
371,4,0,1,29,0.0,0.03333333333333333,0.9666666666666667,30,550,300,250,0.5454545454545454,8,3,5,384.0192120305572,0.391044061302682,0.058138449330159325,0.22644766251942275,131585.97414205974,4106.308420861414,135692.28256292114,370,1,208.0,28,2,21,33.64841525463287,0.6566220238095237,43.49856321839081,1026.005747126437,36.64306239737275,0
372,4,0,0,29,0.0,0.0,1.0,29,900,900,0,1.0,9,9,0,395.5758976020679,0.38649425287356326,0.06588303584385358,0.23238819355292845,131442.54723373728,4599.100721017568,136041.64795475485,371,4,216.13793103448276,27,2,23,33.497345571518395,0.6585648148148149,43.638392857142854,1025.4464285714287,37.97949735449736,0
373,4,1,0,30,0.03333333333333333,0.0,1.0,30,650,500,150,0.7692307692307693,8,5,3,383.6110600000985,0.3911877394636016,0.06152626177815046,0.2273038668955808,131770.30692627828,4109.709423305592,135880.01634958386,372,0,209.9,28,2,22,33.47239714525608,0.6584821428571428,43.31896551724138,1026.7241379310349,36.668719211822676,0
374,4,1,1,30,0.03225806451612903,0.03225806451612903,0.967741935483871,31,750,300,450,0.4,12,3,9,373.5420234571003,0.39390681003584227,0.046994521228604924,0.22313030795851496,132076.584201389,3667.2309027777974,135743.8151041668,373,0,204.09677419354838,29,2,22,33.42158154303472,0.658405172413793,43.02083333333334,1027.9166666666677,35.44540229885061,0
375,4,0,2,28,0.0,0.06666666666666667,0.9333333333333333,30,600,400,200,0.6666666666666666,8,4,4,383.9291111696185,0.390205938697318,0.0673423738291632,0.22904461486207528,132028.58958003038,4137.923809287892,136166.51338931828,374,2,211.9,28,2,23,33.20314320331797,0.6610863095238095,43.06752873563219,1027.7298850574714,36.70463875205255,0
376,4,1,0,29,0.034482758620689655,0.0,1.0,29,550,400,150,0.7272727272727273,7,4,3,393.25699298590956,0.392190065681445,0.06644860046443091,0.2342915907306043,131977.176450007,4580.189510700101,136557.3659607071,375,0,209.86206896551724,27,2,24,33.01547791455469,0.6639660493827161,43.11755952380952,1027.5297619047612,38.05665784832449,0
377,4,0,1,28,0.0,0.034482758620689655,0.9655172413793104,29,1000,700,300,0.7,13,7,6,412.293325831025,0.39183087027914615,0.037715517241379226,0.22381637687969913,128355.55555555543,4784.027777777758,133139.5833333332,376,1,210.86206896551724,29,0,22,36.22190241228069,0.6206896551724139,46.66666666666666,1013.3333333333323,34.94252873563215,8
378,4,2,0,30,0.06666666666666667,0.0,1.0,30,450,100,350,0.2222222222222222,8,1,7,397.8009115412189,0.39171455938697314,0.05717941929220682,0.2187036452534472,128859.99284599359,4252.124523066226,133112.11736905982,377,0,204.73333333333332,30,0,17,36.07194863648399,0.6229166666666668,46.169354838709666,1015.32258064516,33.84408602150533,0
379,4,2,0,32,0.0625,0.0,1.0,32,850,600,250,0.7058823529411765,11,6,5,377.12886536178394,0.3979124663978495,0.062883663366337,0.2111419922480052,129577.44618236196,3374.3823346629483,132951.8285170249,378,0,192.875,30,2,16,35.86441144114411,0.6302083333333335,45.463709677419345,1018.1451612903212,33.93817204301071,0
380,4,0,0,32,0.0,0.0,1.0,32,900,700,200,0.7777777777777778,11,7,4,376.3746105341257,0.3971354166666667,0.06377837160200572,0.21127161471315592,129680.10210718,3361.6595849231076,133041.76169210311,379,1,193.875,30,2,16,35.779009413213664,0.63125,45.36290322580645,1018.5483870967741,33.95161290322581,0
381,4,1,1,32,0.030303030303030304,0.030303030303030304,0.9696969696969697,33,1050,700,350,0.6666666666666666,14,7,7,366.73583195987516,0.40112058080808083,0.06951484991551338,0.20841977629220765,130162.91512383362,2947.080993652354,133109.99611748598,380,0,188.96969696969697,31,2,19,35.53350027646633,0.6334005376344085,44.88932291666667,1020.4427083333339,32.917506720430126,0
382,4,0,0,32,0.0,0.0,1.0,32,950,600,350,0.631578947368421,13,6,7,377.54587929304716,0.39866851478494625,0.07079737119515062,0.21398025974271365,130056.85492903813,3420.4859304544,133477.34085949254,381,1,195.78125,30,2,19,35.36560592085035,0.6350694444444444,44.99327956989248,1020.0268817204309,34.000896057347695,0
383,4,0,0,32,0.0,0.0,1.0,32,1000,700,300,0.7,13,7,6,378.3279165801506,0.3981434811827957,0.069135273972603,0.2149899358290796,130159.70054341537,3448.609665857321,133608.3102092727,382,2,196.78125,30,2,20,35.24104320337199,0.6361111111111111,44.89247311827957,1020.4301075268812,34.01433691756271,0
384,4,0,0,32,0.0,0.0,1.0,32,1050,700,350,0.6666666666666666,14,7,7,376.85337815726416,0.39707241263440857,0.0687483546136638,0.2150980551360433,130331.20022907271,3423.150617123371,133754.3508461961,383,3,197.78125,30,2,21,35.104317493747544,0.6378472222222221,44.7244623655914,1021.1021505376343,34.03673835125448,0
385,4,1,1,32,0.030303030303030304,0.030303030303030304,0.9696969696969697,33,650,400,250,0.6153846153846154,9,4,5,366.9333520498816,0.4018308080808081,0.0618415007509161,0.21068470228526134,130561.83073255757,2981.498040093326,133543.3287726509,384,0,192.75757575757575,31,2,16,35.12350299401197,0.6374327956989246,44.49869791666667,1022.0052083333339,32.96790994623658,0
386,4,0,0,32,0.0,0.0,1.0,32,850,600,250,0.7058823529411765,11,6,5,376.0370498614959,0.3971564180107527,0.06836348684210525,0.21520192612555478,130434.15423748402,3409.6149121285584,133843.76914961258,385,5,199.78125,30,2,21,35.020559210526315,0.638888888888889,44.62365591397849,1021.5053763440853,34.05017921146951,0
387,4,0,0,32,0.0,0.0,1.0,32,950,700,250,0.7368421052631579,12,7,5,376.4358525681876,0.3971354166666667,0.06453893712180991,0.21581186660809673,130502.81282518218,3425.187521678819,133928.000346861,386,6,200.78125,30,2,17,34.94064062088924,0.6395833333333333,44.55645161290323,1021.7741935483878,34.05913978494626,0
388,4,2,2,32,0.058823529411764705,0.058823529411764705,0.9411764705882353,34,950,800,150,0.8421052631578947,11,8,3,357.9166533949627,0.4049502376708259,0.054726438205727534,0.2082696069476541,131077.01965590176,2582.9296424452377,133659.949298347,387,0,189.91176470588235,33,1,19,34.832256262964734,0.6376262626262625,43.9950980392157,1024.0196078431388,31.030897207367843,0
389,4,2,1,33,0.058823529411764705,0.029411764705882353,0.9705882352941176,34,650,400,250,0.6153846153846154,9,4,5,359.5512804047831,0.40298202614379086,0.0681444067701229,0.21024949697516085,131265.32613658224,2639.3232170319275,133904.64935361416,388,0,190.58823529411765,33,1,20,34.59997608227696,0.639520202020202,43.81127450980393,1024.7549019607854,31.05317884729653,0
390,4,0,0,33,0.0,0.0,1.0,33,900,500,400,0.5555555555555556,13,5,8,407.8257519526125,0.4000552398989899,0.029305955785406512,0.22633647250507194,129232.53864198868,3940.871449682819,133173.4100916715,389,1,197.36363636363637,33,0,17,35.435875416817325,0.6190025252525253,45.802696078431374,1016.7892156862747,30.811794414735598,7
391,4,2,0,35,0.05714285714285714,0.0,1.0,35,1000,500,500,0.5,15,5,10,393.1599153213508,0.41218487394957987,0.0565213835963696,0.21030323700747078,127763.95486379025,3046.3331350737267,130810.28799886398,390,0,187.02857142857144,35,0,17,37.3140860522801,0.5997023809523809,47.251157407407405,1010.99537037037,28.885582010582,6
392,4,1,1,35,0.027777777777777776,0.027777777777777776,0.9722222222222222,36,1050,900,150,0.8571428571428571,12,9,3,408.5757900865424,0.4152116402116402,0.042825134942458876,0.2174420424314235,127559.26354595346,3224.0913548096814,130783.35490076315,391,0,182.80555555555554,35,1,16,37.135273449434756,0.5976190476190475,47.45370370370371,1010.185185185186,28.862433862433885,1
393,4,3,3,35,0.07894736842105263,0.07894736842105263,0.9210526315789473,38,900,500,400,0.5555555555555556,13,5,8,409.0553286735004,0.4220009483167378,0.12350693398131685,0.2121247753051652,126505.73284614092,2791.0961748004115,129296.82902094132,392,0,174.10526315789474,33,5,16,38.21098286433588,0.5912247474747474,48.49877450980392,1006.0049019607844,30.48499702911468,6
394,4,8,7,36,0.18604651162790697,0.16279069767441862,0.8372093023255813,43,1000,900,100,0.9,11,9,2,365.6062373408563,0.44216039128829826,0.10339954780361715,0.19498999324845673,127645.42936288098,734.9484267883676,128380.37778966935,393,0,153.88372093023256,37,6,14,38.132052951388886,0.5945945945945945,47.36842105263158,1010.5263157894744,27.311522048364175,0
395,4,1,0,37,0.02702702702702703,0.0,1.0,37,1050,800,250,0.7619047619047619,13,8,5,419.25747816733053,0.42476851851851855,0.14585586681438767,0.21939629077107722,126875.85791822859,3238.7304462226107,130114.5883644512,394,0,179.8108108108108,33,4,18,37.571336617605326,0.5950126262626263,48.131127450980394,1007.4754901960786,30.529560308972076,0
396,4,1,2,36,0.02631578947368421,0.05263157894736842,0.9473684210526316,38,900,400,500,0.4444444444444444,14,4,10,430.21544107433454,0.42918741109530584,0.18112700660376135,0.22076991085840347,126075.53597847144,3269.2318688726405,129344.76784734408,395,0,176.05263157894737,32,6,18,38.12520953817785,0.5891927083333335,48.92676767676767,1004.2929292929281,31.384154040404002,3
397,4,7,7,36,0.16279069767441862,0.16279069767441862,0.8372093023255813,43,550,300,250,0.5454545454545454,8,3,5,379.68598805330953,0.4440291620524179,0.1770662798696696,0.20119205272180818,127383.94445516106,1081.3421949219917,128465.28665008306,396,0,155.8139534883721,35,8,16,38.04507758159442,0.5958333333333334,47.62731481481481,1009.4907407407399,28.842592592592567,0
398,4,5,3,38,0.12195121951219512,0.07317073170731707,0.926829268292683,41,1400,1100,300,0.7857142857142857,17,11,6,397.8923221447223,0.44113313008130084,0.1758697064947814,0.2091835278513846,127064.37467538068,1911.5878202908375,128975.96249567151,397,0,164.26829268292684,37,4,19,37.9149673735726,0.5886824324324325,47.94407894736841,1008.2236842105247,27.24928876244661,0
399,4,5,4,39,0.11627906976744186,0.09302325581395349,0.9069767441860466,43,750,300,450,0.4,12,3,9,389.0686935587915,0.44202196382428943,0.23141436737429788,0.20933092847904688,127998.08873724694,1360.021855534708,129358.11059278165,398,0,157.51162790697674,35,8,19,37.17700350756795,0.6020833333333334,47.01967592592592,1011.9212962962952,28.912037037037006,0
400,4,0,0,39,0.0,0.0,1.0,39,750,400,350,0.5333333333333333,11,4,7,424.2225881930261,0.43213000449842554,0.24198138808360792,0.22390167665664615,127223.34120008674,2994.203016493045,130217.54421657979,399,1,174.6153846153846,31,8,20,37.08699019101705,0.603494623655914,47.78645833333333,1008.8541666666661,32.543682795698906,0
401,4,4,4,39,0.09302325581395349,0.09302325581395349,0.9069767441860466,43,1100,600,500,0.5454545454545454,16,6,10,391.925845721515,0.4402916205241787,0.22335457786145319,0.21200008955575086,128212.5846376746,1466.5802591204204,129679.16489679503,400,0,159.27906976744185,30,13,20,36.884538818845385,0.6163194444444446,46.807795698924714,1012.7688172042988,33.75896057347663,0
402,4,3,2,40,0.07142857142857142,0.047619047619047616,0.9523809523809523,42,900,400,500,0.4444444444444444,14,4,10,392.9007195918979,0.43782665505226476,0.22353918354714253,0.21325259359275128,128348.74561004149,1685.6629017805362,130034.40851182202,400,0,154.47619047619048,30,12,21,36.72016624662866,0.6177083333333334,46.673387096774185,1013.306451612902,33.77688172043007,0
403,4,3,2,41,0.06976744186046512,0.046511627906976744,0.9534883720930233,43,650,400,250,0.6153846153846154,9,4,5,376.5425766837143,0.44013012181616834,0.2463411289889894,0.20776415723382857,129002.89747450069,1115.0166829426846,130117.91415744337,401,0,151.8139534883721,31,12,21,36.465543023156464,0.6216397849462367,46.02864583333332,1015.8854166666652,32.77049731182791,0
404,4,1,2,40,0.023809523809523808,0.047619047619047616,0.9523809523809523,42,1550,1100,450,0.7096774193548387,20,11,9,380.98107911817334,0.4403552071234998,0.25440521919395187,0.2116260475044759,129267.58660210489,1449.7009277343564,130717.28752983925,402,0,152.97619047619048,31,11,22,36.08247972684593,0.6243279569892475,45.76822916666666,1016.9270833333321,32.80409946236555,0
405,4,1,0,41,0.024390243902439025,0.0,1.0,41,900,400,500,0.4444444444444444,14,4,10,376.09485457725094,0.4417936991869919,0.24937354343180274,0.21147800568528494,129747.52456700848,1559.475276757471,131306.99984376595,402,0,146.5609756097561,32,9,18,35.717457760152016,0.6266276041666667,45.29671717171717,1018.8131313131314,31.837910353535356,0
406,4,0,3,38,0.0,0.07317073170731707,0.926829268292683,41,1050,800,250,0.7619047619047619,13,8,5,371.7292084312588,0.44171747967479674,0.24247038457006664,0.20971138362442707,129876.19447314041,1455.7549931129379,131331.94946625334,403,1,147.5609756097561,32,9,18,35.697696023782974,0.6279296875,45.17045454545454,1019.3181818181811,31.85369318181816,0
407,4,1,1,38,0.02564102564102564,0.02564102564102564,0.9743589743589743,39,1100,1000,100,0.9090909090909091,12,10,2,392.5156443568253,0.43606612685560053,0.24239839709744704,0.21994811550645754,129611.6603075498,2374.9208723551583,131986.58117990496,404,0,155.0,30,9,19,35.43784098908834,0.6305555555555556,45.430107526881706,1018.2795698924714,33.942652329749045,0
408,4,1,1,38,0.02564102564102564,0.02564102564102564,0.9743589743589743,39,850,600,250,0.7058823529411765,11,6,5,394.82674108966273,0.4367408906882591,0.2371414165000021,0.2214361374712342,129645.87894915589,2437.5319762400177,132083.4109253959,405,0,155.71794871794873,30,9,19,35.344078571114345,0.6309027777777778,45.39650537634408,1018.4139784946229,33.94713261648743,0
409,4,3,2,39,0.07317073170731707,0.04878048780487805,0.9512195121951219,41,1450,1000,450,0.6896551724137931,19,10,9,375.1368227866151,0.43889735772357724,0.22075269318658797,0.21465706599277876,130428.79104614267,1587.191774048756,132015.98282019142,406,0,149.0487804878049,31,10,21,35.048996175908215,0.6360887096774193,44.62890625000001,1021.4843750000007,32.951108870967765,0
410,4,0,0,39,0.0,0.0,1.0,39,1250,900,350,0.72,16,9,7,401.33277800916255,0.43525078722447147,0.25138670852956513,0.22866635026103466,130262.58680555566,2655.729166666676,132918.31597222234,407,1,157.69230769230768,30,9,21,34.54931972789115,0.6371527777777778,44.79166666666667,1020.8333333333343,34.02777777777781,0
411,4,0,0,39,0.0,0.0,1.0,39,900,600,300,0.6666666666666666,12,6,6,401.581204126024,0.4346603688708952,0.26070584297399657,0.22964449262385525,130404.4077932098,2673.591820987642,133077.99961419744,408,2,158.69230769230768,29,10,21,34.39851328075424,0.6415229885057472,44.65277777777777,1021.3888888888882,35.22030651340994,0
412,4,1,1,39,0.025,0.025,0.975,40,1250,900,350,0.72,16,9,7,389.5966347479063,0.4357238247863248,0.2537948482060717,0.22474911249407273,130743.26014929471,2187.426834027054,132930.68698332176,409,0,155.7,30,10,18,34.360077977833264,0.6420138888888889,44.321236559139784,1022.7150537634408,34.090501792114694,0
413,4,1,1,39,0.025,0.025,0.975,40,1200,900,300,0.75,15,9,6,394.1860463044319,0.4358840811965812,0.2463312969326712,0.22789696584355584,130828.11355590835,2314.1233656141644,133142.2369215225,410,0,156.675,31,9,18,34.156511178991124,0.6401209677419355,44.23828125000001,1023.0468750000011,33.00151209677423,0
414,4,0,0,39,0.0,0.0,1.0,39,850,600,250,0.7058823529411765,11,6,5,402.26832455957015,0.4340418353576248,0.25176602227075384,0.23185283433706144,130708.89698231017,2716.0097988206808,133424.90678113085,411,5,161.69230769230768,30,9,18,34.0710436382755,0.6416666666666666,44.35483870967742,1022.5806451612909,34.086021505376365,0
415,4,0,1,38,0.0,0.02564102564102564,0.9743589743589743,39,600,300,300,0.5,9,3,6,399.82412550138736,0.43395748987854255,0.24753250822497241,0.23095723014256622,130794.81336805562,2658.9843750000055,133453.79774305562,412,6,162.69230769230768,31,8,18,34.046164290563475,0.6397849462365591,44.270833333333336,1022.9166666666672,32.997311827957006,0
416,4,0,0,38,0.0,0.0,1.0,38,900,700,200,0.7777777777777778,11,7,4,409.1828366367436,0.43141002844950216,0.2524676456550754,0.23604793055109807,130743.26014929476,3099.579611804832,133842.8397610996,413,7,167.60526315789474,30,8,19,33.85930038988916,0.6420138888888889,44.321236559139784,1022.7150537634411,34.0905017921147,0
417,4,1,0,39,0.02564102564102564,0.0,1.0,39,1300,900,400,0.6923076923076923,17,9,8,398.79304651887463,0.4334514170040486,0.24724925424226174,0.23216190309925588,131094.66764661993,2655.928378634974,133750.5960252549,414,0,164.28205128205127,31,8,20,33.76787984742529,0.6428091397849462,43.97786458333333,1024.088541666666,33.03511424731181,0
418,4,0,0,39,0.0,0.0,1.0,39,850,400,450,0.47058823529411764,13,4,9,400.530862862042,0.4327204228520018,0.24563255465415623,0.23418855057386845,131261.40170627163,2714.8484971788153,133976.25020345044,415,1,165.28205128205127,31,8,20,33.554108428631956,0.644489247311828,43.815104166666664,1024.7395833333328,33.056115591397834,0
419,4,1,0,40,0.025,0.0,1.0,40,1200,800,400,0.6666666666666666,16,8,8,393.2293632368562,0.43517628205128206,0.21841926729986438,0.22819688244532532,130972.46334876552,2305.3434395495888,133277.80678831512,416,0,162.125,32,8,19,34.034373586612396,0.6389973958333333,44.09722222222223,1023.6111111111119,31.987847222222246,2
420,4,0,0,40,0.0,0.0,1.0,40,1000,700,300,0.7,13,7,6,390.96030079623415,0.4345219017094017,0.2147780517879161,0.22745251359092267,131069.41415416806,2248.5875165799553,133318.00167074802,417,1,163.125,32,8,19,33.99404027949035,0.6399739583333333,44.00252525252526,1023.9898989898999,31.99968434343437,0
421,4,0,0,40,0.0,0.0,1.0,40,1500,900,600,0.6,21,9,12,391.5445959897681,0.4344150641025641,0.21114739955632245,0.22856063682453104,131198.73769258257,2274.031348841976,133472.76904142453,418,2,164.125,32,8,19,33.84787609892367,0.6412760416666665,43.87626262626264,1024.494949494951,32.01546717171722,0
422,4,0,0,40,0.0,0.0,1.0,40,1250,900,350,0.72,16,9,7,393.6149117588736,0.4345219017094017,0.20873983739837398,0.2305458768873404,131328.12500000012,2338.5416666666806,133666.6666666668,419,3,165.125,32,8,20,33.663617886178855,0.642578125,43.75000000000001,1025.000000000001,32.03125000000003,0
423,4,0,1,39,0.0,0.025,0.975,40,1000,600,400,0.6,14,6,8,391.7604635928445,0.4344284188034188,0.20839047619047624,0.23006067492868387,131428.24172973633,2297.6777818467876,133725.9195115831,420,4,166.125,31,9,21,33.609656084656095,0.6461693548387097,43.65234375,1025.390625,33.07711693548387,0
424,4,2,1,40,0.04878048780487805,0.024390243902439025,0.975609756097561,41,1250,700,550,0.56,18,7,11,384.48794901948474,0.43579776422764227,0.20929137871587677,0.22847402960361643,131878.73247946645,1941.156674063875,133819.88915353033,421,0,161.5609756097561,32,9,17,33.34024790002048,0.6481119791666666,43.21338383838384,1027.1464646464651,32.098327020202035,0
425,4,0,0,40,0.0,0.0,1.0,40,1250,800,450,0.64,17,8,9,393.2181523001842,0.434642094017094,0.22236174530695063,0.23274263609119014,131728.82080078125,2359.6327039930547,134088.4535047743,422,1,166.6,31,9,17,33.26779976323355,0.6491935483870968,43.359375,1026.5625,33.11491935483871,0
426,4,0,0,40,0.0,0.0,1.0,40,1700,1400,300,0.8235294117647058,20,14,6,389.6702839616686,0.43445512820512816,0.21957334854824406,0.23125128138492707,131829.0901184082,2273.9757961697046,134103.06591457792,423,2,167.6,31,9,17,33.25739085414818,0.6502016129032258,43.26171875,1026.953125,33.12752016129032,0
427,4,0,0,40,0.0,0.0,1.0,40,950,600,350,0.631578947368421,13,6,7,389.2946027824524,0.433840811965812,0.22586174122417968,0.23184329890991168,131962.84188164596,2274.484422471783,134237.32630411774,424,3,168.6,31,9,19,33.13175875469945,0.6515456989247312,43.131510416666664,1027.4739583333328,33.14432123655912,0
428,4,0,0,40,0.0,0.0,1.0,40,1300,900,400,0.6923076923076923,17,9,8,387.0339354273493,0.4337072649572649,0.19621827411167492,0.22828049484786775,131595.18771701393,2194.943745930994,133790.13146294493,425,4,169.6,31,9,15,33.56175972927242,0.6478494623655914,43.489583333333336,1026.041666666667,33.0981182795699,2
429,4,0,1,39,0.0,0.025,0.975,40,1150,900,250,0.782608695652174,14,9,5,386.85235490421013,0.4334535256410256,0.19578152753108302,0.22857348286019386,131661.99578179262,2186.7506239149393,133848.74640570756,426,5,170.6,31,9,16,33.498794722151736,0.648521505376344,43.42447916666667,1026.3020833333342,33.106518817204325,0
430,4,0,1,38,0.0,0.02564102564102564,0.9743589743589743,39,800,500,300,0.625,11,5,6,390.2864442554575,0.43128654970760233,0.1555125517389666,0.2298353505059916,131534.85952133193,2467.2545236443493,134002.11404497628,427,6,175.4102564102564,30,9,21,33.539428284416495,0.65,43.54838709677419,1025.8064516129032,34.193548387096776,4
431,4,1,1,38,0.02564102564102564,0.02564102564102564,0.9743589743589743,39,1200,900,300,0.75,15,9,6,389.970780718528,0.430921052631579,0.15988526363166167,0.23006467851663362,131603.80715978716,2464.327884726549,134068.1350445137,428,0,176.05128205128204,30,9,14,33.47769845428346,0.6506944444444445,43.48118279569892,1026.0752688172036,34.202508960573454,0
432,4,0,0,38,0.0,0.0,1.0,38,1050,900,150,0.8571428571428571,12,9,3,399.8153395323819,0.4288021574205785,0.1704377766847025,0.23483187364897146,131434.91753472196,2909.939236111072,134344.85677083302,429,8,181.68421052631578,29,9,22,33.39640051469591,0.6519396551724139,43.645833333333314,1025.4166666666645,35.359195402298774,0
433,4,0,0,38,0.0,0.0,1.0,38,1400,1000,400,0.7142857142857143,18,10,8,403.59359914898187,0.42785384068278803,0.17035786053272872,0.2377146988288977,131541.75347222207,3017.881944444426,134559.6354166665,430,9,182.68421052631578,29,9,22,33.19117248849174,0.6530172413793104,43.54166666666666,1025.8333333333321,35.373563218390764,0
434,4,0,0,38,0.0,0.0,1.0,38,1350,1100,250,0.8148148148148148,16,11,5,403.8482314358909,0.428490990990991,0.1712484865750301,0.23875507442489832,131684.26890432075,3036.0918209876268,134720.3607253084,431,10,183.68421052631578,29,9,15,33.04014433919712,0.6544540229885059,43.402777777777764,1026.388888888887,35.39272030651335,0
435,4,0,0,38,0.0,0.0,1.0,38,650,400,250,0.6153846153846154,9,4,5,403.4255866128444,0.4276908487434803,0.17415834324076118,0.2391760514698281,131791.20611496895,3033.588927469113,134824.79504243805,432,11,184.68421052631578,29,9,15,32.94262027142793,0.6555316091954024,43.2986111111111,1026.805555555554,35.407088122605316,0
436,4,0,0,38,0.0,0.0,1.0,38,900,600,300,0.6666666666666666,12,6,6,402.93290607148515,0.4275871266002845,0.17277878222741028,0.23910801825782987,131826.86149691354,3023.4760802469063,134850.33757716045,433,12,185.68421052631578,29,9,16,32.91914615453971,0.6558908045977012,43.263888888888886,1026.9444444444441,35.411877394636,0
437,4,0,0,38,0.0,0.0,1.0,38,750,400,350,0.5333333333333333,11,4,7,405.7846896215127,0.4272315078236131,0.1775088573014043,0.24170653251368363,131969.53125,3110.2430555555557,135079.77430555556,434,13,186.68421052631578,29,9,16,32.701405785347404,0.6573275862068966,43.125,1027.5,35.43103448275862,0
438,4,1,1,38,0.02564102564102564,0.02564102564102564,0.9743589743589743,39,900,700,200,0.7777777777777778,11,7,4,397.8771165693894,0.4295152946468736,0.17129303933589268,0.23903857537065193,132294.2771563186,2727.373106717531,135021.65026303614,435,0,182.87179487179486,30,9,16,32.57610399790957,0.6576388888888889,42.80913978494623,1028.7634408602146,34.29211469534049,0
439,4,0,1,37,0.0,0.02631578947368421,0.9736842105263158,38,600,400,200,0.6666666666666666,8,4,4,408.120489427155,0.4269203413940256,0.1775409206615568,0.24401517469626824,132112.27816358028,3183.545524691365,135295.82368827166,436,15,188.68421052631578,29,9,17,32.49684769882015,0.6587643678160919,42.986111111111114,1028.0555555555557,35.45019157088123,0
440,4,0,0,37,0.0,0.0,1.0,37,1050,700,350,0.6666666666666666,14,7,7,409.95833142633296,0.4259259259259259,0.1574770396155576,0.24627423851377525,132290.8203125,3446.744791666667,135737.56510416666,437,16,183.83783783783784,29,8,19,32.268884163629,0.6605603448275862,42.8125,1028.75,35.474137931034484,0
441,4,0,0,37,0.0,0.0,1.0,37,1350,1100,250,0.8148148148148148,16,11,5,409.30737420056073,0.42573823823823825,0.15911213589399376,0.2461159925387789,132326.54320987663,3432.4459876543383,135758.98919753096,438,17,184.83783783783784,29,8,20,32.249482541396695,0.6609195402298851,42.777777777777786,1028.8888888888896,35.47892720306516,0
442,4,0,0,37,0.0,0.0,1.0,37,900,600,300,0.6666666666666666,12,6,6,406.40861660291125,0.42530030030030025,0.15807986003535568,0.24600162384576224,132576.73852237663,3376.0657793210007,135952.80430169764,439,18,185.83783783783784,29,8,21,32.07111148572712,0.6634339080459769,42.53472222222223,1029.8611111111118,35.512452107279714,0
443,4,0,1,36,0.0,0.02702702702702703,0.972972972972973,37,800,600,200,0.75,10,6,4,407.86474356479573,0.42505005005005003,0.16222046503831633,0.2473534589550361,132648.2663001544,3420.5102237654482,136068.77652391986,440,19,186.83783783783784,29,8,15,31.961344433958043,0.6641522988505746,42.465277777777786,1030.1388888888896,35.52203065134102,0
444,4,0,0,36,0.0,0.0,1.0,36,900,600,300,0.6666666666666666,12,6,6,422.61551837531886,0.42402447089947093,0.16589936755952372,0.2558537192326255,132582.90395032373,4006.3185361342375,136589.22248645796,441,20,191.22222222222223,28,8,21,31.647600446428566,0.6666666666666666,42.52873563218391,1029.8850574712646,36.78160919540231,0
445,4,0,0,36,0.0,0.0,1.0,36,900,600,300,0.6666666666666666,12,6,6,424.8458924427482,0.42402447089947093,0.1611885944521929,0.2577110870401443,132656.9002675387,4071.747836570231,136728.64810410893,442,21,192.22222222222223,28,8,16,31.515283589028357,0.6674107142857142,42.45689655172414,1030.172413793104,36.791871921182285,0
446,4,0,0,36,0.0,0.0,1.0,36,1000,600,400,0.6,14,6,8,424.3071727042641,0.4240575396825397,0.15872185810130301,0.25763816557682306,132693.90616742644,4060.595232197133,136754.50139962358,443,22,193.22222222222223,28,8,17,31.4917143122763,0.667782738095238,42.42097701149426,1030.3160919540237,36.797003284072275,0
447,4,0,0,36,0.0,0.0,1.0,36,750,600,150,0.8,9,6,3,425.39206351526934,0.4241898148148148,0.16209642436636318,0.2585518541975857,132730.91722816753,4092.5357543929194,136823.45298256044,444,23,194.22222222222223,28,8,17,31.426322271797734,0.6681547619047619,42.38505747126437,1030.4597701149426,36.80213464696224,0
448,4,0,0,36,0.0,0.0,1.0,36,1250,900,350,0.72,16,9,7,430.9627475648135,0.42397486772486775,0.21203250136070273,0.25511423623451496,131733.4300477277,4154.440191901191,135887.87023962892,445,24,195.22222222222223,28,8,18,32.2944366689993,0.6581101190476188,43.35488505747127,1026.580459770116,36.663587848932714,3
449,4,0,0,36,0.0,0.0,1.0,36,900,600,300,0.6666666666666666,12,6,6,433.56427399516053,0.42387566137566135,0.20841296477571136,0.2581530494037796,131954.7687318338,4242.174701083368,136196.94343291718,446,25,196.22222222222223,28,8,18,32.00280846501654,0.6603422619047619,43.139367816091955,1027.4425287356323,36.694376026272586,0
450,4,0,0,36,0.0,0.0,1.0,36,1200,900,300,0.75,15,9,6,433.27246165084,0.42318121693121696,0.2060810810810807,0.25856582388840454,132040.89506172843,4241.936728395065,136282.83179012348,447,26,197.22222222222223,29,7,18,31.922860360360367,0.6580459770114943,43.05555555555556,1027.777777777778,35.44061302681993,0
451,4,0,0,36,0.0,0.0,1.0,36,950,700,250,0.7368421052631579,12,7,5,434.17330156637047,0.4223875661375662,0.20457410408788057,0.26008245346257336,132183.6805555555,4278.124999999995,136461.8055555555,448,27,198.22222222222223,29,7,18,31.75479470556456,0.6594827586206896,42.916666666666664,1028.333333333333,35.459770114942515,0
452,4,0,0,36,0.0,0.0,1.0,36,850,600,250,0.7058823529411765,11,6,5,430.95521040822115,0.42212301587301587,0.2028437724982004,0.25913280833637214,132326.54320987666,4205.362654321004,136531.90586419767,449,28,199.22222222222223,29,7,18,31.692652087832972,0.6609195402298851,42.777777777777786,1028.8888888888898,35.47892720306517,0
453,4,1,1,36,0.02702702702702703,0.02702702702702703,0.972972972972973,37,1100,900,200,0.8181818181818182,13,9,4,421.9232150095229,0.4247997997997998,0.19225723635953273,0.2558243291007109,132640.18961729686,3792.7950485605334,136432.9846658574,450,0,194.8108108108108,30,7,17,31.60746129088378,0.6611111111111111,42.473118279569896,1030.107526881721,34.33691756272403,0
454,4,0,0,36,0.0,0.0,1.0,36,800,400,400,0.5,12,4,8,432.19642305623177,0.421875,0.20261548149147646,0.26061901474936816,132433.7408371914,4247.47781635803,136681.21865354944,451,30,201.22222222222223,29,7,18,31.552056627535634,0.6619971264367817,42.673611111111114,1029.3055555555559,35.4932950191571,0
455,4,0,0,36,0.0,0.0,1.0,36,1300,900,400,0.6923076923076923,17,9,8,429.4043690918159,0.4213624338624338,0.2023873752360399,0.2596740613741211,132540.981867284,4182.735339506184,136723.71720679017,452,31,202.22222222222223,29,7,19,31.51526391511556,0.6630747126436781,42.56944444444445,1029.7222222222226,35.50766283524906,0
456,4,0,0,36,0.0,0.0,1.0,36,700,500,200,0.7142857142857143,9,5,4,431.85293409159937,0.4210978835978836,0.20186084142394822,0.26165207183196904,132612.5,4253.819444444443,136866.31944444444,453,32,203.22222222222223,29,7,19,31.379786947141316,0.6637931034482758,42.5,1030.0,35.51724137931034,0
457,4,0,0,36,0.0,0.0,1.0,36,1000,800,200,0.8,12,8,4,430.1144794355271,0.42083333333333334,0.19766527347085527,0.26084702321940334,132648.26630015424,4210.788001543195,136859.05430169744,454,33,204.22222222222223,29,7,17,31.388336479259358,0.6641522988505747,42.46527777777777,1030.1388888888882,35.52203065134098,0
458,4,1,0,37,0.02702702702702703,0.0,1.0,37,1050,800,250,0.7619047619047619,13,8,5,413.84135623602333,0.42267267267267267,0.22759706609264163,0.2461267013403716,131911.15702479324,3518.0584251606806,135429.21544995392,455,0,199.67567567567568,32,5,19,32.5536197148476,0.6484375,43.18181818181817,1027.2727272727261,32.10227272727269,5
459,4,1,0,38,0.02631578947368421,0.0,1.0,38,1200,800,400,0.6666666666666666,16,8,8,400.72783386619636,0.42717223802750115,0.21767199483278676,0.2404080564431011,132240.39619677514,2998.4815035082493,135238.8777002834,456,0,195.39473684210526,33,5,20,32.557264982723694,0.6493055555555556,42.86151960784313,1028.5539215686265,31.16830065359474,0
460,4,0,0,38,0.0,0.0,1.0,38,400,200,200,0.5,6,2,4,401.4105404151702,0.42697961119013755,0.22031400875311968,0.2410186034509968,132271.9101427333,3019.067786428264,135290.97792916157,457,1,196.39473684210526,33,5,20,32.507842903661334,0.6496212121212123,42.83088235294116,1028.6764705882333,31.172014260249494,0
461,4,0,1,37,0.0,0.02631578947368421,0.9736842105263158,38,950,800,150,0.8421052631578947,11,8,3,399.1657804350364,0.4272018729255571,0.23709592393249745,0.22780900962442746,130327.04132550242,2809.840625153347,133136.88195065578,458,2,197.39473684210526,32,6,18,34.538972012695275,0.6324869791666667,44.72853535353535,1021.0858585858579,31.90893308080806,6
462,4,0,0,37,0.0,0.0,1.0,37,1150,800,350,0.6956521739130435,15,8,7,424.09410371877993,0.42520645645645644,0.2941084217679968,0.22510949858584087,127453.32717895495,3410.440911187052,130863.768090142,459,3,203.64864864864865,31,6,17,36.85270255748979,0.6058467741935485,47.55859374999999,1009.765624999999,32.573084677419324,4
463,4,6,6,37,0.13953488372093023,0.13953488372093023,0.8604651162790697,43,900,600,300,0.6666666666666666,12,6,6,374.53267911857535,0.43835363602805466,0.2485781232258799,0.2053095197212044,128743.83674214751,1045.6240206683503,129789.46076281586,460,0,176.09302325581396,36,7,17,36.78128236425507,0.607638888888889,46.28378378378378,1014.8648648648646,28.190690690690683,0
464,4,2,2,37,0.05128205128205128,0.05128205128205128,0.9487179487179487,39,850,600,250,0.7058823529411765,11,6,5,402.5841572362174,0.43325461088618983,0.2698332038977689,0.2180913364960277,128272.40404359243,2528.0875357106343,130800.49157930305,461,0,192.15384615384616,32,7,19,36.5532427603972,0.6116536458333334,46.74873737373737,1013.0050505050499,31.65640782828281,0
465,4,1,0,38,0.02631578947368421,0.0,1.0,38,900,600,300,0.6666666666666666,12,6,6,410.33717759826595,0.4286539829302987,0.28145982239549494,0.22158207590306347,128144.5312499999,2916.4930555555416,131061.02430555545,462,0,198.18421052631578,31,7,20,36.48834019204389,0.6129032258064517,46.87499999999999,1012.4999999999992,32.66129032258062,0
466,4,1,0,39,0.02564102564102564,0.0,1.0,39,1150,800,350,0.6956521739130435,15,8,7,403.83995766870316,0.4317082771030139,0.28420639253661295,0.22017913781652104,128528.3409377869,2580.975952708899,131109.3168904958,463,0,194.07692307692307,32,7,18,36.25871622462955,0.6142578125,46.49621212121212,1014.015151515151,31.68797348484847,0
467,4,1,2,38,0.025,0.05,0.95,40,800,500,300,0.625,11,5,6,396.89860222379684,0.4342147435897436,0.27111205022941376,0.21768968368327704,128765.68657487497,2221.3842031910717,130987.07077806605,464,0,190.2,33,7,18,36.19143926587782,0.6142676767676768,46.26225490196078,1014.9509803921562,30.756090314913823,0
468,4,1,1,38,0.02564102564102564,0.02564102564102564,0.9743589743589743,39,900,600,300,0.6666666666666666,12,6,6,406.35453703115866,0.4320737741790373,0.27933777709674157,0.22172823651047976,128560.35098459326,2648.2163809815156,131208.56736557477,465,0,196.0,32,7,18,36.162122343957506,0.6145833333333335,46.46464646464646,1014.1414141414128,31.69191919191915,0
469,4,4,1,41,0.09523809523809523,0.023809523809523808,0.9761904761904762,42,1250,700,550,0.56,18,7,11,377.84488370563895,0.43658052651955087,0.2586812127886575,0.21052806876001406,129388.34372597051,1380.9331877590398,130769.27691372955,466,0,182.9047619047619,33,9,21,36.039006665060626,0.6205808080808082,45.64950980392155,1017.4019607843115,30.830362448009442,0
470,4,0,0,41,0.0,0.0,1.0,41,650,300,350,0.46153846153846156,10,3,7,390.4566718336576,0.43414634146341463,0.2728618794567832,0.2170551063920021,129297.68207644623,1897.0285238751067,131194.71060032133,467,1,188.3658536585366,32,9,21,35.81083178150218,0.6220703125,45.73863636363636,1017.0454545454542,31.782670454545443,0
471,4,2,5,38,0.046511627906976744,0.11627906976744186,0.8837209302325582,43,1000,800,200,0.8,12,8,4,370.4626322166228,0.43763842746400883,0.25227129229200385,0.20838227165513937,129760.92470689732,1014.3147451560391,130775.23945205336,468,0,180.5581395348837,35,8,16,35.84727271006095,0.6199404761904761,45.28356481481482,1018.865740740741,29.11044973544974,0
472,4,2,2,38,0.05,0.05,0.95,40,950,700,250,0.7368421052631579,12,7,5,398.6025788554525,0.4344284188034188,0.2730444499627518,0.22140311517943528,129265.58036169766,2305.1187378838763,131570.69909958154,469,0,194.9,32,8,18,35.63653671053722,0.6217447916666667,45.770202020202014,1016.919191919191,31.77872474747472,0
473,4,2,1,39,0.05,0.025,0.975,40,950,600,350,0.631578947368421,13,6,7,395.5077943726078,0.43246527777777777,0.2794677263969172,0.22071886589181008,129450.69204152246,2239.7515378700464,131690.4435793925,470,0,195.85,33,7,19,35.526051701991,0.6212121212121213,45.588235294117645,1017.6470588235292,30.837789661319064,0
474,4,0,1,38,0.0,0.02564102564102564,0.9743589743589743,39,900,700,200,0.7777777777777778,11,7,4,405.01284990834745,0.42985267656320286,0.2850905248820108,0.22551406577135835,129361.89746263137,2678.6461521783517,132040.54361480972,471,1,201.87179487179486,32,7,19,35.375036200405454,0.6227213541666666,45.67550505050505,1017.2979797979799,31.790561868686872,0
475,4,1,1,38,0.02564102564102564,0.02564102564102564,0.9743589743589743,39,1300,1100,200,0.8461538461538461,15,11,4,394.78407112411287,0.43165204678362573,0.2629138398600561,0.22154290446404465,129669.02941476836,2438.2534662149183,132107.2828809833,472,0,198.15384615384616,33,6,19,35.32153671840533,0.6234217171717171,45.37377450980392,1018.5049019607843,30.863784907902556,0
476,4,2,2,38,0.05,0.05,0.95,40,1400,1200,200,0.8571428571428571,16,12,4,380.20822923554294,0.4341212606837607,0.24492737176577406,0.21532101002722395,130026.38996056246,1887.420696159131,131913.8106567216,473,0,194.15,35,5,19,35.32871841428356,0.6226190476190476,45.02314814814815,1019.9074074074078,29.140211640211653,0
477,4,2,1,39,0.05,0.025,0.975,40,950,600,350,0.631578947368421,13,6,7,379.98318893923346,0.4334001068376068,0.26179688465817774,0.21722148518229395,130391.51178770026,1909.959496054827,132301.4712837551,474,0,195.1,32,8,20,34.96311863848024,0.6331380208333334,44.66540404040404,1021.3383838383841,31.916824494949502,0
478,4,0,0,39,0.0,0.0,1.0,39,1250,900,350,0.72,16,9,7,390.3112218084365,0.43052744039586144,0.2786908824644674,0.22314877724966273,130395.54172091997,2378.9686414930325,132774.51036241298,475,1,201.10256410256412,31,8,20,34.695308516063236,0.6357526881720431,44.66145833333332,1021.3541666666653,32.94690860215049,0
479,4,0,0,39,0.0,0.0,1.0,39,550,200,350,0.36363636363636365,9,2,7,386.18889556109804,0.4304430949167792,0.27416457502829905,0.22110375229377144,130450.3075740099,2275.69204152248,132725.99961553238,476,2,202.10256410256412,33,6,20,34.74488163787589,0.6313131313131313,44.607843137254896,1021.5686274509796,30.95662507427211,0
480,4,1,1,39,0.025,0.025,0.975,40,1050,800,250,0.7619047619047619,13,8,5,380.15633037475584,0.4332799145299145,0.27638484813220066,0.21968280745866,130810.03578514728,1945.6526360544044,132755.6884212017,477,0,198.025,34,6,20,34.53368051514798,0.6326593137254903,44.25595238095237,1022.9761904761896,30.087535014005574,0
481,4,1,2,38,0.025,0.05,0.95,40,1250,900,350,0.72,16,9,7,377.9691643189853,0.4329727564102564,0.27262470308788633,0.2188359778483396,130883.62328800143,1893.994743441346,132777.61803144278,478,0,199.0,35,5,20,34.51497285374956,0.6312500000000001,44.18402777777777,1023.263888888888,29.236111111111086,0
482,4,0,0,38,0.0,0.0,1.0,38,1250,1000,250,0.8,15,10,5,393.52797357007626,0.4295430298719773,0.2763268292990655,0.22658411894376435,130669.48596993941,2684.419604238749,133353.90557417818,479,5,208.05263157894737,33,5,20,34.33454692556634,0.6335227272727273,44.393382352941174,1022.426470588235,30.982620320855606,0
483,4,0,0,38,0.0,0.0,1.0,38,1200,900,300,0.75,15,9,6,396.42001526479186,0.4288466097676624,0.2762180433110093,0.2288050793499275,130763.47588667825,2767.4518214148475,133530.9277080931,480,6,209.05263157894737,33,5,20,34.16506909497563,0.634469696969697,44.3014705882353,1022.7941176470592,30.993761140819977,0
484,4,0,0,38,0.0,0.0,1.0,38,1300,1000,300,0.7692307692307693,16,10,6,395.7519671941827,0.429054054054054,0.2759312031876524,0.22879068020339596,130826.15460399851,2754.9416089965443,133581.09621299506,481,7,210.05263157894737,33,5,20,34.11845152531544,0.6351010101010102,44.240196078431374,1023.0392156862749,31.001188354129543,0
485,4,2,0,40,0.05,0.0,1.0,40,1100,900,200,0.8181818181818182,13,9,4,377.57468028828686,0.4327590811965812,0.26679802955665055,0.2215250291864803,131392.8425670849,1925.0056112309676,133317.84817831588,482,0,200.5,32,8,22,34.00913382594419,0.6432291666666667,43.686868686868685,1025.2525252525247,32.0391414141414,0
486,4,0,0,40,0.0,0.0,1.0,40,1000,800,200,0.8,12,8,4,373.3524020388932,0.4322649572649573,0.2553863557257221,0.22025491808167152,131602.82206632654,1826.8459467120122,133429.66801303855,483,1,201.5,34,6,21,33.90498704412731,0.640625,43.482142857142854,1026.0714285714284,30.178571428571423,0
487,4,0,1,39,0.0,0.025,0.975,40,1300,1000,300,0.7692307692307693,16,10,6,374.57194003611914,0.4317708333333334,0.2628624449083743,0.22150612256456917,131694.45153061225,1865.8092403628184,133560.26077097506,484,2,202.5,34,6,21,33.781073610144595,0.6415441176470588,43.392857142857146,1026.4285714285716,30.189075630252105,0
488,4,0,0,39,0.0,0.0,1.0,39,1150,800,350,0.6956521739130435,15,8,7,386.9746240796744,0.4303587494376968,0.27539907138569397,0.22815151780246695,131579.47063629364,2383.5832372164487,133963.0538735101,485,3,208.64102564102564,33,6,21,33.57919254658385,0.6426767676767677,43.50490196078431,1025.980392156862,31.090314913844306,0
489,4,0,0,39,0.0,0.0,1.0,39,650,400,250,0.6153846153846154,9,4,5,383.8449961028175,0.4297402159244264,0.27628420761467964,0.22680793087062298,131663.9048327664,2307.706207482987,133971.61104024938,486,4,209.64102564102564,34,5,21,33.574024668445254,0.6412377450980392,43.422619047619044,1026.3095238095234,30.185574229691866,0
490,4,0,0,39,0.0,0.0,1.0,39,800,400,400,0.5,12,4,8,386.05169992106545,0.429880791722897,0.28015712301923656,0.22847795527929599,131725.00177154175,2370.5321712017926,134095.53394274355,487,5,210.64102564102564,34,5,21,33.45558390351385,0.6418504901960785,43.36309523809523,1026.5476190476174,30.192577030812277,0
491,4,0,0,39,0.0,0.0,1.0,39,1050,700,350,0.6666666666666666,14,7,7,381.4546293900276,0.429880791722897,0.27832713633107753,0.22648376378167706,131847.23816609973,2258.7478741496484,134105.98604024938,488,6,211.64102564102564,34,5,21,33.44997295313163,0.6430759803921569,43.24404761904761,1027.0238095238092,30.206582633053213,0
492,4,0,0,39,0.0,0.0,1.0,39,1250,800,450,0.64,17,8,9,384.0788217554707,0.42934660368870897,0.2803874379772413,0.22859311943101432,131938.9526643989,2334.991496598612,134273.94416099752,489,7,212.64102564102564,34,5,21,33.28988026264966,0.6439950980392158,43.15476190476189,1027.3809523809507,30.217086834733845,0
493,4,0,0,39,0.0,0.0,1.0,39,1650,1500,150,0.9090909090909091,18,15,3,382.95260545928676,0.4283625730994152,0.27895488402609003,0.22921425179153546,132153.0771683672,2321.6730442176686,134474.75021258486,490,8,213.64102564102564,34,5,21,33.102495079309946,0.646139705882353,42.94642857142856,1028.2142857142844,30.241596638655423,0
494,4,0,0,39,0.0,0.0,1.0,39,1350,900,450,0.6666666666666666,18,9,9,358.59796920922236,0.4281376518218623,0.23360895347866006,0.2077161821645874,130901.38888888896,1588.421201814069,132489.81009070305,491,9,214.64102564102564,34,5,20,34.99253528773072,0.633578431372549,44.16666666666667,1023.3333333333339,30.098039215686292,5
495,4,1,0,40,0.025,0.0,1.0,40,750,400,350,0.5333333333333333,11,4,7,347.015665278604,0.4288862179487179,0.21239837398373984,0.20325203252032514,131328.125,1115.2777777777774,132443.40277777778,492,0,210.25,34,6,22,34.857723577235774,0.6378676470588236,43.75,1025.0,30.147058823529413,0
496,4,0,1,39,0.0,0.025,0.975,40,1000,600,400,0.6,14,6,8,343.8237695549647,0.42943376068376066,0.15512712880786772,0.19716661558110674,130512.91120001907,979.0284986543498,131491.9396986734,493,1,211.25,33,7,16,35.76347245542497,0.6319444444444446,44.546568627450974,1021.8137254901948,30.96405228758166,4
497,4,0,0,39,0.0,0.0,1.0,39,800,500,300,0.625,11,5,6,356.5729180831833,0.4281095366621683,0.1653513359323,0.20400812639978463,130423.75299714321,1501.1156387103433,131924.86863585355,494,12,217.64102564102564,32,7,21,35.52817264112073,0.6334635416666666,44.63383838383839,1021.464646464647,31.92077020202022,0
498,4,1,1,39,0.025,0.025,0.975,40,800,700,100,0.875,9,7,2,346.47275392690136,0.4311030982905983,0.1544773435626947,0.19932935953504918,130638.16350682439,1052.5128556324598,131690.67636245684,495,0,213.175,33,7,16,35.5690082314393,0.6332070707070707,44.42401960784314,1022.3039215686282,30.978906714200853,0
499,4,2,2,39,0.04878048780487805,0.04878048780487805,0.9512195121951219,41,950,500,450,0.5263157894736842,14,5,9,337.04601640335727,0.43198678861788614,0.14936045125923636,0.19523231516194456,130901.38888888882,623.9583333333287,131525.34722222216,496,0,208.9268292682927,34,7,17,35.54390608034746,0.633578431372549,44.166666666666664,1023.3333333333327,30.098039215686256,0
500,4,0,0,39,0.0,0.0,1.0,39,700,500,200,0.7142857142857143,9,5,4,354.03596327290717,0.4277440395861449,0.1607458516279865,0.20323170827878817,130552.75769054191,1444.0742653810983,131996.831955923,497,15,220.64102564102564,32,7,17,35.46222510501604,0.634765625,44.507575757575765,1021.9696969696979,31.93655303030306,0
501,4,3,2,40,0.07142857142857142,0.047619047619047616,0.9523809523809523,42,800,500,300,0.625,11,5,6,330.7163386064483,0.4327695509097948,0.15385138670852916,0.1934137969999151,131270.41737683633,282.6543604415185,131553.07173727785,498,0,205.8095238095238,36,6,18,35.333562271062256,0.6331018518518519,43.806306306306304,1024.7747747747749,28.465965965965967,0
502,4,0,0,40,0.0,0.0,1.0,40,800,500,300,0.625,11,5,6,344.7809626825313,0.42864583333333334,0.158604651162791,0.2003456945317411,131023.24263038553,1034.8639455782397,132058.1065759638,499,1,217.1,34,6,18,35.22286821705427,0.6348039215686274,44.04761904761905,1023.8095238095241,30.112044817927178,0
503,4,0,1,39,0.0,0.025,0.975,40,950,800,150,0.8421052631578947,11,8,3,349.4954658268288,0.4284054487179487,0.160909355026148,0.20389210057219412,131175.639526644,1169.0582482993245,132344.6977749433,500,2,218.1,34,6,18,34.94818903738137,0.6363357843137254,43.898809523809526,1024.404761904762,30.12955182072829,0
504,4,1,0,40,0.025,0.0,1.0,40,1200,900,300,0.75,15,9,6,349.65845864614636,0.4273904914529914,0.15903466826061008,0.20496797523300742,131359.53006355738,1186.2827391986345,132545.812802756,501,0,218.625,33,7,19,34.75829348475791,0.6404671717171717,43.719362745098046,1025.1225490196086,31.064319667260868,0
505,4,0,1,39,0.0,0.025,0.975,40,1500,1200,300,0.8,18,12,6,348.3810275600716,0.4265491452991453,0.16657907310081255,0.20539760300936064,131579.47063629376,1167.9582372164612,132747.42887351022,502,1,219.625,33,7,17,34.569099378881994,0.6426767676767677,43.504901960784316,1025.980392156863,31.090314913844335,0
506,4,0,0,39,0.0,0.0,1.0,39,850,600,250,0.7058823529411765,11,6,5,355.5659836835707,0.4240890688259109,0.18072471729206563,0.20896576841374534,131457.5760764207,1548.3684700540687,133005.94454647476,503,2,225.53846153846155,32,7,22,34.50786957235493,0.6438802083333334,43.62373737373737,1025.50505050505,32.04703282828281,0
507,4,1,1,39,0.025,0.025,0.975,40,900,700,200,0.7777777777777778,11,7,4,349.52496524752047,0.4259481837606838,0.17555509132147584,0.2069237197087264,131736.6836823577,1209.051957179931,132945.73563953763,504,0,220.875,33,7,17,34.381217420715465,0.6442550505050505,43.35171568627451,1026.5931372549016,31.108882947118232,0
508,4,0,0,39,0.0,0.0,1.0,39,500,300,200,0.6,7,3,4,357.66756043702276,0.42377980206927574,0.17467199303281022,0.2109148473230222,131587.09092184462,1612.8867590041682,133199.9776808488,505,4,227.53846153846155,32,7,17,34.32321150217408,0.6451822916666667,43.49747474747474,1026.0101010101002,32.06281565656563,0
509,4,1,2,38,0.025,0.05,0.95,40,1150,800,350,0.6956521739130435,15,8,7,351.57519677102147,0.4232905982905983,0.17124746450304262,0.20882719519049825,131862.52170138885,1271.9184027777724,133134.44010416663,506,0,222.825,33,7,17,34.201741041244084,0.6455176767676768,43.229166666666664,1027.083333333333,31.123737373737363,0
510,4,0,0,38,0.0,0.0,1.0,38,800,600,200,0.75,10,6,4,372.98363382533114,0.42001541014698907,0.18403682473510496,0.21960874942271724,131528.3966064452,2211.587863498249,133739.98446994345,507,9,235.42105263157896,31,7,22,33.98969704662773,0.6471774193548387,43.55468749999999,1025.781249999999,33.08971774193545,0
511,4,0,0,38,0.0,0.0,1.0,38,800,600,200,0.75,10,6,4,374.91305166637716,0.41965979137031767,0.18544600938967126,0.22132507566911738,131628.58963012684,2269.8552449544127,133898.44487508124,508,10,236.42105263157896,31,7,17,33.838900520238546,0.6481854838709677,43.45703124999999,1026.171874999999,33.10231854838707,0
512,4,0,0,38,0.0,0.0,1.0,38,950,600,350,0.631578947368421,13,6,7,372.2461553456809,0.41965979137031767,0.17973771595388688,0.22044672171272614,131749.07415378516,2208.6172648199,133957.69141860507,509,11,237.42105263157896,32,6,17,33.78556348132662,0.6468098958333335,43.33964646464646,1026.641414141413,32.082544191919155,0
513,4,0,0,38,0.0,0.0,1.0,38,300,200,100,0.6666666666666666,4,2,2,370.0546371007253,0.419467164532954,0.17860563854298772,0.2193355910279224,131781.4827568614,2153.2697556371545,133934.75251249856,510,12,238.42105263157896,32,6,17,33.80907730775535,0.6471354166666667,43.308080808080796,1026.7676767676755,32.08648989898986,0
514,4,0,0,38,0.0,0.0,1.0,38,600,300,300,0.5,9,3,6,397.77855081889226,0.419467164532954,0.23069655887573437,0.2166439730694336,128485.98082768648,2623.2322389700826,131109.21306665655,511,13,239.42105263157896,33,5,18,36.45581510133366,0.6114267676767677,46.53799019607843,1013.8480392156863,30.7226678550208,8
515,4,1,1,38,0.02564102564102564,0.02564102564102564,0.9743589743589743,39,800,300,500,0.375,13,3,10,383.19000657462186,0.4208839406207827,0.19261012491781693,0.2110792409097493,128936.76757812501,2081.456163194444,131018.22374131945,512,0,234.25641025641025,35,4,18,36.36431623931624,0.6116071428571428,46.09375,1015.6250000000001,29.017857142857146,1
516,4,1,1,38,0.02564102564102564,0.02564102564102564,0.9743589743589743,39,1050,600,450,0.5714285714285714,15,6,9,381.29982517592606,0.42203666216824115,0.18805561154883277,0.21035000412125082,128995.54887099187,2037.1960465963573,131032.74491758824,513,0,235.23076923076923,35,4,19,36.352232159811635,0.612202380952381,46.035879629629626,1015.8564814814808,29.02447089947088,0
517,4,0,0,38,0.0,0.0,1.0,38,750,400,350,0.5333333333333333,11,4,7,394.6733871959061,0.41936344238975815,0.17573880886761617,0.2142845856022941,128361.76478097332,2532.3585985187256,130894.12337949204,514,16,242.42105263157896,33,5,20,36.66190490587336,0.6101641414141417,46.660539215686256,1013.3578431372521,30.70781342840158,1
518,4,1,0,39,0.02564102564102564,0.0,1.0,39,850,700,150,0.8235294117647058,10,7,3,391.31070424231024,0.4220647773279352,0.1841341454244687,0.21452885875663574,128747.91843820826,2276.0877267573273,131024.00616496558,515,0,237.17948717948718,34,5,19,36.35141739980448,0.6118259803921571,46.279761904761884,1014.8809523809495,29.849439775910277,0
519,4,0,0,39,0.0,0.0,1.0,39,950,600,350,0.631578947368421,13,6,7,391.833722390326,0.42265519568151144,0.1845348148548993,0.21547065237054075,128868.76594387741,2299.0256519274208,131167.79159580483,516,1,238.17948717948718,34,5,19,36.21443506468128,0.6130514705882353,46.16071428571428,1015.3571428571418,29.863445378151226,0
520,4,0,0,39,0.0,0.0,1.0,39,1000,600,400,0.6,14,6,8,390.77385278747414,0.42251461988304095,0.20532010503321474,0.21068150489557394,128080.61876658017,2241.2834247182514,130321.90219129842,517,2,239.17948717948718,32,7,17,37.04913517109476,0.6097005208333333,46.93813131313133,1012.2474747474766,31.632733585858645,4
521,4,1,1,39,0.025,0.025,0.975,40,750,500,250,0.6666666666666666,10,5,5,385.92258517224957,0.4276709401709402,0.20008466376390932,0.20937059935722846,128330.72015570941,1905.1446559015844,130235.864811611,518,0,234.175,33,7,17,36.915416868247064,0.6098484848484848,46.69117647058824,1013.2352941176475,30.704099821746894,0
522,4,1,0,40,0.025,0.0,1.0,40,1750,1300,450,0.7428571428571429,22,13,9,386.32500155930234,0.4247996794871795,0.21135814403093311,0.21089879372722864,128579.18228565934,1934.67055940023,130513.85284505956,519,0,235.15,33,7,16,36.650656516835824,0.6123737373737373,46.44607843137255,1014.2156862745096,30.73380867498514,0
523,4,2,3,39,0.047619047619047616,0.07142857142857142,0.9285714285714286,42,900,600,300,0.6666666666666666,12,6,6,371.09021855577265,0.4298175571041425,0.19999674510952703,0.20486980745173397,129024.94454089501,1175.9789737654291,130200.92351466045,520,0,224.9047619047619,35,7,17,36.58151059466849,0.6125,46.00694444444444,1015.9722222222218,29.027777777777768,0
524,4,2,1,40,0.04878048780487805,0.024390243902439025,0.975609756097561,41,800,600,200,0.75,10,6,4,371.0982275630245,0.428760162601626,0.21238027750474364,0.20516155896878077,129080.38548752826,1380.3004535147325,130460.68594104299,521,0,228.390243902439,34,7,19,36.52471883786317,0.6151960784313726,45.95238095238095,1016.1904761904756,29.88795518207281,0
525,4,1,1,40,0.024390243902439025,0.024390243902439025,0.975609756097561,41,1250,1000,250,0.8,15,10,5,363.7102464991466,0.429369918699187,0.1987021181226678,0.20215853193508196,129292.17864229018,1205.0347222222117,130497.2133645124,522,0,222.90243902439025,34,7,19,36.49649810761247,0.6173406862745099,45.74404761904761,1017.023809523809,29.91246498599438,0
526,4,2,1,41,0.047619047619047616,0.023809523809523808,0.9761904761904762,42,1250,800,450,0.64,17,8,9,354.0885158559893,0.4309789972899729,0.19919174213652768,0.19902216580871107,129731.4453124999,787.2829861110977,130518.728298611,523,0,218.54761904761904,35,7,14,36.29430811179276,0.6196428571428572,45.31249999999999,1018.7499999999992,29.107142857142833,0
527,4,1,2,40,0.023809523809523808,0.047619047619047616,0.9523809523809523,42,1200,900,300,0.75,15,9,6,353.6348583174948,0.429732868757259,0.19757632782842927,0.19936674534851823,129849.38298396752,783.8536308298754,130633.2366147974,524,0,219.52380952380952,35,7,15,36.186028465440224,0.6208333333333333,45.196759259259245,1019.2129629629609,29.12037037037031,0
528,4,1,1,40,0.024390243902439025,0.024390243902439025,0.975609756097561,41,1250,1100,150,0.88,14,11,3,363.24093468803505,0.42891260162601624,0.21374867877869286,0.2047205820845469,129837.58680555549,1232.4652777777687,131070.05208333326,525,0,225.70731707317074,34,7,17,35.95325701826109,0.6228553921568627,45.20833333333333,1019.1666666666661,29.975490196078415,0
529,4,0,0,40,0.0,0.0,1.0,40,1050,700,350,0.6666666666666666,14,7,7,365.3313511799782,0.4281517094017094,0.21624722643933203,0.20621834938392558,129898.25857426293,1491.1812641723238,131389.43983843527,526,1,229.125,34,6,18,35.83829654716027,0.623468137254902,45.14880952380952,1019.404761904761,29.982492997198854,0
530,4,1,1,40,0.024390243902439025,0.024390243902439025,0.975609756097561,41,950,600,350,0.631578947368421,13,6,7,356.14575655313496,0.4301829268292683,0.21088776060761205,0.20215227585420986,130114.93866008637,1067.9766535922258,131182.9153136786,527,0,224.5121951219512,35,6,18,35.852358668935516,0.6235119047619049,44.93634259259258,1020.2546296296279,29.150132275132226,0
531,4,1,1,40,0.024390243902439025,0.024390243902439025,0.975609756097561,41,950,700,250,0.7368421052631579,12,7,5,353.6361174514718,0.4291412601626016,0.21163278057627544,0.20179675473201028,130321.66950660126,1017.2898448216472,131338.9593514229,528,0,225.4878048780488,35,6,19,35.70666137686088,0.6255952380952381,44.73379629629628,1021.0648148148128,29.173280423280367,0
532,4,1,1,40,0.024390243902439025,0.024390243902439025,0.975609756097561,41,600,400,200,0.6666666666666666,8,4,4,353.3236925101719,0.42957317073170737,0.2078297519519101,0.20207916956592756,130410.3186755185,1015.4110671724673,131425.72974269098,529,0,224.70731707317074,35,6,20,35.62476392823416,0.6264880952380953,44.646990740740726,1021.4120370370355,29.183201058201014,0
533,4,2,2,40,0.047619047619047616,0.047619047619047616,0.9523809523809523,42,1150,800,350,0.6956521739130435,15,8,7,345.69808824451553,0.4313419473480449,0.19534191126351463,0.19946823617768009,130751.61944038607,640.1169750831609,131391.73641546923,530,0,220.3095238095238,36,6,15,35.47401453424354,0.6278935185185187,44.31306306306305,1022.7477477477457,28.409659659659603,0
534,4,0,0,40,0.0,0.0,1.0,40,1000,700,300,0.7,13,7,6,362.6900955330753,0.4264022435897436,0.2120281919850886,0.20811041310534198,130536.16780045332,1468.8350340135796,132005.0028344669,531,3,232.325,34,6,16,35.25794113078595,0.6299019607843138,44.52380952380951,1021.9047619047603,30.05602240896354,0
535,4,0,0,40,0.0,0.0,1.0,40,1200,600,600,0.5,18,6,12,363.47324297549324,0.42617521367521366,0.20998253783469156,0.209545983701979,130718.714569161,1502.551020408163,132221.26558956917,532,4,233.325,34,6,16,35.05287155607296,0.6317401960784315,44.345238095238095,1022.6190476190477,30.07703081232493,0
536,4,1,1,40,0.024390243902439025,0.024390243902439025,0.975609756097561,41,850,500,350,0.5882352941176471,12,5,7,385.0210321124449,0.42654979674796745,0.25214662672942545,0.21515881206283688,129504.14540816324,1863.0668934240343,131367.21230158728,533,0,228.609756097561,34,7,17,35.73830409356725,0.619485294117647,45.535714285714285,1017.8571428571427,29.93697478991596,6
537,4,1,1,40,0.024390243902439025,0.024390243902439025,0.975609756097561,41,1150,700,450,0.6086956521739131,16,7,9,384.54335716093334,0.4276676829268293,0.25950288142499556,0.2156530911191238,129643.02722318676,1770.672984182103,131413.70020736885,534,0,229.34146341463415,35,6,17,35.60880497783839,0.6187499999999999,45.39930555555556,1018.4027777777779,29.09722222222223,0
538,4,3,3,40,0.06976744186046512,0.06976744186046512,0.9302325581395349,43,1300,1000,300,0.7692307692307693,16,10,6,368.5364187082389,0.4355389442598745,0.242809600368052,0.20862795072460943,130010.85820877597,982.7472154894028,130993.60542426538,535,0,219.6046511627907,37,6,17,35.642112855248534,0.6185247747747746,45.038377192982466,1019.8464912280717,27.563418681839778,0
539,4,1,2,39,0.024390243902439025,0.04878048780487805,0.9512195121951219,41,600,500,100,0.8333333333333334,7,5,2,384.8453861054386,0.4261432926829268,0.26623407208739813,0.21647245583937225,129760.9247068973,1787.5786340449283,131548.50334094223,536,0,231.29268292682926,35,6,17,35.48092033019047,0.6199404761904761,45.28356481481482,1018.8657407407409,29.110449735449738,0
540,4,3,4,38,0.07142857142857142,0.09523809523809523,0.9047619047619048,42,750,300,450,0.4,12,3,9,377.3159610587855,0.43093060394889665,0.2594076270384509,0.21387534263269595,130061.4867401186,1414.8549732164756,131476.34171333507,537,0,226.45238095238096,36,6,18,35.36675682637817,0.6209490740740741,44.988738738738746,1020.0450450450459,28.334584584584608,0
541,4,2,2,38,0.05,0.05,0.95,40,1200,900,300,0.75,15,9,6,389.52038249305417,0.42844551282051285,0.25005392212509925,0.22009525653504255,129937.87140185611,2122.6898737568545,132060.56127561297,534,0,225.075,35,5,18,35.181466871003146,0.6217261904761905,45.1099537037037,1019.560185185185,29.130291005291,0
542,4,2,0,40,0.05,0.0,1.0,40,1400,1200,200,0.8571428571428571,16,12,4,390.36577535969565,0.42632211538461534,0.266256520753005,0.22208034884656738,130203.5175004286,2165.3994127228966,132368.9169131515,535,0,226.025,35,5,20,34.88933620624479,0.6244047619047619,44.84953703703703,1020.6018518518513,29.160052910052894,0
543,4,1,1,40,0.024390243902439025,0.024390243902439025,0.975609756097561,41,1000,700,300,0.7,13,7,6,379.9933852870684,0.42802337398373985,0.2560873240342909,0.2180842973096258,130544.21864487215,1721.2281022612378,132265.4467471334,536,0,221.4878048780488,33,8,19,34.80770576008316,0.632260101010101,44.51593137254902,1021.9362745098038,30.96776589423648,0
544,4,0,0,40,0.0,0.0,1.0,40,900,600,300,0.6666666666666666,12,6,6,383.85989036291494,0.4267227564102564,0.2568857965451059,0.21977033283415245,130450.30757401,2014.9281526336056,132465.23572664362,537,2,228.025,33,7,20,34.80436260396673,0.6313131313131313,44.6078431372549,1021.5686274509806,30.95662507427214,0
545,4,1,0,41,0.024390243902439025,0.0,1.0,41,850,500,350,0.5882352941176471,12,5,7,374.08236659366247,0.4303607723577236,0.25319423080197767,0.21634346288734413,130840.48327664396,1589.0235260770949,132429.50680272107,538,0,223.4390243902439,34,7,20,34.65814327825614,0.6329656862745099,44.226190476190474,1023.095238095238,30.09103641456582,0
546,4,1,1,41,0.023809523809523808,0.023809523809523808,0.9761904761904762,42,700,300,400,0.42857142857142855,11,3,8,363.78507499779283,0.4320073557878436,0.24431671402738364,0.21176120681450455,131090.9636488339,1137.7872085047863,132228.7508573387,539,0,219.0952380952381,35,7,20,34.66790988547317,0.6333333333333333,43.981481481481474,1024.074074074073,29.259259259259228,0
547,4,0,1,40,0.0,0.024390243902439025,0.975609756097561,41,850,500,350,0.5882352941176471,12,5,7,370.0730454094879,0.4297002032520325,0.24912831191822438,0.21453256718714547,130931.84700963716,1490.8694727891111,132422.71648242627,540,2,225.4390243902439,34,7,20,34.66810127563878,0.6338848039215685,44.13690476190476,1023.4523809523807,30.101540616246492,0
548,4,1,1,40,0.024390243902439025,0.024390243902439025,0.975609756097561,41,1200,800,400,0.6666666666666666,16,8,8,368.75985225507037,0.4290142276422764,0.25192006191827665,0.21478950636089153,131114.67013888876,1469.965277777769,132584.63541666654,541,0,226.2439024390244,34,7,20,34.51654461621916,0.6357230392156863,43.95833333333333,1024.1666666666656,30.122549019607813,0
549,4,0,0,40,0.0,0.0,1.0,40,1200,800,400,0.6666666666666666,16,8,8,375.358291996354,0.42664262820512816,0.25773035613340944,0.21799370273852556,131002.08340031264,1834.543654621031,132836.62705493366,542,4,232.9,35,5,20,34.461677972489184,0.6324404761904763,44.068287037037024,1023.7268518518495,29.249338624338556,0
550,4,1,0,41,0.024390243902439025,0.0,1.0,41,1050,600,450,0.5714285714285714,15,6,9,363.6634329354757,0.4302337398373984,0.2534240367949432,0.21334260793190157,131389.1439909296,1357.0958839425546,132746.23987487215,543,0,228.1951219512195,34,7,21,34.36943605821334,0.6384803921568627,43.69047619047618,1025.2380952380943,30.15406162464983,0
551,4,1,0,42,0.023809523809523808,0.0,1.0,42,800,500,300,0.625,11,5,6,351.69814774095084,0.4319831591173055,0.24540183604445187,0.20824850270108353,131743.6731074244,866.8011616940835,132610.47426911848,544,0,223.73809523809524,35,7,21,34.318395340097716,0.6398809523809523,43.3449074074074,1026.620370370369,29.332010582010543,0
552,4,0,0,42,0.0,0.0,1.0,42,1050,700,350,0.6666666666666666,14,7,7,351.32833296989514,0.4318742740998838,0.24693325606104533,0.20868056404115437,131862.52170138876,865.4079861110924,132727.92968749985,545,1,224.73809523809524,35,7,22,34.20807978363759,0.6410714285714286,43.22916666666666,1027.0833333333321,29.34523809523806,0
553,4,1,0,43,0.023255813953488372,0.0,1.0,43,1200,800,400,0.6666666666666666,16,8,8,343.19423810392624,0.43332410483573275,0.2467178370947416,0.2061196163760267,132282.1316882761,479.693079904226,132761.82476818032,546,0,220.48837209302326,36,7,23,33.99470899470899,0.6432291666666667,42.820945945945944,1028.716216216216,28.575450450450447,0
554,4,0,0,43,0.0,0.0,1.0,43,850,400,450,0.47058823529411764,13,4,9,344.4443845229626,0.43307032115171645,0.2508803013220009,0.20735154257524052,132369.79316953273,518.8063875422962,132888.59955707504,547,1,221.48837209302326,37,6,23,33.874422837861836,0.6421734234234235,42.735745614035075,1029.057017543858,27.812351825509673,0
555,4,0,0,43,0.0,0.0,1.0,43,1300,1000,300,0.7692307692307693,16,10,6,347.56959879618586,0.433047249907715,0.25680233865527313,0.20972076063047998,132457.56842635447,607.6507945583292,133065.2192209128,548,2,222.48837209302326,35,8,23,33.70577542912824,0.6470238095238096,42.650462962962955,1029.3981481481471,29.411375661375633,0
556,4,0,0,43,0.0,0.0,1.0,43,1500,900,600,0.6,21,9,12,345.70675177064953,0.4323089700996678,0.2550942820450872,0.2092315185269749,132571.90626014533,566.2006178475822,133138.10687799292,549,3,223.48837209302326,36,7,23,33.63882813923819,0.6461226851851851,42.539414414414416,1029.8423423423428,28.606731731731745,0
557,4,0,0,43,0.0,0.0,1.0,43,1100,800,300,0.7272727272727273,14,8,6,344.658946809392,0.43217054263565896,0.24754844007820598,0.2089195087120946,132629.89921932074,542.4162760733809,133172.3154953941,550,4,224.48837209302326,36,7,15,33.60755803359937,0.6467013888888888,42.48310810810811,1030.0675675675682,28.612987987988006,0
558,4,0,0,43,0.0,0.0,1.0,43,1300,900,400,0.6923076923076923,17,9,8,343.9028108039646,0.43180140273163525,0.2469656106780007,0.20878346490016397,132687.90486009655,526.3486882152424,133214.2535483118,551,5,225.48837209302326,36,7,15,33.56878711698913,0.6472800925925927,42.4268018018018,1030.2927927927924,28.619244244244232,0
559,4,0,0,43,0.0,0.0,1.0,43,1500,900,600,0.6,21,9,12,344.74580676628585,0.4316629752676264,0.24544273976919562,0.2096191945327762,132745.92318247302,552.7200764954189,133298.64325896846,552,6,226.48837209302326,36,7,15,33.4888263577751,0.6478587962962963,42.3704954954955,1030.5180180180182,28.625500500500507,0
560,4,1,1,43,0.022727272727272728,0.022727272727272728,0.9772727272727273,44,1350,1100,250,0.8148148148148148,16,11,5,336.32699058416216,0.43362403100775193,0.2406984160731367,0.20584437218121107,132991.11415291252,145.700239496774,133136.8143924093,553,0,222.3181818181818,37,7,15,33.459901314623856,0.648367117117117,42.13267543859649,1031.4692982456147,27.87754860123283,0
561,4,0,0,43,0.0,0.0,1.0,43,1000,800,200,0.8,12,8,4,347.6710943614886,0.4309246954595792,0.25019049651010383,0.21221843599825238,132891.0244704162,640.4735816897771,133531.49805210598,554,8,228.48837209302326,36,7,15,33.26780253385757,0.6493055555555557,42.22972972972972,1031.0810810810797,28.6411411411411,0
562,4,1,0,44,0.022727272727272728,0.0,1.0,44,700,300,400,0.42857142857142855,11,3,8,340.8236205065229,0.4325999823819591,0.24722337579556353,0.2095475336269036,133160.8178117303,276.8704072406632,133437.68821897096,555,0,224.27272727272728,37,7,16,33.17386858599809,0.6500563063063064,41.96820175438595,1032.1271929824543,27.89532954006633,0
563,4,0,1,43,0.0,0.022727272727272728,0.9772727272727273,44,1100,700,400,0.6363636363636364,15,7,8,338.1879540905235,0.432522903453136,0.24550184366493566,0.20871914492952467,133302.3201850568,216.2477877808399,133518.56797283763,556,1,225.27272727272728,37,7,16,33.10018050541515,0.6514639639639641,41.831140350877185,1032.6754385964903,27.910146989094333,0
564,4,0,0,43,0.0,0.0,1.0,43,1200,1000,200,0.8333333333333334,14,10,4,338.402046204097,0.4295173495754891,0.2407697541468652,0.208630591167018,133263.00643272034,419.5112247708424,133682.51765749117,557,2,231.09302325581396,35,8,18,33.13401431080222,0.6550595238095238,41.86921296296296,1032.523148148148,29.500661375661373,1
565,4,0,1,42,0.0,0.023255813953488372,0.9767441860465116,43,1200,1100,100,0.9166666666666666,13,11,2,343.45533010258004,0.429655777039498,0.24240655727454152,0.2125993256931782,133412.42953746565,564.2420053154875,133976.67154278114,558,3,232.09302325581396,35,8,18,32.85392859810291,0.656547619047619,41.72453703703703,1033.1018518518513,29.51719576719575,0
566,4,0,0,42,0.0,0.0,1.0,42,1050,800,250,0.7619047619047619,13,8,5,351.4587779983226,0.4261154665118079,0.25032249210923574,0.2170039074117754,133318.49666950098,971.1911848072398,134289.68785430823,559,13,238.54761904761904,34,8,18,32.74135446685879,0.6577818627450981,41.81547619047618,1032.738095238094,30.374649859943943,0
567,4,0,0,42,0.0,0.0,1.0,42,900,600,300,0.6666666666666666,12,6,6,349.77092677171964,0.42542586140147115,0.24465372572239374,0.2166832104990381,133442.324205354,934.8490815757795,134377.17328692978,560,14,239.54761904761904,35,7,18,32.66086497890295,0.6568452380952381,41.69560185185185,1033.217592592592,29.520502645502628,0
568,4,0,0,42,0.0,0.0,1.0,42,1050,500,550,0.47619047619047616,16,5,11,349.65993130754083,0.4255589430894309,0.24472636324744124,0.21714932214678612,133533.73724489796,938.28282743781,134472.02007233576,561,15,240.54761904761904,34,8,19,32.5721799892498,0.6599264705882353,41.607142857142854,1033.5714285714284,30.399159663865543,0
569,4,0,1,41,0.0,0.023809523809523808,0.9761904761904762,42,850,600,250,0.7058823529411765,11,6,5,348.42264387576597,0.4252322880371661,0.23950708665734588,0.2169211944129768,133626.03635204083,911.6673752834536,134537.7037273243,562,16,241.54761904761904,34,8,19,32.51175398196125,0.660845588235294,41.517857142857146,1033.9285714285716,30.40966386554622,0
570,4,0,0,41,0.0,0.0,1.0,41,800,600,200,0.75,10,6,4,357.6448388691073,0.42517784552845533,0.24736114565319212,0.22211904057599802,133535.54672481748,1351.6598183391084,134887.2065431566,563,17,247.6341463414634,33,8,19,32.36404236819222,0.6622474747474747,41.60539215686275,1033.5784313725499,31.320558526440905,0
571,4,0,0,41,0.0,0.0,1.0,41,1000,800,200,0.8,12,8,4,356.5135081679438,0.42444105691056916,0.24979402573449705,0.22198556962457153,133630.5616379518,1328.2200655997733,134958.78170355156,564,18,248.6341463414634,33,8,20,32.298086800205446,0.6631944444444444,41.513480392156865,1033.9460784313728,31.331699346405237,0
572,4,0,0,41,0.0,0.0,1.0,41,1100,700,400,0.6363636363636364,15,7,8,356.6849139263233,0.4238313008130081,0.2479429131298061,0.22247331771058726,133693.9236862026,1337.3211324971332,135031.24481869972,565,19,249.6341463414634,33,8,20,32.23019611328356,0.6638257575757576,41.45220588235295,1034.1911764705894,31.33912655971483,0
573,4,0,0,41,0.0,0.0,1.0,41,950,700,250,0.7368421052631579,12,7,5,358.72415833599047,0.4237042682926829,0.24597058381763315,0.2247082190644737,133852.39451172636,1403.2175124952048,135255.61202422157,566,20,250.6341463414634,33,8,19,32.01879046265592,0.6654040404040403,41.29901960784314,1034.8039215686283,31.357694592988736,0
574,4,0,0,41,0.0,0.0,1.0,41,1150,900,250,0.782608695652174,14,9,5,356.00400825156373,0.4224847560975609,0.24506319172342894,0.22358110466178152,133947.52206182736,1337.1709498750702,135284.69301170242,567,21,251.6341463414634,33,8,19,31.99397715165149,0.66635101010101,41.207107843137265,1035.1715686274522,31.368835412953096,0
575,4,0,0,41,0.0,0.0,1.0,41,1150,800,350,0.6956521739130435,15,8,7,335.97359789934245,0.42225609756097565,0.20914744409650265,0.19557199961930133,131090.9636488339,609.9759400022854,131700.93958883616,568,22,252.6341463414634,35,6,18,35.379935201928866,0.6333333333333333,43.981481481481474,1024.074074074073,29.259259259259228,6
576,4,1,1,41,0.023809523809523808,0.023809523809523808,0.9761904761904762,42,1200,900,300,0.75,15,9,6,333.27537872364394,0.4247120596205962,0.2067533347312056,0.19535539572172816,131357.7852393046,355.8774594907285,131713.66269879532,569,0,247.5952380952381,35,7,18,35.17991889654135,0.6360119047619048,43.72106481481481,1025.1157407407397,29.289021164021136,0
577,4,0,0,41,0.0,0.0,1.0,41,1150,800,350,0.6956521739130435,15,8,7,341.72780752197775,0.4223831300813008,0.21257188181637932,0.20015485869144406,131328.12499999997,775.6944444444435,132103.8194444444,570,24,254.6341463414634,34,7,19,34.99322493224933,0.6378676470588236,43.75,1024.9999999999998,30.147058823529406,0
578,4,1,1,41,0.023809523809523808,0.023809523809523808,0.9761904761904762,42,1400,800,600,0.5714285714285714,20,8,12,333.1681625877411,0.4245184862562911,0.19938294478725282,0.19681559611362417,131654.57182623874,372.6223583247423,132027.19418456347,571,0,249.54761904761904,35,7,15,34.88367448592158,0.6389880952380953,43.431712962962955,1026.2731481481471,29.322089947089918,0
579,4,1,0,42,0.023809523809523808,0.0,1.0,42,1050,800,250,0.7619047619047619,13,8,5,333.88329102362104,0.4245668795973674,0.21380276248430463,0.19831862948752413,131862.5217013888,405.3385416666618,132267.86024305545,572,0,250.52380952380952,35,7,17,34.65601757944558,0.6410714285714285,43.229166666666664,1027.0833333333326,29.345238095238074,0
580,4,0,0,42,0.0,0.0,1.0,42,1350,1100,250,0.8148148148148148,16,11,5,333.5646457268079,0.42437330623306235,0.21660231660231655,0.1990627724498691,132040.8950617283,408.8348765431984,132449.7299382715,573,1,251.52380952380952,35,7,17,34.48479729729729,0.6428571428571428,43.05555555555555,1027.7777777777771,29.365079365079346,0
581,4,1,1,42,0.023255813953488372,0.023255813953488372,0.9767441860465116,43,700,300,400,0.42857142857142855,11,3,8,328.5534432073829,0.42681801402731634,0.18547290978240505,0.18923785410184346,130682.67549871115,-12.751399469070122,130669.92409924208,574,0,246.65116279069767,37,6,17,35.98201519213583,0.6252815315315314,44.38048245614035,1022.4780701754387,27.63454243717402,7
582,4,0,1,41,0.0,0.023809523809523808,0.9761904761904762,42,800,600,200,0.75,10,6,4,333.1898105165194,0.42600658149438636,0.1879087795488279,0.19182183193909189,130665.25298524876,307.2661766496198,130972.51916189838,575,1,252.5952380952381,36,6,17,35.88110841869515,0.627025462962963,44.39752252252252,1022.40990990991,28.400275275275277,0
583,4,1,0,42,0.023809523809523808,0.0,1.0,42,950,600,350,0.631578947368421,13,6,7,335.92916396770977,0.4259944831591173,0.20774575924790528,0.19455629783139455,130895.62694028488,394.3317050158274,131289.9586453007,576,0,252.83333333333334,36,6,18,35.57829866842745,0.6293402777777778,44.1722972972973,1023.3108108108108,28.4253003003003,0
584,4,0,1,41,0.0,0.023809523809523808,0.9761904761904762,42,1300,1000,300,0.7692307692307693,16,10,6,333.8681724306965,0.4261517615176152,0.13186813186813207,0.18714995720656455,129625.34722222206,256.26889558475546,129881.61611780681,577,1,253.83333333333334,39,3,16,36.91693944353519,0.6111111111111113,45.41666666666666,1018.333333333332,26.11111111111108,8
585,4,0,2,39,0.0,0.04878048780487805,0.9512195121951219,41,1300,900,400,0.6923076923076923,17,9,8,341.0087257816023,0.4236280487804878,0.14731379793865096,0.1912055984794253,129636.22708013713,641.4169223463891,130277.64400248352,578,2,260.9512195121951,38,3,17,36.72410476989788,0.6129385964912282,45.405982905982896,1018.3760683760668,26.79937022042281,0
586,4,0,0,39,0.0,0.0,1.0,39,900,500,400,0.5555555555555556,13,5,8,348.1717771812687,0.418072424651372,0.17941060524845498,0.1949115193495884,129573.74762854083,1222.7843975732633,130796.5320261141,579,3,274.28205128205127,36,3,17,36.60523356560852,0.6160300925925926,45.46734234234235,1018.1306306306317,28.281406406406436,0
587,4,1,1,39,0.025,0.025,0.975,40,900,800,100,0.8888888888888888,10,8,2,339.5094912122266,0.420579594017094,0.17371974179666516,0.1913729970174435,129843.17440221985,816.5980157356057,130659.77241795546,580,0,268.4,37,3,17,36.55224583109199,0.6168355855855856,45.20285087719298,1019.1885964912276,27.54563774300615,0
588,4,2,2,39,0.04878048780487805,0.04878048780487805,0.9512195121951219,41,800,500,300,0.625,11,5,6,335.31350218428844,0.4215193089430895,0.17989336928545208,0.19064967695620966,130180.80210387896,530.2761341222824,130711.07823800124,581,0,262.8048780487805,38,3,19,36.31700167504188,0.618421052631579,44.87179487179487,1020.51282051282,26.855600539811054,0
589,4,0,1,38,0.0,0.02564102564102564,0.9743589743589743,39,1000,700,300,0.7,13,7,6,352.74061421688003,0.4172008547008547,0.18754902377210492,0.19950445107644274,129975.3485537903,1369.5168563834134,131344.86541017372,582,1,275.71794871794873,36,3,19,36.08089453340697,0.6200810185185186,45.0731981981982,1019.7072072072075,28.325200200200207,0
590,4,0,0,38,0.0,0.0,1.0,38,950,700,250,0.7368421052631579,12,7,5,357.9458725158879,0.4159998814604078,0.19076931347777015,0.20256012092084036,129996.88042534703,1706.3693576388655,131703.2497829859,583,2,279.13157894736844,35,3,20,35.926327885597544,0.6223214285714287,45.05208333333332,1019.791666666665,29.136904761904717,0
591,4,0,0,38,0.0,0.0,1.0,38,700,400,300,0.5714285714285714,10,4,6,357.06447963793664,0.4161628733997155,0.19215333807115131,0.20236715492277363,130055.9028447571,1687.668654621026,131743.57149937813,584,3,280.13157894736844,35,3,20,35.888862097658766,0.6229166666666668,44.99421296296295,1020.0231481481459,29.143518518518455,0
592,4,0,0,38,0.0,0.0,1.0,38,650,300,350,0.46153846153846156,10,3,7,356.94342946883665,0.4162073257467995,0.1953172584285765,0.20245169802691915,130085.419077932,1686.6271219135685,131772.0461998456,585,4,281.13157894736844,35,3,21,35.861980939414565,0.6232142857142857,44.96527777777777,1020.1388888888881,29.146825396825374,0
593,4,0,0,38,0.0,0.0,1.0,38,1150,900,250,0.782608695652174,14,9,5,354.8630641243631,0.4165333096254149,0.1905007728528716,0.20203598208603962,130233.05047850205,1642.9798686128033,131876.03034711484,586,5,282.13157894736844,35,3,22,35.76522753902558,0.6247023809523811,44.82060185185184,1020.7175925925911,29.163359788359745,0
594,4,0,0,38,0.0,0.0,1.0,38,800,500,300,0.625,11,5,6,355.01874219075404,0.41613323850165956,0.19172932330827086,0.2022781205505457,130262.58680555539,1649.1319444444248,131911.71874999983,587,6,283.13157894736844,35,3,22,35.73129251700679,0.625,44.79166666666666,1020.833333333332,29.16666666666663,0
595,4,0,0,38,0.0,0.0,1.0,38,1050,800,250,0.7619047619047619,13,8,5,355.320594820599,0.41534791370317686,0.1946473833308484,0.20322127344729635,130410.31867551846,1667.4944005057998,132077.81307602426,588,7,284.13157894736844,35,3,23,35.57377242681774,0.6264880952380953,44.646990740740726,1021.4120370370351,29.183201058201004,0
596,4,1,0,39,0.02564102564102564,0.0,1.0,39,900,600,300,0.6666666666666666,12,6,6,347.6897780437028,0.41784750337381915,0.1901309437094505,0.2006174437225482,130751.61944038632,1292.2003084165226,132043.81974880284,589,0,277.8205128205128,36,3,19,35.423089627835274,0.6278935185185186,44.31306306306306,1022.7477477477477,28.409659659659656,0
597,4,0,0,39,0.0,0.0,1.0,39,1100,800,300,0.7272727272727273,14,8,6,349.8556541742795,0.4175101214574899,0.1963921409282916,0.20262194579233106,130895.62694028465,1358.9150383491326,132254.5419786338,590,1,278.8205128205128,36,3,19,35.22202046880158,0.6293402777777779,44.172297297297284,1023.310810810809,28.42530030030025,0
598,4,0,0,39,0.0,0.0,1.0,39,1100,1000,100,0.9090909090909091,12,10,2,349.8495064027857,0.41680724246513723,0.19192124340639194,0.20307356406138677,130982.06948502533,1364.8024713902807,132346.87195641562,591,2,279.8205128205128,36,3,19,35.13476347634764,0.6302083333333335,44.087837837837824,1023.6486486486467,28.43468468468463,0
599,4,0,0,39,0.0,0.0,1.0,39,1150,600,550,0.5217391304347826,17,6,11,337.7841696378306,0.41635739991003146,0.10617211099402879,0.20132466021849818,131992.6741564201,1124.6192983524213,133117.29345477253,592,3,280.8205128205128,36,3,17,34.42488584474886,0.6403356481481481,43.102477477477485,1027.5900900900913,28.5441691691692,5
600,4,0,0,39,0.0,0.0,1.0,39,1100,800,300,0.7272727272727273,14,8,6,336.45375892555535,0.415429599640126,0.11103089174761549,0.20118561503099525,132116.0357032932,1090.1873653431658,133206.22306863635,593,4,281.8205128205128,37,2,18,34.3350042662116,0.6396396396396395,42.98245614035087,1028.0701754385955,27.785680417259336,0
601,4,1,0,40,0.025,0.0,1.0,40,900,500,400,0.5555555555555556,13,5,8,334.7561787716167,0.4168803418803419,0.1281933508311459,0.2024477843047397,132542.91453615788,874.5130651820583,133417.42760133994,594,0,275.75,36,4,20,33.94985783027121,0.6458333333333334,42.56756756756757,1029.7297297297305,28.603603603603624,0
602,4,0,0,40,0.0,0.0,1.0,40,550,200,350,0.36363636363636365,9,2,7,335.1687748122452,0.41641292735042734,0.12824696621843223,0.20316691737624998,132629.89921932085,890.6801649622827,133520.57938428313,595,1,276.75,36,4,17,33.85194599322184,0.6467013888888888,42.48310810810812,1030.067567567569,28.61298798798803,0
603,4,0,1,39,0.0,0.025,0.975,40,850,500,350,0.5882352941176471,12,5,7,338.6098956273878,0.4153445512820513,0.13771547137688822,0.20583802064076295,132736.76155163156,989.1961949831008,133725.95774661464,596,2,277.75,37,3,17,33.656097041923815,0.6458333333333333,42.379385964912295,1030.482456140353,27.850877192982512,0
604,4,0,1,38,0.0,0.02564102564102564,0.9743589743589743,39,1150,1100,50,0.9565217391304348,12,11,1,346.82387600156795,0.4125337381916329,0.14059670193499185,0.21006961390134737,132600.90115453317,1397.8316999432145,133998.7328544764,597,3,285.6923076923077,36,3,20,33.580937021648815,0.6464120370370369,42.511261261261275,1029.954954954957,28.609859859859917,0
605,4,1,1,38,0.02564102564102564,0.02564102564102564,0.9743589743589743,39,1700,1400,300,0.8235294117647058,20,14,6,342.37322722171183,0.4127024291497976,0.13260813260813276,0.20922808330215742,132934.57031250015,1302.6475694444598,134237.2178819446,598,0,281.53846153846155,37,2,17,33.360690235690235,0.647804054054054,42.18750000000001,1031.2500000000011,27.871621621621653,0
606,4,0,0,38,0.0,0.0,1.0,38,1150,700,450,0.6086956521739131,16,7,9,353.45601677298106,0.4106063300142247,0.1459183790807579,0.21541520489613006,132832.97444403885,1790.1228086194483,134623.0972526583,599,5,289.94736842105266,36,2,17,33.17698091908817,0.6487268518518519,42.286036036036045,1030.8558558558575,28.63488488488493,0
607,4,1,0,39,0.02564102564102564,0.0,1.0,39,1000,900,100,0.9,11,9,2,347.3537583245455,0.4118589743589744,0.1535356836472077,0.2138872226700849,133217.40974386354,1454.7135897583935,134672.12333362192,600,0,283.4871794871795,37,2,19,32.94864135245177,0.6506193693693694,41.91337719298246,1032.3464912280706,27.901256519677585,0
608,4,0,0,39,0.0,0.0,1.0,39,900,800,100,0.8888888888888888,10,8,2,349.25823735637937,0.41174651372019794,0.14846638460993944,0.21555138135140126,133302.32018505692,1511.3866766697422,134813.70686172665,601,1,284.4871794871795,37,2,19,32.81438026474127,0.6514639639639639,41.83114035087719,1032.6754385964912,27.910146989094358,0
609,4,0,0,39,0.0,0.0,1.0,39,800,700,100,0.875,9,7,2,359.3668442064139,0.41174651372019794,0.1390409459163564,0.21566732949943443,132253.17166829028,1705.5891941157374,133958.76086240602,602,2,285.4871794871795,36,3,18,33.607948324939805,0.6429398148148147,42.84909909909912,1028.6036036036066,28.572322322322407,2
610,4,0,0,39,0.0,0.0,1.0,39,1100,1000,100,0.9090909090909091,12,10,2,359.27151236590055,0.4116621682411156,0.1411308997515892,0.21577549411324845,132282.1316882765,1705.0403021264913,133987.171990403,603,3,286.4871794871795,36,3,19,33.581235176062776,0.6432291666666665,42.820945945945965,1028.7162162162192,28.575450450450532,0
611,4,0,0,39,0.0,0.0,1.0,39,1000,700,300,0.7,13,7,6,360.18312131063016,0.41115609536662173,0.14356788656202624,0.2168260804041225,132369.7931695332,1735.4730542090197,134105.26622374222,604,4,287.4871794871795,37,2,19,33.469521399396214,0.6421734234234233,42.7357456140351,1029.0570175438618,27.81235182550978,0
612,4,0,0,39,0.0,0.0,1.0,39,1000,600,400,0.6,14,6,8,361.0942647806058,0.4108468286099865,0.1405584968338005,0.21753727658734098,132398.0034722225,1761.6319444444796,134159.63541666698,605,5,288.4871794871795,38,1,19,33.41767881241567,0.6406249999999998,42.70833333333335,1029.166666666669,27.083333333333396,0
613,4,0,0,39,0.0,0.0,1.0,39,1150,900,250,0.782608695652174,14,9,5,358.51028816518624,0.4102564102564103,0.143722113316338,0.21664636911396587,132513.92598257068,1701.5211579823363,134215.447140553,606,6,289.4871794871795,36,3,19,33.367512486784065,0.6455439814814813,42.595720720720735,1029.6171171171193,28.600475475475534,0
614,4,0,0,39,0.0,0.0,1.0,39,500,200,300,0.4,8,2,6,351.1433145645096,0.40935672514619886,0.10763663357149511,0.20833284876472116,131819.15181651246,1457.482778386498,133276.63459489896,607,7,290.4871794871795,36,3,15,34.256543115107654,0.638599537037037,43.2713963963964,1026.9144144144145,28.525400400400404,2
615,4,0,0,39,0.0,0.0,1.0,39,650,400,250,0.6153846153846154,9,4,5,351.26175596526997,0.40868196131354023,0.1077018637031788,0.20903855183764913,131934.82069485038,1468.731358047248,133403.55205289763,608,8,291.4871794871795,36,3,15,34.1369341225474,0.6397569444444444,43.15878378378379,1027.364864864866,28.537912912912944,0
616,4,0,0,39,0.0,0.0,1.0,39,1200,800,400,0.6666666666666666,16,8,8,348.90381686190943,0.40817588843904634,0.1052888828962446,0.2084289293400205,132079.4781267756,1416.6068095122307,133496.0849362878,609,9,292.4871794871795,36,3,15,34.051818580192815,0.6412037037037036,43.018018018018026,1027.9279279279292,28.553553553553588,0
617,4,0,0,39,0.0,0.0,1.0,39,1100,800,300,0.7272727272727273,14,8,6,345.0478076599138,0.4077822762033288,0.10711670913103788,0.2075674850451362,132343.03232750748,1332.9346327343114,133675.96696024179,610,10,293.4871794871795,38,1,16,33.88580278960301,0.6400767543859649,42.761752136752136,1028.9529914529915,27.07771030139451,1
618,4,0,0,39,0.0,0.0,1.0,39,1400,1200,200,0.8571428571428571,16,12,4,345.53561155602904,0.4069107062528115,0.10763715395809959,0.20894558455393894,132539.10007165684,1359.4072139433788,133898.5072856002,611,11,294.4871794871795,37,2,16,33.676192631242685,0.6438626126126126,42.57127192982457,1029.714912280703,27.830132764343322,0
619,4,0,0,39,0.0,0.0,1.0,39,650,300,350,0.46153846153846156,10,3,7,350.65626106043555,0.40696693657219973,0.12517674479521634,0.20523767616551297,131300.74929003205,1408.2859640952493,132709.0352541273,612,12,295.4871794871795,38,1,15,34.792079293929596,0.6296600877192983,43.7767094017094,1024.8931623931617,26.970872694556885,2
620,4,0,0,39,0.0,0.0,1.0,39,700,500,200,0.7142857142857143,9,5,4,352.5628136012075,0.4066857849752587,0.12910745973105597,0.20665264854907106,131356.2240905853,1462.2668434500338,132818.49093403533,613,13,296.4871794871795,37,2,16,34.687199165686174,0.6320382882882885,43.72258771929823,1025.109649122805,27.705666192508243,0
621,4,0,0,39,0.0,0.0,1.0,39,1000,800,200,0.8,12,8,4,354.25889144302437,0.4071637426900585,0.13055955268675756,0.2085646274039957,131524.88175448202,1518.7717615035242,133043.65351598556,614,14,297.4871794871795,37,2,16,34.473432210938874,0.6337274774774775,43.55811403508771,1025.7675438596482,27.723447131341842,0
622,4,0,0,39,0.0,0.0,1.0,39,1000,700,300,0.7,13,7,6,354.1604841465377,0.40671390013495273,0.13367967076024345,0.20896808389932522,131609.25116381957,1522.1592220683197,133131.4103858879,615,15,298.4871794871795,37,2,14,34.390806440122525,0.6345720720720721,43.47587719298245,1026.0964912280697,27.73233760075864,0
623,4,0,0,39,0.0,0.0,1.0,39,950,600,350,0.631578947368421,13,6,7,367.8191095807881,0.4066857849752587,0.19265889947348014,0.21181968800760595,130676.44702717729,1878.3794571524954,132554.8264843298,616,16,299.4871794871795,35,4,17,34.9846238019772,0.6291666666666669,44.386574074074055,1022.4537037037009,29.21296296296288,5
624,4,0,0,39,0.0,0.0,1.0,39,1550,1300,250,0.8387096774193549,18,13,5,367.736123338998,0.40629217273954116,0.195591135862629,0.21274786193172385,130854.016632373,1823.9497599451147,132677.9663923181,617,17,300.4871794871795,35,4,17,34.80674962292607,0.630952380952381,44.212962962962955,1023.1481481481472,29.232804232804206,0
625,4,3,2,40,0.07142857142857142,0.047619047619047616,0.9523809523809523,42,650,500,150,0.7692307692307693,8,5,3,348.55755422448465,0.4180821718931475,0.17937967446146597,0.20490627307741066,131468.65051025304,765.735594629763,132234.3861048828,618,0,279.95238095238096,37,5,18,34.67637389073024,0.6331644144144144,43.61293859649122,1025.5482456140342,27.717520151730653,0
626,4,1,1,40,0.024390243902439025,0.024390243902439025,0.975609756097561,41,1300,1000,300,0.7692307692307693,16,10,6,347.1044721479649,0.41328760162601624,0.14788896786698813,0.1962142544987187,129954.95158366027,824.862217220671,130779.81380088093,619,0,287.7560975609756,37,4,18,36.24527278918879,0.6179617117117118,45.09320175438596,1019.6271929824554,27.557491702228525,4
627,4,0,0,40,0.0,0.0,1.0,40,1300,1000,300,0.7692307692307693,16,10,6,356.11201143409585,0.41059027777777773,0.15021268368136176,0.20082054925171355,129860.54202428783,1248.9797652382174,131109.52178952604,620,1,295.925,36,4,18,36.11157146539978,0.6189236111111112,45.185810810810814,1019.256756756757,28.312687687687696,0
628,4,0,0,40,0.0,0.0,1.0,40,1250,1000,250,0.8,15,10,5,356.0487200177305,0.4105769230769231,0.14957486749116633,0.20152357553003533,130004.05811216617,1257.555697589478,131261.61380975565,621,2,296.925,36,4,18,35.967406507656065,0.6203703703703705,45.04504504504504,1019.8198198198194,28.328328328328315,0
629,4,0,0,40,0.0,0.0,1.0,40,1000,700,300,0.7,13,7,6,356.9004853575403,0.41010950854700856,0.1566260072855723,0.20245219141227025,130090.20580969482,1285.8515187484743,131376.0573284433,622,3,297.925,36,4,20,35.85821650660483,0.6212384259259259,44.960585585585584,1020.1576576576575,28.337712712712708,0
630,4,0,0,40,0.0,0.0,1.0,40,950,700,250,0.7368421052631579,12,7,5,357.8327461271194,0.41022970085470084,0.15829470198675533,0.20313061904208646,130118.92804967119,1312.1626694261731,131431.09071909735,623,4,298.925,36,4,20,35.805279617365706,0.6215277777777779,44.93243243243243,1020.2702702702694,28.340840840840816,0
631,4,1,1,40,0.024390243902439025,0.024390243902439025,0.975609756097561,41,950,800,150,0.8421052631578947,11,8,3,347.276901096047,0.4135162601626016,0.15017354294598984,0.1990114492258894,130486.54994806078,862.9929401354075,131349.54288819619,624,0,292.609756097561,37,4,22,35.701956786148656,0.6233108108108109,44.57236842105262,1021.7105263157882,27.61379800853482,0
632,4,1,0,41,0.024390243902439025,0.0,1.0,41,950,800,150,0.8421052631578947,11,8,3,347.5176104685584,0.41209349593495936,0.16573750206020765,0.19987086257855446,130626.62459843408,879.0104888042392,131505.6350872383,625,0,293.5853658536585,37,4,18,35.553983875004455,0.6247184684684686,44.435307017543856,1022.2587719298241,27.628615457562812,0
633,4,1,2,40,0.023809523809523808,0.047619047619047616,0.9523809523809523,42,1100,600,500,0.5454545454545454,16,6,10,331.00452796257736,0.414017131242741,0.16331194887669276,0.18833152207424098,130208.06081753618,219.89154156624096,130427.95235910242,626,0,287.57142857142856,38,4,17,36.399342265954836,0.6186951754385963,44.84508547008548,1020.6196581196598,26.85841205578052,5
634,4,0,0,40,0.0,0.0,1.0,40,1200,800,400,0.6666666666666666,16,8,8,345.36529283047616,0.40849358974358974,0.1763361307420499,0.1954767557420496,130004.05811216631,979.777919811716,130983.83603197803,627,1,302.75,36,4,17,36.239785777385165,0.6203703703703705,45.04504504504505,1019.8198198198205,28.328328328328347,0
635,4,0,0,40,0.0,0.0,1.0,40,1050,600,450,0.5714285714285714,15,6,9,346.82518797908455,0.4085470085470086,0.17340507726269294,0.1968819676121873,130118.92804967148,1025.7043360928706,131144.63238576436,628,2,303.75,36,4,18,36.086046725533485,0.6215277777777777,44.93243243243244,1020.2702702702718,28.340840840840883,0
636,4,1,1,40,0.024390243902439025,0.024390243902439025,0.975609756097561,41,1050,800,250,0.7619047619047619,13,8,5,339.63527967433185,0.41277947154471545,0.16669677807889238,0.19421133395742177,130402.5412266274,657.8607119498364,131060.40193857724,629,0,297.3170731707317,37,4,18,35.98217480765792,0.6224662162162161,44.6546052631579,1021.3815789473683,27.604907539118063,0
637,4,1,0,41,0.024390243902439025,0.0,1.0,41,1100,900,200,0.8181818181818182,13,9,4,347.6204849351087,0.41224593495934964,0.18440970169941884,0.20036518186061963,130710.70545744857,887.5437634656959,131598.24922091427,630,0,298.2926829268293,37,4,15,35.466259203660016,0.625563063063063,44.3530701754386,1022.5877192982466,27.63750592697964,0
638,4,0,0,41,0.0,0.0,1.0,41,950,700,250,0.7368421052631579,12,7,5,349.52495520596403,0.4119664634146341,0.18386813370706556,0.20175549394562095,130766.77439212073,941.2501923668855,131708.0245844876,631,1,299.2926829268293,37,4,15,35.36083118925097,0.6261261261261261,44.29824561403509,1022.8070175438603,27.643432906590817,0
639,4,1,0,42,0.023809523809523808,0.0,1.0,42,900,700,200,0.7777777777777778,11,7,4,310.8574907446905,0.4153116531165311,0.06746845150944702,0.17205483482870634,129125.75511975626,-361.9470703505336,128763.80804940572,632,0,293.14285714285717,41,1,19,38.00908979990239,0.6028963414634146,45.907738095238095,1016.3690476190478,24.78948896631824,8
640,4,1,1,42,0.023255813953488372,0.023255813953488372,0.9767441860465116,43,1100,600,500,0.5454545454545454,16,6,10,303.16662131519286,0.4192045035068291,0.06754817275747493,0.16896228894955,129398.49242833958,-754.1392494441508,128644.35317889543,633,0,287.30232558139534,42,1,21,37.9281746031746,0.6041666666666667,45.63953488372093,1017.4418604651157,24.224806201550376,0
641,4,1,0,43,0.023255813953488372,0.0,1.0,43,500,300,200,0.6,7,3,4,305.06421519180464,0.41823551125876707,0.07605519049221576,0.17044651682844209,129497.10053482343,-699.0137311459846,128798.08680367745,634,0,288.27906976744185,42,1,16,37.7800520436659,0.6051587301587302,45.54263565891472,1017.8294573643395,24.234034699150943,0
642,4,1,1,43,0.022727272727272728,0.022727272727272728,0.9772727272727273,44,1100,600,500,0.5454545454545454,16,6,10,302.5947312847707,0.42212825933756165,0.07896792884714454,0.1706038288537447,129852.06400833608,-941.4899169249436,128910.57409141114,635,0,282.70454545454544,43,1,18,37.4838373749574,0.6073158914728684,45.19412878787878,1019.2234848484838,23.702871740662417,0
643,4,0,0,43,0.0,0.0,1.0,43,1000,600,400,0.6,14,6,8,309.306429544012,0.417843300110742,0.0756720656010339,0.17412561097884477,129793.15020130952,-570.8288263926889,129222.32137491682,636,2,290.27906976744185,42,1,19,37.37241663496895,0.6081349206349209,45.2519379844961,1018.9922480620114,24.26172019195265,0
644,4,1,0,44,0.022727272727272728,0.0,1.0,44,1150,800,350,0.6956521739130435,15,8,7,302.06907127929685,0.4184725158562368,0.08992810308599819,0.1713633546546528,130093.46954093451,-940.5572952537104,129152.91224568081,637,0,284.65909090909093,43,1,20,37.25333781985828,0.6097383720930234,44.957386363636346,1020.1704545454513,23.724894291754683,0
645,4,0,0,44,0.0,0.0,1.0,44,950,700,250,0.7368421052631579,12,7,5,304.6725200661067,0.41812015503875966,0.09601560852140922,0.1730546338277434,130141.7775500025,-869.8753335916344,129271.90221641086,638,1,285.65909090909093,43,1,20,37.13814771848413,0.6102228682170544,44.91003787878786,1020.3598484848455,23.72929880197315,0
646,4,0,0,44,0.0,0.0,1.0,44,1350,800,550,0.5925925925925926,19,8,11,313.3995529163057,0.418208245243129,0.07903372538826381,0.1777140603190147,130076.5638563369,-646.5884206051951,129429.9754357317,639,2,286.65909090909093,39,5,18,36.98145358929847,0.6156517094017094,44.973958333333336,1020.1041666666674,26.156517094017115,2
647,4,0,0,44,0.0,0.0,1.0,44,1100,700,400,0.6363636363636364,15,7,8,315.48164807967765,0.41769071529245944,0.07617127692150638,0.17938326791854925,130182.84640842023,-585.9402126736004,129596.90619574663,640,3,287.65909090909093,39,5,19,36.82090180667552,0.6167200854700854,44.86979166666667,1020.520833333334,26.167200854700873,0
648,4,2,2,44,0.043478260869565216,0.043478260869565216,0.9565217391304348,46,1250,800,450,0.64,17,8,9,301.85256985423007,0.42445652173913045,0.07026888105071016,0.17340617186239476,130581.79253472213,-1316.661241319448,129265.13129340268,641,0,276.10869565217394,39,7,14,36.76620464737056,0.6207264957264957,44.479166666666664,1022.0833333333326,26.207264957264936,0
649,4,1,2,43,0.022222222222222223,0.044444444444444446,0.9555555555555556,45,1000,500,500,0.5,15,5,10,297.88185516120416,0.41898148148148145,0.01978494623655913,0.16330821963017805,128747.91843820877,-1329.666241496584,127418.25219671219,642,0,283.22222222222223,41,4,17,38.7218963831867,0.5990853658536585,46.27976190476191,1014.8809523809537,24.753193960511066,6
650,4,0,0,43,0.0,0.0,1.0,43,1050,900,150,0.8571428571428571,12,9,3,312.4790015978716,0.41320598006644516,0.025008716750968496,0.1707587271358066,128619.58007812499,-561.8164062500014,128057.76367187499,643,1,295.6744186046512,39,4,17,38.48197781885399,0.6009615384615385,46.40625,1014.3749999999999,26.009615384615383,0
651,4,1,0,44,0.022727272727272728,0.0,1.0,44,800,400,400,0.5,12,4,8,308.3231196646671,0.41412306201550386,0.03708876191862598,0.16964562839699082,128891.61544054464,-851.9470057505414,128039.6684347941,644,0,289.9318181818182,40,4,19,38.311065519081936,0.6020833333333333,46.13821138211382,1015.4471544715446,25.386178861788615,0
652,4,1,1,44,0.022222222222222223,0.022222222222222223,0.9777777777777777,45,1400,900,500,0.6428571428571429,19,9,10,301.5801403962753,0.4147516835016835,0.03682589266345593,0.16681355065979722,129100.54878432858,-1213.167674477196,127887.38110985138,645,0,284.46666666666664,41,4,20,38.2703696472732,0.6026422764227642,45.932539682539684,1016.2698412698415,24.787069299264427,0
653,4,1,0,45,0.022222222222222223,0.0,1.0,45,1200,600,600,0.5,18,6,12,304.80881498281354,0.4181607744107744,0.04906879893386673,0.1691409979979506,129227.22012566916,-1122.0414663954298,128105.17865927373,646,0,285.44444444444446,40,5,21,38.05992836914878,0.60546875,45.80792682926829,1016.7682926829262,25.419207317073155,0
654,4,0,1,44,0.0,0.022222222222222223,0.9777777777777777,45,950,500,450,0.5263157894736842,14,5,9,302.09485489146687,0.41771885521885527,0.049644728661516035,0.16796473931965542,129304.72932778094,-1187.5413113887332,128117.1880163922,647,1,286.44444444444446,40,5,22,38.05039301891821,0.6062500000000001,45.731707317073166,1017.0731707317061,25.426829268292654,0
655,4,0,0,44,0.0,0.0,1.0,44,1250,1000,250,0.8,15,10,5,302.9278154395839,0.4185936398872445,0.05619559651817707,0.16855214346253772,129333.80126953128,-964.2388237847217,128369.56244574656,648,2,290.47727272727275,39,5,23,37.99976531831371,0.608173076923077,45.703125,1017.1875000000002,26.081730769230774,0
656,4,0,0,44,0.0,0.0,1.0,44,1300,1000,300,0.7692307692307693,16,10,6,304.6423943117496,0.4177457716701903,0.060598306504140886,0.17007749671004532,129466.28146701383,-911.8164062500044,128554.46506076383,649,3,291.47727272727275,39,5,16,37.82198908222451,0.6095085470085471,45.572916666666664,1017.7083333333328,26.095085470085458,0
657,4,0,0,44,0.0,0.0,1.0,44,800,400,400,0.5,12,4,8,303.9266625772481,0.417657681465821,0.0598277081085099,0.16990682761469514,129519.29253472234,-927.1267361111059,128592.16579861123,650,4,292.47727272727275,39,5,17,37.786532951289395,0.6100427350427351,45.520833333333336,1017.9166666666675,26.100427350427374,0
658,4,1,1,44,0.022222222222222223,0.022222222222222223,0.9777777777777777,45,1150,800,350,0.6956521739130435,15,8,7,297.3426084002855,0.420959595959596,0.06599729591949788,0.1672927604837971,129770.27253123143,-1282.7537345495423,128487.51879668189,651,0,286.9555555555556,40,5,18,37.700312520779285,0.6109375000000001,45.27439024390244,1018.9024390243904,25.47256097560976,0
659,4,2,1,45,0.043478260869565216,0.021739130434782608,0.9782608695652174,46,850,500,350,0.5882352941176471,12,5,7,296.4519459856886,0.4222423510466989,0.0911098898776177,0.16836047843527369,130136.02612630703,-1484.1843624023722,128651.84176390465,652,0,281.67391304347825,41,5,20,37.35365013774103,0.6130589430894309,44.9156746031746,1020.3373015873018,24.886275648470775,0
660,4,0,1,44,0.0,0.022222222222222223,0.9777777777777777,45,850,500,350,0.5882352941176471,12,5,7,302.6099541407728,0.42058080808080806,0.08888445950435186,0.17116055692494464,129977.4491456806,-1133.5060149381852,128843.94313074241,653,1,288.7111111111111,40,5,20,37.35673709388082,0.6130208333333333,45.07113821138212,1019.7154471544725,25.492886178861813,0
661,4,0,0,44,0.0,0.0,1.0,44,950,500,450,0.5263157894736842,14,5,9,305.6727427344457,0.41955162085976044,0.0917542816807222,0.1727439264367643,129943.77170138899,-855.9461805555458,129087.82552083344,654,2,296.0681818181818,39,5,20,37.31269581800846,0.6143162393162394,45.10416666666667,1019.5833333333342,26.143162393162413,0
662,4,0,0,44,0.0,0.0,1.0,44,1600,1400,200,0.875,18,14,4,307.2470125794329,0.4189239781536293,0.09371435392736793,0.1740389276214407,130034.82187145688,-809.4378897392364,129225.38398171765,655,3,297.0681818181818,41,3,21,37.180539344421746,0.6120426829268293,45.01488095238095,1019.9404761904759,24.87659698025551,0
663,4,0,0,44,0.0,0.0,1.0,44,1050,800,250,0.7619047619047619,13,8,5,309.12565060576696,0.419386451726568,0.09333318601670593,0.1755581069287856,130136.02612630682,-754.3232512912764,129381.70287501554,656,4,298.0681818181818,41,3,22,37.03036379841193,0.6130589430894309,44.915674603174594,1020.3373015873001,24.886275648470733,0
664,4,2,1,45,0.043478260869565216,0.021739130434782608,0.9782608695652174,46,1350,1100,250,0.8148148148148148,16,11,5,297.5101242069345,0.4238929146537842,0.09920382785046455,0.1711065945910549,130625.94112507413,-1427.3074706265052,129198.63365444762,657,0,286.0652173913044,40,6,16,36.83268714583955,0.6195312500000001,44.435975609756085,1022.2560975609738,25.556402439024346,0
665,4,0,0,45,0.0,0.0,1.0,45,1250,1000,250,0.8,15,10,5,305.17636997485084,0.4210016835016835,0.10220591565883108,0.17531560551482617,130581.792534722,-1029.9045138889098,129551.8880208331,658,1,293.4222222222222,39,6,16,36.681274629705136,0.6207264957264957,44.47916666666666,1022.0833333333316,26.20726495726491,0
666,4,1,0,46,0.021739130434782608,0.0,1.0,46,1150,500,650,0.43478260869565216,18,5,13,298.51131179977995,0.4246779388083736,0.12016258518022216,0.17311642517359863,130947.07739866736,-1382.1632298753273,129564.91416879203,659,0,288.0217391304348,41,5,17,36.483776776194624,0.621189024390244,44.12202380952379,1023.5119047619013,24.963704994192714,0
667,4,0,0,46,0.0,0.0,1.0,46,1250,800,450,0.64,17,8,9,298.3098972417524,0.42441626409017713,0.12328109201213344,0.17334223758642336,131023.24263038514,-1382.8939909297437,129640.34863945539,660,1,289.0217391304348,41,5,18,36.41230620155037,0.6219512195121952,44.04761904761903,1023.809523809521,24.97096399535417,0
668,4,0,2,44,0.0,0.043478260869565216,0.9565217391304348,46,600,400,200,0.6666666666666666,8,4,4,299.88263290380576,0.4244867149758454,0.12608948408268583,0.17437119178592525,131048.6359619076,-1340.1580018581762,129708.47796004942,661,2,290.0217391304348,41,5,18,36.346506313987675,0.6222052845528456,44.02281746031745,1023.9087301587276,24.97338366240799,0
669,4,0,1,43,0.0,0.022727272727272728,0.9772727272727273,44,900,500,400,0.5555555555555556,13,5,8,312.315062314036,0.422843992248062,0.12871383350919086,0.18065715795338427,130848.09570312513,-626.8337673610971,130221.26193576404,662,3,300.6818181818182,39,5,18,36.23031629674879,0.6233974358974359,44.21875000000001,1023.125000000001,26.233974358974386,0
670,4,1,1,43,0.022727272727272728,0.022727272727272728,0.9772727272727273,44,1000,800,200,0.8,12,8,4,311.34333886726836,0.42393410852713176,0.12354526494460982,0.18027119488525148,130885.78976014601,-649.916241159367,130235.87351898664,663,0,300.84090909090907,40,4,18,36.2171847584997,0.6221354166666667,44.18191056910569,1023.2723577235768,25.58180894308942,0
671,4,0,0,43,0.0,0.0,1.0,43,1550,1100,450,0.7096774193548387,20,11,9,316.9806752318526,0.42234219269102985,0.1147246787861429,0.18353527423286517,130885.78976014616,-302.34679671490943,130583.44296343125,664,5,308.83720930232556,40,3,20,36.07297149667297,0.6221354166666666,44.181910569105696,1023.2723577235779,25.58180894308945,0
672,4,0,0,43,0.0,0.0,1.0,43,1250,800,450,0.64,17,8,9,317.93322802014893,0.42243447766703585,0.12427290367509025,0.18462312774000658,130997.85175933792,-270.2860252897505,130727.56573404817,665,6,309.83720930232556,41,2,21,35.93563249022839,0.6216971544715446,44.07242063492063,1023.7103174603169,24.96854432830041,0
673,4,1,1,43,0.022727272727272728,0.022727272727272728,0.9772727272727273,44,1100,500,600,0.45454545454545453,17,5,12,313.11049163668355,0.42601523960535587,0.12581030658390224,0.18291880323570678,131228.8220734932,-582.1758007331308,130646.64627276007,666,0,303.77272727272725,42,2,21,35.82647689300801,0.6225198412698414,43.8468992248062,1024.6124031007753,24.395533407161317,0
674,4,1,1,43,0.022727272727272728,0.022727272727272728,0.9772727272727273,44,850,600,250,0.7058823529411765,11,6,5,313.9665542996891,0.42270084566596194,0.11363636363636331,0.18389469608981807,131328.12500000017,-553.4346643831358,130774.69033561704,667,0,304.75,42,2,21,35.70460704607044,0.6235119047619047,43.75000000000001,1025.0000000000014,24.404761904761937,0
675,4,1,1,43,0.022727272727272728,0.022727272727272728,0.9772727272727273,44,850,700,150,0.8235294117647058,10,7,3,314.275730769438,0.4235927589852009,0.11618951078100714,0.18433923670314944,131382.88498064133,-541.9095624223917,130840.97541821895,668,0,305.72727272727275,38,6,22,35.64158677226621,0.6304824561403508,43.69658119658119,1025.2136752136746,26.979307242465122,0
676,4,0,0,43,0.0,0.0,1.0,43,700,300,400,0.42857142857142855,11,3,8,318.1990906779902,0.4226190476190476,0.120619790202658,0.1865105516456755,131356.22409058534,-240.5137878963037,131115.71030268903,669,1,312.25581395348837,37,6,22,35.567863764395476,0.6320382882882885,43.72258771929823,1025.1096491228052,27.70566619250825,0
677,4,1,0,44,0.022727272727272728,0.0,1.0,44,1250,1000,250,0.8,15,10,5,312.1017841382178,0.4237028717406624,0.12960342624580012,0.1842493937705948,131629.4461451711,-583.6430025933421,131045.80314257776,670,0,306.1363636363636,38,6,18,35.44941870553533,0.6329495614035088,43.45619658119657,1026.175213675212,27.00461088618979,0
678,4,0,0,44,0.0,0.0,1.0,44,1450,1200,250,0.8275862068965517,17,12,5,308.4415584415586,0.42353770260747003,0.13237898465171205,0.18269230769230774,131755.55555555545,-672.2222222222317,131083.33333333323,671,1,307.1363636363636,39,5,19,35.41666666666668,0.6324786324786326,43.33333333333333,1026.6666666666658,26.324786324786302,0
679,4,0,1,43,0.0,0.022727272727272728,0.9772727272727273,44,1200,800,400,0.6666666666666666,16,8,8,306.0680560012567,0.4224365750528541,0.12870009480669964,0.18216326367523067,131938.95266439897,-723.5402494331211,131215.41241496586,672,2,308.1363636363636,41,3,19,35.293549633062966,0.6310975609756098,43.1547619047619,1027.3809523809514,25.058072009291497,0
680,4,0,0,43,0.0,0.0,1.0,43,1250,1000,250,0.8,15,10,5,310.77329918850285,0.4204042081949058,0.12425865353509935,0.18446818768345064,131837.04963466854,-405.7130259511382,131431.3366087174,673,3,316.2093023255814,41,2,19,35.2749871200412,0.6300813008130082,43.253968253968246,1026.9841269841259,25.048393341076242,0
681,4,0,0,43,0.0,0.0,1.0,43,1100,1000,100,0.9090909090909091,12,10,2,310.9574275416955,0.4199658545588778,0.12648450323452742,0.1851975892495307,131964.43457301898,-392.93577963593134,131571.49879338304,674,4,317.2093023255814,41,2,19,35.142395642238746,0.6313516260162602,43.129960317460316,1027.4801587301583,25.060491676345325,0
682,4,0,0,43,0.0,0.0,1.0,43,900,700,200,0.7777777777777778,11,7,4,312.746530314098,0.4196659283868586,0.12740414833438085,0.18663905841325176,132040.89506172814,-340.93364197533583,131699.9614197528,675,5,318.2093023255814,41,2,20,35.0197072072072,0.6321138211382115,43.05555555555554,1027.7777777777758,25.067750677506726,0
683,4,0,0,43,0.0,0.0,1.0,43,700,500,200,0.7142857142857143,9,5,4,311.2944808275097,0.41922757475083056,0.1203917477198535,0.18639903488025025,132168.37841907569,-371.3426516440169,131797.03576743166,676,6,319.2093023255814,41,2,21,34.929148576941635,0.6333841463414636,42.931547619047606,1028.2738095238074,25.07984901277579,0
684,4,1,1,43,0.022727272727272728,0.022727272727272728,0.9772727272727273,44,1050,500,550,0.47619047619047616,16,5,11,305.8263376849992,0.4203994890768146,0.11797209381955165,0.18411993799402998,132373.0732828555,-703.3655579592644,131669.70772489623,677,0,312.9318181818182,42,2,21,34.86464218455744,0.6339285714285714,42.73255813953488,1029.0697674418598,24.501661129568088,0
685,4,0,0,43,0.0,0.0,1.0,43,1150,800,350,0.6956521739130435,15,8,7,314.89894847277145,0.4181893687707641,0.1305123812769624,0.18945080589092686,132346.95845930933,-264.8163895188039,132082.14206979054,678,8,321.2093023255814,41,2,21,34.65741097827484,0.6351626016260163,42.75793650793649,1028.9682539682515,25.096786682152477,0
686,4,1,0,44,0.022727272727272728,0.0,1.0,44,1350,1100,250,0.8148148148148148,16,11,5,310.79451986043483,0.42014622973925303,0.139402975473935,0.18897911401224823,132746.64849175335,-548.5842980855589,132198.0641936678,679,0,314.8863636363636,39,5,16,34.36278597661648,0.6423611111111112,42.369791666666664,1030.5208333333326,26.423611111111093,0
687,4,0,0,44,0.0,0.0,1.0,44,1000,700,300,0.7,13,7,6,313.17455784295765,0.42020128611698376,0.14255530241787406,0.19083592514863942,132827.17013888876,-480.3819444444497,132346.78819444432,680,1,315.8863636363636,39,5,17,34.22089733225548,0.6431623931623932,42.291666666666664,1030.8333333333323,26.431623931623907,0
688,4,0,0,44,0.0,0.0,1.0,44,750,400,350,0.5333333333333333,11,4,7,313.3995269693212,0.4197278012684989,0.1404441537965393,0.19158906022196787,132947.67086390348,-466.8525679159429,132480.81829598753,681,2,316.8863636363636,40,4,18,34.094567073971895,0.6427083333333334,42.17479674796747,1031.300813008128,25.7825203252032,0
689,4,0,0,44,0.0,0.0,1.0,44,1350,1000,350,0.7407407407407407,17,10,7,312.2567473491301,0.4197608350951374,0.14332306617838086,0.19156149582088905,133078.71187991582,-489.05485739310325,132589.6570225227,682,3,317.8863636363636,40,4,19,33.99303161627106,0.6440104166666667,42.04776422764227,1031.808943089429,25.795223577235724,0
690,4,0,0,44,0.0,0.0,1.0,44,1100,700,400,0.6363636363636364,15,7,8,313.8212068183755,0.4197498238195913,0.14347094417988449,0.192927855717156,133157.36747306483,-442.4788485689926,132714.88862449586,683,4,318.8863636363636,40,4,20,33.874064592359176,0.6447916666666668,41.971544715447145,1032.1138211382101,25.802845528455254,0
691,4,0,0,44,0.0,0.0,1.0,44,1350,900,450,0.6666666666666666,18,9,9,312.6797619442999,0.41921027131782945,0.15038113643073814,0.19290461816126486,133288.51176754906,-464.67597412254713,132823.83579342652,684,5,319.8863636363636,40,4,20,33.77251254797756,0.6460937500000001,41.84451219512195,1032.621951219512,25.815548780487802,0
692,4,0,0,44,0.0,0.0,1.0,44,1050,900,150,0.8571428571428571,12,9,3,309.49008476646134,0.4187367864693446,0.14814317913491482,0.19134168014393624,133367.22932778104,-544.8329780553952,132822.39634972563,685,6,320.8863636363636,40,4,21,33.776277384231946,0.6468750000000001,41.76829268292683,1032.9268292682923,25.823170731707307,0
693,4,0,0,44,0.0,0.0,1.0,44,1150,800,350,0.6956521739130435,15,8,7,313.5057245557107,0.4180430761099366,0.15970943178381947,0.1945147150292187,133499.13330078137,-429.41018600709504,133069.72311477427,686,7,321.8863636363636,39,5,22,33.540910694486456,0.6498397435897435,41.64062500000001,1033.437500000001,26.49839743589746,0
694,4,0,0,44,0.0,0.0,1.0,44,750,400,350,0.5333333333333333,11,4,7,312.56844469541704,0.41806509866102887,0.1599839706892603,0.19449791934808888,133606.80474175364,-447.7457682291474,133159.0589735245,687,8,322.8863636363636,39,5,22,33.457703610411414,0.6509081196581196,41.53645833333334,1033.854166666668,26.509081196581235,0
695,4,0,0,44,0.0,0.0,1.0,44,900,600,300,0.6666666666666666,12,6,6,314.1328280785229,0.4175475687103594,0.16495128562010097,0.1958989143946972,133687.58680555577,-400.8680555555351,133286.71875000023,688,9,323.8863636363636,39,5,22,33.33669084071984,0.6517094017094016,41.45833333333334,1034.1666666666683,26.51709401709406,0
696,4,0,0,44,0.0,0.0,1.0,44,950,800,150,0.8421052631578947,11,8,3,315.2342088100003,0.41707408386187456,0.1643082048841209,0.197160337651192,133795.33420138914,-364.62673611108585,133430.70746527804,689,10,324.8863636363636,39,5,16,33.200765203383014,0.6527777777777777,41.35416666666668,1034.5833333333353,26.52777777777783,0
697,4,0,0,44,0.0,0.0,1.0,44,1100,600,500,0.5454545454545454,16,6,10,315.64758246164223,0.4164684637068358,0.16012032758384054,0.19785228591523157,133876.17323133702,-348.4619140624749,133527.71131727454,690,11,325.8863636363636,39,5,17,33.109482469384346,0.6535790598290598,41.27604166666668,1034.895833333335,26.535790598290642,0
698,4,0,0,44,0.0,0.0,1.0,44,1150,1100,50,0.9565217391304348,12,11,1,316.92918933441723,0.41568666314305847,0.16269210859825423,0.19902840459681742,133945.20147564297,-309.77117621784123,133635.43029942512,691,12,326.8863636363636,40,4,17,33.00751848942994,0.6526041666666667,41.20934959349594,1035.1626016260177,25.879065040650442,0
699,4,0,0,44,0.0,0.0,1.0,44,1150,1000,150,0.8695652173913043,13,10,3,317.3844370195849,0.4148718287526427,0.15931836021121715,0.20017216473413446,134103.0471280325,-287.55597693169636,133815.49115110078,692,13,327.8863636363636,40,4,18,32.838459903192046,0.6541666666666666,41.0569105691057,1035.772357723579,25.894308943089477,0
700,4,0,0,44,0.0,0.0,1.0,44,850,700,150,0.8235294117647058,10,7,3,318.8192094038827,0.41440935517970406,0.16164092870644398,0.20165512773461508,134208.32920219473,-242.3613176680301,133965.9678845267,693,14,328.8863636363636,40,4,19,32.69644141493396,0.6552083333333333,40.95528455284554,1036.17886178862,25.9044715447155,0
701,4,0,0,44,0.0,0.0,1.0,44,1100,700,400,0.6363636363636364,15,7,8,319.476163014225,0.4139358703312192,0.15519162210338666,0.20265278997171027,134313.65258774563,-217.9979261682613,134095.65466157737,694,15,329.8863636363636,40,4,19,32.57455065359477,0.6562499999999998,40.85365853658538,1036.5853658536605,25.914634146341513,0
702,4,0,0,44,0.0,0.0,1.0,44,1200,800,400,0.6666666666666666,16,8,8,318.46371978448576,0.41371564482029594,0.15863645274545113,0.20230179758663305,134366.3297722918,-241.83976138540083,134124.4900109064,695,16,330.8863636363636,40,4,19,32.54835653139906,0.6567708333333333,40.80284552845529,1036.7886178861802,25.919715447154505,0
703,4,0,0,44,0.0,0.0,1.0,44,1150,700,450,0.6086956521739131,16,7,9,320.0739385231646,0.4124163143058492,0.16312116864484194,0.20392279264227214,134473.59738166106,-191.70121173468397,134281.8961699264,696,17,331.8863636363636,41,3,19,32.39986848397898,0.65625,40.699404761904766,1037.2023809523814,25.297619047619058,0
704,4,0,0,44,0.0,0.0,1.0,44,1150,700,450,0.6086956521739131,16,7,9,318.89862465120893,0.4114693446088795,0.1635350696282234,0.2039068099342327,134604.82313368068,-214.89711770123756,134389.92601597944,697,18,332.8863636363636,39,5,21,32.29982265943921,0.6607905982905983,40.57291666666667,1037.7083333333344,26.60790598290601,0
705,4,1,1,44,0.022222222222222223,0.022222222222222223,0.9777777777777777,45,1050,800,250,0.7619047619047619,13,8,5,314.8559848398803,0.4117003367003367,0.17402662320021767,0.2033734962089561,134972.85970858944,-500.5974659594166,134472.26224263004,698,0,326.46666666666664,40,5,15,32.03911980440098,0.6627604166666667,40.21849593495935,1039.1260162601625,25.978150406504064,0
706,4,0,0,44,0.0,0.0,1.0,44,650,500,150,0.7692307692307693,8,5,3,321.918614418984,0.4099057434813249,0.17308744415063337,0.20706636037143683,134821.0991753473,-119.71571180555122,134701.38346354174,699,20,334.8863636363636,39,5,15,32.00643597459044,0.6629273504273505,40.364583333333336,1038.5416666666672,26.629273504273517,0
707,4,0,0,44,0.0,0.0,1.0,44,550,500,50,0.9090909090909091,6,5,1,324.10900648084413,0.40985068710359407,0.17576198247645403,0.20863078783863775,134848.14588758693,-58.90028211804656,134789.2456054689,700,21,335.8863636363636,39,5,15,31.922679938488265,0.6631944444444444,40.33854166666667,1038.6458333333344,26.63194444444447,0
708,4,0,0,44,0.0,0.0,1.0,44,1500,1200,300,0.8,18,12,6,323.87033638573206,0.40983967582804787,0.17284485115846682,0.20894454948973412,134929.30230034713,-60.08029513889437,134869.22200520823,701,22,336.8863636363636,39,5,16,31.848222043981025,0.6639957264957266,40.260416666666664,1038.9583333333328,26.63995726495725,0
709,4,0,0,44,0.0,0.0,1.0,44,950,700,250,0.7368421052631579,12,7,5,322.705527749357,0.4100819238900634,0.16998979368666634,0.20850455601214946,134983.42013888905,-88.02083333331313,134895.39930555574,702,23,337.8863636363636,39,5,16,31.82471264367816,0.6645299145299145,40.20833333333334,1039.166666666668,26.645299145299184,0
710,4,0,0,44,0.0,0.0,1.0,44,1250,1000,250,0.8,15,10,5,316.8417260752842,0.41068754404510216,0.129753452106111,0.19905137938564665,133959.60416863504,-309.63905816956765,133649.96511046548,703,24,338.8863636363636,41,3,13,32.99542804663792,0.6511686991869918,41.195436507936506,1035.218253968254,25.24922570654278,3
711,4,0,0,44,0.0,0.0,1.0,44,1050,700,350,0.6666666666666666,14,7,7,315.29765297878197,0.4100929351656096,0.13060617669850516,0.19891376403332092,134113.69879259565,-342.85310767826365,133770.84568491738,704,25,339.8863636363636,41,3,14,32.88188790984262,0.6526930894308943,41.04662698412698,1035.8134920634914,25.263743708865643,0
712,4,0,0,44,0.0,0.0,1.0,44,1050,600,450,0.5714285714285714,15,6,9,311.09509883703186,0.408947762508809,0.1341883614088819,0.1972282519811474,134293.5878054926,-444.38460569412837,133849.20319979847,705,26,340.8863636363636,41,3,14,32.81170239918325,0.6544715447154472,40.87301587301587,1036.5079365079368,25.280681378242363,0
713,4,0,0,44,0.0,0.0,1.0,44,1300,900,400,0.6923076923076923,17,9,8,311.89793931523013,0.40888169485553205,0.12642191468936637,0.19831371649508497,134400.02408396435,-416.1818888588373,133983.8421951055,706,27,341.8863636363636,42,2,15,32.68502943650125,0.6540178571428572,40.770348837209305,1036.9186046511632,24.688538205980073,0
714,4,0,1,43,0.0,0.022727272727272728,0.9772727272727273,44,1550,1200,350,0.7741935483870968,19,12,7,310.8741885631895,0.4080998942917548,0.12584364704834816,0.1986248726677202,134577.14178894853,-432.5190391656274,134144.6227497829,707,28,342.8863636363636,40,4,17,32.535504407443696,0.6588541666666665,40.59959349593497,1037.6016260162614,25.940040650406537,0
715,4,0,0,43,0.0,0.0,1.0,43,1250,800,450,0.64,17,8,9,314.38590406797243,0.4059385382059801,0.11948129545433273,0.20132012520136774,134658.87586805577,-133.02951388886936,134525.8463541669,708,29,349.2325581395349,39,4,18,32.363174093402925,0.6613247863247862,40.52083333333334,1037.9166666666683,26.613247863247906,0
716,4,0,0,43,0.0,0.0,1.0,43,1250,700,550,0.56,18,7,11,317.5950995898451,0.405500184569952,0.1281208756200789,0.20439684620958568,134840.889186331,-35.0388740167773,134805.85031231423,709,30,350.2325581395349,40,3,15,32.0990296803653,0.6614583333333333,40.34552845528456,1038.6178861788628,25.96544715447157,0
717,4,0,0,43,0.0,0.0,1.0,43,800,500,300,0.625,11,5,6,317.56184403888153,0.405500184569952,0.12412748950760899,0.20090451005367155,134216.47775140146,-75.5935649722897,134140.88418642918,710,31,351.2325581395349,41,2,17,32.7208991543003,0.6537093495934959,40.94742063492063,1036.2103174603171,25.273422377080905,1
718,4,0,1,42,0.0,0.023255813953488372,0.9767441860465116,43,900,700,200,0.7777777777777778,11,7,4,317.13768124309456,0.4055924695459579,0.12542911718739602,0.20077698292517362,134242.17864229018,-85.3493480725702,134156.8292942176,711,32,352.2325581395349,41,2,17,32.706299061841854,0.6539634146341464,40.922619047619044,1036.3095238095232,25.275842044134713,0
719,4,0,0,42,0.0,0.0,1.0,42,900,500,400,0.5555555555555556,13,5,8,323.3467889699282,0.4046409214092141,0.12408227316034304,0.20451884989686023,134208.3292021944,279.1664601097198,134487.49566230414,712,33,345.35714285714283,40,2,17,32.579156858898926,0.6552083333333334,40.95528455284553,1036.1788617886175,25.904471544715438,0
720,4,0,1,41,0.0,0.023809523809523808,0.9761904761904762,42,850,500,350,0.5882352941176471,12,5,7,320.1337964086725,0.4045683313975997,0.1209947795552817,0.202777916507804,134260.98573104636,196.29581433009866,134457.28154537646,713,34,346.35714285714283,40,2,17,32.6099480290253,0.6557291666666667,40.90447154471545,1036.3821138211383,25.90955284552846,0
721,4,1,0,42,0.023809523809523808,0.0,1.0,42,850,500,350,0.5882352941176471,12,5,7,342.1442221830127,0.40610481997677117,0.09805973620386088,0.1933934073894178,129951.543032008,538.7956284288408,130490.33866043684,714,0,339.57142857142856,40,2,19,36.3751702714376,0.6127604166666667,45.09654471544715,1019.6138211382109,25.490345528455272,8
722,4,3,3,42,0.06666666666666667,0.06666666666666667,0.9333333333333333,45,850,600,250,0.7058823529411765,11,6,5,325.63777738379156,0.4135942760942761,0.10997167198475166,0.1874415815153507,130658.55910289317,-490.1556410145249,130168.40346187864,715,0,317.8666666666667,42,3,14,36.080900704514576,0.6168154761904763,44.40406976744185,1022.3837209302303,24.342469545957865,0
723,4,1,0,43,0.023255813953488372,0.0,1.0,43,1300,1200,100,0.9230769230769231,14,12,2,334.0473934669119,0.4096991509782208,0.11898947290521966,0.19173405186662443,130548.0368828076,121.84628858481415,130669.88317139242,716,0,333.6279069767442,40,3,15,35.9776915937417,0.6187500000000001,44.51219512195121,1021.9512195121931,25.548780487804827,0
724,4,0,0,43,0.0,0.0,1.0,43,1100,900,200,0.8181818181818182,13,9,4,326.1928050306341,0.4103451458102621,0.06854213821724509,0.18706404615879862,130514.55886667041,-57.062884753807225,130457.49598191661,717,1,334.6279069767442,37,6,16,36.2121964087706,0.6235923423423424,44.54495614035087,1021.8201754385957,27.616761498340423,2
725,4,0,1,42,0.0,0.023255813953488372,0.9767441860465116,43,700,400,300,0.5714285714285714,10,4,6,326.57308974923535,0.4105297157622739,0.06898650958201413,0.18755315893731495,130570.58572108718,-71.83207813943972,130498.75364294773,718,2,335.6279069767442,37,6,16,36.145866859778984,0.6241554054054055,44.49013157894736,1022.03947368421,27.62268847795162,0
726,4,0,0,42,0.0,0.0,1.0,42,1050,600,450,0.5714285714285714,15,6,9,333.48486113146026,0.41019405729771585,0.061902662530900265,0.19113759602310426,130492.60567577726,303.46169649380374,130796.06737227106,719,3,340.26190476190476,36,6,18,36.048118961019874,0.6252893518518519,44.56644144144145,1021.7342342342353,28.381506506506536,0
727,4,0,0,42,0.0,0.0,1.0,42,1100,700,400,0.6363636363636364,15,7,8,334.80039227213683,0.41067799070847855,0.06354885893584594,0.1933243460271975,130780.41459956569,357.06682188945024,131137.48142145513,720,4,341.26190476190476,36,6,19,35.72355866270321,0.6281828703703705,44.284909909909906,1022.8603603603597,28.412787787787767,0
728,4,1,1,42,0.023255813953488372,0.023255813953488372,0.9767441860465116,43,950,700,250,0.7368421052631579,12,7,5,328.3141948086485,0.4148671096345515,0.06382708454236852,0.19075728916791232,131019.23338190601,3.094822445374575,131022.32820435139,721,0,334.30232558139534,37,6,19,35.648383670700795,0.6286599099099099,44.0515350877193,1023.7938596491231,27.670104314841165,0
729,4,0,0,42,0.0,0.0,1.0,42,1150,900,250,0.782608695652174,14,9,5,333.13562178293097,0.4109804490902052,0.06235779077004722,0.19313589401999237,130935.05333371805,323.82608110187806,131258.87941481994,722,6,343.26190476190476,37,5,19,35.60995643168347,0.6278153153153152,44.13377192982456,1023.4649122807016,27.661213845424367,0
730,4,1,1,42,0.023255813953488372,0.023255813953488372,0.9767441860465116,43,800,500,300,0.625,11,5,6,327.43146599838855,0.4123984865263935,0.05843420392067489,0.1910980114095282,131191.27498584634,-8.769701037322363,131182.505284809,723,0,336.25581395348837,38,5,19,35.49748844161715,0.628563596491228,43.88354700854701,1024.4658119658122,26.95962663067927,0
731,4,0,0,42,0.0,0.0,1.0,42,1350,900,450,0.6666666666666666,18,9,9,336.32270312859805,0.4096254355400697,0.058123249299720126,0.19614732832098514,131163.91354372117,422.6803911900021,131586.59393491116,724,8,345.26190476190476,38,4,19,35.297376929495215,0.6282894736842106,43.91025641025641,1024.358974358974,26.95681511470984,0
732,4,1,1,42,0.023255813953488372,0.023255813953488372,0.9767441860465116,43,1300,700,600,0.5384615384615384,19,7,12,329.58096479920704,0.41115263935031376,0.07892588708056114,0.19401022949338953,131519.83486969446,69.389541785358,131589.2244114798,725,0,338.2093023255814,38,5,20,35.1113599277853,0.6318530701754387,43.56303418803418,1025.7478632478617,26.99336482231215,0
733,4,0,0,42,0.0,0.0,1.0,42,900,800,100,0.8888888888888888,10,8,2,333.9995222011065,0.4099883855981417,0.0841425924794883,0.19678208625400204,131553.00188519547,387.7279547553103,131940.72983995077,726,1,343.0,37,5,20,34.96463944705715,0.634009009009009,43.530701754385966,1025.8771929824563,27.72641062114747,0
734,4,1,1,42,0.023255813953488372,0.023255813953488372,0.9767441860465116,43,1350,1000,350,0.7407407407407407,17,10,7,325.0371318409351,0.4120985603543743,0.08627362194975308,0.19320019030038943,131889.27001953122,-26.217990451389284,131863.05202907984,727,0,336.0,39,4,16,34.85627302842849,0.6338141025641025,43.203125,1027.1874999999998,26.33814102564102,0
735,4,0,0,42,0.0,0.0,1.0,42,1550,1100,450,0.7096774193548387,20,11,9,335.0806990979493,0.40904471544715443,0.08618042036329787,0.19895804573369902,131848.80566741546,435.99799565344875,132284.80366306892,728,3,345.0,38,4,16,34.63907382364161,0.6351425438596492,43.24252136752137,1027.0299145299148,27.027103013945126,0
736,4,0,0,42,0.0,0.0,1.0,42,1250,800,450,0.64,17,8,9,339.919649379109,0.408234126984127,0.08848133848133899,0.20285527462946829,132040.89506172837,576.658950617287,132617.55401234564,729,4,346.0,38,4,17,34.32150900900903,0.6370614035087719,43.05555555555556,1027.7777777777776,27.04678362573099,0
737,4,0,0,42,0.0,0.0,1.0,42,850,600,250,0.7058823529411765,11,6,5,341.65499172617893,0.4079558652729385,0.08698976940323977,0.20403865148339953,132068.34781804736,624.3620562130161,132692.70987426038,730,5,347.0,38,4,17,34.249298409728695,0.6373355263157894,43.02884615384615,1027.8846153846155,27.049595141700408,0
738,4,0,0,42,0.0,0.0,1.0,42,1050,600,450,0.5714285714285714,15,6,9,344.239254720507,0.40805265195509094,0.10066656055717171,0.20635544394994326,132210.46142578125,702.4061414930559,132912.8675672743,731,6,348.0,39,3,19,34.03991103683446,0.6370192307692308,42.890625,1028.4375,26.370192307692307,0
739,4,2,1,43,0.045454545454545456,0.022727272727272728,0.9772727272727273,44,1100,800,300,0.7272727272727273,14,8,6,333.04733012966796,0.4116675475687104,0.11857748469147444,0.20315466091980383,132865.7190536197,50.513362334153754,132916.23241595385,732,0,333.1363636363636,38,6,18,33.67012089810019,0.6452850877192982,42.254273504273506,1030.982905982906,27.131129104813315,0
740,4,0,0,43,0.0,0.0,1.0,43,1100,700,400,0.6363636363636364,15,7,8,338.23630602082403,0.40988372093023256,0.11802078179119291,0.20592106713703015,132793.26331178824,383.1005694059756,133176.3638811942,733,1,341.8837209302326,37,6,19,33.60904255319151,0.6463963963963963,42.324561403508774,1030.701754385965,27.856804172593648,0
741,4,0,0,43,0.0,0.0,1.0,43,1150,900,250,0.782608695652174,14,9,5,341.87508473257174,0.4088685861941676,0.13143107186385183,0.2092400079427004,132991.11415291257,493.269683941231,133484.3838368538,734,2,342.8837209302326,37,6,21,33.31683409517736,0.648367117117117,42.1326754385965,1031.4692982456152,27.877548601232842,0
742,4,0,0,43,0.0,0.0,1.0,43,1150,800,350,0.6956521739130435,15,8,7,342.4046998314415,0.40778423772609823,0.13608024256621998,0.21020030202959541,133104.23790252782,515.1033250615687,133619.34122758938,735,3,343.8837209302326,37,6,21,33.189773492012904,0.6494932432432432,42.02302631578948,1031.907894736843,27.889402560455217,0
743,4,0,0,43,0.0,0.0,1.0,43,1400,800,600,0.5714285714285714,20,8,12,338.47379184041506,0.40716131413805834,0.13821629230380572,0.20876510517789482,133279.09412895393,422.29607257653174,133701.39020153048,736,4,344.8837209302326,38,5,22,33.11605449215383,0.6493969298245613,41.853632478632484,1032.5854700854704,27.173301844354484,0
744,4,1,0,44,0.022727272727272728,0.0,1.0,44,1050,700,350,0.6666666666666666,14,7,7,331.7041683487976,0.40830910852713176,0.14114046081172282,0.20660305862147701,133642.23246575863,66.21676498498195,133708.4492307436,737,0,338.02272727272725,37,7,24,32.92771297278191,0.6548423423423424,41.50219298245614,1033.9912280701749,27.945708866761482,0
745,4,0,0,44,0.0,0.0,1.0,44,900,600,300,0.6666666666666666,12,6,6,331.7041683487976,0.40832011980267796,0.14114046081172282,0.20660305862147701,133642.23246575863,65.9371152662296,133708.16958102485,738,1,339.02272727272725,37,7,24,32.92771297278191,0.6548423423423424,41.50219298245614,1033.9912280701749,27.945708866761482,0
746,4,0,0,44,0.0,0.0,1.0,44,900,500,400,0.5555555555555556,13,5,8,328.00601187162107,0.40825405214940097,0.14068937105190904,0.20484903760284268,133741.45507812512,-26.39973958331808,133715.0553385418,739,2,340.02272727272725,39,5,13,32.92421953675731,0.6522435897435896,41.40625000000001,1034.375000000001,26.52243589743592,0
747,4,0,1,43,0.0,0.022727272727272728,0.9772727272727273,44,1200,900,300,0.75,15,9,6,325.69781080799703,0.4078246124031008,0.1393718259596466,0.2041519085411644,133876.17323133704,-79.36469184025279,133796.8085394968,740,3,341.02272727272725,39,5,15,32.849458983392054,0.6535790598290598,41.27604166666668,1034.8958333333353,26.53579059829065,0
748,4,0,0,43,0.0,0.0,1.0,43,1550,1300,250,0.8387096774193549,18,13,5,334.92444833284907,0.4048541897379107,0.14061520954719953,0.20999437741102328,133886.53897518083,368.37504109138996,134254.9140162722,741,9,349.8837209302326,38,5,17,32.60039227831114,0.6554276315789473,41.26602564102564,1034.9358974358977,27.235155195681518,0
749,4,0,0,43,0.0,0.0,1.0,43,1200,600,600,0.5,18,6,12,335.5471288061653,0.40390826873385016,0.14452152920595185,0.21101798995850418,133997.1318782417,392.47057400102216,134389.60245224272,742,10,350.8837209302326,38,5,19,32.47385890688953,0.6565241228070176,41.159188034188034,1035.3632478632483,27.246401259559164,0
750,4,0,0,43,0.0,0.0,1.0,43,1150,800,350,0.6956521739130435,15,8,7,334.09064130024535,0.4036314138058324,0.14842462549623958,0.21073576886180082,134107.77043839943,360.83020582218955,134468.60064422162,743,11,351.8837209302326,38,5,19,32.401151796458656,0.6576206140350876,41.052350427350426,1035.7905982905982,27.257647323436792,0
751,4,0,0,43,0.0,0.0,1.0,43,1350,1000,350,0.7407407407407407,17,10,7,338.4914993714358,0.4029623477297896,0.14842300556586263,0.21464343313082807,134301.49778106503,491.9830703484502,134793.48085141348,744,12,352.8837209302326,38,5,21,32.093898165326735,0.6595394736842106,40.86538461538461,1036.5384615384612,27.27732793522266,0
752,4,0,0,43,0.0,0.0,1.0,43,1300,1000,300,0.7692307692307693,16,10,6,335.287395014581,0.4034237726098191,0.14854934471083836,0.2129620575992423,134361.7201063369,409.9582248263989,134771.6783311633,745,13,353.8837209302326,39,4,21,32.11688686828093,0.6583867521367521,40.80729166666667,1036.7708333333342,26.583867521367544,0
753,4,0,0,43,0.0,0.0,1.0,43,1750,1200,550,0.6857142857142857,23,12,11,331.0323831805357,0.40201642672572907,0.1498516867407702,0.21151650520171567,134579.22299409434,310.2820248778491,134889.50501897218,746,14,354.8837209302326,37,6,23,32.0105278452922,0.6641328828828829,40.59758771929825,1037.609649122807,28.043504030346135,0
754,4,0,0,43,0.0,0.0,1.0,43,1200,1000,200,0.8333333333333334,14,10,4,328.6470225655516,0.40201642672572907,0.14759716125292055,0.21065005840406748,134693.02002779694,253.2919984995338,134946.31202629648,747,15,355.8837209302326,37,6,23,31.959151966480057,0.665259009009009,40.487938596491226,1038.0482456140346,28.055357989568503,0
755,4,0,0,43,0.0,0.0,1.0,43,900,400,500,0.4444444444444444,14,4,10,326.6384697454656,0.4023624953857512,0.14959804766006313,0.2099818734077992,134800.2958579881,206.19247205784563,135006.48833004595,748,16,356.8837209302326,38,5,15,31.904578189300413,0.6644736842105263,40.38461538461538,1038.4615384615379,27.32793522267205,0
756,4,0,1,42,0.0,0.023255813953488372,0.9767441860465116,43,600,300,300,0.5,9,3,6,333.4149789655067,0.4023624953857512,0.1535187718498252,0.21052774386107725,134145.8129882814,345.2446831597368,134491.05767144114,749,17,357.8837209302326,39,4,16,32.380698005698,0.65625,41.01562500000001,1035.9375000000011,26.56250000000003,1
757,4,0,0,42,0.0,0.0,1.0,42,1450,800,650,0.5517241379310345,21,8,13,340.1328351157598,0.4000072590011614,0.15384928210206983,0.21603970056842153,134361.7201063372,740.166558159762,135101.88666449694,750,18,359.3809523809524,39,3,17,31.991296593991756,0.658386752136752,40.807291666666686,1036.7708333333364,26.5838675213676,0
758,4,0,0,42,0.0,0.0,1.0,42,900,800,100,0.8888888888888888,10,8,2,340.65355624208087,0.3997289972899729,0.14548776521456297,0.21685081879451182,134442.73003472263,759.678819444483,135202.40885416712,751,19,360.3809523809524,39,3,17,31.897013526181862,0.6591880341880341,40.729166666666686,1037.0833333333364,26.591880341880422,0
759,4,0,0,42,0.0,0.0,1.0,42,1150,900,250,0.782608695652174,14,9,5,341.4461057079723,0.39939024390243905,0.14849875693249182,0.21800020595201344,134550.78125000026,788.3680555555853,135339.14930555585,752,20,361.3809523809524,39,3,18,31.76874163319946,0.6602564102564101,40.625000000000014,1037.500000000002,26.602564102564155,0
760,4,0,0,42,0.0,0.0,1.0,42,1250,900,350,0.72,16,9,7,340.8094271736639,0.3992450638792102,0.1456812133426344,0.21794301675262437,134609.20538359327,775.2172358169172,135384.42261941018,753,21,362.3809523809524,36,6,18,31.727030204376923,0.6663773148148147,40.5686936936937,1037.725225225227,28.82570070070075,0
761,4,0,0,42,0.0,0.0,1.0,42,1150,800,350,0.6956521739130435,15,8,7,336.9699935535782,0.3989668021680217,0.1439933891126952,0.21635538583314712,134755.32119957803,681.6999431864382,135437.02114276445,754,22,363.3809523809524,36,6,19,31.681127982646426,0.6678240740740741,40.42792792792793,1038.2882882882889,28.84134134134136,0
762,4,0,0,42,0.0,0.0,1.0,42,800,400,400,0.5,12,4,8,337.5886566176753,0.39818041037553237,0.14416598255913016,0.21727705373236716,134843.02873397054,704.2953849119473,135547.32411888248,755,23,364.3809523809524,36,6,15,31.57775850229499,0.6686921296296295,40.34346846846847,1038.6261261261268,28.850725725725745,0
763,4,0,1,41,0.0,0.023809523809523808,0.9761904761904762,42,1050,900,150,0.8571428571428571,12,9,3,336.1327839836663,0.39762388695315526,0.1411614401858301,0.21668937332280377,134901.5162755661,668.9644458647826,135570.48072143088,756,24,365.3809523809524,36,6,16,31.55736224028906,0.6692708333333334,40.28716216216216,1038.8513513513515,28.856981981981985,0
764,4,0,0,41,0.0,0.0,1.0,41,1500,1000,500,0.6666666666666666,20,10,10,339.5479410708955,0.39667174796747967,0.12437747414123357,0.21913169424826937,134941.3275489754,963.8099869255741,135905.13753590095,757,25,357.0487804878049,35,6,16,31.429045523745863,0.6717261904761905,40.24884259259259,1039.0046296296289,29.68584656084654,0
765,4,0,0,41,0.0,0.0,1.0,41,1100,800,300,0.7272727272727273,14,8,6,338.19871925238493,0.3968241869918699,0.1240262914878596,0.21880579963158592,135031.533993484,933.4983710562142,135965.0323645402,758,26,358.0487804878049,35,6,18,31.374350408314776,0.6726190476190477,40.162037037037024,1039.35185185185,29.69576719576714,0
766,4,0,1,40,0.0,0.024390243902439025,0.975609756097561,41,1000,600,400,0.6,14,6,8,338.4323757735913,0.3964939024390244,0.12014272447333685,0.2193217604039246,135091.68836805542,943.8802083333146,136035.56857638873,759,27,359.0487804878049,35,6,18,31.308450233800926,0.6732142857142858,40.10416666666666,1039.5833333333321,29.702380952380917,0
767,4,0,0,40,0.0,0.0,1.0,40,550,300,250,0.5454545454545454,8,3,5,339.9136805195979,0.3948317307692308,0.11943455031166517,0.22064916949335736,135151.85613854587,1187.992969821662,136339.84910836755,760,28,360.1,35,5,18,31.210114277233593,0.6738095238095239,40.04629629629629,1039.8148148148143,29.708994708994695,0
768,4,0,0,40,0.0,0.0,1.0,40,700,500,200,0.7142857142857143,9,5,4,339.97836396078173,0.3946314102564103,0.11940302659396917,0.22124442845152376,135242.13291162965,1195.8798171724818,136438.01272880213,761,29,361.1,35,5,18,31.118676050591596,0.674702380952381,39.95949074074073,1040.162037037036,29.718915343915317,0
769,4,0,0,40,0.0,0.0,1.0,40,1350,900,450,0.6666666666666666,18,9,9,339.4666203831317,0.39405715811965814,0.11964710976401793,0.22115603942872858,135281.99440995057,1184.7442882071323,136466.7386981577,762,30,362.1,36,4,18,31.092363065598608,0.6730324074074073,39.921171171171174,1040.315315315316,28.897647647647666,0
770,4,0,0,40,0.0,0.0,1.0,40,1000,700,300,0.7,13,7,6,340.39251016313347,0.393349358974359,0.1192605214757112,0.2226643999602156,135428.47482195043,1219.7676984416964,136648.24252039212,763,31,363.1,36,4,19,30.9227253056367,0.6744791666666666,39.78040540540541,1040.8783783783792,28.913288288288314,0
771,4,0,0,40,0.0,0.0,1.0,40,1050,600,450,0.5714285714285714,15,6,9,340.82814413591194,0.39278846153846153,0.12198756084369933,0.2233136918877752,135487.0891795513,1235.5626318886616,136722.65181143995,764,32,364.1,36,4,19,30.85316387236345,0.6750578703703705,39.72409909909911,1041.1036036036046,28.91954454454457,0
772,4,0,0,40,0.0,0.0,1.0,40,1700,1100,600,0.6470588235294118,23,11,12,340.8974506788929,0.39113247863247863,0.11852294189534485,0.22446363961673113,135663.82304794664,1249.5695452827322,136913.39259322936,765,33,365.1,35,5,19,30.67587397696551,0.6788690476190476,39.554398148148145,1041.7824074074072,29.765211640211632,0
773,4,0,0,40,0.0,0.0,1.0,40,1000,800,200,0.8,12,8,4,341.30557572903024,0.39098557692307695,0.12024550099977804,0.22492187355144436,135693.96888931756,1262.6216349451277,136956.5905242627,766,34,366.1,35,5,19,30.63532178034511,0.6791666666666667,39.52546296296296,1041.898148148148,29.768518518518515,0
774,4,0,0,40,0.0,0.0,1.0,40,1050,800,250,0.7619047619047619,13,8,5,350.1556426509252,0.39126602564102564,0.03544176706827362,0.22356091030789818,134550.78124999985,1422.7430555555416,135973.5243055554,767,35,367.1,37,3,18,31.54283801874164,0.6638513513513514,40.62499999999999,1037.4999999999989,28.04054054054051,4
775,4,0,0,40,0.0,0.0,1.0,40,850,600,250,0.7058823529411765,11,6,5,348.1814562531047,0.39085202991452994,0.03551276771004974,0.22246962520593064,134578.49368105747,1371.5471820439434,135950.04086310143,768,36,368.1,38,2,18,31.566404104887418,0.6622807017543861,40.59829059829058,1037.6068376068351,27.305443094916715,0
776,4,0,0,40,0.0,0.0,1.0,40,800,600,200,0.75,10,6,4,349.5530793769061,0.39074519230769234,0.025761630300535243,0.22402755403865549,134689.37194097432,1416.2169442617947,136105.58888523612,769,37,369.1,38,2,18,31.420251818306568,0.6633771929824562,40.49145299145298,1038.0341880341866,27.316689158794386,0
777,4,0,1,39,0.0,0.025,0.975,40,1200,900,300,0.75,15,9,6,354.3286084438349,0.3913595085470085,0.020432098765432283,0.22778267685675102,134800.29585798818,1552.7202498356387,136353.01610782382,770,38,370.1,38,2,14,31.18569958847739,0.6644736842105262,40.38461538461539,1038.4615384615386,27.327935222672068,0
778,4,0,0,39,0.0,0.0,1.0,39,850,500,350,0.5882352941176471,12,5,7,355.9130204982331,0.3893949617633828,0.031516529932580806,0.2286632499401812,134778.39936326575,1793.8774430594196,136572.27680632516,771,39,379.15384615384613,37,2,18,31.16640267511441,0.6661036036036035,40.40570175438597,1038.3771929824572,28.064248458985332,0
779,4,0,0,39,0.0,0.0,1.0,39,1200,800,400,0.6666666666666666,16,8,8,355.7109184254039,0.38886077372919475,0.03349871564798246,0.2290720278887731,134863.80575032707,1794.5056411588262,136658.31139148588,772,40,380.15384615384613,37,2,14,31.086487033322793,0.6669481981981982,40.323464912280706,1038.7061403508776,28.0731389284021,0
780,4,0,0,39,0.0,0.0,1.0,39,1100,900,200,0.8181818181818182,13,9,4,353.709929616196,0.3880735492577598,0.03015763480143474,0.22814170068845868,134920.75837036403,1744.5623893890556,136665.32075975309,773,41,381.15384615384613,37,2,14,31.081684256816203,0.6675112612612611,40.2686403508772,1038.9254385964919,28.079065908013295,0
781,4,0,0,39,0.0,0.0,1.0,39,1200,700,500,0.5833333333333334,17,7,10,353.28363503008546,0.38770805218173643,0.03031360676184991,0.22822556299796326,134977.72301333104,1737.0841268467238,136714.80714017776,774,42,382.15384615384613,37,2,15,31.035995040624663,0.6680743243243243,40.213815789473685,1039.1447368421054,28.08499288762447,0
782,4,0,0,39,0.0,0.0,1.0,39,1250,1000,250,0.8,15,10,5,352.97046999811226,0.3869770580296896,0.020142849802168294,0.22874320068708856,135091.68836805565,1736.6753472222322,136828.36371527787,775,43,383.15384615384613,37,2,15,30.930611222444888,0.6692004504504503,40.10416666666667,1039.5833333333342,28.09684684684687,0
783,4,0,0,39,0.0,0.0,1.0,39,950,700,250,0.7368421052631579,12,7,5,350.59290964925583,0.38675213675213677,0.021896922265925545,0.22792143577951976,135205.70181450067,1680.4320800631006,136886.13389456377,776,44,384.15384615384613,37,2,16,30.878909681953957,0.6703265765765766,39.99451754385965,1040.021929824562,28.108700806069244,0
784,4,0,0,39,0.0,0.0,1.0,39,800,500,300,0.625,11,5,6,350.56978508059706,0.3870614035087719,0.022251891410770108,0.2283276252394498,135272.23186728396,1684.4714506172875,136956.70331790124,777,45,385.15384615384613,38,1,17,30.81330663106364,0.6691337719298245,39.93055555555556,1040.2777777777778,27.375730994152047,0
785,4,0,0,39,0.0,0.0,1.0,39,650,300,350,0.46153846153846156,10,3,7,348.5238417229843,0.3865834457939721,0.026122732621038924,0.22769756822425166,135383.39548405667,1636.8682199211198,137020.2637039778,778,46,386.15384615384613,38,1,17,30.755954214146392,0.6702302631578947,39.823717948717956,1040.7051282051293,27.386977058029718,0
786,4,0,0,39,0.0,0.0,1.0,39,900,700,200,0.7777777777777778,11,7,4,347.93220984052545,0.38621794871794873,0.02857015029857135,0.22766309741277646,135438.99441385423,1624.71772499818,137063.71213885242,779,47,387.15384615384613,38,1,17,30.71606965684766,0.6707785087719298,39.77029914529915,1040.9188034188037,27.392600089968518,0
787,4,0,0,39,0.0,0.0,1.0,39,1250,800,450,0.64,17,8,9,349.53103926382744,0.38517768780926676,0.03099967642903989,0.22941946395316676,135550.22651627217,1675.8023093359668,137226.02882560814,780,48,388.15384615384613,38,1,19,30.56389145378066,0.671875,39.66346153846154,1041.3461538461538,27.403846153846153,0
788,4,0,0,39,0.0,0.0,1.0,39,750,400,350,0.5333333333333333,11,4,7,350.72000000000014,0.3848965362123257,0.030974358974359406,0.23073684210526324,135633.68055555545,1713.9402531229357,137347.6208086784,781,49,389.15384615384613,36,3,19,30.45000000000001,0.6765046296296298,39.58333333333333,1041.6666666666658,28.935185185185162,0
789,4,0,0,39,0.0,0.0,1.0,39,800,400,400,0.5,12,4,8,350.33723230870316,0.3845872694556905,0.025203238516400495,0.23124256403600132,135751.01072356146,1711.7266760003254,137462.73739956177,782,50,390.15384615384613,36,3,19,30.343410056912308,0.6776620370370371,39.47072072072072,1042.1171171171175,28.947697697697706,0
790,4,0,0,39,0.0,0.0,1.0,39,1100,600,500,0.5454545454545454,16,6,10,350.93506990283134,0.38388439046333783,0.024854627014454733,0.23278357788683504,135927.101087574,1740.3173443713983,137667.4184319454,783,51,391.15384615384613,36,3,15,30.15298776097913,0.6793981481481481,39.3018018018018,1042.7927927927924,28.966466466466457,0
791,4,0,0,39,0.0,0.0,1.0,39,850,600,250,0.7058823529411765,11,6,5,349.6308334751268,0.38340643274853803,0.02151302529612731,0.23298928650905498,136090.936634349,1716.317520775618,137807.25415512462,784,52,392.15384615384613,37,2,16,30.024432534678436,0.6790540540540541,39.14473684210526,1043.4210526315787,28.20056899004267,0
792,4,0,0,39,0.0,0.0,1.0,39,1000,800,200,0.8,12,8,4,350.89074625402264,0.38318151147098517,0.019675804362286664,0.23477377337206948,136233.9869599299,1760.6490699061144,137994.63602983602,785,53,393.15384615384613,37,2,16,29.8496962854042,0.6804617117117118,39.007675438596486,1043.9692982456133,28.21538643907063,0
793,4,0,0,39,0.0,0.0,1.0,39,550,200,350,0.36363636363636365,9,2,7,349.0408256685439,0.3830128205128205,0.02307503830133273,0.23391384819433783,136291.22813029002,1714.2405595952546,138005.46868988528,786,54,394.15384615384613,37,2,16,29.841239630368584,0.6810247747747749,38.95285087719298,1044.1885964912276,28.221313418681827,0
794,4,0,0,39,0.0,0.0,1.0,39,750,400,350,0.5333333333333333,11,4,7,350.01525774684745,0.38245051731893837,0.015550944279820289,0.23532783066719928,136405.74653980057,1748.8185066558822,138154.56504645647,787,55,395.15384615384613,37,2,16,29.702315349357974,0.6821509009009009,38.84320175438596,1044.6271929824552,28.233167377904195,0
795,4,0,0,39,0.0,0.0,1.0,39,700,300,400,0.42857142857142855,11,3,8,350.8932415336119,0.381578947368421,0.012774773320418875,0.23649311116091368,136491.6669071252,1778.8006886734318,138270.46759579863,788,56,396.15384615384613,37,2,17,29.59426372857643,0.6829954954954955,38.7609649122807,1044.9561403508767,28.242057847320993,0
796,4,0,0,39,0.0,0.0,1.0,39,1200,700,500,0.5833333333333334,17,7,10,350.60694298142255,0.38135402609086816,0.033735640540933476,0.23477350992047127,136262.60604224357,1776.3239650661512,138038.9300073097,789,57,397.15384615384613,37,2,16,29.82872995869215,0.6807432432432433,38.980263157894726,1044.0789473684194,28.2183499288762,3
797,4,0,0,39,0.0,0.0,1.0,39,700,400,300,0.5714285714285714,10,4,6,348.29965790385984,0.3810166441745389,0.03344481605351146,0.233673929719302,136330.12963191248,1696.747502556795,138026.87713446928,790,58,398.15384615384613,38,1,16,29.822037510656436,0.6795504385964912,38.91559829059829,1044.3376068376067,27.48256860098965,0
798,4,0,0,39,0.0,0.0,1.0,39,1050,800,250,0.7619047619047619,13,8,5,343.43784109300327,0.38067926225820964,0.03091080698442661,0.23132383511636143,136469.6334648257,1573.7672583826334,138043.40072320832,791,59,399.15384615384613,38,1,16,29.81083844580777,0.680921052631579,38.78205128205128,1044.8717948717942,27.49662618083669,0
799,4,0,0,39,0.0,0.0,1.0,39,750,300,450,0.4,12,3,9,342.84074819159963,0.3801450742240216,0.038795713128740195,0.23147074117035318,136553.37000739636,1563.2119082840152,138116.58191568038,792,60,400.15384615384613,38,1,17,29.7435602575897,0.6817434210526316,38.70192307692307,1045.192307692307,27.50506072874492,0
800,4,0,0,39,0.0,0.0,1.0,39,750,400,350,0.5333333333333333,11,4,7,340.5525326106957,0.3796108861898336,0.03942435412753209,0.23065658385196378,136665.05868078372,1508.3263706260384,138173.38505140977,793,61,401.15384615384613,38,1,17,29.69287490208099,0.6828399122807018,38.595085470085465,1045.619658119657,27.516306792622554,0
801,4,0,0,39,0.0,0.0,1.0,39,900,500,400,0.5555555555555556,13,5,8,344.0519670020082,0.378936122357175,0.03845616298446464,0.23377890065521098,136778.26350415524,1611.77753461897,138390.04103877422,794,62,402.15384615384613,37,2,17,29.48943046820405,0.6858108108108107,38.486842105263165,1046.0526315789484,28.271692745376985,0
802,4,0,0,39,0.0,0.0,1.0,39,900,600,300,0.6666666666666666,12,6,6,342.37711733899266,0.37865497076023397,0.03617633545329224,0.23321233624311236,136864.3010950484,1571.840975107716,138436.14207015611,795,63,403.15384615384613,37,2,17,29.448177547242306,0.6866554054054055,38.40460526315789,1046.3815789473679,28.280583214793726,0
803,4,0,0,39,0.0,0.0,1.0,39,1050,900,150,0.8571428571428571,12,9,3,347.35411985784606,0.3780083220872694,0.02611093657276564,0.23776949752849955,137036.4574316134,1720.03561191904,138756.49304353245,796,64,404.15384615384613,37,2,16,29.147794707997356,0.6883445945945947,38.24013157894736,1047.0394736842093,28.29836415362728,0
804,4,0,0,39,0.0,0.0,1.0,39,400,100,300,0.25,7,1,6,347.25338793385157,0.3776990553306343,0.03248418074090842,0.23809168041322423,137093.86692299545,1721.2619507925438,138815.128873788,797,65,405.15384615384613,37,2,16,29.09370310264197,0.6889076576576577,38.185307017543856,1047.2587719298238,28.30429113323848,0
805,4,0,0,39,0.0,0.0,1.0,39,750,500,250,0.6666666666666666,10,5,5,345.05160434741094,0.37724921277552853,0.03359765997128661,0.23736271270982778,137208.7219745497,1668.8179295552343,138877.53990410492,798,66,406.15384615384613,37,2,16,29.03791644863073,0.6900337837837839,38.075657894736835,1047.6973684210514,28.316145092460847,0
806,4,0,0,39,0.0,0.0,1.0,39,550,300,250,0.5454545454545454,8,3,5,346.7465584228232,0.37693994601889336,0.028138859152775808,0.23892262861189015,137266.16753472202,1719.3142361110863,138985.4817708331,799,67,407.15384615384613,37,2,16,28.936795891318745,0.6905968468468469,38.02083333333332,1047.916666666665,28.322072072072025,0
807,4,0,0,39,0.0,0.0,1.0,39,800,600,200,0.75,10,6,4,341.13319262081615,0.37724921277552853,0.024604644918780894,0.2337031556333426,137065.16067443838,1551.4951715912648,138616.65584602964,800,68,408.15384615384613,37,2,15,29.282286212914485,0.6886261261261261,38.21271929824562,1047.149122807018,28.30132764343292,2
808,4,0,0,39,0.0,0.0,1.0,39,900,400,500,0.4444444444444444,14,4,10,343.4542877623906,0.3769961763382816,0.02717932610090501,0.2354868558807319,137093.86692299563,1617.095284125893,138710.9622071215,801,69,409.15384615384613,37,2,15,29.193169127141985,0.6889076576576576,38.18530701754386,1047.2587719298253,28.30429113323852,0
809,4,0,1,38,0.0,0.02564102564102564,0.9743589743589743,39,500,400,100,0.8,6,4,2,342.9171261107322,0.3770242914979757,0.028529399132414257,0.23531209688288193,137122.57617728543,1604.3359495229402,138726.91212680837,802,70,410.15384615384613,37,2,15,29.178880513679506,0.6891891891891891,38.15789473684211,1047.3684210526324,28.307254623044116,0
810,4,0,0,38,0.0,0.0,1.0,38,1000,900,100,0.9,11,9,2,348.0892032920519,0.37646692745376953,0.03613363588521867,0.23893562212689107,137133.43992218567,1946.9339694424134,139080.37389162809,803,71,418.0,36,2,15,29.032720496004014,0.6912615740740741,38.14752252252252,1047.4099099099099,29.09471971971972,0
811,4,0,0,38,0.0,0.0,1.0,38,1150,800,350,0.6956521739130435,15,8,7,344.73527767988406,0.3756816026552869,0.03645652593021009,0.2371451100238511,137208.72197454987,1860.1373739996934,139068.85934854957,804,72,419.0,37,1,15,29.046201814058957,0.6900337837837838,38.07565789473684,1047.6973684210527,28.316145092460886,0
812,4,0,0,38,0.0,0.0,1.0,38,1100,700,400,0.6363636363636364,15,7,8,344.9748531169968,0.37538525367472736,0.031044429397937723,0.23848912296830116,137381.09472385733,1878.6045946829781,139259.6993185403,805,73,420.0,37,1,16,28.86977913746819,0.691722972972973,37.911184210526315,1048.3552631578946,28.333926031294446,0
813,4,0,0,38,0.0,0.0,1.0,38,750,500,250,0.6666666666666666,10,5,5,346.56415766918144,0.3751333570412518,0.034186858067569936,0.23978628622523254,137409.83403547248,1924.264677593107,139334.09871306558,806,74,421.0,37,1,16,28.79976295056822,0.6920045045045045,37.88377192982456,1048.4649122807018,28.336889521100048,0
814,4,0,0,38,0.0,0.0,1.0,38,1200,800,400,0.6666666666666666,16,8,8,349.98902176758617,0.37442211948790893,0.03608723879529463,0.24296044863778868,137524.82133925817,2026.4355378577966,139551.25687711596,807,75,422.0,37,1,16,28.59650498292565,0.6931306306306306,37.77412280701754,1048.9035087719292,28.348743480322412,0
815,4,0,0,38,0.0,0.0,1.0,38,950,600,350,0.631578947368421,13,6,7,353.06774392903884,0.37403686581318163,0.03463298715014984,0.24550524519716893,137582.3330255463,2115.1767851646655,139697.50981071097,808,76,423.0,37,1,16,28.45901268115942,0.6936936936936937,37.719298245614034,1049.1228070175437,28.35467045993361,0
816,4,0,0,38,0.0,0.0,1.0,38,1050,500,550,0.47619047619047616,16,5,11,352.32576549190964,0.37345898530109056,0.034642248253863084,0.24539720347580604,137639.8567347646,2098.813577254543,139738.67031201912,809,77,424.0,37,1,17,28.421717171717177,0.6942567567567567,37.66447368421053,1049.3421052631581,28.360597439544815,0
817,4,0,0,38,0.0,0.0,1.0,38,1150,900,250,0.782608695652174,14,9,5,352.52955572674153,0.37264402560455195,0.025265906280060202,0.2465646819637364,137783.71860812954,2114.566621460463,139898.28522959,810,78,425.0,37,1,18,28.274477806788514,0.6956644144144144,37.52741228070176,1049.890350877194,28.37541488857281,0
818,4,0,0,38,0.0,0.0,1.0,38,500,400,100,0.8,6,4,2,376.7291832135418,0.37264402560455195,-0.01645923598764054,0.2283593001228807,132629.89921932077,2393.113726250357,135023.01294557113,811,79,426.0,36,2,16,32.78169527349586,0.6467013888888888,42.48310810810811,1030.0675675675684,28.61298798798801,8
819,4,0,2,36,0.0,0.05263157894736842,0.9473684210526316,38,900,700,200,0.7777777777777778,11,7,4,378.2487571920073,0.3722884068278805,-0.010858247378200847,0.2296348957896269,132687.90486009675,2437.8070215485895,135125.71188164534,812,80,427.0,36,2,16,32.68412759135787,0.6472800925925926,42.42680180180181,1030.292792792794,28.61924424424428,0
820,4,0,0,36,0.0,0.0,1.0,36,450,200,250,0.4444444444444444,7,2,5,393.03269835475754,0.37003968253968256,-0.007390064361968651,0.23754995164712067,132520.55165816317,3216.982001133775,135737.53365929695,813,81,433.6388888888889,34,2,18,32.47220295217173,0.6498161764705883,42.58928571428571,1029.6428571428564,30.28361344537813,0
821,4,0,0,36,0.0,0.0,1.0,36,550,300,250,0.5454545454545454,8,3,5,392.06121153396384,0.3698247354497355,-0.007129094412331227,0.23715590767613895,132551.19756235817,3193.6366213151814,135744.83418367335,814,82,434.6388888888889,34,2,18,32.46628131021194,0.6501225490196079,42.5595238095238,1029.761904761904,30.28711484593835,0
822,4,0,1,35,0.0,0.027777777777777776,0.9722222222222222,36,750,600,150,0.8,9,6,3,390.0984450773729,0.3697089947089947,-0.007092950076419857,0.23616106706538495,132581.84700963704,3143.9944727891034,135725.84148242616,815,83,435.6388888888889,34,2,18,32.485887951296576,0.6504289215686274,42.5297619047619,1029.8809523809514,30.29061624649857,0
823,4,0,0,35,0.0,0.0,1.0,35,650,500,150,0.7692307692307693,8,5,3,397.42743764172326,0.370203081232493,-0.004081632653061051,0.23982690202517778,132461.0726643599,3528.732939254135,135989.80560361405,816,84,444.9428571428571,33,2,18,32.419146825396815,0.6515151515151515,42.64705882352941,1029.4117647058827,31.19429590017826,0
824,4,0,1,34,0.0,0.02857142857142857,0.9714285714285714,35,700,400,300,0.5714285714285714,10,4,6,398.040285220635,0.3700980392156863,-0.006468617681568478,0.24039801841398672,132492.61289227704,3547.479485053828,136040.09237733088,817,85,445.9428571428571,33,2,18,32.37151827163433,0.6518308080808082,42.61642156862745,1029.5343137254904,31.198009506833042,0
825,4,0,0,34,0.0,0.0,1.0,34,1400,1000,400,0.7142857142857143,18,10,8,404.3665688668885,0.3700794711824124,-0.001309835675160631,0.24360620124419874,132398.00347222228,3907.4652777777837,136305.46875000006,818,86,447.6764705882353,32,2,18,32.30431848852901,0.6533203125,42.708333333333336,1029.166666666667,32.16145833333334,0
826,4,2,2,34,0.05555555555555555,0.05555555555555555,0.9444444444444444,36,850,700,150,0.8235294117647058,10,7,3,388.7189203956758,0.3824900793650794,-0.016202367668372464,0.23764798922990407,132949.9167375284,3136.029620181413,136085.94635770982,819,0,423.75,34,2,17,32.15038093039363,0.6541053921568627,42.17261904761905,1031.3095238095243,30.332633053221304,0
827,4,1,0,35,0.02857142857142857,0.0,1.0,35,750,500,250,0.6666666666666666,10,5,5,394.1230486685034,0.3734593837535014,-0.003924963924963887,0.24085297418630758,132934.5703125,3478.515625000001,136413.0859375,820,0,436.8285714285714,33,2,18,32.02651515151514,0.65625,42.1875,1031.25,31.25,0
828,4,0,0,35,0.0,0.0,1.0,35,550,500,50,0.9090909090909091,6,5,1,391.2403931861268,0.3728641456582633,-0.001859959949767509,0.23969880857647885,133029.37121539802,3409.2926999231177,136438.66391532114,821,1,437.8285714285714,33,2,18,32.00532588896807,0.6571969696969696,42.09558823529412,1031.6176470588243,31.261140819964375,0
829,4,0,0,35,0.0,0.0,1.0,35,600,300,300,0.5,9,3,6,395.0327520156167,0.37279411764705883,-0.0024838819138108814,0.24243263644107121,133092.59059015784,3515.1864667435834,136607.77705690142,822,2,438.8285714285714,33,2,18,31.843824228028502,0.6578282828282828,42.03431372549021,1031.862745098041,31.26856803327397,0
830,4,0,0,35,0.0,0.0,1.0,35,950,700,250,0.7368421052631579,12,7,5,394.1414833937711,0.3726890756302521,-0.0011807216652244268,0.24209084111297946,133124.20590938587,3493.954398548643,136618.1603079345,823,3,439.8285714285714,33,2,18,31.83497110398607,0.6581439393939392,42.00367647058824,1031.9852941176475,31.272281639928714,0
831,4,0,0,35,0.0,0.0,1.0,35,1200,1000,200,0.8333333333333334,14,10,4,394.42810614844933,0.37212885154061626,-0.003892713031094175,0.2432980397076747,133282.33882401013,3514.060097078064,136796.3989210882,824,4,440.8285714285714,33,2,18,31.66834797056729,0.6597222222222221,41.85049019607844,1032.5980392156873,31.290849673202647,0
832,4,1,1,35,0.027777777777777776,0.027777777777777776,0.9722222222222222,36,700,500,200,0.7142857142857143,9,5,4,384.731713785557,0.3734623015873016,-0.009602708341333033,0.2387316660023176,133502.97796201822,3072.5659013605527,136575.54386337879,825,0,429.55555555555554,34,2,18,31.6968571209154,0.6596200980392156,41.636904761904766,1033.4523809523816,30.395658263305343,0
833,4,0,0,35,0.0,0.0,1.0,35,1300,1100,200,0.8461538461538461,15,11,4,390.6100162036372,0.37202380952380953,-0.00029946232900024405,0.23492562292591218,132334.94929834662,3338.271337946922,135673.22063629355,826,6,442.8285714285714,33,2,18,32.72193107829125,0.6502525252525254,42.769607843137244,1028.9215686274497,31.17944147355908,1
834,4,0,0,35,0.0,0.0,1.0,35,800,500,300,0.625,11,5,6,388.5804988662134,0.37177871148459385,0.0014557823129250913,0.23448823207443895,132461.07266435976,3294.3579392541214,135755.43060361387,827,7,443.8285714285714,33,2,18,32.646825396825406,0.6515151515151516,42.647058823529406,1029.4117647058815,31.19429590017823,0
835,4,0,0,35,0.0,0.0,1.0,35,950,700,250,0.7368421052631579,12,7,5,386.1381117336398,0.3709733893557423,0.0019040818755204914,0.2336010477248216,132555.70461180774,3236.9618956650993,135792.66650747284,828,8,444.8285714285714,33,2,19,32.61422011979848,0.6524621212121213,42.555147058823515,1029.7794117647043,31.205436720142554,0
836,4,0,0,35,0.0,0.0,1.0,35,1000,700,300,0.7,13,7,6,389.8266926816436,0.37058823529411766,0.0016586791747392748,0.23642735776925636,132650.37035034588,3342.131031334084,135992.50138167996,829,9,445.8285714285714,33,2,15,32.42376477119517,0.653409090909091,42.46323529411764,1030.1470588235281,31.216577540106915,0
837,4,0,0,35,0.0,0.0,1.0,35,600,300,300,0.5,9,3,6,388.5163669994893,0.3712885154061625,0.003723901262253193,0.23622806435999302,132745.06987997395,3314.7264573721573,136059.7963373461,830,10,446.8285714285714,33,2,15,32.3620277876878,0.6543560606060608,42.37132352941176,1030.5147058823522,31.22771836007128,0
838,4,0,0,35,0.0,0.0,1.0,35,950,800,150,0.8421052631578947,11,8,3,385.9606162636467,0.37195378151260505,0.010158730158730256,0.23586482105000614,132934.57031249988,3261.501736111097,136196.07204861098,831,11,447.8285714285714,33,2,15,32.23695286195286,0.65625,42.18749999999999,1031.249999999999,31.24999999999997,0
839,4,0,0,35,0.0,0.0,1.0,35,1050,800,250,0.7619047619047619,13,8,5,382.2146979719585,0.37058823529411766,0.01375120900005089,0.23436748304631586,133060.97902549486,3171.5723820165135,136232.55140751138,832,12,448.8285714285714,33,2,16,32.20629429465099,0.6575126262626263,42.06495098039215,1031.7401960784302,31.2648544266191,0
840,4,0,0,35,0.0,0.0,1.0,35,850,500,350,0.5882352941176471,12,5,7,380.85447636012964,0.3713235294117647,0.012579299114564124,0.2341282043726285,133155.82498317945,3142.598399653972,136298.42338283343,833,13,449.8285714285714,33,2,16,32.14596691205573,0.658459595959596,41.97303921568627,1032.1078431372543,31.275995246583467,0
841,4,0,0,35,0.0,0.0,1.0,35,800,700,100,0.875,9,7,2,382.9902878426334,0.37090336134453783,0.013253073336159549,0.23604192941288835,133250.70473195394,3206.745152104948,136457.44988405888,834,14,450.8285714285714,33,2,17,31.995425321463905,0.6594065656565657,41.88112745098039,1032.4754901960775,31.287136066547806,0
842,4,0,0,35,0.0,0.0,1.0,35,400,200,200,0.5,6,2,4,385.3398375418008,0.37076330532212887,0.011473325535269474,0.2378944183856964,133313.9766706315,3274.237222462516,136588.213893094,835,15,451.8285714285714,33,2,17,31.871143348759936,0.6600378787878787,41.81985294117647,1032.7205882352941,31.2945632798574,0
843,4,0,0,35,0.0,0.0,1.0,35,1050,800,250,0.7619047619047619,13,8,5,386.0206363747594,0.37030812324929974,0.006006474247072235,0.23872105238465488,133377.26362757114,3297.2752366878103,136674.53886425894,836,16,452.8285714285714,33,2,17,31.789926642148135,0.6606691919191918,41.75857843137255,1032.9656862745098,31.301990493166965,0
844,4,0,0,35,0.0,0.0,1.0,35,500,200,300,0.4,8,2,6,388.29802054178646,0.3706232492997199,0.008459583121504854,0.2403342373837931,133408.91273788933,3360.4833477508782,136769.3960856402,837,17,453.8285714285714,33,2,17,31.69928825622777,0.6609848484848484,41.727941176470594,1033.0882352941182,31.305704099821764,0
845,4,0,0,35,0.0,0.0,1.0,35,1200,900,300,0.75,15,9,6,386.7474928890351,0.36995798319327733,0.008111409723918994,0.2402059921691686,133537.46588358335,3329.071045708393,136866.53692929176,838,18,454.8285714285714,32,3,17,31.610116866194314,0.6647135416666666,41.60353535353536,1033.585858585859,32.29955808080809,0
846,4,0,0,35,0.0,0.0,1.0,35,900,400,500,0.4444444444444444,14,4,10,384.36769608652503,0.37013305322128853,0.004347678867707261,0.23953431459217883,133662.24078479444,3275.0895088427706,136937.3302936372,839,19,455.8285714285714,33,2,18,31.546278739037696,0.6635101010101009,41.48284313725491,1034.0686274509815,31.335412953060043,0
847,4,0,0,35,0.0,0.0,1.0,35,1050,800,250,0.7619047619047619,13,8,5,381.42225391752527,0.36988795518207285,0.008229004534073159,0.23892652166762499,133852.39451172634,3210.856401384094,137063.25091311042,840,20,456.8285714285714,33,2,16,31.431588504658137,0.6654040404040404,41.29901960784314,1034.803921568628,31.35769459298873,0
848,4,0,0,35,0.0,0.0,1.0,35,850,600,250,0.7058823529411765,11,6,5,380.9853635747909,0.36953781512605044,0.03478496811830167,0.2346067765171079,133219.0743944636,3150.9034986543543,136369.97789311793,841,21,457.8285714285714,33,2,18,32.078980690091804,0.6590909090909092,41.91176470588235,1032.3529411764698,31.283422459893025,1
849,4,0,0,35,0.0,0.0,1.0,35,1100,1000,100,0.9090909090909091,12,10,2,376.2460161159641,0.36936274509803924,0.028910434605736057,0.23247811025112491,133345.6182718184,3034.1515282583478,136379.76980007676,842,22,458.8285714285714,33,2,18,32.07413779465274,0.6603535353535355,41.7892156862745,1032.843137254901,31.298276886512152,0
850,4,0,0,35,0.0,0.0,1.0,35,600,200,400,0.3333333333333333,10,2,8,376.90357727631425,0.36852240896358546,0.028656149922903662,0.23348082733406353,133440.56560277296,3058.845305891961,136499.41090866493,843,23,459.8285714285714,33,2,19,31.96178290436088,0.661300505050505,41.697303921568626,1033.2107843137253,31.309417706476523,0
851,4,0,0,35,0.0,0.0,1.0,35,950,600,350,0.631578947368421,13,6,7,375.5213731427649,0.36904761904761907,0.026328805176327075,0.23322144779720758,133535.54672481734,3029.090373894649,136564.63709871197,844,24,460.8285714285714,33,2,19,31.902122361868624,0.6622474747474747,41.60539215686274,1033.5784313725487,31.32055852644087,0
852,4,1,0,36,0.027777777777777776,0.0,1.0,36,900,600,300,0.6666666666666666,12,6,6,366.9072108971073,0.37521494708994707,0.05270200158379068,0.21858644819038497,131976.01807213554,2504.7901018989014,134480.80817403444,845,0,449.0,32,4,18,33.69352625542722,0.6490885416666666,43.11868686868687,1027.5252525252529,32.11016414141415,6
853,4,0,0,36,0.0,0.0,1.0,36,500,300,200,0.6,7,3,4,366.62156476122334,0.3751984126984127,0.04913584797477166,0.21860314399938427,132008.4545741506,2479.429235537188,134487.88380968777,846,1,450.0,32,4,19,33.66814104926894,0.6494140625,43.08712121212121,1027.651515151515,32.114109848484844,0
854,4,0,0,36,0.0,0.0,1.0,36,1150,600,550,0.5217391304347826,17,6,11,364.06386160532855,0.37418981481481484,0.043660540068497955,0.21782307311184368,132138.24043783802,2421.351615906545,134559.59205374456,847,2,451.0,32,4,20,33.60299234516353,0.6507161458333333,42.96085858585859,1028.156565656566,32.12989267676769,0
855,4,0,0,36,0.0,0.0,1.0,36,850,600,250,0.7058823529411765,11,6,5,361.74041628087593,0.3742228835978836,0.041037446286065205,0.21680468657893573,132203.15728305798,2364.6450298439095,134567.80231290188,848,3,452.0,32,4,21,33.59729895641499,0.6513671875,42.89772727272728,1028.409090909092,32.13778409090912,0
856,4,0,0,36,0.0,0.0,1.0,36,700,400,300,0.5714285714285714,10,4,6,362.3315104049864,0.3741236772486773,0.04471652823806971,0.21753241085257374,132268.09007052862,2384.9793707274885,134653.0694412561,849,4,453.0,32,4,21,33.51668303260915,0.6520182291666666,42.834595959595966,1028.6616161616168,32.14567550505053,0
857,4,0,0,36,0.0,0.0,1.0,36,1000,600,400,0.6,14,6,8,360.8448944258342,0.37374338624338627,0.039659168370824505,0.21719984413371893,132365.51914345502,2352.6843561881733,134718.2034996432,850,5,454.0,32,4,22,33.45679959100204,0.6529947916666665,42.739898989899004,1029.0404040404062,32.157512626262694,0
858,4,1,0,37,0.02702702702702703,0.0,1.0,37,550,400,150,0.7272727272727273,7,4,3,351.4538238248416,0.37903528528528524,0.04258999096634386,0.21333373984804657,132681.93310565653,1926.314548490974,134608.2476541475,851,0,442.7027027027027,33,4,18,33.38029320804092,0.6537247474747474,42.43259803921569,1030.2696078431377,31.22029114676175,0
859,4,0,0,37,0.0,0.0,1.0,37,400,200,200,0.5,6,2,4,348.62683367311644,0.3789727227227227,0.04024002596960141,0.21197418975829638,132745.0698799742,1855.6986795944076,134600.76855956862,852,1,443.7027027027027,33,4,18,33.38969655527808,0.6543560606060606,42.371323529411775,1030.5147058823543,31.227718360071343,0
860,4,0,0,37,0.0,0.0,1.0,37,850,600,250,0.7058823529411765,11,6,5,348.2378840182344,0.3785347847847848,0.03628021744997478,0.21227370147546318,132839.80320069232,1851.970396001569,134691.77359669388,853,2,444.7027027027027,33,4,18,33.30460453320653,0.6553030303030302,42.2794117647059,1030.8823529411786,31.238859180035718,0
861,4,0,1,36,0.0,0.02702702702702703,0.972972972972973,37,1000,700,300,0.7,13,7,6,349.71941638608286,0.378440940940941,0.038656838656838666,0.21371742112482872,132934.57031250023,1897.9600694444728,134832.5303819447,854,3,445.7027027027027,33,4,18,33.1712962962963,0.6562499999999998,42.187500000000014,1031.2500000000018,31.250000000000057,0
862,4,0,1,35,0.0,0.027777777777777776,0.9722222222222222,36,850,600,250,0.7058823529411765,11,6,5,353.3071655853902,0.3783234126984127,0.04002067689628874,0.21600396171418215,132950.84685236233,2194.497372717108,135145.34422507943,855,4,446.0833333333333,32,4,18,33.06245919033626,0.6588541666666665,42.17171717171719,1031.313131313134,32.228535353535435,0
863,4,0,1,34,0.0,0.02857142857142857,0.9714285714285714,35,850,400,450,0.47058823529411764,13,4,9,353.5374577256728,0.37710084033613445,0.04391463180157662,0.21708952982659105,133113.6670524693,2412.133487654343,135525.80054012366,856,5,446.6,32,3,19,32.89311350381336,0.6604817708333333,42.0138888888889,1031.944444444446,32.248263888888935,0
864,4,0,0,34,0.0,0.0,1.0,34,700,400,300,0.5714285714285714,10,4,6,385.53664074522254,0.3708593285799168,0.012494813542295757,0.21894037904863978,130133.72559241409,3234.2638825119902,133367.9894749261,857,6,460.4117647058824,32,2,20,35.08358082745535,0.6305338541666666,44.917929292929294,1020.3282828282832,31.88525883838385,6
865,4,1,2,33,0.02857142857142857,0.05714285714285714,0.9428571428571428,35,600,500,100,0.8333333333333334,7,5,2,376.32167333127785,0.3766106442577031,0.003129470356569186,0.21512834032344255,130391.51178770048,2813.8941498316813,133205.40593753217,858,0,448.22857142857146,32,3,21,35.05660979931595,0.6331380208333333,44.665404040404056,1021.3383838383858,31.916824494949555,0
866,4,0,0,33,0.0,0.0,1.0,33,800,700,100,0.875,9,7,2,392.2861002407711,0.3702256944444444,0.009325198914379662,0.22313051187860417,130196.13477918842,3614.8267957899347,133810.96157497834,859,8,469.4848484848485,31,2,21,34.84785659607042,0.6337365591397849,44.856770833333336,1020.5729166666671,32.921706989247326,0
867,4,1,1,33,0.029411764705882353,0.029411764705882353,0.9705882352941176,34,1350,900,450,0.6666666666666666,18,9,9,381.227877746809,0.37505570409982175,0.0004234334834711806,0.21889229059507728,130561.83073255769,3154.7788831922962,133716.60961575,860,0,456.6470588235294,31,3,17,34.75827600118911,0.6374327956989245,44.49869791666668,1022.0052083333348,32.96790994623661,0
868,4,1,0,34,0.029411764705882353,0.0,1.0,34,800,700,100,0.875,9,7,2,381.52807711968273,0.3770796197266786,0.003947033358798313,0.22000892200425765,130728.22570800791,3175.297715928833,133903.52342393674,861,0,457.61764705882354,31,3,19,34.58163568457687,0.6391129032258064,44.33593750000001,1022.6562500000008,32.988911290322605,0
869,4,0,0,34,0.0,0.0,1.0,34,900,700,200,0.7777777777777778,11,7,4,382.57464886902517,0.3766896910279263,0.004286174187124292,0.22118388639911185,130828.11355590819,3210.303921169705,134038.4174770779,862,1,458.61764705882354,31,3,19,34.45348627550805,0.6401209677419355,44.23828125,1023.0468749999999,33.00151209677419,0
870,4,0,0,34,0.0,0.0,1.0,34,1000,800,200,0.8,12,8,4,380.2083535665495,0.3759469696969697,0.002469690166142957,0.22038625804078754,130928.03955078124,3155.9868706597226,134084.02642144097,863,2,459.61764705882354,31,3,19,34.41263782866837,0.6411290322580645,44.140625,1023.4374999999999,33.0141129032258,0
871,4,1,1,34,0.02857142857142857,0.02857142857142857,0.9714285714285714,35,1000,800,200,0.8,12,8,4,369.9887434088164,0.3779411764705882,0.001575003175409151,0.21689660289334428,131361.49300469304,2721.065097384991,134082.55810207804,864,0,447.45714285714286,31,4,21,34.235281976374935,0.645497311827957,43.71744791666667,1025.1302083333344,33.0687163978495,0
872,4,0,1,33,0.0,0.029411764705882353,0.9705882352941176,34,850,700,150,0.8235294117647058,10,7,3,380.3606573787191,0.3759655377302436,0.0023245384557888382,0.22239512433659164,131261.4017062719,3185.3346082899525,134446.73631456186,865,4,461.61764705882354,31,3,22,34.07083862770013,0.6444892473118278,43.81510416666668,1024.7395833333348,33.0561155913979,0
873,4,0,0,33,0.0,0.0,1.0,33,900,600,300,0.6666666666666666,12,6,6,387.76496569598254,0.37622316919191917,0.006560818790184886,0.22610228030367904,131155.97043372074,3571.5380752110127,134727.50850893176,866,5,465.8787878787879,30,3,22,33.98804837510388,0.6461805555555555,43.918010752688176,1024.327956989248,34.14426523297493,0
874,4,2,1,34,0.05714285714285714,0.02857142857142857,0.9714285714285714,35,900,600,300,0.6666666666666666,12,6,6,365.9444831686943,0.38424369747899156,0.007535958842071144,0.21698031535852055,131795.6627739801,2646.092049992009,134441.7548239721,867,0,440.2,31,4,16,33.900266294699456,0.6498655913978495,43.294270833333336,1026.822916666667,33.12331989247313,0
875,4,0,0,34,0.0,0.0,1.0,34,800,600,200,0.75,10,6,4,377.1026564407785,0.3799390968508616,0.010928772294772626,0.22267430641340616,131638.2877536419,3128.2296002427825,134766.51735388467,868,1,454.1470588235294,30,4,16,33.77292075965945,0.6510416666666667,43.44758064516128,1026.2096774193537,34.20698924731179,0
876,4,1,1,34,0.02857142857142857,0.02857142857142857,0.9714285714285714,35,950,600,350,0.631578947368421,13,6,7,366.30426788884256,0.38760504201680673,0.006432102565960163,0.21776747320083492,131895.95752292214,2662.8104315863757,134558.7679545085,869,0,442.14285714285717,31,4,16,33.7897969746905,0.6508736559139785,43.196614583333336,1027.213541666667,33.13592069892474,0
877,4,0,0,34,0.0,0.0,1.0,34,800,400,400,0.5,12,4,8,379.66323236194984,0.3799762329174094,0.047301510973529526,0.21430306028563134,129897.31046888568,3063.4465535481813,132960.75702243386,870,3,456.1470588235294,31,3,20,35.4740122195257,0.6307123655913978,45.149739583333336,1019.4010416666671,32.883904569892486,5
878,4,1,0,35,0.02857142857142857,0.0,1.0,35,750,500,250,0.6666666666666666,10,5,5,369.01291128696346,0.3850490196078431,0.042215743440233044,0.2102515424774561,130262.58680555566,2613.7152777777865,132876.30208333346,871,0,444.0857142857143,32,3,22,35.37414965986394,0.6318359375,44.79166666666667,1020.8333333333343,31.901041666666696,0
879,4,0,0,35,0.0,0.0,1.0,35,800,500,300,0.625,11,5,6,369.1010531042803,0.38483893557422966,0.04236964815599853,0.21082551677312275,130359.27456382,2623.149104683192,132982.42366850318,872,1,445.0857142857143,32,3,22,35.27370796241345,0.6328125,44.696969696969695,1021.212121212121,31.912878787878782,0
880,4,0,0,35,0.0,0.0,1.0,35,650,500,150,0.7692307692307693,8,5,3,370.4262787213686,0.3847689075630252,0.05231209280152527,0.21211033412134425,130455.99819214887,2664.865989439866,133120.86418158872,873,2,446.0857142857143,32,3,22,35.14166975651959,0.6337890625,44.602272727272734,1021.59090909091,31.92471590909094,0
881,4,2,1,36,0.05405405405405406,0.02702702702702703,0.972972972972973,37,800,400,400,0.5,12,4,8,353.36057425893824,0.3939877377377377,0.07464069158039188,0.20647484471464259,131236.62308673482,1874.7696995465017,133111.39278628133,874,0,422.9189189189189,34,3,19,34.78757600402772,0.6369485294117647,43.83928571428572,1024.6428571428582,30.136554621848774,0
882,4,0,1,35,0.0,0.027777777777777776,0.9722222222222222,36,850,200,650,0.23529411764705882,15,2,13,359.64902873159826,0.3897321428571428,0.07711100474652,0.20944856676724516,131108.39468293454,2230.601361255295,133338.99604418984,875,1,435.5833333333333,33,3,19,34.756167484344466,0.6379419191919191,43.96446078431373,1024.1421568627457,31.034610814022596,0
883,4,0,1,34,0.0,0.02857142857142857,0.9714285714285714,35,750,500,250,0.6666666666666666,10,5,5,359.053783714777,0.3887605042016807,0.08208388883191464,0.209272770173508,131139.77346453283,2417.2463715878434,133557.0198361207,876,2,437.0571428571429,33,2,19,34.739670575097705,0.6382575757575758,43.93382352941176,1024.2647058823527,31.038324420677355,0
884,4,0,0,34,0.0,0.0,1.0,34,900,600,300,0.6666666666666666,12,6,6,367.7821478374559,0.38200014854426617,0.0811860436444336,0.21414795413564996,131101.73906042744,2843.375835373933,133945.11489580138,877,3,450.47058823529414,32,2,20,34.55466855710352,0.6402994791666667,43.97095959595959,1024.116161616161,32.00363005050503,0
885,4,1,0,35,0.02857142857142857,0.0,1.0,35,700,500,200,0.7142857142857143,9,5,4,358.83479819772276,0.3867296918767507,0.07726496929600768,0.21035232682796462,131360.48179076108,2427.537687480861,133788.01947824194,878,0,438.57142857142856,32,3,21,34.52215995401735,0.6429036458333335,43.71843434343434,1025.1262626262621,32.03519570707069,0
886,4,0,0,35,0.0,0.0,1.0,35,1500,1300,200,0.8666666666666667,17,13,4,356.10311047163094,0.38588935574229694,0.07448370029015194,0.20960499540418778,131516.61169982693,2366.6949009996088,133883.30660082653,879,1,439.57142857142856,33,2,21,34.43448825169254,0.6420454545454546,43.56617647058823,1025.7352941176466,31.082887700534744,0
887,4,1,1,35,0.027777777777777776,0.027777777777777776,0.9722222222222222,36,1050,800,250,0.7619047619047619,13,8,5,346.72043688300766,0.3887566137566138,0.061594202898550776,0.20553015588425733,131786.11288265322,1938.5877267573885,133724.70060941062,880,0,428.3333333333333,34,2,17,34.40338164251207,0.6424632352941175,43.30357142857144,1026.7857142857156,30.199579831932812,0
888,4,0,1,34,0.0,0.02857142857142857,0.9714285714285714,35,850,800,50,0.9411764705882353,9,8,1,357.33827578525285,0.38553921568627453,0.07113006396588495,0.21120028649975245,131673.78720023538,2410.416816849276,134084.20401708467,881,3,441.57142857142856,33,2,17,34.24415422885572,0.6436237373737375,43.412990196078425,1026.3480392156855,31.101455733808653,0
889,4,0,1,33,0.0,0.029411764705882353,0.9705882352941176,34,700,400,300,0.5714285714285714,10,4,6,386.88178647708475,0.38135026737967914,0.010577455721408224,0.22386723697620992,130861.41798231332,3327.565999161225,134188.98398147454,882,8,455.47058823529414,31,3,20,34.30951471960635,0.6404569892473118,44.205729166666664,1023.1770833333329,33.005712365591386,6
890,4,0,0,33,0.0,0.0,1.0,33,1050,900,150,0.8571428571428571,12,9,3,391.2619548899478,0.374960542929293,0.03883309649761779,0.22651538118457565,130880.7579814139,3641.7322450572183,134522.49022647113,883,9,470.030303030303,30,3,20,34.17783177897457,0.6434027777777779,44.18682795698924,1023.252688172042,34.10842293906806,0
891,4,0,0,33,0.0,0.0,1.0,33,700,500,200,0.7142857142857143,9,5,4,389.9074565487961,0.3742897727272727,0.04183377896613205,0.22633652355759376,130983.9287778934,3614.322103711411,134598.2508816048,884,10,471.030303030303,30,3,20,34.10774466036413,0.6444444444444444,44.086021505376344,1023.6559139784946,34.121863799283155,0
892,4,0,0,33,0.0,0.0,1.0,33,800,400,400,0.5,12,4,8,388.4557435722456,0.3744870580808081,0.04162639652861477,0.2260996417323865,131087.1402221355,3584.310505549774,134671.45072768527,885,11,472.030303030303,30,3,20,34.040173688585554,0.6454861111111111,43.98521505376344,1024.0591397849462,34.1353046594982,0
893,4,0,1,32,0.0,0.030303030303030304,0.9696969696969697,33,650,300,350,0.46153846153846156,10,3,7,388.56123716504885,0.3740530303030303,0.04659558057616331,0.22676981237917307,131190.39231414022,3595.100228350082,134785.4925424903,886,12,473.030303030303,30,3,20,33.932749497069885,0.6465277777777778,43.88440860215053,1024.4623655913967,34.14874551971322,0
894,4,0,0,32,0.0,0.0,1.0,32,900,600,300,0.6666666666666666,12,6,6,389.9795095511933,0.37296286962365593,0.018292682926829507,0.2284165698799845,131328.12499999997,3843.0555555555547,135171.18055555553,887,13,461.28125,30,2,20,33.75677506775068,0.6479166666666667,43.75,1024.9999999999998,34.16666666666666,0
895,4,0,0,32,0.0,0.0,1.0,32,1350,1200,150,0.8888888888888888,15,12,3,389.6027489002168,0.3727528561827957,0.019415050452103122,0.22922579621106814,131500.3924767315,3846.5828780783977,135346.9753548099,888,14,462.28125,30,2,21,33.591873061634566,0.6496527777777779,43.58198924731183,1025.6720430107532,34.18906810035844,0
896,4,1,1,32,0.030303030303030304,0.030303030303030304,0.9696969696969697,33,1400,1100,300,0.7857142857142857,17,11,6,378.10086254975505,0.3767755681818182,0.013781441555696494,0.2239913825097535,131762.23966810433,3363.883293999562,135126.1229621039,889,0,449.24242424242425,31,2,17,33.62198795180722,0.6495295698924731,43.326822916666664,1026.692708333333,33.119119623655905,0
897,4,0,0,32,0.0,0.0,1.0,32,750,600,150,0.8,9,6,3,390.2911530456584,0.3723958333333333,0.016556155861165545,0.23046194535990727,131638.287753642,3875.4518224650196,135513.73957610704,890,16,464.28125,30,2,17,33.43456668849595,0.6510416666666666,43.44758064516129,1026.2096774193546,34.206989247311824,0
898,4,1,1,32,0.030303030303030304,0.030303030303030304,0.9696969696969697,33,650,400,250,0.6153846153846154,9,4,5,376.13854243731214,0.3778409090909091,0.010806327116047232,0.22400824440549652,131962.841881646,3327.2622002495614,135290.10408189555,891,0,451.1818181818182,31,2,17,33.46969648967177,0.6515456989247312,43.131510416666664,1027.473958333333,33.14432123655913,0
899,4,0,0,32,0.0,0.0,1.0,32,950,600,350,0.631578947368421,13,6,7,385.7036058276291,0.37283686155913975,0.016984212528531772,0.22869613801178057,131795.66277397997,3766.8124728732546,135562.47524685322,892,18,466.28125,31,1,17,33.39303829571393,0.6498655913978495,43.29427083333333,1026.822916666666,33.1233198924731,0
900,4,0,0,32,0.0,0.0,1.0,32,1100,800,300,0.7272727272727273,14,8,6,386.9547559051759,0.37229082661290325,0.019972757222503912,0.23065309166190717,131996.29041883684,3815.3184678819507,135811.60888671878,893,19,467.28125,31,1,18,33.15805034634229,0.6518817204301075,43.098958333333336,1027.604166666667,33.14852150537635,0
901,4,1,1,32,0.030303030303030304,0.030303030303030304,0.9696969696969697,33,700,400,300,0.5714285714285714,10,4,6,374.47278179494515,0.37827493686868685,0.013137388367534752,0.22482164725743678,132268.0900705285,3306.15992628303,135574.24999681153,894,0,454.09090909090907,32,1,18,33.20445153635285,0.6520182291666667,42.83459595959596,1028.661616161616,32.1456755050505,0
902,4,0,0,32,0.0,0.0,1.0,32,1050,800,250,0.7619047619047619,13,8,5,387.49244049270646,0.3722488239247312,0.015613129906305367,0.23220146396141092,132197.07065158425,3845.0731065538234,136042.14375813806,895,21,469.28125,31,1,18,32.94135646155144,0.6538978494623656,42.903645833333336,1028.385416666667,33.17372311827958,0
903,4,0,0,32,0.0,0.0,1.0,32,550,300,250,0.5454545454545454,8,3,5,387.4537388795382,0.37105174731182794,0.014574895582837755,0.23279634911689956,132297.51798841677,3851.8335978190003,136149.35158623577,896,22,470.28125,31,1,18,32.84091148799731,0.6549059139784946,42.80598958333333,1028.7760416666658,33.186323924731155,0
904,4,0,0,32,0.0,0.0,1.0,32,1100,900,200,0.8181818181818182,13,9,4,393.34230260506274,0.37019069220430106,0.01515782086434303,0.23740021242333925,132467.17693158163,4021.027025744767,136488.2039573264,897,23,471.28125,30,2,18,32.518115942028984,0.659375,42.641129032258064,1029.4354838709673,34.31451612903224,0
905,4,1,1,32,0.030303030303030304,0.030303030303030304,0.9696969696969697,33,700,300,400,0.42857142857142855,11,3,8,381.8295859156643,0.3742503156565657,0.0016847780304944937,0.2320890432362955,132733.2305908203,3536.294894748263,136269.52548556856,898,0,457.969696969697,31,2,17,32.5462260972117,0.6592741935483871,42.3828125,1030.46875,33.24092741935484,0
906,4,0,0,32,0.0,0.0,1.0,32,600,300,300,0.5,9,3,6,389.6144091052412,0.3689936155913978,0.006752591983815837,0.23576590371946068,132565.56404961474,3929.890780978726,136495.45483059346,899,25,473.28125,31,1,19,32.514777468706534,0.6575940860215055,42.545572916666664,1029.817708333333,33.21992607526881,0
907,4,0,0,32,0.0,0.0,1.0,32,950,600,350,0.631578947368421,13,6,7,387.590083435485,0.36876260080645157,0.007488624873609684,0.23516968866116228,132666.1512586805,3884.0169270833267,136550.16818576382,900,26,474.28125,31,1,17,32.4654533198517,0.6586021505376344,42.447916666666664,1030.208333333333,33.23252688172042,0
908,4,1,1,32,0.030303030303030304,0.030303030303030304,0.9696969696969697,33,700,600,100,0.8571428571428571,8,6,2,380.8389351734636,0.3740924873737374,0.013782871555209741,0.23324243630938507,133015.96297571668,3531.5315401489543,136547.49451586563,901,0,460.8787878787879,32,1,17,32.28707670338638,0.6595052083333334,42.108585858585855,1031.565656565656,32.23642676767675,0
909,4,0,0,32,0.0,0.0,1.0,32,900,600,300,0.6666666666666666,12,6,6,386.84225512442214,0.36691448252688175,0.01878313975508128,0.23661602338537066,132968.14176771385,3887.53916422527,136855.68093193913,902,28,476.28125,31,1,18,32.18041177460758,0.6616263440860215,42.15494791666667,1031.3802083333342,33.27032930107529,0
910,4,0,0,32,0.0,0.0,1.0,32,800,600,200,0.75,10,6,4,384.8575109463189,0.36710349462365593,0.019194963393082576,0.23561369410484842,133001.7174614801,3837.341986762158,136839.05944824225,903,29,477.28125,31,1,18,32.197782546494985,0.6619623655913978,42.122395833333336,1031.510416666667,33.274529569892486,0
911,4,0,0,32,0.0,0.0,1.0,32,650,200,450,0.3076923076923077,11,2,9,385.79949328964256,0.3670404905913978,0.01708238672220097,0.23640289136379256,133035.29739379883,3864.990064832899,136900.28745863173,904,30,478.28125,31,1,18,32.13968299044976,0.6622983870967742,42.08984375,1031.640625,33.27872983870968,0
912,4,0,0,32,0.0,0.0,1.0,32,950,800,150,0.8421052631578947,11,8,3,390.80713174459726,0.3667044690860215,0.022338899034698434,0.23739520379984813,132709.42630650944,3981.341118911249,136690.7674254207,905,31,479.28125,30,2,16,32.33895338725107,0.6618055555555555,42.405913978494624,1030.3763440860216,34.34587813620072,2
913,4,0,0,32,0.0,0.0,1.0,32,700,400,300,0.5714285714285714,10,4,6,389.42604797042844,0.36657846102150543,0.019154277516953755,0.23699356633628932,132778.68106139434,3941.4954040929542,136720.17646548728,906,32,480.28125,30,2,16,32.30470787689097,0.6624999999999999,42.33870967741935,1030.6451612903222,34.35483870967741,0
914,4,0,0,32,0.0,0.0,1.0,32,500,400,100,0.8,6,4,2,389.42604797042844,0.36657846102150543,0.019154277516953755,0.23699356633628932,132778.68106139434,3941.4954040929542,136720.17646548728,907,33,481.28125,30,2,16,32.30470787689097,0.6624999999999999,42.33870967741935,1030.6451612903222,34.35483870967741,0
915,4,0,0,32,0.0,0.0,1.0,32,900,800,100,0.8888888888888888,10,8,2,389.1058233738234,0.3669984879032258,0.01520654370894392,0.2369355152174757,132800.32687717007,3934.676106770822,136735.00298394088,908,34,482.28125,31,1,17,32.29114030655212,0.6599462365591398,42.31770833333333,1030.729166666666,33.24932795698923,7
916,4,0,0,32,0.0,0.0,1.0,32,700,500,200,0.7142857142857143,9,5,4,391.41839288185236,0.36647345430107525,0.018650530503979024,0.23855730688572918,132833.88137817368,3998.724873860662,136832.60625203434,909,35,483.28125,31,1,17,32.197723253757744,0.6602822580645162,42.28515624999999,1030.8593749999989,33.25352822580641,0
917,4,0,0,32,0.0,0.0,1.0,32,350,300,50,0.8571428571428571,4,3,1,391.41839288185236,0.36647345430107525,0.018650530503979024,0.23855730688572918,132833.88137817368,3998.724873860662,136832.60625203434,910,36,484.28125,31,1,17,32.197723253757744,0.6602822580645162,42.28515624999999,1030.8593749999989,33.25352822580641,0
918,4,0,0,32,0.0,0.0,1.0,32,800,500,300,0.625,11,5,6,394.37551834371266,0.36630544354838707,0.02048475186260923,0.2407910354482542,132901.00309583856,4082.580396864126,136983.5834927027,911,37,485.28125,31,1,17,32.05384202550826,0.660954301075269,42.22005208333332,1031.1197916666652,33.261928763440814,0
919,4,0,0,32,0.0,0.0,1.0,32,750,500,250,0.6666666666666666,10,5,5,391.3841601665214,0.36645245295698925,0.023486808886644672,0.23960937533533067,133001.7174614799,4010.9530978732405,137012.67055935314,912,38,486.28125,31,1,17,32.02947488008078,0.661962365591398,42.12239583333332,1031.5104166666654,33.27452956989243,0
920,4,0,0,32,0.0,0.0,1.0,32,1100,800,300,0.7272727272727273,14,8,6,388.9404007291921,0.36550739247311825,0.012994230041619481,0.23961992520448808,133236.86599731434,3964.2400105794122,137201.10600789374,913,39,487.28125,31,1,17,31.855766805397906,0.6643145161290323,41.89453124999999,1032.421874999999,33.303931451612875,0
921,4,0,0,32,0.0,0.0,1.0,32,850,600,250,0.7058823529411765,11,6,5,388.82911477954167,0.36515036962365593,0.009875472887767689,0.23976787559889298,133270.47559950076,3963.8882107204686,137234.36381022123,914,40,488.28125,31,1,17,31.824821353509876,0.6646505376344087,41.86197916666666,1032.5520833333323,33.308131720430076,0
922,4,1,0,33,0.030303030303030304,0.0,1.0,33,1050,700,350,0.6666666666666666,14,7,7,378.39498718619603,0.3694760101010101,0.011166611166611329,0.2358489303694783,133668.00103305784,3515.86030762167,137183.86134067952,915,0,474.45454545454544,32,1,18,31.694902319902333,0.666015625,41.47727272727273,1034.090909090909,32.31534090909091,0
923,4,0,1,32,0.0,0.030303030303030304,0.9696969696969697,33,1100,800,300,0.7272727272727273,14,8,6,378.0585527420042,0.36872632575757575,0.009514086174242209,0.23605607195598333,133733.29252117142,3511.8030047954403,137245.09552596687,916,1,475.45454545454544,32,1,16,31.638081868489582,0.6666666666666666,41.41414141414142,1034.343434343435,32.32323232323235,0
924,4,0,0,32,0.0,0.0,1.0,32,1100,800,300,0.7272727272727273,14,8,6,388.08308512565327,0.36300823252688175,0.012760646339927018,0.2408299801909545,133505.86149427618,3962.2733222113625,137468.13481648755,917,43,491.28125,31,1,17,31.607371592961243,0.667002688172043,41.63411458333333,1033.463541666666,33.337533602150515,0
925,4,0,0,32,0.0,0.0,1.0,32,450,200,250,0.4444444444444444,7,2,5,380.2592940106612,0.36332325268817206,0.05541899264146144,0.22467794268306093,131661.9957817926,3613.1395128038293,135275.13529459643,918,44,492.28125,31,1,15,33.667956525416564,0.648521505376344,43.42447916666667,1026.302083333334,33.10651881720432,4
926,4,1,1,32,0.030303030303030304,0.030303030303030304,0.9696969696969697,33,850,500,350,0.5882352941176471,12,5,7,372.7748578180688,0.3682528409090909,0.04824948514268912,0.22189239342104086,131943.58555568318,3237.05026910521,135180.6358247884,919,0,478.3333333333333,32,1,15,33.57553971570194,0.6487630208333333,43.15025252525253,1027.3989898989907,32.10621843434346,0
927,4,0,0,32,0.0,0.0,1.0,32,1100,800,300,0.7272727272727273,14,8,6,381.4224625848598,0.3635752688172043,0.0585769084453458,0.226157709770241,131795.66277398012,3653.9652506510465,135449.62802463118,920,46,494.28125,31,1,15,33.50293769549411,0.6498655913978495,43.294270833333336,1026.8229166666672,33.123319892473134,0
928,4,0,0,32,0.0,0.0,1.0,32,550,500,50,0.9090909090909091,6,5,1,380.12910976798923,0.36399529569892475,0.05863336713995948,0.2257875314646008,131862.52170138885,3624.956597222217,135487.47829861107,921,47,495.28125,31,1,16,33.46855983772819,0.6505376344086022,43.229166666666664,1027.083333333333,33.131720430107514,0
929,4,0,0,32,0.0,0.0,1.0,32,700,300,400,0.42857142857142855,11,3,8,379.78156560180327,0.36433131720430106,0.06274556400507003,0.22597862387618586,131929.39758300767,3620.8706325954718,135550.26821560314,922,48,496.28125,31,1,16,33.40990705534433,0.651209677419355,43.16406249999999,1027.3437499999989,33.1401209677419,0
930,4,0,0,32,0.0,0.0,1.0,32,400,200,200,0.5,6,2,4,379.75645903222556,0.36401629704301075,0.06264652768977319,0.22616288439421067,131962.841881646,3622.748311360672,135585.59019300665,923,49,497.28125,31,1,16,33.376763612554385,0.6515456989247312,43.131510416666664,1027.473958333333,33.14432123655913,0
931,4,0,0,32,0.0,0.0,1.0,32,800,500,300,0.625,11,5,6,378.03079125146064,0.36384828629032256,0.06371547573799585,0.22553265573301406,132029.74319457993,3582.2616577148297,135612.00485229478,924,50,498.28125,31,1,17,33.353525275560635,0.652217741935484,43.06640624999999,1027.7343749999989,33.15272177419351,0
932,4,0,0,32,0.0,0.0,1.0,32,700,500,200,0.7142857142857143,9,5,4,380.1595279663893,0.36435231854838707,0.05932317381947105,0.22800912007642418,132230.54885864243,3653.740607367607,135884.28946601003,925,51,499.28125,31,1,18,33.096093387348624,0.654233870967742,42.87109374999999,1028.5156249999989,33.17792338709674,0
933,4,0,0,32,0.0,0.0,1.0,32,1200,1000,200,0.8333333333333334,14,10,4,383.6829521478948,0.3650873655913978,0.060658044523146826,0.2315570549375001,132465.01498752148,3764.913601345452,136229.92858886693,926,52,500.28125,31,1,18,32.76888860780841,0.6565860215053765,42.64322916666665,1029.4270833333314,33.207325268817144,0
934,4,0,0,32,0.0,0.0,1.0,32,1050,800,250,0.7619047619047619,13,8,5,396.19197896120977,0.3650873655913978,0.08612179487179494,0.21824134434303932,128936.76757812499,3816.742621527778,132753.51019965275,927,53,501.28125,31,1,18,36.03418803418804,0.6209677419354838,46.09375,1015.6249999999999,32.762096774193544,6
935,4,0,0,32,0.0,0.0,1.0,32,500,400,100,0.8,6,4,2,391.59992766249263,0.36548639112903225,0.07837930924003578,0.21625295368368208,129035.96878051748,3706.095208062051,132742.06398857952,928,54,502.28125,31,1,18,36.04930261865095,0.621975806451613,45.99609374999999,1016.0156249999992,32.77469758064514,0
936,4,0,0,32,0.0,0.0,1.0,32,700,400,300,0.5714285714285714,10,4,6,391.9588845805954,0.36496135752688175,0.07499839866769165,0.2169951101444061,129135.20812988278,3723.1384277343745,132858.34655761716,929,55,503.28125,31,1,18,35.938700999231365,0.622983870967742,45.8984375,1016.4062499999998,32.78729838709677,0
937,4,1,1,32,0.030303030303030304,0.030303030303030304,0.9696969696969697,33,1000,700,300,0.7,13,7,6,378.49343105691526,0.36856849747474746,0.07323545552272925,0.21160985028993395,129522.50567544115,3204.6835144372876,132727.18918987844,930,0,489.0,32,1,16,35.88568800132308,0.6243489583333335,45.51767676767676,1017.9292929292918,31.81029040404037,0
938,4,1,1,32,0.030303030303030304,0.030303030303030304,0.9696969696969697,33,1050,900,150,0.8571428571428571,12,9,3,376.18883100012437,0.36991003787878785,0.06671172693477545,0.21170459317789428,129779.68606519743,3164.333677685949,132944.01974288336,931,0,489.969696969697,32,1,17,35.682311028500635,0.626953125,45.265151515151516,1018.9393939393939,31.84185606060606,0
939,4,1,1,32,0.030303030303030304,0.030303030303030304,0.9696969696969697,33,500,300,200,0.6,7,3,4,375.8543967054076,0.37306660353535354,0.05952461417145449,0.21151638643044904,129779.68606519743,3155.653122130393,132935.33918732783,932,0,490.93939393939394,32,1,17,35.69083023543992,0.626953125,45.265151515151516,1018.9393939393939,31.84185606060606,0
940,4,2,1,33,0.058823529411764705,0.029411764705882353,0.9705882352941176,34,650,500,150,0.7692307692307693,8,5,3,363.99934088910277,0.37436868686868685,0.06264787101057223,0.2072283328957851,130231.31315179258,2680.822430074966,132912.13558186754,933,0,477.44117647058823,33,1,18,35.533852603353736,0.6291035353535354,44.822303921568626,1020.7107843137254,30.930629827688648,0
941,4,1,1,33,0.029411764705882353,0.029411764705882353,0.9705882352941176,34,650,400,250,0.6153846153846154,9,4,5,365.3331780697124,0.3765597147950089,0.05575634790097461,0.2086580790167865,130356.43029423784,2724.705792243373,133081.13608648122,934,0,478.4117647058824,33,1,18,35.37278991159647,0.6303661616161615,44.69975490196079,1021.2009803921572,30.945484254307797,0
942,4,1,0,34,0.029411764705882353,0.0,1.0,34,500,400,100,0.8,6,4,2,366.60420765277047,0.37670825906120026,0.05963160309114657,0.20972176189333167,130419.01139285376,2762.431666906962,133181.44305976073,935,0,479.38235294117646,33,1,19,35.27681963607278,0.6309974747474747,44.638480392156865,1021.4460784313729,30.952911467617362,0
943,4,0,0,34,0.0,0.0,1.0,34,1100,700,400,0.6363636363636364,15,7,8,363.36960132010086,0.37648544266191325,0.04986844240034438,0.20854364111550733,130544.21864487219,2687.160136726258,133231.37878159844,936,1,480.38235294117646,33,1,16,35.2324169564696,0.632260101010101,44.51593137254902,1021.9362745098041,30.96776589423649,0
944,4,0,1,33,0.0,0.029411764705882353,0.9705882352941176,34,850,700,150,0.8235294117647058,10,7,3,363.6170200530222,0.376095513963161,0.04688954718578042,0.20885440408004172,130575.52984429066,2695.897010765089,133271.42685505576,937,2,481.38235294117646,33,1,16,35.19434452438049,0.6325757575757576,44.48529411764706,1022.0588235294118,30.971479500891267,0
945,4,1,1,33,0.029411764705882353,0.029411764705882353,0.9705882352941176,34,550,300,250,0.5454545454545454,8,3,5,366.49732637525983,0.37583556149732616,0.05391686876092705,0.2111915532648596,130700.8121876201,2780.299644367545,133481.11183198766,938,0,482.29411764705884,33,1,16,34.99370805369127,0.6338383838383839,44.36274509803921,1022.5490196078429,30.98633392751039,0
946,4,1,1,33,0.029411764705882353,0.029411764705882353,0.9705882352941176,34,800,600,200,0.75,10,6,4,368.2069681115618,0.37802658942364825,0.05515146389253056,0.2125211172793288,130763.47588667825,2829.604599192625,133593.0804858709,939,0,483.2647058823529,33,1,16,34.8864725617062,0.634469696969697,44.3014705882353,1022.7941176470592,30.993761140819977,0
947,4,1,1,33,0.029411764705882353,0.029411764705882353,0.9705882352941176,34,500,400,100,0.8,6,4,2,369.86655912057535,0.3755756090314914,0.05227583484867737,0.21347899740112875,130763.47588667825,2873.0073769704036,133636.48326364867,940,0,484.2352941176471,33,1,16,34.84403706366322,0.634469696969697,44.3014705882353,1022.7941176470592,30.993761140819977,0
948,4,1,1,33,0.029411764705882353,0.029411764705882353,0.9705882352941176,34,350,300,50,0.8571428571428571,4,3,1,367.7078468691579,0.3731803327391563,0.05843954541931762,0.21275071472699933,130857.49959450695,2823.4658845155745,133680.96547902253,941,0,485.20588235294116,33,1,16,34.8039435860582,0.6354166666666666,44.20955882352941,1023.1617647058827,31.004901960784323,0
949,4,0,0,33,0.0,0.0,1.0,33,750,600,150,0.8,9,6,3,384.37320414256334,0.3703440656565657,0.054253541151469964,0.2067360307381545,127984.7799331701,3238.783988878689,131223.56392204878,942,9,500.90909090909093,32,1,17,37.30944804924715,0.6087239583333334,47.032828282828284,1011.868686868687,31.620896464646467,6
950,4,1,1,33,0.029411764705882353,0.029411764705882353,0.9705882352941176,34,900,700,200,0.7777777777777778,11,7,4,375.40998767877716,0.3752413844325609,0.047285265171223445,0.20402274685833088,128400.34060618826,2840.653696051439,131240.9943022397,943,0,487.1470588235294,32,2,15,37.110429384161804,0.6129557291666666,46.622474747474755,1013.510101010102,31.672190656565686,0
951,4,1,0,34,0.029411764705882353,0.0,1.0,34,650,500,150,0.7692307692307693,8,5,3,375.78013847367356,0.37642973856209155,0.06253981737099168,0.20521018710802297,128592.36501696249,2864.4913465462605,131456.85636350876,944,0,488.11764705882354,32,2,16,36.90453960745258,0.6149088541666667,46.4330808080808,1014.2676767676762,31.695864898989882,0
952,4,0,0,34,0.0,0.0,1.0,34,1050,800,250,0.7619047619047619,13,8,5,373.34499151774173,0.37694964349376114,0.06246568322413015,0.20420878194996958,128656.40503838891,2806.644889552086,131463.049927941,945,1,489.11764705882354,32,2,16,36.900798589504255,0.6155598958333334,46.369949494949495,1014.5202020202017,31.703756313131304,0
953,4,2,0,36,0.05555555555555555,0.0,1.0,36,650,300,350,0.46153846153846156,10,3,7,356.42300456866394,0.3901289682539682,0.07103825136611985,0.19765275707898655,129201.38888888898,2010.0694444444493,131211.45833333343,946,0,462.8888888888889,34,2,18,36.77424863387976,0.616421568627451,45.833333333333336,1016.6666666666674,29.901960784313747,0
954,4,2,2,36,0.05263157894736842,0.05263157894736842,0.9473684210526316,38,900,800,100,0.8888888888888888,10,8,2,346.4021244772745,0.39996740161213845,0.07450421634195936,0.1952016953000833,129831.84831791263,1394.8056164272505,131226.65393433988,947,0,439.4736842105263,36,2,17,36.38812154696133,0.6186342592592593,45.21396396396397,1019.1441441441452,28.309559559559588,0
955,4,2,2,36,0.05263157894736842,0.05263157894736842,0.9473684210526316,38,750,500,250,0.6666666666666666,10,5,5,345.39922468789075,0.39981922712185874,0.06632742076184917,0.19463654940382422,129831.84831791275,1368.7639497605983,131200.61226767334,948,0,440.39473684210526,36,2,17,36.413674033149185,0.6186342592592592,45.21396396396398,1019.1441441441461,28.309559559559617,0
956,4,0,0,36,0.0,0.0,1.0,36,600,400,200,0.6666666666666666,8,4,4,361.5292808382507,0.3883432539682539,0.07842869764057814,0.202342827861827,129564.7392290248,2168.2893990929533,131733.02862811775,949,2,465.8611111111111,34,2,17,36.274409494855,0.6200980392156863,45.47619047619047,1018.0952380952369,29.94397759103638,0
957,4,1,1,36,0.02702702702702703,0.02702702702702703,0.972972972972973,37,550,400,150,0.7272727272727273,7,4,3,355.3505974130003,0.3926113613613614,0.07998526635664649,0.20018311005895484,129819.89354263099,1826.3153452931924,131646.20888792418,950,0,454.2432432432432,35,2,17,36.17227427597957,0.6205357142857144,45.225694444444436,1019.0972222222207,29.117063492063448,0
958,4,0,0,36,0.0,0.0,1.0,36,600,400,200,0.6666666666666666,8,4,4,362.686847545779,0.38781415343915343,0.08323593579554345,0.20361867897648825,129685.96938775493,2207.0790816326326,131893.04846938755,951,4,467.8611111111111,34,2,17,36.12158134642357,0.6213235294117647,45.35714285714285,1018.5714285714271,29.95798319327727,0
959,4,0,0,36,0.0,0.0,1.0,36,900,800,100,0.8888888888888888,10,8,2,362.5367363921948,0.387880291005291,0.0899548181039187,0.2038495000029173,129746.60572562352,2207.5821995464785,131954.18792517,952,5,468.8611111111111,34,2,17,36.063722053439285,0.6219362745098039,45.297619047619044,1018.8095238095233,29.964985994397743,0
960,4,0,0,36,0.0,0.0,1.0,36,600,300,300,0.5,9,3,6,363.0161476984897,0.38695436507936504,0.08849299065420624,0.20443540949335948,129807.2562358273,2224.4260204081256,132031.68225623542,953,6,469.8611111111111,34,2,17,35.989826713395644,0.6225490196078434,45.23809523809522,1019.0476190476161,29.97198879551812,0
961,4,0,0,36,0.0,0.0,1.0,36,1200,900,300,0.75,15,9,6,361.5173474180508,0.3872850529100529,0.09033940526233897,0.2042239157841809,129928.59977324237,2194.2885487528083,132122.88832199518,954,7,470.8611111111111,34,2,17,35.90465903783279,0.6237745098039217,45.119047619047606,1019.5238095238074,29.98599439775904,0
962,4,1,0,37,0.02702702702702703,0.0,1.0,37,1050,800,250,0.7619047619047619,13,8,5,354.76232620200034,0.3930492992992993,0.09493002012553231,0.20259339832234577,130351.21588059381,1848.7401138116911,132199.9559944055,955,0,459.1081081081081,35,2,18,35.647951377082634,0.6258928571428573,44.70486111111109,1021.1805555555529,29.176587301587226,0
963,4,2,2,37,0.05128205128205128,0.05128205128205128,0.9487179487179487,39,1050,700,350,0.6666666666666666,14,7,7,339.31917984577456,0.4048301844354476,0.08759629819033687,0.1955803875921932,130710.70545744804,1070.529874576748,131781.23533202478,956,0,436.5128205128205,37,2,18,35.678479519622556,0.6255630630630633,44.353070175438575,1022.5877192982424,27.637505926979525,0
964,4,0,0,37,0.0,0.0,1.0,37,1300,800,500,0.6153846153846154,18,8,10,352.7760379124811,0.39245495495495497,0.09361983430605347,0.2026912941317576,130587.70743580646,1813.642805855587,132401.35024166203,957,2,461.1081081081081,35,2,18,35.45901275808703,0.6282738095238096,44.47337962962961,1022.1064814814791,29.20304232804226,0
965,4,1,1,37,0.02631578947368421,0.02631578947368421,0.9736842105263158,38,700,600,100,0.8571428571428571,8,6,2,344.22714212209877,0.3945738501659554,0.09107440696812419,0.19951124155648162,130924.43795146486,1413.5490219949493,132337.9869734598,958,0,449.94736842105266,36,2,19,35.33689113849764,0.6296296296296298,44.144144144144136,1023.4234234234225,28.428428428428404,0
966,4,0,0,37,0.0,0.0,1.0,37,950,600,350,0.631578947368421,13,6,7,349.858407213985,0.3907032032032032,0.09099109291438845,0.2022497358642515,130824.41332572409,1754.0041741683463,132578.41749989244,959,4,463.1081081081081,35,2,19,35.29398593355208,0.630654761904762,44.24189814814813,1023.0324074074044,29.22949735449727,0
967,4,0,0,37,0.0,0.0,1.0,37,1150,800,350,0.6956521739130435,15,8,7,349.16156507852025,0.3908596096096096,0.09027760792466677,0.20200184785956238,130854.01663237275,1737.8386488339727,132591.85528120672,960,5,464.1081081081081,35,2,19,35.281862745098046,0.6309523809523812,44.21296296296294,1023.1481481481452,29.23280423280415,0
968,4,0,0,37,0.0,0.0,1.0,37,150,100,50,0.6666666666666666,2,1,1,349.7820159314962,0.3905155155155155,0.09396637900200888,0.20251622808450248,130883.62328800131,1756.1475212191074,132639.7708092204,961,6,465.1081081081081,35,2,19,35.23604513064132,0.6312500000000001,44.184027777777764,1023.2638888888871,29.23611111111106,0
969,4,1,0,38,0.02631578947368421,0.0,1.0,38,800,400,400,0.5,12,4,8,343.9417944692669,0.3922326932195353,0.10709080393290904,0.20114847877058667,131270.4173768363,1429.8765826637398,132700.29395950004,962,0,453.8421052631579,36,2,20,34.994734432234424,0.6331018518518519,43.806306306306304,1024.7747747747746,28.465965965965964,0
970,4,0,0,38,0.0,0.0,1.0,38,1050,900,150,0.8571428571428571,12,9,3,345.1530958640525,0.39192152678994785,0.10927948924062725,0.20200889552789325,131299.269603218,1463.6698776479088,132762.93948086593,963,1,454.8421052631579,36,2,20,34.93457678643372,0.6333912037037037,43.77815315315315,1024.8873873873868,28.469094094094075,0
971,4,2,1,39,0.05,0.025,0.975,40,950,700,250,0.7368421052631579,12,7,5,330.50164441360545,0.39671474358974357,0.1285090455396134,0.19694949293494762,131985.99810979603,724.317882971712,132710.31599276775,964,0,433.05,38,2,20,34.61868371802869,0.636513157894737,43.10897435897435,1027.5641025641014,27.041160593792142,0
972,4,0,0,39,0.0,0.0,1.0,39,1050,600,450,0.5714285714285714,15,6,9,333.6267852329405,0.3932186234817814,0.12613381709529414,0.1987550288886131,131975.1645337988,1006.0899747999276,132981.2545085987,965,1,445.15384615384613,37,2,20,34.549296588766765,0.6382319819819819,43.119517543859644,1027.5219298245606,27.77086296823137,0
973,4,1,1,39,0.025,0.025,0.975,40,1050,800,250,0.7619047619047619,13,8,5,325.28391586416376,0.3971821581196581,0.12012309130570253,0.19510954878656112,132233.1242809008,602.6616946088122,132835.7859755096,966,0,435.0,38,2,20,34.50451854160173,0.6389802631578947,42.868589743589745,1028.5256410256416,27.066464237516882,0
974,4,0,0,39,0.0,0.0,1.0,39,1050,700,350,0.6666666666666666,14,7,7,329.8337355134384,0.3925157444894287,0.12336771449966899,0.1981114024703638,132285.18029586037,926.4230340104771,133211.60332987085,967,3,447.15384615384613,37,2,20,34.33525190080295,0.6413288288288288,42.817982456140356,1028.7280701754396,27.803461356092964,0
975,4,0,0,39,0.0,0.0,1.0,39,900,800,100,0.8888888888888888,10,8,2,329.95131865790256,0.3917566351776878,0.12228796844181389,0.19877555050854157,132398.00347222234,936.9791666666717,133334.98263888902,968,4,448.15384615384613,37,2,20,34.218960863697696,0.642454954954955,42.708333333333336,1029.1666666666674,27.815315315315335,0
976,4,0,0,39,0.0,0.0,1.0,39,1350,900,450,0.6666666666666666,18,9,9,329.79304913632933,0.39155982905982906,0.11489845192444204,0.19897796563572395,132454.43309479862,936.5102723915292,133390.94336719014,969,5,449.15384615384613,37,2,20,34.166400369265716,0.6430180180180178,42.653508771929836,1029.3859649122826,27.821242294926556,0
977,4,0,0,39,0.0,0.0,1.0,39,700,400,300,0.5714285714285714,10,4,6,330.7993941006211,0.3911662168241115,0.11969452476320708,0.20003458531866938,132539.10007165687,968.7707996691448,133507.870871326,970,6,450.15384615384613,37,2,20,34.0555452028538,0.6438626126126126,42.57127192982457,1029.7149122807032,27.83013276434333,0
978,4,0,0,39,0.0,0.0,1.0,39,800,500,300,0.625,11,5,6,332.3173297655908,0.3906601439496176,0.12191499585025944,0.2011033737859816,132567.32840874136,1010.8841181902302,133578.2125269316,971,7,451.15384615384613,37,2,20,33.98814593980692,0.6441441441441441,42.543859649122815,1029.8245614035104,27.83309625414893,0
979,4,0,2,37,0.0,0.05128205128205128,0.9487179487179487,39,850,700,150,0.8235294117647058,10,7,3,333.5422661210811,0.3901821862348178,0.12961067671019766,0.20230016721804764,132652.0314543899,1049.011835372432,133701.0432897623,972,8,452.15384615384613,37,2,17,33.87162941280825,0.6449887387387387,42.46162280701755,1030.1535087719303,27.841986723565686,0
980,4,0,0,37,0.0,0.0,1.0,37,1300,1000,300,0.7692307692307693,16,10,6,343.2640176303373,0.3898898898898899,0.1332010476553247,0.20904162031739718,132803.95418644996,1717.3637742472147,134521.31796069717,973,9,460.0810810810811,36,1,17,33.46876251866418,0.6484375,42.314189189189186,1030.7432432432431,28.631756756756754,0
981,4,1,0,38,0.02631578947368421,0.0,1.0,38,1050,700,350,0.6666666666666666,14,7,7,335.29520805093074,0.3925290422000948,0.13862332695984736,0.20630516918898417,133189.1122749305,1331.5342220683049,134520.6464969988,974,0,448.94736842105266,37,1,18,33.28818780539622,0.6503378378378379,41.9407894736842,1032.2368421052613,27.898293029871926,0
982,4,0,0,38,0.0,0.0,1.0,38,500,300,200,0.6,7,3,4,334.96826385645585,0.3923512328117591,0.13551401869158886,0.20641761599950165,133245.71021852858,1326.616843644178,134572.32706217276,975,1,449.94736842105266,37,1,18,33.23996389124893,0.650900900900901,41.88596491228069,1032.4561403508758,27.90422000948313,0
983,4,1,0,39,0.02564102564102564,0.0,1.0,39,1100,800,300,0.7272727272727273,14,8,6,329.3266258117626,0.39513045434098065,0.13475345167652875,0.20433860752309793,133500.5497484801,993.2494854185591,134493.79923389864,976,0,439.38461538461536,37,2,19,33.13074712643678,0.6534346846846848,41.6392543859649,1033.4429824561385,27.93089141773347,0
984,4,0,0,39,0.0,0.0,1.0,39,600,500,100,0.8333333333333334,7,5,2,329.560075289583,0.3949898785425101,0.1350982280326649,0.20463987283791868,133528.8802804707,1001.1575677131138,134530.03784818383,977,1,440.38461538461536,37,2,19,33.096400028290525,0.6537162162162163,41.61184210526314,1033.5526315789457,27.93385490753907,0
985,4,0,0,39,0.0,0.0,1.0,39,1200,800,400,0.6666666666666666,16,8,8,330.5319826354656,0.3945962663067926,0.13117197081562315,0.20571525176698366,133613.8899108378,1032.7327879731995,134646.622698811,978,2,441.38461538461536,37,2,19,32.9863320606639,0.654560810810811,41.52960526315788,1033.8815789473672,27.94274537695587,0
986,4,0,1,38,0.0,0.02564102564102564,0.9743589743589743,39,1050,900,150,0.8571428571428571,12,9,3,334.3532693284961,0.39372469635627527,0.13372254203290934,0.2088932942281474,133755.6327427666,1144.3266197291055,134899.95936249572,979,3,442.38461538461536,37,2,16,32.745919016323924,0.6559684684684687,41.3925438596491,1034.4298245614004,27.957562825983796,0
987,4,0,0,38,0.0,0.0,1.0,38,1400,1000,400,0.7142857142857143,18,10,8,336.0025113047946,0.3943367709815078,0.11956830841804145,0.2107327378209934,133897.45071800912,1397.9759397121875,135295.4266577213,980,4,433.2894736842105,37,1,16,32.56160168803193,0.6573761261261263,41.255482456140335,1034.9780701754364,27.972380275011794,0
988,4,0,1,37,0.0,0.02631578947368421,0.9736842105263158,38,850,500,350,0.5882352941176471,12,5,7,340.18952306775714,0.3931661925082978,0.11878058841235695,0.2138528280163621,133982.577571945,1515.8938327177343,135498.47140466273,981,5,434.2894736842105,37,1,16,32.368230600861395,0.6582207207207209,41.173245614035075,1035.307017543858,27.981270744428592,0
989,4,0,0,37,0.0,0.0,1.0,37,650,400,250,0.6153846153846154,9,4,5,351.6189699940268,0.3897334834834835,0.11989990207811996,0.22059590124335154,133908.95276611068,2016.985608919724,135925.9383750304,982,8,446.8918918918919,36,1,16,32.146030537119636,0.6594328703703705,41.244369369369366,1035.0225225225222,28.750625625625617,0
990,4,0,0,37,0.0,0.0,1.0,37,1200,700,500,0.5833333333333334,17,7,10,350.76313136823705,0.389232982982983,0.12158781946710184,0.22075749438267903,134025.5347196859,2002.2432483158855,136027.77796800178,983,9,447.8918918918919,36,1,16,32.0516131955773,0.6605902777777778,41.13175675675676,1035.4729729729731,28.763138138138142,0
991,4,0,0,37,0.0,0.0,1.0,37,950,800,150,0.8421052631578947,11,8,3,349.89351712863083,0.3896396396396396,0.11349806459365053,0.22080454617997136,134124.51577648878,1985.8597116420278,136110.3754881308,984,10,448.8918918918919,37,0,16,31.97520817896333,0.6596283783783785,41.03618421052631,1035.8552631578937,27.996088193456586,0
992,4,0,1,36,0.0,0.02702702702702703,0.972972972972973,37,1050,900,150,0.8571428571428571,12,9,3,349.3090517260837,0.3898586086086086,0.11151759230921066,0.22077733978326164,134181.31209843402,1974.1493776931243,136155.46147612715,985,11,449.8918918918919,37,0,17,31.93360408508835,0.6601914414414415,40.9813596491228,1036.074561403508,28.002015173067782,0
993,4,0,2,34,0.0,0.05555555555555555,0.9444444444444444,36,1050,700,350,0.6666666666666666,14,7,7,358.2124303194916,0.3853009259259259,0.11409819627173157,0.22580395624731767,134083.84471887432,2406.0999766658633,136489.94469554018,986,22,463.0833333333333,36,0,17,31.800451234098084,0.6611689814814814,41.075450450450454,1035.6981981981985,28.769394394394403,0
994,4,0,0,34,0.0,0.0,1.0,34,600,400,200,0.6666666666666666,8,4,4,366.6025016668581,0.38463680926916216,0.11587836238324223,0.23053810245818285,133995.5516581635,3024.620890022703,137020.17254818618,987,23,467.88235294117646,34,0,17,31.67160131846232,0.6645220588235292,41.1607142857143,1035.3571428571445,30.451680672268957,0
995,4,0,0,34,0.0,0.0,1.0,34,1150,1000,150,0.8695652173913043,13,10,3,368.51280592287816,0.3849896019013666,0.1213716927819164,0.2327139649594258,134149.66695011346,3087.1740362811893,137236.84098639464,988,24,468.88235294117646,34,0,17,31.467861794223545,0.6660539215686274,41.011904761904766,1035.9523809523816,30.46918767507005,0
996,4,0,0,34,0.0,0.0,1.0,34,950,600,350,0.631578947368421,13,6,7,392.3896049328479,0.38528669043374925,0.12782562272580433,0.2317257088651387,131642.3445910226,3539.180782607149,135181.52537362973,989,25,469.88235294117646,33,1,17,33.37662208422897,0.6433080808080809,43.44362745098039,1026.2254901960775,31.097742127153865,6
997,4,0,1,33,0.0,0.029411764705882353,0.9705882352941176,34,850,600,250,0.7058823529411765,11,6,5,393.2026272813432,0.38547237076648844,0.12534930420007573,0.23297394705538144,131768.13755526723,3562.315575740098,135330.45313100732,990,26,470.88235294117646,33,1,18,33.22839579851992,0.6445707070707071,43.32107843137255,1026.7156862745098,31.112596553773024,0
998,4,0,0,33,0.0,0.0,1.0,33,850,800,50,0.9411764705882353,9,8,1,396.17139674816895,0.38139204545454547,0.13891776488604246,0.2350154609593623,131813.89534550047,3844.179005968773,135658.07435146923,991,27,484.8181818181818,32,1,18,33.10586499446699,0.6474609375,43.27651515151515,1026.8939393939393,32.0904356060606,0
999,4,0,0,33,0.0,0.0,1.0,33,800,400,400,0.5,12,4,8,407.22620637798167,0.38115530303030304,0.13066417699806743,0.2404874648948674,131642.34459102273,4121.642517301041,135763.98710832378,992,28,485.8181818181818,33,0,14,32.99597961945705,0.6433080808080808,43.443627450980394,1026.2254901960787,31.0977421271539,2
1000,4,0,0,33,0.0,0.0,1.0,33,1050,900,150,0.8571428571428571,12,9,3,407.64580476898095,0.3804056186868687,0.12940291163786855,0.24113285739724483,131705.23356401396,4137.817185697823,135843.05074971178,993,29,486.8181818181818,33,0,14,32.921442215854825,0.6439393939393938,43.38235294117648,1026.470588235295,31.105169340463487,0
1001,4,0,0,33,0.0,0.0,1.0,33,1000,800,200,0.8,12,8,4,410.01019588633017,0.380011047979798,0.13302957980762287,0.24333466299769452,131831.05656478283,4210.4154652057005,136041.47202998854,994,30,487.8181818181818,33,0,14,32.73319411296739,0.6452020202020201,43.25980392156863,1026.960784313726,31.120023767082607,0
1002,4,0,0,33,0.0,0.0,1.0,33,500,400,100,0.8,6,4,2,409.6500204019693,0.3797743055555556,0.13865208997635636,0.24352386319214936,131893.9905925605,4206.075187427907,136100.0657799884,995,31,488.8181818181818,33,0,16,32.678656645192085,0.6458333333333334,43.1985294117647,1027.2058823529408,31.127450980392144,0
1003,4,0,0,33,0.0,0.0,1.0,33,850,600,250,0.7058823529411765,11,6,5,409.69331824263776,0.3796559343434343,0.1427802171988215,0.24415625255611378,131988.41979346902,4214.954734957728,136203.37452842674,996,32,489.8181818181818,33,0,16,32.5818674219837,0.646780303030303,43.10661764705883,1027.573529411766,31.138591800356547,0
1004,4,0,0,33,0.0,0.0,1.0,33,700,600,100,0.8571428571428571,8,6,2,407.4960772127169,0.37934027777777773,0.13907739450310408,0.24304851376286216,132019.90370290267,4159.518574586687,136179.42227748936,997,33,490.8181818181818,33,0,16,32.60642737896494,0.6470959595959596,43.07598039215686,1027.696078431372,31.14230540701127,0
1005,4,0,0,33,0.0,0.0,1.0,33,650,500,150,0.7692307692307693,8,5,3,406.7643258067696,0.37847222222222227,0.1405014503119162,0.24321781391254388,132114.37795859767,4147.8831759419445,136262.2611345396,998,34,491.8181818181818,33,0,16,32.529577422815585,0.6480429292929293,42.98406862745098,1028.0637254901962,31.153446226975642,0
1006,4,0,0,33,0.0,0.0,1.0,33,1000,800,200,0.8,12,8,4,410.2701312287862,0.3774463383838384,0.15220106714030956,0.24633816033865732,132271.91014273348,4253.442786428292,136525.35292916177,999,35,492.8181818181818,33,0,16,32.28000158843619,0.6496212121212122,42.830882352941174,1028.6764705882347,31.172014260249536,0
1007,4,0,0,33,0.0,0.0,1.0,33,650,400,250,0.6153846153846154,9,4,5,423.6594266999657,0.37720959595959597,0.12121212121212133,0.25164349079889536,131862.52170138896,4572.960069444454,136435.48177083343,1000,36,493.8181818181818,33,0,14,32.35082826233942,0.6455176767676767,43.22916666666667,1027.083333333334,31.12373737373739,2
1008,4,0,0,33,0.0,0.0,1.0,33,700,500,200,0.7142857142857143,9,5,4,426.7928823405795,0.3774463383838384,0.12262879239623437,0.2543467177274884,131988.419793469,4666.343623846618,136654.7634173156,1001,37,494.8181818181818,33,0,15,32.14259093619559,0.646780303030303,43.10661764705883,1027.5735294117658,31.13859180035654,0
1009,4,0,0,33,0.0,0.0,1.0,33,600,500,100,0.8333333333333334,7,5,2,424.3534165312219,0.37693339646464646,0.12481076413352543,0.2533133170425167,132051.39136690216,4607.291816849292,136658.68318375145,1002,38,495.8181818181818,33,0,16,32.14138448392354,0.6474116161616161,43.0453431372549,1027.8186274509806,31.146019013666077,0
1010,4,1,1,33,0.029411764705882353,0.029411764705882353,0.9705882352941176,34,750,500,250,0.6666666666666666,10,5,5,416.11437324100365,0.38135026737967914,0.11099164330239297,0.25047998901777396,132367.37528344663,4215.993480725616,136583.36876417225,1003,0,482.20588235294116,34,0,16,32.03305761221657,0.6482843137254901,42.738095238095234,1029.0476190476184,30.266106442577012,0
1011,4,0,0,33,0.0,0.0,1.0,33,600,400,200,0.6666666666666666,8,4,4,423.0784866200957,0.375039457070707,0.12125543703864183,0.2542407942144381,132303.4278432573,4594.946805315258,136898.37464857256,1004,40,497.8181818181818,33,0,16,31.918676791741124,0.6499368686868687,42.80024509803921,1028.7990196078424,31.175727866904314,0
1012,4,0,0,33,0.0,0.0,1.0,33,1050,800,250,0.7619047619047619,13,8,5,420.40181873799617,0.37417140151515155,0.12561379962261054,0.2534784548155367,132429.53619100814,4534.723573865809,136964.25976487395,1005,41,498.8181818181818,33,0,17,31.8598196213835,0.651199494949495,42.67769607843137,1029.2892156862736,31.19058229352344,0
1013,4,1,1,33,0.029411764705882353,0.029411764705882353,0.9705882352941176,34,1050,800,250,0.7619047619047619,13,8,5,413.85761297996146,0.37930778371954843,0.12005841597609002,0.2523948541131315,132857.85147392287,4196.846655328793,137054.69812925166,1006,0,485.11764705882354,34,0,10,31.59521747498074,0.6531862745098039,42.26190476190476,1030.9523809523807,30.32212885154061,0
1014,4,0,0,33,0.0,0.0,1.0,33,1150,800,350,0.6956521739130435,15,8,7,428.44531553014247,0.3720012626262626,0.13302925822245726,0.26094522439710555,132808.22167255377,4780.212087898875,137588.43376045264,1007,43,500.8181818181818,33,0,10,31.269443783933724,0.6549873737373737,42.31004901960784,1030.7598039215682,31.235145573380855,0
1015,4,0,0,33,0.0,0.0,1.0,33,900,700,200,0.7777777777777778,11,7,4,427.75227017651264,0.3718434343434343,0.1351698806244257,0.26140416510786874,132934.5703124999,4772.612847222208,137707.18315972213,1008,44,501.8181818181818,33,0,12,31.159511784511775,0.65625,42.18749999999999,1031.2499999999993,31.24999999999998,0
1016,4,0,0,33,0.0,0.0,1.0,33,600,400,200,0.6666666666666666,8,4,4,426.249959420601,0.37247474747474746,0.13437138938980042,0.26136914846045445,133060.97902549495,4743.447382016528,137804.42640751146,1009,45,502.8181818181818,33,0,13,31.070470562616308,0.6575126262626263,42.064950980392155,1031.740196078431,31.26485442661912,0
1017,4,0,1,32,0.0,0.030303030303030304,0.9696969696969697,33,950,800,150,0.8421052631578947,11,8,3,427.14005526907334,0.37306660353535354,0.13040881385692615,0.2625820106186959,133155.82498317945,4775.237288542861,137931.0622717223,1010,46,503.8181818181818,33,0,13,30.951674186654003,0.658459595959596,41.97303921568627,1032.1078431372543,31.275995246583467,0
1018,4,0,0,32,0.0,0.0,1.0,32,850,400,450,0.47058823529411764,13,4,9,435.0078603406086,0.37281586021505375,0.13218566536203546,0.2678180923301817,133211.40699928565,5189.601826344231,138401.0088256299,1011,47,497.1875,32,0,14,30.69247390737116,0.6614583333333335,41.91919191919191,1032.3232323232312,32.260101010100975,0
1019,4,0,0,32,0.0,0.0,1.0,32,700,500,200,0.7142857142857143,9,5,4,432.64797722429444,0.37310987903225806,0.1286225238444607,0.26683221400756246,133276.58689164364,5132.369146005502,138408.95603764916,1012,48,498.1875,32,0,14,30.687515284910745,0.662109375,41.8560606060606,1032.575757575757,32.26799242424241,0
1020,4,0,0,32,0.0,0.0,1.0,32,750,500,250,0.6666666666666666,10,5,5,437.24797641722245,0.37214381720430106,0.13385327548276726,0.2706174692167707,133406.99450311167,5266.3876772777985,138673.38218038945,1013,49,499.1875,32,0,15,30.436985659577935,0.6634114583333335,41.729797979797965,1033.080808080806,32.28377525252519,0
1021,4,0,0,32,0.0,0.0,1.0,32,850,600,250,0.7058823529411765,11,6,5,446.60111506499766,0.371072748655914,0.13191775859896682,0.2771441008812262,133505.86149427606,5524.789264462137,139030.6507587382,1014,50,500.1875,31,1,15,30.095465331149462,0.6670026881720431,41.63411458333332,1033.4635416666652,33.337533602150486,0
1022,4,0,0,32,0.0,0.0,1.0,32,750,600,150,0.8,9,6,3,454.9177618468909,0.371072748655914,0.13703518746158538,0.27032549252187466,131878.73247946665,5598.795562952795,137477.52804241944,1015,51,501.1875,32,0,11,31.531704568735933,0.6481119791666665,43.213383838383855,1027.1464646464667,32.098327020202085,4
1023,4,0,0,32,0.0,0.0,1.0,32,700,500,200,0.7142857142857143,9,5,4,452.3806391676248,0.37115675403225806,0.13395984392282134,0.26927734169034157,131943.58555568333,5537.744713549668,137481.330269233,1016,52,502.1875,32,0,12,31.530867231985585,0.6487630208333333,43.15025252525254,1027.3989898989919,32.106218434343496,0
1024,4,0,0,32,0.0,0.0,1.0,32,550,300,250,0.5454545454545454,8,3,5,452.11998011765365,0.37065272177419356,0.12984046800147397,0.2700446631062231,132073.33953486907,5542.599128915442,137615.9386637845,1017,53,503.1875,32,0,13,31.40559104123163,0.6500651041666665,43.02398989898991,1027.9040404040418,32.122001262626306,0
1025,4,0,0,32,0.0,0.0,1.0,32,950,700,250,0.7368421052631579,12,7,5,454.60006248595084,0.36983366935483875,0.1354575865455434,0.2726930860832516,132235.62168401192,5622.8643760840805,137858.486060096,1018,54,504.1875,32,0,13,31.176855716507074,0.6516927083333333,42.86616161616162,1028.535353535354,32.141729797979814,0
1026,4,0,0,32,0.0,0.0,1.0,32,300,200,100,0.6666666666666666,4,2,2,454.2114020046727,0.37006468413978494,0.1388586289431688,0.2726941998623488,132268.09007052876,5615.53492628306,137883.62499681182,1019,55,505.1875,32,0,14,31.153850087966948,0.6520182291666665,42.83459595959597,1028.661616161618,32.14567550505056,0
1027,4,0,1,31,0.0,0.03125,0.96875,32,650,400,250,0.6153846153846154,9,4,5,453.86746217771156,0.36872059811827956,0.13853744939271273,0.2734274711168165,132398.00347222225,5618.229166666671,138016.2326388889,1020,56,506.1875,32,0,14,31.030701754385976,0.6533203125,42.708333333333336,1029.1666666666667,32.161458333333336,0
1028,4,0,0,31,0.0,0.0,1.0,31,550,500,50,0.9090909090909091,6,5,1,455.3143532004217,0.367831541218638,0.1405072330701267,0.27454309397782883,132431.50711059582,5859.593200683607,138291.1003112794,1021,57,511.0,31,0,14,30.959440227703983,0.65625,42.67578125000001,1029.296875000001,33.20312500000003,0
1029,4,0,0,31,0.0,0.0,1.0,31,500,300,200,0.6,7,3,4,455.3143532004217,0.367831541218638,0.1405072330701267,0.27454309397782883,132431.50711059582,5859.593200683607,138291.1003112794,1022,58,512.0,31,0,14,30.959440227703983,0.65625,42.67578125000001,1029.296875000001,33.20312500000003,0
1030,4,0,0,31,0.0,0.0,1.0,31,900,700,200,0.7777777777777778,11,7,4,455.3143532004217,0.367831541218638,0.1405072330701267,0.27454309397782883,132431.50711059582,5859.593200683607,138291.1003112794,1023,59,513.0,31,0,14,30.959440227703983,0.65625,42.67578125000001,1029.296875000001,33.20312500000003,0
1031,4,0,0,31,0.0,0.0,1.0,31,600,300,300,0.5,9,3,6,454.1287013376053,0.367921146953405,0.1373558669201833,0.27407187120420684,132465.01498752175,5831.23304578994,138296.24803331168,1024,60,514.0,31,0,14,30.955919554768535,0.6565860215053763,42.64322916666667,1029.4270833333337,33.207325268817215,0
1032,4,0,0,31,0.0,0.0,1.0,31,1000,700,300,0.7,13,7,6,459.02450783529383,0.3672043010752688,0.13939203602266104,0.27776777601142616,132565.56404961483,5970.16855875652,138535.73260837136,1025,61,515.0,31,0,15,30.727783748472213,0.6575940860215054,42.54557291666667,1029.8177083333337,33.21992607526883,0
1033,4,0,0,31,0.0,0.0,1.0,31,800,400,400,0.5,12,4,8,457.274713455697,0.36724910394265237,0.13907824782282496,0.27745073104765927,132666.15125868062,5932.975260416676,138599.1265190973,1026,62,516.0,31,0,12,30.670711156049883,0.6586021505376343,42.44791666666667,1030.208333333334,33.23252688172045,0
1034,4,1,1,31,0.03125,0.03125,0.96875,32,600,200,400,0.3333333333333333,10,2,8,443.4538335790831,0.3758190524193548,0.11954875137715781,0.27135388513165015,132983.402921258,5394.399965564739,138377.80288682276,1027,0,500.84375,32,0,13,30.70525768147877,0.6591796875,42.140151515151516,1031.4393939393938,32.232481060606055,0
1035,4,1,0,32,0.03125,0.0,1.0,32,750,600,150,0.8,9,6,3,440.59494718765933,0.3718707997311828,0.1220137954239573,0.2705471452565543,133113.66705246904,5329.841820987648,138443.50887345668,1028,0,501.8125,32,0,14,30.64715118887394,0.6604817708333334,42.013888888888886,1031.944444444444,32.24826388888887,0
1036,4,0,0,32,0.0,0.0,1.0,32,1050,800,250,0.7619047619047619,13,8,5,443.80496733315226,0.37151377688172044,0.12537457191780854,0.2732341425388442,133211.40699928574,5423.976826344246,138635.38382562998,1029,1,502.8125,32,0,14,30.465437459230266,0.6614583333333334,41.91919191919192,1032.3232323232319,32.260101010100996,0
1037,4,0,0,32,0.0,0.0,1.0,32,800,500,300,0.625,11,5,6,443.33729704572517,0.37149277553763443,0.12318513877002091,0.27366458509713093,133309.1828161667,5420.186556218749,138729.36937238544,1030,2,503.8125,32,0,14,30.37861189224437,0.6624348958333334,41.82449494949495,1032.7020202020199,32.27193813131312,0
1038,4,1,1,32,0.030303030303030304,0.030303030303030304,0.9696969696969697,33,750,600,150,0.8,9,6,3,405.465153342902,0.3771306818181818,0.029105296286305204,0.24989348331484612,133250.70473195385,4205.703485438269,137456.40821739213,1031,0,489.5151515151515,33,0,14,31.415306627101877,0.6594065656565657,41.88112745098038,1032.4754901960769,31.287136066547784,6
1039,4,0,0,32,0.0,0.0,1.0,32,1100,1000,100,0.9090909090909091,12,10,2,413.8493392812055,0.37115675403225806,0.034942660550458804,0.2545687245014187,133178.8230314508,4623.193583562893,137802.01661501368,1032,4,505.8125,32,0,15,31.271406727828744,0.6611328125,41.95075757575757,1032.196969696969,32.25615530303028,0
1040,4,0,0,32,0.0,0.0,1.0,32,850,500,350,0.5882352941176471,12,5,7,413.8296398030034,0.3707997311827957,0.038848458904109595,0.25477945293895743,133211.40699928574,4625.365715233134,137836.77271451888,1033,5,506.8125,32,0,15,31.239043134377045,0.6614583333333334,41.91919191919192,1032.3232323232319,32.260101010100996,0
1041,4,0,0,32,0.0,0.0,1.0,32,800,600,200,0.75,10,6,4,413.7997675826162,0.37119875672043007,0.03871759202641556,0.25498422754506794,133243.9949526833,4627.266828639921,137871.26178132324,1034,6,507.8125,32,0,15,31.206942236353996,0.6617838541666667,41.887626262626256,1032.4494949494942,32.264046717171695,0
1042,4,0,0,32,0.0,0.0,1.0,32,950,700,250,0.7368421052631579,12,7,5,415.85664494820065,0.37052671370967744,0.03668179317931797,0.2571521702434795,133374.386621901,4692.924988521603,138067.31161042262,1035,7,508.8125,32,0,18,31.022338344945602,0.6630859375,41.76136363636365,1032.9545454545469,32.27982954545459,0
1043,4,1,1,32,0.030303030303030304,0.030303030303030304,0.9696969696969697,33,900,600,300,0.6666666666666666,12,6,6,408.15619814902647,0.3751578282828283,0.031750478591773046,0.2541412430836411,133630.56163795176,4308.428398933107,137938.99003688488,1036,0,494.3636363636364,33,0,18,30.963192880565764,0.6631944444444444,41.513480392156865,1033.9460784313726,31.33169934640523,0
1044,4,0,0,32,0.0,0.0,1.0,32,550,400,150,0.7272727272727273,7,4,3,414.17077367489503,0.37040070564516125,0.039939676237018995,0.2570119622842318,133504.8420601215,4658.760745077047,138163.60280519855,1037,9,510.8125,32,0,18,30.934381999592755,0.6643880208333333,41.63510101010102,1033.4595959595968,32.2956123737374,0
1045,4,0,0,32,0.0,0.0,1.0,32,950,900,50,0.9473684210526315,10,9,1,412.65053876379835,0.37048471102150543,0.04772789717914283,0.25697302372142555,133635.36126734523,4628.940764972972,138264.3020323182,1038,10,511.8125,32,0,20,30.842186673179473,0.6656901041666666,41.50883838383839,1033.9646464646469,32.311395202020215,0
1046,4,0,0,32,0.0,0.0,1.0,32,850,700,150,0.8235294117647058,10,7,3,410.0452031279031,0.3706107190860215,0.044694634354779605,0.2558019999101796,133700.6447843334,4564.661609784736,138265.30639411812,1039,11,512.8125,32,0,13,30.84381231432874,0.6663411458333333,41.44570707070708,1034.217171717173,32.319286616161655,0
1047,4,0,0,32,0.0,0.0,1.0,32,700,400,300,0.5714285714285714,10,4,6,407.7263087694468,0.3696026545698925,0.04745285609666805,0.25480561767719906,133765.9442435722,4507.978937098271,138273.92318067045,1040,12,513.8125,32,0,13,30.838062980593193,0.6669921875,41.382575757575765,1034.4696969696977,32.32717803030305,0
1048,4,0,0,32,0.0,0.0,1.0,32,900,700,200,0.7777777777777778,11,7,4,409.1325943106295,0.3694766465053763,0.046674850555080916,0.25659218634768416,133896.59098880223,4556.291928119587,138452.8829169218,1041,13,514.8125,32,0,14,30.67026554430483,0.6682942708333333,41.256313131313135,1034.974747474748,32.342960858585876,0
1049,4,0,0,32,0.0,0.0,1.0,32,1050,900,150,0.8571428571428571,12,9,3,409.7685596693721,0.36937163978494625,0.04048555230431572,0.25813530924794115,134059.98909550064,4586.713728191021,138646.70282369165,1042,14,515.8125,32,0,15,30.4895147524994,0.669921875,41.09848484848486,1035.606060606062,32.36268939393944,0
1050,4,1,1,32,0.030303030303030304,0.030303030303030304,0.9696969696969697,33,1000,900,100,0.9,11,9,2,402.16439409271715,0.37208017676767674,0.040179626565823634,0.2558733160009455,134423.66667868133,4212.082492310655,138635.74917099197,1043,0,501.1515151515151,33,0,15,30.321338533049715,0.6710858585858586,40.747549019607845,1037.009803921569,31.42453951277482,0
1051,4,0,1,31,0.0,0.03125,0.96875,32,650,400,250,0.6153846153846154,9,4,5,414.62756375308396,0.3680065524193548,0.052636587891338626,0.26283225257521764,134288.91383851142,4735.977036781961,139024.89087529338,1044,16,517.8125,32,0,16,30.133593210703694,0.6722005208333334,40.87752525252525,1036.4898989898993,32.39030934343435,0
1052,4,0,0,31,0.0,0.0,1.0,31,1100,900,200,0.8181818181818182,13,9,4,421.0701749955808,0.36765232974910395,0.05057545793483542,0.2668565758729956,134280.73459201396,5108.3224826389005,139389.05707465287,1045,17,532.8709677419355,31,0,19,29.974874371859297,0.6747311827956989,40.88541666666667,1036.458333333334,33.434139784946254,0
1053,4,0,0,31,0.0,0.0,1.0,31,850,400,450,0.47058823529411764,13,4,9,420.95161784570314,0.368010752688172,0.05082843377594837,0.2670275561489753,134314.47558932824,5107.979159884973,139422.4547492132,1046,18,533.8709677419355,31,0,19,29.94402399196082,0.6750672043010753,40.85286458333333,1036.5885416666658,33.43834005376341,0
1054,4,0,0,31,0.0,0.0,1.0,31,350,200,150,0.5714285714285714,5,2,3,421.46881939400544,0.36810035842293903,0.05056275372535701,0.2676024513568638,134348.2208251953,5124.717203776042,139472.93802897134,1047,19,534.8709677419355,31,0,19,29.896696809846784,0.6754032258064516,40.8203125,1036.71875,33.44254032258065,0
1055,4,0,0,31,0.0,0.0,1.0,31,300,200,100,0.6666666666666666,4,2,2,431.542544304348,0.36810035842293903,0.007027475477038525,0.26658843157492895,133337.70751953125,5308.178710937498,138645.88623046875,1048,20,535.8709677419355,31,0,20,30.654311649016645,0.6653225806451613,41.796875,1032.8125,33.31653225806452,4
1056,4,0,0,31,0.0,0.0,1.0,31,750,600,150,0.8,9,6,3,434.4432882414151,0.3678763440860215,0.005983350676378674,0.2693548387096774,133472.22222222228,5397.222222222229,138869.4444444445,1049,21,536.8709677419355,31,0,20,30.443548387096776,0.6666666666666666,41.66666666666667,1033.333333333334,33.33333333333335,0
1057,4,0,0,31,0.0,0.0,1.0,31,650,400,250,0.6153846153846154,9,4,5,434.4740626112752,0.36796594982078856,-0.0020803790190526694,0.2701088162154202,133573.15275404195,5406.814066569022,138979.96682061098,1050,22,537.8709677419355,31,0,20,30.340854221774368,0.6676747311827957,41.56901041666667,1033.723958333334,33.345934139784966,0
1058,4,0,0,31,0.0,0.0,1.0,31,450,400,50,0.8888888888888888,5,4,1,438.39921711408306,0.36796594982078856,0.011965506573185403,0.2623661604119286,132147.9769483025,5406.050204053347,137554.02715235585,1051,23,538.8709677419355,29,2,20,31.682397901751546,0.6591235632183907,42.95138888888889,1028.1944444444448,35.45498084291189,5
1059,4,0,0,31,0.0,0.0,1.0,31,550,400,150,0.7272727272727273,7,4,3,436.1959477134574,0.36765232974910395,0.00858937391652792,0.2617882648918853,132255.10223765424,5337.827932098749,137592.93016975297,1052,24,539.8709677419355,29,2,20,31.63032226122963,0.6602011494252873,42.847222222222214,1028.6111111111104,35.469348659003806,0
1060,4,0,0,31,0.0,0.0,1.0,31,800,600,200,0.75,10,6,4,435.5471756643919,0.3674731182795699,0.01278478366891922,0.261893951081316,132326.54320987646,5326.890432098753,137653.43364197522,1053,25,540.8709677419355,29,2,20,31.574536537077023,0.6609195402298851,42.77777777777777,1028.8888888888882,35.47892720306511,0
1061,4,0,0,31,0.0,0.0,1.0,31,700,500,200,0.7142857142857143,9,5,4,421.3824649871522,0.3680555555555556,-0.04279908559817114,0.2454842800613227,131121.55306971906,4850.464649092384,135972.01771881143,1054,26,541.8709677419355,30,1,19,33.16218285214348,0.6458333333333334,43.95161290322581,1024.1935483870968,34.13978494623656,3
1062,4,0,0,31,0.0,0.0,1.0,31,350,200,150,0.5714285714285714,5,2,3,421.3824649871522,0.36796594982078856,-0.04279908559817114,0.2454842800613227,131121.55306971906,4850.464649092384,135972.01771881143,1055,27,542.8709677419355,30,1,19,33.16218285214348,0.6458333333333334,43.95161290322581,1024.1935483870968,34.13978494623656,0
1063,4,2,2,31,0.06060606060606061,0.06060606060606061,0.9393939393939394,33,700,500,200,0.7142857142857143,9,5,4,399.6433047404277,0.37993213383838387,-0.050270500974726184,0.2359242610231691,131628.5896301268,3921.0595026720694,135549.6491327989,1056,0,510.90909090909093,31,2,17,33.20446326608299,0.6481854838709677,43.45703124999999,1026.1718749999989,33.10231854838706,0
1064,4,0,0,31,0.0,0.0,1.0,31,1000,800,200,0.8,12,8,4,422.6981294203186,0.3685931899641577,-0.035929714135851,0.24758033294618656,131328.125,4902.430555555556,136230.55555555556,1057,29,544.8709677419355,29,2,20,32.91836043360433,0.6508620689655173,43.75,1025.0,35.3448275862069,0
1065,4,1,1,31,0.03125,0.03125,0.96875,32,700,600,100,0.8571428571428571,8,6,2,414.70569077611447,0.3732358870967742,-0.04187680115273773,0.24465712854597035,131603.8071597872,4515.369551393215,136119.1767111804,1058,0,528.8125,30,2,17,32.84320146712077,0.6506944444444445,43.48118279569892,1026.0752688172038,34.20250896057346,0
1066,4,1,1,31,0.03125,0.03125,0.96875,32,850,400,450,0.47058823529411764,13,4,9,415.61391548615467,0.37619707661290325,-0.038181714023831526,0.24585929299517906,131707.2624906058,4547.874212336677,136255.13670294246,1059,0,529.78125,30,2,17,32.71490768626423,0.6517361111111111,43.38037634408602,1026.4784946236555,34.215949820788516,0
1067,4,0,0,31,0.0,0.0,1.0,31,1000,900,100,0.9,11,9,2,427.58959047785174,0.3687724014336917,-0.0256160561055383,0.25208334436232155,131577.3750964506,5052.223186728393,136629.598283179,1060,32,547.8709677419355,29,2,17,32.53956838590317,0.6533764367816093,43.50694444444444,1025.972222222222,35.37835249042145,0
1068,4,1,1,31,0.03125,0.03125,0.96875,32,450,300,150,0.6666666666666666,6,3,3,416.010610692176,0.37266885080645157,-0.02548341185708658,0.24698811781654334,131845.2661615503,4569.805938547788,136415.0721000981,1061,0,531.71875,30,2,18,32.56472756619989,0.6531250000000001,43.24596774193547,1027.0161290322567,34.233870967741886,0
1069,4,0,0,31,0.0,0.0,1.0,31,650,500,150,0.7692307692307693,8,5,3,424.8071567549319,0.3682347670250896,-0.017449295350491445,0.2513810805104644,131719.90981867278,4991.112075617274,136711.02189429005,1062,1,548.8064516129032,29,2,18,32.46614689036215,0.6548132183908046,43.36805555555555,1026.5277777777771,35.39750957854404,0
1070,4,2,1,32,0.06060606060606061,0.030303030303030304,0.9696969696969697,33,550,400,150,0.7272727272727273,7,4,3,404.6505367729532,0.3774068813131313,-0.022063674721902737,0.24291331614789724,132264.03130425335,4104.142252604148,136368.1735568575,1063,0,516.4848484848485,31,2,19,32.43248945147678,0.6545698924731184,42.83854166666666,1028.6458333333323,33.18212365591395,0
1071,4,0,0,32,0.0,0.0,1.0,32,550,300,250,0.5454545454545454,8,3,5,411.82587893545224,0.37243783602150543,-0.010637254901960436,0.24651549091206654,132156.0386316337,4485.05535322003,136641.09398485374,1064,1,533.625,30,2,20,32.357298474945544,0.65625,42.943548387096776,1028.225806451613,34.274193548387096,0
1072,4,1,0,33,0.030303030303030304,0.0,1.0,33,650,500,150,0.7692307692307693,8,5,3,403.6007620981655,0.3746843434343434,-0.006058233384345746,0.2444895367555923,132605.57804731763,4104.163776159096,136709.7418234767,1065,0,518.4242424242424,30,3,21,32.114272043151075,0.6607638888888889,42.50672043010753,1029.97311827957,34.33243727598566,0
1073,4,0,0,33,0.0,0.0,1.0,33,1050,600,450,0.5714285714285714,15,6,9,404.46255655613,0.3741319444444444,0.0007429537945968789,0.2461443558470162,132778.68106139437,4140.800959648511,136919.48202104287,1066,1,519.4242424242424,30,3,16,31.917275256477133,0.6625000000000001,42.33870967741935,1030.6451612903224,34.354838709677416,0
1074,4,0,1,32,0.0,0.030303030303030304,0.9696969696969697,33,650,500,150,0.7692307692307693,8,5,3,404.91320127657013,0.37476325757575757,0.002370201822684992,0.2471033545737923,132882.5970668574,4161.183554457157,137043.78062131454,1067,2,520.4242424242424,30,3,16,31.800775648546484,0.6635416666666667,42.23790322580645,1031.048387096774,34.368279569892465,0
1075,4,1,2,31,0.030303030303030304,0.06060606060606061,0.9393939393939394,33,1100,900,200,0.8181818181818182,13,9,4,397.05010804255886,0.37436868686868685,0.005398430193325421,0.24411111126171395,133159.90513715454,3974.230944328811,137134.13608148336,1068,0,517.7575757575758,30,3,17,31.723965794157213,0.6663194444444445,41.96908602150537,1032.123655913978,34.40412186379926,0
1076,4,1,1,31,0.03125,0.03125,0.96875,32,700,400,300,0.5714285714285714,10,4,6,409.4341301904802,0.37506300403225806,-0.00029457312146519143,0.2504495758479825,132970.38001543222,4488.522376543227,137458.90239197545,1069,0,534.6875,29,3,17,31.595632462519074,0.6673850574712643,42.152777777777786,1031.3888888888898,35.56513409961689,0
1077,4,1,1,31,0.03125,0.03125,0.96875,32,1100,900,200,0.8181818181818182,13,9,4,409.1060710618743,0.3717447916666667,0.0019335352351179669,0.25105574001135167,133090.55102107173,4489.630484738112,137580.18150580986,1070,0,535.65625,30,2,17,31.48283834831314,0.6656249999999999,42.03629032258064,1031.8548387096769,34.39516129032256,0
1078,4,0,0,31,0.0,0.0,1.0,31,600,300,300,0.5,9,3,6,420.0795837159475,0.36796594982078856,0.014858260019550373,0.2567153011597456,132934.5703125,4968.619791666668,137903.19010416666,1071,6,553.9354838709677,29,2,17,31.357323232323232,0.6670258620689655,42.1875,1031.25,35.560344827586206,0
1079,4,0,0,31,0.0,0.0,1.0,31,500,400,100,0.8,6,4,2,420.0795837159475,0.36796594982078856,0.014858260019550373,0.2567153011597456,132934.5703125,4968.619791666668,137903.19010416666,1072,7,554.9354838709677,29,2,17,31.357323232323232,0.6670258620689655,42.1875,1031.25,35.560344827586206,0
1080,4,0,1,30,0.0,0.03225806451612903,0.967741935483871,31,600,300,300,0.5,9,3,6,420.0795837159475,0.36841397849462365,0.014858260019550373,0.2567153011597456,132934.5703125,4968.619791666668,137903.19010416666,1073,8,555.9354838709677,29,2,17,31.357323232323232,0.6670258620689655,42.1875,1031.25,35.560344827586206,0
1081,4,0,0,30,0.0,0.0,1.0,30,550,400,150,0.7272727272727273,7,4,3,421.4892801263243,0.3640325670498084,0.036194324462403005,0.2574492394439685,132916.04994467573,5204.538041683195,138120.58798635894,1074,9,571.1666666666666,28,2,17,31.33969625191584,0.6700148809523809,42.20545977011495,1031.178160919541,36.827791461412176,0
1082,4,0,0,30,0.0,0.0,1.0,30,750,500,250,0.6666666666666666,10,5,5,420.4237905214779,0.36412835249042147,0.030640818524501734,0.2576656696364305,133042.01388888893,5186.805555555561,138228.8194444445,1075,10,572.1666666666666,29,1,17,31.23990306946689,0.6681034482758621,42.083333333333336,1031.666666666667,35.57471264367817,0
1083,4,0,0,30,0.0,0.0,1.0,30,550,400,150,0.7272727272727273,7,4,3,420.4237905214779,0.36412835249042147,0.030640818524501734,0.2576656696364305,133042.01388888893,5186.805555555561,138228.8194444445,1076,11,573.1666666666666,29,1,17,31.23990306946689,0.6681034482758621,42.083333333333336,1031.666666666667,35.57471264367817,0
1084,4,0,0,30,0.0,0.0,1.0,30,700,500,200,0.7142857142857143,9,5,4,420.4237905214779,0.36412835249042147,0.030640818524501734,0.2576656696364305,133042.01388888893,5186.805555555561,138228.8194444445,1077,12,574.1666666666666,29,1,17,31.23990306946689,0.6681034482758621,42.083333333333336,1031.666666666667,35.57471264367817,0
1085,4,0,0,30,0.0,0.0,1.0,30,700,300,400,0.42857142857142855,11,3,8,419.7941088649706,0.364918582375479,0.03409569935871559,0.25851943754708606,133221.18296682107,5185.093557098778,138406.27652391983,1078,13,575.1666666666666,29,1,17,31.075244405578726,0.6698994252873562,41.90972222222223,1032.3611111111118,35.59865900383144,0
1086,4,0,0,30,0.0,0.0,1.0,30,600,300,300,0.5,9,3,6,419.7941088649706,0.364918582375479,0.03409569935871559,0.25851943754708606,133221.18296682107,5185.093557098778,138406.27652391983,1079,14,576.1666666666666,29,1,17,31.075244405578726,0.6698994252873562,41.90972222222223,1032.3611111111118,35.59865900383144,0
1087,4,0,0,30,0.0,0.0,1.0,30,850,700,150,0.8235294117647058,10,7,3,422.76146310290875,0.36484674329501915,0.03736884584342248,0.2605977377037332,133257.03124999997,5267.187499999998,138524.21874999997,1080,15,577.1666666666666,29,1,17,30.96246973365619,0.6702586206896551,41.875,1032.4999999999998,35.603448275862064,0
1088,4,0,0,30,0.0,0.0,1.0,30,800,700,100,0.875,9,7,2,420.837713301339,0.36465517241379314,0.04104149861073769,0.26041521726583694,133400.47260802472,5227.989969135809,138628.46257716054,1081,16,578.1666666666666,29,1,18,30.867392668280022,0.6716954022988506,41.736111111111114,1033.0555555555557,35.622605363984675,0
1089,4,0,0,30,0.0,0.0,1.0,30,950,500,450,0.5263157894736842,14,5,9,420.66339722987163,0.3655890804597701,0.004270164666480447,0.25417149279504725,132508.92827652264,5148.35047654174,137657.27875306437,1082,17,579.1666666666666,28,2,21,31.772723044004103,0.6659226190476191,42.60057471264368,1029.5977011494251,36.77134646962232,8
1090,4,0,0,30,0.0,0.0,1.0,30,200,100,100,0.5,3,1,2,420.66339722987163,0.3655890804597701,0.004270164666480447,0.25417149279504725,132508.92827652264,5148.331186418283,137657.2594629409,1083,18,580.1666666666666,28,2,21,31.772723044004103,0.6659226190476191,42.60057471264368,1029.5977011494251,36.77134646962232,0
1091,4,0,0,30,0.0,0.0,1.0,30,400,300,100,0.75,5,3,2,414.90051836419036,0.3654693486590039,0.008401915655367853,0.2514304155666001,132619.89952850438,5004.813011956658,137624.71254046104,1084,19,581.1666666666666,28,2,21,31.80882968335891,0.6670386904761905,42.49281609195402,1030.0287356321835,36.786740558292266,0
1092,4,0,0,30,0.0,0.0,1.0,30,900,600,300,0.6666666666666666,12,6,6,406.77616933910156,0.3645354406130268,0.03678439831041613,0.24692844714872775,132684.03742283944,4794.540895061718,137478.57831790115,1085,20,582.1666666666666,29,1,18,31.95324436056439,0.6645114942528736,42.43055555555555,1030.2777777777771,35.526819923371626,1
1093,4,0,0,30,0.0,0.0,1.0,30,950,600,350,0.631578947368421,13,6,7,410.15730942137765,0.3648706896551724,0.03150094314201013,0.24993329643066212,132827.17013888885,4896.00694444444,137723.17708333328,1086,21,583.1666666666666,29,1,18,31.72157100511991,0.6659482758620691,42.291666666666664,1030.833333333333,35.545977011494244,0
1094,4,0,0,30,0.0,0.0,1.0,30,550,400,150,0.7272727272727273,7,4,3,408.0332293490008,0.3645593869731801,0.02883380484081033,0.24887680044844962,132862.96537422834,4842.500964506169,137705.46633873452,1087,22,584.1666666666666,29,1,18,31.740171314383225,0.666307471264368,42.25694444444444,1030.972222222222,35.550766283524894,0
1095,4,0,0,30,0.0,0.0,1.0,30,700,600,100,0.8571428571428571,8,6,2,406.8228552420148,0.3638888888888889,0.03241763174432166,0.24885226713568379,132970.38001543202,4819.077932098752,137789.45794753078,1088,23,585.1666666666666,29,1,18,31.6629634617111,0.6673850574712643,42.15277777777777,1031.3888888888882,35.565134099616834,0
1096,4,0,0,30,0.0,0.0,1.0,30,600,400,200,0.6666666666666666,8,4,4,407.92015580617726,0.36429597701149424,0.034868273416812645,0.24976281922279292,133006.194540895,4851.181520061717,137857.3760609567,1089,24,586.1666666666666,29,1,18,31.598531259817786,0.6677442528735633,42.11805555555555,1031.5277777777771,35.56992337164749,0
1097,4,0,0,30,0.0,0.0,1.0,30,800,600,200,0.75,10,6,4,409.10080135653476,0.36496647509578545,0.033037196571992444,0.25096695733094104,133077.8380594135,4888.450038580238,137966.28809799373,1090,25,587.1666666666666,29,1,18,31.495799120563564,0.668462643678161,42.04861111111111,1031.805555555555,35.57950191570879,0
1098,4,0,0,30,0.0,0.0,1.0,30,600,400,200,0.6666666666666666,8,4,4,410.1628659774764,0.3651340996168582,0.030641543292956097,0.25186033836468186,133113.6670524691,4919.656635802463,138033.32368827157,1091,26,588.1666666666666,29,1,18,31.432256617317176,0.6688218390804599,42.013888888888886,1031.9444444444443,35.58429118773946,0
1099,4,0,0,30,0.0,0.0,1.0,30,800,500,300,0.625,11,5,6,411.8650567864646,0.3652538314176245,0.030130534248418828,0.25314882026304525,133149.5008680555,4967.925347222216,138117.42621527772,1092,27,589.1666666666666,29,1,18,31.352190149374238,0.6691810344827587,41.979166666666664,1032.083333333333,35.5890804597701,0
1100,4,1,0,31,0.03225806451612903,0.0,1.0,31,1200,1100,100,0.9166666666666666,13,11,2,399.4508607485246,0.37011648745519715,0.03350376015535539,0.24835703880492332,133576.40921277023,4471.442327147641,138047.85153991787,1093,0,571.1290322580645,30,1,20,31.242686256663635,0.6704861111111111,41.56586021505376,1033.7365591397847,34.45788530465949,0
1101,4,0,1,30,0.0,0.03225806451612903,0.967741935483871,31,900,700,200,0.7777777777777778,11,7,4,400.1298295087326,0.36966845878136195,0.035788255616022946,0.24948127295301353,133680.63685108098,4497.922086368358,138178.55893744933,1094,1,572.1290322580645,30,1,20,31.120299367472494,0.6715277777777777,41.46505376344086,1034.139784946236,34.47132616487453,0
1102,4,1,2,29,0.03225806451612903,0.06451612903225806,0.935483870967742,31,800,600,200,0.75,10,6,4,395.9625968735207,0.36998207885304657,0.04589990955682843,0.24922351685568656,134028.35587929236,4414.043169730598,138442.39904902296,1095,0,568.6129032258065,30,1,17,30.878710193838696,0.675,41.12903225806451,1035.4838709677415,34.51612903225805,0
1103,4,0,0,29,0.0,0.0,1.0,29,950,800,150,0.8421052631578947,11,8,3,417.8273872963844,0.3573481116584565,0.06494141092832262,0.2606171173101713,133695.0162670102,5372.2878682785,139067.30413528872,1096,31,608.7586206896551,28,1,20,30.648270352875794,0.6778273809523809,41.451149425287355,1034.1954022988507,36.93555008210181,0
1104,4,0,0,29,0.0,0.0,1.0,29,600,400,200,0.6666666666666666,8,4,4,416.7507716049381,0.3576046798029557,0.062490421455938305,0.2604692322530863,133769.32223543405,5349.6936517373515,139119.0158871714,1097,32,609.7586206896551,28,1,18,30.60127314814814,0.6785714285714286,41.37931034482759,1034.48275862069,36.94581280788179,0
1105,4,0,0,29,0.0,0.0,1.0,29,650,400,250,0.6153846153846154,9,4,5,416.84427132809833,0.35714285714285715,0.05876578444564706,0.2607902343904112,133806.48296092596,5355.293177764541,139161.7761386905,1098,33,610.7586206896551,28,1,18,30.56143822617229,0.6789434523809526,41.34339080459769,1034.6264367816077,36.950944170771706,0
1106,4,0,0,29,0.0,0.0,1.0,29,600,300,300,0.5,9,3,6,415.15795232414865,0.3557573891625616,0.054703390844480504,0.26078579306848193,133955.17747142943,5322.511436451301,139277.68890788074,1099,34,611.7586206896551,28,1,18,30.455412907702982,0.6804315476190477,41.199712643678154,1035.2011494252865,36.97146962233166,0
1107,4,0,0,29,0.0,0.0,1.0,29,650,300,350,0.46153846153846156,10,3,7,416.2032474280533,0.35580870279146143,0.05258752230210306,0.2625029930628903,134103.95455558857,5362.900275796006,139466.85483138458,1100,35,612.7586206896551,28,1,18,30.27870254774124,0.6819196428571428,41.05603448275862,1035.7758620689654,36.99199507389162,0
1108,4,0,0,29,0.0,0.0,1.0,29,750,500,250,0.6666666666666666,10,5,5,416.5162039931439,0.3557573891625616,0.05635850590654745,0.2629668853581935,134141.16172876215,5374.393496498892,139515.55522526105,1101,36,613.7586206896551,28,1,18,30.233183079056875,0.6822916666666666,41.02011494252874,1035.9195402298858,36.997126436781635,0
1109,4,0,0,29,0.0,0.0,1.0,29,850,600,250,0.7058823529411765,11,6,5,416.09157672378177,0.3561165845648604,0.06045597747362308,0.26350031105431404,134252.8142134033,5372.293029131978,139625.10724253528,1102,37,614.7586206896551,28,1,19,30.131937705069557,0.6834077380952381,40.91235632183908,1036.3505747126433,37.01252052545154,0
1110,4,0,0,29,0.0,0.0,1.0,29,400,200,200,0.5,6,2,4,416.9359188070208,0.3561165845648604,0.06383253279805001,0.26457279280498275,134327.2750074316,5401.1731652133685,139728.44817264497,1103,38,615.7586206896551,28,1,19,30.035227535227534,0.6841517857142858,40.84051724137931,1036.6379310344826,37.02278325123152,0
1111,4,0,0,29,0.0,0.0,1.0,29,750,600,150,0.8,9,6,3,413.87737904450705,0.3556034482758621,0.05915831892970691,0.26451525942118825,134588.05035341508,5340.589906196299,139928.64025961136,1104,39,616.7586206896551,28,1,19,29.852649312286523,0.6867559523809524,40.5890804597701,1037.6436781609182,37.058702791461364,0
1112,4,0,0,29,0.0,0.0,1.0,29,750,500,250,0.6666666666666666,10,5,5,412.5797605864054,0.3556547619047619,0.05699392828502714,0.264226612630868,134662.60404280608,5311.812987184561,139974.41702999064,1105,40,617.7586206896551,28,1,20,29.811507936507944,0.6875,40.51724137931034,1037.931034482758,37.06896551724135,0
1113,4,0,0,29,0.0,0.0,1.0,29,300,100,200,0.3333333333333333,5,1,4,412.5797605864054,0.3556547619047619,0.05699392828502714,0.264226612630868,134662.60404280608,5311.812987184561,139974.41702999064,1106,41,618.7586206896551,28,1,20,29.811507936507944,0.6875,40.51724137931034,1037.931034482758,37.06896551724135,0
1114,4,0,0,29,0.0,0.0,1.0,29,600,400,200,0.6666666666666666,8,4,4,414.13671407851626,0.3557573891625616,0.05898241026179396,0.2657683744166392,134737.17837561094,5359.922463337281,140097.10083894822,1107,42,619.7586206896551,28,1,20,29.696293477258045,0.6882440476190477,40.44540229885057,1038.218390804597,37.07922824302132,0
1115,4,0,0,29,0.0,0.0,1.0,29,700,500,200,0.7142857142857143,9,5,4,416.61179591510484,0.3560652709359606,0.0626300020991164,0.26790658904576325,134811.77335182985,5432.835001321183,140244.60835315104,1108,43,620.7586206896551,28,1,19,29.55721960892825,0.6889880952380952,40.37356321839081,1038.505747126437,37.08949096880132,0
1116,4,0,0,29,0.0,0.0,1.0,29,750,500,250,0.6666666666666666,10,5,5,417.1075260794789,0.3553468801313629,0.06295607383030433,0.26877784434533264,134886.38897146253,5452.425601136209,140338.81457259873,1109,44,621.7586206896551,28,1,19,29.469513600737645,0.6897321428571429,40.30172413793103,1038.7931034482758,37.09975369458128,0
1117,4,0,0,29,0.0,0.0,1.0,29,500,400,100,0.8,6,4,2,417.1075260794789,0.35524425287356326,0.06295607383030433,0.26877784434533264,134886.38897146253,5452.425601136209,140338.81457259873,1110,45,622.7586206896551,28,1,19,29.469513600737645,0.6897321428571429,40.30172413793103,1038.7931034482758,37.09975369458128,0
1118,4,0,0,29,0.0,0.0,1.0,29,600,300,300,0.5,9,3,6,416.96019379356187,0.35483374384236455,0.06427437463350438,0.26951502070677696,134998.35110731277,5457.787727903292,140456.13883521606,1111,46,623.7586206896551,28,1,19,29.361088068574585,0.6908482142857144,40.19396551724138,1039.2241379310349,37.115147783251246,0
1119,4,0,0,29,0.0,0.0,1.0,29,900,800,100,0.8888888888888888,10,8,2,417.0310690879488,0.35473111658456485,0.06697356131221266,0.2703975641505733,135110.35969084423,5469.043549346014,140579.40324019024,1112,47,624.7586206896551,28,1,19,29.246994195688227,0.6919642857142858,40.08620689655172,1039.655172413793,37.13054187192118,0
1120,4,0,0,29,0.0,0.0,1.0,29,450,300,150,0.6666666666666666,6,3,3,417.0310690879488,0.35473111658456485,0.06697356131221266,0.2703975641505733,135110.35969084423,5469.043549346014,140579.40324019024,1113,48,625.7586206896551,28,1,19,29.246994195688227,0.6919642857142858,40.08620689655172,1039.655172413793,37.13054187192118,0
1121,4,0,0,29,0.0,0.0,1.0,29,550,400,150,0.7272727272727273,7,4,3,417.96155614471877,0.35467980295566504,0.0713281983127787,0.27184399864614733,135222.41472205712,5503.554176575511,140725.96889863262,1114,49,626.7586206896551,28,1,19,29.110547036883546,0.6930803571428572,39.97844827586207,1040.086206896552,37.145935960591146,0
1122,4,0,0,29,0.0,0.0,1.0,29,550,400,150,0.7272727272727273,7,4,3,419.8069117264294,0.3543206075533662,0.07330860187914601,0.27361132743574046,135297.14388046644,5559.735227573005,140856.87910803943,1115,50,627.7586206896551,28,1,19,28.987708879988944,0.6938244047619048,39.906609195402304,1040.3735632183914,37.15619868637112,0
1123,4,0,0,29,0.0,0.0,1.0,29,700,500,200,0.7142857142857143,9,5,4,418.14598187976645,0.35375615763546797,0.07540306069003622,0.2728120000696638,135334.51620095118,5517.916831813978,140852.43303276517,1116,51,628.7586206896551,28,1,19,28.99348706618799,0.6941964285714286,39.87068965517241,1040.51724137931,37.161330049261075,0
1124,4,0,0,29,0.0,0.0,1.0,29,1000,900,100,0.9,11,9,2,418.8679658658957,0.35442323481116583,0.07284928964089388,0.27413716465206994,135446.66412752675,5546.853737283662,140993.51786481042,1117,52,629.7586206896551,28,1,19,28.86243386243387,0.6953125,39.76293103448276,1040.948275862069,37.17672413793104,0
1125,4,0,0,29,0.0,0.0,1.0,29,400,300,100,0.75,5,3,2,416.2022939131561,0.35385878489326766,0.070250411642095,0.272676475740934,135484.05709142558,5477.755070022469,140961.81216144806,1118,53,630.7586206896551,28,1,19,28.894390008280432,0.6956845238095237,39.72701149425288,1041.0919540229888,37.18185550082103,0
1126,4,0,0,29,0.0,0.0,1.0,29,600,600,0,1.0,6,6,0,415.12797775753893,0.3542179802955665,0.06627236954173621,0.27225633075193556,135521.45521617803,5451.749529330189,140973.2047455082,1119,54,631.7586206896551,28,1,19,28.884940895083016,0.6960565476190476,39.691091954023,1041.2356321839097,37.18698686371106,0
1127,4,0,0,29,0.0,0.0,1.0,29,900,700,200,0.7777777777777778,11,7,4,414.86735147165734,0.35370484400656815,0.06632068156844473,0.2726539828484175,135596.2669482429,5450.892827652283,141047.15977589518,1120,55,632.7586206896551,28,1,19,28.816905780107614,0.6968005952380952,39.61925287356323,1041.522988505748,37.197249589490994,0
1128,4,0,0,29,0.0,0.0,1.0,29,450,300,150,0.6666666666666666,6,3,3,412.79999999999995,0.35370484400656815,0.0651034482758619,0.27157894736842114,135633.6805555556,5397.9166666666715,141031.59722222225,1121,56,633.7586206896551,28,1,19,28.83333333333334,0.6971726190476191,39.583333333333336,1041.666666666667,37.20238095238096,0
1129,4,0,0,29,0.0,0.0,1.0,29,700,400,300,0.5714285714285714,10,4,6,411.19303224338296,0.3539100985221675,0.06349734674857821,0.27108835180263763,135708.52325274152,5360.479835513289,141069.0030882548,1122,57,634.7586206896551,28,1,21,28.80038839860269,0.6979166666666666,39.51149425287357,1041.9540229885063,37.21264367816094,0
1130,4,0,0,29,0.0,0.0,1.0,29,1050,900,150,0.8571428571428571,12,9,3,409.7642949787818,0.35334564860426926,0.060839067786944145,0.2712819091574857,135858.27057735508,5333.9736920333025,141192.24426938838,1123,58,635.7586206896551,28,1,22,28.68803978316795,0.6994047619047619,39.367816091954026,1042.5287356321844,37.23316912972087,0
1131,4,0,0,29,0.0,0.0,1.0,29,850,500,350,0.5882352941176471,12,5,7,406.7476099006798,0.3525759441707717,0.05758212103647797,0.2698513850693909,135933.17520478278,5258.098824151155,141191.27402893393,1124,59,636.7586206896551,28,1,18,28.691903187287593,0.7001488095238095,39.29597701149426,1042.8160919540237,37.243431855500845,0
1132,4,0,0,29,0.0,0.0,1.0,29,800,400,400,0.5,12,4,8,405.9717172607678,0.3527298850574712,0.05449045206084424,0.2701888761714424,136045.57085232533,5246.130804928002,141291.70165725332,1125,60,637.7586206896551,28,1,18,28.59999770463206,0.7012648809523809,39.1882183908046,1043.247126436782,37.25882594417079,0
1133,4,1,0,30,0.03333333333333333,0.0,1.0,30,600,500,100,0.8333333333333334,7,5,2,394.60731959939807,0.3552203065134099,0.054149497097788934,0.2657682063873115,136466.8426890431,4770.163001543195,141237.0056905863,1126,0,617.4666666666667,29,1,19,28.476976161992102,0.7022270114942528,38.784722222222214,1044.8611111111102,36.029693486590006,0
1134,4,0,0,30,0.0,0.0,1.0,30,650,300,350,0.46153846153846156,10,3,7,392.3886049822849,0.3551245210727969,0.05207087486157258,0.2648183186091207,136539.4121334878,4715.301890432115,141254.7140239199,1127,1,618.4666666666667,29,1,19,28.462763012181618,0.7029454022988506,38.715277777777786,1045.1388888888898,36.039272030651375,0
1135,4,0,0,30,0.0,0.0,1.0,30,700,600,100,0.8571428571428571,8,6,2,396.39755235498194,0.3551245210727969,0.012909942738156932,0.2448487775157298,133333.36946467782,4570.604260608141,137903.97372528596,1128,2,619.4666666666667,30,0,21,31.56613309040431,0.6680555555555556,41.80107526881719,1032.7956989247298,34.426523297490995,8
1136,4,0,0,30,0.0,0.0,1.0,30,450,200,250,0.4444444444444444,7,2,5,396.39755235498194,0.3551245210727969,0.012909942738156932,0.2448487775157298,133333.36946467782,4570.604260608141,137903.97372528596,1129,3,620.4666666666667,30,0,21,31.56613309040431,0.6680555555555556,41.80107526881719,1032.7956989247298,34.426523297490995,0
1137,4,0,0,30,0.0,0.0,1.0,30,950,700,250,0.7368421052631579,12,7,5,397.95840813522864,0.3548132183908046,0.006586878279345898,0.24650332661849322,133437.50225820896,4620.515196843557,138058.01745505253,1130,4,621.4666666666667,30,0,21,31.421013832878025,0.6690972222222222,41.7002688172043,1033.1989247311822,34.43996415770607,0
1138,4,0,0,30,0.0,0.0,1.0,30,600,500,100,0.8333333333333334,7,5,2,397.7942407429642,0.3542145593869732,0.005643693107932224,0.24709513015455517,133541.67569950275,4624.421898485364,138166.09759798812,1131,5,622.4666666666667,30,0,21,31.320437798006065,0.670138888888889,41.59946236559139,1033.6021505376339,34.45340501792113,0
1139,4,0,0,30,0.0,0.0,1.0,30,750,600,150,0.8,9,6,3,397.8571036181242,0.3543103448275862,0.004834936314010774,0.24806422651846408,133680.636851081,4637.15819747947,138317.79504856048,1132,6,623.4666666666667,30,0,21,31.179057274066363,0.6715277777777778,41.46505376344086,1034.1397849462362,34.47132616487454,0
1140,4,1,1,30,0.03225806451612903,0.03225806451612903,0.967741935483871,31,950,900,50,0.9473684210526315,10,9,1,386.6395129223999,0.3609767025089606,-0.011681532227643787,0.243463503267763,134044.6662902832,4165.3928968641485,138210.05918714736,1133,0,604.3225806451613,31,0,18,31.103697766042163,0.6723790322580645,41.11328125,1035.546875,33.40473790322581,0
1141,4,0,0,30,0.0,0.0,1.0,30,600,300,300,0.5,9,3,6,399.0839368933706,0.3545977011494253,0.0018783000086557422,0.25071325301408975,133958.77594230545,4692.159136894436,138650.9350791999,1134,8,625.4666666666667,30,0,18,30.867794079459888,0.6743055555555555,41.196236559139784,1035.2150537634407,34.50716845878136,0
1142,4,0,0,30,0.0,0.0,1.0,30,700,500,200,0.7142857142857143,9,5,4,400.376303175037,0.3539511494252874,0.007107938568029271,0.25224034472311213,134063.15262241306,4735.141887790507,138798.29451020356,1135,9,626.4666666666667,30,0,19,30.729504650659745,0.6753472222222222,41.09543010752689,1035.618279569893,34.520609318996435,0
1143,4,0,0,30,0.0,0.0,1.0,30,800,600,200,0.75,10,6,4,390.30741704167366,0.35359195402298854,0.02663368914345221,0.24063736578765155,133263.97018441447,4402.78319747949,137666.75338189397,1136,10,627.4666666666667,30,0,21,31.793207064132606,0.6673611111111111,41.86827956989248,1032.5268817204308,34.41756272401436,4
1144,4,0,0,30,0.0,0.0,1.0,30,400,200,200,0.5,6,2,4,398.88600329696794,0.35359195402298854,0.002712873020039641,0.231962868176817,131052.73189097014,4455.020089027643,135507.7519799978,1137,11,628.4666666666667,30,0,19,33.80808611184037,0.6451388888888889,44.01881720430108,1023.9247311827964,34.13082437275988,3
1145,4,1,0,31,0.03225806451612903,0.0,1.0,31,700,300,400,0.42857142857142855,11,3,8,384.62857893076557,0.36088709677419356,0.0034076573993675474,0.2260697528103515,131461.62245008687,3912.7794053819534,135374.40185546884,1138,0,609.1612903225806,31,0,20,33.758676146944296,0.646505376344086,43.61979166666667,1025.520833333334,33.081317204301094,0
1146,4,0,0,31,0.0,0.0,1.0,31,550,500,50,0.9090909090909091,6,5,1,384.09109952533004,0.36093189964157707,0.006290261152313681,0.22595112703219017,131495.00740898986,3901.21239556207,135396.21980455192,1139,1,610.1612903225806,31,0,21,33.73865367525707,0.6468413978494623,43.587239583333336,1025.651041666667,33.08551747311829,0
1147,4,0,0,31,0.0,0.0,1.0,31,450,200,250,0.4444444444444444,7,2,5,385.3848334149294,0.36084229390681005,0.0068118552480758154,0.2273078209064106,131595.18771701393,3942.95789930556,135538.1456163195,1140,2,611.1612903225806,31,0,17,33.604060913705595,0.6478494623655914,43.489583333333336,1026.041666666667,33.0981182795699,0
1148,4,0,0,31,0.0,0.0,1.0,31,700,400,300,0.5714285714285714,10,4,6,384.9810069446858,0.35976702508960573,-0.004975368651904066,0.22786713654293564,131728.82080078125,3942.618815104167,135671.4396158854,1141,3,612.1612903225806,31,0,17,33.47919837645865,0.6491935483870968,43.359375,1026.5625,33.11491935483871,0
1149,4,0,0,31,0.0,0.0,1.0,31,450,300,150,0.6666666666666666,6,3,3,387.02088067155836,0.3602598566308244,-0.007330262695016687,0.22947719285533133,131795.66277397994,4001.534695095476,135797.1974690754,1142,4,613.1612903225806,31,0,17,33.359223095781566,0.6498655913978495,43.29427083333333,1026.8229166666658,33.12331989247309,0
1150,4,0,0,31,0.0,0.0,1.0,31,700,500,200,0.7142857142857143,9,5,4,384.40302407978163,0.3596326164874552,-0.003925433126566569,0.22852716329807046,131895.957522922,3940.240987141918,135836.1985100639,1143,5,614.1612903225806,31,0,17,33.3250147885241,0.6508736559139785,43.19661458333333,1027.2135416666658,33.13592069892471,0
1151,4,0,0,31,0.0,0.0,1.0,31,700,500,200,0.7142857142857143,9,5,4,383.07141445830746,0.35922939068100357,-0.006541559344208636,0.22793615837677567,131929.3975830078,3907.6761881510406,135837.07377115884,1144,6,615.1612903225806,31,0,17,33.32541191381497,0.6512096774193548,43.1640625,1027.34375,33.140120967741936,0
1152,4,0,0,31,0.0,0.0,1.0,31,600,300,300,0.5,9,3,6,383.29054884578517,0.35927419354838713,-0.013601271849699392,0.22867061995765547,132029.74319458008,3921.150546603734,135950.8937411838,1145,7,616.1612903225806,31,0,17,33.218384433464244,0.6522177419354838,43.06640625,1027.734375,33.15272177419355,0
1153,4,0,0,31,0.0,0.0,1.0,31,800,700,100,0.875,9,7,2,382.5754587529766,0.35927419354838713,-0.01726096586219006,0.22844558785143715,132063.20020887593,3904.827880859385,135968.0280897353,1146,8,617.1612903225806,31,0,17,33.202960054049484,0.6525537634408602,43.03385416666667,1027.864583333334,33.15692204301077,0
1154,4,0,0,31,0.0,0.0,1.0,31,700,300,400,0.42857142857142855,11,3,8,382.42851086413145,0.35945340501792117,-0.015426348988462957,0.22876178195327135,132130.126953125,3906.0655381944457,136036.19249131944,1147,9,618.1612903225806,31,0,18,33.13914218169537,0.6532258064516129,42.96875,1028.125,33.16532258064516,0
1155,4,2,2,31,0.06060606060606061,0.06060606060606061,0.9393939393939394,33,450,200,250,0.4444444444444444,7,2,5,364.20026967978623,0.3728298611111111,-0.024767489244461816,0.22032936401146438,132555.70461180783,3055.364673442891,135611.06928525073,1148,0,581.6363636363636,33,0,18,33.17899857193861,0.6524621212121213,42.55514705882352,1029.779411764705,31.205436720142576,0
1156,4,0,0,31,0.0,0.0,1.0,31,800,600,200,0.75,10,6,4,385.67042576292584,0.3587365591397849,-0.006270360300781208,0.2319305711094854,132331.0089111327,4007.231309678806,136338.2402208115,1149,11,620.1612903225806,31,0,19,32.852969712309125,0.655241935483871,42.77343749999999,1028.906249999999,33.190524193548356,0
1157,4,0,0,31,0.0,0.0,1.0,31,600,400,200,0.6666666666666666,8,4,4,387.1564700994881,0.3585573476702509,-0.007053262746282707,0.23303104213223566,132364.50407240115,4049.1548326280217,136413.65890502918,1150,12,621.1612903225806,31,0,19,32.78093234636635,0.6555779569892475,42.74088541666666,1029.0364583333323,33.194724462365556,0
1158,4,0,0,31,0.0,0.0,1.0,31,650,400,250,0.6153846153846154,9,4,5,388.27011721141065,0.3581541218637993,-0.011750977208000224,0.23432546157812312,132465.01498752166,4086.4413791232605,136551.4563666449,1151,13,622.1612903225806,31,0,20,32.650834809005815,0.6565860215053764,42.643229166666664,1029.427083333333,33.20732526881719,0
1159,4,0,0,31,0.0,0.0,1.0,31,600,500,100,0.8333333333333334,7,5,2,388.52212686665484,0.3586469534050179,-0.008876270660988617,0.23489548771112423,132532.04345703116,4098.326280381931,136630.3697374131,1152,14,623.1612903225806,31,0,20,32.576715562299775,0.6572580645161291,42.57812499999999,1029.6874999999993,33.215725806451594,0
1160,4,0,0,31,0.0,0.0,1.0,31,750,400,350,0.5333333333333333,11,4,7,390.1294391573835,0.35810931899641574,-0.008090001264063007,0.236499156565062,132632.61795043937,4148.77777099608,136781.39572143546,1153,15,624.1612903225806,31,0,18,32.43387372013651,0.6582661290322582,42.48046874999999,1030.0781249999993,33.2283266129032,0
1161,4,1,1,31,0.03125,0.03125,0.96875,32,550,200,350,0.36363636363636365,9,2,7,381.3126285712408,0.3663684475806452,-0.013258387412758754,0.23292297962163985,132918.2947690287,3736.684872717075,136654.97964174577,1154,0,605.625,32,0,18,32.373168442104394,0.6585286458333334,42.20328282828283,1031.186868686869,32.22458964646466,0
1162,4,0,0,31,0.0,0.0,1.0,31,700,300,400,0.42857142857142855,11,3,8,388.2144704805086,0.35810931899641574,0.0023648523814805422,0.22444452498641335,130828.1135559083,3957.873365614164,134785.98692152248,1155,17,626.1612903225806,31,0,19,34.309241228628416,0.6401209677419355,44.23828125000001,1023.0468750000008,33.00151209677422,8
1163,4,0,0,31,0.0,0.0,1.0,31,500,100,400,0.2,9,1,8,384.5443261572243,0.35869175627240146,0.0015761670408693806,0.22270699036622152,130894.72664727112,3866.9648912217926,134761.69153849292,1156,18,627.1612903225806,31,0,19,34.33550176019001,0.6407930107526882,44.173177083333336,1023.3072916666672,33.00991263440862,0
1164,4,1,1,31,0.03125,0.03125,0.96875,32,1050,800,250,0.7619047619047619,13,8,5,379.9235344966019,0.36254620295698925,-0.006989371534195987,0.22196396561842532,131231.07854109284,3571.5550390266417,134802.63358011947,1157,0,608.53125,32,0,19,34.11275415896488,0.6416015625,43.844696969696976,1024.621212121213,32.019412878787904,0
1165,4,0,0,31,0.0,0.0,1.0,31,550,300,250,0.5454545454545454,8,3,5,390.6523104357499,0.3582437275985663,0.0015745642270488247,0.22781777065960282,131161.34855482308,4047.69677056206,135209.04532538514,1158,20,629.1612903225806,31,0,20,33.90865323503242,0.643481182795699,43.912760416666664,1024.348958333333,33.043514784946225,0
1166,4,0,0,31,0.0,0.0,1.0,31,650,200,450,0.3076923076923077,11,2,9,392.06871460307434,0.3581541218637993,-0.003410688737758072,0.2290414784863838,131228.04641723618,4090.082295735663,135318.12871297184,1159,21,630.1612903225806,31,0,20,33.804724234337286,0.6441532258064517,43.84765624999999,1024.6093749999989,33.051915322580605,0
1167,4,0,0,31,0.0,0.0,1.0,31,850,600,250,0.7058823529411765,11,6,5,390.9709828805609,0.3574820788530466,0.002360346184107076,0.2289972899728997,131328.12499999985,4069.1353691948625,135397.26036919473,1160,22,631.1612903225806,30,1,20,33.73136856368565,0.6479166666666667,43.74999999999999,1024.9999999999989,34.16666666666663,0
1168,4,0,0,31,0.0,0.0,1.0,31,1100,900,200,0.8181818181818182,13,9,4,388.6515855154563,0.35752688172043007,0.007310250407768448,0.22928641451506898,131603.8071597872,4029.605662504327,135633.41282229152,1161,23,632.1612903225806,30,1,18,33.511538293598804,0.6506944444444445,43.48118279569892,1026.0752688172038,34.20250896057346,0
1169,4,0,0,31,0.0,0.0,1.0,31,1150,900,250,0.782608695652174,14,9,5,388.9522377665169,0.35672043010752685,0.013391574714003207,0.22987920182547375,131672.7728639148,4042.883931668388,135715.6567955832,1162,24,633.1612903225806,30,1,18,33.434007770211274,0.6513888888888889,43.41397849462365,1026.3440860215046,34.21146953405015,0
1170,4,0,0,31,0.0,0.0,1.0,31,600,400,200,0.6666666666666666,8,4,4,387.60303710825,0.3564516129032258,0.014859744790852503,0.22928926370222344,131707.2624906058,4010.0269901144547,135717.28948072024,1163,25,634.1612903225806,30,1,18,33.43372179302517,0.6517361111111111,43.38037634408602,1026.4784946236555,34.215949820788516,0
1171,4,0,0,31,0.0,0.0,1.0,31,1000,800,200,0.8,12,8,4,389.7501439105288,0.3565860215053764,0.0213561898327983,0.23118719716431968,131810.75846918713,4074.6524164643206,135885.41088565145,1164,26,635.1612903225806,30,1,18,33.273887434554965,0.6527777777777779,43.27956989247311,1026.881720430107,34.229390681003565,0
1172,4,0,0,31,0.0,0.0,1.0,31,650,300,350,0.46153846153846156,10,3,7,389.25986577708926,0.3565412186379928,0.021671408430490313,0.2313160104407866,131879.77837033183,4067.1009654295276,135946.87933576136,1165,27,636.1612903225806,30,1,19,33.21665358108698,0.6534722222222222,43.21236559139785,1027.1505376344085,34.238351254480285,0
1173,4,0,0,31,0.0,0.0,1.0,31,700,400,300,0.5714285714285714,10,4,6,389.0551712372752,0.3565860215053764,0.014137168515049092,0.23161508792349916,131948.81633714872,4067.073866921023,136015.89020406973,1166,28,637.1612903225806,30,1,19,33.152090964590975,0.6541666666666666,43.14516129032258,1027.4193548387088,34.24731182795696,0
1174,4,1,0,32,0.03125,0.0,1.0,32,1050,600,450,0.5714285714285714,15,6,9,380.2624540869377,0.36027805779569894,0.003190227703984805,0.22928868799063645,132431.5071105957,3671.745978461372,136103.25308905708,1167,0,618.21875,31,1,20,32.8907073582121,0.65625,42.67578125,1029.296875,33.203125,0
1175,4,0,0,32,0.0,0.0,1.0,32,1000,900,100,0.9,11,9,2,378.48260081834593,0.36061407930107525,0.0007704829940573532,0.22902975438961726,132565.56404961474,3634.751892089839,136200.31594170458,1168,1,619.21875,31,1,20,32.801370801196946,0.6575940860215055,42.545572916666664,1029.817708333333,33.21992607526881,0
1176,4,2,2,32,0.058823529411764705,0.058823529411764705,0.9411764705882353,34,800,700,100,0.875,9,7,2,362.7405621707618,0.3749814319667261,0.0009915647170550823,0.22337181986304797,133219.0743944636,2864.792387543241,136083.86678200684,1169,0,583.7352941176471,33,1,19,32.54985754985755,0.6590909090909092,41.91176470588235,1032.3529411764698,31.283422459893025,0
1177,4,0,0,32,0.0,0.0,1.0,32,600,400,200,0.6666666666666666,8,4,4,381.28930460142647,0.3629872311827957,0.01437965769862326,0.23238394338179322,132833.88137817383,3729.627651638455,136563.5090298123,1170,1,621.15625,31,1,19,32.45876489410971,0.6602822580645162,42.28515625,1030.859375,33.25352822580645,0
1178,4,0,0,32,0.0,0.0,1.0,32,850,700,150,0.8235294117647058,10,7,3,381.6389076793621,0.3624411962365592,0.013673601464831098,0.23301453430322797,132901.00309583868,3744.038730197474,136645.04182603615,1171,2,622.15625,31,1,19,32.382166308877395,0.6609543010752689,42.22005208333333,1031.119791666666,33.26192876344084,0
1179,4,0,0,32,0.0,0.0,1.0,32,850,600,250,0.7058823529411765,11,6,5,381.2932024535114,0.3618111559139785,0.014987848756470301,0.23322188854318643,132968.1417677137,3739.969719780812,136708.11148749452,1172,3,623.15625,31,1,19,32.32349135210201,0.6616263440860215,42.154947916666664,1031.380208333333,33.27032930107526,0
1180,4,0,0,32,0.0,0.0,1.0,32,900,700,200,0.7777777777777778,11,7,4,382.4902958723727,0.3617901545698925,0.023394119131751934,0.23458615359850465,133068.8815646701,3779.5111762152733,136848.39274088538,1173,4,624.15625,31,1,19,32.191233383812886,0.6626344086021505,42.057291666666664,1031.770833333333,33.28293010752687,0
1181,4,0,0,32,0.0,0.0,1.0,32,600,500,100,0.8333333333333334,7,5,2,382.10701668839414,0.362273185483871,0.02190457413249236,0.2345622081530225,133102.46997409387,3771.877543131501,136874.34751722537,1174,5,625.15625,31,1,20,32.16732386961094,0.662970430107527,42.02473958333333,1031.9010416666658,33.28713037634406,0
1182,4,0,0,32,0.0,0.0,1.0,32,850,600,250,0.7058823529411765,11,6,5,379.7102325041465,0.3617901545698925,0.027072824716267707,0.23414480122534073,133270.47559950082,3720.832655164926,136991.30825466575,1175,6,626.15625,31,1,21,32.06021437578814,0.6646505376344086,41.861979166666664,1032.552083333333,33.3081317204301,0
1183,4,0,1,31,0.0,0.03125,0.96875,32,900,700,200,0.7777777777777778,11,7,4,382.91601342018566,0.3616431451612903,0.030501405524321568,0.2369908337219334,133406.99450311193,3816.7348995000507,137223.729402612,1176,7,627.15625,32,0,21,31.8402183655178,0.6634114583333334,41.72979797979798,1033.080808080808,32.28377525252525,0
1184,4,0,1,30,0.0,0.03225806451612903,0.967741935483871,31,300,100,200,0.3333333333333333,5,1,4,385.78459470422405,0.3617383512544803,0.028072591918471668,0.22537037681718924,131228.04641723633,3925.1517401801216,135153.19815741645,1177,8,625.483870967742,31,0,18,33.96569343838693,0.6441532258064516,43.84765625,1024.609375,33.05191532258065,7
1185,4,0,0,30,0.0,0.0,1.0,30,1000,700,300,0.7,13,7,6,388.8979521633967,0.3564415708812261,0.038351912568305835,0.22757842557528005,131293.6850539079,4211.969049890142,135505.65410379804,1178,9,646.0333333333333,30,0,20,33.81939890710382,0.6475694444444444,43.783602150537625,1024.8655913978487,34.162186379928286,0
1186,4,1,1,30,0.03225806451612903,0.03225806451612903,0.967741935483871,31,550,300,250,0.5454545454545454,8,3,5,377.13932335283073,0.3628584229390681,0.02698542655968561,0.22244445119912454,131595.18771701382,3725.944010416657,135321.13172743047,1179,0,626.1612903225806,31,0,18,33.815566835871415,0.6478494623655915,43.48958333333333,1026.041666666666,33.098118279569874,0
1187,4,1,1,30,0.03225806451612903,0.03225806451612903,0.967741935483871,31,550,400,150,0.7272727272727273,7,4,3,376.69381660997357,0.3615143369175627,0.029594104094969653,0.22276649334856857,131695.40617201055,3721.769036187057,135417.17520819762,1180,0,627.1290322580645,31,0,18,33.72565964734238,0.6488575268817205,43.39192708333333,1026.432291666666,33.11071908602148,0
1188,4,0,0,30,0.0,0.0,1.0,30,600,500,100,0.8333333333333334,7,5,2,386.6322254466905,0.35648946360153255,0.04021753374393877,0.22747806571963747,131500.39247673153,4168.4578780783995,135668.85035480993,1181,12,649.0333333333333,30,0,20,33.66804263311929,0.6496527777777779,43.58198924731183,1025.6720430107534,34.18906810035845,0
1189,4,0,0,30,0.0,0.0,1.0,30,650,400,250,0.6153846153846154,9,4,5,387.00016060020874,0.35538793103448274,0.04156076684571386,0.22810596338697994,131569.33108235046,4183.470451786322,135752.8015341368,1182,13,650.0333333333333,30,0,19,33.58880300449801,0.6503472222222222,43.51478494623655,1025.940860215053,34.1980286738351,0
1190,4,0,0,30,0.0,0.0,1.0,30,500,200,300,0.4,8,2,6,387.00016060020874,0.35538793103448274,0.04156076684571386,0.22810596338697994,131569.33108235046,4183.470451786322,135752.8015341368,1183,14,651.0333333333333,30,0,19,33.58880300449801,0.6503472222222222,43.51478494623655,1025.940860215053,34.1980286738351,0
1191,4,2,2,30,0.0625,0.0625,0.9375,32,450,300,150,0.6666666666666666,6,3,3,369.3178578391258,0.3679855510752688,0.03293109801031702,0.22077723924567985,132105.78799357195,3357.8053259871303,135463.5933195591,1184,0,611.28125,32,0,20,33.50067550970277,0.650390625,42.992424242424235,1028.030303030302,32.12594696969694,0
1192,4,0,0,30,0.0,0.0,1.0,30,550,400,150,0.7272727272727273,7,4,3,382.58252538639226,0.3592672413793103,0.02555279340573069,0.22755472696717474,131914.29509553118,4093.620830442815,136007.915925974,1185,1,616.4333333333333,30,0,20,33.35323171529503,0.6538194444444445,43.17876344086021,1027.2849462365584,34.242831541218614,0
1193,4,2,0,32,0.0625,0.0,1.0,32,400,300,100,0.75,5,3,2,362.31566435264625,0.36951864919354843,0.03300505824647426,0.21902774223838611,132527.98064291902,3203.392670390761,135731.37331330977,1186,0,578.84375,32,0,22,33.25541590026566,0.6546223958333335,42.5820707070707,1029.6717171717164,32.17724116161614,0
1194,4,0,0,32,0.0,0.0,1.0,32,350,200,150,0.5714285714285714,5,2,3,363.1680393195854,0.3693296370967742,0.0336332148111822,0.21973282853787332,132560.4848994998,3228.3462784409503,135788.83117794077,1187,1,579.84375,32,0,22,33.20076222004252,0.6549479166666667,42.55050505050504,1029.7979797979779,32.18118686868681,0
1195,4,0,0,32,0.0,0.0,1.0,32,950,700,250,0.7368421052631579,12,7,5,364.3271790914257,0.37069472446236557,0.031211708124004423,0.22139047718280908,132723.06596584525,3270.924044740321,135993.99001058558,1188,2,580.84375,32,0,18,33.00734182902421,0.6565755208333335,42.39267676767676,1030.4292929292924,32.20091540404039,0
1196,4,0,0,32,0.0,0.0,1.0,32,650,500,150,0.7692307692307693,8,5,3,363.72234215726064,0.36987567204301075,0.032589723174914376,0.22159919413222948,132820.66243240482,3261.9684853586264,136082.63091776345,1189,3,581.84375,32,0,18,32.92478156132615,0.6575520833333335,42.29797979797979,1030.8080808080804,32.21275252525251,0
1197,4,0,0,32,0.0,0.0,1.0,32,1150,800,350,0.6956521739130435,15,8,7,354.53443802843054,0.36987567204301075,-0.01634067838573916,0.200836549115965,130037.12153096613,2820.5275609631535,132857.64909192928,1190,4,582.84375,32,0,20,35.97244573739374,0.6295572916666667,45.012626262626256,1019.9494949494942,31.873421717171695,7
1198,4,1,1,32,0.030303030303030304,0.030303030303030304,0.9696969696969697,33,650,500,150,0.7692307692307693,8,5,3,345.956946011186,0.3746054292929293,-0.021241352431063065,0.19727841082132952,130294.8120727478,2415.474345730044,132710.28641847783,1191,0,566.1515151515151,32,1,20,35.92989941462611,0.6321614583333333,44.76010101010102,1020.9595959595969,31.904987373737402,0
1199,4,0,0,32,0.0,0.0,1.0,32,1200,900,300,0.75,15,9,6,353.2854120945326,0.3694556451612903,-0.01862014593123895,0.2014573936668823,130294.81207274777,2806.251275380079,133101.06334812785,1192,6,584.84375,32,0,21,35.74284772033969,0.6321614583333333,44.76010101010102,1020.9595959595966,31.904987373737395,0
1200,4,0,0,32,0.0,0.0,1.0,32,700,500,200,0.7142857142857143,9,5,4,347.9754040533679,0.36893061155913975,-0.02111905796202107,0.19375520597498164,129361.89746263131,2602.9517077338933,131964.8491703652,1193,7,585.84375,32,0,25,36.825638161433105,0.6227213541666667,45.675505050505045,1017.2979797979795,31.790561868686858,4
1201,4,1,1,32,0.030303030303030304,0.030303030303030304,0.9696969696969697,33,950,800,150,0.8421052631578947,11,8,3,338.2806194353486,0.37567077020202017,-0.023052612009667017,0.19013703782055805,129731.44531249999,2177.1267361111113,131908.5720486111,1194,0,569.060606060606,33,0,18,36.696915473755965,0.6240530303030303,45.3125,1018.7499999999999,30.871212121212118,0
1202,4,0,0,32,0.0,0.0,1.0,32,800,500,300,0.625,11,5,6,347.8388725620663,0.3693086357526882,-0.022638130968621883,0.19463045312060662,129554.63927469138,2612.8279320987717,132167.46720679014,1195,9,587.84375,32,0,18,36.6331286948613,0.6246744791666666,45.486111111111114,1018.0555555555558,31.814236111111118,0
1203,4,0,0,32,0.0,0.0,1.0,32,700,500,200,0.7142857142857143,9,5,4,352.75787904960305,0.3693086357526882,-0.030992798353909334,0.19048925468678568,128144.53125000009,2640.798611111125,130785.32986111121,1196,10,588.84375,32,0,21,37.94581618655694,0.6103515625,46.87500000000001,1012.5000000000007,31.64062500000002,5
1204,4,3,3,32,0.08571428571428572,0.08571428571428572,0.9142857142857143,35,900,600,300,0.6666666666666666,12,6,6,329.31336391021017,0.387640056022409,-0.044572601534627054,0.18059717874475506,128760.50407503855,1480.5109471450542,130241.01502218361,1197,0,539.2857142857143,35,0,16,37.911606226479634,0.6098214285714285,46.26736111111111,1014.9305555555553,28.998015873015866,0
1205,4,1,1,32,0.030303030303030304,0.030303030303030304,0.9696969696969697,33,650,600,50,0.9230769230769231,7,6,1,347.5059691489435,0.3751578282828283,-0.025645532170423202,0.18970708447735213,128579.18228565944,2336.406670511356,130915.58895617079,1198,0,572.939393939394,33,0,17,37.63492830675045,0.6123737373737372,46.446078431372555,1014.2156862745104,30.733808674985163,0
1206,4,2,0,34,0.058823529411764705,0.0,1.0,34,750,600,150,0.8,9,6,3,339.6878623736108,0.3791406714200832,-0.022564763802602306,0.18708051348671856,128929.21095521527,1959.137613378668,130888.34856859394,1199,0,557.0294117647059,34,0,21,37.476556089555736,0.6136642156862746,46.10119047619047,1015.5952380952369,29.870448179271676,0
1207,4,1,0,35,0.02857142857142857,0.0,1.0,35,650,400,250,0.6153846153846154,9,4,5,332.23595807578624,0.38641456582633055,-0.028571428571428026,0.18423994038748118,129201.38888888869,1585.0694444444216,130786.45833333311,1200,0,542.0857142857143,35,0,23,37.38900273224044,0.6142857142857144,45.83333333333332,1016.666666666665,29.047619047619,0
1208,4,1,1,35,0.027777777777777776,0.027777777777777776,0.9722222222222222,36,250,100,150,0.4,4,1,3,324.56293532284985,0.38867394179894177,-0.0342403000676379,0.18090228998408067,129401.82317029867,1199.8071128560996,130601.63028315477,1201,0,528.0,36,0,23,37.38055709278729,0.6142939814814815,45.63626126126126,1017.4549549549549,28.26263763763764,0
1209,4,0,0,35,0.0,0.0,1.0,35,900,500,400,0.5555555555555556,13,5,8,331.0510314622185,0.3857843137254902,-0.03370063383715227,0.1844067532669772,129377.95380015431,1566.1410108024697,130944.09481095678,1202,2,544.0857142857143,35,0,23,37.239761092150175,0.6160714285714286,45.65972222222222,1017.3611111111111,29.067460317460316,0
1210,4,0,0,35,0.0,0.0,1.0,35,850,600,250,0.7058823529411765,11,6,5,331.8698130801116,0.3843487394957983,-0.025725979341258753,0.1856950938837569,129554.63927469119,1599.054783950595,131153.6940586418,1203,3,545.0857142857143,35,0,17,37.03956343792632,0.6178571428571429,45.4861111111111,1018.0555555555541,29.087301587301546,0
1211,4,0,0,35,0.0,0.0,1.0,35,350,200,150,0.5714285714285714,5,2,3,331.9167383333335,0.38431372549019605,-0.024553825167670684,0.18586069682484635,129584.09857521002,1602.2262677897775,131186.3248429998,1204,4,546.0857142857143,35,0,18,37.00847353264369,0.6181547619047618,45.457175925925924,1018.1712962962961,29.090608465608458,0
1212,4,0,1,34,0.0,0.02857142857142857,0.9714285714285714,35,550,200,350,0.36363636363636365,9,2,7,332.31661208750194,0.3837535014005602,-0.023145487311869273,0.1863641727060501,129643.02722318661,1616.5063175154216,131259.53354070205,1205,5,547.0857142857143,35,0,18,36.93850153426526,0.6187500000000001,45.39930555555555,1018.4027777777768,29.097222222222193,0
1213,4,1,1,34,0.02857142857142857,0.02857142857142857,0.9714285714285714,35,600,200,400,0.3333333333333333,10,2,8,332.6237994220619,0.3793067226890756,-0.027123047445847925,0.1863964450519297,129613.56122470838,1622.5110382372957,131236.07226294567,1206,0,547.9142857142857,35,0,18,36.96057816170342,0.618452380952381,45.42824074074073,1018.287037037036,29.093915343915317,0
1214,4,3,4,33,0.08108108108108109,0.10810810810810811,0.8918918918918919,37,650,400,250,0.6153846153846154,9,4,5,315.50722557914827,0.39060935935935936,-0.020088008481344843,0.17912109420463518,130122.70752779683,810.9308873884127,130933.63841518524,1207,0,519.2162162162163,37,0,19,36.88104513702312,0.6196509009009009,44.92872807017543,1020.2850877192967,27.575272641062075,0
1215,4,1,1,33,0.029411764705882353,0.029411764705882353,0.9705882352941176,34,500,200,300,0.4,8,2,6,340.75995549375574,0.3777852049910873,-0.021907500137567038,0.19071853006430634,129564.73922902494,2030.0949546485226,131594.83418367346,1208,0,565.5294117647059,34,0,19,36.80303827564702,0.6200980392156863,45.476190476190474,1018.0952380952381,29.943977591036415,0
1216,4,0,0,33,0.0,0.0,1.0,33,950,800,150,0.8421052631578947,11,8,3,345.33698535041344,0.3697916666666667,-0.014139225406831546,0.19317941665359492,129544.24267409169,2347.283646914641,131891.52632100633,1209,2,583.6666666666666,33,0,20,36.70737029011675,0.6221590909090909,45.49632352941176,1018.0147058823529,30.84893048128342,0
1217,4,0,0,33,0.0,0.0,1.0,33,550,300,250,0.5454545454545454,8,3,5,345.58056008803084,0.36955492424242425,-0.012649363154900284,0.19346922460992996,129575.4337274125,2355.7501922337474,131931.18391964625,1210,3,584.6666666666666,33,0,20,36.66947520462204,0.6224747474747474,45.4656862745098,1018.1372549019605,30.8526440879382,0
1218,4,0,0,33,0.0,0.0,1.0,33,400,200,200,0.5,6,2,4,346.4836301420049,0.3695943813131313,-0.010911862638905978,0.19412896040795147,129606.62853529889,2381.3150290753456,131987.94356437423,1211,4,585.6666666666666,33,0,20,36.61479018734705,0.6227904040404041,45.43504901960784,1018.2598039215684,30.856357694592983,0
1219,4,1,0,34,0.029411764705882353,0.0,1.0,34,1400,1200,200,0.8571428571428571,16,12,4,336.00678120098655,0.37765522875817,-0.009492649633682904,0.1902557894612592,130019.64462868475,1937.4964569160993,131957.14108560086,1212,0,569.4117647058823,34,0,21,36.462589004318914,0.6246936274509804,45.029761904761905,1019.880952380952,29.996498599439764,0
1220,4,1,1,34,0.02857142857142857,0.02857142857142857,0.9714285714285714,35,600,400,200,0.6666666666666666,8,4,4,330.3623490212414,0.3824579831932773,-0.00816326530612188,0.1882297104888468,130262.58680555547,1606.7708333333285,131869.35763888882,1213,0,554.1142857142858,35,0,21,36.36054421768708,0.625,44.791666666666664,1020.8333333333327,29.166666666666647,0
1221,4,1,0,35,0.02857142857142857,0.0,1.0,35,250,100,150,0.4,4,1,3,329.4567616253505,0.38158263305322127,0.0020984116189828317,0.1881422011534283,130351.21588059409,1589.0178915894971,131940.2337721836,1214,0,555.0857142857143,35,0,22,36.29399013940836,0.6258928571428571,44.70486111111111,1021.1805555555552,29.17658730158729,0
1222,4,0,0,35,0.0,0.0,1.0,35,850,400,450,0.47058823529411764,13,4,9,328.0295965780966,0.381687675070028,-0.002564144071225849,0.1876125204019248,130410.31867551863,1555.688844950273,131966.0075204689,1215,1,556.0857142857143,35,0,23,36.270656279508984,0.6264880952380951,44.64699074074074,1021.4120370370366,29.183201058201046,0
1223,4,0,0,35,0.0,0.0,1.0,35,750,400,350,0.5333333333333333,11,4,7,327.2310338493171,0.38105742296918765,-0.005593228568191666,0.18744116390577048,130469.43486636237,1538.7296114111855,132008.16447777356,1216,2,557.0857142857143,35,0,23,36.23128375061365,0.6270833333333332,44.589120370370374,1021.643518518519,29.18981481481483,0
1224,4,2,2,35,0.05405405405405406,0.05405405405405406,0.9459459459459459,37,600,200,400,0.3333333333333333,10,2,8,313.09475537715366,0.3909221721721721,-0.010124998551916509,0.18125311769104202,130878.94833025541,795.5024622960871,131674.4507925515,1217,0,527.918918918919,37,0,15,36.17927561080154,0.6272522522522522,44.18859649122807,1023.2456140350873,27.65528686581317,0
1225,4,0,0,35,0.0,0.0,1.0,35,650,400,250,0.6153846153846154,9,4,5,328.84576100233437,0.38175770308123247,-0.0055906951162303375,0.1889418943013416,130587.70743580698,1588.6428058556467,132176.3502416626,1218,4,559.0857142857143,35,0,15,36.07049503642471,0.6282738095238094,44.47337962962964,1022.1064814814833,29.203042328042383,0
1226,4,0,0,35,0.0,0.0,1.0,35,500,400,100,0.8,6,4,2,328.84576100233437,0.38175770308123247,-0.0055906951162303375,0.1889418943013416,130587.70743580698,1588.6428058556467,132176.3502416626,1219,5,560.0857142857143,35,0,15,36.07049503642471,0.6282738095238094,44.47337962962964,1022.1064814814833,29.203042328042383,0
1227,4,0,0,35,0.0,0.0,1.0,35,950,700,250,0.7368421052631579,12,7,5,331.63400313039597,0.3815126050420168,-0.007450885277709984,0.19112762019941604,130706.03358892749,1669.3130304784027,132375.3466194059,1220,6,561.0857142857143,35,0,15,35.87966893039051,0.6294642857142856,44.35763888888889,1022.5694444444446,29.216269841269845,0
1228,4,0,1,34,0.0,0.02857142857142857,0.9714285714285714,35,900,400,500,0.4444444444444444,14,4,10,330.97784246283385,0.38070728291316525,-0.006052474175139988,0.1910418807213629,130765.21675936657,1656.0778624400014,132421.29462180656,1221,7,562.0857142857143,35,0,16,35.836657425219705,0.6300595238095237,44.299768518518526,1022.8009259259271,29.222883597883634,0
1229,4,2,2,34,0.05555555555555555,0.05555555555555555,0.9444444444444444,36,650,500,150,0.7692307692307693,8,5,3,321.3379922080219,0.38291997354497354,-0.0075746464757568965,0.18666349438742078,131010.89000740637,1219.7552704732161,132230.64527787958,1222,0,547.1666666666666,36,0,16,35.835349979833545,0.6304976851851851,44.059684684684704,1023.7612612612638,28.437812812812883,0
1230,4,2,3,33,0.05555555555555555,0.08333333333333333,0.9166666666666666,36,950,700,250,0.7368421052631579,12,7,5,321.94432957753924,0.38133267195767195,-0.00712086220169339,0.18729621169856495,131068.54056336766,1239.354684075999,132307.89524744367,1223,0,548.1111111111111,36,0,16,35.76171230616959,0.6310763888888888,44.00337837837839,1023.9864864864884,28.444069069069123,0
1231,4,0,0,33,0.0,0.0,1.0,33,600,500,100,0.8333333333333334,7,5,2,347.21030770930037,0.3670296717171717,-0.0002471639751235877,0.19894792682972068,130481.60750973185,2460.9118187716294,132942.5193285035,1224,10,598.4545454545455,33,0,21,35.70866318819719,0.6316287878787878,44.57720588235294,1021.6911764705883,30.960338680926917,0
1232,4,0,0,33,0.0,0.0,1.0,33,1050,800,250,0.7619047619047619,13,8,5,346.48421302396395,0.366635101010101,-0.0002471343320464836,0.1986922536584466,130512.91120001934,2444.132665321047,132957.04386534038,1225,11,599.4545454545455,33,0,16,35.69551051411211,0.6319444444444444,44.54656862745099,1021.813725490197,30.96405228758173,0
1233,4,2,1,34,0.05714285714285714,0.02857142857142857,0.9714285714285714,35,650,400,250,0.6153846153846154,9,4,5,332.8258240791857,0.37720588235294117,-0.03159830907741423,0.19463935577259636,131268.81456832984,1737.9302769204314,133006.74484525027,1226,0,566.1428571428571,35,0,18,35.281134703712084,0.6351190476190476,43.80787037037037,1024.768518518518,29.279100529100514,3
1234,4,0,2,32,0.0,0.058823529411764705,0.9411764705882353,34,1400,1200,200,0.8571428571428571,16,12,4,344.5345724516906,0.37201054664289956,-0.0471003877051801,0.2055540403576671,132030.69905045346,2297.828089569161,134328.52714002263,1227,1,583.7941176470588,34,0,17,34.213193559596895,0.6449142156862745,43.06547619047619,1027.738095238095,30.22759103641456,3
1235,4,1,1,32,0.030303030303030304,0.030303030303030304,0.9696969696969697,33,500,300,200,0.6,7,3,4,347.99063479505924,0.3673847853535353,-0.024080538270855323,0.20755686083864616,132019.90370290267,2588.3380190311314,134608.2417219338,1228,0,602.030303030303,33,0,17,34.1352651244137,0.6470959595959596,43.07598039215686,1027.696078431372,31.14230540701127,0
1236,4,0,0,32,0.0,0.0,1.0,32,950,800,150,0.8421052631578947,11,8,3,356.590070570218,0.36239919354838707,-0.02154775073746329,0.2120772524970242,131911.15702479324,3007.6417584940136,134918.79878328726,1229,43,621.84375,32,0,17,34.02393682399214,0.6484375,43.18181818181817,1027.2727272727261,32.10227272727269,0
1237,4,0,0,32,0.0,0.0,1.0,32,600,400,200,0.6666666666666666,8,4,4,355.3405338034967,0.36237819220430106,-0.0234461410839375,0.211514698138921,131943.58555568295,2976.9808246607367,134920.5663803437,1230,44,622.84375,32,0,17,34.02333988775552,0.6487630208333335,43.15025252525252,1027.398989898989,32.106218434343404,0
1238,4,0,0,32,0.0,0.0,1.0,32,700,500,200,0.7142857142857143,9,5,4,357.74429243968626,0.36258820564516125,-0.024960836712126788,0.21330994843711384,132008.45457415047,3045.0542355371745,135053.50880968766,1231,45,623.84375,32,0,17,33.89620960805996,0.6494140625,43.087121212121204,1027.651515151514,32.114109848484816,0
1239,4,0,0,32,0.0,0.0,1.0,32,900,700,200,0.7777777777777778,11,7,4,359.7369506661167,0.3631552419354838,0.00203201970443323,0.21105954041971567,131392.84256708485,3053.3721048872403,134446.2146719721,1232,46,624.84375,32,0,20,34.46633825944171,0.6432291666666667,43.68686868686868,1025.2525252525243,32.03914141414138,3
1240,4,0,0,32,0.0,0.0,1.0,32,900,700,200,0.7777777777777778,11,7,4,360.51846863041175,0.36349126344086025,-0.0007618197488301615,0.2118763388000147,131457.5760764207,3078.576803387402,134536.1528798081,1233,47,625.84375,32,0,20,34.38089961421654,0.6438802083333334,43.62373737373737,1025.50505050505,32.04703282828281,0
1241,4,0,0,32,0.0,0.0,1.0,32,750,600,150,0.8,9,6,3,360.06825320454277,0.36317624327956993,-0.0019043149082851318,0.21179105146853733,131489.94880943268,3069.0712363534317,134559.0200457861,1234,48,626.84375,32,0,21,34.35973983339488,0.6442057291666667,43.592171717171716,1025.631313131313,32.05097853535353,0
1242,4,0,0,32,0.0,0.0,1.0,32,600,500,100,0.8333333333333334,7,5,2,361.7769278106512,0.36372227822580644,-0.0006346153846150671,0.21315718190438993,131554.7062321445,3118.691491939579,134673.3977240841,1235,49,627.84375,32,0,19,34.250512820512824,0.6448567708333335,43.529040404040394,1025.883838383837,32.058869949494905,0
1243,4,0,0,32,0.0,0.0,1.0,32,1200,700,500,0.5833333333333334,17,7,10,372.64056170672427,0.3637432795698925,0.025877329192546483,0.20631062735482308,129137.21335833064,3224.352744617877,132361.5661029485,1236,50,628.84375,32,0,18,36.42753623188406,0.6204427083333335,45.896464646464636,1016.4141414141403,31.762941919191885,6
1244,4,1,0,33,0.030303030303030304,0.0,1.0,33,800,500,300,0.625,11,5,6,367.4497653103849,0.3689236111111111,0.027782337641492516,0.20554917174635484,129544.24267409177,2920.200313581323,132464.4429876731,1237,0,610.7575757575758,33,0,18,36.14459191043698,0.6221590909090908,45.49632352941177,1018.0147058823536,30.848930481283443,0
1245,4,1,0,34,0.029411764705882353,0.0,1.0,34,650,600,50,0.9230769230769231,7,6,1,359.84709245287985,0.37258615567439096,0.04086875291919667,0.2032803759740412,129928.59977324268,2550.8857709750596,132479.48554421775,1238,0,593.7647058823529,34,0,19,35.94723065545695,0.6237745098039216,45.11904761904762,1019.5238095238099,29.985994397759114,0
1246,4,1,1,34,0.02857142857142857,0.02857142857142857,0.9714285714285714,35,700,400,300,0.5714285714285714,10,4,6,353.52998384655933,0.3767156862745098,0.041287479953995954,0.2012770127529249,130233.05047850226,2208.25764639061,132441.30812489288,1239,0,577.7714285714286,35,0,19,35.7992450013229,0.6247023809523808,44.820601851851855,1020.7175925925928,29.163359788359795,0
1247,4,0,0,34,0.0,0.0,1.0,34,1150,800,350,0.6956521739130435,15,8,7,362.1490396201781,0.37247474747474746,0.051891001441416895,0.20553756751953145,130110.72137188204,2623.8945578231287,132734.61592970518,1240,2,595.7647058823529,34,0,19,35.7035200311163,0.6256127450980392,44.94047619047619,1020.238095238095,30.00700280112044,0
1248,4,0,0,34,0.0,0.0,1.0,34,1150,900,250,0.782608695652174,14,9,5,365.0911211781577,0.371694890077243,0.056415989903424224,0.20817961803350263,130292.97052154192,2713.7613378684755,133006.73185941039,1241,3,596.7647058823529,34,0,19,35.44338852611939,0.6274509803921569,44.76190476190476,1020.9523809523807,30.028011204481786,0
1249,4,1,1,34,0.02857142857142857,0.02857142857142857,0.9714285714285714,35,1100,900,200,0.8181818181818182,13,9,4,356.43205244041997,0.37580532212885154,0.052179821084815226,0.204791896883627,130587.70743580669,2309.1289169667293,132896.83635277342,1242,0,580.6857142857143,35,0,17,35.36559185445212,0.6282738095238095,44.473379629629626,1022.106481481481,29.20304232804231,0
1250,4,1,1,34,0.02857142857142857,0.02857142857142857,0.9714285714285714,35,650,400,250,0.6153846153846154,9,4,5,355.87468040274297,0.3772408963585434,0.045636672325976235,0.20509803009512284,130706.03358892744,2302.9935860339456,133009.02717496137,1243,0,581.6571428571428,35,0,17,35.259974533106956,0.6294642857142857,44.357638888888886,1022.5694444444442,29.216269841269835,0
1251,4,0,1,33,0.0,0.029411764705882353,0.9705882352941176,34,750,600,150,0.8,9,6,3,389.8569307363089,0.37175059417706474,0.03493128092358444,0.21153494720479235,128336.36435376493,3264.4948737692616,131600.8592275342,1244,6,599.7647058823529,32,2,18,36.80996884735203,0.6123046875,46.68560606060606,1013.2575757575759,31.664299242424246,5
1252,4,1,0,34,0.029411764705882353,0.0,1.0,34,900,700,200,0.7777777777777778,11,7,4,385.0853433874066,0.36883541295306,0.05356515116006566,0.2101226547613892,128560.35098459339,3101.34138098153,131661.6923655749,1245,0,600.5294117647059,32,2,16,36.701371596945556,0.6145833333333334,46.464646464646464,1014.141414141414,31.691919191919187,0
1253,4,0,0,34,0.0,0.0,1.0,34,700,500,200,0.7142857142857143,9,5,4,382.21690018510003,0.369281045751634,0.053810846720618644,0.20914565212375708,128672.41753472229,3036.154513888899,131708.57204861118,1246,1,601.5294117647059,33,1,16,36.65939425051335,0.6133207070707071,46.35416666666667,1014.5833333333339,30.744949494949513,0
1254,4,1,1,34,0.02857142857142857,0.02857142857142857,0.9714285714285714,35,850,600,250,0.7058823529411765,11,6,5,369.61764319290404,0.37804621848739495,0.04810444388651791,0.2041868339580218,129050.14349489802,2539.8419784580583,131589.98547335606,1247,0,585.3142857142857,34,1,16,36.59319468853739,0.6148897058823529,45.98214285714286,1016.071428571429,29.88445378151262,0
1255,4,1,0,35,0.02857142857142857,0.0,1.0,35,600,400,200,0.6666666666666666,8,4,4,372.90083925475244,0.37443977591036415,0.07318803153944153,0.2071172131282422,129263.6921496541,2640.596434652309,131904.2885843064,1248,0,586.2857142857143,33,2,17,36.29187756085804,0.6193181818181817,45.77205882352942,1016.9117647058833,30.815508021390404,0
1256,4,0,0,35,0.0,0.0,1.0,35,700,400,300,0.5714285714285714,10,4,6,372.8131965542403,0.3754201680672269,0.07413015796537858,0.20772450723444996,129388.34372597087,2647.5364042676024,132035.88013023848,1249,1,587.2857142857143,33,2,17,36.16698787440779,0.620580808080808,45.649509803921575,1017.4019607843145,30.83036244800953,0
1257,4,2,0,37,0.05405405405405406,0.0,1.0,37,650,300,350,0.46153846153846156,10,3,7,355.56594129997205,0.3863238238238238,0.08971218707392659,0.20169516983321562,130090.20580969503,1851.1292965262805,131941.33510622132,1250,0,556.4864864864865,36,1,17,35.89225264010009,0.6212384259259258,44.9605855855856,1020.1576576576593,28.337712712712758,0
1258,4,0,0,37,0.0,0.0,1.0,37,550,300,250,0.5454545454545454,8,3,5,357.3343368747752,0.3855730730730731,0.09041617207584984,0.20314703643407872,130176.3820408247,1903.2982306631045,132079.6802714878,1251,1,557.4864864864865,36,1,17,35.75967409696167,0.6221064814814814,44.87612612612613,1020.4954954954962,28.34709709709712,0
1259,4,1,1,37,0.02631578947368421,0.02631578947368421,0.9736842105263158,38,750,400,350,0.5333333333333333,11,4,7,351.26996480444103,0.3897433617828355,0.09316491073447608,0.20193017546104564,130607.69120049098,1575.740351838318,132183.4315523293,1252,0,543.7894736842105,36,2,17,35.477259373508126,0.6264467592592593,44.453828828828826,1022.1846846846843,28.39401901901901,0
1260,4,2,2,37,0.05128205128205128,0.05128205128205128,0.9487179487179487,39,1050,800,250,0.7619047619047619,13,8,5,344.09303276664065,0.3936965811965812,0.08714101189985457,0.1989087977517195,130822.85534972278,1203.0466104955144,132025.9019602183,1253,0,530.6153846153846,37,2,17,35.44301536262951,0.6266891891891893,44.24342105263157,1023.0263157894719,27.649359886201943,0
1261,4,0,0,37,0.0,0.0,1.0,37,1000,700,300,0.7,13,7,6,357.80216209829905,0.38698073073073075,0.10157168037602848,0.20573624320652167,130617.28395061711,1947.0293209876359,132564.31327160474,1254,2,560.2972972972973,35,2,17,35.300611413043484,0.6285714285714286,44.444444444444436,1022.2222222222208,29.206349206349167,0
1262,4,0,0,37,0.0,0.0,1.0,37,1050,800,250,0.7619047619047619,13,8,5,358.1991289083111,0.38654279279279274,0.10291377965401782,0.20643765844128636,130706.03358892715,1963.7574749228033,132669.79106384996,1255,3,561.2972972972973,35,2,17,35.20055178268252,0.6294642857142858,44.35763888888887,1022.5694444444418,29.216269841269767,0
1263,4,1,1,37,0.02631578947368421,0.02631578947368421,0.9736842105263158,38,1300,900,400,0.6923076923076923,17,9,8,347.5753288745429,0.3920845187292556,0.10015441752469889,0.2022433642591497,131075.36844269373,1511.7128587642164,132587.08130145795,1256,0,547.5,37,1,18,35.098667773137734,0.629222972972973,43.99671052631578,1024.0131578947353,27.676031294452304,0
1264,4,0,0,37,0.0,0.0,1.0,37,1100,800,300,0.7272727272727273,14,8,6,355.09889715125973,0.38626126126126126,0.11260864912426749,0.20642961463550197,131039.71370018648,1906.4115635905946,132946.12526377707,1257,5,563.2972972972973,36,1,18,34.94211944566651,0.6307870370370372,44.03153153153152,1023.8738738738723,28.440940940940898,0
1265,4,1,1,37,0.02631578947368421,0.02631578947368421,0.9736842105263158,38,800,500,300,0.625,11,5,6,347.7378817298078,0.39116583688952106,0.10792936658539443,0.20352573453528544,131300.02891514672,1531.5987852031083,132831.6277003498,1258,0,549.4473684210526,37,1,19,34.86758229021788,0.6314752252252254,43.77741228070174,1024.890350877191,27.699739212897054,0
1266,4,0,0,37,0.0,0.0,1.0,37,1300,800,500,0.6153846153846154,18,8,10,354.2955902118861,0.38744994994994997,0.1056546160403733,0.20704788537815988,131241.56832085448,1899.6617817141316,133141.2301025686,1259,7,565.2972972972973,36,1,19,34.758627321683704,0.6328125,43.83445945945945,1024.662162162161,28.462837837837803,0
1267,4,0,0,37,0.0,0.0,1.0,37,850,400,450,0.47058823529411764,13,4,9,355.27794302333285,0.387012012012012,0.10854757196220644,0.20809136662795202,131328.12499999997,1931.6257558233906,133259.75075582336,1260,8,566.2972972972973,35,2,20,34.64600271002711,0.6357142857142857,43.75,1024.9999999999998,29.285714285714278,0
1268,4,0,0,37,0.0,0.0,1.0,37,1050,900,150,0.8571428571428571,12,9,3,356.0170284251049,0.38663663663663667,0.1156232006221023,0.20915426198961332,131443.57829112894,1959.2304297540736,133402.808720883,1261,9,567.2972972972973,36,1,20,34.51044183322351,0.634837962962963,43.637387387387385,1025.4504504504503,28.48473473473473,0
1269,4,0,0,37,0.0,0.0,1.0,37,800,400,400,0.5,12,4,8,355.8142591883826,0.3867304804804805,0.11960846563986349,0.20950950788280387,131530.20154867697,1960.0642449882257,133490.2657936652,1262,10,568.2972972972973,36,1,20,34.42817543089253,0.6357060185185186,43.552927927927925,1025.7882882882877,28.494119119119105,0
1270,4,0,0,37,0.0,0.0,1.0,37,900,800,100,0.8888888888888888,10,8,2,355.74335388969257,0.3863863863863864,0.12094676171067342,0.20978496422582477,131587.96623904325,1962.3088882801865,133550.27512732343,1263,11,569.2972972972973,36,1,15,34.371684410785484,0.6362847222222221,43.49662162162163,1026.0135135135147,28.50037537537541,0
1271,4,0,0,37,0.0,0.0,1.0,37,850,500,350,0.5882352941176471,12,5,7,355.9655644158774,0.38641766766766766,0.11833406983193018,0.21023423127167148,131645.7436110097,1972.2702854881945,133618.0138964979,1264,12,570.2972972972973,36,1,15,34.307674018800974,0.6368634259259258,43.44031531531532,1026.2387387387391,28.50663163163164,0
1272,4,1,0,38,0.02631578947368421,0.0,1.0,38,1100,700,400,0.6363636363636364,15,7,8,363.4117165392123,0.3892543859649123,0.09515224478362683,0.20880213850083185,130587.70743580683,1895.706964608979,132483.41440041582,1265,0,556.2631578947369,35,3,19,35.187242856603625,0.6282738095238094,44.47337962962963,1022.1064814814821,29.203042328042347,6
1273,4,0,0,38,0.0,0.0,1.0,38,950,600,350,0.631578947368421,13,6,7,359.80811835139366,0.38919511616880037,0.07837981838398789,0.20854184818733823,130924.43795146485,1821.5351331060615,132745.9730845709,1266,1,557.2631578947369,36,2,19,34.93824273767605,0.6296296296296298,44.144144144144136,1023.4234234234224,28.4284284284284,1
1274,4,0,0,38,0.0,0.0,1.0,38,1150,1000,150,0.8695652173913043,13,10,3,361.4610647067442,0.3889432195353248,0.08141999293535829,0.20965664435989742,130953.25213304501,1866.9003885642176,132820.15252160924,1267,2,558.2631578947369,36,2,19,34.86678035720834,0.6299189814814816,44.11599099099098,1023.5360360360345,28.431556556556515,0
1275,4,2,2,38,0.05,0.05,0.95,40,900,700,200,0.7777777777777778,11,7,4,346.11100372415416,0.39497863247863246,0.07745991653854634,0.20333463225239648,131443.57829112888,1099.8853583312991,132543.46364946017,1268,0,531.3,36,4,19,34.76439527051762,0.634837962962963,43.637387387387385,1025.4504504504498,28.484734734734715,0
1276,4,0,0,38,0.0,0.0,1.0,38,1350,1100,250,0.8148148148148148,16,11,5,362.1642284893901,0.38811344238975815,0.08234388742304333,0.21116960399612109,131155.0401753103,1899.9327875172335,133054.97296282754,1269,4,560.2631578947369,36,2,19,34.64457820287306,0.6319444444444444,43.91891891891891,1024.3243243243232,28.453453453453424,0
1277,4,0,0,38,0.0,0.0,1.0,38,950,800,150,0.8421052631578947,11,8,3,362.66005766765943,0.38802453769559037,0.07450451805486469,0.21177671403468315,131212.72243527306,1917.122697021336,133129.8451322944,1270,5,561.2631578947369,36,2,19,34.57353264453725,0.6325231481481481,43.86261261261261,1024.549549549549,28.459709709709696,0
1278,4,0,0,38,0.0,0.0,1.0,38,800,400,400,0.5,12,4,8,364.65444581049894,0.38805417259364633,0.08712445302759875,0.21392398414986497,131389.14399092973,1982.428550309823,133371.57254123955,1271,6,562.2631578947369,34,4,20,34.344035454404704,0.6384803921568627,43.69047619047619,1025.2380952380954,30.154061624649867,0
1279,4,0,0,38,0.0,0.0,1.0,38,850,400,450,0.47058823529411764,13,4,9,367.0762807922179,0.3871947605500237,0.09147142377126816,0.2158608982269595,131480.6990504535,2052.6892006802686,133533.38825113376,1272,7,563.2631578947369,34,4,20,34.18939833623526,0.6393995098039216,43.601190476190474,1025.5952380952378,30.164565826330524,0
1280,4,0,0,38,0.0,0.0,1.0,38,300,100,200,0.3333333333333333,5,1,4,369.08037094791257,0.38716512565196776,0.09386891273675624,0.21738657255353133,131541.7534722223,2109.8958333333435,133651.64930555565,1273,8,564.2631578947369,34,4,20,34.076292986731644,0.6400122549019608,43.54166666666667,1025.8333333333342,30.171568627451006,0
1281,4,1,1,38,0.02564102564102564,0.02564102564102564,0.9743589743589743,39,700,400,300,0.5714285714285714,10,4,6,365.85653408744435,0.3922345928924876,0.09026380892927377,0.21697053278234008,131803.09070644728,1844.2043895747756,133647.29509602205,1274,0,550.7692307692307,35,4,18,33.89502554854225,0.6404761904761904,43.287037037037045,1026.8518518518526,29.33862433862436,0
1282,4,0,0,38,0.0,0.0,1.0,38,600,200,400,0.3333333333333333,10,2,8,372.8718852483564,0.38645388809862496,0.10361823031427564,0.2206777121823324,131725.00177154221,2223.3099489796255,133948.31172052183,1275,10,566.2631578947369,34,4,18,33.79382658780781,0.6418504901960782,43.363095238095255,1026.547619047621,30.192577030812384,0
1283,4,1,1,38,0.02564102564102564,0.02564102564102564,0.9743589743589743,39,1150,1000,150,0.8695652173913043,13,10,3,367.6565930531557,0.3909412955465587,0.0994228531668011,0.21958024229354936,132070.63567654768,1911.327991040831,133981.9636675885,1276,0,552.7179487179487,35,4,19,33.57882464437186,0.6431547619047618,43.02662037037038,1027.89351851852,29.368386243386286,0
1284,4,0,0,38,0.0,0.0,1.0,38,1500,1200,300,0.8,18,12,6,379.0134638874582,0.3866613323850166,0.10421735604217353,0.2257601937068774,131969.53125000012,2403.6458333333476,134373.17708333346,1277,12,568.2631578947369,34,4,19,33.38909164639092,0.6443014705882353,43.12500000000001,1027.500000000001,30.220588235294144,0
1285,4,1,0,39,0.02564102564102564,0.0,1.0,39,900,800,100,0.8888888888888888,10,8,2,371.6442482564427,0.3905476833108412,0.10768884502848008,0.2228360856954624,132219.3889853396,2027.7150848765548,134247.10407021616,1278,0,554.6666666666666,35,4,20,33.32629979743416,0.6446428571428571,42.88194444444445,1028.472222222223,29.38492063492066,0
1286,4,0,1,38,0.0,0.02564102564102564,0.9743589743589743,39,1150,900,250,0.782608695652174,14,9,5,384.6223011482216,0.39108187134502925,0.05080172352899637,0.22077466052625608,130550.14209733374,2248.4068140494,132798.54891138314,1279,1,555.6666666666666,36,3,15,34.68342516069788,0.6258680555555556,44.51013513513513,1021.9594594594588,28.387762762762744,7
1287,4,2,2,38,0.05,0.05,0.95,40,450,300,150,0.6666666666666666,6,3,3,374.36916373481563,0.39461805555555557,0.05625066981031046,0.21656780327399636,130850.90033712286,1797.3084266312674,132648.20876375414,1280,0,542.0,37,3,16,34.64024488264925,0.6269707207207207,44.21600877192982,1023.1359649122799,27.652323376007566,0
1288,4,0,0,38,0.0,0.0,1.0,38,1100,800,300,0.7272727272727273,14,8,6,391.5682368674541,0.3860389995258416,0.06312033907398429,0.22463651483448674,130528.56445312491,2622.1679687499864,133150.7324218749,1281,3,571.5263157894736,35,3,16,34.52790519877675,0.6276785714285715,44.53124999999999,1021.8749999999993,29.19642857142855,0
1289,4,1,1,38,0.02564102564102564,0.02564102564102564,0.9743589743589743,39,700,400,300,0.5714285714285714,10,4,6,382.92229796457093,0.39122244714349974,0.061698806166492925,0.22111145787744424,130780.41459956575,2215.7473774450054,132996.16197701075,1282,0,557.8461538461538,36,3,16,34.493008917758445,0.6281828703703705,44.284909909909906,1022.8603603603601,28.41278778778778,0
1290,4,0,0,38,0.0,0.0,1.0,38,1150,900,250,0.782608695652174,14,9,5,389.0393685109988,0.3842757230915126,0.06254689677350211,0.22472744698694128,130794.81336805534,2576.86631944442,133371.67968749977,1283,5,573.5263157894736,35,3,17,34.32196198234893,0.6303571428571428,44.27083333333332,1022.9166666666649,29.226190476190425,0
1291,4,0,0,38,0.0,0.0,1.0,38,1300,1000,300,0.7692307692307693,16,10,6,387.9797269702399,0.38506104788999523,0.06830635911813454,0.22453399995233092,130866.81909950469,2554.7345487379052,133421.55364824258,1284,6,574.5263157894736,36,2,17,34.275946511116,0.629050925925926,44.20045045045044,1023.1981981981965,28.422172172172125,0
1292,4,1,1,38,0.02564102564102564,0.02564102564102564,0.9743589743589743,39,1150,700,450,0.6086956521739131,16,7,9,381.3475925611032,0.38838281601439495,0.07043664682033146,0.22221883107381543,131131.51552641173,2201.337550977195,133332.85307738892,1285,0,560.7692307692307,37,2,17,34.177171430610564,0.6297860360360361,43.94188596491227,1024.232456140349,27.68195827406349,0
1293,4,0,0,38,0.0,0.0,1.0,38,1000,900,100,0.9,11,9,2,390.10343256989603,0.38402382645803695,0.06902758325327274,0.22711911752820937,131097.3705969481,2628.3068541514303,133725.67745109953,1286,8,576.5263157894736,36,2,18,33.98761087896783,0.6313657407407408,43.975225225225216,1024.0990990990977,28.447197197197156,0
1294,4,1,0,39,0.02564102564102564,0.0,1.0,39,1050,700,350,0.6666666666666666,14,7,7,382.0768515983967,0.38984480431848856,0.07031528128717435,0.2243087361371895,131417.1157648531,2242.6933787320213,133659.80914358512,1287,0,562.7179487179487,35,4,19,33.86915848289873,0.6366071428571429,43.66319444444443,1025.3472222222201,29.29563492063486,0
1295,4,0,0,39,0.0,0.0,1.0,39,1100,800,300,0.7272727272727273,14,8,6,386.8277976757971,0.3899291497975708,0.07231550175712664,0.22815891060518562,131595.1877170138,2380.935329861102,133976.12304687488,1288,1,563.7179487179487,35,4,16,33.56704737732657,0.6383928571428572,43.48958333333333,1026.0416666666658,29.315476190476165,0
1296,4,0,1,38,0.0,0.02564102564102564,0.9743589743589743,39,850,500,350,0.5882352941176471,12,5,7,384.2672658109439,0.39023841655420605,0.06604147328180288,0.22700185515960308,131654.57182623894,2318.1084694358847,133972.68029567483,1289,2,564.7179487179487,35,4,16,33.57263354761101,0.6389880952380952,43.43171296296297,1026.273148148149,29.32208994708997,0
1297,4,0,1,37,0.0,0.02631578947368421,0.9736842105263158,38,750,400,350,0.5333333333333333,11,4,7,395.8060148509094,0.3836089378852537,0.07253335288080964,0.23294157267455148,131511.22448979586,2810.586734693875,134321.81122448973,1290,12,580.5263157894736,34,4,18,33.42183147632313,0.6397058823529411,43.57142857142857,1025.714285714285,30.168067226890738,0
1298,4,3,2,38,0.075,0.05,0.95,40,1000,800,200,0.8,12,8,4,369.93103322861765,0.39590010683760685,0.07484008528784614,0.22186400841972076,132228.78674207447,1783.106340412428,134011.8930824869,1291,0,549.4,37,3,17,33.36087420042642,0.6407657657657657,42.872807017543856,1028.5087719298244,27.797534376481742,0
1299,4,0,0,38,0.0,0.0,1.0,38,700,500,200,0.7142857142857143,9,5,4,386.98289612930836,0.38618717401612135,0.0855396544978122,0.2305794732775839,131981.42387902955,2614.910729595346,134596.3346086249,1292,1,579.3157894736842,35,3,17,33.17235488473381,0.6422619047619047,43.11342592592593,1027.5462962962968,29.35846560846562,0
1300,4,0,0,38,0.0,0.0,1.0,38,1050,600,450,0.5714285714285714,15,6,9,391.0923053392173,0.38498696064485544,0.08801258465312278,0.23394430628473195,132130.1269531251,2735.0151909722376,134865.14214409734,1293,2,580.3157894736842,35,3,17,32.916455589327946,0.6437499999999999,42.96875000000001,1028.1250000000007,29.375000000000018,0
1301,4,1,0,39,0.02564102564102564,0.0,1.0,39,1100,800,300,0.7272727272727273,14,8,6,381.5556711920582,0.38874831309041835,0.08674961137206694,0.22968746530652384,132369.0307706357,2301.2308761464415,134670.26164678214,1294,0,566.4102564102565,36,3,18,32.92045122929891,0.6440972222222221,42.7364864864865,1029.0540540540558,28.584834834834883,0
1302,4,1,0,40,0.025,0.0,1.0,40,900,800,100,0.8888888888888888,10,8,2,357.5602577933158,0.39208066239316236,0.11607103463489965,0.20387681114177392,130291.32806793296,1321.9782282282476,131613.3062961612,1295,0,553.225,36,4,20,35.63727112287668,0.6232638888888888,44.76351351351352,1020.9459459459472,28.359609609609645,7
1303,4,1,2,39,0.024390243902439025,0.04878048780487805,0.9512195121951219,41,900,600,300,0.6666666666666666,12,6,6,347.3545427391888,0.39509654471544714,0.11675501436413227,0.19963249367538338,130598.60365689447,872.8036511234277,131471.4073080179,1296,0,540.7073170731708,37,4,14,35.58651576914825,0.6244369369369369,44.46271929824562,1022.1491228070179,27.62565196775724,0
1304,4,1,1,39,0.025,0.025,0.975,40,1300,1000,300,0.7692307692307693,16,10,6,348.1373574379683,0.39256143162393164,0.11364412380218081,0.20042733469748344,130665.25298524876,1097.891176649621,131763.14416189838,1297,0,540.925,36,4,15,35.499045416161835,0.627025462962963,44.39752252252252,1022.40990990991,28.400275275275277,0
1305,4,0,0,39,0.0,0.0,1.0,39,1100,900,200,0.8181818181818182,13,9,4,350.21572905924796,0.389198155645524,0.11031968559702343,0.2016822523148238,130676.44702717767,1352.9894332990443,132029.43646047672,1298,3,555.7948717948718,35,4,16,35.43458984227606,0.6291666666666667,44.386574074074076,1022.4537037037039,29.21296296296297,0
1306,4,0,1,38,0.0,0.02564102564102564,0.9743589743589743,39,950,800,150,0.8421052631578947,11,8,3,347.7435255273431,0.38936684660368875,0.10474908041791253,0.20079812093864327,130780.41459956583,1295.6084885561313,132076.02308812196,1299,4,556.7948717948718,36,3,16,35.392583214062896,0.6281828703703705,44.28490990990991,1022.8603603603608,28.4127877877878,0
1307,4,0,0,38,0.0,0.0,1.0,38,1550,1200,350,0.7741935483870968,19,12,7,357.4091266716402,0.3862908961593172,0.11289804082653188,0.206932160373541,130883.62328800155,1755.8002989969164,132639.42358699845,1300,5,571.2105263157895,35,3,18,35.04093145571768,0.6312499999999999,44.18402777777778,1023.2638888888889,29.23611111111111,0
1308,4,1,0,39,0.02564102564102564,0.0,1.0,39,850,400,450,0.47058823529411764,13,4,9,348.72956721844884,0.3904071075123707,0.12780187253280229,0.20410615308646476,131300.0289151471,1357.6404518698198,132657.6693670169,1301,0,557.5384615384615,37,2,20,34.84217306800757,0.6314752252252251,43.77741228070176,1024.890350877194,27.699739212897132,0
1309,4,0,0,39,0.0,0.0,1.0,39,900,500,400,0.5555555555555556,13,5,8,345.1703722114944,0.39023841655420605,0.12314177110383517,0.20232786146109896,131357.7852393047,1268.1691362507358,132625.95437555545,1302,1,558.5384615384615,35,4,20,34.87507527003125,0.6360119047619047,43.72106481481482,1025.1157407407409,29.289021164021168,0
1310,4,0,0,39,0.0,0.0,1.0,39,800,500,300,0.625,11,5,6,346.73824904884697,0.3898166891587944,0.1305235006555694,0.20356223646943286,131417.11576485363,1313.4681230710144,132730.58388792464,1303,2,559.5384615384615,35,4,20,34.775016931933635,0.6366071428571427,43.66319444444446,1025.3472222222242,29.295634920634978,0
1311,4,0,1,38,0.0,0.02564102564102564,0.9743589743589743,39,1150,800,350,0.6956521739130435,15,8,7,347.51772471946674,0.3890856950067476,0.13417569193742485,0.20481363776019681,131565.50068587135,1344.2686899863131,132909.76937585766,1304,3,560.5384615384615,35,4,15,34.60533243080627,0.6380952380952379,43.51851851851853,1025.9259259259281,29.312169312169374,0
1312,4,0,0,38,0.0,0.0,1.0,38,1050,800,250,0.7619047619047619,13,8,5,347.95770429293947,0.3898322664770033,0.12982639334151602,0.20527361076665632,131602.8220663266,1558.4431689342496,133161.26523526086,1305,4,564.3684210526316,34,4,16,34.55640638898557,0.640625,43.48214285714286,1026.0714285714291,30.178571428571445,0
1313,4,0,0,38,0.0,0.0,1.0,38,1100,800,300,0.7272727272727273,14,8,6,348.572631758763,0.3896248221906116,0.12457035757239021,0.20596604923867717,131663.90483276665,1578.8867630385705,133242.79159580523,1306,5,565.3684210526316,34,4,16,34.47903375478482,0.6412377450980391,43.42261904761906,1026.3095238095254,30.185574229691923,0
1314,4,0,0,38,0.0,0.0,1.0,38,850,400,450,0.47058823529411764,13,4,9,352.0609979390233,0.38913584637268844,0.13533660298172334,0.20919988224641148,131877.80612244902,1685.8064058956948,133563.6125283447,1307,6,566.3684210526316,34,4,19,34.17386223149435,0.6433823529411764,43.214285714285715,1027.1428571428576,30.21008403361346,0
1315,4,0,0,38,0.0,0.0,1.0,38,700,200,500,0.2857142857142857,12,2,10,343.9455723855317,0.3891802987197724,0.07672135146673176,0.20470691653014747,131938.95266439908,1475.9637188208628,133414.91638321994,1308,7,567.3684210526316,34,4,17,34.32068366164543,0.6439950980392157,43.154761904761905,1027.3809523809523,30.21708683473389,2
1316,4,0,1,37,0.0,0.02631578947368421,0.9736842105263158,38,1350,1000,350,0.7407407407407407,17,10,7,347.50709884128537,0.38857278330962547,0.07952640721665172,0.20766254660861577,132091.8810232426,1580.5732709750541,133672.45429421766,1309,8,568.3684210526316,34,4,17,34.07522679019495,0.6455269607843137,43.00595238095238,1027.9761904761904,30.234593837535012,0
1317,4,0,0,37,0.0,0.0,1.0,37,1200,800,400,0.6666666666666666,16,8,8,355.6369639007051,0.38522897897897895,0.08690942851248185,0.21176564668632872,131956.93963860036,1985.7530757400775,133942.69271434043,1310,9,584.3513513513514,33,4,18,34.002266221374036,0.6464646464646466,43.13725490196077,1027.4509803921555,31.134878193701685,0
1318,4,0,0,37,0.0,0.0,1.0,37,1000,600,400,0.6,14,6,8,353.57954375141395,0.3852915415415415,0.09009868442255775,0.21089033100279894,132019.90370290255,1935.9074634755616,133955.81116637812,1311,10,585.3513513513514,33,4,18,33.99167262898481,0.6470959595959597,43.07598039215685,1027.696078431371,31.142305407011243,0
1319,4,0,0,37,0.0,0.0,1.0,37,1050,600,450,0.5714285714285714,15,6,9,352.7009677564409,0.3846033533533533,0.08785797840286946,0.21054113996962742,132051.39136690192,1914.9307057381511,133966.32207264006,1312,11,586.3513513513514,33,4,18,33.98252752275347,0.6474116161616162,43.04534313725489,1027.8186274509787,31.146019013666024,0
1320,4,1,1,37,0.02631578947368421,0.02631578947368421,0.9736842105263158,38,700,400,300,0.5714285714285714,10,4,6,356.36060842940594,0.38873577524893316,0.04520981888526432,0.21631217581704085,132681.93310565644,1927.8971729623163,134609.83027861876,1313,0,571.8947368421053,33,5,17,33.25391043178303,0.6537247474747474,42.432598039215684,1030.269607843137,31.220291146761728,3
1321,4,0,1,36,0.0,0.02702702702702703,0.972972972972973,37,450,300,150,0.6666666666666666,6,3,3,366.57315102356563,0.38325825825825827,0.04341557989626632,0.2216014860338904,132527.9806429192,2316.239892613011,134844.2205355322,1314,13,588.3513513513514,32,5,21,33.14582055998364,0.6546223958333333,42.58207070707071,1029.671717171718,32.17724116161619,0
1322,4,1,0,37,0.02702702702702703,0.0,1.0,37,1150,1000,150,0.8695652173913043,13,10,3,360.274911951544,0.38247622622622623,0.0661374811196449,0.21924110054359505,132776.64389898113,2167.218737985381,134943.8626369665,1315,0,588.972972972973,33,4,18,33.05786761791517,0.6546717171717171,42.3406862745098,1030.6372549019604,31.231431966726074,0
1323,4,0,0,37,0.0,0.0,1.0,37,800,600,200,0.75,10,6,4,360.5013545837583,0.38294544544544545,0.0684975954202156,0.21993458274932265,132871.3884833958,2180.063106737795,135051.4515901336,1316,1,589.972972972973,33,4,19,32.95680791631999,0.6556186868686869,42.24877450980392,1031.0049019607843,31.242572786690435,0
1324,4,0,0,37,0.0,0.0,1.0,37,650,300,350,0.46153846153846156,10,3,7,359.18783797571666,0.3829767267267267,0.06868686868686869,0.21950367876293808,132934.57031250012,2149.6961805555693,135084.26649305568,1317,2,590.972972972973,33,4,19,32.927188552188554,0.65625,42.18750000000001,1031.250000000001,31.25000000000003,0
1325,4,0,0,37,0.0,0.0,1.0,37,1050,800,250,0.7619047619047619,13,8,5,357.23278187262395,0.3818506006006006,0.07697064493834316,0.21935864209203249,133113.66705246904,2110.5131172839433,135224.18016975297,1318,3,591.972972972973,35,2,20,32.79777927321669,0.6535714285714285,42.013888888888886,1031.944444444444,29.48412698412697,0
1326,4,0,0,37,0.0,0.0,1.0,37,300,100,200,0.3333333333333333,5,1,4,357.23278187262395,0.3818506006006006,0.07697064493834316,0.21935864209203249,133113.66705246904,2110.5131172839433,135224.18016975297,1319,4,592.972972972973,35,2,20,32.79777927321669,0.6535714285714285,42.013888888888886,1031.944444444444,29.48412698412697,0
1327,4,1,1,37,0.02631578947368421,0.02631578947368421,0.9736842105263158,38,800,400,400,0.5,12,4,8,349.7083800458834,0.38605381697486957,0.08076007457335455,0.21664918210134915,133443.1322158307,1733.2363190893593,135176.36853492007,1320,0,578.3421052631579,36,2,20,32.66167120799274,0.6548032407407407,41.69481981981982,1033.2207207207207,28.700575575575574,0
1328,4,0,0,37,0.0,0.0,1.0,37,650,300,350,0.46153846153846156,10,3,7,358.12752982956243,0.3810372872872873,0.08131125298314923,0.2213247975207072,133352.6502486281,2151.4510459533412,135504.10129458146,1321,6,594.972972972973,35,2,20,32.53492454803526,0.6559523809523811,41.7824074074074,1032.870370370369,29.510582010581974,0
1329,4,0,0,37,0.0,0.0,1.0,37,1050,700,350,0.6666666666666666,14,7,7,360.6034404122568,0.38100600600600604,0.09632043997038697,0.22376518123595027,133503.88259623706,2228.499041871963,135732.38163810901,1322,7,595.972972972973,33,4,20,32.31933574449584,0.6619318181818181,41.63602941176471,1033.4558823529414,31.316844919786103,0
1330,4,0,0,37,0.0,0.0,1.0,37,700,300,400,0.42857142857142855,11,3,8,359.4661087927124,0.38031781781781787,0.09852339386018127,0.2237966419257857,133626.0363520409,2206.806264172343,135832.84261621322,1323,8,596.972972972973,34,3,20,32.226300134331225,0.660845588235294,41.517857142857146,1033.928571428572,30.409663865546236,0
1331,4,0,0,37,0.0,0.0,1.0,37,1400,1000,400,0.7142857142857143,18,10,8,358.02123299467695,0.378785035035035,0.09648378098498922,0.22401458142237143,133810.73022959195,2181.4165249433286,135992.1467545353,1324,9,597.972972972973,34,3,18,32.078682928700196,0.6626838235294117,41.33928571428572,1034.642857142858,30.43067226890759,0
1332,4,0,0,37,0.0,0.0,1.0,37,1200,800,400,0.6666666666666666,16,8,8,354.722195656792,0.377784034034034,0.09105149307541205,0.22288036224215765,133964.73922902494,2104.0532879818593,136068.7925170068,1325,10,598.972972972973,34,3,18,32.00992793621589,0.6642156862745099,41.19047619047619,1035.2380952380952,30.448179271708682,0
1333,4,0,0,37,0.0,0.0,1.0,37,650,500,150,0.7692307692307693,8,5,3,354.42888866307766,0.3768768768768769,0.09780174381944273,0.22363203482650063,134118.83680555577,2107.118055555581,136225.95486111136,1326,11,599.972972972973,34,3,18,31.863435237329043,0.6657475490196078,41.04166666666668,1035.833333333335,30.465686274509856,0
1334,4,0,0,37,0.0,0.0,1.0,37,750,600,150,0.8,9,6,3,353.468830041648,0.3762825325325325,0.10263003437770735,0.22340154160148623,134180.5006377553,2085.724914966011,136266.2255527213,1327,12,600.972972972973,34,3,18,31.826668964724792,0.666360294117647,40.98214285714287,1036.0714285714303,30.472689075630303,0
1335,4,0,0,37,0.0,0.0,1.0,37,800,500,300,0.625,11,5,6,356.4107070226314,0.3758133133133133,0.10511449368081816,0.22606333513418472,134310.7263803156,2173.956189986297,136484.6825703019,1328,13,601.972972972973,35,2,19,31.62032901592973,0.6654761904761903,40.85648148148149,1036.5740740740748,29.61640211640214,0
1336,4,0,0,37,0.0,0.0,1.0,37,400,100,300,0.25,7,1,6,354.07950741663643,0.37609484484484484,0.09781180889049335,0.2162093441792193,132904.7325772674,2011.9827835647832,134916.71536083217,1329,14,602.972972972973,35,2,17,33.08884742021176,0.6514880952380955,42.21643518518517,1031.134259259257,29.460978835978775,2
1337,4,0,0,37,0.0,0.0,1.0,37,650,500,150,0.7692307692307693,8,5,3,353.6232187694403,0.37609484484484484,0.09605026929982086,0.2164484976423936,132994.2558299039,2005.9713648833954,135000.2271947873,1330,15,603.972972972973,35,2,18,33.01073459006584,0.6523809523809524,42.129629629629626,1031.4814814814808,29.470899470899454,0
1338,4,1,0,38,0.02631578947368421,0.0,1.0,38,1350,1000,350,0.7407407407407407,17,10,7,347.78908637353396,0.37823020388809864,0.1023997521059512,0.2149542789904348,133355.88121905684,1675.9440183426536,135031.8252373995,1331,0,589.0526315789474,36,2,19,32.79864442506177,0.6539351851851853,41.77927927927927,1032.8828828828823,28.691191191191177,0
1339,4,0,0,38,0.0,0.0,1.0,38,1100,800,300,0.7272727272727273,14,8,6,347.842683356553,0.3776078710289237,0.09765427005363292,0.21601079015118363,133532.02830289784,1689.6785341867171,135221.70683708455,1332,1,590.0526315789474,35,3,20,32.62084733109369,0.6577380952380951,41.6087962962963,1033.5648148148152,29.530423280423292,0
1340,4,0,0,38,0.0,0.0,1.0,38,750,500,250,0.6666666666666666,10,5,5,346.7287997145773,0.3772226173541963,0.09407924199212725,0.21566724505923426,133591.84777949244,1664.0282064471835,135255.87598593964,1333,2,591.0526315789474,35,3,21,32.589752201821156,0.6583333333333334,41.550925925925924,1033.796296296296,29.53703703703703,0
1341,4,0,0,38,0.0,0.0,1.0,38,1300,1000,300,0.7692307692307693,16,10,6,346.8079451980603,0.3769262683736368,0.09218627560729886,0.2158909668609248,133621.76254125938,1668.2177801354585,135289.98032139483,1334,3,592.0526315789474,35,3,21,32.55776801373186,0.6586309523809524,41.52199074074074,1033.9120370370367,29.540343915343907,0
1342,4,0,0,38,0.0,0.0,1.0,38,500,200,300,0.4,8,2,6,346.8079451980603,0.3769262683736368,0.09218627560729886,0.2158909668609248,133621.76254125938,1668.2177801354585,135289.98032139483,1335,4,593.0526315789474,35,3,21,32.55776801373186,0.6586309523809524,41.52199074074074,1033.9120370370367,29.540343915343907,0
1343,4,0,1,37,0.0,0.02631578947368421,0.9736842105263158,38,800,400,400,0.5,12,4,8,345.86171030832503,0.37652619724988146,0.07932783766645524,0.20692774673099654,132137.36329234645,1540.2508927846836,133677.61418513113,1336,5,594.0526315789474,36,2,19,34.071741511500555,0.6417824074074074,42.961711711711715,1028.1531531531534,28.559809809809817,3
1344,4,0,0,37,0.0,0.0,1.0,37,950,600,350,0.631578947368421,13,6,7,353.5253712650272,0.3743743743743744,0.08816270385913438,0.21114047223972462,132070.63567654742,1938.0641021519136,134008.69977869935,1337,22,610.972972972973,35,2,19,33.94195942649102,0.643154761904762,43.02662037037037,1027.893518518518,29.36838624338623,0
1345,4,0,0,37,0.0,0.0,1.0,37,1000,600,400,0.6,14,6,8,354.63045939667563,0.37378003003003,0.08757085352830041,0.2121334929845568,132130.126953125,1971.4735243055572,134101.60047743056,1338,23,611.972972972973,35,2,19,33.853638973319825,0.64375,42.96875,1028.125,29.375,0
1346,4,0,0,37,0.0,0.0,1.0,37,1450,1100,350,0.7586206896551724,18,11,7,358.4584997780299,0.371559059059059,0.0956162734945929,0.21613014642036385,132429.53619100805,2094.641108588018,134524.17729959608,1339,24,612.972972972973,33,4,21,33.4537593761162,0.651199494949495,42.67769607843136,1029.2892156862729,31.19058229352342,0
1347,4,0,0,37,0.0,0.0,1.0,37,1250,700,550,0.56,18,7,11,356.6975174579842,0.3709021521521521,0.09426652085611642,0.2157645822385706,132551.19756235805,2056.1366213151664,134607.33418367323,1340,25,613.972972972973,34,3,21,33.376685934489394,0.6501225490196079,42.559523809523796,1029.761904761903,30.287114845938323,0
1348,4,0,0,37,0.0,0.0,1.0,37,1050,800,250,0.7619047619047619,13,8,5,357.6595841387853,0.37012012012012013,0.09881385892479022,0.21705371957482755,132673.81660997702,2090.412414965943,134764.22902494296,1341,26,614.972972972973,34,3,17,33.22861297280639,0.6513480392156865,42.44047619047617,1030.2380952380927,30.301120448179198,0
1349,4,0,0,37,0.0,0.0,1.0,37,750,400,350,0.5333333333333333,11,4,7,357.6304724297242,0.3699637137137137,0.09661654722313284,0.21721345535994793,132704.48022959157,2091.833191609948,134796.3134212015,1342,27,615.972972972973,34,3,18,33.19853649143076,0.6516544117647061,42.41071428571427,1030.3571428571408,30.304621848739437,0
1350,4,0,0,37,0.0,0.0,1.0,37,1300,1000,300,0.7692307692307693,16,10,6,359.7703880584475,0.3690878378378379,0.09304386353566674,0.21976947118210644,132919.22477324243,2164.0802154194803,135083.3049886619,1343,28,616.972972972973,34,3,18,32.92758600785038,0.6537990196078433,42.20238095238094,1031.1904761904748,30.329131652661022,0
1351,4,0,0,37,0.0,0.0,1.0,37,1050,700,350,0.6666666666666666,14,7,7,367.72672924620383,0.3695257757757758,0.10735140179843894,0.20902874821607823,130171.45691609975,2174.652777777774,132346.10969387752,1344,29,617.972972972973,34,3,22,35.49954308601651,0.6262254901960784,44.88095238095238,1020.4761904761903,30.01400560224089,6
1352,4,1,0,38,0.02631578947368421,0.0,1.0,38,1050,600,450,0.5714285714285714,15,6,9,357.51187820311236,0.37483700806069226,0.1080953650653258,0.2050562459459808,130520.50053884815,1732.6215215960967,132253.12206044424,1345,0,602.6842105263158,32,6,19,35.4061122781004,0.6344401041666666,44.53914141414142,1021.843434343435,31.932607323232343,0
1353,4,1,0,39,0.02564102564102564,0.0,1.0,39,700,600,100,0.8571428571428571,8,6,2,360.7978964794413,0.3779520917678812,0.1396020801765272,0.20895924061878157,130895.6269402849,1645.3733716824959,132541.0003119674,1346,0,588.2051282051282,36,3,16,34.94208759766701,0.6293402777777778,44.1722972972973,1023.310810810811,28.425300300300304,4
1354,4,0,0,39,0.0,0.0,1.0,39,800,500,300,0.625,11,5,6,362.08683122716695,0.37741790373369316,0.1407196184448416,0.21033427365406862,131010.89000740601,1687.4636038065064,132698.35361121251,1347,1,589.2051282051282,36,3,17,34.79242290910425,0.6304976851851851,44.05968468468468,1023.7612612612609,28.4378128128128,0
1355,4,0,0,39,0.0,0.0,1.0,39,1550,1500,50,0.967741935483871,16,15,1,360.82791887715604,0.37693994601889336,0.14011969472354902,0.2101080275756006,131103.4404816865,1661.1563173283928,132764.5967990149,1348,2,590.2051282051282,37,2,17,34.73099571734476,0.6295045045045047,43.96929824561403,1024.1228070175425,27.678994784257906,0
1356,4,0,0,39,0.0,0.0,1.0,39,750,400,350,0.5333333333333333,11,4,7,360.8264218004388,0.37679937022042287,0.13729930633902399,0.21026073649643764,131131.51552641182,1663.1431065327645,132794.6586329446,1349,3,591.2051282051282,37,2,18,34.702632658887346,0.6297860360360361,43.941885964912274,1024.2324561403498,27.681958274063508,0
1357,4,1,1,39,0.025,0.025,0.975,40,1200,900,300,0.75,15,9,6,350.8966136636298,0.38059561965811967,0.12724003513780602,0.20630183735536958,131472.44953991144,1226.942028511713,132699.39156842316,1350,0,577.4,36,4,18,34.61256908605101,0.6351273148148149,43.60923423423423,1025.5630630630624,28.487862862862844,0
1358,4,1,1,39,0.025,0.025,0.975,40,1400,900,500,0.6428571428571429,19,9,10,349.8408913824863,0.3786858974358975,0.12072740867336029,0.20702973610131717,131721.7857898584,1216.3333910433976,132938.1191809018,1351,0,578.375,37,3,15,34.388129317097494,0.6356981981981982,43.36622807017544,1026.5350877192982,27.744191559981033,0
1359,4,0,0,39,0.0,0.0,1.0,39,1000,600,400,0.6,14,6,8,355.7433538896929,0.3764901034637877,0.12168441078549752,0.20978496422582485,131587.9662390432,1562.3088882801867,133150.27512732337,1352,6,594.2051282051282,36,3,15,34.371684410785505,0.6362847222222221,43.49662162162163,1026.0135135135142,28.500375375375395,0
1360,4,1,1,39,0.025,0.025,0.975,40,650,400,250,0.6153846153846154,9,4,5,348.77740702492076,0.38007478632478636,0.11587221095334699,0.207165375497935,131862.521701389,1198.1336805555666,133060.65538194455,1353,0,580.325,37,3,16,34.27358012170386,0.6371058558558558,43.22916666666667,1027.0833333333342,27.75900900900903,0
1361,4,0,1,38,0.0,0.02564102564102564,0.9743589743589743,39,1100,700,400,0.6363636363636364,15,7,8,357.1686607727901,0.3761246063877643,0.12755299951090326,0.21239195068900865,131905.89871966565,1622.5306387468588,133528.4293584125,1354,8,596.2051282051282,36,3,16,34.0143791566177,0.6394675925925926,43.18693693693694,1027.2522522522527,28.534784784784797,0
1362,4,1,0,39,0.02564102564102564,0.0,1.0,39,900,500,400,0.5555555555555556,13,5,8,346.6496891464625,0.3805668016194332,0.1368505667929849,0.2075913655693183,132172.40521121878,1363.5046360418485,133535.90984726063,1355,0,594.2051282051282,37,2,17,34.016225918817085,0.6402027027027027,42.92763157894736,1028.28947368421,27.79160739687054,0
1363,4,0,0,39,0.0,0.0,1.0,39,950,600,350,0.631578947368421,13,6,7,344.30365518347696,0.38062303193882147,0.13403524308545123,0.20664827826463186,132256.98201610107,1307.3124663357905,133564.29448243688,1356,1,595.2051282051282,37,2,17,33.99146768290516,0.6410472972972973,42.8453947368421,1028.6184210526312,27.80049786628733,0
1364,4,0,1,38,0.0,0.02564102564102564,0.9743589743589743,39,1150,1000,150,0.8695652173913043,13,10,3,348.1120755504098,0.38051057130004495,0.13454434170546703,0.20940280236955422,132341.58587257622,1413.940827947063,133755.52670052327,1357,2,596.2051282051282,37,2,18,33.808432793407206,0.6418918918918919,42.76315789473684,1028.947368421053,27.809388335704135,0
1365,4,1,1,38,0.02564102564102564,0.02564102564102564,0.9743589743589743,39,850,700,150,0.8235294117647058,10,7,3,345.3588814765039,0.3829284750337382,0.12623274161735765,0.20805766762121072,132398.0034722221,1344.9652777777692,133742.96874999988,1358,0,596.8717948717949,37,2,18,33.82253711201081,0.642454954954955,42.70833333333333,1029.1666666666656,27.815315315315285,0
1366,4,1,0,39,0.02564102564102564,0.0,1.0,39,1000,700,300,0.7,13,7,6,348.26935050883463,0.3793297345928925,0.12290215996286302,0.21044074654298286,132510.87474030457,1429.895256232672,133940.76999653724,1359,0,597.8461538461538,37,2,20,33.63418530351439,0.6435810810810811,42.59868421052631,1029.6052631578937,27.827169274537667,0
1367,4,0,0,39,0.0,0.0,1.0,39,800,600,200,0.75,10,6,4,347.1729690510749,0.3797795771479982,0.12341876701369858,0.20993569558007996,132539.10007165652,1402.798577446894,133941.89864910342,1360,1,598.8461538461538,37,2,20,33.634042345508114,0.6438626126126126,42.571271929824555,1029.7149122807007,27.83013276434326,0
1368,4,0,0,39,0.0,0.0,1.0,39,950,600,350,0.631578947368421,13,6,7,348.5557135884824,0.3800607287449393,0.12424418620522126,0.21108857625639024,132595.55975155806,1443.3879895737055,134038.94774113176,1361,2,599.8461538461538,37,2,20,33.5417110259413,0.6444256756756757,42.51644736842105,1029.934210526315,27.836059743954458,0
1369,4,0,0,39,0.0,0.0,1.0,39,700,500,200,0.7142857142857143,9,5,4,348.435001552249,0.37975146198830406,0.11708200980231642,0.21149194280264394,132680.2718144043,1446.0901431209431,134126.36195752522,1362,3,600.8461538461538,37,2,13,33.45971690080884,0.6452702702702704,42.43421052631578,1030.2631578947357,27.844950213371238,0
1370,4,0,1,38,0.0,0.02564102564102564,0.9743589743589743,39,850,800,50,0.9411764705882353,9,8,1,345.87898516523217,0.3801731893837157,0.12298200682415072,0.2107328800737748,132821.51870046536,1388.0344192443602,134209.55311970972,1363,4,601.8461538461538,37,2,13,33.38374906924794,0.646677927927928,42.29714912280701,1030.8114035087706,27.859767662399204,0
1371,4,0,0,38,0.0,0.0,1.0,38,650,500,150,0.7692307692307693,8,5,3,351.5236644868464,0.37673364153627314,0.11966062697727886,0.21357513479778503,132716.9124360846,1730.6270797824652,134447.53951586704,1364,9,618.578947368421,36,2,13,33.34335154826957,0.6475694444444446,42.39864864864864,1030.4054054054043,28.62237237237234,0
1372,4,0,1,37,0.0,0.02631578947368421,0.9736842105263158,38,850,600,250,0.7058823529411765,11,6,5,350.6311099173751,0.3766299193930773,0.11774669435034468,0.21319769347866405,132745.92318247273,1708.9700764953889,134454.89325896814,1365,10,619.578947368421,36,2,13,33.33720358430774,0.6478587962962965,42.37049549549548,1030.518018018016,28.625500500500443,0
1373,4,0,0,37,0.0,0.0,1.0,37,750,500,250,0.6666666666666666,10,5,5,356.70368404164935,0.37493743743743746,0.11702705738424068,0.21677357672510567,132725.77649444836,2068.754688571633,134794.53118302,1366,11,629.1621621621622,35,2,13,33.201004343105325,0.6497023809523811,42.390046296296276,1030.439814814812,29.44113756613749,0
1374,4,0,0,37,0.0,0.0,1.0,37,1200,900,300,0.75,15,9,6,358.6514957657768,0.37512512512512514,0.12120752473205054,0.2190011086893284,132904.73257726742,2133.2962266374852,135038.02880390492,1367,12,630.1621621621622,35,2,14,32.970989074718446,0.6514880952380955,42.21643518518517,1031.1342592592573,29.46097883597878,0
1375,4,0,0,37,0.0,0.0,1.0,37,850,500,350,0.5882352941176471,12,5,7,357.5394280078262,0.37506256256256254,0.11958367703430572,0.21884556197841634,132994.2558299037,2110.138031550033,135104.39386145375,1368,13,631.1621621621622,35,2,16,32.909747157390775,0.6523809523809525,42.12962962962961,1031.4814814814792,29.470899470899408,0
1376,4,0,1,36,0.0,0.02702702702702703,0.972972972972973,37,850,600,250,0.7058823529411765,11,6,5,357.0784756531504,0.37521896896896895,0.121339647927039,0.21891317276287314,133053.95474322664,2102.1406678668986,135156.09541109353,1369,14,632.1621621621622,35,2,16,32.86169695609903,0.6529761904761907,42.07175925925924,1031.7129629629599,29.47751322751314,0
1377,4,0,0,36,0.0,0.0,1.0,36,600,300,300,0.5,9,3,6,363.2550709270812,0.36942791005291004,0.12710826375261353,0.222080358464453,132949.91673752805,2458.9462868480364,135408.8630243761,1370,24,650.3333333333334,34,2,17,32.806908692138975,0.6541053921568629,42.17261904761903,1031.3095238095216,30.332633053221222,0
1378,4,0,0,36,0.0,0.0,1.0,36,750,500,250,0.6666666666666666,10,5,5,362.8761799870033,0.3693121693121693,0.12690719798958927,0.22239639149698465,133042.01388888856,2455.555555555517,135497.56944444406,1371,25,651.3333333333334,34,2,18,32.72415185783521,0.6550245098039218,42.083333333333314,1031.666666666664,30.343137254901883,0
1379,4,1,0,37,0.02702702702702703,0.0,1.0,37,950,600,350,0.631578947368421,13,6,7,356.6648495755382,0.37468718718718713,0.1271599964864567,0.22024362994896352,133322.76562767892,2110.3088295181524,135433.07445719707,1372,0,634.7027027027027,35,2,20,32.60266072696029,0.6556547619047619,41.81134259259258,1032.7546296296277,29.50727513227508,0
1380,4,0,0,37,0.0,0.0,1.0,37,900,800,100,0.8888888888888888,10,8,2,356.00084739778305,0.37428053053053056,0.12651374063138832,0.2201876343052812,133382.5382185568,2096.85932677466,135479.39754533145,1373,1,635.7027027027027,35,2,20,32.55987394957984,0.6562500000000002,41.75347222222221,1032.9861111111088,29.513888888888822,0
1381,4,0,1,36,0.0,0.02702702702702703,0.972972972972973,37,850,700,150,0.8235294117647058,10,7,3,359.0003946883823,0.3745307807807808,0.07218258784523868,0.21478857165825235,132137.36329234642,2087.4731150069047,134224.83640735332,1374,2,636.7027027027027,36,1,17,33.734027017159555,0.6417824074074073,42.961711711711715,1028.1531531531532,28.55980980980981,8
1382,4,0,0,36,0.0,0.0,1.0,36,950,700,250,0.7368421052631579,12,7,5,364.66526626978754,0.3688822751322751,0.06711964064905263,0.20558529672034223,129849.38298396763,2270.311964163223,132119.69494813087,1375,29,655.3333333333334,35,1,17,35.90497009614656,0.6208333333333333,45.19675925925925,1019.2129629629618,29.12037037037034,6
1383,4,1,0,37,0.02702702702702703,0.0,1.0,37,800,500,300,0.625,11,5,6,356.5713927014679,0.3739677177177177,0.07015158157164114,0.20286293358778423,130205.11379200139,1885.4837523334052,132090.5975443348,1376,0,638.5945945945946,36,1,18,35.74998161021,0.6223958333333335,44.84797297297297,1020.6081081081076,28.35022522522521,0
1384,4,0,0,37,0.0,0.0,1.0,37,1050,700,350,0.6666666666666666,14,7,7,357.0251380865577,0.37412412412412416,0.06542156128040166,0.20358497093765285,130293.86421388382,1903.6750173601542,132197.53923124398,1377,1,639.5945945945946,33,4,18,35.64835653983114,0.6297348484848486,44.76102941176469,1020.955882352939,30.938057040998153,0
1385,4,0,0,37,0.0,0.0,1.0,37,1000,800,200,0.8,12,8,4,340.5805468765163,0.3740615615615615,0.022842005000595522,0.19622280238824655,130694.03863322776,1502.3694302410445,132196.4080634688,1378,2,640.5945945945946,36,1,17,35.66308737151249,0.6273148148148149,44.369369369369366,1022.522522522522,28.403403403403388,2
1386,4,0,0,37,0.0,0.0,1.0,37,800,600,200,0.75,10,6,4,340.44227087055987,0.3743430930930931,0.02339386617708694,0.19658214534757096,130780.41459956563,1504.6362663338796,132285.0508658995,1379,3,641.5945945945946,36,1,17,35.57928731329589,0.6281828703703705,44.2849099099099,1022.8603603603592,28.412787787787757,0
1387,4,0,0,37,0.0,0.0,1.0,37,850,500,350,0.5882352941176471,12,5,7,343.195397209313,0.37374874874874875,-0.02042268960815452,0.18638596134499744,128372.67324334475,1411.3821169142147,129784.05536025896,1380,4,642.5945945945946,36,1,14,37.95491165685076,0.6038773148148149,46.64977477477478,1013.4009009009013,28.150025025025037,8
1388,4,0,1,36,0.0,0.02702702702702703,0.972972972972973,37,850,700,150,0.8235294117647058,10,7,3,343.9824105838189,0.37318568568568566,-0.02029579012471716,0.18721461064543762,128458.27880245112,1437.4776803830887,129895.75648283421,1381,5,643.5945945945946,36,1,16,37.847607938976516,0.6047453703703705,46.56531531531532,1013.738738738739,28.159409409409417,0
1389,4,1,1,36,0.02702702702702703,0.02702702702702703,0.972972972972973,37,800,600,200,0.75,10,6,4,343.6874665645896,0.3729667167167167,-0.009936009936009738,0.1879951661372427,128658.1360710372,1443.637767835401,130101.7738388726,1382,0,644.4324324324324,36,1,19,37.65123765123767,0.6067708333333335,46.36824324324324,1014.5270270270265,28.181306306306293,0
1390,4,0,0,36,0.0,0.0,1.0,36,800,400,400,0.5,12,4,8,341.72616425011546,0.36779100529100534,0.023892507522950135,0.18493788889009025,128232.4369454089,1564.0757619598746,129796.51270736878,1383,37,663.3333333333334,35,1,20,38.13528453890984,0.6044642857142857,46.78819444444444,1012.847222222222,28.938492063492056,2
1391,4,3,3,36,0.07692307692307693,0.07692307692307693,0.9230769230769231,39,650,400,250,0.6153846153846154,9,4,5,319.6777883249938,0.38824224021592446,0.010313238304208827,0.17562456172578317,128830.99500868065,436.88151041667686,129267.87651909732,1384,0,613.2307692307693,39,0,18,38.084427799439084,0.6030982905982906,46.19791666666667,1015.2083333333342,26.030982905982928,0
1392,4,3,2,37,0.07692307692307693,0.05128205128205128,0.9487179487179487,39,950,800,150,0.8421052631578947,11,8,3,321.6706225802698,0.3864428699955016,0.01872068319976483,0.17742827553183202,128989.6701388888,498.4374999999954,129488.1076388888,1385,0,614.1538461538462,39,0,19,37.87257314738858,0.6047008547008548,46.041666666666664,1015.8333333333326,26.047008547008527,0
1393,4,2,1,38,0.05128205128205128,0.02564102564102564,0.9743589743589743,39,1250,700,550,0.56,18,7,11,323.7295177188438,0.3871176338281601,0.02309935790941431,0.1796529696056201,129230.01284646122,567.6347800503063,129797.64762651152,1386,0,615.1025641025641,36,3,21,37.5761435374903,0.6125578703703705,45.80518018018017,1016.7792792792784,28.243868868868844,0
1394,4,1,2,37,0.02564102564102564,0.05128205128205128,0.9487179487179487,39,1050,700,350,0.6666666666666666,14,7,7,323.84343750010544,0.3881860098965362,0.022608988869633695,0.18022168984333975,129340.77222077922,577.232056979042,129918.00427775827,1387,0,616.0769230769231,37,2,22,37.460812583090785,0.6117680180180182,45.69627192982455,1017.2149122806998,27.492294926505398,0
1395,4,3,3,37,0.075,0.075,0.925,40,950,500,450,0.5263157894736842,14,5,9,310.2093016849303,0.3961271367521368,0.042992230627683314,0.17459536185742142,129784.51063368037,52.072482638869445,129836.58311631925,1388,0,600.575,39,1,16,37.35815784093231,0.6127136752136754,45.26041666666666,1018.9583333333319,26.127136752136714,0
1396,4,1,0,38,0.02631578947368421,0.0,1.0,38,950,700,250,0.7368421052631579,12,7,5,325.1755928426167,0.3844535324798483,0.05470812392997204,0.18207540539307496,129581.83235627135,827.3698316166143,130409.20218788796,1389,0,633.1052631578947,38,0,17,37.18236271423574,0.6123903508771931,45.4594017094017,1018.1623931623923,26.79374718848401,0
1397,4,0,0,38,0.0,0.0,1.0,38,1000,700,300,0.7,13,7,6,321.7936283849455,0.3843201754385965,0.06061216715343365,0.18055671921092897,129663.42872242302,744.9730394842468,130408.40176190727,1390,1,634.1052631578947,38,0,18,37.18574076016644,0.6132127192982457,45.3792735042735,1018.4829059829052,26.802181736392242,0
1398,4,1,1,38,0.02564102564102564,0.02564102564102564,0.9743589743589743,39,1000,600,400,0.6,14,6,8,314.47561459694,0.3906601439496176,0.07144185266951086,0.1780815929738948,130023.43885633688,377.8401692708437,130401.27902560773,1391,0,618.8205128205128,39,0,19,37.007732441357724,0.6151175213675213,45.02604166666667,1019.895833333334,26.15117521367523,0
1399,4,0,0,38,0.0,0.0,1.0,38,1150,900,250,0.782608695652174,14,9,5,321.76569128379884,0.38423127074442864,0.07648155605447915,0.18154739565574965,129881.14458917748,758.2592546935477,130639.40384387103,1392,3,636.1052631578947,38,0,19,36.96590154770639,0.6154057017543859,45.16559829059829,1019.3376068376072,26.824673864147556,0
1400,4,0,0,38,0.0,0.0,1.0,38,1000,600,400,0.6,14,6,8,319.53748901360774,0.3833718587008061,0.07709464861735249,0.18079343999021266,129990.07100820012,707.340177332175,130697.4111855323,1393,4,637.1052631578947,38,0,20,36.91243233804782,0.6165021929824561,45.05876068376069,1019.7649572649581,26.835919928025213,0
1401,4,0,0,38,0.0,0.0,1.0,38,1000,700,300,0.7,13,7,6,316.5599627203199,0.38311996206733046,0.07501240011022281,0.17973529393454574,130126.29323727096,638.5549072247964,130764.84814449576,1394,5,638.1052631578947,38,0,21,36.85056719022686,0.6178728070175438,44.92521367521368,1020.2991452991466,26.84997750787228,0
1402,4,0,0,38,0.0,0.0,1.0,38,1150,600,550,0.5217391304347826,17,6,11,313.00574864843924,0.3830458748221906,0.07893080198134617,0.1753825861474583,129609.02829141972,513.6741863904864,130122.7024778102,1395,6,639.1052631578947,38,0,18,37.464589235127455,0.6126644736842106,45.432692307692285,1018.2692307692275,26.796558704453357,1
1403,4,1,0,39,0.02564102564102564,0.0,1.0,39,950,600,350,0.631578947368421,13,6,7,306.4642385263718,0.3862460638776428,0.09364958399786305,0.17354490222161384,130023.4388563366,169.50683593747974,130192.94569227408,1396,0,623.6923076923077,39,0,20,37.212001668198695,0.6151175213675215,45.02604166666666,1019.8958333333317,26.15117521367517,0
1404,4,0,0,39,0.0,0.0,1.0,39,700,400,300,0.5714285714285714,10,4,6,307.6206698785022,0.38565564552406656,0.10198819387180835,0.17467504124405359,130129.69970703099,206.11707899302638,130335.81678602402,1397,1,624.6923076923077,39,0,20,37.07514463161477,0.6161858974358976,44.921874999999986,1020.312499999998,26.16185897435892,0
1405,4,0,0,39,0.0,0.0,1.0,39,1300,1000,300,0.7692307692307693,16,10,6,306.2596234618218,0.3869489428699955,0.09962836633915417,0.17462577020785386,130291.32806793282,180.79806540599225,130472.12613333881,1398,2,625.6923076923077,36,3,20,36.94665048900655,0.6232638888888888,44.763513513513516,1020.945945945946,28.359609609609613,0
1406,4,0,0,39,0.0,0.0,1.0,39,850,500,350,0.5882352941176471,12,5,7,305.6736058236849,0.3868645973909132,0.1012916652528475,0.17454963838848714,130348.82010388776,168.8387712036444,130517.65887509141,1399,3,626.6923076923077,36,3,21,36.90358035583004,0.6238425925925926,44.70720720720721,1021.1711711711719,28.365865865865885,0
1407,4,0,1,38,0.0,0.02564102564102564,0.9743589743589743,39,600,500,100,0.8333333333333334,7,5,2,307.0480849061992,0.387089518668466,0.10128063777457363,0.17559433354976225,130406.32482144322,208.2024592159857,130614.52728065921,1400,4,627.6923076923077,36,3,21,36.81045571481071,0.6244212962962963,44.65090090090091,1021.3963963963977,28.372122122122157,0
1408,4,0,0,38,0.0,0.0,1.0,38,950,400,550,0.42105263157894735,15,4,11,315.66916471521887,0.38497214319582745,0.10472025677433239,0.18013152465185397,130321.66950660163,627.7065114883571,130949.37601808998,1401,5,642.9736842105264,35,3,21,36.675829365979006,0.6255952380952381,44.733796296296305,1021.0648148148158,29.173280423280453,0
1409,4,1,0,39,0.02564102564102564,0.0,1.0,39,700,500,200,0.7142857142857143,9,5,4,332.9237899166313,0.38959176788124156,0.08235657964550325,0.18583275413691167,129459.11864144562,820.0040834753853,130279.122724921,1402,0,627.4615384615385,36,3,14,37.109706392239325,0.6148726851851851,45.579954954954964,1017.6801801801811,28.268893893893917,3
1410,4,0,0,39,0.0,0.0,1.0,39,1150,800,350,0.6956521739130435,15,8,7,335.77804151205345,0.38922627080521816,0.07982438974585904,0.18797332961674754,129573.74762854057,901.6038420176768,130475.35147055825,1403,1,628.4615384615385,36,3,14,36.92069461342771,0.6160300925925927,45.467342342342334,1018.1306306306295,28.281406406406376,0
1411,4,1,1,39,0.025,0.025,0.975,40,1250,800,450,0.64,17,8,9,329.0188251152622,0.3919871794871795,0.0773123252312331,0.18585765710338403,129927.00277970114,549.6859610649138,130476.68874076605,1404,0,613.725,37,3,14,36.73460242346026,0.6176801801801803,45.120614035087705,1019.5175438596467,27.554528212422884,0
1412,4,2,2,39,0.04878048780487805,0.04878048780487805,0.9512195121951219,41,1050,600,450,0.5714285714285714,15,6,9,317.7009579341945,0.3973323170731707,0.0657043305126932,0.1810156620787847,130262.58680555511,76.9097222221742,130339.49652777729,1405,0,599.7073170731708,38,3,14,36.68367346938775,0.6192434210526319,44.79166666666664,1020.8333333333297,26.864035087719202,0
1413,4,0,0,39,0.0,0.0,1.0,39,1300,800,500,0.6153846153846154,18,8,10,335.6652341608582,0.3881016644174539,0.053380984796914,0.1877731260404803,129545.08562616687,896.7563002191555,130441.84192638603,1406,4,631.4615384615385,36,3,15,36.95266408554572,0.6157407407407407,45.495495495495504,1018.0180180180193,28.278278278278314,1
1414,4,0,0,39,0.0,0.0,1.0,39,850,500,350,0.5882352941176471,12,5,7,335.30596545686694,0.3888888888888889,0.05484905451730593,0.18798337542631446,129631.08114448929,893.2149632741025,130524.2961077634,1407,5,632.4615384615385,36,3,16,36.87451620037596,0.6166087962962963,45.411036036036045,1018.3558558558575,28.287662662662708,0
1415,4,0,0,39,0.0,0.0,1.0,39,700,400,300,0.5714285714285714,10,4,6,334.1277764485111,0.3886920827710301,0.0546384884693345,0.18759688007304678,129688.42734203805,866.5011717798955,130554.92851381794,1408,6,633.4615384615385,36,3,16,36.846323935876185,0.6171875,45.35472972972973,1018.5810810810816,28.293918918918934,0
1416,4,0,0,39,0.0,0.0,1.0,39,1200,900,300,0.75,15,9,6,336.0099074303541,0.3883265856950067,0.05757258912303653,0.1892068234186232,129803.15778193736,923.0294060952859,130726.18718803265,1409,7,634.4615384615385,36,3,16,36.68199985265407,0.6183449074074074,45.24211711711712,1019.0315315315316,28.306431431431434,0
1417,4,1,1,39,0.025,0.025,0.975,40,1100,700,400,0.6363636363636364,15,7,8,332.18915264212063,0.39300213675213674,0.05604041272570992,0.1884565778159931,130094.7406894427,643.2123345644649,130737.95302400716,1410,0,619.575,37,3,17,36.4838599885354,0.6193693693693694,44.956140350877185,1020.1754385964896,27.572309151256476,0
1418,4,0,1,38,0.0,0.02564102564102564,0.9743589743589743,39,1050,600,450,0.5714285714285714,15,6,9,340.02357923684906,0.38827035537561855,0.0674152849506211,0.19245334584805668,130004.0581121663,1040.889030922826,131044.94714308913,1411,9,636.4615384615385,36,3,17,36.37597541224971,0.6203703703703705,45.04504504504505,1019.8198198198204,28.328328328328343,0
1419,4,1,0,39,0.02564102564102564,0.0,1.0,39,650,500,150,0.7692307692307693,8,5,3,337.9962582491021,0.39206590193432295,0.0757799546146487,0.19215320528565658,130176.38204082473,999.8260084408837,131176.2080492656,1412,0,631.6666666666666,36,3,18,36.25303465018759,0.6221064814814814,44.87612612612613,1020.4954954954965,28.347097097097123,0
1420,4,1,1,39,0.025,0.025,0.975,40,1500,1000,500,0.6666666666666666,20,10,10,337.2173664314232,0.3936965811965812,0.07564356966641617,0.19394679255028732,130626.62459843411,809.9132665820187,131436.53786501611,1413,0,616.85,37,3,13,35.817221745503936,0.6247184684684686,44.435307017543856,1022.2587719298243,27.62861545756282,0
1421,4,0,0,39,0.0,0.0,1.0,39,1600,1500,100,0.9375,17,15,2,373.0459571913805,0.39110998650472334,0.054234671952149816,0.20488328682063825,128819.24518014806,1834.9592294275196,130654.20440957558,1414,2,633.6666666666666,35,4,15,36.74193839546991,0.6104166666666668,46.209490740740726,1015.162037037035,29.004629629629573,8
1422,4,2,1,40,0.04878048780487805,0.024390243902439025,0.975609756097561,41,950,600,350,0.631578947368421,13,6,7,366.06246971720867,0.3974339430894309,0.08770097698803592,0.1933700830274257,127257.91229032014,1165.2618904404178,128423.17418076056,1415,0,603.7073170731708,37,4,18,38.51834746069695,0.5906531531531531,47.752192982456144,1008.9912280701757,27.27003319108583,6
1423,4,4,3,41,0.09090909090909091,0.06818181818181818,0.9318181818181819,44,950,700,250,0.7368421052631579,12,7,5,350.84709787891865,0.41126013037350245,0.10457923617007703,0.1887295815008319,127990.23321311739,181.00037593366008,128171.23358905104,1416,0,563.3863636363636,40,4,15,38.151970138261206,0.5929687499999998,47.027439024390254,1011.8902439024406,25.297256097561014,0
1424,4,1,0,42,0.023809523809523808,0.0,1.0,42,1000,700,300,0.7,13,7,6,357.08777326429373,0.40328590785907864,0.11976172874894964,0.19179036443786757,127928.27641034807,736.3246721820794,128664.60108253015,1417,0,591.1904761904761,38,4,16,38.05752103354808,0.5956688596491226,47.08867521367523,1011.6452991453019,26.62224471435005,0
1425,4,0,0,42,0.0,0.0,1.0,42,1100,400,700,0.36363636363636365,18,4,14,358.6655833409418,0.40317702284165696,0.12415037805662732,0.19302729576167077,128009.35057345338,782.5096793045741,128791.86025275796,1418,1,592.1904761904761,38,4,16,37.93461430180179,0.5964912280701753,47.00854700854702,1011.9658119658139,26.630679262258262,0
1426,4,2,3,41,0.045454545454545456,0.06818181818181818,0.9318181818181819,44,900,700,200,0.7777777777777778,11,7,4,346.93389892348284,0.4086614693446089,0.11754608047383708,0.1887095455799005,128434.73442925386,111.7439737626184,128546.47840301647,1419,0,566.2272727272727,39,5,14,37.79683913951974,0.5990918803418802,46.588541666666686,1013.6458333333364,25.990918803418882,0
1427,4,0,0,41,0.0,0.0,1.0,41,1550,1200,350,0.7741935483870968,19,12,7,361.7947566678488,0.39974593495934957,0.13304509157191258,0.1955083204301261,128173.03790276768,1074.4666118821629,129247.50451464985,1420,3,607.9024390243902,36,5,18,37.68789850237249,0.6018518518518519,46.84684684684685,1012.612612612613,28.12812812812814,0
1428,4,3,3,41,0.06818181818181818,0.06818181818181818,0.9318181818181819,44,950,600,350,0.631578947368421,13,6,7,343.9404684582772,0.4122181113460183,0.13582445591791403,0.18782660355458497,128593.16541883702,62.573773229547214,128655.73919206657,1421,0,567.3863636363636,39,5,16,37.711072027660826,0.6006944444444444,46.43229166666668,1014.2708333333351,26.00694444444449,2
1429,4,1,2,40,0.023809523809523808,0.047619047619047616,0.9523809523809523,42,1100,900,200,0.8181818181818182,13,9,4,352.0959541078875,0.4052216415021293,0.14805171392515892,0.19159076490449786,128450.017373134,645.3462844336661,129095.36365756766,1422,0,594.5238095238095,37,5,16,37.65041914548403,0.602759009009009,46.5734649122807,1013.7061403508769,27.397463252726403,0
1430,4,1,1,40,0.024390243902439025,0.024390243902439025,0.975609756097561,41,1350,1000,350,0.7407407407407407,17,10,7,361.21915256255056,0.39982215447154473,0.14935957472067996,0.19655509508185864,128450.01737313397,1079.721284433666,129529.73865756764,1423,0,609.829268292683,37,4,17,37.419213088155765,0.6027590090090091,46.5734649122807,1013.7061403508767,27.397463252726396,0
1431,4,2,1,41,0.047619047619047616,0.023809523809523808,0.9761904761904762,42,700,300,400,0.42857142857142855,11,3,8,355.85041551246553,0.4028745644599303,0.15100250626566436,0.1951835419958673,128767.28121119135,764.3781046825798,129531.65931587393,1424,0,596.2619047619048,38,4,18,37.23135964912281,0.6041666666666667,46.260683760683754,1014.957264957264,26.709401709401686,0
1432,4,2,1,42,0.046511627906976744,0.023255813953488372,0.9767441860465116,43,1050,600,450,0.5714285714285714,15,6,9,350.05676010019624,0.40829180509413066,0.15627830696911582,0.19360282038194535,129095.50781250001,438.15104166666765,129533.65885416669,1425,0,583.3488372093024,39,4,19,37.04387043870438,0.6057692307692308,45.9375,1016.2500000000001,26.05769230769231,0
1433,4,0,0,42,0.0,0.0,1.0,42,1100,800,300,0.7272727272727273,14,8,6,356.92053418242654,0.4025842044134727,0.1586166130664346,0.19657512154913928,128929.98598327114,803.5518938563721,129733.53787712751,1426,1,598.2380952380952,38,4,19,37.03823024054984,0.605811403508772,46.100427350427346,1015.5982905982897,26.72627080521815,0
1434,4,0,0,42,0.0,0.0,1.0,42,1400,1100,300,0.7857142857142857,17,11,6,351.21313896368474,0.40203977932636464,0.17870903512676506,0.18796231950240463,127784.6470871341,575.9294029678183,128360.57649010191,1427,2,599.2380952380952,40,2,18,38.35310081415216,0.5908854166666666,47.23069105691057,1011.0772357723588,25.27693089430897,4
1435,4,0,0,42,0.0,0.0,1.0,42,1450,1100,350,0.7586206896551724,18,11,7,346.7488176957033,0.40203977932636464,0.17270335557628447,0.18628626444472338,127938.82118985057,472.5269969925314,128411.3481868431,1428,3,600.2380952380952,40,2,18,38.308220324794924,0.5924479166666667,47.078252032520325,1011.6869918699183,25.292174796747958,0
1436,4,0,0,42,0.0,0.0,1.0,42,1000,500,500,0.5,15,5,10,350.1625466501221,0.4019671893147503,0.17595713855378525,0.18860296387715328,128041.65556423088,567.0784379337695,128608.73400216465,1429,4,601.2380952380952,40,2,19,38.11669511664493,0.5934895833333333,46.97662601626016,1012.0934959349588,25.30233739837397,0
1437,4,0,0,42,0.0,0.0,1.0,42,1050,700,350,0.6666666666666666,14,7,7,366.2448165359048,0.4019671893147503,0.1823513104301282,0.18975050471570196,126468.25034493954,879.3949583345847,127347.64530327413,1430,5,602.2380952380952,36,6,17,39.32629870129871,0.5844907407407407,48.53603603603604,1005.8558558558559,27.94044044044044,3
1438,4,3,2,43,0.06666666666666667,0.044444444444444446,0.9555555555555556,45,700,500,200,0.7142857142857143,9,5,4,346.2528360145618,0.4131944444444444,0.1899846568325425,0.18228319020182715,127119.65610812923,-193.82276454719812,126925.83334358204,1431,0,563.0222222222222,37,8,18,39.1598483201044,0.5892454954954955,47.889254385964904,1008.4429824561388,27.255215742057807,0
1439,4,0,1,42,0.0,0.023255813953488372,0.9767441860465116,43,800,400,400,0.5,12,4,8,358.5684523429163,0.4061461794019934,0.19596747935392878,0.18739375657921345,126822.83676674683,494.93366023812735,127317.77042698495,1432,1,590.2093023255813,38,5,18,39.15442476311696,0.5844298245614037,48.183760683760674,1007.2649572649557,26.506972559604097,0
1440,4,3,2,43,0.06666666666666667,0.044444444444444446,0.9555555555555556,45,700,400,300,0.5714285714285714,10,4,6,345.84966901728774,0.41550925925925924,0.1930336725946853,0.18281760505261907,127285.57254395577,-194.80930243178105,127090.763241524,1433,0,561.7777777777778,37,8,19,38.9998505921982,0.5909346846846846,47.72478070175438,1009.100877192982,27.272996680891406,0
1441,4,2,2,43,0.044444444444444446,0.044444444444444446,0.9555555555555556,45,800,400,400,0.5,12,4,8,348.6674602449723,0.4157617845117845,0.19985519837822152,0.18493836255390045,127423.91889812279,-114.28516466601647,127309.63373345678,1434,0,562.7333333333333,37,8,17,38.78692441355343,0.5923423423423422,47.58771929824563,1009.64912280702,27.28781412991946,0
1442,4,0,0,43,0.0,0.0,1.0,43,1000,700,300,0.7,13,7,6,365.7559803805934,0.41064507198228134,0.2039487379304088,0.19269634903485455,127150.37321030536,701.2018818587271,127851.57509216409,1435,1,589.8837209302326,35,8,19,38.636580980797184,0.5934523809523808,47.858796296296305,1008.564814814816,28.816137566137602,0
1443,4,1,0,44,0.022727272727272728,0.0,1.0,44,950,600,350,0.631578947368421,13,6,7,360.53856843981686,0.4119318181818182,0.21392118306490082,0.19168170837799153,127518.18700034496,395.04491822904805,127913.231918574,1436,0,577.4545454545455,36,8,18,38.39056751031332,0.5951967592592593,47.49436936936937,1010.0225225225226,28.056181181181184,0
1444,4,2,1,45,0.043478260869565216,0.021739130434782608,0.9782608695652174,46,1100,600,500,0.5454545454545454,16,6,10,346.7313838382386,0.4185185185185185,0.2153048436187348,0.1864788720233936,127982.32299884959,-324.90240795528155,127657.42059089431,1437,0,553.304347826087,38,8,19,38.26417484954069,0.5962171052631577,47.035256410256416,1011.8589743589755,26.62786774628883,0
1445,4,0,0,45,0.0,0.0,1.0,45,1900,1700,200,0.8947368421052632,21,17,4,352.8189078637697,0.4156144781144781,0.21509338535457578,0.1896016344122889,127950.32035097324,28.65845740995789,127978.9788083832,1438,1,566.6,37,8,20,38.14292745926809,0.5976914414414415,47.066885964912274,1011.7324561403498,27.34412043622567,0
1446,4,2,0,47,0.0425531914893617,0.0,1.0,47,1050,700,350,0.6666666666666666,14,7,7,363.5428688843321,0.41913351834720936,0.26841829491663627,0.19967539538375229,128821.50472094349,-33.42483905623965,128788.07988188724,1439,0,543.4468085106383,38,9,19,36.98081105732126,0.6047149122807018,46.20726495726494,1015.1709401709375,26.71502474134046,0
1447,4,1,2,46,0.020833333333333332,0.041666666666666664,0.9583333333333334,48,1250,1000,250,0.8,15,10,5,358.6984135407703,0.420739140070922,0.2713245344267903,0.19824946312125827,129069.0443250866,-340.6277126736305,128728.41661241297,1440,0,533.1041666666666,39,9,20,36.85129420809842,0.6055021367521369,45.96354166666666,1016.1458333333317,26.055021367521324,0
1448,4,2,2,46,0.041666666666666664,0.041666666666666664,0.9583333333333334,48,1200,1100,100,0.9166666666666666,13,11,2,358.8891943657969,0.42068373226950356,0.2668575552594721,0.19862063921877915,129121.9740125866,-331.90375434030125,128790.0702582463,1441,0,534.0,39,9,20,36.79249513170031,0.606036324786325,45.91145833333332,1016.3541666666649,26.060363247863204,0
1449,4,0,0,46,0.0,0.0,1.0,46,1250,900,350,0.72,16,9,7,370.6689739620158,0.4155193236714976,0.27147630847788595,0.2043974627847684,128978.53185595544,361.66801323481576,129340.19986919026,1442,3,558.2173913043479,37,9,20,36.63959052964881,0.6081081081081082,46.052631578947356,1015.7894736842086,27.453769559032665,0
1450,4,1,2,45,0.02127659574468085,0.0425531914893617,0.9574468085106383,47,1050,600,450,0.5714285714285714,15,6,9,363.44898983602917,0.41842044403330253,0.26718072806480064,0.2012720424505225,129147.08547921664,-12.324448462298506,129134.76103075434,1443,0,547.3191489361702,38,9,20,36.65103181276715,0.6080043859649125,45.88675213675212,1016.4529914529894,26.748762932973406,0
1451,4,0,1,44,0.0,0.022222222222222223,0.9777777777777777,45,1100,900,200,0.8181818181818182,13,9,4,370.35290844418984,0.41508838383838387,0.2696405017147523,0.20451073001453265,129034.22807979358,557.6403316404833,129591.86841143407,1444,5,568.9777777777778,37,8,20,36.590761925318354,0.6086711711711712,45.99780701754385,1016.0087719298228,27.45969653864386,0
1452,4,1,2,43,0.022222222222222223,0.044444444444444446,0.9555555555555556,45,900,400,500,0.4444444444444444,14,4,10,364.36818976904874,0.41820286195286194,0.25800322417888033,0.20220530949137927,129230.01284646137,417.56937531039995,129647.58222177177,1445,0,558.6,36,9,20,36.54312954553844,0.6125578703703705,45.80518018018018,1016.7792792792795,28.243868868868876,0
1453,4,2,2,43,0.044444444444444446,0.044444444444444446,0.9555555555555556,45,1700,1200,500,0.7058823529411765,22,12,10,358.9774520556644,0.419760101010101,0.24692103183157332,0.19991553422403655,129368.65790435494,288.08623807322726,129656.74414242817,1446,0,558.9333333333333,37,8,20,36.53894517496587,0.6120495495495497,45.668859649122794,1017.3245614035068,27.495258416310993,0
1454,4,0,0,43,0.0,0.0,1.0,43,1150,800,350,0.6956521739130435,15,8,7,363.46900206702526,0.4139904023624954,0.275029781944373,0.19008037828563376,126849.74163790247,635.9178905297899,127485.65952843225,1447,8,585.9302325581396,38,5,17,39.00334075723831,0.5847039473684212,48.15705128205127,1007.371794871793,26.5097840755735,7
1455,4,2,0,45,0.044444444444444446,0.0,1.0,45,1100,700,400,0.6363636363636364,15,7,8,350.1485601546413,0.42083333333333334,0.28510095741474784,0.1735534693713753,124635.68250868085,-258.6498012203798,124377.03270746047,1448,0,560.8444444444444,39,6,17,41.623635162389604,0.5603632478632476,50.36458333333335,998.5416666666691,25.60363247863254,7
1456,4,2,0,47,0.0425531914893617,0.0,1.0,47,1100,700,400,0.6363636363636364,15,7,8,337.84167051039515,0.4258788159111933,0.2906235876895258,0.16934401897608797,125104.18836805603,-945.8550347221712,124158.33333333385,1449,0,537.936170212766,39,8,19,41.44627238650565,0.5651709401709399,49.89583333333336,1000.4166666666706,25.651709401709503,0
1457,4,7,5,49,0.12962962962962962,0.09259259259259259,0.9074074074074074,54,1200,500,700,0.4166666666666667,19,5,14,318.9259458984577,0.44263918006056374,0.32582647020756217,0.1662512337344122,126718.83144718825,-2710.184113511628,124008.64733367662,1450,0,469.0740740740741,44,10,15,40.2592575562504,0.5743371212121211,48.28703703703705,1006.8518518518545,22.882996632996694,0
1458,4,7,8,48,0.125,0.14285714285714285,0.8571428571428572,56,1350,1000,350,0.7407407407407407,17,10,7,310.1330608219423,0.4425662878787879,0.32879807950217277,0.16354145365719458,127187.51793503223,-3309.3430623575678,123878.17487267466,1451,0,453.17857142857144,43,13,16,40.00109525597698,0.5804263565891472,47.8219696969697,1008.7121212121219,23.458421423537718,0
1459,4,3,0,51,0.058823529411764705,0.0,1.0,51,1550,1100,450,0.7096774193548387,20,11,9,361.49082256425174,0.4392320261437908,0.38116404648126956,0.1787934756600217,124546.3525115971,-1148.0712215997587,123398.28128999734,1452,0,497.921568627451,38,13,17,41.43320311106353,0.5611293859649122,50.45405982905984,998.1837606837623,26.267993702204272,7
1460,4,2,2,51,0.03773584905660377,0.03773584905660377,0.9622641509433962,53,1250,800,450,0.64,17,8,9,349.9825182854813,0.4443184567005322,0.3796091540773623,0.17510644812297743,125027.41378356816,-1846.0441299207805,123181.36965364739,1453,0,480.0943396226415,37,16,18,41.222065380258,0.567849099099099,49.972587719298254,1000.1096491228082,27.02999051683265,0
1461,4,7,5,53,0.1206896551724138,0.08620689655172414,0.9137931034482758,58,1250,600,650,0.48,19,6,13,327.71601313063366,0.4525294918330309,0.3740446281109906,0.16868456044066693,126200.78667534742,-3316.051723847706,122884.73495149972,1454,0,439.5344827586207,39,19,19,40.56992535766119,0.5763888888888888,48.80208333333334,1004.7916666666683,25.763888888888932,0
1462,4,7,7,53,0.11666666666666667,0.11666666666666667,0.8833333333333333,60,850,600,250,0.7058823529411765,11,6,5,325.9474852071007,0.45918079096045195,0.4000128205128206,0.17085956885856074,126945.49606393834,-3724.4869599182907,123221.00910402005,1455,0,425.73333333333335,42,18,13,39.85016025641024,0.5793650793650793,48.06201550387596,1007.751937984495,23.994093761535595,0
1463,4,3,4,52,0.05357142857142857,0.07142857142857142,0.9285714285714286,56,1150,1000,150,0.8695652173913043,13,10,3,348.02326727792575,0.45083874458874457,0.42424578527063006,0.18074756784434198,126567.38281249987,-2390.321180555569,124177.0616319443,1456,0,456.73214285714283,39,17,14,39.68253968253969,0.5801282051282053,48.43749999999999,1006.249999999999,25.801282051282026,0
1464,4,4,3,53,0.07142857142857142,0.05357142857142857,0.9464285714285714,56,1100,800,300,0.7272727272727273,14,8,6,349.9782036450219,0.448823051948052,0.4254474839581237,0.1827663952368444,126792.09183673437,-2325.106292517037,124466.98554421733,1457,0,457.44642857142856,41,15,16,39.40233451536644,0.5792682926829269,48.2142857142857,1007.1428571428545,24.564459930313525,0
1465,4,1,0,54,0.018518518518518517,0.0,1.0,54,1000,600,400,0.6,14,6,8,361.2639102264038,0.44509230142091777,0.4434554190737936,0.1880356821225711,126656.87715851999,-1648.6882601295636,125008.18889839042,1458,0,475.2962962962963,40,14,17,39.25731953558809,0.5794270833333335,48.34857723577235,1006.6056910569099,25.16514227642275,0
1466,4,2,1,55,0.03571428571428571,0.017857142857142856,0.9821428571428571,56,1700,1300,400,0.7647058823529411,21,13,8,350.6234927645081,0.4480113636363636,0.44907522391766697,0.18534106857620722,127285.57254395579,-2270.4066604275085,125015.16588352827,1459,0,459.2857142857143,37,19,20,38.87941884892607,0.5909346846846846,47.72478070175438,1009.1008771929821,27.27299668089141,0
1467,4,7,7,55,0.11290322580645161,0.11290322580645161,0.8870967741935484,62,1850,1200,650,0.6486486486486487,25,12,13,311.43532702273194,0.4563282213996122,0.40613538154269135,0.16994171702919247,128561.83992097821,-4386.483250384617,124175.3566705936,1460,0,414.5967741935484,42,20,13,38.56714599656028,0.595734126984127,46.46317829457364,1014.1472868217047,24.146363971945352,0
1468,4,0,2,53,0.0,0.03636363636363636,0.9636363636363636,55,2000,1200,800,0.6,28,12,16,359.93539427605356,0.4463945005611672,0.4632367632367629,0.19267129928894636,127793.20987654322,-1800.5401234567912,125992.66975308642,1461,1,468.3272727272727,38,17,17,38.12385531135531,0.5942982456140351,47.22222222222222,1011.1111111111112,26.608187134502927,0
1469,4,1,1,53,0.018518518518518517,0.018518518518518517,0.9814814814814815,54,1400,1000,400,0.7142857142857143,18,10,8,370.3064792750858,0.44642441183321685,0.45901148899088806,0.19845070647031457,127839.4088205024,-1332.0477214142852,126507.36109908811,1462,0,477.35185185185185,37,17,17,37.81431837073981,0.5965653153153154,47.176535087719294,1011.2938596491223,27.332266477003305,0
1470,4,1,0,54,0.018518518518518517,0.0,1.0,54,1550,1100,450,0.7096774193548387,20,11,9,372.4430175953442,0.4453761938038667,0.4702395995041935,0.20097991709280033,128116.77781865576,-1256.7601329255158,126860.01768573024,1463,0,478.3333333333333,37,17,18,37.475969349073964,0.5993806306306306,46.90241228070175,1012.3903508771931,27.361901375059272,0
1471,4,1,1,54,0.01818181818181818,0.01818181818181818,0.9818181818181818,55,850,700,150,0.8235294117647058,10,7,3,365.3463087126965,0.4470117845117845,0.4591161672290811,0.19827419094070226,128344.14439777612,-1621.982108411571,126722.16228936455,1464,0,470.6181818181818,36,19,19,37.42289953322959,0.603587962962963,46.677927927927925,1013.2882882882881,28.14689689689689,0
1472,4,3,1,56,0.05263157894736842,0.017543859649122806,0.9824561403508771,57,1700,1300,400,0.7647058823529411,21,13,8,356.0018206511265,0.4505926274018379,0.4645441309173839,0.19620343819885577,128957.11343277465,-2218.206566403669,126738.90686637099,1465,0,455.05263157894734,38,19,19,37.03389607657516,0.6060855263157894,46.073717948717956,1015.7051282051295,26.72908232118762,0
1473,4,2,2,56,0.034482758620689655,0.034482758620689655,0.9655172413793104,58,1200,800,400,0.6666666666666666,16,8,8,349.86253862507516,0.45149601734220607,0.4652581791062351,0.1941593431346359,129230.80800165047,-2556.4717325815554,126674.33626906891,1466,0,448.17241379310343,35,23,20,36.911046291026366,0.6145833333333333,45.80439814814815,1016.7824074074082,29.05092592592595,0
1474,4,2,0,58,0.034482758620689655,0.0,1.0,58,1450,1100,350,0.7586206896551724,18,11,7,349.3335700994202,0.45130696713046986,0.4706208621277628,0.19561345742613648,129584.09857521014,-2546.384843321323,127037.71373188881,1467,0,448.86206896551727,35,23,18,36.565140578227414,0.6181547619047618,45.45717592592593,1018.171296296297,29.090608465608486,0
1475,4,1,0,59,0.01694915254237288,0.0,1.0,59,1750,1400,350,0.8,21,14,7,341.99017196999,0.45251315020455873,0.46380917482038275,0.19304691128142015,129899.05698147471,-2915.1598328332116,126983.8971486415,1468,0,442.23728813559325,37,22,19,36.43233928507406,0.6173986486486488,45.14802631578946,1019.4078947368392,27.551564722617275,0
1476,4,0,0,59,0.0,0.0,1.0,59,1400,1000,400,0.7142857142857143,18,10,8,344.4048276854578,0.452233099551919,0.4606753741081149,0.19513548308089385,130044.5513391225,-2842.4057409233865,127202.1455981991,1469,1,443.23728813559325,38,21,19,36.223202751300605,0.6170504385964912,45.005341880341874,1019.9786324786312,26.841542959963977,0
1477,4,1,1,59,0.016666666666666666,0.016666666666666666,0.9833333333333333,60,2000,1500,500,0.75,25,15,10,335.7647309346717,0.45357815442561206,0.4585538011084387,0.19238574726951846,130480.80490037614,-3237.646901709414,127243.15799866672,1470,0,436.8333333333333,38,22,21,36.001821255533464,0.621436403508772,44.57799145299145,1021.6880341880336,26.88652721547457,0
1478,4,1,1,59,0.016666666666666666,0.016666666666666666,0.9833333333333333,60,1600,1100,500,0.6875,21,11,10,337.51693670466545,0.4533662900188324,0.4602968848003346,0.1937987404872046,130562.68376981512,-3186.576585214419,127376.1071846007,1471,0,437.7,38,22,16,35.874233396055466,0.6222587719298246,44.49786324786324,1022.0085470085465,26.894961763382803,0
1479,4,0,0,59,0.0,0.0,1.0,59,1450,1000,450,0.6896551724137931,19,10,9,343.5236376849777,0.4516608221313072,0.46735705292880536,0.19657654844430295,130430.5411280394,-2838.80520929516,127591.73591874425,1472,2,446.1186440677966,37,22,21,35.85453341920711,0.6227477477477477,44.627192982456144,1021.4912280701755,27.60787102892366,0
1480,4,0,0,59,0.0,0.0,1.0,59,1350,900,450,0.6666666666666666,18,9,9,344.1505717376752,0.4512346580946815,0.4710078370960735,0.19736241095528578,130514.55886667047,-2816.6679891889803,127697.89087748149,1473,3,447.1186440677966,37,22,19,35.753456200593774,0.6235923423423423,44.54495614035088,1021.8201754385962,27.616761498340438,0
1481,4,2,4,57,0.03278688524590164,0.06557377049180328,0.9344262295081968,61,1750,1500,250,0.8571428571428571,20,15,5,333.7774928940946,0.4527322404371585,0.45686397196846484,0.19347279455365662,130928.0395507812,-3459.8334418402783,127468.20610894093,1474,0,433.42622950819674,39,22,19,35.60061492790502,0.624198717948718,44.140625,1023.4374999999997,26.24198717948717,0
1482,4,0,0,57,0.0,0.0,1.0,57,1300,1200,100,0.9230769230769231,14,12,2,360.0898134812946,0.4477600250626566,0.4748474382147143,0.20563575562106542,130351.21588059414,-2012.3709972993774,128338.84488329476,1475,5,463.87719298245617,35,22,22,35.511943216593004,0.625892857142857,44.704861111111114,1021.1805555555557,29.176587301587304,0
1483,4,0,0,57,0.0,0.0,1.0,57,2050,1300,750,0.6341463414634146,28,13,15,365.2271571405979,0.44764254385964913,0.4761175827085615,0.20995357222072253,130607.69120049111,-1859.7048484295005,128747.98635206162,1476,6,464.87719298245617,36,21,19,35.12058866732767,0.6264467592592593,44.45382882882883,1022.1846846846853,28.394019019019037,0
1484,4,1,1,57,0.017241379310344827,0.017241379310344827,0.9827586206896551,58,1650,1000,650,0.6060606060606061,23,10,13,355.9873781536576,0.44906357128453317,0.4680301841144576,0.20614553252453036,130890.4560687414,-2280.929943750443,128609.52612499097,1477,0,457.8448275862069,38,20,20,35.070386997981494,0.625548245614035,44.17735042735043,1023.290598290599,26.928699955015762,0
1485,4,0,2,55,0.0,0.03508771929824561,0.9649122807017544,57,1600,1100,500,0.6875,21,11,10,361.6831081463057,0.44743368838763575,0.4747065030998552,0.20914718862373316,130835.79881656799,-1935.7803254437958,128900.0184911242,1478,8,466.87719298245617,38,19,20,34.980028195488714,0.625,44.230769230769226,1023.0769230769225,26.92307692307691,0
1486,4,1,0,56,0.017857142857142856,0.0,1.0,56,1050,1000,50,0.9523809523809523,11,10,1,370.38880645801044,0.44735524891774897,0.48358964741185373,0.21426521717667044,130850.90033712289,-1506.8582400354003,129344.04209708748,1479,0,475.60714285714283,37,19,21,34.742056049726735,0.6269707207207207,44.21600877192982,1023.1359649122801,27.65232337600757,0
1487,4,0,0,56,0.0,0.0,1.0,56,1450,900,550,0.6206896551724138,20,9,11,372.25064596766475,0.44679383116883115,0.48379580029997893,0.21581289002870685,130935.05333371795,-1451.8683633425799,129483.18497037537,1480,1,476.60714285714283,37,19,21,34.60913506178131,0.6278153153153154,44.133771929824555,1023.4649122807008,27.661213845424346,0
1488,4,0,0,56,0.0,0.0,1.0,56,2100,1600,500,0.7619047619047619,26,16,10,378.8597696420218,0.4459889069264069,0.48579812206572726,0.22048396429986505,131081.84633875737,-1267.6723783694986,129814.17396038787,1481,2,477.60714285714283,38,18,21,34.29121022430879,0.6274671052631579,43.99038461538461,1024.0384615384614,26.948380566801617,0
1489,4,0,0,56,0.0,0.0,1.0,56,1450,900,550,0.6206896551724138,20,9,11,375.09636493523294,0.44571834415584416,0.4786831520929542,0.21907272470943273,131218.63928153997,-1356.0730787493571,129862.56620279062,1482,3,478.60714285714283,38,18,21,34.24900069516856,0.6288377192982456,43.85683760683761,1024.5726495726499,26.96243814664868,0
1490,4,0,0,56,0.0,0.0,1.0,56,1650,1100,550,0.6666666666666666,22,11,11,380.2863716100012,0.4450487012987013,0.4860339687769668,0.22324354697028118,131414.71021274655,-1204.8640212090916,130209.84619153745,1483,4,479.60714285714283,36,20,21,33.91749038989565,0.6345486111111112,43.66554054054054,1025.337837837838,28.481606606606608,0
1491,4,1,2,55,0.017543859649122806,0.03508771929824561,0.9649122807017544,57,1200,600,600,0.5,18,6,12,375.88960318480747,0.4456323099415205,0.48066779499482437,0.22254609963048744,131739.10307774466,-1496.1281640368406,130242.97491370782,1484,0,472.17543859649123,38,19,18,33.70212821313352,0.634046052631579,43.349358974358964,1026.6025641025622,27.015856950067427,0
1492,4,0,0,55,0.0,0.0,1.0,55,1250,900,350,0.72,16,9,7,381.8624374749954,0.44361672278338943,0.4821309914705951,0.22531328435630527,131609.2511638194,-948.6741112650283,130660.57705255436,1485,6,488.8545454545455,37,18,18,33.68018451236018,0.6345720720720722,43.475877192982445,1026.0964912280683,27.732337600758605,0
1493,4,0,0,55,0.0,0.0,1.0,55,1800,1400,400,0.7777777777777778,22,14,8,379.82570182287066,0.4433361391694725,0.47998290963469414,0.22477422379682124,131721.78578985826,-993.7360534010629,130728.0497364572,1486,7,489.8545454545455,37,18,18,33.61861781670584,0.6356981981981983,43.36622807017543,1026.535087719297,27.744191559981,0
1494,4,1,0,56,0.017857142857142856,0.0,1.0,56,1750,1400,350,0.8,21,14,7,377.06355003652334,0.44349296536796534,0.482722007722008,0.2250217959895379,132040.89506172817,-1242.4382716049618,130798.45679012321,1487,0,482.0892857142857,38,18,20,33.367117117117104,0.637061403508772,43.05555555555554,1027.777777777776,27.04678362573095,0
1495,4,0,0,56,0.0,0.0,1.0,56,900,700,200,0.7777777777777778,11,7,4,373.58830955594993,0.4429518398268398,0.47531188040001693,0.22363191046857406,132156.90239800359,-1325.545247395829,130831.35715060776,1488,1,483.0892857142857,39,17,20,33.339348428055246,0.6364850427350428,42.942708333333336,1028.2291666666674,26.364850427350447,0
1496,4,0,0,56,0.0,0.0,1.0,56,1550,1200,350,0.7741935483870968,19,12,7,373.78494995426,0.4425933441558441,0.4762682496274111,0.2240667159015428,132210.46142578128,-1316.343858506941,130894.11756727434,1489,2,484.0892857142857,39,17,20,33.28026351328539,0.6370192307692308,42.890625,1028.4375000000002,26.370192307692314,0
1497,4,0,0,56,0.0,0.0,1.0,56,1500,1100,400,0.7333333333333333,19,11,8,374.9322224002566,0.4421875,0.47881555153707045,0.22507329460197747,132264.03130425332,-1281.9905598958524,130982.04074435747,1490,3,485.0892857142857,39,17,20,33.19672995780589,0.6375534188034189,42.83854166666666,1028.6458333333321,26.375534188034155,0
1498,4,0,0,56,0.0,0.0,1.0,56,900,300,600,0.3333333333333333,15,3,12,378.9970899428565,0.44233630952380953,0.48237427501120855,0.22783653422797304,132317.61203342024,-1170.402018229159,131147.21001519109,1491,4,486.0892857142857,39,17,20,33.03813995477708,0.6380876068376069,42.786458333333336,1028.8541666666674,26.38087606837609,0
1499,4,0,0,56,0.0,0.0,1.0,56,1850,1200,650,0.6486486486486487,25,12,13,381.97527089789367,0.44237689393939394,0.48533120241575367,0.2304808724128808,132457.56842635447,-1080.7992273234026,131376.76919903106,1492,5,487.0892857142857,35,21,21,32.82034705044599,0.6470238095238096,42.650462962962955,1029.3981481481471,29.411375661375633,0
1500,4,0,0,56,0.0,0.0,1.0,56,900,600,300,0.6666666666666666,12,6,6,381.7197027060232,0.4418290043290043,0.48671600406154814,0.23102757652194464,132571.9062601453,-1078.9382710413045,131492.967989104,1493,6,488.0892857142857,36,20,21,32.711636595589574,0.6461226851851851,42.539414414414416,1029.8423423423426,28.606731731731738,0
1501,4,0,0,56,0.0,0.0,1.0,56,1350,900,450,0.6666666666666666,18,9,9,364.5982763888223,0.4420995670995671,0.44457169542786046,0.22012963604528138,132480.48159105855,-1539.5689513477923,130940.91263971075,1494,7,489.0892857142857,38,18,19,33.244473848069745,0.6414473684210527,42.62820512820513,1029.4871794871797,27.09176788124157,2
1502,4,0,0,56,0.0,0.0,1.0,56,850,400,450,0.47058823529411764,13,4,9,348.72700784922733,0.4420995670995671,0.3732598215132106,0.20047527007092633,130609.02970261696,-2054.8199036057,128554.20979901125,1495,8,490.0892857142857,42,14,14,35.540888551837455,0.6163194444444444,44.45251937984496,1022.1899224806195,24.33785529715761,8
1503,4,0,0,56,0.0,0.0,1.0,56,1400,900,500,0.6428571428571429,19,9,10,345.3073080152964,0.441801948051948,0.36781449691324597,0.19889097784811174,130683.32732407906,-2174.8184078480886,128508.50891623097,1496,9,491.0892857142857,42,14,14,35.553094200151634,0.6170634920634921,44.37984496124031,1022.4806201550385,24.344776670358062,0
1504,4,1,0,57,0.017543859649122806,0.0,1.0,57,1800,1200,600,0.6666666666666666,24,12,12,337.3351571978519,0.4427866541353383,0.37172986740936476,0.19576063846835973,130972.46334876539,-2563.6766975308683,128408.78665123452,1497,0,483.4561403508772,44,13,16,35.464721845318856,0.6171875,44.09722222222222,1023.6111111111109,23.263888888888882,0
1505,4,0,1,56,0.0,0.017543859649122806,0.9824561403508771,57,1000,700,300,0.7,13,7,6,338.48360545938095,0.44319131161236425,0.3741801601127075,0.19679031068190492,131043.55709876528,-2528.780864197542,128514.77623456773,1498,1,484.4561403508772,44,13,17,35.363537710255024,0.6178977272727273,44.02777777777777,1023.8888888888877,23.270202020201992,0
1506,4,0,1,55,0.0,0.017857142857142856,0.9821428571428571,56,1000,800,200,0.8,12,8,4,338.48360545938095,0.4426948051948052,0.3673649329509343,0.19679031068190492,131043.55709876528,-2328.780864197543,128714.77623456773,1499,2,489.67857142857144,44,12,17,35.363537710255024,0.6178977272727273,44.02777777777777,1023.8888888888877,23.270202020201992,0
1507,4,1,3,53,0.017857142857142856,0.05357142857142857,0.9464285714285714,56,900,400,500,0.4444444444444444,14,4,10,343.4995838330436,0.44358089826839825,0.3813702900515046,0.2008193288050868,131256.95408950612,-2182.658179012351,129074.29591049378,1500,0,490.44642857142856,44,12,19,35.01965302249932,0.6200284090909092,43.81944444444444,1024.722222222222,23.289141414141408,0
1508,4,0,0,53,0.0,0.0,1.0,53,1400,900,500,0.6428571428571429,19,9,10,353.7420281528296,0.4406597726173198,0.40542372881355937,0.20623300060293434,131150.23389274697,-1321.33005401234,129828.90383873462,1501,1,516.8490566037735,41,12,19,34.86511299435029,0.623221544715447,43.923611111111114,1024.3055555555559,24.983062330623316,0
1509,4,0,0,53,0.0,0.0,1.0,53,1150,700,450,0.6086956521739131,16,7,9,354.30745295590407,0.4401457426221577,0.4089560527892666,0.20697326776745384,131226.4581758632,-1301.0975686570655,129925.36060720614,1502,2,517.8490566037735,41,12,19,34.77359282210174,0.6239837398373982,43.84920634920636,1024.6031746031767,24.9903213317848,0
1510,4,0,0,53,0.0,0.0,1.0,53,1800,1500,300,0.8333333333333334,21,15,6,355.1301967783784,0.4400399129172714,0.4163216404921617,0.2078668590888065,131302.70460325366,-1274.0889353426237,130028.61566791104,1503,3,518.8490566037735,41,12,21,34.675471074113524,0.6247459349593494,43.7748015873016,1024.9007936507962,24.99758033294625,0
1511,4,2,2,53,0.03636363636363636,0.03636363636363636,0.9636363636363636,55,1400,900,500,0.6428571428571429,19,9,10,343.37680465604103,0.44239618406285075,0.40705070217194605,0.20368443008565557,131811.58002842384,-1947.7872456852656,129863.79278273857,1504,0,500.94545454545454,41,14,16,34.46355827134256,0.6298272357723574,43.27876984126986,1026.8849206349241,25.04597367402254,0
1512,4,1,1,53,0.018518518518518517,0.018518518518518517,0.9814814814814815,54,950,800,150,0.8421052631578947,11,8,3,360.09564109593373,0.4406155369205684,0.3936788734013925,0.20746259210596885,130693.35322381239,-1375.8815389582041,129317.47168485419,1505,0,511.2037037037037,41,13,16,35.16491623815529,0.61864837398374,44.37003968253967,1022.5198412698389,24.939508323654607,3
1513,4,0,0,53,0.0,0.0,1.0,53,1250,700,550,0.56,18,7,11,367.71072479948407,0.43837687469762937,0.39785919823037075,0.21233553901932345,130781.8193225759,-982.0244852600874,129799.79483731581,1506,1,520.8867924528302,40,13,16,34.880567974830285,0.62109375,44.28353658536586,1022.865853658537,25.571646341463428,0
1514,4,1,2,52,0.018518518518518517,0.037037037037037035,0.962962962962963,54,850,700,150,0.8235294117647058,10,7,3,360.42189447483196,0.44058641975308643,0.39331122166943056,0.20915821750232375,130972.46334876542,-1358.9313271604956,129613.53202160493,1507,0,512.2222222222222,41,13,16,34.87392582541836,0.6214430894308943,44.09722222222222,1023.6111111111111,24.96612466124661,0
1515,4,0,0,52,0.0,0.0,1.0,52,1350,1000,350,0.7407407407407407,17,10,7,375.34377268075457,0.43669086224233283,0.3998184875234059,0.21674326288191598,130781.8193225759,-582.3717074823085,130199.4476150936,1508,3,532.7307692307693,40,12,16,34.68537837390298,0.62109375,44.28353658536586,1022.865853658537,25.571646341463428,0
1516,4,1,1,52,0.018867924528301886,0.018867924528301886,0.9811320754716981,53,1500,1200,300,0.8,18,12,6,370.8558680367769,0.4379384373488147,0.40680122860903944,0.21549732872407293,131023.2426303854,-881.8523242630482,130141.39030612235,1509,0,523.6603773584906,41,12,17,34.555474806201545,0.6219512195121951,44.047619047619044,1023.8095238095231,24.97096399535422,0
1517,4,1,0,53,0.018867924528301886,0.0,1.0,53,1700,1300,400,0.7647058823529411,21,13,8,394.70593708079457,0.43831640058055155,0.45016012325860855,0.23254840978135502,131553.0018851956,-213.6325894623585,131339.36929573325,1510,0,523.8301886792453,37,16,18,33.40770628473706,0.6340090090090089,43.53070175438597,1025.8771929824575,27.7264106211475,0
1518,4,1,0,54,0.018518518518518517,0.0,1.0,54,1650,1100,550,0.6666666666666666,22,11,11,386.57695686751765,0.4391014442115071,0.45033092172680167,0.22970030057628674,131876.23844875465,-603.9370114690482,131272.3014372856,1511,0,515.1111111111111,38,16,17,33.28912696761665,0.6354166666666665,43.21581196581197,1027.1367521367536,27.029914529914567,0
1519,4,0,0,54,0.0,0.0,1.0,54,1450,1000,450,0.6896551724137931,19,10,9,385.1923859568495,0.43876659678546476,0.45148903062796597,0.22920853857432338,131931.11257213826,-636.2279932792669,131294.884578859,1512,1,516.1111111111111,38,16,18,33.26920410427066,0.6359649122807017,43.162393162393165,1027.3504273504277,27.03553756185336,0
1520,4,1,0,55,0.01818181818181818,0.0,1.0,55,1600,1000,600,0.625,22,10,12,388.2712166542014,0.4391414141414141,0.4601753950068561,0.23374353134228262,132371.20361328134,-720.8143446180386,131650.3892686633,1513,0,507.7090909090909,39,16,19,32.74549127779467,0.6386217948717948,42.73437500000001,1029.0625000000007,26.386217948717967,0
1521,4,1,2,54,0.017857142857142856,0.03571428571428571,0.9642857142857143,56,550,300,250,0.5454545454545454,8,3,5,381.1923578669786,0.4392857142857143,0.45508575177282773,0.23088644404313832,132600.90115453306,-1090.6991160290215,131510.20203850404,1514,0,499.625,36,20,20,32.69598731685982,0.646412037037037,42.51126126126127,1029.954954954956,28.609859859859892,0
1522,4,0,0,54,0.0,0.0,1.0,54,1500,900,600,0.6,21,9,12,386.9637364921831,0.43807506405776847,0.45885929754903754,0.23441731048631292,132606.53941883144,-537.2156046382004,132069.32381419325,1515,2,517.3148148148148,35,19,20,32.541694759710836,0.6485119047619048,42.50578703703704,1029.976851851852,29.427910052910057,0
1523,4,0,0,54,0.0,0.0,1.0,54,850,500,350,0.5882352941176471,12,5,7,387.99747506627955,0.4379149196366177,0.4601997503121098,0.2352300768453602,132636.34366426614,-507.4867112482787,132128.85695301785,1516,3,518.3148148148148,35,19,19,32.48501872659176,0.6488095238095237,42.476851851851855,1030.0925925925928,29.431216931216937,0
1524,4,0,0,54,0.0,0.0,1.0,54,1750,1400,350,0.8,21,14,7,383.899907432291,0.43803866759841603,0.45498886865007093,0.23324595969491804,132716.9124360849,-609.9979202174911,132106.91451586742,1517,4,519.3148148148148,36,18,19,32.50933515482697,0.6475694444444444,42.39864864864866,1030.4054054054068,28.62237237237241,0
1525,4,0,0,54,0.0,0.0,1.0,54,900,500,400,0.5555555555555556,13,5,8,385.15047714372355,0.4374272070812952,0.46093996552812255,0.234731522488259,132832.97444403885,-567.8633024916626,132265.11114154718,1518,5,520.3148148148148,36,18,19,32.360170417303884,0.6487268518518519,42.286036036036045,1030.8558558558575,28.63488488488493,0
1526,4,0,0,54,0.0,0.0,1.0,54,1750,1400,350,0.8,21,14,7,384.03052547549635,0.4369904495690659,0.45544375157470385,0.23521869685374147,133019.3905817174,-583.2987072945607,132436.09187442283,1519,6,521.3148148148148,37,17,19,32.20131802721087,0.6486486486486487,42.10526315789473,1031.5789473684206,27.880512091038394,0
1527,4,0,0,54,0.0,0.0,1.0,54,1100,600,500,0.5454545454545454,16,6,10,384.1739809151377,0.436378989051945,0.44773186019334954,0.23620050178668783,133160.81781173055,-568.6157038704179,132592.20210786012,1520,7,522.3148148148148,37,17,19,32.05529144091503,0.6500563063063063,41.968201754385966,1032.1271929824563,27.89532954006639,0
1528,4,1,1,54,0.01818181818181818,0.01818181818181818,0.9818181818181818,55,1700,1500,200,0.8823529411764706,19,15,4,378.23437127375036,0.43670033670033676,0.4389997179655911,0.23415661781159833,133417.02849915996,-907.4188216816401,132509.60967747832,1521,0,513.8,38,17,19,31.95105136159944,0.6507675438596492,41.72008547008547,1033.1196581196584,27.18735942420154,0
1529,4,0,0,54,0.0,0.0,1.0,54,2100,1600,500,0.7619047619047619,26,16,10,386.37952390158637,0.4348503377591428,0.4485726545827924,0.2386665084700725,133334.25931633054,-496.4744731171127,132837.78484321342,1522,9,524.3148148148148,38,16,19,31.82390262404744,0.6499451754385965,41.80021367521367,1032.7991452991446,27.17892487629328,0
1530,4,0,0,54,0.0,0.0,1.0,54,1650,1200,450,0.7272727272727273,21,12,9,381.76378772112344,0.43465379687863964,0.4426523297491034,0.2366935483870968,133472.22222222248,-609.0277777777528,132863.19444444473,1523,10,525.3148148148148,39,15,19,31.804435483870964,0.6495726495726495,41.66666666666668,1033.3333333333353,26.495726495726547,0
1531,4,0,0,54,0.0,0.0,1.0,54,1500,1000,500,0.6666666666666666,20,10,10,379.2177313801885,0.434180642907058,0.44785650588068715,0.23599292518109863,133610.2564673278,-666.5243306669564,132943.73213666084,1524,11,526.3148148148148,38,16,19,31.73159725810341,0.6526864035087719,41.53311965811966,1033.8675213675215,27.207040035987408,0
1532,4,0,0,54,0.0,0.0,1.0,54,1150,800,350,0.6956521739130435,15,8,7,379.9885826491665,0.43405689494525973,0.4502765934430748,0.23714058058601994,133714.51958550356,-638.0018446180472,133076.51774088552,1525,12,527.3148148148148,39,15,19,31.60701396582401,0.6519764957264957,41.43229166666667,1034.2708333333342,26.51976495726498,0
1533,4,0,0,54,0.0,0.0,1.0,54,1350,600,750,0.4444444444444444,21,6,15,375.19350898893015,0.43323433496389474,0.43827160493827155,0.2353486556385107,133903.125,-752.0833333333319,133151.04166666666,1526,13,528.3148148148148,39,15,19,31.54186795491143,0.6538461538461539,41.25,1035.0,26.53846153846154,0
1534,4,0,0,54,0.0,0.0,1.0,54,1350,800,550,0.5925925925925926,19,8,11,378.5547472823205,0.43299411833216866,0.44241307634164717,0.23875185546419636,134103.04712803237,-646.9309769317086,133456.11615110066,1527,14,529.3148148148148,40,14,19,31.25449699110413,0.6541666666666666,41.056910569105696,1035.7723577235781,25.894308943089452,0
1535,4,0,0,54,0.0,0.0,1.0,54,2100,1800,300,0.8571428571428571,24,18,6,380.22741253364103,0.4326956673654787,0.45047204066811886,0.24118903033850358,134313.65258774534,-586.0534817238461,133727.5991060215,1528,15,530.3148148148148,40,14,19,31.000204248366,0.65625,40.853658536585364,1036.5853658536582,25.914634146341456,0
1536,4,0,0,54,0.0,0.0,1.0,54,1400,1000,400,0.7142857142857143,18,10,8,383.61256321646,0.4326811087817377,0.44832091990069234,0.24403881515341405,134419.01728468516,-487.0352468768485,133931.9820378083,1529,16,531.3148148148148,40,14,19,30.806954788971638,0.6572916666666666,40.75203252032521,1036.9918699187,25.924796747967502,0
1537,4,0,0,54,0.0,0.0,1.0,54,1750,1500,250,0.8571428571428571,20,15,5,385.1518468342846,0.4318221523410202,0.4408985885205776,0.24646673518763101,134633.92710387893,-428.96976778796136,134204.95733609097,1530,17,532.3148148148148,38,16,19,30.55190961498866,0.662828947368421,40.54487179487179,1037.820512820512,27.31106612685558,0
1538,4,0,0,54,0.0,0.0,1.0,54,1000,600,400,0.6,14,6,8,380.1999261880515,0.4309923130677848,0.43665329080495296,0.24422756659759864,134772.56059838174,-551.8964816641314,134220.6641167176,1531,18,533.3148148148148,38,16,19,30.54176527077544,0.6641995614035088,40.411324786324776,1038.3547008546993,27.325123706702612,0
1539,4,0,0,54,0.0,0.0,1.0,54,1850,1500,350,0.8108108108108109,22,15,7,383.4110211901972,0.43050460051246214,0.4453357100415922,0.24723400331919598,134911.26543209865,-454.70679012347074,134456.55864197516,1532,19,534.3148148148148,38,16,19,30.319741532976828,0.6655701754385965,40.27777777777777,1038.888888888888,27.339181286549685,0
1540,4,0,1,53,0.0,0.018518518518518517,0.9814814814814815,54,1350,1000,350,0.7407407407407407,17,10,7,385.1686457161354,0.4296165269042627,0.4439475457775035,0.24893923035753135,134994.5225751515,-400.86851212653875,134593.65406302497,1533,20,535.3148148148148,38,16,19,30.190877625852426,0.6663925438596492,40.19764957264957,1039.209401709401,27.34761583445792,0
1541,4,0,0,53,0.0,0.0,1.0,53,1150,800,350,0.6956521739130435,15,8,7,385.0072324945819,0.4289126753749395,0.4388347605443128,0.24931779189250056,135064.61724175353,-199.8291015624946,134864.78814019103,1534,21,541.9056603773585,39,14,19,30.125033403480643,0.6653311965811965,40.130208333333336,1039.479166666667,26.653311965811973,0
1542,4,0,0,53,0.0,0.0,1.0,53,1250,900,350,0.72,16,9,7,386.9295422171613,0.42858006773101115,0.44263549921659284,0.2513153949221809,135172.9180230034,-139.5209418402826,135033.39708116313,1535,22,542.9056603773585,39,14,19,29.96688119803665,0.6663995726495726,40.026041666666664,1039.895833333333,26.66399572649572,0
1543,4,0,0,53,0.0,0.0,1.0,53,1550,1000,550,0.6451612903225806,21,10,11,385.82960492076177,0.4277939042089986,0.4444683749251386,0.25135552931139254,135281.26220703125,-160.8968098958327,135120.3653971354,1536,23,543.9056603773585,39,14,20,29.887290978271757,0.6674679487179487,39.921875,1040.3125,26.674679487179485,0
1544,4,0,0,53,0.0,0.0,1.0,53,1250,700,550,0.56,18,7,11,385.0705893611812,0.4275217706821481,0.4410020834238413,0.25123906708875515,135335.4505750869,-177.25965711804758,135158.19091796884,1537,24,544.9056603773585,39,14,20,29.852942403310298,0.6680021367521367,39.86979166666667,1040.5208333333342,26.680021367521388,0
1545,4,0,0,53,0.0,0.0,1.0,53,1100,800,300,0.7272727272727273,14,8,6,382.42924203253693,0.42705309627479443,0.4404127075245101,0.25008069282651263,135416.7534722223,-242.53472222221416,135174.2187500001,1538,25,545.9056603773585,39,14,20,29.840539097945015,0.6688034188034189,39.79166666666667,1040.8333333333342,26.68803418803421,0
1546,4,0,3,50,0.0,0.05660377358490566,0.9433962264150944,53,1750,1200,550,0.6857142857142857,23,12,11,358.82330212244585,0.4268263183357523,0.3052552868665015,0.2194310028744086,132960.14817964222,-930.9031714537697,132029.24500818845,1539,26,546.9056603773585,41,12,11,32.910895216108756,0.641260162601626,42.16269841269841,1031.3492063492063,25.154858691444055,8
1547,4,0,0,50,0.0,0.0,1.0,50,1700,1300,400,0.7647058823529411,21,13,8,369.3901276584706,0.42612244897959184,0.29362463907603487,0.22496854785296092,132806.71788391293,-188.50190539177197,132618.21597852116,1540,27,573.1,41,9,11,32.79274943856273,0.6397357723577235,42.311507936507944,1030.753968253969,25.1403406891212,0
1548,4,0,0,50,0.0,0.0,1.0,50,1450,1000,450,0.6896551724137931,19,10,9,367.03971242615296,0.4255697278911565,0.2924706324593547,0.22407742856722307,132897.10020619267,-244.29731160986887,132652.8028945828,1541,28,574.1,42,8,12,32.762428343200824,0.6391369047619047,42.22383720930233,1031.104651162792,24.550110741971235,0
1549,4,0,0,50,0.0,0.0,1.0,50,1400,1100,300,0.7857142857142857,17,11,6,367.70713716213294,0.4248044217687075,0.2909562276911517,0.22523648919609127,133022.02109999396,-217.37068836007847,132804.6504116339,1542,29,575.1,42,8,14,32.6196458763855,0.6403769841269842,42.10271317829457,1031.5891472868213,24.56164636397194,0
1550,4,0,0,50,0.0,0.0,1.0,50,1200,1000,200,0.8333333333333334,14,10,4,368.60626006660925,0.42421768707482993,0.2970122958340977,0.2264414330443015,133129.95455262862,-185.49306990357798,132944.46148272505,1543,30,576.1,43,7,14,32.48799473909585,0.6400193798449612,41.99810606060606,1032.0075757575762,24.000176180408747,0
1551,4,0,0,50,0.0,0.0,1.0,50,1400,900,500,0.6428571428571429,19,9,10,373.6380925079919,0.4237925170068027,0.30057404251502384,0.23002159543741596,133209.2346107682,-45.59113511659541,133163.64347565162,1544,31,577.1,44,6,14,32.27849283941759,0.6394412878787878,41.9212962962963,1032.314814814815,23.461700336700343,0
1552,4,0,1,49,0.0,0.02,0.98,50,1300,900,400,0.6923076923076923,17,9,8,376.90281324780324,0.4233503401360544,0.3015784753363231,0.23218046230458583,133233.1318587105,43.18844307269609,133276.32030178318,1545,32,578.1,44,6,14,32.17021674140508,0.6396780303030303,41.898148148148145,1032.407407407407,23.463804713804702,0
1553,4,1,0,50,0.02,0.0,1.0,50,1550,1300,250,0.8387096774193549,18,13,5,378.2544888132206,0.423078231292517,0.312384622277982,0.23436656527855235,133448.30354080925,95.48396776404996,133543.7875085733,1546,0,578.4,44,6,17,31.91911610956776,0.6418087121212122,41.68981481481481,1033.24074074074,23.48274410774409,0
1554,4,0,0,50,0.0,0.0,1.0,50,1450,1200,250,0.8275862068965517,17,12,5,380.47971516211635,0.4227465986394558,0.3108827085852479,0.2365840033376468,133579.8828125,164.897869513032,133744.78068201302,1547,1,579.4,39,11,17,31.729477361279052,0.6506410256410255,41.5625,1033.75,26.506410256410255,0
1555,4,0,0,50,0.0,0.0,1.0,50,1300,900,400,0.6923076923076923,17,9,8,378.09155928338487,0.42185374149659866,0.3121518987341776,0.23637522663112315,133779.9390589568,116.21315192742611,133896.15221088423,1548,2,580.4,41,9,15,31.590429612581506,0.649390243902439,41.36904761904761,1034.5238095238085,25.23228803716606,0
1556,4,0,0,50,0.0,0.0,1.0,50,1000,700,300,0.7,13,7,6,378.09155928338487,0.42185374149659866,0.3121518987341776,0.23637522663112315,133779.9390589568,116.21315192742611,133896.15221088423,1549,3,581.4,41,9,15,31.590429612581506,0.649390243902439,41.36904761904761,1034.5238095238085,25.23228803716606,0
1557,4,0,0,50,0.0,0.0,1.0,50,1050,800,250,0.7619047619047619,13,8,5,355.32957135914455,0.42185374149659866,0.2621308858739022,0.1996537905439502,129718.50419723731,-768.6807992084188,128949.8233980289,1550,4,582.4,40,10,17,36.27585461558925,0.6104166666666666,45.32520325203253,1018.6991869918717,25.46747967479679,8
1558,4,2,2,50,0.038461538461538464,0.038461538461538464,0.9615384615384616,52,1200,800,400,0.6666666666666666,16,8,8,343.81799614886853,0.4256378833584716,0.2621947656369845,0.19539920763322935,130163.68762581897,-1449.4763498287125,128714.21127599027,1551,0,560.9615384615385,42,10,17,36.117375684487065,0.6118551587301586,44.88856589147288,1020.4457364341101,24.296327057955004,0
1559,4,1,0,51,0.0196078431372549,0.0,1.0,51,1100,800,300,0.7272727272727273,14,8,6,367.15701201475633,0.4223692810457516,0.3014468408475066,0.20991104972622132,130395.54172092056,-624.7973886620833,129770.74433225847,1552,0,572.9411764705883,39,12,18,35.28652473227945,0.6188568376068374,44.66145833333336,1021.3541666666702,26.188568376068467,0
1560,4,0,1,50,0.0,0.0196078431372549,0.9803921568627451,51,1050,600,450,0.5714285714285714,15,6,9,366.4217481797362,0.421781045751634,0.30692970358377725,0.21021037132416515,130528.56445312544,-634.2990451388454,129894.26540798659,1553,1,573.9411764705883,39,12,17,35.17031940197077,0.6201923076923075,44.53125000000002,1021.8750000000035,26.20192307692317,0
1561,4,0,0,50,0.0,0.0,1.0,50,1400,1200,200,0.8571428571428571,16,12,4,373.2746337005335,0.42098639455782316,0.3099184952978058,0.21493611579507263,130671.89554569365,-244.69921104536434,130427.1963346483,1554,2,556.76,38,12,17,34.84979101358412,0.6233552631578947,44.39102564102564,1022.4358974358977,26.906207827260467,0
1562,4,0,0,50,0.0,0.0,1.0,50,1550,1400,150,0.9032258064516129,17,14,3,374.8638388015153,0.4205867346938776,0.3120085513590549,0.21698806650249192,130874.7409396702,-187.95844184027146,130686.78249782993,1555,3,557.76,39,11,17,34.60341799857478,0.62366452991453,44.192708333333336,1023.2291666666672,26.236645299145312,0
1563,4,0,1,49,0.0,0.02,0.98,50,1300,800,500,0.6153846153846154,18,8,10,370.4347962304373,0.42024659863945574,0.3096551724137928,0.2156154222463842,131088.00048828128,-288.0886501736111,130799.91183810767,1556,4,558.76,39,11,17,34.50066541213168,0.625801282051282,43.984375,1024.0625000000002,26.258012820512825,0
1564,4,0,0,49,0.0,0.0,1.0,49,1400,1200,200,0.8571428571428571,16,12,4,376.9824338700372,0.41834963151927435,0.3075508288221933,0.21970398744754085,131136.55495516476,87.23553126598222,131223.79048643075,1557,5,570.9591836734694,38,11,18,34.283839226730656,0.628015350877193,43.93696581196581,1024.252136752137,26.954003598740446,0
1565,4,1,0,50,0.02,0.0,1.0,50,1450,1000,450,0.6896551724137931,19,10,9,368.1550412629633,0.4188945578231293,0.31016465422612494,0.21694000167565314,131559.0823086601,-312.7526502493975,131246.3296584107,1558,0,560.52,36,14,17,34.0825100622027,0.6359953703703705,43.52477477477478,1025.9009009009014,28.497247247247262,0
1566,4,0,0,50,0.0,0.0,1.0,50,1300,900,400,0.6923076923076923,17,9,8,362.84899275582893,0.41818877551020406,0.30750208159866776,0.2146707587683498,131711.6845642485,-441.7095843378074,131269.9749799107,1559,1,561.52,38,12,17,34.064494865389946,0.6337719298245614,43.37606837606837,1026.4957264957252,27.013045434098032,0
1567,4,0,0,50,0.0,0.0,1.0,50,1400,900,500,0.6428571428571429,19,9,10,361.0863912017788,0.41789115646258507,0.31145115988765193,0.2143992265980666,131848.80566741535,-478.2381154576793,131370.56755195768,1560,2,562.52,38,12,18,33.97135823017441,0.6351425438596492,43.24252136752136,1027.0299145299139,27.0271030139451,0
1568,4,1,0,51,0.0196078431372549,0.0,1.0,51,1200,1000,200,0.8333333333333334,14,10,4,356.7245519001326,0.41862745098039217,0.30879869678367844,0.2133861410457154,132130.12695312485,-773.1879340277926,131356.93901909707,1561,0,552.4705882352941,39,12,20,33.7998142519419,0.6362179487179489,42.96874999999999,1028.1249999999989,26.362179487179457,0
1569,4,0,0,51,0.0,0.0,1.0,51,1100,800,300,0.7272727272727273,14,8,6,355.95985174249876,0.41844771241830064,0.31032510248832157,0.2132303189564287,132183.68055555545,-789.5833333333367,131394.0972222221,1562,1,553.4705882352941,39,12,20,33.7655321447866,0.6367521367521367,42.916666666666664,1028.3333333333326,26.36752136752135,0
1570,4,0,0,51,0.0,0.0,1.0,51,1050,600,450,0.5714285714285714,15,6,9,357.4596324464018,0.4180228758169935,0.3066083634182857,0.2144323457336436,132237.24500868065,-746.104600694439,131491.1404079862,1563,2,554.4705882352941,39,12,20,33.67303018027142,0.6372863247863249,42.864583333333336,1028.5416666666674,26.37286324786327,0
1571,4,0,0,51,0.0,0.0,1.0,51,1450,1200,250,0.8275862068965517,17,12,5,355.70769426177446,0.41772875816993466,0.30897688628959696,0.21383596446887088,132317.61203342024,-786.7214626736047,131530.89057074665,1564,3,555.4705882352941,39,12,20,33.637174749417824,0.6380876068376069,42.786458333333336,1028.8541666666674,26.38087606837609,0
1572,4,0,0,51,0.0,0.0,1.0,51,1350,1000,350,0.7407407407407407,17,10,7,358.71048309578634,0.4183496732026144,0.31621229557710206,0.2164430825409718,132457.56842635458,-697.1186717678337,131760.44975458676,1565,4,556.4705882352941,35,16,20,33.419065287459716,0.6470238095238094,42.65046296296296,1029.398148148148,29.411375661375658,0
1573,4,0,0,51,0.0,0.0,1.0,51,1350,1000,350,0.7407407407407407,17,10,7,358.09300187469665,0.4176470588235294,0.31800933454973346,0.216755886440888,132576.73852237666,-705.0395447530739,131871.6989776236,1566,5,557.4705882352941,35,16,20,33.31507080242751,0.6482142857142856,42.53472222222223,1029.861111111112,29.4246031746032,0
1574,4,1,1,51,0.019230769230769232,0.019230769230769232,0.9807692307692307,52,1250,800,450,0.64,17,8,9,350.56746171061485,0.4196911136249371,0.3124165021215819,0.21382046049038497,132861.99787202748,-1084.58132964044,131777.41654238704,1567,0,547.7307692307693,36,16,19,33.222282905516124,0.6490162037037037,42.25788288288289,1030.968468468469,28.638013013013026,0
1575,4,0,0,51,0.0,0.0,1.0,51,1200,900,300,0.75,15,9,6,358.6657495389833,0.41705882352941176,0.3149412073039932,0.21796595004406613,132725.77649444874,-679.1619780949914,132046.61451635376,1568,7,559.4705882352941,35,16,19,33.15045958291213,0.649702380952381,42.3900462962963,1030.439814814815,29.44113756613757,0
1576,4,1,0,52,0.019230769230769232,0.0,1.0,52,1200,900,300,0.75,15,9,6,350.3520825580979,0.4191804927099045,0.31539553003207255,0.21485446990611068,133065.2506391527,-1076.0624644915138,131989.1881746612,1569,0,549.6923076923077,36,16,20,33.02385760023286,0.6510416666666666,42.060810810810814,1031.756756756757,28.65990990990992,0
1577,4,0,1,51,0.0,0.019230769230769232,0.9807692307692307,52,1200,700,500,0.5833333333333334,17,7,10,312.57502001989866,0.41847347913524385,0.2810989010989011,0.19135322395669296,133000.07952442317,-2077.2532852633053,130922.82623915987,1570,1,550.6923076923077,40,12,14,34.06342364532019,0.6432291666666667,42.12398373983739,1031.5040650406495,25.787601626016237,4
1578,4,1,0,52,0.019230769230769232,0.0,1.0,52,1250,700,550,0.56,18,7,11,312.4605130624002,0.41780574409250876,0.2871547400796959,0.19182128474217697,133104.9278290037,-2081.9931918831658,131022.93463712052,1571,0,551.6538461538462,40,12,15,33.961575077145284,0.6442708333333336,42.02235772357722,1031.9105691056893,25.797764227642233,0
1579,4,0,1,51,0.0,0.019230769230769232,0.9807692307692307,52,1100,700,400,0.6363636363636364,15,7,8,309.76357027105297,0.4180099924585219,0.2843188858006227,0.190567449015329,133183.59116803802,-2148.915059653662,131034.67610838436,1572,1,552.6538461538462,40,12,16,33.952569656394616,0.6450520833333334,41.946138211382106,1032.2154471544702,25.805386178861756,0
1580,4,0,0,51,0.0,0.0,1.0,51,1550,1200,350,0.7741935483870968,19,12,7,309.2763810527621,0.41730392156862745,0.289844835572024,0.19067039026068328,133262.2777447285,-1957.0250016524783,131305.252743076,1573,2,562.4901960784314,40,11,18,33.88656496062991,0.6458333333333335,41.86991869918698,1032.5203252032506,25.813008130081265,0
1581,4,0,0,51,0.0,0.0,1.0,51,1250,600,650,0.48,19,6,13,309.2367724732974,0.4170098039215686,0.2912696666936805,0.19091519330945597,133314.74837233115,-1954.8354980501163,131359.91287428103,1574,3,563.4901960784314,40,11,18,33.83520304402022,0.6463541666666668,41.819105691056905,1032.7235772357712,25.818089430894283,0
1582,4,0,0,51,0.0,0.0,1.0,51,2000,1500,500,0.75,25,15,10,307.8335778169719,0.4169281045751634,0.2855254461335104,0.19046173771884267,133395.34837372418,-1987.2865291950382,131408.06184452915,1575,4,564.4901960784314,41,10,18,33.7909944300394,0.6455792682926831,41.741071428571416,1033.035714285712,25.195993031358828,0
1583,4,0,0,51,0.0,0.0,1.0,51,1100,600,500,0.5454545454545454,16,6,10,299.0259128007482,0.41673202614379085,0.19870359881687683,0.18454315671149743,133301.0334613895,-2227.9073583849804,131073.12610300453,1576,5,565.4901960784314,43,8,14,34.11250573131591,0.6417151162790697,41.83238636363637,1032.670454545455,24.01559196617337,3
1584,4,0,0,51,0.0,0.0,1.0,51,1100,700,400,0.6363636363636364,15,7,8,297.8932803738667,0.41660130718954247,0.18236934129709126,0.17991718546860522,132493.3138288751,-2306.2264231824415,130187.08740569267,1577,6,566.4901960784314,44,7,15,34.948436610006915,0.6323390151515151,42.61574074074074,1029.5370370370367,23.398569023569017,4
1585,4,0,0,51,0.0,0.0,1.0,51,1250,800,450,0.64,17,8,9,300.24005713745953,0.4165686274509804,0.1857791129399069,0.181679538383179,132564.8191015091,-2239.7462277091727,130325.07287379995,1578,7,567.4901960784314,44,7,17,34.816504825271224,0.6330492424242424,42.546296296296305,1029.8148148148164,23.40488215488219,0
1586,4,0,0,51,0.0,0.0,1.0,51,1050,700,350,0.6666666666666666,14,7,7,303.9198991340177,0.41627450980392156,0.18801964131865323,0.1847255356342155,132731.7397548013,-2132.0366083676104,130599.70314643369,1579,8,568.4901960784314,44,7,14,34.55480426513315,0.6347064393939392,42.38425925925927,1030.4629629629644,23.419612794612828,0
1587,4,0,1,50,0.0,0.0196078431372549,0.9803921568627451,51,1450,1000,450,0.6896551724137931,19,10,9,304.032987895483,0.41591503267973856,0.1908409852175108,0.18538353161162716,132851.03309327862,-2121.780692729749,130729.25240054887,1580,9,569.4901960784314,44,7,14,34.4326312795641,0.6358901515151514,42.268518518518526,1030.9259259259272,23.43013468013471,0
1588,4,0,0,50,0.0,0.0,1.0,50,1100,900,200,0.8181818181818182,13,9,4,309.3967717416105,0.4138095238095238,0.19328921974083224,0.18797019951538071,132714.93454610035,-1787.6855379074732,130927.24900819288,1581,20,581.7,43,7,14,34.43052492111632,0.6359011627906976,42.40056818181819,1030.3977272727284,23.962737843551825,0
1589,4,0,0,50,0.0,0.0,1.0,50,1450,800,650,0.5517241379310345,21,8,13,320.57637649547206,0.4133928571428571,0.22682926829268268,0.18776616337591945,131328.12500000015,-1565.0960959021904,129763.02890409796,1582,21,582.7,42,8,20,35.53523035230352,0.6235119047619047,43.75000000000001,1025.0000000000011,24.404761904761934,4
1590,4,0,0,50,0.0,0.0,1.0,50,1050,700,350,0.6666666666666666,14,7,7,322.16524001899967,0.4130527210884354,0.23213598969174343,0.18908232149806245,131406.26161882828,-1533.0940371141273,129873.16758171415,1583,22,583.7,40,10,20,35.415840684573965,0.6273437499999999,43.67378048780489,1025.3048780487823,25.632621951219555,0
1591,4,0,0,50,0.0,0.0,1.0,50,1550,1100,450,0.7096774193548387,20,11,9,321.48565840954694,0.4133418367346939,0.2380287270926198,0.18945695981578412,131562.604569453,-1540.9018895828867,130021.7026798701,1584,23,584.7,40,10,15,35.27592042265148,0.6289062499999998,43.52134146341465,1025.9146341463438,25.647865853658594,0
1592,4,0,0,50,0.0,0.0,1.0,50,1700,1000,700,0.5882352941176471,24,10,14,320.8142125532399,0.41343537414965986,0.2374539695109883,0.1899686503641754,131745.12215777655,-1546.8584754444978,130198.26368233205,1585,24,585.7,40,10,16,35.10959051013002,0.6307291666666666,43.34349593495936,1026.6260162601634,25.665650406504085,0
1593,4,1,1,50,0.0196078431372549,0.0196078431372549,0.9803921568627451,51,1200,1000,200,0.8333333333333334,14,10,4,315.23309554979704,0.4161928104575163,0.23784993383275843,0.1877440581143906,131964.43457301927,-1880.088557413681,130084.3460156056,1586,0,575.1960784313726,41,10,16,35.0325665411477,0.6313516260162599,43.12996031746033,1027.4801587301608,25.060491676345386,0
1594,4,0,0,50,0.0,0.0,1.0,50,1700,1300,400,0.7647058823529411,21,13,8,319.408621724641,0.41374149659863946,0.23445628595680423,0.19015663201271066,131949.6192104595,-1570.83079817916,130378.78841228034,1587,26,587.7,42,8,16,34.94018988336634,0.6297123015873014,43.14437984496126,1027.422480620158,24.46244001476567,0
1595,4,0,0,50,0.0,0.0,1.0,50,1200,800,400,0.6666666666666666,16,8,8,318.98380146234143,0.41300170068027214,0.22780542986425356,0.19052816249507443,132074.09410492174,-1574.1006775433984,130499.99342737834,1588,27,588.7,42,8,16,34.82611393916541,0.6309523809523809,43.0232558139535,1027.9069767441872,24.47397563676636,0
1596,4,0,0,50,0.0,0.0,1.0,50,1400,1000,400,0.7142857142857143,18,10,8,316.13944998081195,0.4131037414965986,0.2257632868450803,0.18932685345352057,132173.71627306088,-1642.934807102903,130530.78146595797,1589,28,589.7,42,8,17,34.79924456590023,0.6319444444444443,42.926356589147304,1028.2945736434137,24.483204134366993,0
1597,4,0,0,50,0.0,0.0,1.0,50,1500,900,600,0.6,21,9,12,316.1069977968748,0.41238095238095235,0.2285338242061663,0.1900665484816298,132324.91933719328,-1634.2334029212234,130690.68593427206,1590,29,590.7,43,7,18,34.6484315079,0.6320251937984496,42.77935606060608,1028.8825757575783,23.927501761804145,0
1598,4,1,0,51,0.0196078431372549,0.0,1.0,51,1700,1200,500,0.7058823529411765,22,12,10,311.5620971317052,0.4145098039215686,0.23422815326280988,0.18907124524567853,132672.39048134125,-1932.822004209056,130739.5684771322,1591,0,580.0980392156863,42,9,16,34.4173250564334,0.6369047619047619,42.44186046511628,1030.2325581395348,24.52934662236988,0
1599,4,0,0,51,0.0,0.0,1.0,51,1450,900,550,0.6206896551724138,20,9,11,311.1820197876762,0.4144281045751634,0.2303197912921633,0.18921788338718906,132747.2725966739,-1938.2871184123524,130808.98547826154,1592,1,581.0980392156863,42,9,17,34.352178341952666,0.6376488095238095,42.36918604651163,1030.5232558139537,24.536267995570327,0
1600,4,0,0,51,0.0,0.0,1.0,51,1850,1400,450,0.7567567567567568,23,14,9,311.22195598840847,0.4140359477124183,0.2275998540743116,0.1901276725389577,132922.07969022298,-1926.3460729523404,130995.73361727064,1593,2,582.0980392156863,42,9,17,34.17629831485311,0.6393849206349207,42.19961240310078,1031.2015503875973,24.552417866371364,0
1601,4,0,0,51,0.0,0.0,1.0,51,1250,700,550,0.56,18,7,11,314.84934758822044,0.41410130718954247,0.23242827095143848,0.19285881210726097,133022.02109999402,-1823.6206883600769,131198.40041163395,1594,3,583.0980392156863,42,9,17,33.982833928235934,0.6403769841269842,42.10271317829457,1031.5891472868218,24.56164636397195,0
1602,4,0,0,51,0.0,0.0,1.0,51,1250,1100,150,0.88,14,11,3,312.06246459704454,0.4142647058823529,0.2317488016611069,0.1919220192198454,133172.00363559905,-1888.4032660296652,131283.60036956938,1595,4,584.0980392156863,42,9,18,33.904822255601445,0.6418650793650793,41.95736434108528,1032.1705426356607,24.575489110372875,0
1603,4,1,1,51,0.019230769230769232,0.019230769230769232,0.9807692307692307,52,1550,1000,550,0.6451612903225806,21,10,11,312.7411748081659,0.4160539215686274,0.21109004371191165,0.1914946384027739,133007.82258845543,-2080.2574404504307,130927.565148005,1596,0,573.8461538461538,43,9,16,34.051397686587734,0.6388081395348838,42.116477272727266,1031.5340909090896,23.989164904862548,1
1604,4,0,0,51,0.0,0.0,1.0,51,1550,1300,250,0.8387096774193549,18,13,5,321.6708512519017,0.41429738562091506,0.21526987039882628,0.19651097583368182,132922.07969022292,-1648.5682951745746,131273.51139504835,1597,6,586.0980392156863,42,9,16,33.906925389964286,0.6393849206349207,42.19961240310077,1031.2015503875969,24.552417866371353,0
1605,4,0,0,51,0.0,0.0,1.0,51,1700,1000,700,0.5882352941176471,24,10,14,321.04880848126953,0.414281045751634,0.21043983170118863,0.19639330560199045,132972.0457003786,-1661.896633315302,131310.1490670633,1598,7,587.0980392156863,42,9,17,33.87295659526494,0.6398809523809523,42.151162790697676,1031.3953488372094,24.557032115171655,0
1606,4,0,1,50,0.0,0.0196078431372549,0.9803921568627451,51,1300,800,500,0.6153846153846154,18,8,10,318.0210275738942,0.4139542483660131,0.21131915677068935,0.1953243335445197,133122.0000676041,-1732.8809491617126,131389.11911844238,1599,8,588.0980392156863,42,9,17,33.801056338028175,0.6413690476190477,42.00581395348837,1031.9767441860463,24.57087486157253,0
1607,4,0,0,50,0.0,0.0,1.0,50,1250,900,350,0.72,16,9,7,328.08412334491493,0.41304421768707483,0.20382123744249347,0.20164016143950908,133147.00067791907,-1263.3166013160157,131883.68407660307,1600,9,597.98,42,8,18,33.51641473414078,0.6416170634920635,41.981589147286826,1032.0736434108535,24.573181985972703,0
1608,4,0,1,49,0.0,0.02,0.98,50,950,600,350,0.631578947368421,13,6,7,330.4054625049483,0.41255102040816327,0.20955054118510352,0.2035073645327091,133227.70047778945,-1196.1680010330347,132031.5324767564,1601,10,598.98,43,7,18,33.37575674188223,0.6409883720930232,41.9034090909091,1032.3863636363653,24.008985200845704,0
1609,4,0,0,49,0.0,0.0,1.0,49,1250,700,550,0.56,18,7,11,330.26208856049936,0.41284013605442177,0.20584726336814096,0.20379867271506943,133297.05363447242,-995.4073335436211,132301.6463009288,1602,11,609.0816326530612,42,7,18,33.31007006349506,0.6431051587301586,41.836240310077535,1032.6550387596926,24.587024732373635,0
1610,4,0,0,49,0.0,0.0,1.0,49,900,600,300,0.6666666666666666,12,6,6,329.49572864110866,0.412733843537415,0.21231687497248175,0.20387428688583112,133397.13588614014,-1009.2427025118192,132387.89318362833,1603,12,610.0816326530612,42,7,19,33.22976268642717,0.644097222222222,41.73934108527134,1033.0426356589187,24.596253229974256,0
1611,4,0,0,49,0.0,0.0,1.0,49,1100,700,400,0.6363636363636364,15,7,8,329.6038498472203,0.41271612811791386,0.2123272040255142,0.20408501713014665,133423.29993830388,-1004.6333362029003,132418.66660210097,1604,13,611.0816326530612,43,6,20,33.20080965475101,0.6429263565891471,41.71401515151517,1033.1439393939427,24.0266032417196,0
1612,4,0,0,49,0.0,0.0,1.0,49,850,500,350,0.5882352941176471,12,5,7,327.337922467781,0.41216695011337867,0.19736308912054024,0.20421890136006102,133702.97663336177,-1042.0362966984217,132660.94033666336,1605,14,612.0816326530612,41,8,18,32.97991606714629,0.6486280487804876,41.44345238095239,1034.2261904761913,25.225029036004667,1
1613,4,0,0,49,0.0,0.0,1.0,49,1150,700,450,0.6086956521739131,16,7,9,330.58729256968104,0.4116886337868481,0.20089046854696968,0.20719907773733554,133873.03948080057,-948.6548659936142,132924.38461480694,1606,15,613.0816326530612,42,7,18,32.72608458177278,0.6488095238095237,41.27906976744187,1034.8837209302335,24.640088593576987,0
1614,4,0,0,49,0.0,0.0,1.0,49,1450,1000,450,0.6896551724137931,19,10,9,324.2704518091642,0.41027140022675734,0.19172103306660904,0.20449126014089422,134098.7632673068,-1103.146689652047,132995.61657765473,1607,16,614.0816326530612,42,7,18,32.66442136776126,0.6510416666666665,41.061046511627914,1035.7558139534895,24.660852713178322,0
1615,4,0,0,49,0.0,0.0,1.0,49,1150,600,550,0.5217391304347826,17,6,11,327.4222529013234,0.4105017006802721,0.19304534383899452,0.2069029981099853,134174.0467820444,-1013.6862643470881,133160.36051769732,1608,17,615.0816326530612,42,7,19,32.507755019329096,0.6517857142857142,40.98837209302326,1036.0465116279074,24.66777408637875,0
1616,4,0,0,49,0.0,0.0,1.0,49,1150,700,450,0.6086956521739131,16,7,9,326.9449291098921,0.4101296768707483,0.1904303937563805,0.20702640715395482,134249.3514230666,-1021.5710631872969,133227.7803598793,1609,18,616.0816326530612,42,7,19,32.44506778868632,0.6525297619047619,40.91569767441861,1036.337209302326,24.67469545957919,0
1617,4,0,0,49,0.0,0.0,1.0,49,1350,800,550,0.5925925925925926,19,8,11,324.6716233474374,0.40972222222222227,0.18564941504552168,0.20617778030207362,134354.35677800758,-1075.7905762166856,133278.5662017909,1610,19,617.0816326530612,43,6,19,32.399372792595315,0.6521317829457364,40.81439393939395,1036.742424242426,24.110288935870372,0
1618,4,0,0,49,0.0,0.0,1.0,49,1050,700,350,0.6666666666666666,14,7,7,326.2613514552008,0.4088541666666667,0.19606593664581662,0.20788485063925644,134477.10525891028,-1025.0635796889198,133452.04167922135,1611,20,618.0816326530612,43,6,19,32.235936121001856,0.653343023255814,40.696022727272734,1037.2159090909104,24.12130021141652,0
1619,4,0,0,49,0.0,0.0,1.0,49,1500,1000,500,0.6666666666666666,20,10,10,325.8681894789952,0.4089781746031746,0.19660514301322896,0.20834848789427185,134602.24946460055,-1027.4413796118065,133574.80808498873,1612,21,619.0816326530612,41,8,20,32.121574251115376,0.657520325203252,40.57539682539682,1037.6984126984119,25.309717382888095,0
1620,4,0,0,49,0.0,0.0,1.0,49,1700,1400,300,0.8235294117647058,20,14,6,322.7570161407592,0.40837585034013607,0.1959456692375947,0.2070908751632767,134730.9630594135,-1102.927276234575,133628.03578317893,1613,22,620.0816326530612,41,8,20,32.07427536231884,0.6587906504065041,40.451388888888886,1038.194444444444,25.32181571815717,0
1621,4,0,0,49,0.0,0.0,1.0,49,650,200,450,0.3076923076923077,11,2,9,323.46466983312956,0.4085707199546485,0.19843458117051527,0.20769210027444981,134756.7131598009,-1082.1928539934584,133674.52030580744,1614,23,621.0816326530612,41,8,20,32.030304477992225,0.6590447154471545,40.4265873015873,1038.2936507936502,25.32423538521098,0
1622,4,0,0,49,0.0,0.0,1.0,49,1350,1000,350,0.7407407407407407,17,10,7,325.53889321183266,0.4081809807256236,0.20475222279187744,0.2094693714219221,134833.97822381248,-1021.2591923343609,133812.7190314781,1615,24,622.0816326530612,41,8,17,31.899636227592573,0.6598069105691058,40.35218253968253,1038.5912698412683,25.3314943863724,0
1623,4,0,1,48,0.0,0.02040816326530612,0.9795918367346939,49,1350,900,450,0.6666666666666666,18,9,9,326.09372376182245,0.40772037981859416,0.20905236395192173,0.2106644032302278,134978.38546361384,-996.8791313623099,133981.50633225153,1616,25,623.0816326530612,42,7,18,31.741693087156527,0.6597222222222223,40.21317829457364,1039.1472868217045,24.74160206718344,0
1624,4,0,1,47,0.0,0.020833333333333332,0.9791666666666666,48,1350,900,450,0.6666666666666666,18,9,9,328.5475239424262,0.4062592346335698,0.21714605991223057,0.2133726856235755,135169.04939058944,-718.1087018140719,134450.94068877536,1617,26,633.375,41,7,19,31.488504102270547,0.6631097560975611,40.0297619047619,1039.8809523809514,25.362950058071984,0
1625,4,0,0,47,0.0,0.0,1.0,47,1300,800,500,0.6153846153846154,18,8,10,333.7616129924733,0.40629818069688556,0.21758557524571143,0.2168496879842527,135184.14680621654,-376.14422218917184,134808.00258402736,1618,27,643.7446808510638,40,7,19,31.337950747581356,0.66484375,40.015243902439025,1039.9390243902437,25.998475609756092,0
1626,4,0,1,46,0.0,0.02127659574468085,0.9787234042553191,47,750,700,50,0.9333333333333333,8,7,1,338.1903736585956,0.406086185630589,0.2266316975140592,0.22053458888641422,135316.28515599185,-247.4669922004033,135068.81816379144,1619,28,644.7446808510638,40,7,19,31.09148108354496,0.6661458333333332,39.88821138211382,1040.447154471545,26.011178861788625,0
1627,4,0,1,45,0.0,0.021739130434782608,0.9782608695652174,46,1350,1100,250,0.8148148148148148,16,11,5,338.1215018348582,0.40608896940418676,0.21343487600078115,0.22113923510808564,135422.04231112447,-42.17913444376347,135379.86317668072,1620,29,643.5652173913044,40,6,19,30.988210310486245,0.6671874999999999,39.78658536585367,1040.8536585365866,26.021341463414664,0
1628,4,0,0,45,0.0,0.0,1.0,45,950,600,350,0.631578947368421,13,6,7,343.24546380602465,0.40612373737373736,0.20922830547492688,0.22428812484538901,135389.64979383704,294.3766276041865,135684.02642144123,1583,30,622.8666666666667,39,6,19,30.887069195609378,0.6685363247863247,39.81770833333334,1040.7291666666686,26.685363247863297,0
1629,4,0,0,45,0.0,0.0,1.0,45,1100,800,300,0.7272727272727273,14,8,6,341.7974489477767,0.4057449494949495,0.20593081823943438,0.223679234272111,135443.8598632814,258.87315538195946,135702.73301866336,1584,31,623.8666666666667,39,6,19,30.870880449648094,0.6690705128205128,39.76562500000001,1040.9375000000011,26.690705128205156,0
1630,4,0,0,45,0.0,0.0,1.0,45,1450,1000,450,0.6896551724137931,19,10,9,342.0404024793756,0.40475589225589226,0.2079171389833525,0.2246859358731144,135579.43250868074,274.72873263891375,135854.16124131964,1585,32,624.8666666666667,39,6,19,30.72989597919586,0.6704059829059827,39.63541666666668,1041.4583333333348,26.70405982905987,0
1631,4,0,0,45,0.0,0.0,1.0,45,1150,800,350,0.6956521739130435,15,8,7,342.0867516158833,0.4041456228956229,0.2134150947588258,0.2253986620330744,135687.93945312515,283.40928819445907,135971.3487413196,1586,33,625.8666666666667,39,6,19,30.62095914150503,0.6714743589743589,39.53125000000001,1041.8750000000011,26.71474358974362,0
1632,4,0,0,45,0.0,0.0,1.0,45,1600,1300,300,0.8125,19,13,6,342.5493018854298,0.4035563973063973,0.21632471800337472,0.22673501410511807,135850.78125000015,307.11805555557004,136157.8993055557,1587,34,626.8666666666667,39,6,20,30.447308819610978,0.673076923076923,39.37500000000001,1042.5000000000011,26.73076923076926,0
1633,4,0,0,45,0.0,0.0,1.0,45,850,700,150,0.8235294117647058,10,7,3,352.05599723303203,0.4035563973063973,0.1235182305166751,0.21396219869644612,132728.07004026978,362.3828895463763,133090.45292981615,1588,35,627.8666666666667,38,7,17,33.31842923794713,0.6439144736842104,42.387820512820525,1030.4487179487198,27.11707152496631,7
1634,4,0,0,45,0.0,0.0,1.0,45,950,700,250,0.7368421052631579,12,7,5,352.05599723303203,0.4037037037037037,0.1235182305166751,0.21396219869644612,132728.07004026978,345.54261176859836,133073.61265203837,1589,36,628.8666666666667,38,7,17,33.31842923794713,0.6439144736842104,42.387820512820525,1030.4487179487198,27.11707152496631,0
1635,4,0,0,45,0.0,0.0,1.0,45,1050,800,250,0.7619047619047619,13,8,5,350.8148838835176,0.403219696969697,0.12673600313281064,0.21352121039900943,132783.1210849042,316.45904101836715,133099.58012592257,1590,37,629.8666666666667,38,7,17,33.295109014892375,0.6444627192982455,42.334401709401725,1030.6623931623953,27.12269455690514,0
1636,4,0,0,45,0.0,0.0,1.0,45,900,600,300,0.6666666666666666,12,6,6,349.03800339100485,0.4032828282828283,0.12385295743504687,0.21259587479270323,132810.65088757421,271.1928829717562,133081.84377054597,1591,38,630.8666666666667,38,7,17,33.313251451077946,0.644736842105263,42.30769230769232,1030.7692307692328,27.125506072874547,0
1637,4,1,1,45,0.021739130434782608,0.021739130434782608,0.9782608695652174,46,900,600,300,0.6666666666666666,12,6,6,344.47660382972145,0.406219806763285,0.12400786682587617,0.2111198195748493,133042.01388888905,-34.0277777777583,133007.9861111113,1592,0,618.1304347826087,39,7,18,33.19870759289177,0.6452991452991452,42.08333333333334,1031.666666666668,26.45299145299149,0
1638,4,0,0,45,0.0,0.0,1.0,45,900,700,200,0.7777777777777778,11,7,4,354.2051565908203,0.40294612794612794,0.1241626959464126,0.2166981357241941,132975.889628534,420.149161735715,133396.03879026973,1593,40,632.8666666666667,38,7,18,33.01416511290657,0.6463815789473684,42.147435897435905,1031.4102564102575,27.142375168690986,0
1639,4,0,0,45,0.0,0.0,1.0,45,1250,800,450,0.64,17,8,9,338.1759354723711,0.40294612794612794,0.09094065978960253,0.1915026364493921,130023.43885633704,-196.56914203749312,129826.86971429955,1594,41,633.8666666666667,39,6,17,36.40343597861982,0.6151175213675213,45.02604166666668,1019.8958333333353,26.151175213675263,7
1640,4,0,0,45,0.0,0.0,1.0,45,950,800,150,0.8421052631578947,11,8,3,338.63940228486945,0.40246212121212116,0.08534966819806078,0.19228828668871295,130129.69970703135,-186.591254340263,129943.10845269109,1595,42,634.8666666666667,39,6,17,36.28392462140549,0.6161858974358974,44.92187500000001,1020.3125000000008,26.161858974358996,0
1641,4,0,0,45,0.0,0.0,1.0,45,600,300,300,0.5,9,3,6,336.56343128126304,0.40225168350168355,0.08769136558481372,0.1915010743143912,130209.4238281251,-235.25390624998553,129974.16992187512,1596,43,635.8666666666667,39,6,17,36.25612369871403,0.6169871794871794,44.84375000000001,1020.6250000000008,26.169871794871817,0
1642,4,1,0,46,0.021739130434782608,0.0,1.0,46,1150,900,250,0.782608695652174,14,9,5,334.7997362151592,0.40497181964573264,0.09945580160689138,0.19220129970783675,130555.17713758688,-458.0213758680508,130097.15576171884,1597,0,623.0217391304348,39,7,13,35.951249447898604,0.6204594017094017,44.505208333333336,1021.9791666666673,26.204594017094035,0
1643,4,0,0,46,0.0,0.0,1.0,46,1700,1400,300,0.8235294117647058,20,14,6,331.18591538256646,0.4044182769726248,0.10036851989653073,0.19078174562178835,130688.28125,-543.5763888888888,130144.70486111111,1598,1,624.0217391304348,39,7,13,35.90906003803315,0.6217948717948718,44.375,1022.5,26.21794871794872,0
1644,4,1,0,47,0.02127659574468085,0.0,1.0,47,1600,1400,200,0.875,18,14,4,327.23477147202436,0.4066836262719704,0.11764954331872657,0.19024179587886003,131041.8228753552,-823.7118076211354,130218.11106773406,1599,0,611.7234042553191,40,7,15,35.65322580645161,0.6236979166666667,44.02947154471544,1023.8821138211375,25.597052845528438,0
1645,4,0,0,47,0.0,0.0,1.0,47,1350,1000,350,0.7407407407407407,17,10,7,344.6515983143577,0.4067607153869874,0.1575027112845342,0.19099359102860314,129174.23575726867,-488.6845949728141,128685.55116229586,1600,1,612.7234042553191,38,9,17,37.101068488351736,0.6082785087719298,45.86004273504274,1016.5598290598296,26.751574448942883,5
1646,4,2,1,48,0.04081632653061224,0.02040816326530612,0.9795918367346939,49,1150,800,350,0.6956521739130435,15,8,7,330.5198475306771,0.41420422335600904,0.16309829987641544,0.18527305214793027,129625.34722222244,-1231.2471464314158,128394.10007579102,1601,0,588.6734693877551,39,10,15,37.002182214948185,0.6111111111111109,45.41666666666668,1018.3333333333351,26.111111111111157,0
1647,4,0,0,48,0.0,0.0,1.0,48,1100,700,400,0.6363636363636364,15,7,8,337.3417285669351,0.40919584810874704,0.16697930877671707,0.18875686033554465,129554.6392746914,-859.1628086419682,128695.47646604944,1602,1,601.9375,38,10,16,36.900295588904044,0.6121162280701754,45.486111111111114,1018.055555555556,26.79093567251463,0
1648,4,0,0,48,0.0,0.0,1.0,48,700,400,300,0.5714285714285714,10,4,6,337.3417285669351,0.409057328605201,0.16697930877671707,0.18875686033554465,129554.6392746914,-859.1628086419682,128695.47646604944,1603,2,602.9375,38,10,16,36.900295588904044,0.6121162280701754,45.486111111111114,1018.055555555556,26.79093567251463,0
1649,4,0,0,48,0.0,0.0,1.0,48,1250,900,350,0.72,16,9,7,339.0561526479438,0.4091866134751773,0.17162261380322996,0.1903746383595701,129690.63321827762,-805.5185733070208,128885.1146449706,1604,3,603.9375,38,10,16,36.71858611285923,0.613486842105263,45.35256410256411,1018.589743589745,26.80499325236171,0
1650,4,0,1,47,0.0,0.020833333333333332,0.9791666666666666,48,1000,600,400,0.6,14,6,8,340.5469994616371,0.4091681442080379,0.17523893140441027,0.1918770128685503,129826.69850107754,-757.5814750894808,129069.11702598806,1605,4,604.9375,38,10,16,36.542527169165204,0.6148574561403508,45.2190170940171,1019.1239316239319,26.819050832208735,0
1651,4,0,0,47,0.0,0.0,1.0,47,1450,1100,350,0.7586206896551724,18,11,7,340.47911679544507,0.4085144927536232,0.1981996040734071,0.1925078608232066,129962.8351230915,-550.0737362115566,129412.76138687994,1606,5,616.0425531914893,38,9,17,36.406162685107574,0.6162280701754386,45.085470085470085,1019.6581196581194,26.833108412055775,0
1652,4,1,0,48,0.020833333333333332,0.0,1.0,48,850,500,350,0.5882352941176471,12,5,7,334.2301174894326,0.41203088061465726,0.19768064911206373,0.19017344315687923,130209.42382812501,-896.017795138888,129313.40603298612,1607,0,604.1875,39,9,18,36.315659658433695,0.6169871794871795,44.84375,1020.6250000000001,26.1698717948718,0
1653,4,0,0,48,0.0,0.0,1.0,48,1300,1000,300,0.7692307692307693,16,10,6,330.01869827170157,0.41157838356973997,0.18753923825468255,0.18829783279896425,130317.12420784938,-998.5716105883358,129318.55259726105,1608,1,605.1875,38,10,19,36.31413274737539,0.6197916666666666,44.738247863247864,1021.0470085470087,26.869658119658123,0
1654,4,0,0,48,0.0,0.0,1.0,48,1250,900,350,0.72,16,9,7,327.78143662972025,0.41171690307328607,0.17576205165742986,0.187811496614141,130480.8049003761,-1046.1628634305025,129434.64203694559,1609,2,606.1875,38,10,20,36.20573216215274,0.621436403508772,44.57799145299145,1021.6880341880333,26.88652721547456,0
1655,4,0,0,48,0.0,0.0,1.0,48,1050,700,350,0.6666666666666666,14,7,7,327.44752781320176,0.4119015957446808,0.17024014842688473,0.1881495794948289,130589.98243343191,-1047.7266190006555,129542.25581443126,1610,3,607.1875,38,10,13,36.10392495035018,0.6225328947368421,44.47115384615385,1022.1153846153843,26.89777327935222,0
1656,4,0,0,48,0.0,0.0,1.0,48,1100,800,300,0.7272727272727273,14,8,6,328.778280508242,0.4114490986997636,0.1678911581949678,0.18952533057835677,130714.91021050367,-1004.7553168402567,129710.15489366342,1611,4,608.1875,39,9,14,35.94370734440256,0.6220619658119657,44.34895833333334,1022.6041666666682,26.2206196581197,0
1657,4,1,0,49,0.02040816326530612,0.0,1.0,49,1450,900,550,0.6206896551724138,20,9,11,320.7032822857239,0.4130172902494331,0.18281444167368588,0.18123809047417253,129943.77170138902,-1363.7098524305459,128580.06184895847,1612,0,596.7551020408164,39,10,19,36.92957362757116,0.6143162393162394,45.10416666666667,1019.5833333333344,26.14316239316242,8
1658,4,0,0,49,0.0,0.0,1.0,49,1300,900,400,0.6923076923076923,17,9,8,323.8222200126034,0.41248582766439906,0.18280011422401699,0.18337439885155565,130023.43885633671,-1379.1042751736163,128644.3345811631,1613,1,597.7551020408164,39,10,19,36.76941834337658,0.6151175213675215,45.026041666666664,1019.8958333333326,26.151175213675195,0
1659,4,0,0,49,0.0,0.0,1.0,49,1250,1000,250,0.8,15,10,5,322.7273704936353,0.4129109977324263,0.17649852917892295,0.1833780348814185,130156.27170138899,-1399.0017361111065,128757.26996527788,1614,2,598.7551020408164,39,10,20,36.66292364230296,0.6164529914529915,44.895833333333336,1020.4166666666675,26.164529914529936,0
1660,4,1,1,49,0.02,0.02,0.98,50,1700,1200,500,0.7058823529411765,22,12,10,312.7113982346929,0.41638605442176874,0.17541277103640351,0.17924745711810727,130496.11363110579,-1838.4755684447098,128657.63806266108,1615,0,587.76,40,10,13,36.575202241230684,0.6182291666666667,44.5630081300813,1021.7479674796746,25.543699186991866,0
1661,4,1,1,49,0.02,0.02,0.98,50,750,200,550,0.26666666666666666,13,2,11,315.7777737592748,0.4148894557823129,0.17187431639653972,0.18136933584791692,130574.00238160152,-1753.5264434199282,128820.47593818158,1616,0,588.74,40,10,14,36.418249312253494,0.6190104166666668,44.48678861788618,1022.052845528455,25.551321138211375,0
1662,4,0,0,49,0.0,0.0,1.0,49,1750,1500,250,0.8571428571428571,20,15,5,326.11631073476127,0.4126098356009071,0.16938858706956128,0.1873450375251449,130581.79253472213,-1283.0295138888944,129298.76302083324,1617,5,601.7551020408164,39,10,14,36.14621551841283,0.6207264957264957,44.479166666666664,1022.0833333333326,26.207264957264936,0
1663,4,1,1,49,0.02,0.02,0.98,50,700,300,400,0.42857142857142855,11,3,8,318.0594839477727,0.41500000000000004,0.16994040524433873,0.18403579795322844,130859.79327781074,-1675.7603361094668,129184.03294170127,1618,0,590.7,40,10,14,36.07158820023838,0.6218750000000001,44.20731707317073,1023.1707317073162,25.579268292682904,0
1664,4,1,0,50,0.02,0.0,1.0,50,750,400,350,0.5333333333333333,11,4,7,318.21480027099284,0.41264455782312925,0.16997418073485604,0.1843741679360701,130911.78882444311,-1668.3862532222902,129243.40257122082,1619,0,591.68,40,10,15,36.01518536908309,0.6223958333333334,44.15650406504065,1023.3739837398373,25.584349593495933,0
1665,4,0,2,48,0.0,0.04,0.96,50,1250,1000,250,0.8,15,10,5,319.9865353538696,0.4126615646258503,0.16927855512553402,0.18627985654309312,131093.8545694526,-1610.3463340273688,129483.50823542524,1620,1,592.68,40,10,16,35.78632033343259,0.62421875,43.978658536585364,1024.0853658536578,25.602134146341445,0
1666,4,0,0,48,0.0,0.0,1.0,48,1050,700,350,0.6666666666666666,14,7,7,335.096817587775,0.40757055260047287,0.1678412333820556,0.19404820549309007,130890.45606874135,-827.8049437504599,130062.65112499088,1621,2,617.9375,38,10,16,35.60481485348368,0.6255482456140351,44.177350427350426,1023.2905982905985,26.928699955015748,0
1667,4,2,1,49,0.04,0.02,0.98,50,1300,900,400,0.6923076923076923,17,9,8,321.5678498248398,0.41130952380952385,0.17544715447154524,0.18834688346883485,131328.12500000012,-1553.8194444444293,129774.3055555557,1622,0,594.18,40,10,17,35.5098238482385,0.6265624999999999,43.75000000000001,1025.000000000001,25.62500000000002,0
1668,4,0,0,49,0.0,0.0,1.0,49,950,700,250,0.7368421052631579,12,7,5,327.9137761691081,0.40865929705215415,0.17744063871990434,0.19152968541563833,131221.37586805565,-1194.1406249999914,130027.23524305566,1623,1,607.3061224489796,39,10,17,35.454791920835035,0.6271367521367521,43.85416666666667,1024.5833333333342,26.271367521367544,0
1669,4,0,1,48,0.0,0.02040816326530612,0.9795918367346939,49,1200,700,500,0.5833333333333334,17,7,10,328.45501258130724,0.40789753401360546,0.17925332547898765,0.19224680956498988,131301.43364800335,-1174.677191840282,130126.75645616307,1624,2,608.3061224489796,39,10,17,35.360237320865956,0.6279380341880343,43.776041666666664,1024.8958333333326,26.279380341880323,0
1670,4,0,0,48,0.0,0.0,1.0,48,950,700,250,0.7368421052631579,12,7,5,332.42171209754855,0.408346261820331,0.18489556865535173,0.19456854404091484,131301.43364800335,-870.5105251736154,130430.92312282974,1625,3,617.7708333333334,39,9,17,35.25860097570893,0.6279380341880343,43.776041666666664,1024.8958333333326,26.279380341880323,0
1671,4,0,0,48,0.0,0.0,1.0,48,1600,1100,500,0.6875,21,11,10,330.962890625,0.4072935135933806,0.18412760416666685,0.1946840533088234,131492.4391847468,-896.1737337432305,130596.26545100356,1626,4,618.7708333333334,38,10,18,35.10351562499999,0.631578947368421,43.589743589743584,1025.641025641025,26.99055330634276,0
1672,4,0,0,48,0.0,0.0,1.0,48,1350,1100,250,0.8148148148148148,16,11,5,332.4801587671737,0.407385859929078,0.18198899534819146,0.19585733033634345,131547.2334082108,-852.6309902111392,130694.60241799966,1627,5,619.7708333333334,38,10,19,35.009416441019226,0.6321271929824562,43.536324786324776,1025.8547008546993,26.99617633828156,0
1673,4,0,0,48,0.0,0.0,1.0,48,1200,600,600,0.5,18,6,12,328.81448523820427,0.40736739066193856,0.17878772499661677,0.1942134477558026,131648.6328125,-942.4045138888889,130706.22829861111,1628,6,620.7708333333334,39,9,16,35.00135336310733,0.6314102564102565,43.4375,1026.25,26.314102564102566,0
1674,4,0,0,48,0.0,0.0,1.0,48,1300,900,400,0.6923076923076923,17,9,8,328.5361148591669,0.4068040780141844,0.18242694805194826,0.19459446803196806,131755.55555555545,-942.7083333333437,130812.8472222221,1629,7,621.7708333333334,39,9,16,34.90090638528138,0.6324786324786326,43.33333333333333,1026.6666666666658,26.324786324786302,0
1675,4,0,1,47,0.0,0.020833333333333332,0.9791666666666666,48,800,600,200,0.75,10,6,4,330.322142695705,0.40702570921985815,0.18086410360451755,0.1959275380682465,131809.03320312485,-892.1115451389045,130916.92165798595,1630,8,622.7708333333334,39,9,16,34.801261242983706,0.6330128205128207,43.28124999999999,1026.8749999999989,26.330128205128176,0
1676,4,0,0,47,0.0,0.0,1.0,47,1300,1000,300,0.7692307692307693,16,10,6,331.0855012775204,0.4071268886833179,0.1654654525052872,0.19665680979496067,131862.5217013887,-668.4461805555758,131194.07552083314,1631,9,603.6170212765958,39,8,17,34.727856659905335,0.6335470085470087,43.22916666666666,1027.0833333333317,26.335470085470043,0
1677,4,1,1,47,0.020833333333333332,0.020833333333333332,0.9791666666666666,48,600,400,200,0.6666666666666666,8,4,4,337.30856226165815,0.40856789302600477,0.16400304414003064,0.19596577025512923,131015.81090124912,-759.2788993819963,130256.53200186712,1632,0,592.0208333333334,40,8,14,35.42162993845542,0.6234375000000001,44.05487804878048,1023.780487804877,25.594512195121926,6
1678,4,0,0,47,0.0,0.0,1.0,47,1450,1100,350,0.7586206896551724,18,11,7,349.9788389808385,0.4072617946345976,0.17246402850444764,0.20342649369264695,131034.66932508671,-228.1277126736203,130806.54161241309,1633,1,601.2553191489362,39,8,14,35.078276019941,0.6252670940170941,44.03645833333333,1023.8541666666658,26.25267094017092,0
1679,4,0,0,47,0.0,0.0,1.0,47,1700,1400,300,0.8235294117647058,20,14,6,351.2242621455559,0.40737742830712304,0.17246288387227993,0.20485998777813705,131168.01757812474,-186.1219618055843,130981.89561631915,1634,2,602.2553191489362,39,8,14,34.91161616161616,0.6266025641025643,43.906249999999986,1024.374999999998,26.26602564102559,0
1680,4,1,2,46,0.020833333333333332,0.041666666666666664,0.9583333333333334,48,1300,900,400,0.6923076923076923,17,9,8,341.1922027003793,0.41008237293144206,0.15731853883133606,0.20067971492162084,131488.33007812488,-627.3437500000156,130860.98632812487,1635,0,590.6875,39,9,14,34.845368677635584,0.6298076923076924,43.59374999999999,1025.624999999999,26.2980769230769,0
1681,4,0,0,46,0.0,0.0,1.0,46,2000,1500,500,0.75,25,15,10,354.5788409475187,0.4051630434782609,0.15308008771770854,0.207979129445745,131382.88498064133,117.11821535538706,131500.00319599672,1636,4,617.0217391304348,38,8,16,34.608604279560915,0.6304824561403508,43.69658119658119,1025.2136752136746,26.979307242465122,0
1682,4,1,1,46,0.02127659574468085,0.02127659574468085,0.9787234042553191,47,1000,800,200,0.8,12,8,4,343.94350862592603,0.40679925994449584,0.15925318074467043,0.20324666434249444,131666.88484243842,-338.8993961323334,131327.9854463061,1637,0,604.8723404255319,40,7,14,34.594803115820035,0.6299479166666666,43.41971544715447,1026.3211382113825,25.658028455284562,1
1683,4,0,1,45,0.0,0.021739130434782608,0.9782608695652174,46,900,600,300,0.6666666666666666,12,6,6,347.5309237114998,0.40646135265700484,0.17620511098771918,0.2056479121505483,131719.04047070196,-44.71203896490613,131674.32843173706,1638,1,616.4782608695652,40,6,14,34.45017820017818,0.63046875,43.36890243902439,1026.5243902439024,25.663109756097562,0
1684,4,0,0,45,0.0,0.0,1.0,45,1550,1200,350,0.7741935483870968,19,12,7,349.37594614554365,0.4054292929292929,0.17121596482327117,0.20679278974560555,131728.82080078125,204.57628038194406,131933.3970811632,1639,2,617.6,39,6,15,34.39296888212413,0.6322115384615385,43.359375,1026.5625,26.322115384615383,0
1685,4,0,0,45,0.0,0.0,1.0,45,1200,900,300,0.75,15,9,6,352.384258170217,0.4050294612794613,0.1739455828317671,0.20901347876305626,131809.03320312485,289.4856770833187,132098.51888020817,1640,3,618.6,39,6,15,34.23488537228647,0.6330128205128207,43.28124999999999,1026.8749999999989,26.330128205128176,0
1686,4,0,1,44,0.0,0.022222222222222223,0.9777777777777777,45,900,600,300,0.6666666666666666,12,6,6,350.7642068071018,0.40364057239057244,0.1706369319141754,0.20908090031130214,131996.2904188364,259.9148220485713,132256.20524088497,1641,4,619.6,39,6,15,34.087789322520685,0.6348824786324789,43.098958333333314,1027.6041666666636,26.348824786324705,0
1687,4,0,0,44,0.0,0.0,1.0,44,850,600,250,0.7058823529411765,11,6,5,353.07643027419914,0.4012949260042283,0.17553905489332333,0.2102499089750443,131958.55391418256,518.2910320329776,132476.84494621554,1642,5,633.7727272727273,38,6,15,34.066410176423695,0.6362390350877194,43.13568376068374,1027.457264957262,27.038349077822684,0
1688,4,0,0,44,0.0,0.0,1.0,44,500,300,200,0.6,7,3,4,353.07643027419914,0.4012949260042283,0.17553905489332333,0.2102499089750443,131958.55391418256,518.2910320329776,132476.84494621554,1643,6,634.7727272727273,38,6,15,34.066410176423695,0.6362390350877194,43.13568376068374,1027.457264957262,27.038349077822684,0
1689,4,0,0,44,0.0,0.0,1.0,44,1050,800,250,0.7619047619047619,13,8,5,318.69816656258706,0.4014380725863284,0.10481581279273744,0.18267909729876003,130496.11363110582,-482.2255684447099,130013.8880626611,1644,7,635.7727272727273,40,4,13,36.42227803196075,0.6182291666666667,44.5630081300813,1021.7479674796748,25.54369918699187,8
1690,4,0,1,43,0.0,0.022727272727272728,0.9772727272727273,44,1250,800,450,0.64,17,8,9,318.0890276187637,0.40122885835095135,0.10399038113835268,0.18257438708529047,130548.03688280792,-494.82037808182235,130053.2165047261,1645,8,636.7727272727273,40,4,14,36.38540837974012,0.61875,44.51219512195122,1021.9512195121956,25.54878048780489,0
1691,4,0,1,42,0.0,0.023255813953488372,0.9767441860465116,43,1400,1200,200,0.8571428571428571,16,12,4,324.16140750740385,0.3992017349575489,0.10910392464082741,0.1860940648949761,130555.17713758691,-135.81000434027163,130419.36713324665,1646,14,652.3953488372093,39,4,14,36.22305320558556,0.6204594017094017,44.505208333333336,1021.9791666666675,26.20459401709404,0
1692,4,3,3,42,0.06666666666666667,0.06666666666666667,0.9333333333333333,45,1000,400,600,0.4,16,4,12,307.73111131158083,0.41003787878787884,0.10197497361676477,0.17858096774538174,130972.46334876526,-939.1396604938427,130033.32368827141,1647,0,623.8,41,4,14,36.2222976028946,0.6214430894308944,44.097222222222214,1023.6111111111098,24.96612466124658,0
1693,4,0,0,42,0.0,0.0,1.0,42,450,300,150,0.6666666666666666,6,3,3,327.96441329566414,0.39601480836236935,0.10935454160754743,0.18818114056226906,130535.38795976693,162.19238530936843,130697.58034507629,1648,16,669.3571428571429,38,4,14,36.14588778532845,0.621984649122807,44.52457264957265,1021.901709401709,26.892150247413394,0
1694,4,0,0,42,0.0,0.0,1.0,42,1500,1200,300,0.8,18,12,6,329.3508777659289,0.3966439217963608,0.10396356546285279,0.18998630539987588,130741.54188368049,211.96831597221774,130953.51019965271,1649,17,670.3571428571429,39,3,14,35.90216948462009,0.6223290598290598,44.322916666666664,1022.7083333333328,26.223290598290586,0
1695,4,1,0,43,0.023255813953488372,0.0,1.0,43,1550,1300,250,0.8387096774193549,18,13,5,322.96627076010145,0.39964008859357697,0.10473770571252561,0.1880145066695285,131093.8545694526,-132.22133402736966,130961.63323542524,1650,0,655.7441860465116,40,3,16,35.71003274784164,0.62421875,43.978658536585364,1024.0853658536578,25.602134146341445,0
1696,4,1,2,42,0.022727272727272728,0.045454545454545456,0.9545454545454546,44,800,400,400,0.5,12,4,8,318.5934298367374,0.4027043692741367,0.0997782705099779,0.1866047231900889,131328.12499999985,-431.9444444444597,130896.1805555554,1651,0,641.8181818181819,41,3,16,35.5860433604336,0.625,43.74999999999999,1024.9999999999989,24.99999999999997,0
1697,4,0,1,41,0.0,0.023809523809523808,0.9761904761904762,42,950,700,250,0.7368421052631579,12,7,5,331.5521357915191,0.3993418505613628,0.10113480121613483,0.19365479855376388,131221.37586805565,301.34548611111984,131522.72135416677,1652,2,668.047619047619,39,3,16,35.36159685509015,0.6271367521367521,43.85416666666667,1024.5833333333342,26.271367521367544,0
1698,4,1,0,42,0.023809523809523808,0.0,1.0,42,1600,1100,500,0.6875,21,11,10,324.66851133162356,0.4024753193960511,0.10860314881435951,0.19122819973647281,131541.7534722221,141.493055555549,131683.24652777766,1653,0,663.3333333333334,39,3,17,35.215272136474425,0.6303418803418804,43.541666666666664,1025.8333333333326,26.303418803418783,0
1699,4,0,1,41,0.0,0.023809523809523808,0.9761904761904762,42,950,600,350,0.631578947368421,13,6,7,321.52973743038194,0.4018462059620596,0.10467419290948721,0.18987177126152005,131640.8109012491,65.28707284022579,131706.09797408932,1654,1,664.3333333333334,40,2,13,35.196119693668706,0.6296875000000001,43.445121951219505,1026.2195121951206,25.655487804878014,0
1700,4,0,0,41,0.0,0.0,1.0,41,1100,900,200,0.8181818181818182,13,9,4,326.97819199517505,0.3983739837398374,0.1087753363317554,0.19258859059620098,131541.7534722221,402.2569444444382,131944.01041666654,1655,5,681.5121951219512,39,2,17,35.15603845112376,0.6303418803418804,43.541666666666664,1025.8333333333326,26.303418803418783,0
1701,4,1,0,42,0.023809523809523808,0.0,1.0,42,850,800,50,0.9411764705882353,9,8,1,323.115810270057,0.4002008323654665,0.12420619217216,0.19212085942410195,131901.6665014209,123.90276951547665,132025.56927093636,1656,0,666.2619047619048,40,2,14,34.89315393747526,0.6322916666666668,43.191056910569095,1027.235772357722,25.68089430894305,0
1702,4,0,0,42,0.0,0.0,1.0,42,950,400,550,0.42105263157894735,15,4,11,321.95461530918374,0.3992934572202865,0.1261389159638937,0.19209008994818716,132032.1911250742,101.67466042036509,132133.86578549456,1657,1,667.2619047619048,40,2,14,34.79185207159102,0.6335937500000002,43.064024390243894,1027.743902439023,25.693597560975576,0
1703,4,0,1,41,0.0,0.023809523809523808,0.9761904761904762,42,1000,400,600,0.4,16,4,12,321.88319722144433,0.39861595044521875,0.1314278182605586,0.19244506046643797,132110.5368828078,104.83239969594115,132215.36928250373,1658,2,668.2619047619048,40,2,15,34.71501416897324,0.6343750000000001,42.98780487804878,1028.0487804878044,25.70121951219511,0
1704,4,0,0,41,0.0,0.0,1.0,41,1000,600,400,0.6,14,6,8,329.3318785749827,0.3948170731707317,0.13422171915507808,0.19686107266241665,132103.35422091995,501.16916232636925,132604.52338324633,1659,3,685.3658536585366,39,2,16,34.53079086026952,0.6359508547008548,42.99479166666666,1028.0208333333317,26.359508547008506,0
1705,4,0,1,40,0.0,0.024390243902439025,0.975609756097561,41,850,400,450,0.47058823529411764,13,4,9,333.8278636524073,0.3943089430894309,0.13412905042560608,0.20025615587508294,132237.24500868036,628.8953993055309,132866.1404079859,1660,4,686.3658536585366,39,2,16,34.28068665181283,0.637286324786325,42.86458333333332,1028.5416666666652,26.372863247863208,0
1706,4,0,0,40,0.0,0.0,1.0,40,1100,700,400,0.6363636363636364,15,7,8,339.1417537471993,0.39357638888888885,0.1410299003322255,0.20416333575581386,132370.51647308056,978.4738202206092,133348.99029330118,1661,5,699.575,38,2,17,34.010113856589136,0.6403508771929824,42.73504273504273,1029.0598290598289,27.080521817363916,0
1707,4,0,0,40,0.0,0.0,1.0,40,900,500,400,0.5555555555555556,13,5,8,337.81901030995436,0.39329594017094016,0.1418016194331988,0.20351535499160658,132398.00347222213,945.3124999999902,133343.31597222213,1662,6,700.575,38,2,17,34.01653171390014,0.640625,42.70833333333333,1029.1666666666658,27.08333333333331,0
1708,4,0,0,40,0.0,0.0,1.0,40,950,700,250,0.7368421052631579,12,7,5,340.06456201430046,0.39342948717948717,0.1451660612350807,0.20516731715765713,132452.98603121113,1008.5133364380118,133461.49936764914,1663,7,701.575,38,2,17,33.9035201522228,0.6411732456140351,42.65491452991453,1029.3803418803413,27.08895636527214,0
1709,4,0,0,40,0.0,0.0,1.0,40,1250,800,450,0.64,17,8,9,338.6162825341912,0.39300213675213674,0.14221830255239643,0.20474176480956932,132535.48127145885,975.7343944042631,133511.2156658631,1664,8,702.575,38,2,18,33.857949436259254,0.6419956140350876,42.574786324786324,1029.7008547008547,27.097390913180387,0
1710,4,0,0,40,0.0,0.0,1.0,40,950,600,350,0.631578947368421,13,6,7,337.8269141371532,0.39308226495726495,0.13809647302904549,0.20456353343480896,132590.49236613343,958.5273759953282,133549.01974212876,1665,9,703.575,38,2,18,33.823046334716466,0.6425438596491228,42.52136752136752,1029.9145299145302,27.103013945119216,0
1711,4,0,0,40,0.0,0.0,1.0,40,700,300,400,0.42857142857142855,11,3,8,336.1104476341137,0.392855235042735,0.1358339383881335,0.2036732134280637,132618.00219382366,914.8592163416016,133532.86141016526,1666,10,704.575,38,2,18,33.839634546900385,0.6428179824561402,42.494658119658126,1030.0213675213688,27.105825461088653,0
1712,4,0,0,40,0.0,0.0,1.0,40,800,700,100,0.875,9,7,2,328.42802000587915,0.39340277777777777,0.02688325774009126,0.19993499273107004,132790.50684942823,722.4246480269699,133512.9314974552,1667,11,705.575,40,0,15,33.86454019588513,0.6411458333333333,42.327235772357724,1030.691056910569,25.767276422764223,4
1713,4,0,0,40,0.0,0.0,1.0,40,650,200,450,0.3076923076923077,11,2,9,329.04570624492504,0.3932291666666667,0.02455634427684128,0.20045108699353004,132816.6943969364,740.5526017912675,133557.24699872767,1668,12,706.575,40,0,15,33.822381609648694,0.64140625,42.301829268292686,1030.7926829268297,25.769817073170742,0
1714,4,0,0,40,0.0,0.0,1.0,40,500,300,200,0.6,7,3,4,331.75889860073966,0.39280181623931626,0.018283729181038932,0.20267053245645436,132921.47040658674,819.5761244960064,133741.04653108274,1669,13,707.575,40,0,17,33.64746558917251,0.6424479166666666,42.20020325203252,1031.1991869918702,25.779979674796756,0
1715,4,0,0,40,0.0,0.0,1.0,40,1000,900,100,0.9,11,9,2,332.48154529350353,0.3923611111111111,0.027266009852216833,0.20353966735398465,133000.07952442346,844.0143928878474,133844.09391731131,1670,14,708.575,40,0,17,33.55008210180623,0.6432291666666666,42.123983739837406,1031.5040650406518,25.787601626016293,0
1716,4,0,0,40,0.0,0.0,1.0,40,900,700,200,0.7777777777777778,11,7,4,334.63391367969706,0.3923344017094017,0.022611778609415323,0.20543366139683447,133104.92782900392,908.2845858946414,134013.21241489856,1671,15,709.575,40,0,17,33.389550915895214,0.6442708333333333,42.02235772357724,1031.9105691056911,25.79776422764228,0
1717,4,0,0,40,0.0,0.0,1.0,40,1100,900,200,0.8181818181818182,13,9,4,334.8568558596074,0.3924278846153846,0.030173771783007064,0.20600491126384224,133183.59116803834,919.4877181241452,134103.0788861625,1672,16,710.575,40,0,18,33.30502773128549,0.6450520833333333,41.94613821138212,1032.2154471544725,25.805386178861813,0
1718,4,0,0,40,0.0,0.0,1.0,40,1500,1000,500,0.6666666666666666,20,10,10,339.8642516529401,0.39200053418803416,0.029948352188883476,0.21026902727036773,133393.47367844894,1067.134621422461,134460.60829987138,1673,17,711.575,40,0,18,32.96565010657486,0.6471354166666665,41.7428861788618,1033.0284552845549,25.825711382113873,0
1719,4,0,0,40,0.0,0.0,1.0,40,1000,800,200,0.8,12,8,4,333.31165452653494,0.3917067307692308,0.011693548387096797,0.2066532258064516,133472.22222222216,902.5913601361583,134374.81358235833,1674,18,712.575,38,2,18,33.05611559139785,0.6513157894736842,41.666666666666664,1033.333333333333,27.192982456140342,2
1720,4,0,0,40,0.0,0.0,1.0,40,950,700,250,0.7368421052631579,12,7,5,333.5734825050631,0.391920405982906,0.010150919991730678,0.20712386840526187,133527.42735955876,908.2417908539717,134435.66915041272,1675,19,713.575,38,2,19,32.99415098890497,0.6518640350877192,41.613247863247864,1033.5470085470085,27.19860548807917,0
1721,4,1,0,41,0.024390243902439025,0.0,1.0,41,1700,1200,500,0.7058823529411765,22,12,10,326.0220117223955,0.3952489837398374,0.019492555267776934,0.20435512217425883,133876.17323133693,529.3158637152876,134405.4890950522,1676,0,697.1463414634146,39,2,18,32.84107112900519,0.6535790598290598,41.27604166666667,1034.8958333333344,26.535790598290625,0
1722,4,0,0,41,0.0,0.0,1.0,41,900,700,200,0.7777777777777778,11,7,4,326.87966876647636,0.39527439024390243,0.02372521159561125,0.2054938031543332,133983.99658203122,559.3288845486115,134543.32546657984,1677,1,698.1463414634146,39,2,18,32.71130982325519,0.6546474358974359,41.171875,1035.3124999999998,26.546474358974354,0
1723,4,0,0,41,0.0,0.0,1.0,41,1300,1100,200,0.8461538461538461,15,11,4,330.67559669628633,0.39529979674796745,0.02425288935109804,0.20864455162105758,134118.83680555536,669.9652777777591,134788.8020833331,1678,2,699.1463414634146,39,2,19,32.47854652721911,0.6559829059829061,41.04166666666666,1035.8333333333317,26.559829059829017,0
1724,4,0,0,41,0.0,0.0,1.0,41,950,700,250,0.7368421052631579,12,7,5,330.9060754847606,0.3951981707317073,0.026910667176635483,0.20940544776860015,134226.75781249985,683.289930555542,134910.0477430554,1679,3,700.1463414634146,39,2,19,32.364964481972926,0.6570512820512822,40.93749999999999,1036.2499999999989,26.570512820512793,0
1725,4,0,0,41,0.0,0.0,1.0,41,1150,800,350,0.6956521739130435,15,8,7,332.07881584006145,0.39471544715447154,0.02556193208990898,0.21064701004780012,134313.65258774537,720.5437404983772,135034.19632824374,1680,4,701.1463414634146,40,1,20,32.24795751633985,0.65625,40.853658536585364,1036.5853658536585,25.914634146341463,0
1726,4,0,0,41,0.0,0.0,1.0,41,1300,1100,200,0.8461538461538461,15,11,4,332.1557005164079,0.39423272357723577,0.02592255266863175,0.21115168924416894,134392.67223750753,727.8584382642684,135120.5306757718,1681,5,702.1463414634146,40,1,20,32.16721389133916,0.65703125,40.77743902439025,1036.8902439024396,25.92225609756099,0
1727,4,0,0,41,0.0,0.0,1.0,41,850,600,250,0.7058823529411765,11,6,5,332.3817642301462,0.39375,0.022308528817772233,0.21160049307352724,134445.36491382445,737.4375165245556,135182.802430349,1682,6,703.1463414634146,40,1,20,32.10885186999837,0.6575520833333334,40.72662601626016,1037.0934959349595,25.927337398373986,0
1728,4,1,1,41,0.023809523809523808,0.023809523809523808,0.9761904761904762,42,700,500,200,0.7142857142857143,9,5,4,327.5640488920608,0.3969342818428185,0.02576856550366502,0.21007099815046829,134712.939453125,425.50579986078026,135138.44525298578,1683,0,687.3809523809524,39,3,21,31.96743929359823,0.6618589743589745,40.46875,1038.125,26.618589743589745,0
1729,4,0,0,41,0.0,0.0,1.0,41,1100,700,400,0.6363636363636364,15,7,8,341.8192348154872,0.3927083333333334,0.02420448041450385,0.21907095550575653,134689.3719409743,1007.8836109284608,135697.25555190275,1684,8,705.1463414634146,38,3,22,31.620951694798958,0.6633771929824562,40.49145299145298,1038.0341880341864,27.31668915879438,0
1730,4,0,0,41,0.0,0.0,1.0,41,1050,600,450,0.5714285714285714,15,6,9,344.3472793781436,0.3925558943089431,0.01787112315567585,0.2213661081716636,134800.2958579881,1083.6230276134027,135883.9188856015,1685,9,706.1463414634146,38,3,17,31.44483024691358,0.6644736842105263,40.38461538461538,1038.4615384615379,27.32793522267205,0
1731,4,0,0,41,0.0,0.0,1.0,41,650,600,50,0.9230769230769231,7,6,1,345.71983680783757,0.39265752032520324,0.021555335898966854,0.22258862605601273,134855.77493790616,1124.4633008254618,135980.23823873163,1686,10,707.1463414634146,38,3,17,31.353930946993067,0.6650219298245614,40.33119658119657,1038.6752136752123,27.33355825461085,0
1732,4,0,1,40,0.0,0.024390243902439025,0.975609756097561,41,1250,800,450,0.64,17,8,9,335.00068716759887,0.39352134146341466,-0.006951808648520963,0.2101367946778575,133903.12500000012,786.5746447878012,134689.6996447879,1687,11,708.1463414634146,39,2,15,32.58185721953839,0.6538461538461537,41.25000000000001,1035.000000000001,26.53846153846156,6
1733,4,1,0,41,0.024390243902439025,0.0,1.0,41,1450,1100,350,0.7586206896551724,18,11,7,334.0620774743745,0.3932418699186992,0.0053955290684131185,0.21093634034810513,134145.81298828137,762.6057942708477,134908.4187825522,1688,0,708.8536585365854,39,2,17,32.36393916540975,0.65625,41.01562500000001,1035.937500000001,26.562500000000025,0
1734,4,0,0,41,0.0,0.0,1.0,41,1200,800,400,0.6666666666666666,16,8,8,335.526927968073,0.3928861788617886,0.01141086973570693,0.2129568869348382,134334.7222222223,814.5833333333384,135149.30555555565,1689,1,709.8536585365854,39,2,17,32.1375937834941,0.6581196581196581,40.833333333333336,1036.6666666666672,26.581196581196593,0
1735,4,0,0,41,0.0,0.0,1.0,41,850,700,150,0.8235294117647058,10,7,3,334.07078225903047,0.3922510162601626,0.0063511665858067,0.2123461409071768,134388.720703125,779.0690104166666,135167.78971354166,1690,2,710.8536585365854,39,2,17,32.12150894112921,0.6586538461538461,40.78125,1036.875,26.58653846153846,0
1736,4,0,0,41,0.0,0.0,1.0,41,700,400,300,0.5714285714285714,10,4,6,333.38171964968313,0.39242886178861786,0.018611029483788677,0.21285140562248991,134550.78125,771.5494791666661,135322.33072916666,1691,3,711.8536585365854,37,4,18,31.977911646586335,0.6638513513513513,40.625,1037.5,28.04054054054054,0
1737,4,1,1,41,0.023809523809523808,0.023809523809523808,0.9761904761904762,42,950,600,350,0.631578947368421,13,6,7,326.18991175770867,0.3949380565234224,0.01976695185174293,0.20937341892083297,134744.8281923442,390.4807235736703,135135.30891591788,1692,0,695.8809523809524,38,4,19,31.971384715647943,0.6639254385964912,40.43803418803419,1038.247863247863,27.32231219073324,0
1738,4,0,1,40,0.0,0.024390243902439025,0.975609756097561,41,1000,800,200,0.8,12,8,4,333.4805444995933,0.39235264227642275,0.025320303905479236,0.2137481594297662,134693.02002779683,783.5003318328527,135476.52035962968,1693,5,713.8536585365854,37,4,19,31.83371624238583,0.6652590090090091,40.48793859649122,1038.0482456140337,28.055357989568478,0
1739,4,0,0,40,0.0,0.0,1.0,40,750,500,250,0.6666666666666666,10,5,5,338.7133866231345,0.3896100427350427,0.027973735619709172,0.2164289281793039,134579.99173159653,1116.8089542245048,135696.80068582104,1694,6,731.775,36,4,19,31.810514796324433,0.6660879629629629,40.59684684684685,1037.6126126126132,28.82257257257259,0
1740,4,0,0,40,0.0,0.0,1.0,40,900,800,100,0.8888888888888888,10,8,2,333.802779295196,0.3887286324786325,0.022538819055666792,0.2139546994981462,134693.02002779697,992.1808873884227,135685.20091518539,1695,7,732.775,37,3,20,31.825353860779554,0.665259009009009,40.487938596491226,1038.0482456140348,28.05535798956851,0
1741,4,0,0,40,0.0,0.0,1.0,40,700,400,300,0.5714285714285714,10,4,6,335.7781791098681,0.38838141025641026,0.023120181645368776,0.21555820867737893,134749.93657904342,1049.2176679362724,135799.15424697968,1696,8,733.775,37,3,20,31.717424402436016,0.6658220720720721,40.43311403508771,1038.2675438596482,28.06128496917968,0
1742,4,0,0,40,0.0,0.0,1.0,40,700,400,300,0.5714285714285714,10,4,6,332.21756703916583,0.38747329059829055,0.02608730074949861,0.21394269290020512,134863.80575032698,960.8250856032557,135824.63083593023,1697,9,734.775,37,3,14,31.696554241880424,0.6669481981981982,40.3234649122807,1038.706140350877,28.07313892840208,0
1743,4,0,0,40,0.0,0.0,1.0,40,900,500,400,0.5555555555555556,13,5,8,333.4468631636633,0.3874332264957265,0.026033973412112,0.21558044809448854,135006.20984341344,1003.479435980305,136009.68927939373,1698,10,735.775,37,3,15,31.52300063304494,0.6683558558558558,40.18640350877193,1039.254385964913,28.08795637743008,0
1744,4,1,0,41,0.024390243902439025,0.0,1.0,41,1250,800,450,0.64,17,8,9,324.327320340044,0.38915142276422765,0.03224982342244842,0.21139889193248654,135300.01849112427,576.298487836948,135876.31697896123,1699,0,718.8048780487804,38,3,16,31.46821729307865,0.6694078947368421,39.90384615384615,1040.3846153846155,27.37854251012146,0
1745,4,0,0,41,0.0,0.0,1.0,41,1750,1400,350,0.8,21,14,7,323.6030317477407,0.3875762195121952,0.03044463076749815,0.21207206081921554,135494.60475792616,569.2929770253618,136063.89773495152,1700,1,719.8048780487804,38,3,17,31.29403967846759,0.6713267543859649,39.71688034188035,1041.1324786324794,27.398223121907353,0
1746,4,0,1,40,0.0,0.024390243902439025,0.975609756097561,41,900,700,200,0.7777777777777778,11,7,4,324.5136377795981,0.38783028455284557,0.032118366111346,0.21332996997392464,135605.85968889252,601.1901663744562,136207.049855267,1701,2,720.8048780487804,38,3,17,31.160033507710178,0.6724232456140351,39.61004273504273,1041.5598290598289,27.40946918578497,0
1747,4,0,1,39,0.0,0.025,0.975,40,750,400,350,0.5333333333333333,11,4,7,331.3727516794771,0.38494925213675213,0.03962413139608345,0.21766102319859434,135576.57764889198,985.2767197599275,136561.8543686519,1702,3,737.275,37,3,17,31.010475889660974,0.6739864864864864,39.63815789473684,1041.4473684210527,28.147226173541966,0
1748,4,0,0,39,0.0,0.0,1.0,39,850,500,350,0.5882352941176471,12,5,7,335.21436903230745,0.38388439046333783,0.024534179935316924,0.22018437600752813,135576.57764889198,1289.4433864265943,136866.02103531858,1703,4,717.2564102564103,37,2,18,30.91045483259633,0.6739864864864864,39.63815789473684,1041.4473684210527,28.147226173541966,0
1749,4,0,0,39,0.0,0.0,1.0,39,700,600,100,0.8571428571428571,8,6,2,334.0800000000001,0.3833502024291498,0.019692307692307898,0.2197894736842104,135633.68055555536,1262.524045860241,136896.2046014156,1704,5,718.2564102564103,35,4,19,30.883333333333326,0.6785714285714286,39.58333333333332,1041.6666666666652,29.76190476190472,0
1750,4,0,0,39,0.0,0.0,1.0,39,1500,1000,500,0.6666666666666666,20,10,10,334.58856140043656,0.38360323886639675,0.02287810685944458,0.22049533160517748,135693.96888931718,1280.3299682784177,136974.2988575956,1705,6,719.2564102564103,35,4,20,30.810282900096265,0.6791666666666669,39.52546296296294,1041.898148148145,29.76851851851843,0
1751,4,0,0,39,0.0,0.0,1.0,39,1250,1000,250,0.8,15,10,5,334.1632956704602,0.38309716599190285,0.03083187403009724,0.22077332923789378,135784.42650730864,1274.8342924811182,137059.26079978977,1706,7,720.2564102564103,35,4,20,30.731653710901337,0.680059523809524,39.4386574074074,1042.245370370369,29.778439153439116,0
1752,4,0,0,39,0.0,0.0,1.0,39,1250,1000,250,0.8,15,10,5,334.2604543702111,0.38281601439496177,0.02847927395501504,0.22121116183045447,135844.74833086817,1281.5054601765705,137126.25379104473,1707,8,721.2564102564103,35,4,21,30.669317382776345,0.680654761904762,39.38078703703702,1042.4768518518492,29.785052910052837,0
1753,4,0,0,39,0.0,0.0,1.0,39,750,500,250,0.6666666666666666,10,5,5,336.5565503427643,0.38228182636077374,0.0328901867363407,0.22310801781000425,135905.08355034696,1347.9492187499668,137253.03276909693,1708,9,722.2564102564103,35,4,14,30.54965867465867,0.6812500000000001,39.32291666666665,1042.7083333333312,29.791666666666607,0
1754,4,0,0,39,0.0,0.0,1.0,39,850,700,150,0.8235294117647058,10,7,3,334.96960847883827,0.38216936572199733,0.03412526997840204,0.22219330762994532,135927.10108757377,1306.2895665935907,137233.39065416736,1709,10,723.2564102564103,36,3,14,30.569204463642915,0.6793981481481484,39.30180180180179,1042.7927927927906,28.966466466466404,0
1755,4,0,0,39,0.0,0.0,1.0,39,850,600,250,0.7058823529411765,11,6,5,339.67028570491107,0.38143837156995053,0.03497409326424905,0.22605643152085433,136044.5580715849,1442.058781754707,137486.61685333963,1710,11,724.2564102564103,36,3,14,30.330220926885442,0.6805555555555557,39.18918918918918,1043.2432432432417,28.978978978978937,0
1756,4,0,0,39,0.0,0.0,1.0,39,900,800,100,0.8888888888888888,10,8,2,339.7056566429085,0.3809041835357625,0.031704650808806356,0.22626692370931306,136073.9302435881,1445.016765075876,137518.947008664,1711,12,725.2564102564103,36,3,15,30.3001888828926,0.6808449074074074,39.16103603603603,1043.3558558558552,28.98210710710709,0
1757,4,0,0,39,0.0,0.0,1.0,39,800,500,300,0.625,11,5,6,340.3699443304304,0.38121345029239767,0.03498868208559558,0.22689697152271696,136103.30558599124,1465.0949090982717,137568.4004950895,1712,13,726.2564102564103,36,3,15,30.253750269803582,0.6811342592592593,39.132882882882875,1043.4684684684673,28.985235235235205,0
1758,4,0,0,39,0.0,0.0,1.0,39,1100,900,200,0.8181818181818182,13,9,4,345.4948585370962,0.3806511470985155,0.03460113806429477,0.23088621800867637,136191.45063560165,1610.689194261813,137802.13982986347,1713,14,727.2564102564103,36,3,15,30.032680619987776,0.6820023148148149,39.048423423423415,1043.806306306305,28.994619619619584,0
1759,4,0,1,38,0.0,0.02564102564102564,0.9743589743589743,39,950,700,250,0.7368421052631579,12,7,5,346.03790000873266,0.3807073774179037,0.034016596294176527,0.23201803664359918,136309.02175401745,1633.617528000967,137942.6392820184,1714,15,728.2564102564103,36,3,15,29.902000431359873,0.6831597222222223,38.93581081081081,1044.2567567567562,29.007132132132117,0
1760,4,0,0,38,0.0,0.0,1.0,38,950,700,250,0.7368421052631579,12,7,5,355.89610275281626,0.377993124703651,0.034139639087742424,0.23834734542933594,136267.37618152006,2099.4056230709857,138366.78180459104,1715,27,748.0263157894736,35,3,16,29.685941137346195,0.6848214285714286,38.97569444444444,1044.0972222222222,29.831349206349206,0
1761,4,0,0,38,0.0,0.0,1.0,38,900,800,100,0.8888888888888888,10,8,2,355.45202998749244,0.3779338549075391,0.03861495844875362,0.2388648228322501,136388.24755926352,2095.8958922753754,138484.1434515389,1716,28,749.0263157894736,35,3,17,29.577677746999072,0.6860119047619047,38.8599537037037,1044.560185185185,29.844576719576715,0
1762,4,0,1,37,0.0,0.02631578947368421,0.9736842105263158,38,800,600,200,0.75,10,6,4,356.76175058209446,0.37743006164058795,0.038193203668725806,0.24040612081708465,136485.4735436451,2138.559294091396,138624.03283773648,1717,29,750.0263157894736,36,2,18,29.447093796026873,0.6848958333333333,38.766891891891895,1044.932432432433,29.025900900900915,0
1763,4,0,0,37,0.0,0.0,1.0,37,800,700,100,0.875,9,7,2,372.0094789825016,0.3763763763763764,0.08276224388535391,0.24676273462592924,135927.10108757432,2713.436916646405,138640.53800422073,1718,30,763.8378378378378,36,1,17,29.603581713462933,0.6793981481481481,39.301801801801815,1042.792792792795,28.966466466466525,3
1764,4,0,0,37,0.0,0.0,1.0,37,1100,900,200,0.8181818181818182,13,9,4,372.17448227349223,0.37584459459459457,0.07685327560098143,0.24748400784632907,136015.18906998239,2724.276514690394,138739.46558467278,1719,31,764.8378378378378,36,1,17,29.51167728237793,0.6802662037037036,39.217342342342356,1043.1306306306326,28.975850850850904,0
1765,4,0,0,37,0.0,0.0,1.0,37,600,300,300,0.5,9,3,6,376.41573820864687,0.3744994994994995,0.07607694012527877,0.2513415750517103,136162.06578199822,2850.708901469039,139012.77468346726,1720,32,765.8378378378378,36,1,17,29.25500827219106,0.681712962962963,39.07657657657658,1043.6936936936938,28.991491491491495,0
1766,4,0,0,37,0.0,0.0,1.0,37,500,100,400,0.2,9,1,8,376.68373704170926,0.37374874874874875,0.07535266903188398,0.2521469260731905,136250.22985400943,2864.6491508400322,139114.87900484947,1721,33,766.8378378378378,36,1,17,29.160374644950203,0.6825810185185186,38.99211711711712,1044.0315315315318,29.00087587587588,0
1767,4,0,0,37,0.0,0.0,1.0,37,1100,900,200,0.8181818181818182,13,9,4,380.1614285319721,0.3730292792792793,0.08490046584258049,0.25574746718572205,136426.64359883536,2972.8295440711,139399.47314290647,1722,34,767.8378378378378,36,1,17,28.894263590959707,0.6843171296296297,38.8231981981982,1044.7072072072076,29.019644644644657,0
1768,4,0,0,37,0.0,0.0,1.0,37,1200,700,500,0.5833333333333334,17,7,10,383.56971985580003,0.3723410910910911,0.08436299676467729,0.25890258690775886,136544.3161700553,3074.8530202499915,139619.16919030529,1723,35,768.8378378378378,36,1,17,28.688314836763286,0.685474537037037,38.71058558558559,1045.1576576576585,29.032157157157183,0
1769,4,0,0,37,0.0,0.0,1.0,37,900,800,100,0.8888888888888888,10,8,2,385.21869375375684,0.3724036536536537,0.0817245124042496,0.26045048318398584,136603.17147806592,3124.419055880206,139727.59053394612,1724,36,769.8378378378378,36,1,17,28.586753563862253,0.6860532407407407,38.65427927927928,1045.3828828828832,29.038413413413423,0
1770,4,0,1,36,0.0,0.02702702702702703,0.972972972972973,37,800,500,300,0.625,11,5,6,384.7587664545341,0.3720908408408408,0.07825145265903588,0.26035717111981754,136632.60388767152,3114.118425858301,139746.7223135298,1725,37,770.8378378378378,36,1,17,28.569537196610668,0.6863425925925926,38.62612612612613,1045.495495495496,29.041541541541555,0
1771,4,0,0,36,0.0,0.0,1.0,36,500,300,200,0.6,7,3,4,382.6923382168537,0.3724537037037037,0.07359451084550672,0.2596102078173792,136720.92013888896,3264.4097222222335,139985.32986111118,1726,38,764.6111111111111,35,1,17,28.535856573705182,0.6892857142857143,38.54166666666667,1045.833333333334,29.880952380952397,0
1772,4,0,0,36,0.0,0.0,1.0,36,1200,700,500,0.5833333333333334,17,7,10,383.33633048251966,0.3722387566137566,0.07295301673999943,0.2607399127152,136814.31405895695,3289.179421768717,140103.49348072568,1727,39,765.6111111111111,34,2,17,28.426310499165535,0.6924019607843137,38.452380952380956,1046.1904761904766,30.77030812324931,0
1773,4,0,0,36,0.0,0.0,1.0,36,1350,1200,150,0.8888888888888888,15,12,3,382.2143605464314,0.3716600529100529,0.059280109177754836,0.26113526591179276,136970.0414540817,3270.3833616780103,140240.4248157597,1728,40,766.6111111111111,34,2,16,28.301158118200078,0.6939338235294118,38.30357142857143,1046.7857142857147,30.787815126050432,0
1774,4,0,0,36,0.0,0.0,1.0,36,850,600,250,0.7058823529411765,11,6,5,383.39429165145833,0.3708498677248677,0.06131444015053922,0.2631125567823349,137125.85742630402,3314.6541950113547,140440.51162131538,1729,41,767.6111111111111,34,2,16,28.115764946578768,0.6954656862745097,38.15476190476191,1047.3809523809537,30.80532212885158,0
1775,4,0,0,36,0.0,0.0,1.0,36,1150,700,450,0.6086956521739131,16,7,9,382.903928849287,0.3697916666666667,0.06643060920497867,0.2637183397285936,137250.57397959192,3310.756802721101,140561.33078231302,1730,42,768.6111111111111,34,2,16,28.004998863894574,0.6966911764705881,38.03571428571429,1047.8571428571436,30.819327731092457,0
1776,4,0,0,36,0.0,0.0,1.0,36,1350,1000,350,0.7407407407407407,17,10,7,385.90856780853863,0.37005621693121693,0.06469213499687188,0.26660365359587607,137357.1475935571,3401.460021219138,140758.60761477624,1731,43,769.6111111111111,35,1,17,27.820677376614775,0.6955357142857143,37.93402777777778,1048.263888888889,29.950396825396826,0
1777,4,0,0,36,0.0,0.0,1.0,36,600,300,300,0.5,9,3,6,383.14806197260947,0.3694940476190476,0.06198562509965555,0.2651595334919685,137417.81771101247,3330.2741072959475,140748.09181830843,1732,44,770.6111111111111,35,1,17,27.832933178790892,0.6961309523809524,37.876157407407405,1048.49537037037,29.95701058201057,0
1778,4,0,0,36,0.0,0.0,1.0,36,1100,600,500,0.5454545454545454,16,6,10,383.4967716458534,0.3687996031746032,0.06711098853955977,0.26679955755714996,137599.90843889336,3353.8241330161372,140953.7325719095,1733,45,771.6111111111111,35,1,18,27.64352362566647,0.6979166666666665,37.702546296296305,1049.1898148148161,29.97685185185189,0
1779,4,1,1,36,0.02702702702702703,0.02702702702702703,0.972972972972973,37,700,500,200,0.7142857142857143,9,5,4,373.27551588764754,0.37140265265265265,0.0565264923250155,0.26152345603464305,137842.88361893437,2890.838798868317,140733.7224178027,1734,0,751.7297297297297,35,2,18,27.67150244314632,0.700297619047619,37.47106481481482,1050.115740740741,30.003306878306887,0
1780,4,0,0,36,0.0,0.0,1.0,36,1250,1000,250,0.8,15,10,5,379.1887125220457,0.3693121693121693,0.059082892416225885,0.26543209876543217,137812.50000000012,3251.388888888904,141063.88888888902,1735,47,773.6111111111111,35,1,18,27.546296296296298,0.7,37.50000000000001,1050.000000000001,30.000000000000025,0
1781,4,0,0,36,0.0,0.0,1.0,36,950,700,250,0.7368421052631579,12,7,5,383.2050654447108,0.3685350529100529,0.05780610638967554,0.2694649165378148,137968.79428854887,3374.0681689342528,141342.86245748313,1736,48,774.6111111111111,34,2,18,27.286355051935782,0.7037377450980391,37.35119047619048,1050.595238095239,30.899859943977617,0
1782,4,0,0,36,0.0,0.0,1.0,36,700,400,300,0.5714285714285714,10,4,6,387.06234324094976,0.36803902116402115,0.05564050288820965,0.2731713372081812,138093.89349489802,3490.18920068028,141584.08269557828,1737,49,775.6111111111111,34,2,15,27.06138860573111,0.7049632352941175,37.23214285714286,1051.0714285714291,30.913865546218503,0
1783,4,0,0,36,0.0,0.0,1.0,36,800,700,100,0.875,9,7,2,384.9068481214557,0.36749338624338623,0.06381466384863144,0.2723956155936454,138187.75510204077,3437.8826530612164,141625.63775510198,1738,50,776.6111111111111,34,2,15,27.02530570652174,0.7058823529411764,37.14285714285714,1051.4285714285709,30.924369747899142,0
1784,4,0,0,36,0.0,0.0,1.0,36,1450,1100,350,0.7586206896551724,18,11,7,387.2427828786349,0.3678240740740741,0.060767818520195416,0.2750544396716734,138312.95351473926,3512.138605442181,141825.09212018145,1739,51,777.6111111111111,34,2,15,26.84024634072733,0.7071078431372548,37.023809523809526,1051.9047619047622,30.938375350140063,0
1785,4,0,0,36,0.0,0.0,1.0,36,550,300,250,0.5454545454545454,8,3,5,388.34631219740226,0.3672123015873016,0.062334225842541224,0.27659895676976964,138406.88952664417,3549.961026077115,141956.8505527213,1740,52,778.6111111111111,34,2,15,26.7184730550213,0.7080269607843136,36.93452380952382,1052.261904761906,30.948879551820763,0
1786,4,0,0,36,0.0,0.0,1.0,36,600,300,300,0.5,9,3,6,388.61713084945836,0.36684854497354497,0.06477082783496102,0.2773013764196985,138469.53125000012,3562.326388888905,142031.85763888902,1741,53,779.6111111111111,34,2,15,26.649511744523622,0.7086397058823528,36.87500000000001,1052.500000000001,30.955882352941202,0
1787,4,0,0,36,0.0,0.0,1.0,36,1000,800,200,0.8,12,8,4,407.1246161640181,0.36684854497354497,0.09369417649160416,0.25839950127961153,134334.72222222228,3747.395833333339,138082.11805555562,1742,54,780.6111111111111,34,2,19,30.282020364415864,0.6678921568627452,40.833333333333336,1036.666666666667,30.49019607843138,7
1788,4,0,0,36,0.0,0.0,1.0,36,950,700,250,0.7368421052631579,12,7,5,407.3006863588969,0.36708002645502646,0.09704681719607122,0.25894810059751777,134396.43565759642,3747.9520975056726,138144.3877551021,1743,55,781.6111111111111,34,2,19,30.215508993494062,0.6685049019607843,40.773809523809526,1036.9047619047622,30.497198879551828,0
1789,4,0,0,36,0.0,0.0,1.0,36,800,500,300,0.625,11,5,6,404.34831696262944,0.3668650793650794,0.10430611334225781,0.2581608485222944,134550.78125000012,3681.1649659864092,138231.94621598654,1744,56,782.6111111111111,33,3,19,30.137215528781798,0.6723484848484848,40.62500000000001,1037.500000000001,31.439393939393966,0
1790,4,0,0,36,0.0,0.0,1.0,36,900,600,300,0.6666666666666666,12,6,6,403.8284505048355,0.3666170634920635,0.10440108197041309,0.258068077151005,134584.55615573455,3669.8145548502544,138254.3707105848,1745,57,783.6111111111111,31,5,20,30.11683293596018,0.677755376344086,40.592447916666664,1037.630208333333,33.471942204301065,0
1791,4,0,0,36,0.0,0.0,1.0,36,550,300,250,0.5454545454545454,8,3,5,402.6141532576498,0.3660548941798942,0.10344286968518746,0.2582496093260853,134719.69816419805,3648.0114407009455,138367.709604899,1746,58,784.6111111111111,31,5,21,30.012882018479033,0.6790994623655915,40.46223958333333,1038.151041666666,33.488743279569874,0
1792,4,0,0,36,0.0,0.0,1.0,36,1100,900,200,0.8181818181818182,13,9,4,403.1672228523244,0.3654431216931217,0.10828005515858119,0.25956940570564907,134854.90798950195,3673.8157484266485,138528.7237379286,1747,59,785.6111111111111,31,5,16,29.86306986753583,0.6804435483870968,40.33203125,1038.671875,33.50554435483871,0
1793,4,0,0,36,0.0,0.0,1.0,36,800,400,400,0.5,12,4,8,403.23634255970416,0.36534391534391536,0.1116680844168998,0.2602534794450045,134944.06063475672,3682.869892102853,138626.93052685956,1748,60,786.6111111111111,32,4,16,29.771995382184954,0.6787109375,40.246212121212125,1039.015151515152,32.4692234848485,0
1794,4,0,1,35,0.0,0.027777777777777776,0.9722222222222222,36,1000,900,100,0.9,11,9,2,402.10726120354127,0.36531084656084656,0.10676777494296652,0.2599956690468458,135009.66299676042,3657.673164728077,138667.3361614885,1749,61,787.6111111111111,32,4,17,29.735653829020375,0.6793619791666667,40.1830808080808,1039.267676767676,32.477114898989875,0
1795,4,0,0,35,0.0,0.0,1.0,35,900,600,300,0.6666666666666666,12,6,6,407.73361976369495,0.36463585434173673,0.10403150733977795,0.26324549237170597,134956.35986328125,4005.249023437501,138961.60888671875,1750,62,764.2285714285714,31,4,19,29.64285714285714,0.6814516129032258,40.234375,1039.0625,33.51814516129032,0
1796,4,0,0,35,0.0,0.0,1.0,35,1050,500,550,0.47619047619047616,16,5,11,405.05738491355726,0.3637254901960784,0.10465336792199698,0.2627443719362106,135125.53109063033,3946.7188517252503,139072.2499423556,1751,63,765.2285714285714,31,4,19,29.54302337716552,0.6831317204301075,40.07161458333333,1039.7135416666658,33.539146505376316,0
1797,4,1,1,35,0.027777777777777776,0.027777777777777776,0.9722222222222222,36,1100,800,300,0.7272727272727273,14,8,6,396.70243172750764,0.36792328042328043,0.09148067281255079,0.25955673390171213,135436.46694214875,3545.595156106521,138982.06209825526,1752,0,744.9444444444445,32,4,19,29.44944808345464,0.68359375,39.77272727272727,1040.9090909090908,32.528409090909086,0
1798,4,1,0,36,0.027777777777777776,0.0,1.0,36,1050,700,350,0.6666666666666666,14,7,7,399.04000000000013,0.36653439153439155,0.0993333333333335,0.26252631578947366,135633.68055555547,3624.7962580348844,139258.47681359036,1753,0,745.9166666666666,31,5,20,29.19166666666667,0.6881720430107527,39.58333333333333,1041.666666666666,33.60215053763439,0
1799,4,0,0,36,0.0,0.0,1.0,36,1000,700,300,0.7,13,7,6,402.31508433689197,0.36575727513227513,0.10312899106002549,0.2656872883690168,135769.34814453125,3724.4113498263887,139493.75949435763,1754,1,746.9166666666666,31,5,20,28.97093120106614,0.6895161290322581,39.453125,1042.1875,33.618951612903224,0
1800,4,0,0,36,0.0,0.0,1.0,36,1150,1000,150,0.8695652173913043,13,10,3,399.9471300628686,0.36560846560846566,0.1050851338412222,0.26487813651061937,135871.14334106445,3668.2547675238716,139539.39810858833,1755,2,747.9166666666666,31,5,20,28.931065525998086,0.690524193548387,39.35546875,1042.578125,33.63155241935484,0
1801,4,0,0,36,0.0,0.0,1.0,36,500,300,200,0.6,7,3,4,387.1574434044206,0.36542658730158734,0.07025298260744561,0.24981027024341979,134934.53903630472,3275.7243463077516,138210.26338261247,1756,3,748.9166666666666,30,6,21,30.199169900819324,0.6840277777777778,40.25537634408602,1038.9784946236555,34.63261648745518,3
1802,4,1,1,36,0.02702702702702703,0.02702702702702703,0.972972972972973,37,550,300,250,0.5454545454545454,8,3,5,373.7378727079102,0.3698073073073073,0.0641232118447943,0.24311222534126917,135227.08468967007,2707.896592881935,137934.981282552,1757,0,729.6486486486486,31,6,21,30.2558003672175,0.6841397849462365,39.97395833333333,1040.104166666666,33.55174731182794,0
1803,4,0,0,36,0.0,0.0,1.0,36,750,600,150,0.8,9,6,3,384.33550606262236,0.3662202380952381,0.07132850553903203,0.24870849107801307,135039.2950955312,3180.079163776148,138219.37425930737,1758,5,750.9166666666666,30,6,21,30.167787404629497,0.6850694444444445,40.15456989247311,1039.381720430107,34.64605734767023,0
1804,4,0,0,36,0.0,0.0,1.0,36,1150,800,350,0.6956521739130435,15,8,7,384.9715484593942,0.36532738095238093,0.08344461136148662,0.2504196033463876,135227.08468967007,3211.7160373263796,138438.80072699644,1759,6,751.9166666666666,31,5,21,29.963695543314984,0.6841397849462365,39.97395833333333,1040.104166666666,33.55174731182794,0
1805,4,0,0,36,0.0,0.0,1.0,36,1100,900,200,0.8181818181818182,13,9,4,386.08899422150034,0.3650958994708995,0.08483521068001654,0.25161917323244576,135294.80828179242,3247.1672905815776,138541.97557237398,1760,7,752.9166666666666,31,5,21,29.867021276595736,0.6848118279569892,39.90885416666666,1040.3645833333323,33.56014784946233,0
1806,4,0,0,36,0.0,0.0,1.0,36,500,300,200,0.6,7,3,4,387.9146607822677,0.365244708994709,0.08341676052225466,0.25304702484172237,135328.6764356824,3299.1955227321946,138627.8719584146,1761,8,753.9166666666666,31,5,21,29.78572247945606,0.6851478494623656,39.87630208333333,1040.4947916666658,33.56434811827954,0
1807,4,0,0,36,0.0,0.0,1.0,36,900,700,200,0.7777777777777778,11,7,4,389.6088609624003,0.36461640211640217,0.08680859641074856,0.25463153112612136,135396.42545911993,3350.329420301644,138746.75487942158,1762,9,754.9166666666666,31,5,21,29.67401163518079,0.6858198924731183,39.811197916666664,1040.7552083333328,33.57274865591396,0
1808,4,0,0,36,0.0,0.0,1.0,36,850,600,250,0.7058823529411765,11,6,5,394.6166586657914,0.36354166666666665,0.08839015309382892,0.2591251261091134,135565.87219238284,3499.3103027343745,139065.18249511722,1763,10,755.9166666666666,31,5,22,29.374531132783193,0.6875,39.6484375,1041.4062500000002,33.59375000000001,0
1809,4,0,0,36,0.0,0.0,1.0,36,1000,900,100,0.9,11,9,2,390.11334614811847,0.3637896825396825,0.08611433650138345,0.2569047192858169,135668.68505390792,3385.249892989115,139053.93494689703,1764,11,756.9166666666666,30,6,22,29.389218595450057,0.6913194444444445,39.549731182795696,1041.801075268817,34.726702508960564,0
1810,4,0,0,36,0.0,0.0,1.0,36,950,700,250,0.7368421052631579,12,7,5,385.96647198023476,0.3639880952380952,0.08890607988080923,0.2554228631978414,135843.77529194127,3286.228537981272,139130.00382992256,1765,12,757.9166666666666,30,6,22,29.322728640192548,0.6930555555555555,39.38172043010753,1042.47311827957,34.74910394265233,0
1811,4,0,0,36,0.0,0.0,1.0,36,900,700,200,0.7777777777777778,11,7,4,384.8881901607354,0.3637896825396825,0.08747189643568043,0.2554617166344865,135948.88363177827,3265.023955081513,139213.90758685977,1766,13,758.9166666666666,30,6,20,29.246144262576795,0.6940972222222221,39.280913978494624,1042.8763440860216,34.76254480286739,0
1812,4,0,0,36,0.0,0.0,1.0,36,950,500,450,0.5263157894736842,14,5,9,383.62314429325306,0.3628306878306878,0.08304707515708376,0.25562802310287763,136089.09131474743,3241.385022835012,139330.47633758246,1767,14,759.9166666666666,30,6,20,29.139561595603062,0.695486111111111,39.14650537634409,1043.4139784946242,34.78046594982081,0
1813,4,0,0,36,0.0,0.0,1.0,36,1000,800,200,0.8,12,8,4,381.4933935481621,0.36286375661375664,0.08371968233526483,0.25471162518499413,136159.22225474057,3188.768752167893,139347.99100690847,1768,15,760.9166666666666,30,6,20,29.125348787293397,0.6961805555555556,39.07930107526882,1043.6827956989257,34.78942652329752,0
1814,4,0,0,36,0.0,0.0,1.0,36,700,500,200,0.7142857142857143,9,5,4,380.73208699290706,0.36220238095238094,0.0802858614473343,0.25445485263226486,136194.29449936413,3170.7075962539047,139365.00209561802,1769,16,761.9166666666666,30,6,20,29.11033135891491,0.6965277777777777,39.045698924731184,1043.8172043010757,34.79390681003586,0
1815,4,0,0,36,0.0,0.0,1.0,36,750,500,250,0.6666666666666666,10,5,5,379.39433065822703,0.3615906084656085,0.08040972135622382,0.25416567565148895,136278.70559692383,3140.6736585828994,139419.37925550673,1770,17,762.9166666666666,31,5,20,29.06131791162656,0.6945564516129032,38.96484375,1044.140625,33.68195564516129,0
1816,4,0,0,36,0.0,0.0,1.0,36,700,300,400,0.42857142857142855,11,3,8,378.277530148116,0.3611937830687831,0.08060438570973383,0.2539049430391668,136346.69197930244,3115.377977159309,139462.06995646175,1771,18,763.9166666666666,31,5,20,29.022903420188666,0.6952284946236558,38.89973958333334,1044.4010416666679,33.69035618279574,0
1817,4,0,0,36,0.0,0.0,1.0,36,900,600,300,0.6666666666666666,12,6,6,378.3934537326461,0.3609457671957672,0.07858310136136382,0.25447197647083164,136414.69531589095,3123.6855400933277,139538.3808559843,1772,19,764.9166666666666,31,5,20,28.95230898666334,0.6959005376344085,38.83463541666667,1044.6614583333342,33.69875672043013,0
1818,4,0,0,36,0.0,0.0,1.0,36,700,400,300,0.5714285714285714,10,4,6,378.2769339041698,0.3606646825396826,0.07613271297219448,0.2546387682589816,136448.70334201402,3123.0794270833544,139571.78276909736,1773,20,765.9166666666666,31,5,20,28.921568627450984,0.6962365591397849,38.80208333333334,1044.7916666666679,33.70295698924735,0
1819,4,0,0,36,0.0,0.0,1.0,36,1100,800,300,0.7272727272727273,14,8,6,378.2769339041698,0.3606646825396826,0.07613271297219448,0.2546387682589816,136448.70334201402,3123.0794270833544,139571.78276909736,1774,21,766.9166666666666,31,5,20,28.921568627450984,0.6962365591397849,38.80208333333334,1044.7916666666679,33.70295698924735,0
1820,4,0,0,36,0.0,0.0,1.0,36,1050,900,150,0.8571428571428571,12,9,3,392.01983714919123,0.3606646825396826,0.09276973457428461,0.2544182433042065,135144.09180252042,3402.614656047652,138546.70645856808,1775,22,767.9166666666666,30,6,18,29.863355308514304,0.6861111111111111,40.05376344086021,1039.7849462365584,34.65949820788528,3
1821,4,0,0,36,0.0,0.0,1.0,36,1050,700,350,0.6666666666666666,14,7,7,389.93939580643377,0.3604497354497354,0.07881195366662364,0.2542983035330755,135318.84330919766,3353.2296002428125,138672.07290944047,1776,23,768.9166666666666,30,6,18,29.742873444430092,0.6878472222222222,39.88575268817205,1040.4569892473123,34.681899641577075,0
1822,4,0,0,36,0.0,0.0,1.0,36,900,600,300,0.6666666666666666,12,6,6,388.7915358874985,0.36021825396825397,0.07926619324295259,0.2545384991926186,135458.72581006485,3333.041211411737,138791.76702147658,1777,24,769.9166666666666,30,6,20,29.63309662147622,0.689236111111111,39.75134408602151,1040.9946236559147,34.69982078853049,0
1823,4,0,0,36,0.0,0.0,1.0,36,900,600,300,0.6666666666666666,12,6,6,387.2770027511097,0.35983796296296294,0.07732306279943768,0.2537942185541536,135493.70772632674,3294.7194039773417,138788.42713030407,1778,25,770.9166666666666,30,6,20,29.637608658232203,0.6895833333333332,39.71774193548387,1041.1290322580646,34.70430107526882,0
1824,4,0,0,36,0.0,0.0,1.0,36,800,600,200,0.75,10,6,4,387.67406209899775,0.3599702380952381,0.07426889261793113,0.2543023674073612,135528.69415900685,3308.19187911898,138836.8860381258,1779,26,771.9166666666666,30,6,20,29.592369089109763,0.6899305555555555,39.68413978494624,1041.2634408602153,34.70878136200717,0
1825,4,0,0,36,0.0,0.0,1.0,36,650,300,350,0.46153846153846156,10,3,7,388.79999999999995,0.35993716931216935,0.06933333333333347,0.2557894736842106,135633.6805555556,3346.875000000005,138980.5555555556,1780,27,772.9166666666666,30,6,20,29.45833333333334,0.6909722222222222,39.583333333333336,1041.666666666667,34.722222222222236,0
1826,4,0,0,36,0.0,0.0,1.0,36,950,700,250,0.7368421052631579,12,7,5,389.82825353184575,0.3598544973544973,0.07528626911446423,0.2572202935857363,135738.70759986708,3382.956664065213,139121.6642639323,1781,28,773.9166666666666,30,6,20,29.326819725697572,0.6920138888888888,39.48252688172043,1042.0698924731187,34.73566308243729,0
1827,4,0,0,36,0.0,0.0,1.0,36,800,500,300,0.625,11,5,6,385.6183776263694,0.36053240740740744,0.07373182373182385,0.25563178543311,135905.08355034728,3281.4995659722326,139186.5831163195,1782,29,774.9166666666666,31,5,17,29.270729270729266,0.6908602150537634,39.32291666666667,1042.708333333334,33.63575268817206,0
1828,4,0,0,36,0.0,0.0,1.0,36,1250,900,350,0.72,16,9,7,383.76331230288497,0.36061507936507936,0.049279550975957376,0.24276537673341486,134213.2653130426,3103.6668565538253,137316.9321695964,1783,30,775.9166666666666,31,5,20,31.00915221579961,0.6740591397849462,40.950520833333336,1036.197916666667,33.42573924731184,3
1829,4,0,0,36,0.0,0.0,1.0,36,1050,800,250,0.7619047619047619,13,8,5,383.87277175062883,0.36061507936507936,0.04080608993272761,0.24659241812305363,134773.37630058153,3194.7902798240234,137968.16658040555,1784,31,776.9166666666666,33,3,24,30.445606632833705,0.6745580808080808,40.41053921568628,1038.3578431372553,31.465389185977433,5
1830,4,0,0,36,0.0,0.0,1.0,36,700,300,400,0.42857142857142855,11,3,8,382.0888722915007,0.36005291005291,0.03679091557185066,0.2466621063136259,134952.49433106594,3112.7692743764364,138065.2636054424,1785,32,777.9166666666666,34,2,20,30.3128819126184,0.6740196078431371,40.23809523809525,1039.0476190476204,30.560224089635895,0
1831,4,0,0,36,0.0,0.0,1.0,36,900,700,200,0.7777777777777778,11,7,4,378.05566440642673,0.35970568783068785,0.03411284335560549,0.24459220939263054,135031.5339934842,3009.887259945132,138041.42125342932,1786,33,778.9166666666666,35,1,20,30.338715664439498,0.6726190476190477,40.16203703703704,1039.3518518518517,29.695767195767193,0
1832,4,0,0,36,0.0,0.0,1.0,36,950,800,150,0.8421052631578947,11,8,3,378.81046456468675,0.359755291005291,0.04244093319980724,0.24651481861280522,135242.13291162977,3046.2270393947183,138288.3599510245,1787,34,779.9166666666666,35,1,20,30.10888412892696,0.6747023809523809,39.95949074074074,1040.162037037037,29.71891534391534,0
1833,4,0,0,36,0.0,0.0,1.0,36,1100,1000,100,0.9090909090909091,12,10,2,379.08738049074424,0.3604001322751323,0.04139784946236591,0.24731462631435355,135332.4398255316,3060.564021776417,138393.00384730802,1788,35,780.9166666666666,35,1,20,30.011586948461247,0.675595238095238,39.87268518518519,1040.5092592592598,29.728835978835995,0
1834,4,0,0,36,0.0,0.0,1.0,36,1050,800,250,0.7619047619047619,13,8,5,377.78302779718325,0.36147486772486775,0.04247199384585798,0.2473248094162296,135457.78041555072,3034.73008481455,138492.51050036526,1789,36,781.9166666666666,36,0,20,29.920534040098076,0.6747685185185185,39.752252252252255,1040.9909909909913,28.916416416416425,0
1835,4,0,0,36,0.0,0.0,1.0,36,1150,900,250,0.782608695652174,14,9,5,379.1454281414827,0.3609457671957672,0.04135121493979388,0.24862259777277657,135516.4011139519,3076.0847841084433,138592.48589806035,1790,37,782.9166666666666,36,0,20,29.826636743817144,0.6753472222222221,39.69594594594595,1041.216216216217,28.922672672672693,0
1836,4,0,0,36,0.0,0.0,1.0,36,900,700,200,0.7777777777777778,11,7,4,378.71960185729426,0.3605654761904762,0.04300464915125968,0.24895363166866505,135604.35593955452,3071.205538308589,138675.5614778631,1791,38,783.9166666666666,36,0,21,29.75006306988142,0.6762152777777778,39.61148648648649,1041.5540540540549,28.93205705705708,0
1837,4,0,0,36,0.0,0.0,1.0,36,650,400,250,0.6153846153846154,9,4,5,379.23637825065407,0.36008597883597887,0.040587548242940974,0.249930480606154,135695.6916099774,3092.154866877362,138787.84647685476,1792,39,784.9166666666666,34,2,21,29.645604814137716,0.6813725490196079,39.523809523809526,1041.9047619047624,30.644257703081248,0
1838,4,0,0,36,0.0,0.0,1.0,36,700,500,200,0.7142857142857143,9,5,4,380.1942246030392,0.3604497354497354,0.040286345289772374,0.2509970016723233,135757.71683673482,3122.8599773242804,138880.5768140591,1793,40,785.9166666666666,34,2,21,29.558868326860107,0.681985294117647,39.46428571428572,1042.1428571428582,30.651260504201712,0
1839,4,0,0,36,0.0,0.0,1.0,36,500,300,200,0.6,7,3,4,380.4988974237124,0.3601686507936508,0.04002474776318343,0.25141644127883805,135788.73476473935,3133.4927721088607,138922.22753684822,1794,41,786.9166666666666,34,2,21,29.520036169807735,0.6822916666666665,39.43452380952382,1042.2619047619057,30.654761904761934,0
1840,4,0,0,36,0.0,0.0,1.0,36,900,600,300,0.6666666666666666,12,6,6,379.3868517943821,0.3586805555555555,0.04364082657837676,0.2515555968862222,135912.84190759648,3112.709041950127,139025.5509495466,1795,42,787.9166666666666,34,2,19,29.425448110514907,0.683517156862745,39.3154761904762,1042.738095238096,30.668767507002826,0
1841,4,0,0,36,0.0,0.0,1.0,36,1100,700,400,0.6363636363636364,15,7,8,380.151831641235,0.357390873015873,0.04983520314381695,0.2533863729532644,136099.10891439917,3147.6651077097595,139246.77402210893,1796,43,788.9166666666666,34,2,21,29.22014641566838,0.6853553921568627,39.136904761904766,1043.4523809523816,30.689775910364165,0
1842,4,0,0,36,0.0,0.0,1.0,36,850,700,150,0.8235294117647058,10,7,3,377.14334765799146,0.3571097883597884,-0.014569154672914308,0.2405932971571938,134520.76266986007,2946.7221525634227,137467.4848224235,1797,44,789.9166666666666,35,1,20,30.872870876566637,0.6675595238095239,40.653935185185176,1037.3842592592578,29.639550264550223,5
1843,4,0,0,36,0.0,0.0,1.0,36,1000,600,400,0.6,14,6,8,376.6780603488861,0.3560185185185185,-0.01560628074736825,0.24110714611759082,134643.43112244885,2943.44864376433,137586.87976621318,1798,45,790.9166666666666,34,2,20,30.762263898447653,0.6709558823529412,40.53571428571428,1037.8571428571418,30.52521008403358,0
1844,4,0,0,36,0.0,0.0,1.0,36,1150,900,250,0.782608695652174,14,9,5,377.25108403153837,0.35537367724867724,-0.011537187766695878,0.24250266809190174,134797.91843820855,2970.532171201809,137768.45060941036,1799,46,791.9166666666666,34,2,16,30.592972601169322,0.6724877450980392,40.38690476190476,1038.4523809523805,30.54271708683472,0
1845,4,1,0,37,0.02702702702702703,0.0,1.0,37,800,700,100,0.875,9,7,2,370.01792079732263,0.35873373373373374,0.00680413301448346,0.24039125223166577,135181.94504726047,2603.948447145023,137785.8934944055,1800,0,771.4864864864865,35,2,17,30.397537562604338,0.674107142857143,40.01736111111109,1039.930555555553,29.71230158730151,0
1846,4,1,1,37,0.02631578947368421,0.02631578947368421,0.9736842105263158,38,1000,700,300,0.7,13,7,6,359.1594462156898,0.36277560455192037,0.0035146534011027963,0.23570953862004843,135545.71621875255,2136.504874807244,137682.2210935598,1801,0,752.1578947368421,36,2,17,30.317715655527923,0.6756365740740742,39.667792792792795,1041.328828828829,28.925800800800808,0
1847,4,0,0,37,0.0,0.0,1.0,37,850,500,350,0.5882352941176471,12,5,7,363.88111361972784,0.3564189189189189,0.00248185929119793,0.23839115928692264,135483.01832829634,2459.942317172482,137942.96064546882,1802,2,773.4864864864865,35,2,17,30.257203075782847,0.6770833333333334,39.72800925925925,1041.087962962962,29.745370370370342,0
1848,4,0,1,36,0.0,0.02702702702702703,0.972972972972973,37,900,700,200,0.7777777777777778,11,7,4,368.3599443618662,0.3564189189189189,0.031594460616542586,0.2191396022892713,131921.96609224982,2318.9536179698384,134240.91971021966,1803,3,774.4864864864865,35,2,14,33.710755595613634,0.6416666666666666,43.171296296296305,1027.3148148148161,29.35185185185189,5
1849,4,0,0,36,0.0,0.0,1.0,36,800,500,300,0.625,11,5,6,376.5127173660556,0.3546792328042328,0.02832496459379419,0.22408998281855605,131938.95266439923,2735.338718820877,134674.29138322012,1804,4,769.9444444444445,34,2,14,33.48421205098493,0.6439950980392156,43.15476190476191,1027.3809523809534,30.217086834733923,0
1850,4,0,0,36,0.0,0.0,1.0,36,1200,1100,100,0.9166666666666666,13,11,2,377.0818691624041,0.35540674603174605,0.017982686582101115,0.22538635006059712,132100.37964034636,2762.5316143689956,134862.91125471535,1805,5,770.9444444444445,35,1,15,33.30659386024168,0.6434523809523809,42.99768518518518,1028.0092592592591,29.371693121693117,0
1851,4,1,0,37,0.02702702702702703,0.0,1.0,37,750,500,250,0.6666666666666666,10,5,5,368.76787389930314,0.3593280780780781,0.02052019189248311,0.2219895146042053,132369.03077063573,2362.6892094797745,134731.7199801155,1806,0,751.081081081081,36,1,16,33.249434595462176,0.6440972222222221,42.7364864864865,1029.054054054056,28.58483483483489,0
1852,4,0,0,37,0.0,0.0,1.0,37,900,700,200,0.7777777777777778,11,7,4,365.3677388532315,0.35939064064064064,0.011540039196025642,0.22063448995923252,132487.35592689045,2281.3243027303783,134768.68022962083,1807,1,752.081081081081,35,2,17,33.21774873524452,0.6473214285714286,42.62152777777778,1029.513888888889,29.41468253968254,0
1853,4,0,0,37,0.0,0.0,1.0,37,900,600,300,0.6666666666666666,12,6,6,366.7746628484615,0.35910910910910915,0.014702265460607267,0.22253996414547755,132666.1512586805,2331.7165798611063,134997.8678385416,1808,2,753.081081081081,35,2,13,33.00155881361644,0.6491071428571429,42.447916666666664,1030.208333333333,29.4345238095238,0
1854,4,0,0,37,0.0,0.0,1.0,37,650,400,250,0.6153846153846154,9,4,5,365.177101811225,0.35910910910910915,0.012350701634009198,0.22174669579287345,132695.9622020747,2291.5053798010963,134987.4675818758,1809,3,754.081081081081,35,2,13,33.012712499063895,0.6494047619047618,42.41898148148148,1030.3240740740737,29.437830687830676,0
1855,4,1,2,36,0.02631578947368421,0.05263157894736842,0.9473684210526316,38,1250,1000,250,0.8,15,10,5,353.9521228995009,0.3620050972024656,0.015147162743667453,0.21689333765099184,133036.2050183629,1817.6894377485569,134853.89445611145,1810,0,735.2105263157895,36,2,13,32.960148091547495,0.6507523148148149,42.08896396396396,1031.6441441441439,28.656781781781774,0
1856,4,0,0,36,0.0,0.0,1.0,36,700,500,200,0.7142857142857143,9,5,4,371.9792196965294,0.35588624338624336,0.006771154241117738,0.22611321107395807,132735.14739229047,2674.9433106576225,135410.0907029481,1811,11,776.9444444444445,34,2,13,32.79805914972273,0.6519607843137254,42.380952380952394,1030.4761904761922,30.30812324929977,0
1857,4,0,0,36,0.0,0.0,1.0,36,1400,1100,300,0.7857142857142857,17,11,6,374.3546976185196,0.35535714285714287,0.004857824464196581,0.22886624879811152,132949.91673752852,2754.085175736983,135704.0019132655,1812,12,777.9444444444445,34,2,13,32.5207299241987,0.6541053921568627,42.17261904761906,1031.3095238095252,30.33263305322133,0
1858,4,0,0,36,0.0,0.0,1.0,36,950,700,250,0.7368421052631579,12,7,5,373.12759444728744,0.35529100529100527,0.0016189010707190477,0.22849120889651925,133011.31129535154,2726.0381235827713,135737.34941893432,1813,13,778.9444444444445,34,2,14,32.4906231967686,0.6547181372549019,42.11309523809524,1031.5476190476195,30.33963585434175,0
1859,4,0,0,36,0.0,0.0,1.0,36,1000,600,400,0.6,14,6,8,372.51556038216654,0.3551587301587302,-0.0007211261105339872,0.22849202843823344,133072.7200255102,2714.3317743764205,135787.05179988663,1814,14,779.9444444444445,34,2,14,32.444665589785004,0.6553308823529411,42.05357142857143,1031.7857142857144,30.34663865546219,0
1860,4,0,0,36,0.0,0.0,1.0,36,650,500,150,0.7692307692307693,8,5,3,372.3584075347606,0.35550595238095234,0.0008011587960825572,0.2285837589597243,133103.42970521544,2712.436224489799,135815.86592970524,1815,15,780.9444444444445,34,2,15,32.41784917704968,0.6556372549019608,42.023809523809526,1031.9047619047622,30.350140056022415,0
1861,4,1,0,37,0.02702702702702703,0.0,1.0,37,650,400,250,0.6153846153846154,9,4,5,368.96096939229096,0.36107982982982983,0.004523174457082613,0.22857144856106754,133442.32420535415,2447.0018593535715,135889.3260647077,1816,0,760.8108108108108,35,2,16,32.16517773794854,0.6568452380952381,41.695601851851855,1033.217592592593,29.52050264550266,0
1862,4,1,0,38,0.02631578947368421,0.0,1.0,38,950,800,150,0.8421052631578947,11,8,3,375.7071892275827,0.3663614272166904,0.017087516479058706,0.21909216989788238,131159.5935768697,2325.932748196608,133485.5263250663,1817,0,741.7631578947369,37,1,18,34.2931563548134,0.6300675675675677,43.91447368421052,1024.342105263157,27.68492176386911,7
1863,4,0,0,38,0.0,0.0,1.0,38,1150,700,450,0.6086956521739131,16,7,9,378.48013187768777,0.36643551446183026,0.018787339591086916,0.2215187096218374,131300.02891514674,2338.890451869776,133638.91936701653,1818,1,742.7631578947369,37,1,18,34.07989640169749,0.6314752252252254,43.77741228070174,1024.8903508771912,27.699739212897057,0
1864,4,1,0,39,0.02564102564102564,0.0,1.0,39,1050,800,250,0.7619047619047619,13,8,5,374.7476381861339,0.3706702654071075,0.03391829090656873,0.2222433854269635,131803.09070644696,2078.588406772332,133881.6791132193,1819,0,724.6923076923077,35,4,18,33.66677938082356,0.6404761904761906,43.287037037037024,1026.85185185185,29.33862433862428,0
1865,4,0,0,39,0.0,0.0,1.0,39,1100,700,400,0.6363636363636364,15,7,8,375.9270229800769,0.37036099865047234,0.03681492009567755,0.22364130401951454,131921.96609224938,2118.6063957475735,134040.57248799695,1820,1,725.6923076923077,35,4,19,33.516411296379765,0.6416666666666668,43.17129629629628,1027.3148148148127,29.35185185185179,0
1866,4,0,0,39,0.0,0.0,1.0,39,1150,900,250,0.782608695652174,14,9,5,371.8106119589382,0.3702204228520018,0.035397534192715074,0.22245287596232657,132137.36329234633,2026.014781673558,134163.37807401989,1821,2,726.6923076923077,36,3,19,33.40475538517707,0.6417824074074074,42.96171171171171,1028.1531531531525,28.559809809809792,0
1867,4,1,0,40,0.025,0.0,1.0,40,850,600,250,0.7058823529411765,11,6,5,366.4617242041582,0.3749332264957265,0.044577195547059745,0.22094536361678474,132427.78427479835,1706.4564363968066,134134.24071119516,1822,0,709.5,35,5,20,33.24958300536002,0.6467261904761905,42.67939814814814,1029.282407407406,29.408068783068742,0
1868,4,0,0,40,0.0,0.0,1.0,40,1050,700,350,0.6666666666666666,14,7,7,365.4621267015168,0.37442574786324784,0.0435926258992807,0.22086624178917727,132517.1467764058,1685.999657064449,134203.14643347025,1823,1,710.5,35,5,20,33.18532673860911,0.6476190476190478,42.59259259259258,1029.629629629628,29.41798941798937,0
1869,4,0,0,40,0.0,0.0,1.0,40,1300,900,400,0.6923076923076923,17,9,8,364.43990613844227,0.3733974358974359,0.04467875874125915,0.22176555990552,132774.93709926127,1677.697122798459,134452.6342220597,1824,2,711.5,36,4,18,32.952269085081596,0.6481481481481483,42.342342342342334,1030.6306306306294,28.628628628628594,0
1870,4,0,0,40,0.0,0.0,1.0,40,800,600,200,0.75,10,6,4,367.179391366499,0.37366452991452986,0.0513545990823685,0.223778971276227,132832.97444403855,1754.7061419527524,134587.6805859913,1825,3,712.5,36,4,18,32.823310392542425,0.6487268518518519,42.28603603603603,1030.8558558558552,28.63488488488487,0
1871,4,0,1,39,0.0,0.025,0.975,40,1150,700,450,0.6086956521739131,16,7,9,363.4092736776323,0.37366452991452986,0.05756214354890776,0.20455253666179513,129787.30384589492,1500.2993353920979,131287.603181287,1826,4,713.5,37,3,19,36.00010312421536,0.6162725225225225,45.25767543859649,1018.9692982456143,27.53971076339498,7
1872,4,0,0,39,0.0,0.0,1.0,39,1150,900,250,0.782608695652174,14,9,5,362.80095423525364,0.372638326585695,0.047769582016157885,0.2047427829013416,129889.23890106335,1624.7879636393307,131514.02686470267,1827,5,715.4102564102565,36,3,20,35.91195315952276,0.6192129629629629,45.157657657657666,1019.3693693693704,28.315815815815842,0
1873,4,1,0,40,0.025,0.0,1.0,40,1100,800,300,0.7272727272727273,14,8,6,356.9847510163886,0.3779246794871795,0.04858668341708583,0.2029713298636037,130180.80210387894,1294.5122452333924,131475.31434911233,1828,0,698.5,38,2,21,35.76410699329984,0.618421052631579,44.87179487179487,1020.5128205128199,26.85560053981105,0
1874,4,0,0,40,0.0,0.0,1.0,40,650,500,150,0.7692307692307693,8,5,3,357.3379164096212,0.37753739316239315,0.04466921385952061,0.20331442021805307,130208.06081753602,1305.655430455114,131513.71624799113,1829,1,699.5,38,2,21,35.727432918106004,0.6186951754385964,44.84508547008547,1020.6196581196585,26.858412055780487,0
1875,4,0,0,40,0.0,0.0,1.0,40,750,500,250,0.6666666666666666,10,5,5,357.68429820907926,0.3779647435897436,0.04806122448979555,0.20379686758424298,130262.58680555566,1318.5763888888982,131581.16319444455,1830,2,700.5,38,2,21,35.66326530612245,0.6192434210526315,44.79166666666667,1020.8333333333343,26.864035087719323,0
1876,4,1,1,40,0.024390243902439025,0.024390243902439025,0.975609756097561,41,800,400,400,0.5,12,4,8,348.9350624500985,0.38127540650406505,0.04884679567230665,0.20002589164347223,130498.99798525384,907.1352023319726,131406.1331875858,1831,0,684.390243902439,35,6,18,35.64699441172029,0.6273809523809523,44.56018518518519,1021.7592592592598,29.193121693121707,0
1877,4,1,1,40,0.024390243902439025,0.024390243902439025,0.975609756097561,41,1150,900,250,0.782608695652174,14,9,5,349.12002338454187,0.3847560975609756,0.0468084988855777,0.20059069137988864,130587.7074358067,918.1566947445071,131505.8641305512,1832,0,685.3658536585366,35,6,18,35.552433661721956,0.6282738095238095,44.473379629629626,1022.1064814814811,29.203042328042315,0
1878,4,0,1,39,0.0,0.025,0.975,40,1100,1000,100,0.9090909090909091,12,10,2,361.7498917537859,0.3778311965811966,0.04783433359755418,0.207847319068164,130587.70743580667,1448.0178058556178,132035.7252416623,1833,5,703.5,35,5,19,35.229706903710415,0.6282738095238095,44.473379629629626,1022.1064814814808,29.20304232804231,0
1879,4,2,1,40,0.04878048780487805,0.024390243902439025,0.975609756097561,41,600,300,300,0.5,9,3,6,352.1357787349889,0.38597560975609757,0.05009597701920909,0.20363803627036123,130838.01442912518,1014.5492198279484,131852.56364895313,1834,0,686.9024390243902,36,5,20,35.22197761878556,0.6287615740740741,44.22860360360361,1023.0855855855864,28.419044044044067,0
1880,4,0,0,40,0.0,0.0,1.0,40,950,600,350,0.631578947368421,13,6,7,361.1649196743007,0.37856570512820514,0.05361507128309606,0.20862585360009583,130794.81336805545,1447.6996527777683,132242.51302083323,1835,1,705.075,35,5,21,35.03479293957909,0.6303571428571428,44.27083333333333,1022.9166666666657,29.22619047619045,0
1881,4,0,1,39,0.0,0.025,0.975,40,1050,700,350,0.6666666666666666,14,7,7,381.2819134641221,0.37856570512820514,0.04836065573770498,0.21143815201192254,129201.38888888908,1853.51562500002,131054.9045138891,1836,2,706.075,36,4,20,36.14241803278688,0.6122685185185184,45.83333333333334,1016.6666666666682,28.240740740740783,3
1882,4,2,2,39,0.04878048780487805,0.04878048780487805,0.9512195121951219,41,1150,900,250,0.782608695652174,14,9,5,368.3727520537431,0.3881605691056911,0.06479981236200083,0.20712668041207105,129745.78622118778,1358.9624675351452,131104.74868872293,1837,0,687.780487804878,36,5,18,35.91591135182934,0.6177662037037035,45.29842342342344,1018.8063063063094,28.30017517517526,0
1883,4,1,0,40,0.025,0.0,1.0,40,1150,800,350,0.6956521739130435,15,8,7,368.07525605421347,0.381116452991453,0.12582552431950056,0.1950015718244662,127376.05003652291,1377.8216561155648,128753.87169263848,1838,0,705.95,36,4,14,38.34620890971293,0.59375,47.63513513513513,1009.4594594594587,28.04054054054052,7
1884,4,5,3,42,0.1111111111111111,0.06666666666666667,0.9333333333333333,45,1150,900,250,0.782608695652174,14,9,5,331.0118878099829,0.4023148148148148,0.12277051408219708,0.17959477940445523,128333.90404704507,-497.0567651884799,127836.8472818566,1839,0,628.4,38,7,17,38.30310698720652,0.5997807017543859,46.68803418803419,1013.2478632478632,26.664417453891136,0
1885,4,0,0,42,0.0,0.0,1.0,42,750,600,150,0.8,9,6,3,348.22338870893026,0.38938492063492064,0.12701271965296712,0.18742328095885066,128012.72922092005,515.4052734374898,128528.13449435754,1840,1,674.2857142857143,39,3,18,38.195337965345686,0.5948183760683762,47.00520833333333,1011.979166666666,25.948183760683744,0
1886,4,2,0,44,0.045454545454545456,0.0,1.0,44,900,600,300,0.6666666666666666,12,6,6,334.55991852314753,0.3937191684284707,0.14004415666516623,0.1823841577658352,128523.41666894937,-200.03978766312792,128323.37688128624,1841,0,644.5909090909091,38,6,16,38.02001018508762,0.6016995614035088,46.50106837606837,1013.9957264957253,26.68409806567698,0
1887,4,1,2,43,0.022222222222222223,0.044444444444444446,0.9555555555555556,45,900,500,400,0.5555555555555556,13,5,8,328.4593672740166,0.39800084175084177,0.14739433729995866,0.1806897241640584,128883.87586805563,-533.3767361111061,128350.49913194453,1842,0,631.2444444444444,39,6,17,37.807755437012716,0.6036324786324787,46.145833333333336,1015.4166666666673,26.0363247863248,0
1888,4,1,0,44,0.022727272727272728,0.0,1.0,44,550,100,450,0.18181818181818182,10,1,9,337.12337195356804,0.3947322057787174,0.1571533140052246,0.18503807954539858,128794.39153928333,-116.08008711374251,128678.31145216958,1843,0,646.4318181818181,38,6,18,37.678928533838544,0.6044407894736842,46.23397435897436,1015.0641025641023,26.712213225371112,0
1889,4,2,1,45,0.043478260869565216,0.021739130434782608,0.9782608695652174,46,1450,1100,350,0.7586206896551724,18,11,7,325.6726254793108,0.39792673107890497,0.1677294782521821,0.18119273532086824,129330.57089240856,-776.1146845462429,128554.45620786231,1844,0,619.2826086956521,40,6,20,37.424651147300764,0.6065104166666667,45.70630081300813,1017.174796747967,25.429369918699173,0
1890,4,1,1,45,0.021739130434782608,0.021739130434782608,0.9782608695652174,46,1150,700,450,0.6086956521739131,16,7,9,320.88405915214446,0.40072463768115946,0.16435373145345822,0.17899788770420158,129433.96297053654,-893.3409139731831,128540.62205656336,1845,0,620.2608695652174,40,6,16,37.44153433869302,0.6075520833333334,45.60467479674796,1017.5813008130067,25.439532520325166,0
1891,4,0,0,45,0.0,0.0,1.0,45,1400,1000,400,0.7142857142857143,18,10,8,330.14251687470346,0.3963173400673401,0.17366457366457366,0.18406575940822514,129413.28125000003,-455.0347222222211,128958.24652777781,1846,2,635.0444444444445,39,6,20,37.22699972699972,0.608974358974359,45.625,1017.5000000000002,26.089743589743595,0
1892,4,0,1,44,0.0,0.022222222222222223,0.9777777777777777,45,1250,800,450,0.64,17,8,9,329.6890996269152,0.3962962962962963,0.177304819400389,0.1844334041587776,129545.80213758687,-458.0322265624906,129087.76991102438,1847,3,636.0444444444445,39,6,16,37.10403236808896,0.610309829059829,45.49479166666667,1018.0208333333339,26.103098290598307,0
1893,4,3,3,44,0.06382978723404255,0.06382978723404255,0.9361702127659575,47,1000,800,200,0.8,12,8,4,321.8647688821686,0.4025400863398088,0.18506787892337684,0.18196513171457251,129958.94451530612,-1034.158871882085,128924.78564342404,1848,0,609.8510638297872,41,6,17,36.88460790036973,0.6112804878048781,45.089285714285715,1019.6428571428572,24.86933797909408,0
1894,4,1,0,45,0.022222222222222223,0.0,1.0,45,1300,1000,300,0.7692307692307693,16,10,6,317.8363932762331,0.39520202020202017,0.18596227103720397,0.17414860198521168,128725.26584201396,-794.6094192885454,127930.65642272541,1849,0,637.7777777777778,39,6,13,38.238640251830546,0.6020299145299146,46.302083333333336,1014.7916666666673,26.020299145299163,5
1895,4,0,1,44,0.0,0.022222222222222223,0.9777777777777777,45,1100,700,400,0.6363636363636364,15,7,8,322.22124436875055,0.3957491582491583,0.19022149265300992,0.17713990236109517,128857.43408203153,-695.8794487846933,128161.55463324684,1850,1,638.7777777777778,39,6,13,37.992993570671324,0.6033653846153846,46.171875000000014,1015.3125000000022,26.0336538461539,0
1896,4,1,1,44,0.022222222222222223,0.022222222222222223,0.9777777777777777,45,1200,800,400,0.6666666666666666,16,8,8,323.54798675303425,0.395223063973064,0.19307877254754513,0.17834462514577948,128963.21750217032,-654.8421223958152,128308.3753797745,1851,0,639.5777777777778,39,6,14,37.851780159299906,0.6044337606837606,46.06770833333334,1015.7291666666681,26.044337606837644,0
1897,4,1,0,45,0.022222222222222223,0.0,1.0,45,1150,700,450,0.6086956521739131,16,7,9,322.42134320199034,0.39726430976430976,0.1949607769466355,0.17867744964839485,129174.91455078169,-670.2501085069011,128504.66444227479,1852,0,640.5555555555555,39,6,16,37.665338832530665,0.6065705128205126,45.85937500000002,1016.5625000000035,26.06570512820522,0
1898,4,2,2,45,0.0425531914893617,0.0425531914893617,0.9574468085106383,47,1250,1000,250,0.8,15,10,5,311.2782543410848,0.40525747764415665,0.1877871448325077,0.17409683270433574,129537.39636005393,-1335.5623651570086,128201.83399489692,1853,0,614.2553191489362,40,7,12,37.58111210941399,0.6085937499999998,45.50304878048782,1017.987804878052,25.4496951219513,0
1899,4,1,1,45,0.021739130434782608,0.021739130434782608,0.9782608695652174,46,1450,900,550,0.6206896551724138,20,9,11,318.1310454006068,0.4004931561996779,0.19810716572973686,0.17832850343098244,129625.34722222234,-952.4305555555447,128672.91666666679,1854,0,628.5869565217391,39,7,14,37.31758046917621,0.611111111111111,45.41666666666667,1018.3333333333343,26.111111111111136,0
1900,4,0,1,44,0.0,0.022222222222222223,0.9777777777777777,45,1150,700,450,0.6086956521739131,16,7,9,321.12416008219554,0.40082070707070705,0.19768523374943192,0.18018108405318228,129663.428722423,-672.3880716268648,128991.04065079615,1855,1,634.1111111111111,38,7,14,37.20278681072765,0.6132127192982457,45.3792735042735,1018.4829059829051,26.80218173639224,0
1901,4,0,0,44,0.0,0.0,1.0,44,1200,900,300,0.75,15,9,6,322.9173324622757,0.40121784707540525,0.19836527202096588,0.18174783349516596,129784.51063368063,-418.06640624999216,129366.44422743065,1856,2,640.8181818181819,39,5,14,37.0344339944115,0.6127136752136751,45.26041666666667,1018.958333333334,26.12713675213677,0
1902,4,1,0,45,0.022222222222222223,0.0,1.0,45,650,500,150,0.7692307692307693,8,5,3,320.2117493559175,0.4036195286195286,0.20920815205960142,0.1814774324271793,130055.1829784686,-670.9604691321229,129384.22250933647,1857,0,627.5555555555555,40,5,15,36.82935638138887,0.6138020833333333,44.994918699187,1020.0203252032528,25.50050813008132,0
1903,4,1,2,44,0.021739130434782608,0.043478260869565216,0.9565217391304348,46,1150,800,350,0.6956521739130435,15,8,7,313.6754986043745,0.40623993558776167,0.20933946163334993,0.17895500175367077,130313.22830057939,-1024.7866276140192,129288.44167296537,1858,0,614.8913043478261,41,5,15,36.73524744137842,0.6148373983739838,44.74206349206349,1021.0317460317452,24.903213317847445,0
1904,4,0,0,44,0.0,0.0,1.0,44,1700,1400,300,0.8235294117647058,20,14,6,326.06203713784873,0.40032593375616626,0.22022903597015464,0.18527283734352487,130156.27170138895,-312.196180555551,129844.0755208334,1859,2,643.5,39,5,15,36.57785490676466,0.6164529914529915,44.895833333333336,1020.4166666666672,26.16452991452993,0
1905,4,2,0,46,0.043478260869565216,0.0,1.0,46,850,400,450,0.47058823529411764,13,4,9,311.91437604113304,0.4062097423510467,0.22066082231540918,0.17958600890949228,130667.99433893904,-1048.5548154447226,129619.43952349432,1860,0,616.4782608695652,41,5,14,36.42214891002004,0.6183943089430896,44.39484126984126,1022.420634920633,24.937088656600807,0
1906,4,0,1,45,0.0,0.021739130434782608,0.9782608695652174,46,1500,1100,400,0.7333333333333333,19,11,8,321.433396820969,0.406682769726248,0.15434371987880158,0.18486555395209442,130625.94112507455,-791.1147701666468,129834.8263549079,1861,1,617.4782608695652,40,6,14,36.22129436325678,0.6195312499999999,44.435975609756106,1022.2560975609771,25.556402439024428,5
1907,4,0,1,44,0.0,0.022222222222222223,0.9777777777777777,45,950,700,250,0.7368421052631579,12,7,5,329.525369488067,0.402483164983165,0.16944670832201392,0.18982517763467532,130688.28125000013,-386.9791666666507,130301.30208333347,1862,2,632.0,39,6,16,35.95150774246131,0.6217948717948718,44.37500000000001,1022.500000000001,26.217948717948744,0
1908,4,1,1,44,0.022222222222222223,0.022222222222222223,0.9777777777777777,45,850,400,450,0.47058823529411764,13,4,9,329.09806849069287,0.4022727272727273,0.1775515513477437,0.19049677824302183,130874.74093967033,-385.8751085069231,130488.8658311634,1863,0,632.8,39,6,17,35.7741397739998,0.6236645299145298,44.19270833333334,1023.2291666666682,26.23664529914534,0
1909,4,1,2,43,0.022222222222222223,0.044444444444444446,0.9555555555555556,45,1300,900,400,0.6923076923076923,17,9,8,322.9572105239734,0.4032828282828283,0.1811235447044195,0.1878502591390925,131061.33355034745,-534.559461805531,130526.77408854192,1864,0,632.8666666666667,39,6,17,35.74304849101391,0.6255341880341879,44.01041666666668,1023.9583333333352,26.255341880341927,0
1910,4,0,0,43,0.0,0.0,1.0,43,1150,800,350,0.6956521739130435,15,8,7,334.7007852132684,0.3970561092654116,0.19002510301709807,0.19333892416437037,130794.81336805565,155.42534722222769,130950.23871527788,1865,2,663.2093023255813,37,6,18,35.71155804480651,0.6264076576576576,44.270833333333336,1022.9166666666674,27.646396396396415,0
1911,4,0,0,43,0.0,0.0,1.0,43,1100,900,200,0.8181818181818182,13,9,4,335.89237672570175,0.3963178294573643,0.19317453948204677,0.19430947099984638,130850.90033712289,190.36398218682177,131041.26431930972,1866,3,664.2093023255813,37,6,18,35.62441949773158,0.6269707207207207,44.21600877192982,1023.1359649122801,27.65232337600757,0
1912,4,0,0,43,0.0,0.0,1.0,43,1150,800,350,0.6956521739130435,15,8,7,335.12452131774813,0.3961101882613511,0.19391970340988984,0.19428896161365578,130935.05333371794,175.90941443519762,131110.96274815314,1867,4,665.2093023255813,37,6,18,35.55906720948505,0.6278153153153154,44.133771929824555,1023.4649122807007,27.661213845424342,0
1913,4,0,0,43,0.0,0.0,1.0,43,1150,900,250,0.782608695652174,14,9,5,331.1796356298109,0.39560262089331855,0.17199839866069788,0.19273568958784057,131081.84633875726,82.32762163048727,131164.17396038774,1868,5,666.2093023255813,38,5,17,35.511867501304096,0.627467105263158,43.990384615384606,1024.0384615384603,26.948380566801585,1
1914,4,1,1,43,0.022727272727272728,0.022727272727272728,0.9772727272727273,44,1450,1000,450,0.6896551724137931,19,10,9,327.09859389739495,0.3976171599718112,0.179760018661975,0.19229120985055514,131468.650510253,-198.895577195142,131269.75493305788,1869,0,652.0454545454545,37,7,19,35.226553868633935,0.6331644144144146,43.61293859649122,1025.548245614034,27.717520151730646,0
1915,4,0,1,42,0.0,0.023255813953488372,0.9767441860465116,43,1350,1100,250,0.8148148148148148,16,11,5,339.1387894139228,0.3970561092654116,0.10933854959066891,0.20386432846791971,132315.55103550284,439.6180340707808,132755.16906957363,1870,1,667.046511627907,38,5,19,34.06542056074766,0.6398026315789473,42.78846153846153,1028.846153846153,27.074898785425077,6
1916,4,0,0,42,0.0,0.0,1.0,42,750,400,350,0.5333333333333333,11,4,7,349.1916400282275,0.3940306813782424,0.1285693983413021,0.20973853820389438,132285.18029586025,838.5758117882392,133123.75610764849,1871,8,683.9047619047619,37,5,19,33.837401406949475,0.6413288288288288,42.81798245614035,1028.7280701754385,27.80346135609293,0
1917,4,1,1,42,0.023255813953488372,0.023255813953488372,0.9767441860465116,43,850,600,250,0.7058823529411765,11,6,5,343.4489898975242,0.395671834625323,0.14098094370270586,0.20783974955654305,132567.32840874116,506.07109879963286,133073.3995075408,1872,0,668.9767441860465,37,6,20,33.70155451448042,0.6441441441441441,42.54385964912281,1029.8245614035088,27.833096254148888,0
1918,4,0,1,41,0.0,0.023809523809523808,0.9761904761904762,42,1550,1300,250,0.8387096774193549,18,13,5,346.73426889995454,0.39260307781649245,0.16066869300911857,0.21109469738727815,132793.2633117883,808.7950138504195,133602.0583256387,1873,1,685.0,37,5,16,33.39007092198581,0.6463963963963963,42.324561403508774,1030.7017543859654,27.85680417259366,0
1919,4,0,0,41,0.0,0.0,1.0,41,1100,900,200,0.8181818181818182,13,9,4,349.6363561805569,0.39021849593495933,0.1758711357047653,0.21382832030132112,132962.84072983998,1097.7286280393982,134060.56935787937,1874,2,701.8536585365854,37,4,17,33.14506697852433,0.6480855855855856,42.16008771929825,1031.3596491228072,27.874585111427223,0
1920,4,0,0,41,0.0,0.0,1.0,41,600,500,100,0.8333333333333334,7,5,2,350.80246500590005,0.38897357723577236,0.18502782753409375,0.21502934157918663,133047.67001625508,1134.690120998778,134182.36013725385,1875,3,702.8536585365854,37,4,17,33.02987830800297,0.6489301801801801,42.077850877192986,1031.6885964912287,27.88347558084402,0
1921,4,0,1,40,0.0,0.024390243902439025,0.975609756097561,41,1000,700,300,0.7,13,7,6,354.1698537859544,0.3889989837398374,0.18827029324266853,0.21758790233899503,133132.52635426287,1230.3054786088032,134362.83183287166,1876,4,703.8536585365854,37,4,17,32.8578764697549,0.6497747747747746,41.99561403508772,1032.0175438596493,27.892366050260794,0
1922,4,0,0,40,0.0,0.0,1.0,40,600,300,300,0.5,9,3,6,362.0395295503765,0.3844284188034188,0.2058435181143603,0.22236797914206774,133123.35139193246,1639.183102020936,134762.5344939534,1877,5,722.05,36,4,17,32.664047722973955,0.6516203703703705,42.0045045045045,1031.9819819819818,28.66616616616616,0
1923,4,0,0,40,0.0,0.0,1.0,40,800,600,200,0.75,10,6,4,361.5635353970111,0.3836271367521367,0.20120268353878057,0.22259589852145079,133210.52629910322,1632.813768160063,134843.34006726329,1878,6,723.05,36,4,18,32.588814952183576,0.6524884259259258,41.92004504504505,1032.3198198198204,28.675550550550568,0
1924,4,0,0,40,0.0,0.0,1.0,40,650,300,350,0.46153846153846156,10,3,7,361.0270556669208,0.3829994658119658,0.2039188615123193,0.22247583482720737,133245.71021852887,1621.0612880886504,134866.77150661752,1879,7,724.05,37,3,19,32.567349900877936,0.6509009009009008,41.885964912280706,1032.4561403508778,27.904220009483186,0
1925,4,0,0,40,0.0,0.0,1.0,40,1000,800,200,0.8,12,8,4,357.96809426571264,0.3824919871794872,0.20044585987261154,0.22126374330597204,133358.94217451528,1547.6492767005257,134906.5914512158,1880,8,725.05,37,3,19,32.532731776362326,0.652027027027027,41.776315789473685,1032.8947368421057,27.916073968705557,0
1926,4,0,0,40,0.0,0.0,1.0,40,1100,800,300,0.7272727272727273,14,8,6,353.0598822196738,0.38234508547008544,0.1936896551724141,0.2190644759657949,133500.54974848026,1426.7376740920254,134927.2874225723,1881,9,726.05,37,3,19,32.51757294429708,0.6534346846846846,41.63925438596491,1033.44298245614,27.930891417733516,0
1927,4,1,1,40,0.024390243902439025,0.024390243902439025,0.975609756097561,41,800,500,300,0.625,11,5,6,347.4630318967282,0.38663617886178864,0.1906873614190685,0.21671663329641314,133693.11125721398,1090.6827562276465,134783.79401344163,1882,0,709.3170731707318,38,3,19,32.46943870523416,0.6535087719298245,41.45299145299146,1034.1880341880355,27.215474583895674,0
1928,4,0,0,40,0.0,0.0,1.0,40,1300,900,400,0.6923076923076923,17,9,8,353.46365303756306,0.382411858974359,0.19016436903499478,0.22015602695800665,133642.23246575875,1447.5343374884653,135089.7668032472,1883,11,728.05,37,3,21,32.36523506539413,0.6548423423423423,41.502192982456144,1033.991228070176,27.945708866761514,0
1929,4,0,0,40,0.0,0.0,1.0,40,950,700,250,0.7368421052631579,12,7,5,355.2879408435163,0.3822916666666667,0.18696332025866602,0.2218021936450621,133727.27816491603,1502.3378587642192,135229.61602368025,1884,12,729.05,37,3,14,32.23291900773877,0.6556869369369369,41.41995614035087,1034.3201754385957,27.954599336178262,0
1930,4,0,0,40,0.0,0.0,1.0,40,450,100,350,0.2222222222222222,8,1,7,358.13446559134513,0.3817307692307692,0.18954381689096067,0.22426774729830945,133840.7145107148,1586.5945531317248,135427.30906384654,1885,13,730.05,37,3,15,32.04573752251774,0.6568130630630631,41.310307017543856,1034.7587719298242,27.966453295400655,0
1931,4,0,0,40,0.0,0.0,1.0,40,1050,900,150,0.8571428571428571,12,9,3,355.77562446152103,0.382051282051282,0.1866061023413499,0.22313396141477063,133897.45071800947,1527.489828601119,135424.9405466106,1886,14,731.05,37,3,15,32.04998322562418,0.657376126126126,41.255482456140356,1034.9780701754394,27.972380275011876,0
1932,4,0,0,40,0.0,0.0,1.0,40,400,200,200,0.5,6,2,4,355.77562446152103,0.382051282051282,0.1866061023413499,0.22313396141477063,133897.45071800947,1527.489828601119,135424.9405466106,1887,15,732.05,37,3,15,32.04998322562418,0.657376126126126,41.255482456140356,1034.9780701754394,27.972380275011876,0
1933,4,0,0,40,0.0,0.0,1.0,40,850,500,350,0.5882352941176471,12,5,7,355.77562446152103,0.382051282051282,0.1866061023413499,0.22313396141477063,133897.45071800947,1527.489828601119,135424.9405466106,1888,16,733.05,37,3,15,32.04998322562418,0.657376126126126,41.255482456140356,1034.9780701754394,27.972380275011876,0
1934,4,0,0,40,0.0,0.0,1.0,40,1150,800,350,0.6956521739130435,15,8,7,356.5340065633104,0.3807291666666666,0.1891253706056757,0.22447381053226037,134039.34383656518,1557.9168590335557,135597.26069559873,1889,17,734.05,37,3,15,31.888412395877452,0.6587837837837838,41.11842105263158,1035.5263157894742,27.987197724039845,0
1935,4,0,0,40,0.0,0.0,1.0,40,1000,700,300,0.7,13,7,6,356.27075030525543,0.38043536324786326,0.1878586553732131,0.2244814700889353,134067.73147747395,1552.8822570406367,135620.6137345146,1890,18,735.05,37,3,15,31.86683871536967,0.6590653153153152,41.09100877192983,1035.6359649122815,27.990161213845443,0
1936,4,0,0,40,0.0,0.0,1.0,40,1100,700,400,0.6363636363636364,15,7,8,354.42392594592303,0.38000801282051283,0.18271144278606943,0.22366351559192638,134124.51577648905,1507.3874894198345,135631.90326590888,1891,19,736.05,37,3,15,31.85788698352211,0.6596283783783783,41.03618421052632,1035.8552631578957,27.99608819345664,0
1937,4,0,0,40,0.0,0.0,1.0,40,1350,1100,250,0.8148148148148148,16,11,5,354.1863927393844,0.37986111111111115,0.1806072788827764,0.22438135282658583,134266.5291243459,1511.0755232379124,135777.6046475838,1892,20,737.05,37,3,16,31.72212230215828,0.661036036036036,40.89912280701754,1036.4035087719294,28.01090564248458,0
1938,4,0,0,40,0.0,0.0,1.0,40,800,600,200,0.75,10,6,4,352.2382343379963,0.379821047008547,0.18034750872738825,0.22332045802797323,134294.94081111506,1460.762566366585,135755.70337748164,1893,21,738.05,37,3,16,31.744221411192218,0.6613175675675675,40.871710526315795,1036.5131578947376,28.013869132290203,0
1939,4,0,0,40,0.0,0.0,1.0,40,1200,600,600,0.5,18,6,12,355.08194617703083,0.37877938034188036,0.17726720219849867,0.22652935217672898,134522.34251163833,1553.2910366651404,136075.63354830348,1894,22,739.05,37,3,18,31.4434476623331,0.6635698198198197,40.65241228070176,1037.390350877194,28.03757705073497,0
1940,4,0,0,40,0.0,0.0,1.0,40,700,600,100,0.8571428571428571,8,6,2,352.25861458170243,0.3782451923076923,0.17205339700455813,0.22508397189707402,134579.99173159653,1481.3952932903712,136061.3870248869,1895,23,740.05,36,4,18,31.459147312061354,0.6660879629629629,40.59684684684685,1037.6126126126132,28.82257257257259,0
1941,4,0,0,40,0.0,0.0,1.0,40,1200,1000,200,0.8333333333333334,14,10,4,352.6752957374573,0.3781784188034188,0.17324672581326572,0.22622829946085696,134721.47680055414,1502.5873345644932,136224.06413511862,1896,24,741.05,37,3,20,31.307210252077176,0.6655405405405406,40.46052631578948,1038.157894736843,28.058321479374136,0
1942,4,0,0,40,0.0,0.0,1.0,40,1000,400,600,0.4,16,4,12,347.79674773161156,0.3779113247863248,0.16447646189571485,0.22415145496661834,134892.2805574793,1383.0192943982852,136275.2998518776,1897,25,742.05,37,3,13,31.2636338047991,0.6672297297297296,40.29605263157895,1038.8157894736848,28.0761024182077,0
1943,4,0,0,40,0.0,0.0,1.0,40,1200,800,400,0.6666666666666666,16,8,8,348.4021435311292,0.3772035256410256,0.16293248945147676,0.22560466671278046,135063.1925207757,1411.26115727917,136474.45367805485,1898,26,743.05,37,3,14,31.077707454289726,0.6689189189189189,40.131578947368425,1039.473684210527,28.093883357041268,0
1944,4,0,0,40,0.0,0.0,1.0,40,1350,1000,350,0.7407407407407407,17,10,7,347.66805635578646,0.3765090811965812,0.16571067060312128,0.22584135934782734,135177.19394429057,1399.3584564481393,136576.5524007387,1899,27,744.05,37,3,15,30.983322789259102,0.670045045045045,40.021929824561404,1039.9122807017545,28.105737316263635,0
1945,4,0,0,40,0.0,0.0,1.0,40,950,700,250,0.7368421052631579,12,7,5,343.90916083935974,0.3758413461538461,0.16307967959527825,0.22410783777773663,135291.24345952595,1305.5796014158154,136596.82306094177,1900,28,745.05,37,3,16,30.96762577290613,0.6711711711711712,39.91228070175438,1040.3508771929821,28.117591275486003,0
1946,4,0,0,40,0.0,0.0,1.0,40,1250,800,450,0.64,17,8,9,342.58227790554974,0.37568108974358977,0.16305309734513318,0.22395254696139646,135405.3410664819,1277.4940366266428,136682.83510310855,1901,29,746.05,37,3,17,30.888730861075985,0.6722972972972973,39.80263157894736,1040.7894736842097,28.12944523470837,0
1947,4,0,0,40,0.0,0.0,1.0,40,1000,900,100,0.9,11,9,2,342.58227790554974,0.3754273504273504,0.16305309734513318,0.22395254696139646,135405.3410664819,1277.4940366266428,136682.83510310855,1902,30,747.05,37,3,17,30.888730861075985,0.6722972972972973,39.80263157894736,1040.7894736842097,28.12944523470837,0
1948,4,0,0,40,0.0,0.0,1.0,40,1150,900,250,0.782608695652174,14,9,5,346.175500143254,0.375761217948718,0.16577076971675275,0.2272030908680361,135548.03070415897,1384.6814644890733,136932.71216864805,1903,31,748.05,37,3,17,30.65343003053596,0.673704954954955,39.665570175438596,1041.3377192982455,28.144262683736365,0
1949,4,0,0,40,0.0,0.0,1.0,40,1500,1200,300,0.8,18,12,6,343.19918739908155,0.3763621794871795,0.16473624473029935,0.22597406993800037,135663.00834195685,1311.913896207683,136974.92223816452,1904,32,749.05,36,4,17,30.616735127733925,0.6767939814814815,39.55518018018018,1041.7792792792795,28.93831331331332,0
1950,4,0,0,40,0.0,0.0,1.0,40,700,500,200,0.7142857142857143,9,5,4,345.8611043914958,0.3753739316239317,0.16814350551113044,0.22828806419678327,135751.0107235614,1390.1988982225466,137141.20962178396,1905,33,750.05,36,4,17,30.460026294935524,0.6776620370370371,39.47072072072072,1042.117117117117,28.947697697697695,0
1951,4,0,1,39,0.0,0.025,0.975,40,850,500,350,0.5882352941176471,12,5,7,344.8196651997647,0.3752938034188034,0.16761560069144354,0.2279750586492159,135809.69482996516,1365.9707004301647,137175.66553039532,1906,34,751.05,36,4,18,30.428910976663772,0.6782407407407407,39.414414414414416,1042.3423423423428,28.953953953953967,0
1952,4,0,0,39,0.0,0.0,1.0,39,1050,600,450,0.5714285714285714,15,6,9,351.10446691809517,0.3763495276653171,0.1731402781930269,0.23196593724119188,135784.42650730864,1734.9037369255623,137519.3302442342,1907,35,764.2820512820513,35,4,18,30.29023227836386,0.680059523809524,39.4386574074074,1042.245370370369,29.778439153439116,0
1953,4,0,0,39,0.0,0.0,1.0,39,1300,800,500,0.6153846153846154,18,8,10,351.88587636140085,0.37542172739541163,0.175158175158175,0.23327004121706107,135905.08355034716,1764.6158854166613,137669.69943576382,1908,36,765.2820512820513,35,4,13,30.150058275058267,0.68125,39.322916666666664,1042.708333333333,29.791666666666657,0
1954,4,0,0,39,0.0,0.0,1.0,39,1000,700,300,0.7,13,7,6,349.6625005984036,0.37491565452091763,0.17262453480829043,0.23238631676938104,135995.61149691336,1710.5131172839276,137706.1246141973,1909,37,766.2820512820513,35,4,13,30.118175765645816,0.6821428571428572,39.2361111111111,1043.0555555555538,29.80158730158725,0
1955,4,0,0,39,0.0,0.0,1.0,39,650,400,250,0.6153846153846154,9,4,5,347.3608089913559,0.37505623031938823,0.16810992569222494,0.23136577248777213,136073.93024358808,1653.350098409208,137727.28034199728,1910,38,767.2820512820513,36,3,13,30.10051268213707,0.6808449074074074,39.16103603603603,1043.355855855855,28.982107107107083,0
1956,4,0,0,39,0.0,0.0,1.0,39,1250,900,350,0.72,16,9,7,349.25957413229264,0.3736504723346829,0.1727450720116812,0.23398372625394612,136279.62421881326,1719.3927035143074,137999.01692232757,1911,39,768.2820512820513,36,3,14,29.84703048605118,0.6828703703703705,38.963963963963955,1044.144144144143,29.00400400400397,0
1957,4,0,0,39,0.0,0.0,1.0,39,600,300,300,0.5,9,3,6,351.6737040199648,0.3736504723346829,0.18064501866635752,0.23697750904874718,136485.47354364477,1799.6704052024766,138285.14394884725,1912,40,769.2820512820513,36,3,16,29.580010417789268,0.6848958333333335,38.76689189189188,1044.9324324324307,29.02590090090085,0
1958,4,0,0,39,0.0,0.0,1.0,39,1300,1000,300,0.7692307692307693,16,10,6,350.3944796389378,0.3735098965362123,0.1748573196537,0.2367075371185311,136573.7422388603,1770.9370688255583,138344.67930768584,1913,41,770.2820512820513,36,3,17,29.52600912159736,0.6857638888888891,38.68243243243242,1045.2702702702686,29.03528528528524,0
1959,4,0,0,39,0.0,0.0,1.0,39,400,200,200,0.5,6,2,4,350.26851284728986,0.3730319388214125,0.17694876490524436,0.23682029167963511,136603.1714780658,1769.5579447690798,138372.72942283488,1914,42,771.2820512820513,36,3,18,29.500161585694272,0.6860532407407408,38.65427927927927,1045.382882882882,29.03841341341339,0
1960,4,0,0,39,0.0,0.0,1.0,39,1000,700,300,0.7,13,7,6,356.77384292100385,0.3730319388214125,0.15955037329083144,0.22016259351181725,133297.72973987498,1711.479384790192,135009.20912466518,1915,43,772.2820512820513,36,3,17,32.62495456197747,0.6533564814814815,41.835585585585584,1032.6576576576574,28.68493493493493,6
1961,4,0,0,39,0.0,0.0,1.0,39,1050,700,350,0.6666666666666666,14,7,7,356.0181761244194,0.372638326585695,0.16608810853415146,0.22038534060495446,133414.04537983934,1699.5650211021891,135113.61040094154,1916,44,773.2820512820513,36,3,19,32.52784136327302,0.6545138888888888,41.722972972972975,1033.1081081081084,28.697447447447455,0
1962,4,0,0,39,0.0,0.0,1.0,39,1200,800,400,0.6666666666666666,16,8,8,356.4032826880449,0.37185110211426003,0.16141556337634766,0.22166545630597922,133588.61395178968,1722.2841084327613,135310.89806022245,1917,45,774.2820512820513,36,3,20,32.34295570079883,0.65625,41.554054054054056,1033.7837837837842,28.716216216216228,0
1963,4,0,0,39,0.0,0.0,1.0,39,1000,600,400,0.6,14,6,8,353.01651334239807,0.37165429599640126,0.15492942017332267,0.2202516072375399,133705.05640775923,1640.018565863175,135345.0749736224,1918,46,775.2820512820513,36,3,15,32.31389735772358,0.6574074074074073,41.44144144144145,1034.2342342342351,28.728728728728754,0
1964,4,0,0,39,0.0,0.0,1.0,39,1400,1100,300,0.7857142857142857,17,11,6,352.540077034104,0.37196356275303644,0.14882397254540902,0.22099886138768193,133879.81520371733,1639.600073046032,135519.41527676335,1919,47,776.2820512820513,36,3,16,32.151342038447595,0.6591435185185185,41.27252252252253,1034.9099099099108,28.74749749749752,0
1965,4,0,0,39,0.0,0.0,1.0,39,1100,600,500,0.5454545454545454,16,6,10,353.31474038444253,0.3706702654071075,0.15134703941404704,0.22201110104949995,133967.23740209828,1666.519940548683,135633.75734264698,1920,48,777.2820512820513,36,3,17,32.043855832336206,0.660011574074074,41.188063063063076,1035.2477477477496,28.756881881881935,0
1966,4,0,0,39,0.0,0.0,1.0,39,950,600,350,0.631578947368421,13,6,7,356.5975883381412,0.37041722896986057,0.1476784778220186,0.22460763166832523,134054.68813408012,1760.7156988069273,135815.40383288704,1921,49,778.2820512820513,36,3,18,31.871420545164575,0.6608796296296295,41.10360360360361,1035.5855855855864,28.76626626626629,0
1967,4,0,0,39,0.0,0.0,1.0,39,1000,600,400,0.6,14,6,8,358.7934782608695,0.3703047683310841,0.142447045707915,0.226710164835165,134171.33349565798,1827.9598855612578,135999.29338121924,1922,50,779.2820512820513,36,3,19,31.697916666666682,0.662037037037037,40.990990990991,1036.0360360360373,28.778778778778815,0
1968,4,0,0,39,0.0,0.0,1.0,39,1150,900,250,0.782608695652174,14,9,5,356.7642916707151,0.3705015744489429,0.13972993607855555,0.22578713974923834,134229.67519884772,1777.67099870143,136007.34619754914,1923,51,780.2820512820513,36,3,19,31.6921593131928,0.6626157407407407,40.9346846846847,1036.2612612612631,28.785035035035087,0
1969,4,1,1,39,0.025,0.025,0.975,40,550,400,150,0.7272727272727273,7,4,3,347.6446256270927,0.3736778846153846,0.13229370557329734,0.22128435284997988,134439.96006145462,1347.4659169771521,135787.42597843177,1924,0,761.75,38,2,19,31.718519281618075,0.6609100877192982,40.731837606837615,1037.072649572651,27.291385515069763,0
1970,4,0,0,39,0.0,0.0,1.0,39,850,500,350,0.5882352941176471,12,5,7,346.6224306708705,0.3702204228520018,0.16043932016382012,0.2101097000229591,132629.89921932074,1394.545266503652,134024.44448582438,1925,53,782.2820512820513,36,3,15,33.556995007470576,0.6467013888888888,42.48310810810811,1030.0675675675682,28.612987987988006,2
1971,4,0,0,39,0.0,0.0,1.0,39,1300,800,500,0.6153846153846154,18,8,10,347.5745705186166,0.36974246513720194,0.15479851879240103,0.21183073359037427,132832.97444403882,1433.8728086194476,134266.84725265828,1926,54,783.2820512820513,36,3,17,33.32855400189351,0.6487268518518519,42.286036036036045,1030.8558558558573,28.634884884884926,0
1972,4,0,0,39,0.0,0.0,1.0,39,1050,800,250,0.7619047619047619,13,8,5,350.9958701767198,0.3691801619433199,0.15891948191576932,0.21458078632032054,132949.08717839472,1532.916108676256,134482.00328707098,1927,55,784.2820512820513,36,3,17,33.1238170634054,0.6498842592592593,42.17342342342343,1031.306306306307,28.64739739739742,0
1973,4,0,0,39,0.0,0.0,1.0,39,1100,800,300,0.7272727272727273,14,8,6,354.26620236647443,0.3689271255060729,0.1667646186310232,0.2172548156681153,133065.25063915286,1628.1042021751687,134693.35484132802,1928,56,785.2820512820513,36,3,18,32.922897111256646,0.6510416666666665,42.06081081081082,1031.7567567567583,28.659909909909953,0
1974,4,0,0,39,0.0,0.0,1.0,39,900,600,300,0.6666666666666666,12,6,6,357.1799281160183,0.36926450742240213,0.17027790137033838,0.21921230283503537,133094.29943034265,1707.722460636328,134802.02189097897,1929,57,786.2820512820513,36,3,18,32.81858197824587,0.6513310185185185,42.032657657657666,1031.8693693693704,28.663038038038067,0
1975,4,0,0,39,0.0,0.0,1.0,39,850,400,450,0.47058823529411764,13,4,9,354.8476070585244,0.36915204678362573,0.16717055340382303,0.21833564528424493,133189.11227493064,1652.3675554016509,134841.47983033228,1930,58,787.2820512820513,37,2,18,32.78362014021669,0.6503378378378378,41.940789473684205,1032.2368421052624,27.898293029871958,0
1976,4,0,0,39,0.0,0.0,1.0,39,850,700,150,0.8235294117647058,10,7,3,354.8201328939417,0.36926450742240213,0.1669158069285499,0.21881736682791406,133274.01369892654,1657.6606503924245,134931.67434931896,1931,59,788.2820512820513,37,2,19,32.69917436550917,0.6511824324324325,41.858552631578945,1032.565789473684,27.907183499288756,0
1977,4,2,2,39,0.04878048780487805,0.04878048780487805,0.9512195121951219,41,1350,1000,350,0.7407407407407407,17,10,7,343.40806209512846,0.3779979674796748,0.15293789224454346,0.21488053540647428,133812.35091566638,990.7425842566993,134803.09349992307,1932,0,750.780487804878,37,4,15,32.455048042956065,0.6565315315315314,41.33771929824562,1034.6491228070176,27.96348980559507,0
1978,4,0,0,39,0.0,0.0,1.0,39,1250,1000,250,0.8,15,10,5,353.10341974375154,0.3682242465137202,0.15837564018788153,0.21995899593535462,133646.82883897406,1638.2304601899136,135285.059299164,1933,61,790.2820512820513,36,3,20,32.36994481957453,0.6568287037037037,41.497747747747745,1034.0090090090087,28.72247247247246,0
1979,4,1,1,39,0.025,0.025,0.975,40,700,400,300,0.5714285714285714,10,4,6,348.28810919819455,0.3730502136752137,0.1633393348866765,0.218943830029917,133982.57757194526,1332.9077216066512,135315.48529355193,1934,0,771.5,37,3,18,32.158617524535764,0.6582207207207207,41.17324561403509,1035.30701754386,27.98127074442865,0
1980,4,0,0,39,0.0,0.0,1.0,39,1050,700,350,0.6666666666666666,14,7,7,354.9019240252053,0.3711482231219074,0.16928321171141003,0.22283186377320266,133938.09349890432,1706.9774166057966,135645.07091551012,1935,1,790.1025641025641,36,3,19,32.03192993907746,0.6597222222222222,41.21621621621622,1035.1351351351352,28.753753753753756,0
1981,4,0,0,39,0.0,0.0,1.0,39,1550,1200,350,0.7741935483870968,19,12,7,354.6492067673963,0.37156995051731895,0.17267466990142366,0.22320324820165705,134025.5347196859,1706.4099149825524,135731.94463466847,1936,2,791.1025641025641,36,3,20,31.951015044408187,0.6605902777777778,41.13175675675676,1035.4729729729731,28.763138138138142,0
1982,4,0,0,39,0.0,0.0,1.0,39,600,500,100,0.8333333333333334,7,5,2,353.6197502798995,0.37134502923976603,0.17105963357551657,0.22263899477622467,134039.34383656507,1679.7918590335405,135719.1356955986,1937,3,792.1025641025641,37,2,20,31.963857122688115,0.6587837837837838,41.118421052631575,1035.5263157894733,27.98719772403982,0
1983,4,0,0,39,0.0,0.0,1.0,39,1000,900,100,0.9,11,9,2,353.0333733988618,0.370810841205578,0.17021623162438426,0.22244164187806878,134067.73147747392,1666.076701485081,135733.808178959,1938,4,793.1025641025641,37,2,20,31.95065731427564,0.6590653153153152,41.09100877192983,1035.6359649122812,27.99016121384544,0
1984,4,0,0,39,0.0,0.0,1.0,39,1000,700,300,0.7,13,7,6,350.25265977468536,0.37024853801169594,0.16541826787381408,0.22120234823203394,134152.9124345953,1597.4828793474921,135750.39531394278,1939,5,794.1025641025641,37,2,20,31.937535280835455,0.6599099099099099,41.00877192982456,1035.9649122807018,27.999051683262213,0
1985,4,0,0,39,0.0,0.0,1.0,39,800,500,300,0.625,11,5,6,350.9442624786541,0.3699392712550607,0.16600189933523302,0.22198281662806427,134209.71476800548,1620.025873345635,135829.74064135112,1940,6,795.1025641025641,37,2,20,31.862874779541443,0.660472972972973,40.95394736842105,1036.1842105263152,28.004978662873384,0
1986,4,0,0,39,0.0,0.0,1.0,39,1050,900,150,0.8571428571428571,12,9,3,351.2770675147915,0.3698268106162843,0.16576060418633398,0.22253826019770837,134266.52912434592,1632.9505232379147,135899.47964758382,1941,7,796.1025641025641,37,2,21,31.797503173931446,0.6610360360360361,40.89912280701754,1036.4035087719296,28.010905642484584,0
1987,4,0,0,39,0.0,0.0,1.0,39,950,700,250,0.7368421052631579,12,7,5,349.65271458479447,0.36948942869995505,0.16430003227845158,0.22168122809993704,134294.94081111497,1591.318121922127,135886.25893303708,1942,8,797.1025641025641,37,2,21,31.811219542296968,0.6613175675675675,40.87171052631579,1036.5131578947369,28.013869132290186,0
1988,4,0,0,39,0.0,0.0,1.0,39,1050,700,350,0.6666666666666666,14,7,7,348.0203140554003,0.36923639226270805,0.1622213904845593,0.22081772141474845,134323.3555036164,1549.4512734687437,135872.80677708512,1943,9,798.1025641025641,37,2,21,31.825153374233125,0.6615990990990992,40.84429824561403,1036.622807017543,28.016832622095755,0
1989,4,0,0,39,0.0,0.0,1.0,39,1350,900,450,0.6666666666666666,18,9,9,348.24154508272323,0.3690395861448493,0.16917600041212233,0.22147412857076712,134408.61761551606,1561.3329341720287,135969.9505496881,1944,10,799.1025641025641,37,2,21,31.734319375418572,0.6624436936936938,40.76206140350876,1036.9517543859629,28.02572309151251,0
1990,4,0,0,39,0.0,0.0,1.0,39,850,700,150,0.8235294117647058,10,7,3,359.7211481133485,0.36867408906882587,0.20154933405816733,0.2036021698321556,130004.05811216646,1595.6059871016641,131599.66409926812,1945,11,800.1025641025641,36,3,17,35.87377613368669,0.6203703703703702,45.04504504504506,1019.8198198198218,28.328328328328382,8
1991,4,1,2,38,0.025,0.05,0.95,40,900,700,200,0.7777777777777778,11,7,4,352.4515279886401,0.3747596153846154,0.19555221314997806,0.2005268228923144,130206.62607725461,1178.3048630347857,131384.9309402894,1946,0,781.075,37,3,17,35.85356682423721,0.6204954954954953,44.84649122807018,1020.6140350877199,27.584163110478915,0
1992,4,0,0,38,0.0,0.0,1.0,38,800,500,300,0.625,11,5,6,364.38367812863567,0.3669689426268374,0.19728179700101522,0.20604750990457507,129967.37423911181,1871.5979723936907,131838.97221150552,1947,13,820.8421052631579,35,3,17,35.79218690881574,0.6220238095238095,45.08101851851852,1019.6759259259261,29.13359788359789,0
1993,4,0,0,38,0.0,0.0,1.0,38,1200,1000,200,0.8333333333333334,14,10,4,362.2818021271006,0.36625770507349453,0.19101787825588445,0.20547952406359488,130085.4190779321,1825.5160108024706,131910.93508873458,1948,14,821.8421052631579,35,3,17,35.72583390061266,0.6232142857142857,44.96527777777778,1020.1388888888889,29.1468253968254,0
1994,4,0,0,38,0.0,0.0,1.0,38,1100,900,200,0.8181818181818182,13,9,4,365.0103260529449,0.36633179231863444,0.19433565765593697,0.2073409171702808,130144.46159122066,1900.814471879267,132045.27606309994,1949,15,822.8421052631579,35,3,17,35.5962643678161,0.6238095238095238,44.9074074074074,1020.3703703703688,29.15343915343911,0
1995,4,0,0,38,0.0,0.0,1.0,38,600,400,200,0.6666666666666666,8,4,4,366.19265660467613,0.3659317211948791,0.196961014308483,0.2081702548861011,130173.98787133476,1933.7516878857864,132107.73955922056,1950,16,823.8421052631579,35,3,17,35.53610922082342,0.624107142857143,44.878472222222214,1020.4861111111102,29.156746031746007,0
1996,4,0,0,38,0.0,0.0,1.0,38,750,600,150,0.8,9,6,3,367.52732676349865,0.36610953058321477,0.19812784597847943,0.2092461907506322,130233.05047850215,1972.8409797239276,132205.89145822608,1951,17,824.8421052631579,35,3,18,35.44206164720112,0.6247023809523811,44.82060185185185,1020.7175925925919,29.16335978835977,0
1997,4,0,0,38,0.0,0.0,1.0,38,1300,900,400,0.6923076923076923,17,9,8,366.8239938339066,0.36603544333807486,0.19349459125651114,0.2091631835558427,130292.12648158851,1958.8556402177487,132250.98212180624,1952,18,825.8421052631579,35,3,19,35.400016060159466,0.625297619047619,44.762731481481474,1020.9490740740729,29.169973544973512,0
1998,4,3,2,39,0.07317073170731707,0.04878048780487805,0.9512195121951219,41,1200,1000,200,0.8333333333333334,14,10,4,344.73616866941967,0.3806656504065041,0.17685408875798414,0.20005555614910417,130972.4633487654,830.1890432098745,131802.65239197528,1953,0,766.3414634146342,38,3,16,35.27532790592492,0.6263706140350876,44.09722222222222,1023.611111111111,26.93713450292397,0
1999,4,0,0,39,0.0,0.0,1.0,39,1250,900,350,0.72,16,9,7,359.84203070115876,0.37196356275303644,0.19303625889528986,0.20732015474406848,130694.03863322776,1605.8416524632667,132299.88028569103,1954,1,806.6410256410256,36,3,16,35.17070484581498,0.6273148148148149,44.369369369369366,1022.522522522522,28.403403403403388,0
2000,4,0,0,39,0.0,0.0,1.0,39,600,300,300,0.5,9,3,6,364.6691613226132,0.37221659919028344,0.1978505915531128,0.21057151889976428,130780.41459956561,1738.3168218894343,132518.73142145504,1955,2,807.6410256410256,36,3,16,34.95976916584093,0.6281828703703705,44.2849099099099,1022.8603603603591,28.412787787787753,0
2001,4,1,1,39,0.025,0.025,0.975,40,1400,700,700,0.5,21,7,14,356.84499039129713,0.37773771367521364,0.19351851851851887,0.20809275282368872,131159.59357686958,1360.7287819328749,132520.32235880246,1956,0,788.425,37,3,17,34.776189966459704,0.6300675675675678,43.91447368421051,1024.342105263156,27.684921763869085,0
2002,4,1,1,39,0.025,0.025,0.975,40,1050,800,250,0.7619047619047619,13,8,5,353.08032553478574,0.37442574786324784,0.19302910335972645,0.20650117161752846,131271.9358360263,1269.9075677131236,132541.84340373942,1957,0,789.4,37,3,17,34.75907696697338,0.6311936936936938,43.8048245614035,1024.7807017543846,27.696775723091477,0
2003,4,0,0,39,0.0,0.0,1.0,39,800,600,200,0.75,10,6,4,369.1854850216768,0.37128879892037786,0.20109069610067598,0.20325486592951672,128915.32368517174,1723.5424323402644,130638.866117512,1958,5,810.6410256410256,36,3,15,36.74179418939898,0.609375,46.11486486486487,1015.5405405405412,28.209459459459477,4
2004,4,0,0,39,0.0,0.0,1.0,39,950,500,450,0.5263157894736842,14,5,9,370.038833618415,0.37156995051731895,0.1995520920371281,0.20431397533080442,129029.71172185717,1749.200805535285,130778.91252739244,1959,6,811.6410256410256,36,3,16,36.60334922042415,0.6105324074074073,46.00225225225226,1015.9909909909925,28.221971971972014,0
2005,4,1,1,39,0.025,0.025,0.975,40,850,600,250,0.7058823529411765,11,6,5,364.375304678515,0.3772970085470086,0.1962107419208008,0.20266646693131626,129319.08543381373,1424.36449994793,130743.44993376166,1960,0,792.325,35,5,16,36.45216962524655,0.6154761904761903,45.71759259259261,1017.129629629632,29.060846560846628,0
2006,4,3,0,42,0.07142857142857142,0.0,1.0,42,700,400,300,0.5714285714285714,10,4,6,339.8506420564743,0.38763066202090596,0.20419092804255579,0.18872903319950565,129257.13320444761,401.10962442385835,129658.24282887147,1961,0,755.5238095238095,37,5,18,37.13877507008843,0.6109234234234233,45.77850877192983,1016.8859649122815,27.48340445708869,8
2007,4,2,2,42,0.045454545454545456,0.045454545454545456,0.9545454545454546,44,850,700,150,0.8235294117647058,10,7,3,326.76219847845766,0.39539288231148695,0.20239290728704673,0.18329053439609205,129651.8676757814,-326.93413628470796,129324.93353949669,1962,0,722.1363636363636,39,5,16,37.070953087177394,0.6113782051282051,45.39062500000001,1018.4375000000011,26.11378205128208,0
2008,4,0,0,42,0.0,0.0,1.0,42,1050,800,250,0.7619047619047619,13,8,5,337.1631604230849,0.3884654471544715,0.19735917209249831,0.1881666441302856,129452.33298947748,329.31154297475496,129781.64453245224,1963,1,757.5,37,5,16,37.00874097618791,0.6128941441441441,45.58662280701754,1017.6535087719294,27.504148885727822,0
2009,4,1,1,42,0.023255813953488372,0.023255813953488372,0.9767441860465116,43,850,600,250,0.7058823529411765,11,6,5,329.9601809502156,0.39188815060908083,0.1960251393104253,0.1850106144010269,129636.22708013744,-45.04141098691562,129591.18566915052,1964,0,740.8604651162791,38,5,16,37.00539411106448,0.612938596491228,45.40598290598291,1018.3760683760692,26.799370220422873,0
2010,4,0,0,42,0.0,0.0,1.0,42,950,800,150,0.8421052631578947,11,8,3,336.5546457938186,0.38862272551296945,0.20092283385399856,0.18809372528019372,129508.13140822174,317.3126587026752,129825.44406692442,1965,3,759.5,37,5,16,36.9675526948903,0.6134572072072071,45.531798245614034,1017.8728070175437,27.51007586533902,0
2011,4,0,1,41,0.0,0.023809523809523808,0.9761904761904762,42,1100,900,200,0.8181818181818182,13,9,4,336.5699587895975,0.388913085559427,0.19810846703277019,0.18863761057809242,129619.76431450056,325.2237467297549,129944.98806123031,1966,4,760.5,37,5,16,36.853823444958905,0.6145833333333333,45.422149122807014,1018.3114035087715,27.52192982456139,0
2012,4,1,1,41,0.023809523809523808,0.023809523809523808,0.9761904761904762,42,900,700,200,0.7777777777777778,11,7,4,327.9725647885758,0.3917803910181959,0.18591681114503578,0.18700260567951163,130290.57167830461,146.34659222065142,130436.91827052526,1967,0,729.4047619047619,37,5,19,36.39322217448893,0.6213400900900903,44.7642543859649,1020.9429824561383,27.59305357989563,1
2013,4,0,0,41,0.0,0.0,1.0,41,1000,900,100,0.9,11,9,2,321.2287411970865,0.3917174796747967,0.1493889908072943,0.17484329470525978,128461.13281249987,53.08159722220762,128514.21440972207,1968,1,739.170731707317,39,2,11,38.42135909028633,0.5993589743589745,46.56249999999999,1013.749999999999,25.993589743589716,8
2014,4,1,3,39,0.023809523809523808,0.07142857142857142,0.9285714285714286,42,1200,800,400,0.6666666666666666,16,8,8,313.67816711867215,0.39630516840882696,0.14548038766788807,0.1716975230544308,128685.30636525854,-326.84579284819694,128358.46057241035,1969,0,722.547619047619,40,2,11,38.38474893162393,0.6000000000000001,46.341463414634134,1014.6341463414615,25.365853658536537,0
2015,4,0,0,39,0.0,0.0,1.0,39,550,300,250,0.5454545454545454,8,3,5,334.5082478063474,0.3832658569500675,0.15774267944416231,0.18126226988169158,128283.34349270916,782.3672908971806,129065.71078360634,1970,8,778.8717948717949,37,2,16,38.26611375690007,0.6010698198198199,46.73793859649122,1013.048245614034,27.37968231389281,0
2016,4,2,1,40,0.04878048780487805,0.024390243902439025,0.975609756097561,41,1500,1200,300,0.8,18,12,6,326.35805015624965,0.39418191056910573,0.16384316552525124,0.17905590319383427,128778.12499999999,205.5555555555544,128983.68055555553,1971,0,741.829268292683,39,2,12,37.96866447728516,0.6025641025641025,46.25,1014.9999999999999,26.025641025641022,0
2017,4,2,1,41,0.047619047619047616,0.023809523809523808,0.9761904761904762,42,1250,900,350,0.72,16,9,7,323.9041665388064,0.4024632210607821,0.1345294154130947,0.17695060132587995,128607.98306439612,-68.66768705797307,128539.31537733815,1972,0,725.1190476190476,40,2,13,38.20404602077279,0.5992187500000001,46.417682926829265,1014.3292682926823,25.358231707317056,3
2018,4,0,0,41,0.0,0.0,1.0,41,950,500,450,0.5263157894736842,14,5,9,350.1392120720431,0.3964939024390244,0.11113507850176418,0.19178905630105336,128713.06911571333,814.8643784997319,129527.93349421305,1973,1,743.8048780487804,38,3,17,37.43156453990314,0.6036184210526316,46.31410256410256,1014.7435897435896,26.703778677462886,3
2019,4,0,0,41,0.0,0.0,1.0,41,1150,800,350,0.6956521739130435,15,8,7,352.44342452724993,0.39730691056910566,0.11144327119231234,0.19397653446042318,128902.86138733651,886.1931797428549,129789.05456707937,1974,2,744.8048780487804,38,3,17,37.17955462037523,0.6055372807017544,46.12713675213675,1015.4914529914527,26.723459289248755,0
2020,4,0,1,40,0.0,0.024390243902439025,0.975609756097561,41,1200,700,500,0.5833333333333334,17,7,10,353.16452795308743,0.39664634146341465,0.11559539859576629,0.19466971803677538,128963.2175021702,909.0467664930605,129872.26426866326,1975,3,745.8048780487804,39,2,17,37.099720541482924,0.6044337606837606,46.067708333333336,1015.7291666666672,26.04433760683762,0
2021,4,1,0,41,0.024390243902439025,0.0,1.0,41,1450,1100,350,0.7586206896551724,18,11,7,356.30762671776847,0.3955030487804878,0.12596808657199454,0.19773211810908015,129230.01284646145,1009.7870152933915,130239.79986175484,1976,0,746.439024390244,36,5,19,36.7480248827851,0.6125578703703705,45.80518018018019,1016.7792792792802,28.243868868868894,0
2022,4,3,3,41,0.06818181818181818,0.06818181818181818,0.9318181818181819,44,650,300,350,0.46153846153846156,10,3,7,337.70154887683503,0.40641516913319237,0.12597561882108055,0.19032672547298135,129837.58680555563,-30.72916666666123,129806.85763888898,1977,0,696.4772727272727,39,5,15,36.603979285908956,0.6132478632478633,45.208333333333336,1019.1666666666673,26.132478632478648,0
2023,4,1,1,41,0.023809523809523808,0.023809523809523808,0.9761904761904762,42,1100,800,300,0.7272727272727273,14,8,6,346.564636889223,0.40340689121176926,0.12264188619152461,0.19526757656741273,129826.69850107745,598.6685249105042,130425.36702598796,1978,0,691.7857142857143,38,4,16,36.389209211307964,0.6148574561403508,45.21901709401709,1019.1239316239312,26.819050832208717,0
2024,4,0,1,40,0.0,0.024390243902439025,0.975609756097561,41,1200,900,300,0.75,15,9,6,360.7339563551112,0.39796747967479673,0.1251453362483692,0.20304667815917923,129787.30384589494,1163.7375201985276,130951.04136609347,1979,2,709.6585365853658,37,4,17,36.06825477958319,0.6162725225225224,45.25767543859649,1018.9692982456145,27.539710763394986,0
2025,4,1,0,41,0.024390243902439025,0.0,1.0,41,1050,800,250,0.7619047619047619,13,8,5,349.8460467883077,0.40401422764227646,0.13569006096250513,0.19875868812039027,130150.67737188366,906.5399930747956,131057.21736495846,1980,0,707.2682926829268,37,4,18,35.976789168278536,0.6199324324324323,44.901315789473685,1020.3947368421054,27.578236130867715,0
2026,4,1,1,41,0.023809523809523808,0.023809523809523808,0.9761904761904762,42,1150,800,350,0.6956521739130435,15,8,7,344.53487058983814,0.407701800232288,0.1353788456079008,0.19713332721181606,130426.23325525982,587.2770792242077,131013.51033448403,1981,0,691.4047619047619,38,4,18,35.83307185440854,0.6208881578947367,44.63141025641026,1021.47435897436,26.88090418353579,0
2027,4,1,1,41,0.023809523809523808,0.023809523809523808,0.9761904761904762,42,850,600,250,0.7058823529411765,11,6,5,349.3279377338798,0.40652826171118855,0.1376142677899268,0.20029810530496575,130508.09500328741,718.0247370151367,131226.11974030256,1982,0,692.3809523809524,38,4,13,35.62774466750316,0.6217105263157894,44.55128205128206,1021.7948717948725,26.889338731444013,0
2028,4,2,1,42,0.046511627906976744,0.023255813953488372,0.9767441860465116,43,1200,1000,200,0.8333333333333334,14,10,4,342.08419576822706,0.4124677002583979,0.13877705678965557,0.19760392955552902,130794.81336805575,348.5677083333537,131143.3810763891,1983,0,677.2325581395348,39,4,15,35.52274270196877,0.6228632478632479,44.27083333333334,1022.9166666666682,26.22863247863252,0
2029,4,1,1,42,0.023255813953488372,0.023255813953488372,0.9767441860465116,43,950,700,250,0.7368421052631579,12,7,5,344.22314856976664,0.41198320413436695,0.15218286558205762,0.19966568228137727,130954.69292534742,415.5273437500204,131370.22026909745,1984,0,678.2093023255813,39,4,16,35.306414953524666,0.624465811965812,44.11458333333334,1023.5416666666682,26.24465811965816,0
2030,4,0,0,42,0.0,0.0,1.0,42,1150,900,250,0.782608695652174,14,9,5,350.2157117425566,0.41039972899729,0.1453457440196506,0.20265956926637246,130863.1260158704,766.0645637007844,131629.19057957118,1985,1,695.1904761904761,38,4,16,35.245684104277615,0.6252741228070176,44.20405982905983,1023.1837606837605,26.92588843904633,0
2031,4,1,1,42,0.023255813953488372,0.023255813953488372,0.9767441860465116,43,900,700,200,0.7777777777777778,11,7,4,345.3891942816697,0.41482096714654854,0.15270497852290554,0.20117692880197754,131114.67013888908,457.118055555576,131571.78819444464,1986,0,680.0,39,4,17,35.114930838079744,0.626068376068376,43.95833333333334,1024.1666666666683,26.260683760683804,0
2032,4,1,0,43,0.023255813953488372,0.0,1.0,43,1150,600,550,0.5217391304347826,17,6,11,343.9327597008514,0.41325212255444815,0.14641849118510541,0.20116590308781104,131274.74500868074,429.93706597224354,131704.68207465298,1987,0,680.6279069767442,39,4,18,34.99059768245579,0.6276709401709402,43.80208333333334,1024.7916666666683,26.276709401709443,0
2033,4,0,0,43,0.0,0.0,1.0,43,1100,800,300,0.7272727272727273,14,8,6,345.4578580182125,0.4126522702104098,0.153133727769446,0.20278571439600174,131412.43128895437,479.51310739843746,131891.9443963528,1988,1,681.6279069767442,37,6,18,34.81256460984564,0.6326013513513513,43.66776315789474,1025.3289473684217,27.711593172119507,0
2034,4,0,0,43,0.0,0.0,1.0,43,1100,800,300,0.7272727272727273,14,8,6,347.98895402299195,0.4127445551864157,0.15166619019800365,0.20487329546161653,131524.88175448202,553.8412059479703,132078.72296043,1989,2,682.6279069767442,37,6,18,34.634219668626386,0.6337274774774775,43.55811403508771,1025.7675438596482,27.723447131341842,0
2035,4,1,1,43,0.022727272727272728,0.022727272727272728,0.9772727272727273,44,1250,900,350,0.72,16,9,7,341.99360459390414,0.41356148696264977,0.15524195455018353,0.203062663431822,131848.80566741532,218.28966232010256,132067.09532973543,1990,0,668.0909090909091,38,6,15,34.461579805125005,0.6351425438596492,43.24252136752136,1027.0299145299136,27.027103013945094,0
2036,4,0,1,42,0.0,0.023255813953488372,0.9767441860465116,43,1750,1200,550,0.6857142857142857,23,12,11,348.1244848576199,0.4120062753783684,0.1591746719251368,0.2063188402662498,131778.07113727275,575.0346260387566,132353.1057633115,1991,4,684.6279069767442,37,6,15,34.37544496653852,0.6362612612612613,43.31140350877192,1026.7543859649104,27.750118539592172,0
2037,4,1,2,41,0.023255813953488372,0.046511627906976744,0.9534883720930233,43,1250,1000,250,0.8,15,10,5,346.1787811934791,0.4115909929863418,0.15378812692929955,0.20638597565809677,132003.3327562325,539.3505694059475,132542.68332563844,1992,0,685.5116279069767,37,6,15,34.19849907525962,0.6385135135135136,43.09210526315788,1027.6315789473667,27.77382645803694,0
2038,4,0,0,41,0.0,0.0,1.0,41,1050,700,350,0.6666666666666666,14,7,7,361.240949417195,0.4035315040650407,0.1565936710218383,0.21373222017218824,131713.9693313828,1316.0958665552034,133030.065197938,1993,9,719.8048780487804,35,6,15,34.10345491787876,0.6395833333333334,43.37384259259259,1026.504629629629,29.328703703703688,0
2039,4,0,1,40,0.0,0.024390243902439025,0.975609756097561,41,700,500,200,0.7142857142857143,9,5,4,363.53388929414797,0.4033028455284553,0.15298260274386788,0.2157616187094967,131832.80452942822,1385.1384334276468,133217.94296285586,1994,10,720.8048780487804,35,6,16,33.92466377399601,0.6407738095238095,43.258101851851855,1026.967592592593,29.34193121693123,0
2040,4,0,0,40,0.0,0.0,1.0,40,850,800,50,0.9411764705882353,9,8,1,370.4210571956246,0.39942574786324786,0.15349328972595022,0.21882235270843453,131654.57182623885,1753.5251361025357,133408.0969623414,1995,11,739.55,35,5,16,33.92788335024999,0.6389880952380952,43.43171296296296,1026.273148148148,29.322089947089943,0
2041,4,1,1,40,0.024390243902439025,0.024390243902439025,0.975609756097561,41,800,500,300,0.625,11,5,6,361.7885531994747,0.40233739837398375,0.15163915803541572,0.21563164911464439,131992.67415641993,1350.6877231961707,133343.3618796161,1996,0,722.4878048780488,36,5,17,33.80821917808218,0.6403356481481481,43.10247747747748,1027.5900900900901,28.54416916916917,0
2042,4,0,0,40,0.0,0.0,1.0,40,850,500,350,0.5882352941176471,12,5,7,368.8015041865355,0.39909188034188037,0.15688887636650506,0.21888800980917267,131832.80452942822,1724.0273223165357,133556.83185174476,1997,13,741.55,35,5,17,33.789422029377505,0.6407738095238095,43.258101851851855,1026.967592592593,29.34193121693123,0
2043,4,0,0,40,0.0,0.0,1.0,40,850,600,250,0.7058823529411765,11,6,5,373.29499563461195,0.3988648504273504,0.16274222622803092,0.22207549472203866,131921.96609224967,1849.1619513031574,133771.12804355283,1998,14,742.55,35,5,17,33.58400931350458,0.6416666666666666,43.1712962962963,1027.314814814815,29.35185185185186,0
2044,4,0,0,40,0.0,0.0,1.0,40,1050,600,450,0.5714285714285714,15,6,9,375.5219607438489,0.3988648504273504,0.1712116928644125,0.21775348844969522,130942.84664619755,1834.3829035922306,132777.22954978977,1999,15,743.55,35,5,17,34.517532700064066,0.6318452380952382,44.1261574074074,1023.4953703703691,29.24272486772483,1
2045,4,1,0,41,0.024390243902439025,0.0,1.0,41,1150,900,250,0.782608695652174,14,9,5,364.6649448721383,0.4032774390243902,0.1733946141538869,0.21375495808951187,131357.78523930453,1380.881880144008,132738.66711944854,2000,0,726.390243902439,35,6,18,34.37547043769522,0.6360119047619048,43.7210648148148,1025.1157407407393,29.289021164021122,0
2046,4,1,0,42,0.023809523809523808,0.0,1.0,42,1250,900,350,0.72,16,9,7,356.62495189909214,0.4062379016647309,0.17662627434382117,0.21062366731409105,131645.74361100953,989.631396599292,132635.37500760882,2001,0,710.0714285714286,36,6,16,34.29075679432312,0.636863425925926,43.44031531531531,1026.2387387387378,28.506631631631606,0
2047,4,0,0,42,0.0,0.0,1.0,42,1300,900,400,0.6923076923076923,17,9,8,357.9936556003109,0.40553619821912507,0.18192794359122955,0.21263960507343777,131862.521701389,1041.1892361111209,132903.71093750012,2002,1,711.0714285714286,37,5,16,34.036933739012845,0.6371058558558558,43.22916666666667,1027.0833333333342,27.75900900900903,0
2048,4,1,0,43,0.023255813953488372,0.0,1.0,43,900,500,400,0.5555555555555556,13,5,8,352.7166342249112,0.4073458840900701,0.18883024995650377,0.21110353779729787,132150.72320841567,722.3516600920595,132873.07486850774,2003,0,695.5116279069767,38,5,17,33.88209164588529,0.638157894736842,42.948717948717956,1028.2051282051295,27.058029689608674,0
2049,4,0,0,43,0.0,0.0,1.0,43,1400,1100,300,0.7857142857142857,17,11,6,354.7845253261401,0.4063538205980066,0.19202874412172144,0.21314443619445225,132293.43401951567,787.1326384757954,133080.56665799147,2004,1,696.5116279069767,40,3,19,33.68525470051698,0.6361979166666666,42.809959349593505,1028.7601626016274,25.719004065040686,0
2050,4,0,1,42,0.0,0.023255813953488372,0.9767441860465116,43,1100,700,400,0.6363636363636364,15,7,8,353.36574302697755,0.4058462532299742,0.18790697674418633,0.21258634273013374,132345.71358194537,753.2882832639438,133099.0018652093,2005,2,697.5116279069767,40,3,20,33.66913580246916,0.63671875,42.75914634146342,1028.963414634147,25.724085365853675,0
2051,4,0,0,42,0.0,0.0,1.0,42,950,500,450,0.5263157894736842,14,5,9,363.9621031986057,0.4045683313975997,0.19709503562510244,0.21895357219219427,132344.406467014,1233.6697048611218,133578.07617187512,2006,3,713.4285714285714,39,3,20,33.39787068907335,0.6383547008547008,42.76041666666667,1028.9583333333342,26.38354700854703,0
2052,4,0,0,42,0.0,0.0,1.0,42,1050,600,450,0.5714285714285714,15,6,9,370.9369285850377,0.4037698412698412,0.20423191198907853,0.22399755463434567,132487.35592689048,1428.9339795524706,133916.28990644295,2007,4,714.4285714285714,35,7,20,33.07440978077571,0.6473214285714286,42.62152777777778,1029.5138888888891,29.41468253968255,0
2053,4,1,1,42,0.023255813953488372,0.023255813953488372,0.9767441860465116,43,800,700,100,0.875,9,7,2,362.6485705548771,0.4063538205980066,0.2110331371746863,0.21439783491204334,131684.26890432098,954.6694155092614,132638.93831983025,2008,0,698.7906976744187,38,5,14,34.09731619305368,0.6334978070175439,43.40277777777778,1026.388888888889,27.010233918128655,4
2054,4,1,1,42,0.023255813953488372,0.023255813953488372,0.9767441860465116,43,1050,900,150,0.8571428571428571,12,9,3,361.53087802906424,0.40633074935400515,0.20788393393102678,0.2138909283314808,131711.68456424863,923.5681934399861,132635.2527576886,2009,0,699.7674418604652,38,5,14,34.09832084374132,0.6337719298245614,43.376068376068375,1026.495726495726,27.013045434098057,0
2055,4,0,0,42,0.0,0.0,1.0,42,1250,900,350,0.72,16,9,7,350.3257010444989,0.40278987611304684,0.23554129250991584,0.20504420073946805,131300.74929003228,801.3888888889071,132102.1381789212,2010,7,717.4285714285714,38,4,19,34.800549011431954,0.6296600877192982,43.77670940170941,1024.8931623931635,26.970872694556935,4
2056,4,1,2,41,0.023255813953488372,0.046511627906976744,0.9534883720930233,43,1350,1100,250,0.8148148148148148,16,11,5,345.26562058229035,0.40383905500184575,0.2340547648627247,0.20353503710569273,131574.6348002959,485.64244101103543,132060.27724130693,2011,0,701.7209302325581,38,5,12,34.653884202853284,0.6324013157894737,43.50961538461539,1025.9615384615386,26.998987854251016,0
2057,4,0,0,41,0.0,0.0,1.0,41,1100,700,400,0.6363636363636364,15,7,8,358.8186032681742,0.3979166666666667,0.23528214194827246,0.21064109495530164,131414.71021274666,1230.8085534859324,132645.5187662326,2012,9,736.7073170731708,36,5,19,34.46778326926596,0.634548611111111,43.66554054054055,1025.3378378378388,28.481606606606633,0
2058,4,0,0,41,0.0,0.0,1.0,41,1050,700,350,0.6666666666666666,14,7,7,362.93218025474437,0.39822154471544713,0.2421243184763866,0.21353916652197757,131501.3239590943,1345.2124421719147,132846.5364012662,2013,10,737.7073170731708,36,5,20,34.27481335090031,0.6354166666666665,43.58108108108109,1025.6756756756763,28.49099099099101,0
2059,4,0,0,41,0.0,0.0,1.0,41,850,600,250,0.7058823529411765,11,6,5,364.5376016976649,0.3973323170731707,0.23820165777648117,0.21529689982312514,131645.7436110097,1397.9647299326389,133043.70834094234,2014,11,738.7073170731708,36,5,13,34.08775010058889,0.6368634259259258,43.44031531531532,1026.2387387387391,28.50663163163164,0
2060,4,0,0,41,0.0,0.0,1.0,41,1450,1200,250,0.8275862068965517,17,12,5,348.1313963278999,0.3978912601626016,0.17800349086319955,0.20274529557711118,131109.19922017682,930.7889096783825,132039.9881298552,2015,12,739.7073170731708,38,3,17,35.050246887822524,0.6277412280701754,43.96367521367522,1024.1452991452995,26.95119208277104,6
2061,4,0,0,41,0.0,0.0,1.0,41,1050,800,250,0.7619047619047619,13,8,5,346.28910979825434,0.39773882113821135,0.17202638185522567,0.20210385111719179,131191.27498584634,886.0219656293458,132077.29695147567,2016,13,740.7073170731708,38,3,17,35.014513157437364,0.628563596491228,43.88354700854701,1024.4658119658122,26.95962663067927,0
2062,4,1,1,41,0.023809523809523808,0.023809523809523808,0.9761904761904762,42,1100,800,300,0.7272727272727273,14,8,6,340.96438364720694,0.40119289585753,0.16620335721159019,0.20044248147406188,131468.65051025298,565.36815645962,132034.0186667126,2017,0,724.047619047619,37,5,17,34.87105295983464,0.6331644144144144,43.61293859649122,1025.5482456140337,27.71752015173064,0
2063,4,1,0,42,0.023809523809523808,0.0,1.0,42,900,700,200,0.7777777777777778,11,7,4,339.278340886297,0.3992208672086721,0.1742808281927568,0.1998922013433371,131553.00188519532,526.6168436441855,132079.6187288395,2018,0,725.0238095238095,37,5,19,34.8292539546815,0.6340090090090091,43.53070175438596,1025.8771929824552,27.726410621147437,0
2064,4,0,1,41,0.0,0.023809523809523808,0.9761904761904762,42,850,700,150,0.8235294117647058,10,7,3,336.85481482941134,0.399027293844367,0.17597270770686757,0.19890373577214257,131637.38031173046,468.5370739073504,132105.91738563782,2019,1,726.0238095238095,37,5,17,34.80640292766321,0.6348536036036037,43.4484649122807,1026.2061403508767,27.735301090564235,0
2065,4,0,0,41,0.0,0.0,1.0,41,900,500,400,0.5555555555555556,13,5,8,341.9549580909684,0.3974339430894309,0.17154837483164598,0.20134891488368648,131530.2015486769,795.4809116548786,132325.6824603318,2020,17,744.7073170731708,36,5,19,34.78359314963223,0.6357060185185187,43.55292792792792,1025.788288288287,28.494119119119084,0
2066,4,0,0,41,0.0,0.0,1.0,41,1150,700,450,0.6086956521739131,16,7,9,343.4372022348035,0.3970020325203252,0.17249547015386768,0.20283494646570072,131645.74361100956,842.4091743770696,132488.15278538663,2021,18,745.7073170731708,36,5,18,34.62910128388016,0.636863425925926,43.44031531531531,1026.238738738738,28.50663163163161,0
2067,4,0,0,41,0.0,0.0,1.0,41,1550,1300,250,0.8387096774193549,18,13,5,341.83238492458725,0.39679878048780487,0.17472062361073037,0.20282054838858818,131821.37573964478,812.1630506245693,132633.53879026935,2022,19,746.7073170731708,38,3,18,34.493341656263006,0.6348684210526316,43.26923076923076,1026.9230769230755,27.02429149797567,0
2068,4,0,0,41,0.0,0.0,1.0,41,850,600,250,0.7058823529411765,11,6,5,341.83238492458725,0.39679878048780487,0.17472062361073037,0.20282054838858818,131821.37573964478,812.1630506245693,132633.53879026935,2023,20,747.7073170731708,38,3,18,34.493341656263006,0.6348684210526316,43.26923076923076,1026.9230769230755,27.02429149797567,0
2069,4,0,0,41,0.0,0.0,1.0,41,1050,800,250,0.7619047619047619,13,8,5,343.84388642911415,0.3970020325203252,0.17685214264694604,0.2046670037326703,131942.77479383664,873.5432942708135,132816.31808810745,2024,21,748.7073170731708,39,2,18,34.31944726080636,0.6343482905982907,43.15104166666666,1027.395833333332,26.34348290598287,0
2070,4,0,1,40,0.0,0.024390243902439025,0.975609756097561,41,750,600,150,0.8,9,6,3,332.05939783320724,0.3978912601626016,0.13092818428184283,0.19370131540270452,131171.9214753125,511.3738515434142,131683.2953268559,2025,22,749.7073170731708,40,1,20,35.398478835978835,0.625,43.902439024390254,1024.3902439024405,25.60975609756101,4
2071,4,0,0,40,0.0,0.0,1.0,40,1200,900,300,0.75,15,9,6,341.328519568617,0.39395032051282053,0.1686731201197993,0.20006773225373017,131356.22409058534,967.3110022418425,132323.5350928272,2026,23,768.325,37,3,20,34.97510874603344,0.6320382882882885,43.72258771929823,1025.1096491228052,27.70566619250825,0
2072,4,0,0,40,0.0,0.0,1.0,40,1600,1100,500,0.6875,21,11,10,342.38958231648644,0.3936965811965812,0.17001710863986297,0.20113237272762427,131440.5393967373,1000.7742767005032,132441.3136734378,2027,24,769.325,37,3,20,34.86286355859708,0.632882882882883,43.64035087719297,1025.438596491227,27.71455666192505,0
2073,4,0,0,40,0.0,0.0,1.0,40,600,400,200,0.6666666666666666,8,4,4,341.9547972007648,0.3936565170940171,0.16978776863038614,0.20102471516145515,131468.650510253,991.267144698351,132459.91765495136,2028,25,770.325,37,3,20,34.84566003777753,0.6331644144144144,43.61293859649122,1025.548245614034,27.717520151730646,0
2074,4,2,2,40,0.047619047619047616,0.047619047619047616,0.9523809523809523,42,900,600,300,0.6666666666666666,12,6,6,327.72256699274277,0.4010840108401084,0.16172008969792917,0.19485998277427313,131901.66650142104,245.43054729327122,132147.09704871432,2029,0,734.5952380952381,40,2,17,34.774848304972956,0.6322916666666667,43.1910569105691,1027.2357723577231,25.680894308943078,0
2075,4,0,0,40,0.0,0.0,1.0,40,1250,900,350,0.72,16,9,7,342.83154468418206,0.3925347222222222,0.17133311952106012,0.20168844458967522,131496.7646295013,1017.1798759889163,132513.94450549022,2030,27,772.325,37,3,19,34.794829306535526,0.633445945945946,43.585526315789465,1025.6578947368414,27.720483641536255,4
2076,4,1,1,40,0.024390243902439025,0.024390243902439025,0.975609756097561,41,1050,800,250,0.7619047619047619,13,8,5,336.8722530402666,0.3970020325203252,0.16880282226339416,0.19958954079635993,131766.5244448095,677.697193001655,132444.22163781116,2031,0,754.4634146341464,38,3,17,34.6759018383628,0.6343201754385965,43.32264957264956,1026.7094017094,27.018668466036843,0
2077,4,0,0,40,0.0,0.0,1.0,40,950,600,350,0.631578947368421,13,6,7,344.2709474760761,0.39157318376068373,0.17619658119658177,0.20343283259949912,131665.51246537364,1065.7221452754359,132731.2346106491,2032,29,774.325,37,3,17,34.587784900284895,0.6351351351351353,43.42105263157893,1026.3157894736817,27.738264580369776,0
2078,4,0,0,40,0.0,0.0,1.0,40,1200,900,300,0.75,15,9,6,342.06886384581907,0.3921607905982906,0.17375574068140587,0.2025800614919923,131749.9269606992,1013.5095654431864,132763.43652614238,2033,30,775.325,37,3,17,34.55923582185197,0.6359797297297298,43.33881578947367,1026.6447368421032,27.74715504978657,0
2079,4,0,1,39,0.0,0.025,0.975,40,950,800,150,0.8421052631578947,11,8,3,342.9726785987633,0.3922008547008547,0.1723998932194346,0.20341603135385777,131806.21831957888,1041.1863506078557,132847.40467018675,2034,31,776.325,37,3,18,34.47933351130095,0.6365427927927929,43.283991228070164,1026.8640350877174,27.753082029397767,0
2080,4,1,1,39,0.025,0.025,0.975,40,1050,700,350,0.6666666666666666,14,7,7,343.8401310023907,0.39155982905982906,0.17388438133874273,0.20423275251105835,131862.52170138873,1067.9253472222026,132930.44704861092,2035,0,776.45,37,3,18,34.40035496957403,0.6371058558558559,43.22916666666666,1027.083333333332,27.75900900900897,0
2081,4,0,0,39,0.0,0.0,1.0,39,950,700,250,0.7368421052631579,12,7,5,353.8201658202524,0.38886077372919475,0.18014507422402137,0.21008072345577466,131848.06428049662,1530.1007933609117,133378.16507385753,2036,33,797.3589743589744,36,3,19,34.15867141812865,0.6388888888888891,43.243243243243235,1027.0270270270262,28.528528528528504,0
2082,4,0,0,39,0.0,0.0,1.0,39,1600,1300,300,0.8125,19,13,6,357.43632012590723,0.38812977957714795,0.18105726149250811,0.2134145264242198,132059.67821829778,1640.585083871941,133700.2633021697,2037,34,798.3589743589744,37,2,19,33.852499822203264,0.6390765765765767,43.037280701754376,1027.850877192981,27.779753437648136,0
2083,4,0,0,39,0.0,0.0,1.0,39,1150,1000,150,0.8695652173913043,13,10,3,355.18756980633907,0.387342555105713,0.17468051249241312,0.21270428030931327,132172.40521121875,1589.1990804862912,133761.60429170504,2038,35,799.3589743589744,37,2,19,33.79674059856401,0.6402027027027027,42.92763157894736,1028.2894736842097,27.791607396870532,0
2084,4,0,0,39,0.0,0.0,1.0,39,1050,700,350,0.6666666666666666,14,7,7,354.1934060367958,0.3872863247863248,0.17495714648929295,0.21226708979035805,132200.59447378022,1564.9157673514683,133765.51024113168,2039,36,800.3589743589744,37,2,19,33.79391459643884,0.6404842342342343,42.9002192982456,1028.399122807016,27.79457088667611,0
2085,4,0,0,39,0.0,0.0,1.0,39,1250,900,350,0.72,16,9,7,352.9695336162827,0.387342555105713,0.1784844883406418,0.2124835838992181,132369.79316953284,1544.500831986751,133914.2940015196,2040,37,801.3589743589744,37,2,19,33.655101225359616,0.6421734234234234,42.73574561403508,1029.0570175438588,27.812351825509698,0
2086,4,1,0,40,0.025,0.0,1.0,40,700,300,400,0.42857142857142855,11,3,8,345.3246174796773,0.38997061965811963,0.17343035011173735,0.20976182485174705,132708.5151801516,1165.5064539088917,133874.02163406048,2041,0,782.3,37,3,18,33.511470859494175,0.6455518018018017,42.406798245614034,1030.372807017544,27.84791370317686,0
2087,4,0,0,40,0.0,0.0,1.0,40,650,400,250,0.6153846153846154,9,4,5,342.8121321865094,0.38985042735042735,0.1740319148936169,0.20870686804100994,132793.2633117884,1104.6283471837664,133897.89165897216,2042,1,783.3,37,3,18,33.491134751773046,0.6463963963963963,42.32456140350878,1030.7017543859663,27.856804172593684,0
2088,4,0,0,40,0.0,0.0,1.0,40,1100,600,500,0.5454545454545454,16,6,10,343.5889159811628,0.38969017094017094,0.1707252233092298,0.20981234843421154,132906.3029008927,1133.0265081563666,134039.32940904907,2043,2,784.3,37,3,19,33.35770239614348,0.6475225225225224,42.21491228070176,1031.140350877194,27.86865813181605,0
2089,4,1,1,40,0.024390243902439025,0.024390243902439025,0.975609756097561,41,1300,800,500,0.6153846153846154,18,8,10,338.3849448873481,0.39352134146341466,0.16240979547330392,0.20840112953769563,133223.94035585134,816.1951429980172,134040.13549884935,2044,0,766.1463414634146,38,3,19,33.17357445927766,0.6488486842105263,41.90705128205128,1032.3717948717942,27.167678812415637,0
2090,4,0,0,40,0.0,0.0,1.0,40,800,600,200,0.75,10,6,4,347.29591649686006,0.3891559829059829,0.16822601211348442,0.21320299218212324,133104.23790252768,1245.3116583948874,134349.54956092258,2045,4,786.3,37,3,19,33.06359136471506,0.6494932432432432,42.02302631578947,1031.9078947368419,27.889402560455185,0
2091,4,0,0,40,0.0,0.0,1.0,40,600,300,300,0.5,9,3,6,346.6905865768616,0.3895032051282051,0.17091522362689915,0.21315470225003258,133160.81781173052,1233.1204072406902,134393.93821897122,2046,5,787.3,37,3,19,33.02248220546055,0.6500563063063063,41.968201754385966,1032.127192982456,27.89532954006638,0
2092,4,0,0,40,0.0,0.0,1.0,40,1500,1100,400,0.7333333333333333,19,11,8,347.2664311336125,0.38938301282051285,0.17303414381790017,0.21418826144903394,133279.09412895373,1256.6710725765024,134535.76520153024,2047,6,788.3,38,2,19,32.88907570270735,0.6493969298245614,41.85363247863247,1032.5854700854686,27.173301844354437,0
2093,4,0,0,40,0.0,0.0,1.0,40,750,400,350,0.5333333333333333,11,4,7,347.62992398333535,0.38906250000000003,0.17522190841234586,0.21459545867813132,133310.812717014,1268.5655381944534,134579.37825520846,2048,7,789.3,39,1,19,32.847908681326075,0.6479700854700854,41.82291666666667,1032.7083333333342,26.479700854700877,0
2094,4,0,0,40,0.0,0.0,1.0,40,1100,800,300,0.7272727272727273,14,8,6,345.31128697546393,0.389329594017094,0.1679125919951605,0.2139377049037869,133445.31385633687,1216.0346137152821,134661.34847005215,2049,8,790.3,39,1,20,32.773066001277,0.6493055555555556,41.692708333333336,1033.2291666666672,26.493055555555568,0
2095,4,0,0,40,0.0,0.0,1.0,40,750,300,450,0.4,12,3,9,344.40852376103555,0.38906250000000003,0.1735838548849058,0.2140236752468872,133557.21381819388,1199.6539950994402,134756.86781329333,2050,9,791.3,37,3,20,32.6843773204625,0.6539977477477478,41.5844298245614,1033.6622807017532,27.93681839734468,0
2096,4,0,0,40,0.0,0.0,1.0,40,1150,500,650,0.43478260869565216,18,5,13,344.0453686200381,0.3889155982905983,0.17579533404029735,0.21428981678249384,133642.2324657586,1195.7982263773406,134838.03069213594,2051,10,792.3,37,3,20,32.608695652173935,0.6548423423423424,41.50219298245614,1033.9912280701747,27.94570886676148,0
2097,4,0,0,40,0.0,0.0,1.0,40,1250,900,350,0.72,16,9,7,339.8401511191345,0.3878071581196581,0.16934082238236559,0.21264798845889604,133812.3509156663,1094.9619113573312,134907.31282702362,2052,11,793.3,37,3,17,32.54733644199518,0.6565315315315315,41.33771929824561,1034.649122807017,27.963489805595053,0
2098,4,0,0,40,0.0,0.0,1.0,40,1050,700,350,0.6666666666666666,14,7,7,339.45140053907323,0.3877537393162393,0.1700095359186271,0.21273189364460626,133869.0811114957,1088.4094144351905,134957.4905259309,2053,12,794.3,37,3,17,32.500706364342726,0.6570945945945947,41.282894736842096,1034.8684210526303,27.969416785206224,0
2099,4,0,0,40,0.0,0.0,1.0,40,1300,1100,200,0.8461538461538461,15,11,4,340.6675001314063,0.38758012820512816,0.17080686149936497,0.21448425808273322,134039.34383656492,1132.5696368113045,135171.91347337622,2054,13,795.3,37,3,18,32.29916701962444,0.6587837837837839,41.11842105263157,1035.5263157894722,27.98719772403979,0
2100,4,0,0,40,0.0,0.0,1.0,40,600,400,200,0.6666666666666666,8,4,4,341.4337440509545,0.3872061965811966,0.1758998517891175,0.21529927545429323,134096.12212411495,1156.9882079101083,135253.11033202507,2055,14,796.3,37,3,19,32.222633919119204,0.6593468468468469,41.06359649122806,1035.7456140350864,27.993124703650984,0
2101,4,0,1,39,0.0,0.025,0.975,40,850,400,450,0.47058823529411764,13,4,9,341.4337440509545,0.3872061965811966,0.1758998517891175,0.21529927545429323,134096.12212411495,1156.9882079101083,135253.11033202507,2056,15,797.3,37,3,19,32.222633919119204,0.6593468468468469,41.06359649122806,1035.7456140350864,27.993124703650984,0
2102,4,1,0,40,0.025,0.0,1.0,40,1250,1000,250,0.8,15,10,5,344.15848510924036,0.38607104700854705,0.18446260446419127,0.21819786450286052,134294.94081111506,1243.7486774776958,135538.68948859276,2057,0,797.9,37,3,21,31.953590570894605,0.6613175675675675,40.871710526315795,1036.5131578947376,28.013869132290203,0
2103,4,1,0,41,0.024390243902439025,0.0,1.0,41,1000,700,300,0.7,13,7,6,335.5474849575428,0.3896087398373984,0.18387919058309254,0.21440147536483667,134579.22299409448,831.7874249769325,135411.01041907142,2058,0,779.4146341463414,37,4,22,31.893405016027337,0.6641328828828827,40.597587719298254,1037.6096491228082,28.043504030346167,0
2104,4,0,0,41,0.0,0.0,1.0,41,950,600,350,0.631578947368421,13,6,7,336.62641773330665,0.38897357723577236,0.18725213559584053,0.21542725110518926,134636.11549948077,864.4146516235963,135500.53015110438,2059,1,780.4146341463414,37,4,22,31.808747138580753,0.6646959459459458,40.54276315789475,1037.8289473684224,28.049431009957363,0
2105,4,0,0,41,0.0,0.0,1.0,41,500,400,100,0.8,6,4,2,337.0251272512236,0.3886178861788618,0.18377058176412508,0.21602010018194553,134693.02002779712,878.9864429439934,135572.00647074112,2060,2,781.4146341463414,37,4,22,31.741730044716732,0.6652590090090089,40.48793859649123,1038.048245614036,28.05535798956854,0
2106,4,0,0,41,0.0,0.0,1.0,41,1000,800,200,0.8,12,8,4,338.511944165449,0.3882621951219512,0.1912182762030321,0.2178250771151588,134835.33394890756,928.674207448465,135764.00815635602,2061,3,782.4146341463414,37,4,17,31.561444256756754,0.6666666666666665,40.350877192982466,1038.5964912280717,28.070175438596532,0
2107,4,0,2,39,0.0,0.04878048780487805,0.9512195121951219,41,950,700,250,0.7368421052631579,12,7,5,329.8240279408791,0.38729674796747965,0.1289240189787162,0.2112569885706106,134667.64219878684,688.0378252728901,135355.68002405972,2062,4,783.4146341463414,36,5,19,31.953862428121962,0.6669560185185184,40.5123873873874,1037.950450450452,28.831956956957,4
2108,4,0,0,39,0.0,0.0,1.0,39,1200,800,400,0.6666666666666666,16,8,8,344.6291983709439,0.3810728744939271,0.14845126646234008,0.2196802454114027,134492.36979800765,1469.9995180992055,135962.36931610687,2063,60,824.3589743589744,36,3,20,31.744426953280513,0.6652199074074073,40.68130630630632,1037.2747747747765,28.813188188188235,0
2109,4,0,0,39,0.0,0.0,1.0,39,1150,900,250,0.782608695652174,14,9,5,344.71242982105673,0.3802856500224921,0.14985702686482893,0.2202722535425462,134581.66099773243,1478.419637577456,136060.0806353099,2064,61,825.3589743589744,34,5,20,31.65323351690378,0.6703431372549019,40.595238095238095,1037.6190476190475,30.51820728291316,0
2110,4,0,0,39,0.0,0.0,1.0,39,850,700,150,0.8235294117647058,10,7,3,341.1754033172559,0.37963900134952766,0.15215352592694265,0.21854721549636802,134670.88906035668,1389.278978052127,136060.1680384088,2065,62,826.3589743589744,35,4,20,31.65607344632768,0.669047619047619,40.50925925925926,1037.962962962963,29.65608465608466,0
2111,4,0,0,39,0.0,0.0,1.0,39,1100,900,200,0.8181818181818182,13,9,4,343.82361932201854,0.37924538911381017,0.15595026744541718,0.22042559268757586,134700.92438539528,1462.6718696416374,136163.59625503691,2066,63,827.3589743589744,35,4,20,31.557424647861144,0.669345238095238,40.480324074074076,1038.0787037037042,29.659391534391546,0
2112,4,0,0,39,0.0,0.0,1.0,39,600,300,300,0.5,9,3,6,345.9099682789812,0.3788236617183986,0.1541662379825557,0.2223140569770073,134791.05045438968,1525.1135973937055,136316.1640517834,2067,64,828.3589743589744,35,4,17,31.413471541090814,0.6702380952380952,40.393518518518526,1038.4259259259268,29.669312169312192,0
2113,4,0,0,39,0.0,0.0,1.0,39,950,600,350,0.631578947368421,13,6,7,345.33648869887713,0.37843004948268105,0.14538961502749825,0.22249784537490483,134881.20666420192,1515.8804601766244,136397.08712437854,2068,65,829.3589743589744,35,4,17,31.338556174558963,0.6711309523809523,40.30671296296297,1038.773148148149,29.67923280423283,0
2114,4,0,0,39,0.0,0.0,1.0,39,1000,700,300,0.7,13,7,6,345.9447475672436,0.37834570400359874,0.15336640194642226,0.22363123746625507,135001.46182966832,1540.6093267747037,136542.071156443,2069,66,830.3589743589744,35,4,17,31.20301536919479,0.6723214285714285,40.19097222222223,1039.236111111112,29.69246031746034,0
2115,4,0,0,39,0.0,0.0,1.0,39,750,500,250,0.6666666666666666,10,5,5,347.19867460974893,0.3782051282051282,0.15571926217805987,0.22462853731956384,135031.53399348422,1576.553926611799,136608.087920096,2070,67,831.3589743589744,35,4,17,31.14049740163325,0.6726190476190477,40.16203703703704,1039.351851851852,29.6957671957672,0
2116,4,0,0,39,0.0,0.0,1.0,39,800,600,200,0.75,10,6,4,345.4414227504997,0.3782613585245164,0.1553761092890562,0.22405056321788736,135121.77057881086,1535.3313346622072,136657.10191347307,2071,68,832.3589743589744,35,4,17,31.09635329696834,0.6735119047619047,40.07523148148148,1039.699074074074,29.705687830687825,0
2117,4,0,0,39,0.0,0.0,1.0,39,700,300,400,0.42857142857142855,11,3,8,342.86670202222905,0.37803643724696356,0.15081042988019733,0.22312404424864407,135242.13291162992,1474.0048171725107,136716.13772880242,2072,69,833.3589743589744,35,4,17,31.04356756055042,0.6747023809523809,39.95949074074075,1040.162037037038,29.718915343915373,0
2118,4,0,0,39,0.0,0.0,1.0,39,1150,900,250,0.782608695652174,14,9,5,340.37545911467356,0.37775528565002253,0.1516814174028156,0.22192864267893242,135311.28415155035,1411.3280932960151,136722.61224484636,2073,70,834.3589743589744,36,3,17,31.03961467691309,0.6733217592592592,39.893018018018026,1040.4279279279292,28.900775775775813,0
2119,4,0,0,39,0.0,0.0,1.0,39,1000,800,200,0.8,12,8,4,340.3129157999287,0.3776990553306343,0.15077700077700085,0.22206859759825867,135340.57706355012,1411.629281308346,136752.20634485848,2074,71,835.3589743589744,36,3,18,31.012130230880217,0.673611111111111,39.86486486486487,1040.5405405405413,28.903903903903924,0
2120,4,0,0,39,0.0,0.0,1.0,39,950,400,550,0.42105263157894735,15,4,11,338.2378677247592,0.3777271704903284,0.1512271181174012,0.22107456672646586,135399.17239875026,1359.4254727700834,136758.59787152035,2075,72,836.3589743589744,36,3,18,31.00789872322009,0.6741898148148147,39.808558558558566,1040.765765765767,28.910160160160192,0
2121,4,0,0,39,0.0,0.0,1.0,39,1250,1000,250,0.8,15,10,5,337.6246818694623,0.3775865946918579,0.14933643965553123,0.2212147543503318,135487.0891795513,1348.7570763331057,136835.8462558844,2076,73,837.3589743589744,36,3,18,30.93654227510367,0.6750578703703705,39.72409909909911,1041.1036036036046,28.91954454454457,0
2122,4,0,0,39,0.0,0.0,1.0,39,1050,700,350,0.6666666666666666,14,7,7,336.74490941438467,0.3772210976158345,0.1467087038623751,0.22099930286407515,135545.71621875273,1328.865985918371,136874.5822046711,2077,74,838.3589743589744,36,3,18,30.90123823942901,0.6756365740740741,39.6677927927928,1041.3288288288304,28.925800800800843,0
2123,4,0,1,38,0.0,0.02564102564102564,0.9743589743589743,39,1000,700,300,0.7,13,7,6,338.3908826055493,0.3766025641025641,0.1537241725370171,0.22244330300062023,135604.35593955452,1377.455538308588,136981.8114778631,2078,75,839.3589743589744,36,3,18,30.800176595667985,0.6762152777777778,39.61148648648649,1041.5540540540549,28.93205705705708,0
2124,4,0,0,38,0.0,0.0,1.0,38,900,800,100,0.8888888888888888,10,8,2,356.3886204297619,0.37768195827406353,0.1431678750697154,0.22772801013206107,134580.80317911954,1992.6196970674114,136573.42287618696,2079,76,837.921052631579,35,3,19,31.35120375534485,0.6681547619047619,40.59606481481482,1037.615740740741,29.646164021164033,3
2125,4,0,0,38,0.0,0.0,1.0,38,700,300,400,0.42857142857142855,11,3,8,354.0991278167472,0.37809684684684686,0.1499915082019061,0.23043366123744427,135242.13291162963,1981.9267618312606,137224.0596734609,2080,77,838.921052631579,35,3,16,30.7514789881681,0.674702380952381,39.95949074074073,1040.1620370370358,29.71891534391531,1
2126,4,0,0,38,0.0,0.0,1.0,38,600,300,300,0.5,9,3,6,354.19701420956494,0.37729670459933623,0.15490570346212595,0.23088302833428415,135302.3341719178,1984.7365558556162,137287.07072777342,2081,78,839.921052631579,35,3,16,30.689013423814284,0.675297619047619,39.90162037037037,1040.3935185185182,29.725529100529094,0
2127,4,0,0,38,0.0,0.0,1.0,38,550,300,250,0.5454545454545454,8,3,5,351.87070199212303,0.3766891891891892,0.14773365798838767,0.22994341223206147,135392.66117969799,1928.1421467763812,137320.80332647436,2082,79,840.921052631579,35,3,18,30.65966043890866,0.6761904761904762,39.8148148148148,1040.7407407407388,29.73544973544968,0
2128,4,0,0,38,0.0,0.0,1.0,38,650,300,350,0.46153846153846156,10,3,7,351.39813514221345,0.37700035561877665,0.14702956100358722,0.22982715849701268,135422.7768802512,1917.4622503000614,137340.23913055126,2083,80,841.921052631579,35,3,18,30.642003966047657,0.6764880952380953,39.785879629629626,1040.8564814814813,29.738756613756607,0
2129,4,0,0,38,0.0,0.0,1.0,38,900,800,100,0.8888888888888888,10,8,2,354.67653885542893,0.37686699857752487,0.1505666133539756,0.23276749146885375,135545.71621875244,2014.9770970294526,137560.6933157819,2084,81,842.921052631579,36,2,18,30.43442017230813,0.6756365740740742,39.66779279279279,1041.3288288288281,28.925800800800783,0
2130,4,0,0,38,0.0,0.0,1.0,38,900,600,300,0.6666666666666666,12,6,6,356.6587513372454,0.37756341868183974,0.15059226604614184,0.23503968371433953,135693.9688893173,2079.316835212934,137773.28572453023,2085,82,843.921052631579,35,3,19,30.235410649485306,0.6791666666666668,39.52546296296295,1041.898148148146,29.76851851851846,0
2131,4,0,0,38,0.0,0.0,1.0,38,950,800,150,0.8421052631578947,11,8,3,357.177716988002,0.37763750592697964,0.1529004354306085,0.2359783816197325,135784.42650730867,2099.8342924811186,137884.2607997898,2086,83,844.921052631579,35,3,21,30.131986859152306,0.680059523809524,39.4386574074074,1042.2453703703693,29.778439153439123,0
2132,4,0,0,38,0.0,0.0,1.0,38,550,300,250,0.5454545454545454,8,3,5,356.2871506811092,0.3767780938833571,0.14998493642032518,0.23613906429179582,135897.74476757154,2083.7240534453267,137981.46882101687,2087,84,845.921052631579,36,2,14,30.042616193253412,0.6791087962962964,39.32995495495495,1042.6801801801794,28.963338338338318,0
2133,4,0,0,38,0.0,0.0,1.0,38,650,300,350,0.46153846153846156,10,3,7,357.1273198965542,0.37688181602655285,0.14826285103819825,0.2372821547261034,135985.8232387792,2112.850519438346,138098.67375821754,2088,85,846.921052631579,36,2,16,29.933239761030723,0.6799768518518519,39.24549549549549,1043.0180180180173,28.972722722722704,0
2134,4,0,0,38,0.0,0.0,1.0,38,900,400,500,0.4444444444444444,14,4,10,356.3302996573528,0.3763039355144618,0.1548937885765227,0.2381272925395822,136191.45063560197,2105.82808315073,138297.2787187527,2089,86,847.921052631579,36,2,19,29.7499280756644,0.6820023148148149,39.04842342342343,1043.8063063063073,28.994619619619648,0
2135,4,0,0,38,0.0,0.0,1.0,38,850,700,150,0.8235294117647058,10,7,3,358.52627531864175,0.3756519677572309,0.15192535864523782,0.2399925702873017,136250.22985400943,2169.857484173365,138420.0873381828,2090,87,848.921052631579,36,2,19,29.63429870923669,0.6825810185185186,38.99211711711712,1044.0315315315318,29.00087587587588,0
2136,4,0,0,38,0.0,0.0,1.0,38,1100,800,300,0.7272727272727273,14,8,6,358.77448258243845,0.3752667140825035,0.15147825889537825,0.24055790144518818,136309.02175401757,2180.8397502232033,138489.86150424078,2091,88,849.921052631579,36,2,19,29.569493871095304,0.6831597222222222,38.935810810810814,1044.256756756757,29.007132132132142,0
2137,4,0,0,38,0.0,0.0,1.0,38,700,400,300,0.5714285714285714,10,4,6,359.8756062234819,0.3748962778568042,0.15773586618551505,0.2418989944441321,136397.23338203088,2217.207410112838,138614.44079214372,2092,89,850.921052631579,36,2,19,29.453248526663792,0.6840277777777777,38.85135135135136,1044.5945945945962,29.01651651651656,0
2138,4,0,0,38,0.0,0.0,1.0,38,650,500,150,0.7692307692307693,8,5,3,359.7165209570985,0.37393314366998576,0.15728775484734614,0.2421952018461514,136456.05698604038,2217.099616508426,138673.1566025488,2093,90,851.921052631579,36,2,19,29.39907127972983,0.6846064814814814,38.79504504504506,1044.819819819822,29.022772772772832,0
2139,4,0,0,38,0.0,0.0,1.0,38,600,400,200,0.6666666666666666,8,4,4,358.8863703923896,0.37381460407776196,0.1530626134301265,0.24203964514835621,136514.89327165033,2198.666910153428,138713.56018180377,2094,91,852.921052631579,36,2,19,29.362428160919542,0.6851851851851851,38.73873873873875,1045.0450450450473,29.029029029029093,0
2140,4,0,0,38,0.0,0.0,1.0,38,850,500,350,0.5882352941176471,12,5,7,357.8225844303931,0.37374051683262205,0.1534686030883694,0.24152373862534424,136544.31617005542,2171.728020250006,138716.04419030543,2095,92,853.921052631579,36,2,19,29.36106023057862,0.685474537037037,38.7105855855856,1045.1576576576595,29.032157157157208,0
2141,4,0,0,38,0.0,0.0,1.0,38,550,400,150,0.7272727272727273,7,4,3,357.7576261253624,0.37262920815552397,0.1565738452119092,0.24208613709532573,136632.60388767172,2176.271203636095,138808.87509130783,2096,93,854.921052631579,36,2,19,29.275276461295427,0.6863425925925926,38.62612612612614,1045.4954954954974,29.041541541541594,0
2142,4,0,0,38,0.0,0.0,1.0,38,1200,1100,100,0.9166666666666666,13,11,2,360.15301344423085,0.37211059743954483,0.15611239253512244,0.24432001722838395,136720.92013888908,2248.090277777803,138969.0104166669,2097,94,855.921052631579,36,2,19,29.125166002656055,0.6872106481481481,38.54166666666668,1045.8333333333348,29.050925925925966,0
2143,4,0,0,38,0.0,0.0,1.0,38,1050,700,350,0.6666666666666666,14,7,7,358.4957807618969,0.37135490753911804,0.15575762655045255,0.2447123373026862,136938.88888888896,2218.4027777777833,139157.29166666674,2098,95,856.921052631579,34,4,20,28.952693736730357,0.6936274509803921,38.333333333333336,1046.6666666666672,30.78431372549021,0
2144,4,0,0,38,0.0,0.0,1.0,38,600,300,300,0.5,9,3,6,356.45652335338235,0.37105855855855857,0.15415030112594907,0.2436998680069043,136993.408203125,2166.438802083334,139159.84700520834,2099,96,857.921052631579,35,3,15,28.9521144278607,0.6919642857142858,38.28125,1046.875,29.910714285714285,0
2145,4,0,0,38,0.0,0.0,1.0,38,900,600,300,0.6666666666666666,12,6,6,355.1856583691405,0.37088074917022285,0.15506448779182436,0.24325243385810844,137053.99794506593,2135.9228984482106,139189.92084351415,2100,97,858.921052631579,35,3,15,28.925449504439783,0.6925595238095239,38.223379629629626,1047.1064814814808,29.917328042328023,0
2146,4,0,0,38,0.0,0.0,1.0,38,1000,800,200,0.8,12,8,4,355.7789962950332,0.37077702702702703,0.15241870285172565,0.24408219389490168,137114.60108292598,2156.4990301354455,139271.10011306143,2101,98,859.921052631579,35,3,15,28.849988028143077,0.693154761904762,38.16550925925925,1047.337962962962,29.92394179894177,0
2147,4,0,0,38,0.0,0.0,1.0,38,900,700,200,0.7777777777777778,11,7,4,356.2231174715454,0.36973980559506875,0.15571168615230802,0.2452386222410569,137235.84754640333,2177.316288365899,139413.16383476922,2102,99,860.921052631579,35,3,15,28.71849571044589,0.6943452380952382,38.04976851851851,1047.800925925925,29.937169312169285,0
2148,4,0,0,38,0.0,0.0,1.0,38,1200,900,300,0.75,15,9,6,358.3877900092102,0.36862849691797056,0.15869640989891964,0.24824108390546207,137448.15779320983,2251.9483024691344,139700.10609567896,2103,100,861.921052631579,35,3,17,28.451986754966892,0.6964285714285714,37.84722222222222,1048.6111111111109,29.96031746031745,0
2149,4,0,0,38,0.0,0.0,1.0,38,850,500,350,0.5882352941176471,12,5,7,356.36025218034115,0.36891002844950216,0.15747942309144447,0.24705281140061755,137478.501224387,2198.3746731395777,139676.87589752657,2104,101,862.921052631579,35,3,17,28.475172902181516,0.6967261904761904,37.81828703703704,1048.726851851852,29.963624338624342,0
2150,4,0,0,38,0.0,0.0,1.0,38,850,600,250,0.7058823529411765,11,6,5,355.59235920849994,0.36892484589853014,0.1567566312073212,0.24716941287314748,137569.55161179698,2183.736282578875,139753.28789437586,2105,102,863.921052631579,35,3,18,28.405413356869666,0.6976190476190476,37.73148148148148,1049.074074074074,29.973544973544968,0
2151,4,0,0,38,0.0,0.0,1.0,38,1050,1000,50,0.9523809523809523,11,10,1,356.8229629529053,0.3687766714082503,0.15766832700546862,0.24846059770591705,137630.2686149692,2221.9280478395135,139852.1966628087,2106,103,864.921052631579,35,3,19,28.313203176704175,0.6982142857142857,37.673611111111114,1049.3055555555559,29.980158730158738,0
2152,4,0,0,38,0.0,0.0,1.0,38,1200,900,300,0.75,15,9,6,354.8642623522435,0.36871740161213845,0.15460961623290648,0.24753147161616512,137690.9990140605,2172.3229595336225,139863.32197359414,2107,104,865.921052631579,35,3,20,28.304661079253055,0.6988095238095238,37.61574074074075,1049.5370370370383,29.986772486772523,0
2153,4,0,0,38,0.0,0.0,1.0,38,1250,900,350,0.72,16,9,7,352.7441469284888,0.3685395922238028,0.15533534584591124,0.24736954405430284,137875.0070861679,2126.9739351502058,140001.9810213181,2108,105,866.921052631579,34,4,20,28.178842666062117,0.7028186274509803,37.4404761904762,1050.238095238096,30.889355742296942,0
2154,4,0,0,38,0.0,0.0,1.0,38,950,500,450,0.5263157894736842,14,5,9,349.24428095378096,0.36830251303935513,0.14868986391283867,0.24555308584178726,137964.45158446953,2036.659138160171,140001.1107226297,2109,106,867.921052631579,35,3,20,28.182608975065175,0.7014880952380951,37.35532407407408,1050.5787037037053,30.016534391534435,0
2155,4,0,0,38,0.0,0.0,1.0,38,1050,800,250,0.7619047619047619,13,8,5,348.3537881149251,0.36830251303935513,0.14626292021495502,0.24536105836271574,138025.2556611154,2016.3241330161156,140041.5797941315,2110,107,868.921052631579,35,3,21,28.146110988728562,0.7020833333333333,37.2974537037037,1050.8101851851852,30.02314814814815,0
2156,4,0,0,38,0.0,0.0,1.0,38,1200,1000,200,0.8333333333333334,14,10,4,351.50875957976365,0.36762091038406824,0.1472142699845851,0.2482428113921785,138116.48689343283,2109.830997085057,140226.31789051788,2111,108,869.921052631579,35,3,16,27.973372238126707,0.7029761904761904,37.21064814814815,1051.1574074074078,30.033068783068796,0
2157,4,0,0,38,0.0,0.0,1.0,38,1000,700,300,0.7,13,7,6,353.04136295500024,0.3675912754860123,0.14812626016825403,0.2497685156606871,138177.32445987657,2156.4621913580268,140333.7866512346,2112,109,870.921052631579,35,3,16,27.873183619550858,0.7035714285714285,37.15277777777778,1051.3888888888891,30.03968253968255,0
2158,4,0,0,38,0.0,0.0,1.0,38,1450,1200,250,0.8275862068965517,17,12,5,355.6118883106061,0.36698376007586536,0.1522806631497875,0.2527096522951603,138329.47698313193,2238.3213037980177,140567.79828692996,2113,110,871.921052631579,35,3,16,27.65579730076649,0.7050595238095239,37.008101851851855,1051.967592592593,30.056216931216944,0
2159,4,0,0,38,0.0,0.0,1.0,38,450,400,50,0.8888888888888888,5,4,1,356.78855014214287,0.36667259364627786,0.15586242834809783,0.25377213777715796,138359.91753472216,2273.046874999995,140632.96440972216,2114,111,872.921052631579,35,3,16,27.594884488448844,0.7053571428571428,36.979166666666664,1052.083333333333,30.0595238095238,0
2160,4,0,0,38,0.0,0.0,1.0,38,750,600,150,0.8,9,6,3,363.17426182295225,0.36667259364627786,0.1550967450781291,0.2555366412374168,137989.92193206734,2422.877607337082,140412.79953940443,2115,112,873.921052631579,36,2,18,27.79162200785995,0.6996527777777777,37.33108108108109,1050.6756756756768,29.185435435435465,1
2161,4,0,0,38,0.0,0.0,1.0,38,750,400,350,0.5333333333333333,11,4,7,380.1599554723355,0.36688003793266954,0.20032972368703383,0.2656560048660501,137753.38471917858,2873.664120201277,140627.04883937986,2116,113,874.921052631579,36,2,17,27.57924801544733,0.697337962962963,37.556306306306304,1049.7747747747742,29.160410410410393,3
2162,4,0,0,38,0.0,0.0,1.0,38,1300,1000,300,0.7692307692307693,16,10,6,384.24431017026035,0.3675764580369843,0.19547447086252379,0.24931326182726737,135135.5932579539,2803.3414749208696,137938.93473287477,2117,114,875.921052631579,36,2,17,30.073964764070897,0.6715856481481481,40.06193693693694,1039.7522522522524,28.88200700700701,6
2163,4,0,0,38,0.0,0.0,1.0,38,1300,1000,300,0.7692307692307693,16,10,6,386.9621110516934,0.3668504030346136,0.19955808152712406,0.2529210629660364,135399.17239875026,2878.8699172145275,138278.0423159648,2118,115,876.921052631579,36,2,17,29.740135612782236,0.6741898148148149,39.808558558558566,1040.765765765767,28.910160160160192,0
2164,4,0,0,38,0.0,0.0,1.0,38,750,600,150,0.8,9,6,3,385.8712438054252,0.36584281650071127,0.2018853102906517,0.2530330156187917,135516.4011139519,2858.3764507751102,138374.777564727,2119,116,877.921052631579,36,2,18,29.651561035402704,0.6753472222222222,39.69594594594595,1041.216216216217,28.922672672672693,0
2165,4,0,0,38,0.0,0.0,1.0,38,900,700,200,0.7777777777777778,11,7,4,385.5999999999995,0.36483522996680895,0.2014736842105258,0.2536842105263158,135633.68055555577,2860.0694444444653,138493.75000000023,2120,117,878.921052631579,36,2,18,29.541666666666657,0.6765046296296295,39.58333333333334,1041.6666666666683,28.935185185185233,0
2166,4,0,0,38,0.0,0.0,1.0,38,1000,800,200,0.8,12,8,4,378.2376719771322,0.36483522996680895,0.1765588529509834,0.24821329940031067,135543.27317226076,2653.5144193672772,138196.78759162803,2121,118,879.921052631579,35,3,17,29.823482827609194,0.6776785714285715,39.670138888888886,1041.3194444444441,29.751984126984116,1
2167,4,0,0,38,0.0,0.0,1.0,38,850,500,350,0.5882352941176471,12,5,7,376.4095586609203,0.3636794689426268,0.1784801688701254,0.24784655724264398,135663.82304794661,2613.0319519461527,138276.85499989276,2122,119,880.921052631579,35,3,17,29.75097674332481,0.6788690476190476,39.554398148148145,1041.782407407407,29.76521164021163,0
2168,4,0,0,38,0.0,0.0,1.0,38,1500,1200,300,0.8,18,12,6,374.81012516638486,0.3636794689426268,0.1767470515754268,0.24048975842220868,134730.96305941377,2499.7058256173077,137230.66888503107,2123,120,881.921052631579,35,3,18,30.723244147157192,0.669642857142857,40.4513888888889,1038.194444444446,29.662698412698454,1
2169,4,0,0,38,0.0,0.0,1.0,38,800,600,200,0.75,10,6,4,374.5680075864895,0.36415362731152207,0.17792195602693783,0.24073238997607346,134791.05045438968,2497.683041838151,137288.73349622783,2124,121,882.921052631579,35,3,16,30.669490266012794,0.6702380952380952,40.393518518518526,1038.4259259259268,29.669312169312192,0
2170,4,0,0,38,0.0,0.0,1.0,38,650,300,350,0.46153846153846156,10,3,7,373.6535874178503,0.36402027027027023,0.17672775252895412,0.2407423508309554,134881.20666420195,2479.769349065514,137360.97601326747,2125,122,883.921052631579,35,3,16,30.60318012999071,0.6711309523809523,40.30671296296297,1038.7731481481492,29.679232804232832,0
2171,4,1,0,39,0.02564102564102564,0.0,1.0,39,950,700,250,0.7368421052631579,12,7,5,365.2947216336503,0.3694331983805668,0.17797365636637807,0.23701800174585358,135135.59325795408,2072.8637843925185,137208.4570423466,2126,0,862.2307692307693,36,3,17,30.566536698075748,0.6715856481481481,40.061936936936945,1039.7522522522536,28.882007007007044,0
2172,4,0,0,39,0.0,0.0,1.0,39,850,600,250,0.7058823529411765,11,6,5,366.54098057430224,0.36923639226270805,0.18321602598808862,0.23821294550342598,135194.1442075522,2110.8388371479664,137304.98304470014,2127,1,863.2307692307693,36,3,18,30.47577152138603,0.6721643518518519,40.005630630630634,1039.977477477478,28.88826326326328,0
2173,4,0,0,39,0.0,0.0,1.0,39,1050,600,450,0.5714285714285714,15,6,9,358.6825612862806,0.36923639226270805,0.13961974376295516,0.21438886334755994,132100.37964034622,1684.9932652090106,133785.37290555524,2128,2,864.2307692307693,35,4,17,33.779460331757114,0.643452380952381,42.997685185185176,1028.009259259258,29.371693121693085,6
2174,4,0,0,39,0.0,0.0,1.0,39,1050,700,350,0.6666666666666666,14,7,7,364.6497461515033,0.36923639226270805,0.1500049670518886,0.20510444559562827,129759.37307633163,1670.4309317990987,131429.8040081307,2129,3,865.2307692307693,37,2,16,35.99691490888218,0.6159909909909909,45.28508771929827,1018.8596491228107,27.536747273589476,6
2175,4,0,0,39,0.0,0.0,1.0,39,800,400,400,0.5,12,4,8,360.36715509249325,0.3688427800269905,0.14841843109026054,0.2034203667817192,129899.0569814753,1562.2707227224028,131461.3277041977,2130,4,866.2307692307693,37,2,16,35.96399824316088,0.6173986486486485,45.14802631578949,1019.4078947368439,27.551564722617403,0
2176,4,1,1,39,0.025,0.025,0.975,40,750,400,350,0.5333333333333333,11,4,7,355.25100737370093,0.3735844017094017,0.14482722513088975,0.2017031581699673,130126.29323727111,1245.4993516692548,131371.79258894036,2131,0,845.55,38,2,16,35.86365619546247,0.6178728070175437,44.92521367521369,1020.2991452991478,26.84997750787231,0
2177,4,0,0,39,0.0,0.0,1.0,39,1250,700,550,0.56,18,7,11,364.21709354568924,0.368421052631579,0.1458650263465393,0.20662657550909136,130094.74068944315,1676.5456678978405,131771.28635734098,2132,6,868.2307692307693,37,2,17,35.667007022069356,0.6193693693693693,44.956140350877206,1020.1754385964932,27.572309151256572,0
2178,4,0,0,39,0.0,0.0,1.0,39,1000,500,500,0.5,15,5,10,370.8764575838274,0.368421052631579,0.16359957947186654,0.19441428754860812,126946.17419249378,1616.4858904086823,128562.66008290247,2133,7,869.2307692307693,35,4,16,38.71753091382413,0.5913690476190477,48.06134259259258,1007.7546296296279,28.792989417989368,5
2179,4,2,1,40,0.04878048780487805,0.024390243902439025,0.975609756097561,41,1000,700,300,0.7,13,7,6,355.17594645861294,0.3828506097560975,0.15887291120468228,0.18864881585258472,127479.2784799166,855.514677593072,128334.79315750967,2134,0,827.780487804878,37,4,11,38.56587043069127,0.5929054054054055,47.53289473684209,1009.8684210526291,27.293741109530515,0
2180,4,3,2,41,0.06976744186046512,0.046511627906976744,0.9534883720930233,43,1100,700,400,0.6363636363636364,15,7,8,341.99900137551424,0.3907115171650055,0.14520399710798637,0.18395228678636466,127986.376953125,154.24262152777794,128140.61957465278,2135,0,790.2093023255813,39,4,13,38.379744012078795,0.5945512820512822,47.03125,1011.875,25.94551282051282,0
2181,4,2,4,39,0.046511627906976744,0.09302325581395349,0.9069767441860466,43,1250,800,450,0.64,17,8,9,377.1880549083718,0.39202657807308966,0.17376393787887956,0.20619338248057903,128633.7549160555,1103.8231624694554,129737.57807852497,2136,0,791.1627906976744,40,3,14,36.826496026180465,0.5994791666666666,46.39227642276424,1014.4308943089451,25.360772357723626,5
2182,4,3,1,41,0.07142857142857142,0.023809523809523808,0.9761904761904762,42,1000,600,400,0.6,14,6,8,393.0782380013144,0.38425522648083626,0.22522588522588505,0.2165261480515719,128936.76757812528,1736.4474826389176,130673.2150607642,2137,0,810.8571428571429,39,3,16,36.11324786324787,0.6041666666666665,46.093750000000014,1015.6250000000022,26.04166666666672,0
2183,4,3,0,44,0.06818181818181818,0.0,1.0,44,1300,1100,200,0.8461538461538461,15,11,4,377.42700193457694,0.3923427589852009,0.23831918343985503,0.21133251048393165,129581.83235627135,982.3503003666149,130564.18265663796,2138,0,774.9318181818181,38,6,15,35.852352221056314,0.6123903508771931,45.4594017094017,1018.1623931623923,26.79374718848401,0
2184,4,1,0,45,0.022222222222222223,0.0,1.0,45,550,300,250,0.5454545454545454,8,3,5,368.14438424340983,0.39585437710437715,0.23786361468764894,0.20776591373737077,129890.67382812501,563.7044270833329,130454.37825520834,2139,0,758.6888888888889,39,6,16,35.77432045779685,0.6137820512820513,45.15625,1019.3750000000001,26.137820512820515,0
2185,4,2,3,44,0.0425531914893617,0.06382978723404255,0.9361702127659575,47,1100,700,400,0.6363636363636364,15,7,8,358.14738096704843,0.40036231884057966,0.23280643428169756,0.20393105465442657,130237.85848957411,-71.13041584038245,130166.72807373373,2140,0,727.3617021276596,42,5,16,35.67653945952787,0.6125992063492063,44.81589147286822,1020.7364341085284,24.30324843115544,0
2186,4,0,0,44,0.0,0.0,1.0,44,1400,1100,300,0.7857142857142857,17,11,6,374.12767581075735,0.3960425475687104,0.24364573953566104,0.2121501059186303,130076.56385633672,933.0485026041565,131009.61235894088,2141,2,762.75,39,5,18,35.432728309336596,0.6156517094017095,44.97395833333333,1020.104166666666,26.156517094017076,0
2187,4,1,3,42,0.022222222222222223,0.06666666666666667,0.9333333333333333,45,1200,900,300,0.75,15,9,6,335.1413097773955,0.3995580808080808,0.16512759011259925,0.1860945585811666,129253.05394441151,-315.72729409886216,128937.32665031265,2142,0,746.7777777777778,40,5,15,37.26264241455127,0.6057291666666667,45.78252032520326,1016.8699186991879,25.421747967479696,5
2188,4,3,3,42,0.06666666666666667,0.06666666666666667,0.9333333333333333,45,800,500,300,0.625,11,5,6,330.6316473444819,0.39978956228956225,0.17915529564652366,0.18476474410426946,129504.14540816339,-436.36621315191525,129067.77919501148,2143,0,747.4666666666667,41,4,14,37.12231968810918,0.6067073170731706,45.53571428571429,1017.8571428571438,24.825783972125457,0
2189,4,0,0,42,0.0,0.0,1.0,42,1500,1400,100,0.9333333333333333,16,14,2,352.7277613544748,0.3897962640340689,0.19613583138173318,0.19560357675111772,129201.38888888879,714.583333333324,129915.97222222212,2144,1,801.7380952380952,38,4,18,36.86816939890711,0.6085526315789473,45.83333333333333,1016.6666666666658,26.75438596491226,0
2190,4,1,1,42,0.023255813953488372,0.023255813953488372,0.9767441860465116,43,1300,900,400,0.6923076923076923,17,9,8,349.46885676173264,0.39472591362126247,0.18783381342890393,0.19571428037427607,129589.12854658274,457.47292038469357,130046.60146696743,2145,0,784.0697674418604,40,3,16,36.556584156768814,0.6091145833333333,45.452235772357724,1018.1910569105692,25.45477642276423,0
2191,4,1,1,42,0.023255813953488372,0.023255813953488372,0.9767441860465116,43,1650,1400,250,0.8484848484848485,19,14,5,347.6339546461201,0.39345699520118127,0.19286735091594154,0.19532975119802173,129718.50419723711,418.911320972972,130137.41551821008,2146,0,785.046511627907,40,3,16,36.47184257781326,0.6104166666666666,45.32520325203252,1018.69918699187,25.46747967479675,0
2192,4,0,1,41,0.0,0.023809523809523808,0.9761904761904762,42,1050,600,450,0.5714285714285714,15,6,9,344.2293070605095,0.39048586914440575,0.18200012676310373,0.19179051010039924,129386.78521050357,510.021973463123,129896.8071839667,2147,4,804.7380952380952,39,3,17,36.895605098802086,0.6087072649572649,45.65104166666667,1017.3958333333342,26.087072649572672,6
2193,4,2,1,42,0.046511627906976744,0.023255813953488372,0.9767441860465116,43,800,500,300,0.625,11,5,6,338.59996980909045,0.39320321151716503,0.2018504426585499,0.19025370500932298,129718.50419723713,184.53632097297108,129903.0405182101,2148,0,786.8837209302326,40,3,17,36.70191540303273,0.6104166666666666,45.32520325203252,1018.6991869918701,25.467479674796753,0
2194,4,1,1,42,0.023255813953488372,0.023255813953488372,0.9767441860465116,43,900,700,200,0.7777777777777778,11,7,4,341.41855088399046,0.3929955703211517,0.2036640605249549,0.19221806904625352,129796.16057117141,262.9634105030244,130059.12398167443,2149,0,787.8604651162791,40,3,17,36.55131145906056,0.6111979166666666,45.248983739837406,1019.0040650406515,25.47510162601629,0
2195,4,0,0,42,0.0,0.0,1.0,42,900,600,300,0.6666666666666666,12,6,6,347.66906774494896,0.3898325590398761,0.20915323896201254,0.195281781360015,129704.9167209204,618.8774956597467,130323.79421658015,2150,2,807.6190476190476,39,3,17,36.484750485734736,0.6119123931623931,45.33854166666668,1018.6458333333355,26.11912393162399,0
2196,4,1,0,43,0.023255813953488372,0.0,1.0,43,950,700,250,0.7368421052631579,12,7,5,341.0723252437708,0.39551033591731266,0.2122678009609993,0.19342847462129778,130081.0994199881,273.412609888292,130354.5120298764,2151,0,789.8139534883721,40,3,19,36.27112804675567,0.6140625,44.96951219512195,1020.1219512195121,25.503048780487802,0
2197,4,0,1,42,0.0,0.023255813953488372,0.9767441860465116,43,1050,800,250,0.7619047619047619,13,8,5,338.91399546495626,0.39562569213732,0.20525038667074202,0.1929734790504547,130236.65229030342,227.8048367373966,130464.45712704082,2152,1,790.8139534883721,40,3,20,36.16856664011682,0.615625,44.81707317073171,1020.7317073170734,25.518292682926834,0
2198,4,0,0,42,0.0,0.0,1.0,42,1100,700,400,0.6363636363636364,15,7,8,340.29811342261564,0.3958938250096787,0.19996573433368647,0.1940303572613577,130290.5716783047,467.5348936616072,130758.1065719663,2153,2,788.6190476190476,37,5,20,36.078630114917836,0.6213400900900901,44.764254385964904,1020.942982456139,27.59305357989565,0
2199,4,0,0,42,0.0,0.0,1.0,42,1150,700,450,0.6086956521739131,16,7,9,337.5465653188469,0.39579703832752616,0.2013910678799291,0.19313481214922149,130426.23325525953,404.9854125575109,130831.21866781704,2154,3,789.6190476190476,38,4,22,36.01153122058361,0.620888157894737,44.63141025641025,1021.4743589743576,26.880904183535726,0
2200,4,0,0,42,0.0,0.0,1.0,42,1200,1000,200,0.8333333333333334,14,10,4,338.93685294634435,0.3952163182346109,0.20011699400094618,0.19447696451300434,130535.38795976691,448.6507186427018,130984.03867840962,2155,4,790.6190476190476,38,4,13,35.86556891444503,0.621984649122807,44.52457264957265,1021.9017094017089,26.892150247413394,0
2201,4,0,0,42,0.0,0.0,1.0,42,900,600,300,0.6666666666666666,12,6,6,341.7389719934305,0.3949017615176152,0.20598336543774054,0.19636136606973864,130589.98243343191,525.5372698882319,131115.51970332014,2156,5,791.6190476190476,38,4,14,35.738737326225575,0.6225328947368421,44.47115384615385,1022.1153846153843,26.89777327935222,0
2202,4,1,1,42,0.023255813953488372,0.023255813953488372,0.9767441860465116,43,1100,800,300,0.7272727272727273,14,8,6,332.9345669450073,0.39587947582133626,0.20165139004620825,0.19285077745682505,130901.38888888899,116.31944444445307,131017.70833333344,2157,0,774.1860465116279,39,4,15,35.64909066232356,0.6239316239316239,44.16666666666667,1023.3333333333342,26.23931623931626,0
2203,4,0,0,42,0.0,0.0,1.0,42,1050,800,250,0.7619047619047619,13,8,5,342.45815548508074,0.39479287650019357,0.2082624568523881,0.1977499626425912,130781.152978669,557.4144842574326,131338.56746292644,2158,7,793.6190476190476,38,4,15,35.52699150476987,0.6244517543859649,44.284188034188034,1022.8632478632478,26.9174538911381,0
2204,4,1,1,42,0.023255813953488372,0.023255813953488372,0.9767441860465116,43,800,500,300,0.625,11,5,6,334.5541306732246,0.39837117017349577,0.20074726928234,0.19476036827233312,131093.85456945281,171.59811041709023,131265.4526798699,2159,0,776.1395348837209,40,3,17,35.41335880387682,0.6242187499999999,43.97865853658537,1024.0853658536594,25.602134146341484,0
2205,4,1,1,42,0.023255813953488372,0.023255813953488372,0.9767441860465116,43,1000,600,400,0.6,14,6,8,339.1515924660681,0.3984403839055002,0.2059596339418157,0.19797262325711834,131197.94894118916,299.19866233724326,131497.1476035264,2160,0,777.1162790697674,40,3,18,35.19058129153855,0.6252604166666667,43.87703252032521,1024.4918699186996,25.61229674796749,0
2206,4,0,0,42,0.0,0.0,1.0,42,1000,600,400,0.6,14,6,8,348.2462114956143,0.39311120789779325,0.22127797631153312,0.20312296819975548,131168.01757812526,735.7530381944737,131903.77061631973,2161,10,796.6190476190476,39,3,20,34.9878821774795,0.6266025641025641,43.906250000000014,1024.375000000002,26.266025641025692,0
2207,4,1,1,42,0.023255813953488372,0.023255813953488372,0.9767441860465116,43,1050,900,150,0.8571428571428571,12,9,3,343.89184439583937,0.3968484680693983,0.21876794336619376,0.20214438544737678,131465.0463533677,442.1467653088311,131907.19311867654,2162,0,779.0697674418604,38,5,20,34.79963190610134,0.6313048245614035,43.616452991452995,1025.5341880341884,26.98774179037338,0
2208,4,2,3,41,0.045454545454545456,0.06818181818181818,0.9318181818181819,44,1200,900,300,0.75,15,9,6,336.0205756150838,0.39905963706835795,0.2028669058444854,0.1991674572361927,131782.29302300364,56.312391493078906,131838.60541449673,2163,0,762.3181818181819,39,5,13,34.68188850563052,0.6327457264957264,43.30729166666668,1026.7708333333348,26.327457264957303,0
2209,4,0,0,41,0.0,0.0,1.0,41,500,300,200,0.6,7,3,4,349.87810562922886,0.3934705284552846,0.20325290176883382,0.2056825846606019,131468.6505102531,999.6004780316973,132468.2509882848,2164,13,781.170731707317,37,4,20,34.64251666132079,0.6331644144144144,43.612938596491226,1025.5482456140346,27.717520151730664,0
2210,4,0,0,41,0.0,0.0,1.0,41,900,500,400,0.5555555555555556,13,5,8,352.00315181187193,0.3928861788617886,0.20471956563105165,0.20754212296809613,131581.1250216412,1063.394145313931,132644.51916695514,2165,14,782.170731707317,37,4,15,34.474524420220135,0.6342905405405406,43.503289473684205,1025.9868421052627,27.729374110953046,0
2211,4,0,0,41,0.0,0.0,1.0,41,850,500,350,0.5882352941176471,12,5,7,350.82940161678516,0.3927845528455285,0.1969977230214519,0.207614719212158,131721.78578985823,1042.3750577100498,132764.16084756827,2166,15,783.170731707317,37,4,17,34.36276080609558,0.6356981981981983,43.36622807017543,1026.5350877192968,27.744191559980994,0
2212,4,0,1,40,0.0,0.024390243902439025,0.975609756097561,41,1400,800,600,0.5714285714285714,20,8,12,350.51278367551714,0.3930640243902439,0.201276790735456,0.20835049222539612,131890.67790089245,1045.8737303785601,132936.55163127102,2167,16,784.170731707317,37,4,18,34.20064759464843,0.6373873873873874,43.201754385964904,1027.1929824561394,27.76197249881458,0
2213,4,0,0,40,0.0,0.0,1.0,40,700,400,300,0.5714285714285714,10,4,6,355.17023675207025,0.39395032051282053,0.20239282973358175,0.21104284882186541,131876.9799148812,1367.755635703279,133244.73555058448,2168,17,789.425,36,4,18,34.09485436538391,0.6391782407407407,43.215090090090094,1027.1396396396403,28.531656656656676,0
2214,4,0,0,40,0.0,0.0,1.0,40,1000,700,300,0.7,13,7,6,353.24188476523256,0.3935096153846154,0.19535291538798738,0.21037721648811897,131963.74584043512,1323.024460271089,133286.7703007062,2169,18,790.425,36,4,18,34.05692861318134,0.6400462962962963,43.130630630630634,1027.4774774774783,28.541041041041062,0
2215,4,0,1,39,0.0,0.025,0.975,40,1000,800,200,0.8,12,8,4,351.25454535761503,0.39340277777777777,0.18789173789173752,0.2095130052897774,132021.605642805,1274.637813489163,133296.24345629415,2170,19,791.425,36,4,19,34.04969318430856,0.640625,43.07432432432432,1027.702702702703,28.547297297297305,0
2216,4,0,0,39,0.0,0.0,1.0,39,1050,500,550,0.47619047619047616,16,5,11,360.87167626972325,0.3912505623031939,0.18242277816745922,0.21586687544134342,132130.12695312488,1736.4040798610963,133866.53103298598,2171,20,784.974358974359,35,4,19,33.69322019587977,0.64375,42.96874999999999,1028.124999999999,29.374999999999975,0
2217,4,0,0,39,0.0,0.0,1.0,39,950,700,250,0.7368421052631579,12,7,5,361.9761407018133,0.39060391363022945,0.18104808810333783,0.21721012575401846,132249.14969403707,1774.2073634687783,134023.35705750584,2172,21,785.974358974359,35,4,19,33.54490172911743,0.6449404761904762,42.85300925925925,1028.587962962962,29.388227513227484,0
2218,4,0,0,39,0.0,0.0,1.0,39,1100,700,400,0.6363636363636364,15,7,8,366.01157206313843,0.38973234367971205,0.18955673206685408,0.22049965438925645,132398.00347222213,1891.9240022719387,134289.92747449406,2173,22,786.974358974359,34,5,20,33.29116059379218,0.6485906862745099,42.70833333333333,1029.1666666666658,30.26960784313723,0
2219,4,0,0,39,0.0,0.0,1.0,39,1000,700,300,0.7,13,7,6,370.4564901234841,0.38886077372919475,0.18222882192365542,0.224270055707366,132581.84700963713,2023.1611394557824,134605.0081490929,2174,23,787.974358974359,34,5,20,32.991609833159956,0.6504289215686274,42.529761904761905,1029.880952380952,30.29061624649859,0
2220,4,0,0,39,0.0,0.0,1.0,39,1250,1000,250,0.8,15,10,5,373.6141588452957,0.38863585245164195,0.1888478126925448,0.2271070336351741,132735.1473922902,2118.3460884353717,134853.4934807256,2175,24,788.974358974359,34,5,15,32.75594000308071,0.6519607843137255,42.38095238095238,1030.4761904761904,30.308123249299715,0
2221,4,0,0,39,0.0,0.0,1.0,39,1000,700,300,0.7,13,7,6,373.91144920219824,0.38782051282051283,0.19836046645883876,0.22822037079212373,132888.53635204065,2137.709041950093,135026.24539399074,2176,25,789.974358974359,34,5,15,32.59390755493977,0.6534926470588236,42.23214285714285,1031.0714285714273,30.325630252100805,0
2222,4,0,0,39,0.0,0.0,1.0,39,1100,700,400,0.6363636363636364,15,7,8,370.52780264196457,0.3869770580296896,0.20041598701982433,0.22697692817510837,133024.10361207544,2057.825761959859,135081.9293740353,2177,26,790.974358974359,35,4,15,32.544808145405575,0.6526785714285714,42.100694444444436,1031.597222222221,29.474206349206316,0
2223,4,0,0,39,0.0,0.0,1.0,39,1250,800,450,0.64,17,8,9,369.1568300187016,0.3862460638776428,0.20809474531447658,0.22740876545350933,133233.13185871037,2036.7841220850291,135269.9159807954,2178,27,791.974358974359,35,4,17,32.37014200298953,0.6547619047619049,41.89814814814814,1032.407407407406,29.497354497354458,0
2224,4,0,0,39,0.0,0.0,1.0,39,1150,900,250,0.782608695652174,14,9,5,367.2042625578433,0.38554318488529016,0.2042664184721099,0.22729994782186574,133412.4295374655,1997.9225608710294,135410.35209833653,2179,28,792.974358974359,35,4,18,32.24055194562702,0.6565476190476192,41.724537037037024,1033.1018518518501,29.51719576719572,0
2225,4,0,0,39,0.0,0.0,1.0,39,900,700,200,0.7777777777777778,11,7,4,370.3565899687478,0.3848684210526316,0.20489104160395555,0.2298173011925278,133503.8825962371,2088.8353330242257,135592.71792926133,2180,29,793.974358974359,33,6,18,32.06734949998024,0.6619318181818181,41.63602941176471,1033.4558823529417,31.31684491978611,0
2226,4,0,0,39,0.0,0.0,1.0,39,500,300,200,0.6,7,3,4,370.54498535369976,0.3846434997750787,0.2079002079002079,0.2305248891182752,133598.88624567477,2100.8794694348376,135699.76571510962,2181,30,794.974358974359,33,6,18,31.967164532954,0.6628787878787878,41.544117647058826,1033.823529411765,31.327985739750456,0
2227,4,0,0,39,0.0,0.0,1.0,39,750,500,250,0.6666666666666666,10,5,5,370.54498535369976,0.3846434997750787,0.2079002079002079,0.2305248891182752,133598.88624567477,2100.8794694348376,135699.76571510962,2182,31,795.974358974359,33,6,18,31.967164532954,0.6628787878787878,41.544117647058826,1033.823529411765,31.327985739750456,0
2228,4,0,0,39,0.0,0.0,1.0,39,850,500,350,0.5882352941176471,12,5,7,372.1037541999691,0.3843623481781377,0.2113827068194738,0.2316929427442906,133630.56163795164,2144.8867322664255,135775.44837021807,2183,32,796.974358974359,33,6,18,31.895099956540633,0.6631944444444444,41.51348039215686,1033.9460784313717,31.331699346405202,0
2229,4,0,0,39,0.0,0.0,1.0,39,750,400,350,0.5333333333333333,11,4,7,370.87441881359354,0.3848403058929375,0.21066958318143159,0.2315221963599653,133725.6103421762,2119.0816032295425,135844.69194540574,2184,33,797.974358974359,33,6,16,31.83155608214851,0.6641414141414141,41.42156862745099,1034.313725490197,31.342840166369605,0
2230,4,0,1,38,0.0,0.02564102564102564,0.9743589743589743,39,1000,700,300,0.7,13,7,6,372.80171107645384,0.3840249662618083,0.21759794944681832,0.23332578551656796,133820.6928374905,2177.7166534506073,135998.4094909411,2185,34,798.974358974359,33,6,16,31.686382210114893,0.6650883838383839,41.329656862745104,1034.6813725490204,31.35398098633395,0
2231,4,1,0,39,0.02564102564102564,0.0,1.0,39,1150,800,350,0.6956521739130435,15,8,7,370.0369034697665,0.3848403058929375,0.21902594446973156,0.2329964109030944,134042.68340301808,2120.1478998462167,136162.8313028643,2186,0,798.4358974358975,33,6,17,31.53550295857989,0.6672979797979798,41.115196078431374,1035.5392156862747,31.379976232917414,0
2232,4,0,0,39,0.0,0.0,1.0,39,1150,800,350,0.6956521739130435,15,8,7,370.7775856375935,0.3846434997750787,0.22207685825244994,0.23414416184458206,134149.66695011346,2147.937925170077,136297.60487528355,2187,1,799.4358974358975,34,5,18,31.40920669577875,0.6660539215686274,41.011904761904766,1035.9523809523816,30.46918767507005,0
2233,4,1,0,40,0.025,0.0,1.0,40,1200,1000,200,0.8333333333333334,14,10,4,364.4929846938773,0.3853632478632478,0.21770089285714267,0.23195008116883117,134430.72702331975,1799.811385459548,136230.5384087793,2188,0,780.425,35,5,19,31.290922619047624,0.6666666666666665,40.74074074074075,1037.037037037038,29.629629629629658,0
2234,4,0,0,40,0.0,0.0,1.0,40,1150,700,450,0.6086956521739131,16,7,9,366.28441476750345,0.38505608974358974,0.2179718875502008,0.2338585109669448,134550.78125000015,1856.7708333333485,136407.5520833335,2189,1,781.425,35,5,19,31.12449799196787,0.6678571428571427,40.62500000000001,1037.5000000000011,29.642857142857174,0
2235,4,1,1,40,0.024390243902439025,0.024390243902439025,0.975609756097561,41,950,700,250,0.7368421052631579,12,7,5,357.88841545368757,0.3876016260162602,0.20796921872962026,0.23077632306841234,134911.2654320988,1456.6358024691385,136367.90123456792,2190,0,763.3414634146342,35,6,16,30.982620320855602,0.6714285714285715,40.27777777777778,1038.8888888888891,29.68253968253969,0
2236,4,0,0,40,0.0,0.0,1.0,40,1150,1000,150,0.8695652173913043,13,10,3,363.43586797173106,0.38551014957264956,0.2111958266452647,0.2334232430375139,134767.01388888896,1795.8333333333446,136562.8472222223,2191,3,783.425,34,6,19,30.982477260567148,0.6721813725490196,40.41666666666667,1038.333333333334,30.539215686274527,0
2237,4,0,0,40,0.0,0.0,1.0,40,550,300,250,0.5454545454545454,8,3,5,363.08378646234274,0.3857104700854701,0.21085922274446856,0.2333957162351523,134797.9184382087,1788.587726757379,136586.50616496606,2192,4,784.425,34,6,16,30.96077419847911,0.6724877450980392,40.386904761904766,1038.4523809523816,30.542717086834756,0
2238,4,0,0,40,0.0,0.0,1.0,40,1050,700,350,0.6666666666666666,14,7,7,361.9041301564488,0.38544337606837603,0.21412570184484947,0.2334321761918204,134921.5720663266,1765.7348356009138,136687.3069019275,2193,5,785.425,34,6,16,30.86804361941865,0.6737132352941175,40.267857142857146,1038.928571428572,30.55672268907565,0
2239,4,0,0,40,0.0,0.0,1.0,40,1150,700,450,0.6086956521739131,16,7,9,328.83103733916323,0.3852297008547008,0.1324991813120835,0.20149974134207857,133036.20501836296,749.2866599707793,133785.49167833375,2194,6,786.425,36,4,17,33.60804861186915,0.6507523148148149,42.08896396396396,1031.6441441441443,28.65678178178179,7
2240,4,0,0,40,0.0,0.0,1.0,40,800,500,300,0.625,11,5,6,328.15654215016116,0.38474893162393164,0.12677343664738672,0.20139975858820658,133094.2994303424,735.1530161918554,133829.45244653424,2195,7,787.425,36,4,18,33.56729055258467,0.6513310185185186,42.03265765765765,1031.8693693693683,28.66303803803801,0
2241,4,0,0,40,0.0,0.0,1.0,40,1050,600,450,0.5714285714285714,15,6,9,328.0983389629836,0.384107905982906,0.12892253136933984,0.2016781540305664,133152.40652392263,737.416681884594,133889.82320580722,2196,8,788.425,36,4,20,33.51063829787234,0.6519097222222222,41.976351351351354,1032.094594594595,28.669294294294307,0
2242,4,0,0,40,0.0,0.0,1.0,40,850,500,350,0.5882352941176471,12,5,7,329.9589050317545,0.38336004273504276,0.1328869859277848,0.2031385683294892,133210.5262991031,790.7998792711595,134001.32617837426,2197,9,789.425,36,4,21,33.404467110286895,0.6524884259259259,41.92004504504504,1032.3198198198195,28.67555055055054,0
2243,4,0,0,40,0.0,0.0,1.0,40,1200,700,500,0.5833333333333334,17,7,10,330.22350485336386,0.38356036324786325,0.1339605148342069,0.2034602884741692,133239.59094229352,799.7689412385271,134039.35988353204,2198,10,790.425,36,4,21,33.368555482838865,0.6527777777777779,41.89189189189189,1032.4324324324314,28.67867867867865,0
2244,4,0,0,40,0.0,0.0,1.0,40,1050,700,350,0.6666666666666666,14,7,7,330.3656850154571,0.3834001068376069,0.13199875853507193,0.20391537109574745,133306.67529585786,807.9902202498279,134114.6655161077,2199,11,791.425,38,2,21,33.297770535899026,0.649671052631579,41.82692307692307,1032.6923076923067,27.17611336032386,0
2245,4,1,1,40,0.024390243902439025,0.024390243902439025,0.975609756097561,41,700,400,300,0.5714285714285714,10,4,6,324.06549013208416,0.38622967479674797,0.12693983101975448,0.2010783639582241,133501.31539901387,452.942027016212,133954.2574260301,2200,0,773.0975609756098,36,5,21,33.26590933856378,0.6553819444444444,41.63851351351351,1033.4459459459458,28.706831831831828,0
2246,4,0,0,40,0.0,0.0,1.0,40,1050,800,250,0.7619047619047619,13,8,5,340.93993309549427,0.38303952991452994,0.14287974683544347,0.19846292947558777,131090.963648834,938.8288751714673,132029.79252400546,2201,13,793.425,35,5,19,35.252787823990346,0.6333333333333333,43.98148148148148,1024.074074074074,29.259259259259256,3
2247,4,0,0,40,0.0,0.0,1.0,40,850,600,250,0.7058823529411765,11,6,5,344.5549908319652,0.3831063034188034,0.1380321852060984,0.2016546228563816,131298.46810967516,1047.9084951560474,132346.3766048312,2202,14,794.425,35,5,19,34.95071052136271,0.6354166666666665,43.77893518518519,1024.88425925926,29.28240740740743,0
2248,4,0,0,40,0.0,0.0,1.0,40,1050,800,250,0.7619047619047619,13,8,5,344.6423870960666,0.3831196581196581,0.1389340344168264,0.20252580724858765,131453.76778162262,1060.9147621656332,132514.68254378825,2203,15,795.425,33,7,19,34.79176625239008,0.6414141414141413,43.62745098039217,1025.4901960784327,31.075460487225236,0
2249,4,0,0,40,0.0,0.0,1.0,40,1200,1000,200,0.8333333333333334,14,10,4,340.58993340197304,0.38279914529914527,0.13273916967509014,0.20073066287733332,131565.50068587132,961.9770233196464,132527.47770919095,2204,16,796.425,35,5,13,34.7830174488568,0.6380952380952379,43.51851851851853,1025.925925925928,29.31216931216937,0
2250,4,1,0,41,0.024390243902439025,0.0,1.0,41,900,400,500,0.4444444444444444,14,4,10,332.5212316602028,0.3877794715447154,0.12947359416601656,0.19803679619240813,131963.74584043518,576.1494602711044,132539.8953007063,2205,0,777.9756097560976,36,5,17,34.58917872278242,0.6400462962962962,43.13063063063064,1027.4774774774787,28.541041041041076,0
2251,4,0,0,41,0.0,0.0,1.0,41,1300,1000,300,0.7692307692307693,16,10,6,332.0131519746031,0.38780487804878044,0.12424039255177344,0.19879423545443298,132166.3106307322,576.1906754727863,132742.50130620497,2206,1,778.9756097560976,36,5,18,34.39861460957178,0.6420717592592593,42.933558558558566,1028.2657657657667,28.562937937937964,0
2252,4,0,0,41,0.0,0.0,1.0,41,550,300,250,0.5454545454545454,8,3,5,355.51522375397155,0.38780487804878044,0.11044539845785306,0.20197952822066298,130150.67737188366,1060.7324033905156,131211.40977527417,2207,2,779.9756097560976,37,4,19,35.83216920982879,0.6199324324324323,44.901315789473685,1020.3947368421054,27.578236130867715,8
2253,4,1,1,41,0.023809523809523808,0.023809523809523808,0.9761904761904762,42,1100,800,300,0.7272727272727273,14,8,6,343.2964855915217,0.39360723964382505,0.10448329627073605,0.1963048964570302,130402.54122662733,553.3949147814625,130955.93614140879,2208,0,762.3809523809524,37,5,19,35.88868760064412,0.6224662162162162,44.65460526315789,1021.3815789473678,27.60490753911805,0
2254,4,0,0,41,0.0,0.0,1.0,41,1100,1000,100,0.9090909090909091,12,10,2,350.23159574595974,0.3882876016260162,0.10714381796366035,0.19969809100835686,130291.32806793292,926.4279482185084,131217.75601615143,2209,4,781.9756097560976,36,5,20,35.82432531803811,0.6232638888888888,44.76351351351352,1020.9459459459468,28.359609609609635,0
2255,4,0,0,41,0.0,0.0,1.0,41,900,500,400,0.5555555555555556,13,5,8,351.1407579928892,0.38755081300813005,0.11199771938175895,0.20066134431238272,130377.57087746545,956.17581263698,131333.74669010242,2210,5,782.9756097560976,36,5,21,35.71369500496197,0.6241319444444444,44.67905405405406,1021.283783783785,28.368993993994028,0
2256,4,0,0,41,0.0,0.0,1.0,41,1250,800,450,0.64,17,8,9,349.78261302397124,0.38722052845528454,0.11349138290236649,0.20047868906926694,130492.60567577739,928.808918716041,131421.41459449343,2211,6,783.9756097560976,36,5,16,35.631819684779,0.6252893518518517,44.566441441441455,1021.7342342342363,28.381506506506565,0
2257,4,0,0,41,0.0,0.0,1.0,41,700,500,200,0.7142857142857143,9,5,4,348.50241659432965,0.38666158536585366,0.1129701490932935,0.20019037550697083,130578.91506371259,901.4134911939241,131480.3285549065,2212,7,784.9756097560976,36,5,16,35.577117305714715,0.6261574074074073,44.481981981981995,1022.0720720720739,28.39089089089094,0
2258,4,0,0,41,0.0,0.0,1.0,41,1350,1100,250,0.8148148148148148,16,11,5,345.302632484759,0.386255081300813,0.10812712686096182,0.19909163210121278,130722.82745160727,827.7872889781991,131550.61474058547,2213,8,785.9756097560976,36,5,17,35.51325111037699,0.6276041666666665,44.34121621621623,1022.6351351351371,28.406531531531588,0
2259,4,0,0,41,0.0,0.0,1.0,41,1650,1400,250,0.8484848484848485,19,14,5,345.1960911192284,0.3860772357723577,0.1154067098672309,0.19977399260568884,130866.81909950518,834.9428820712963,131701.76198157648,2214,9,786.9756097560976,36,5,18,35.37034998899408,0.6290509259259258,44.20045045045047,1023.1981981982004,28.422172172172235,0
2260,4,1,0,42,0.023809523809523808,0.0,1.0,42,1000,700,300,0.7,13,7,6,336.3334115377097,0.3889493805652342,0.11202787506181133,0.19598817200085786,131131.51552641226,420.7819954216974,131552.29752183394,2215,0,769.2142857142857,37,5,19,35.32979606037898,0.6297860360360359,43.941885964912295,1024.2324561403532,27.6819582740636,0
2261,4,0,0,42,0.0,0.0,1.0,42,1200,1000,200,0.8333333333333334,14,10,4,335.98191478825413,0.3885622338366241,0.11775029686707161,0.19693775726448676,131356.98356718212,426.8614528363425,131783.84502001846,2216,1,770.2142857142857,36,6,20,35.11136438536745,0.6339699074074073,43.72184684684685,1025.1126126126132,28.475350350350368,0
2262,4,1,1,42,0.023255813953488372,0.023255813953488372,0.9767441860465116,43,1050,800,250,0.7619047619047619,13,8,5,327.9236892198273,0.39264950166112955,0.11438768637334085,0.1933447989936941,131581.1250216414,29.71358975840468,131610.8386113998,2217,0,753.2790697674419,37,6,12,35.092154714830244,0.6342905405405403,43.50328947368422,1025.9868421052643,27.72937411095309,0
2263,4,0,0,42,0.0,0.0,1.0,42,1250,900,350,0.72,16,9,7,335.86760272330514,0.38813879210220675,0.11726478030825871,0.1976151243930147,131501.32395909447,433.4068866163741,131934.73084571084,2218,3,772.2142857142857,36,6,21,34.96880032206119,0.6354166666666665,43.581081081081095,1025.6756756756777,28.490990990991047,0
2264,4,0,0,42,0.0,0.0,1.0,42,700,600,100,0.8571428571428571,8,6,2,334.0353574638743,0.3877758420441347,0.11442111151190049,0.19668571888419112,131530.2015486773,387.1475783215884,131917.3491269989,2219,4,773.2142857142857,36,6,21,34.98668898891204,0.6357060185185184,43.55292792792794,1025.7882882882902,28.494119119119173,0
2265,4,1,1,42,0.023255813953488372,0.023255813953488372,0.9767441860465116,43,750,500,250,0.6666666666666666,10,5,5,328.4838157319754,0.39096530084902176,0.11367412061237392,0.1948227317498389,131806.2183195794,59.24190616347016,131865.46022574286,2220,0,756.2093023255813,37,6,13,34.85128581598151,0.6365427927927926,43.28399122807019,1026.8640350877217,27.753082029397884,0
2266,4,1,0,43,0.023255813953488372,0.0,1.0,43,850,600,250,0.7058823529411765,11,6,5,332.3113020378681,0.38875046142488,0.12040113859432733,0.1979713421104173,131975.16453379902,171.3677525777351,132146.53228637675,2221,0,757.1860465116279,37,6,15,34.583088784548075,0.6382319819819818,43.11951754385966,1027.5219298245627,27.770862968231423,0
2267,4,0,1,42,0.0,0.023255813953488372,0.9767441860465116,43,1450,1000,450,0.6896551724137931,19,10,9,338.44018851196597,0.3888888888888889,0.11689902642007266,0.20267510139624645,132172.40521121895,346.49074715298786,132518.89595837196,2222,1,758.1860465116279,37,6,15,34.227269495983506,0.6402027027027026,42.92763157894738,1028.2894736842115,27.79160739687058,0
2268,4,0,0,42,0.0,0.0,1.0,42,1100,800,300,0.7272727272727273,14,8,6,343.83537802103916,0.3862756484707704,0.12167602776517517,0.2058728417514827,132166.3106307322,688.6906754727866,132855.00130620497,2223,2,777.0714285714286,36,6,17,34.09470485160443,0.6420717592592592,42.933558558558566,1028.2657657657667,28.562937937937964,0
2269,4,1,1,42,0.023255813953488372,0.023255813953488372,0.9767441860465116,43,1200,1000,200,0.8333333333333334,14,10,4,335.38872582583576,0.3886812476928756,0.11254897969568955,0.20220665923800407,132426.9793442092,283.1060790520404,132710.08542326122,2224,0,759.9767441860465,36,7,17,34.04996353026988,0.6446759259259258,42.68018018018019,1029.2792792792802,28.591091091091116,0
2270,4,0,0,42,0.0,0.0,1.0,42,1050,700,350,0.6666666666666666,14,7,7,342.6628050326509,0.3860941734417344,0.11653494144699783,0.2056634532316892,132256.9820161013,663.9096885580428,132920.89170465936,2225,4,779.0714285714286,37,5,17,34.033662900188325,0.6410472972972971,42.84539473684212,1028.6184210526333,27.800497866287387,0
2271,4,0,1,41,0.0,0.023809523809523808,0.9761904761904762,42,850,700,150,0.8235294117647058,10,7,3,343.13282312399,0.3859247967479675,0.1081335464393538,0.2065619977561673,132369.793169533,684.0841653201028,133053.87733485308,2226,5,780.0714285714286,37,5,18,33.90816462440065,0.6421734234234234,42.73574561403509,1029.05701754386,27.81235182550973,0
2272,4,0,0,41,0.0,0.0,1.0,41,900,700,200,0.7777777777777778,11,7,4,344.2525789372565,0.38536585365853654,0.09406674775409152,0.20819084535729335,132542.91453615788,925.6510355190873,133468.56557167697,2227,6,753.9512195121952,36,5,20,33.705389690871975,0.6458333333333334,42.56756756756757,1029.7297297297305,28.603603603603624,0
2273,4,0,0,41,0.0,0.0,1.0,41,1400,1100,300,0.7857142857142857,17,11,6,344.74580676628625,0.38419715447154473,0.09667609297664437,0.2096191945327762,132745.92318247288,952.7200764954056,133698.64325896828,2228,7,754.9512195121952,36,5,12,33.488826357775125,0.6478587962962964,42.37049549549549,1030.518018018017,28.625500500500475,0
2274,4,0,0,41,0.0,0.0,1.0,41,600,300,300,0.5,9,3,6,343.8458462974961,0.3838160569105691,0.09420305304451615,0.20923385540656142,132774.93709926133,930.8221227984599,133705.75922205977,2229,8,755.9512195121952,36,5,12,33.48289080710955,0.6481481481481483,42.342342342342334,1030.6306306306299,28.628628628628608,0
2275,4,0,0,41,0.0,0.0,1.0,41,1300,1100,200,0.8461538461538461,15,11,4,341.420543876756,0.3836636178861788,0.08856149511795564,0.2082415109388206,132861.99787202725,872.3631148039779,133734.36098683122,2230,9,756.9512195121952,36,5,12,33.45803750227563,0.6490162037037038,42.257882882882875,1030.968468468467,28.638013013012976,0
2276,4,0,0,41,0.0,0.0,1.0,41,850,600,250,0.7058823529411765,11,6,5,341.5462947237497,0.38295223577235776,0.0895187726852702,0.20896609975783695,132978.12328798376,883.6370576657528,133861.76034564953,2231,10,757.9512195121952,36,5,12,33.33833751865197,0.6501736111111112,42.14527027027026,1031.4189189189176,28.650525525525488,0
2277,4,0,0,41,0.0,0.0,1.0,41,550,400,150,0.7272727272727273,7,4,3,340.57607597109165,0.3829776422764228,0.09217169027585492,0.20853454919085523,133007.1625679731,859.811500689853,133866.97406866297,2232,11,758.9512195121952,36,5,12,33.334243085880644,0.6504629629629631,42.117117117117104,1031.5315315315295,28.653653653653596,0
2278,4,0,2,39,0.0,0.04878048780487805,0.9512195121951219,41,1250,1000,250,0.8,15,10,5,340.81090178872,0.3828506097560975,0.0914454512793903,0.20949241548582276,133152.4065239225,875.9583485512463,134028.36487247373,2233,12,759.9512195121952,36,5,14,33.18262411347518,0.6519097222222223,41.97635135135135,1032.094594594594,28.669294294294275,0
2279,4,0,0,39,0.0,0.0,1.0,39,900,700,200,0.7777777777777778,11,7,4,357.9075396890626,0.38008884390463343,0.09784504069228728,0.2184522340554593,132888.53635204062,1712.3618197278706,134600.8981717685,2234,29,792.4358974358975,34,5,14,33.006436901050684,0.6534926470588236,42.23214285714285,1031.071428571427,30.325630252100797,0
2280,4,1,0,40,0.025,0.0,1.0,40,950,700,250,0.7368421052631579,12,7,5,349.6108910293795,0.3824919871794872,0.10325112107623302,0.21536803508163394,133233.13185871026,1315.9507887516804,134549.08264746194,2235,0,773.6,35,5,16,32.87462630792227,0.6547619047619049,41.89814814814813,1032.4074074074051,29.497354497354433,0
2281,4,0,0,40,0.0,0.0,1.0,40,850,500,350,0.5882352941176471,12,5,7,351.42975102319605,0.3823851495726496,0.100221387736801,0.2166623917676519,133263.00643271997,1366.51703425064,134629.5234669706,2236,1,774.6,35,5,16,32.79772914097822,0.655059523809524,41.86921296296294,1032.523148148145,29.500661375661288,0
2282,4,0,0,40,0.0,0.0,1.0,40,950,700,250,0.7368421052631579,12,7,5,353.2151653581679,0.3811832264957265,0.09294756889984335,0.21864067725291267,133412.4295374654,1424.6586719821262,134837.0882094475,2237,2,775.6,35,5,17,32.60185600119502,0.6565476190476192,41.72453703703702,1033.1018518518492,29.51719576719569,0
2283,4,0,0,40,0.0,0.0,1.0,40,950,600,350,0.631578947368421,13,6,7,355.7971740382777,0.3809294871794872,0.09024017970279963,0.2207773601019505,133502.97796201808,1500.0098528351616,135002.98781485323,2238,3,776.6,34,6,17,32.4444188457551,0.6596200980392157,41.63690476190476,1033.4523809523805,30.395658263305307,0
2284,4,0,1,39,0.0,0.025,0.975,40,1450,1200,250,0.8275862068965517,17,12,5,356.83921141769406,0.38108974358974357,0.0898738915121502,0.22179204529275845,133564.5000708616,1532.2101757369553,135096.71024659855,2239,4,777.6,34,6,17,32.355848593036185,0.6602328431372548,41.57738095238095,1033.6904761904757,30.402661064425757,0
2285,4,0,0,39,0.0,0.0,1.0,39,1000,800,200,0.8,12,8,4,363.87877211238293,0.3783175888439046,0.0949131513647643,0.22560483870967754,133472.22222222228,1913.5416666666779,135385.76388888896,2240,5,796.2051282051282,33,6,18,32.26646505376344,0.6616161616161615,41.66666666666667,1033.333333333334,31.313131313131333,0
2286,4,0,0,39,0.0,0.0,1.0,39,1000,900,100,0.9,11,9,2,364.95322605808406,0.3782613585245164,0.08915922935259979,0.2277811514362525,133718.3673469388,1960.1899092970564,135678.55725623586,2241,6,797.2051282051282,34,5,15,31.991923726212402,0.6617647058823529,41.42857142857143,1034.2857142857144,30.420168067226896,0
2287,4,0,0,39,0.0,0.0,1.0,39,1000,700,300,0.7,13,7,6,366.13021978955254,0.3778115159694107,0.09278682043611286,0.22908839022253444,133810.73022959198,1998.4304138322168,135809.1606434242,2242,7,798.2051282051282,34,5,16,31.868935297050594,0.6626838235294117,41.33928571428572,1034.6428571428582,30.430672268907596,0
2288,4,0,0,39,0.0,0.0,1.0,39,950,700,250,0.7368421052631579,12,7,5,364.53898504722525,0.3777271704903284,0.08640391619115051,0.22885678519751815,133933.93034297062,1964.8278061224628,135898.75814909308,2243,8,799.2051282051282,34,5,16,31.78670691968565,0.6639093137254901,41.2202380952381,1035.1190476190484,30.444677871148482,0
2289,4,0,0,39,0.0,0.0,1.0,39,1300,700,600,0.5384615384615384,19,7,12,364.8666389162068,0.37761470985155193,0.08817234731237922,0.229638930918464,134026.36763038576,1980.350056689368,136006.71768707514,2244,9,800.2051282051282,34,5,17,31.685684448532214,0.6648284313725489,41.130952380952394,1035.4761904761926,30.455182072829196,0
2290,4,0,0,39,0.0,0.0,1.0,39,1700,1300,400,0.7647058823529411,21,13,8,366.08398891561245,0.3766025641025641,0.09551672426543201,0.23137465181790665,134180.50063775512,2024.2665816326614,136204.76721938778,2245,10,801.2051282051282,34,5,17,31.49991382281972,0.666360294117647,40.98214285714286,1036.071428571429,30.47268907563026,0
2291,4,0,1,38,0.0,0.02564102564102564,0.9743589743589743,39,850,500,350,0.5882352941176471,12,5,7,366.7378335625148,0.37657444894287,0.09769972792480841,0.23276625762845343,134334.72222222236,2053.1250000000196,136387.8472222224,2246,11,802.2051282051282,34,5,19,31.328711146838153,0.667892156862745,40.83333333333334,1036.6666666666679,30.49019607843141,0
2292,4,0,0,38,0.0,0.0,1.0,38,750,600,150,0.8,9,6,3,382.690742193172,0.3751185395922238,0.09937026297121387,0.24263855303372212,134296.61218041158,2678.8140378700746,136975.42621828165,2247,12,822.7894736842105,33,5,19,30.953436588634034,0.6698232323232322,40.8700980392157,1036.5196078431388,31.409685086155722,0
2293,4,0,0,38,0.0,0.0,1.0,38,1450,1100,350,0.7586206896551724,18,11,7,382.7832143967468,0.3745258416311048,0.10091035717839025,0.24396665110346877,134487.21645520953,2695.8898019992334,137183.10625720877,2248,13,823.7894736842105,33,5,19,30.760180371770645,0.6717171717171717,40.68627450980392,1037.2549019607843,31.431966726084372,0
2294,4,0,0,38,0.0,0.0,1.0,38,850,600,250,0.7058823529411765,11,6,5,385.5998839672242,0.37400723091512567,0.10093987182435793,0.24640560132456552,134582.5692792438,2779.004619617484,137361.57389886127,2249,14,824.7894736842105,33,5,19,30.591684382504628,0.6726641414141413,40.59436274509805,1037.6225490196098,31.443107546048783,0
2295,4,0,0,38,0.0,0.0,1.0,38,950,500,450,0.5263157894736842,14,5,9,384.6141842795373,0.3732219061166429,0.09929923960041709,0.24685237645577585,134741.56574394472,2764.7034794309957,137506.2692233757,2250,15,825.7894736842105,33,5,19,30.45817595215611,0.6742424242424241,40.44117647058824,1038.2352941176478,31.46167557932266,0
2296,4,0,0,38,0.0,0.0,1.0,38,900,500,400,0.5555555555555556,13,5,8,385.0537503295561,0.3729403745851114,0.10417624187918428,0.24756794235907886,134805.190611784,2781.448841791624,137586.63945357563,2251,16,826.7894736842105,33,5,14,30.383132719691606,0.6748737373737373,40.379901960784316,1038.4803921568632,31.469102792632217,0
2297,4,0,0,38,0.0,0.0,1.0,38,1250,1000,250,0.8,15,10,5,383.3870105104642,0.3728811047889995,0.10526005351943013,0.24714613597697355,134900.6560727844,2743.831849529014,137644.4879223134,2252,17,827.7894736842105,33,5,16,30.330969092839453,0.6758207070707072,40.287990196078425,1038.8480392156855,31.48024361259653,0
2298,4,0,0,38,0.0,0.0,1.0,38,1100,700,400,0.6363636363636364,15,7,8,384.1687358129879,0.37243658131816026,0.10488464736469783,0.24874192497448566,135059.84026576314,2777.1536188004575,137836.9938845636,2253,18,828.7894736842105,33,5,16,30.151595535644102,0.6773989898989898,40.134803921568626,1039.4607843137253,31.498811645870465,0
2299,4,0,0,38,0.0,0.0,1.0,38,750,500,250,0.6666666666666666,10,5,5,380.02423077363807,0.3725403034613561,0.1034364048010421,0.2467104512711798,135155.39583633695,2672.4650675221,137827.86090385905,2254,19,829.7894736842105,33,5,16,30.163892162639947,0.6783459595959596,40.04289215686274,1039.8284313725487,31.50995246583481,0
2300,4,0,0,38,0.0,0.0,1.0,38,1000,800,200,0.8,12,8,4,379.0049904782422,0.3724069464201043,0.10401318048469,0.2465648996134327,135230.95415249432,2650.6412981859403,137881.59545068027,2255,20,830.7894736842105,34,4,17,30.114980351760718,0.6767769607843137,39.970238095238095,1040.1190476190475,30.591736694677866,0
2301,4,1,0,39,0.02564102564102564,0.0,1.0,39,750,400,350,0.5333333333333333,11,4,7,367.5424342541645,0.3770242914979757,0.10046630411236834,0.24099210922379496,135513.14407578885,2161.3661694101556,137674.510245199,2256,0,810.4615384615385,35,4,18,30.131910478731275,0.6773809523809524,39.699074074074076,1041.2037037037044,29.748677248677268,0
2302,4,0,0,39,0.0,0.0,1.0,39,1200,800,400,0.6666666666666666,16,8,8,365.802520144782,0.37601214574898784,0.09795270238597498,0.2410770825532477,135695.6916099771,2127.618776420008,137823.31038639712,2257,1,811.4615384615385,34,5,20,29.99552483241925,0.6813725490196079,39.52380952380951,1041.90476190476,30.64425770308118,0
2303,4,0,0,39,0.0,0.0,1.0,39,1200,800,400,0.6666666666666666,16,8,8,362.105427040492,0.37542172739541163,0.09662132739055806,0.24004472348843198,135905.0835503471,2042.3936631944257,137947.47721354154,2258,2,812.4615384615385,35,4,13,29.883658008657992,0.6812500000000001,39.32291666666666,1042.7083333333323,29.79166666666664,0
2304,4,0,0,39,0.0,0.0,1.0,39,700,400,300,0.5714285714285714,10,4,6,364.5557313703805,0.3757309941520468,0.09514019759008652,0.23585810286066364,135031.533993484,2045.3039266117698,137076.83792009574,2259,3,813.4615384615385,35,4,15,30.689495174461776,0.6726190476190477,40.162037037037024,1039.35185185185,29.69576719576714,2
2305,4,0,0,39,0.0,0.0,1.0,39,850,700,150,0.8235294117647058,10,7,3,395.73294854286354,0.3755623031938822,0.11516334765065706,0.23341134988905432,131595.18771701396,2643.6560946073437,134238.8438116213,2260,4,814.4615384615385,35,4,14,33.33862098138748,0.6383928571428571,43.489583333333336,1026.0416666666672,29.315476190476204,8
2306,4,0,0,39,0.0,0.0,1.0,39,750,500,250,0.6666666666666666,10,5,5,395.7740810378286,0.37542172739541163,0.11579818031430933,0.23361737699609786,131624.87809713656,2618.743034122094,134243.62113125867,2261,5,815.4615384615385,35,4,15,33.307485525227456,0.6386904761904761,43.46064814814815,1026.157407407408,29.318783068783087,0
2307,4,0,0,39,0.0,0.0,1.0,39,850,600,250,0.7058823529411765,11,6,5,398.47704452377775,0.3757309941520468,0.11333050007083156,0.2357633694383845,131713.9693313828,2696.9986443329817,134410.9679757158,2262,6,816.4615384615385,35,4,17,33.14787931747285,0.6395833333333334,43.37384259259259,1026.504629629629,29.328703703703688,0
2308,4,0,0,39,0.0,0.0,1.0,39,1050,900,150,0.8571428571428571,12,9,3,394.8501397954153,0.3756185335132704,0.1143917518621611,0.23398233734970786,131773.38023244584,2606.147521219121,134379.52775366497,2263,7,817.4615384615385,35,4,17,33.18079979709165,0.6401785714285715,43.315972222222214,1026.73611111111,29.335317460317427,0
2309,4,0,1,38,0.0,0.02564102564102564,0.9743589743589743,39,1150,700,450,0.6086956521739131,16,7,9,395.6672280710594,0.3753936122357175,0.11985070660149555,0.23538487375058437,131921.96609224944,2639.4397290809084,134561.40582133035,2264,8,818.4615384615385,35,4,17,33.009426167943516,0.6416666666666668,43.17129629629628,1027.3148148148132,29.351851851851805,0
2310,4,0,0,38,0.0,0.0,1.0,38,950,700,250,0.7368421052631579,12,7,5,400.9030883640071,0.372599573257468,0.12508536168967344,0.23899139908550482,132000.11337868482,2983.850623582767,134983.9640022676,2265,9,837.6578947368421,34,4,17,32.7958468489342,0.6446078431372548,43.095238095238095,1027.6190476190477,30.224089635854344,0
2311,4,0,0,38,0.0,0.0,1.0,38,1000,700,300,0.7,13,7,6,398.93968225452784,0.37262920815552397,0.12447728076271258,0.23820506338766181,132061.288265306,2936.897675736946,134998.18594104296,2266,10,838.6578947368421,34,4,18,32.7843892363524,0.6452205882352942,43.03571428571428,1027.857142857142,30.231092436974762,0
2312,4,1,1,38,0.02564102564102564,0.02564102564102564,0.9743589743589743,39,950,500,450,0.5263157894736842,14,5,9,391.5220751224694,0.37494376968061177,0.1247505914245548,0.23550606980869015,132340.0612394489,2562.8110796607434,134902.87231910965,2267,0,818.1282051282051,36,3,19,32.6933074313232,0.6438078703703705,42.76463963963964,1028.9414414414414,28.581706706706704,0
2313,4,0,1,37,0.0,0.02631578947368421,0.9736842105263158,38,800,600,200,0.75,10,6,4,391.7203305786074,0.3733256282598388,0.10987086889910258,0.23580634919811036,132369.03077063555,2770.328098368649,135139.3588690042,2268,1,801.578947368421,36,2,19,32.65895163055374,0.6440972222222222,42.73648648648649,1029.0540540540546,28.58483483483485,0
2314,4,0,0,37,0.0,0.0,1.0,37,600,200,400,0.3333333333333333,10,2,8,397.685481651769,0.37096471471471476,0.12684554985758467,0.23939212033621365,132368.22601862554,3128.184343921455,135496.410362547,2269,2,822.027027027027,35,2,19,32.50630319049226,0.6461309523809524,42.73726851851851,1029.050925925925,29.401455026455,0
2315,4,1,1,37,0.02631578947368421,0.02631578947368421,0.9736842105263158,38,750,400,350,0.5333333333333333,11,4,7,390.4005439295019,0.37593349928876246,0.1233858655653346,0.23672991637154733,132643.15653344675,2756.798789796269,135399.95532324302,2270,0,801.3684210526316,34,4,15,32.41626218267268,0.6510416666666667,42.470238095238095,1030.1190476190477,30.29761904761905,0
2316,4,0,0,37,0.0,0.0,1.0,37,700,300,400,0.42857142857142855,11,3,8,400.7996011056133,0.37012012012012013,0.13372010754209684,0.2426743406117849,132587.2561034218,3228.1838715878503,135815.43997500965,2271,4,824.027027027027,33,4,19,32.204902427415504,0.6527777777777778,42.52450980392157,1029.9019607843138,31.20915032679739,0
2317,4,1,1,37,0.02631578947368421,0.02631578947368421,0.9736842105263158,38,850,500,350,0.5882352941176471,12,5,7,390.82288216037375,0.37562233285917496,0.12308664940243896,0.23795671685967043,132796.4923469386,2779.9815759637013,135576.4739229023,2272,0,803.3157894736842,34,4,16,32.25076037576037,0.6525735294117647,42.32142857142856,1030.7142857142844,30.31512605042013,0
2318,4,0,0,37,0.0,0.0,1.0,37,800,600,200,0.75,10,6,4,400.73632922657123,0.36993243243243246,0.13467225550955342,0.24345311099255862,132713.4996155325,3236.624134948092,135950.1237504806,2273,6,826.027027027027,33,4,16,32.07907151918807,0.6540404040404041,42.40196078431372,1030.392156862745,31.224004753416516,0
2319,4,0,0,37,0.0,0.0,1.0,37,750,500,250,0.6666666666666666,10,5,5,398.5543374962608,0.3694944944944945,0.13911914767834888,0.24294486137815535,132839.80320069197,3188.7759515570838,136028.57915224906,2274,7,827.027027027027,33,4,16,32.007845934379446,0.6553030303030304,42.27941176470588,1030.882352941176,31.238859180035632,0
2320,4,1,1,37,0.02631578947368421,0.02631578947368421,0.9736842105263158,38,1000,900,100,0.9,11,9,2,386.2948872223964,0.3740516832622096,0.13486842105263164,0.23792253281197576,133226.30385487515,2692.928004535134,135919.2318594103,2275,0,806.2368421052631,34,4,17,31.934674815498163,0.6568627450980392,41.9047619047619,1032.3809523809514,30.364145658263276,0
2321,4,0,0,37,0.0,0.0,1.0,37,700,400,300,0.5714285714285714,10,4,6,393.6312472364214,0.37087087087087084,0.1410516110599258,0.24136791482035172,133060.97902549486,3075.3918264609583,136136.3708519558,2276,1,828.8108108108108,33,4,17,31.911821475234582,0.6575126262626263,42.06495098039215,1031.7401960784302,31.2648544266191,0
2322,4,0,0,37,0.0,0.0,1.0,37,1050,800,250,0.7619047619047619,13,8,5,393.6340923227278,0.37083958958958957,0.1500717148348638,0.24218991670082793,133187.44781153876,3085.424025615139,136272.8718371539,2277,2,829.8108108108108,33,4,17,31.784375123669324,0.6587752525252526,41.94240196078431,1032.230392156862,31.279708853238244,0
2323,4,1,0,38,0.02631578947368421,0.0,1.0,38,900,800,100,0.8888888888888888,10,8,2,384.69042663891787,0.37529634898055947,0.14813242784380298,0.238508064516129,133472.22222222207,2669.097222222203,136141.31944444426,2278,0,808.9473684210526,34,4,18,31.728830645161295,0.6593137254901962,41.66666666666666,1033.3333333333321,30.39215686274506,0
2324,4,0,0,38,0.0,0.0,1.0,38,850,600,250,0.7058823529411765,11,6,5,384.11335513411245,0.3752667140825035,0.14762545617672407,0.23854593342448926,133533.73724489778,2658.4183673469183,136192.1556122447,2279,1,809.9473684210526,34,4,20,31.681928127159644,0.6599264705882353,41.60714285714285,1033.571428571427,30.399159663865504,0
2325,4,0,1,37,0.0,0.02631578947368421,0.9736842105263158,38,1050,800,250,0.7619047619047619,13,8,5,382.199053687261,0.37529634898055947,0.14923998157531093,0.23775190417049952,133595.26643990926,2611.996882086161,136207.26332199542,2280,2,810.9473684210526,34,4,20,31.6695935052971,0.6605392156862746,41.547619047619044,1033.8095238095234,30.406162464985982,0
2326,4,0,0,37,0.0,0.0,1.0,37,1050,800,250,0.7619047619047619,13,8,5,390.2392063696906,0.3753753753753754,0.14824954239021393,0.24174186252041563,133440.5656027728,3014.748083669724,136455.31368644253,2281,3,821.3243243243244,33,4,20,31.61732000948879,0.6613005050505052,41.69730392156862,1033.2107843137242,31.30941770647649,0
2327,4,0,0,37,0.0,0.0,1.0,37,400,0,400,0.0,8,0,8,390.2392063696906,0.3750938438438438,0.14824954239021393,0.24174186252041563,133440.5656027728,3014.748083669724,136455.31368644253,2282,4,822.3243243243244,33,4,20,31.61732000948879,0.6613005050505052,41.69730392156862,1033.2107843137242,31.30941770647649,0
2328,4,0,0,37,0.0,0.0,1.0,37,800,500,300,0.625,11,5,6,388.8475168740372,0.3747184684684685,0.15075402649507463,0.24149778772574565,133535.5467248172,2984.993151672412,136520.5398764896,2283,5,823.3243243243244,33,4,20,31.5577819935183,0.6622474747474748,41.605392156862735,1033.5784313725476,31.320558526440834,0
2329,4,0,0,37,0.0,0.0,1.0,37,950,700,250,0.7368421052631579,12,7,5,387.6940002319939,0.3744994994994995,0.15238540662269506,0.24140031586400948,133630.56163795156,2961.553398933078,136592.11503688464,2284,6,824.3243243243244,33,4,20,31.49211311287582,0.6631944444444446,41.51348039215685,1033.946078431371,31.33169934640518,0
2330,4,0,0,37,0.0,0.0,1.0,37,850,600,250,0.7058823529411765,11,6,5,385.752437696459,0.3743430930930931,0.14857242415663063,0.24056219858357042,133687.58680555536,2914.062499999976,136601.64930555533,2285,7,825.3243243243244,34,3,20,31.485025517056133,0.6614583333333335,41.45833333333332,1034.1666666666652,30.41666666666662,0
2331,4,0,0,37,0.0,0.0,1.0,37,950,700,250,0.7368421052631579,12,7,5,388.56614682167145,0.3738113113113113,0.14925512393866835,0.24292372776117413,133779.93905895672,2996.471088435348,136776.41014739207,2286,8,826.3243243243244,34,3,14,31.319524357499038,0.6623774509803922,41.369047619047606,1034.5238095238078,30.42717086834729,0
2332,4,0,0,37,0.0,0.0,1.0,37,1050,600,450,0.5714285714285714,15,6,9,386.8892259844348,0.3738113113113113,0.14694293879658082,0.2420773407509517,133810.73022959163,2953.985969387729,136764.71619897935,2287,9,827.3243243243244,34,3,14,31.331981360027605,0.6626838235294119,41.3392857142857,1034.6428571428555,30.430672268907514,0
2333,4,0,0,37,0.0,0.0,1.0,37,750,500,250,0.6666666666666666,10,5,5,383.7324168811553,0.3733108108108108,0.13693048897701154,0.24062659689700452,133891.14610125148,2875.6746184842004,136766.82071973567,2288,10,828.3243243243244,35,2,15,31.33294192201596,0.6613095238095239,41.26157407407406,1034.9537037037019,29.570105820105766,0
2334,4,0,0,37,0.0,0.0,1.0,37,900,600,300,0.6666666666666666,12,6,6,436.46365192575644,0.3733108108108108,0.1463283923851748,0.2596549178614621,131921.96609224967,4145.420203189302,136067.38629543898,2289,11,829.3243243243244,35,2,16,31.961656902508633,0.6416666666666666,43.1712962962963,1027.314814814815,29.35185185185186,7
2335,4,0,0,37,0.0,0.0,1.0,37,1400,1200,200,0.8571428571428571,16,12,4,439.1795332443217,0.372779029029029,0.1448784970514312,0.2625028677170972,132100.37964034633,4203.156614368995,136303.53625471532,2290,12,830.3243243243244,35,2,17,31.71066951887713,0.6434523809523809,42.99768518518518,1028.009259259259,29.371693121693113,0
2336,4,0,0,37,0.0,0.0,1.0,37,550,300,250,0.5454545454545454,8,3,5,438.7226446335287,0.3728728728728729,0.144198910156357,0.26243590924441995,132130.126953125,4193.695746527778,136323.82269965278,2291,13,831.3243243243244,35,2,17,31.69220702465384,0.64375,42.96875,1028.125,29.375,0
2337,4,0,0,37,0.0,0.0,1.0,37,950,700,250,0.7368421052631579,12,7,5,438.741098591482,0.3731544044044044,0.14844341472758615,0.2636896298431157,132308.68115837185,4209.851224922834,136518.5323832947,2292,14,832.3243243243244,35,2,18,31.510504556193045,0.6455357142857143,42.795138888888886,1028.8194444444441,29.394841269841262,0
2338,4,0,0,37,0.0,0.0,1.0,37,1300,900,400,0.6923076923076923,17,9,8,437.0327894611253,0.37281031031031026,0.1503676660576898,0.26307776107642955,132368.22601862566,4169.851010588136,136538.0770292138,2293,15,833.3243243243244,35,2,18,31.494043602144497,0.6461309523809524,42.73726851851852,1029.0509259259259,29.401455026455025,0
2339,4,0,0,37,0.0,0.0,1.0,37,900,500,400,0.5555555555555556,13,5,8,437.94392477822794,0.3727477477477477,0.1517141993219122,0.2647197738119908,132524.1568747597,4207.636575891098,136731.79345065082,2294,16,834.3243243243244,33,4,18,31.31248512258986,0.6521464646464646,42.58578431372549,1029.656862745098,31.201723113487816,0
2340,4,2,2,37,0.05128205128205128,0.05128205128205128,0.9487179487179487,39,1250,700,550,0.56,18,7,11,416.026981314458,0.38051057130004495,0.12917439636452532,0.255256747310282,133083.80922335837,3273.2910826046145,136357.100305963,2295,0,792.4871794871794,35,4,17,31.311109553187507,0.6532738095238094,42.04282407407408,1031.828703703705,29.480820105820143,0
2341,4,0,0,37,0.0,0.0,1.0,37,750,400,350,0.5333333333333333,11,4,7,430.8822094754421,0.3719344344344344,0.14221165279429293,0.2622083488920743,132776.64389898107,4042.218737985381,136818.86263696646,2296,18,836.3243243243244,33,4,17,31.23860483551328,0.6546717171717171,42.3406862745098,1030.63725490196,31.23143196672606,0
2342,4,0,0,37,0.0,0.0,1.0,37,850,600,250,0.7058823529411765,11,6,5,429.5937081482896,0.37140265265265265,0.14398992430376145,0.26186538209734883,132839.80320069208,4013.428729334874,136853.23193002696,2297,19,837.3243243243244,33,4,17,31.207897448090026,0.6553030303030303,42.279411764705884,1030.8823529411768,31.23885918003566,0
2343,4,0,0,37,0.0,0.0,1.0,37,950,400,550,0.42105263157894735,15,4,11,426.49572331678667,0.3714652152152152,0.14602895240235036,0.2603156772125928,132888.5363520409,3935.2784863945662,136823.81483843544,2298,20,838.3243243243244,34,3,17,31.23845398914674,0.6534926470588235,42.23214285714286,1031.0714285714294,30.325630252100865,0
2344,4,0,0,37,0.0,0.0,1.0,37,1300,800,500,0.6153846153846154,18,8,10,428.2205330328553,0.3711211211211211,0.14453516196561345,0.26179777541733434,132949.9167375284,3986.376842403635,136936.29357993204,2299,21,839.3243243243244,34,3,17,31.131921197429687,0.6541053921568627,42.17261904761905,1031.3095238095243,30.332633053221304,0
2345,4,0,0,37,0.0,0.0,1.0,37,600,300,300,0.5,9,3,6,428.77537118861267,0.37096471471471476,0.14207745710168962,0.26278411362945664,133042.01388888893,4009.027777777783,137051.04166666672,2300,22,840.3243243243244,34,3,18,31.02450188476038,0.6550245098039216,42.083333333333336,1031.666666666667,30.34313725490197,0
2346,4,0,0,37,0.0,0.0,1.0,37,1150,800,350,0.6956521739130435,15,8,7,436.34965072931385,0.3705267767767768,0.1466397778241857,0.268530008621283,133195.58000283435,4223.968962585021,137419.54896541938,2301,23,841.3243243243244,34,3,18,30.67384576942298,0.6565563725490196,41.9345238095238,1032.261904761904,30.360644257703058,0
2347,4,0,0,37,0.0,0.0,1.0,37,850,700,150,0.8235294117647058,10,7,3,389.1668976401567,0.3708083083083083,0.032362286403856855,0.2264040051338415,131068.54056336732,2808.3668722845714,133876.9074356519,2302,24,842.3243243243244,36,1,15,34.040837274093626,0.6310763888888891,44.00337837837837,1023.9864864864858,28.444069069069048,8
2348,4,0,0,37,0.0,0.0,1.0,37,750,400,350,0.5333333333333333,11,4,7,389.8777178419846,0.3704642142142142,0.03128444482737103,0.2274995252859865,131183.87972009153,2829.1343285853236,134013.01404867685,2303,25,843.3243243243244,36,1,16,33.90563738961563,0.6322337962962965,43.89076576576576,1024.4369369369356,28.456581581581545,0
2349,4,1,0,38,0.02631578947368421,0.0,1.0,38,800,600,200,0.75,10,6,4,380.12914590431564,0.37457029397818875,0.029984357944250473,0.22363069376031225,131496.76462950127,2397.1505655586157,133893.91519505988,2304,0,822.1052631578947,37,1,19,33.83846482788111,0.633445945945946,43.585526315789465,1025.6578947368412,27.720483641536248,0
2350,4,0,1,37,0.0,0.02631578947368421,0.9736842105263158,38,450,200,250,0.4444444444444444,7,2,5,377.54977635392686,0.37436284969179706,0.027857158929817105,0.22244053574101605,131553.0018851952,2333.561288088616,133886.56317328382,2305,1,823.1052631578947,37,1,19,33.84770913495795,0.6340090090090091,43.53070175438595,1025.8771929824543,27.726410621147412,0
2351,4,0,1,36,0.0,0.02702702702702703,0.972972972972973,37,1200,900,300,0.75,15,9,6,382.8444309907327,0.37252877877877877,0.02107011015403759,0.22645210827258433,131703.5336645766,2684.3928810567113,134387.9265456333,2306,2,801.3783783783783,36,1,14,33.559608703602116,0.6374421296296298,43.384009009009,1026.4639639639627,28.512887887887853,0
2352,4,0,0,36,0.0,0.0,1.0,36,900,600,300,0.6666666666666666,12,6,6,391.11546290808906,0.3683201058201058,0.030090242526791267,0.23068786285297418,131595.18771701353,3093.782552083294,134688.9702690968,2307,29,824.5833333333334,35,1,15,33.45706429780034,0.6383928571428574,43.489583333333314,1026.0416666666638,29.315476190476108,0
2353,4,0,0,36,0.0,0.0,1.0,36,1300,1000,300,0.7692307692307693,16,10,6,390.5730907038788,0.36876653439153434,0.026061630965802163,0.23126724396150883,131743.67310742443,3091.1067172496364,134834.77982467407,2308,30,825.5833333333334,35,1,15,33.32065013152948,0.6398809523809523,43.3449074074074,1026.6203703703693,29.33201058201055,0
2354,4,0,0,36,0.0,0.0,1.0,36,650,400,250,0.6153846153846154,9,4,5,395.10551370299805,0.36896494708994704,0.022932161370295523,0.23468315452479294,131862.52170138896,3219.9218750000095,135082.44357638896,2309,31,826.5833333333334,35,1,15,33.08400946585531,0.6410714285714285,43.22916666666667,1027.083333333334,29.345238095238113,0
2355,4,0,0,36,0.0,0.0,1.0,36,750,500,250,0.6666666666666666,10,5,5,395.6048650013629,0.3685846560846561,0.025430888813788632,0.23553215201992608,131951.69331114978,3240.146363811735,135191.83967496152,2310,32,827.5833333333334,35,1,17,32.98094795539033,0.6419642857142855,43.142361111111114,1027.430555555556,29.355158730158745,0
2356,4,0,0,36,0.0,0.0,1.0,36,1150,800,350,0.6956521739130435,15,8,7,395.69109671935774,0.3683366402116402,0.01894067319599224,0.23669521967394308,132130.126953125,3256.54296875,135386.669921875,2311,33,828.5833333333334,35,1,18,32.798252279635264,0.64375,42.96875,1028.125,29.375,0
2357,4,0,0,36,0.0,0.0,1.0,36,1050,800,250,0.7619047619047619,13,8,5,395.76762293508796,0.3686011904761905,0.025509056136798547,0.2378619608025691,132308.68115837194,3272.698447145069,135581.379605517,2312,34,829.5833333333334,35,1,18,32.615803239959504,0.6455357142857142,42.79513888888889,1028.8194444444448,29.39484126984128,0
2358,4,0,0,36,0.0,0.0,1.0,36,600,400,200,0.6666666666666666,8,4,4,396.56747068596167,0.3685185185185185,0.02866516685414311,0.2385307722867525,132338.45191400903,3296.2250300068704,135634.6769440159,2313,35,830.5833333333334,35,1,18,32.565148106486696,0.6458333333333333,42.76620370370371,1028.935185185186,29.39814814814817,0
2359,4,0,0,36,0.0,0.0,1.0,36,1050,600,450,0.5714285714285714,15,6,9,398.5139602368944,0.3688988095238095,0.024140900095098727,0.24027557184157522,132428.63520408166,3354.9453687081877,135783.58057278986,2314,36,831.5833333333334,34,2,18,32.42395327318992,0.6488970588235293,42.67857142857143,1029.2857142857144,30.273109243697483,0
2360,4,0,0,36,0.0,0.0,1.0,36,700,400,300,0.5714285714285714,10,4,6,399.89167232176993,0.36866732804232805,0.027212457600986895,0.24149882557532604,132489.90929705222,3396.3222789115675,135886.2315759638,2315,37,832.5833333333334,34,2,18,32.326597671908715,0.6495098039215685,42.61904761904762,1029.5238095238099,30.280112044817937,0
2361,4,0,0,36,0.0,0.0,1.0,36,450,400,50,0.8888888888888888,5,4,1,398.28260215844176,0.36916335978835974,0.025112395632627127,0.24091919641052595,132551.19756235817,3358.5671768707366,135909.7647392289,2316,38,833.5833333333334,34,2,19,32.30611753371868,0.6501225490196079,42.5595238095238,1029.761904761904,30.28711484593835,0
2362,4,0,0,36,0.0,0.0,1.0,36,650,300,350,0.46153846153846156,10,3,7,398.2536943964391,0.3689153439153439,0.022525906236757764,0.24149188630780574,132643.15653344677,3365.1254251700666,136008.28195861683,2317,39,834.5833333333334,34,2,17,32.2140201856774,0.6510416666666667,42.470238095238095,1030.119047619048,30.297619047619058,0
2363,4,0,0,36,0.0,0.0,1.0,36,600,400,200,0.6666666666666666,8,4,4,397.5705403785918,0.369130291005291,0.019342372184988577,0.24127457618768086,132673.81660997716,3349.440192743749,136023.25680272092,2318,40,835.5833333333334,34,2,17,32.200668284415684,0.6513480392156863,42.44047619047618,1030.238095238094,30.301120448179237,0
2364,4,0,0,36,0.0,0.0,1.0,36,950,900,50,0.9473684210526315,10,9,1,394.98026615081335,0.36843584656084655,0.02291783642148637,0.2404169015771014,132785.41512613604,3289.5237214934955,136074.93884762953,2319,41,836.5833333333334,35,1,17,32.15480535279806,0.6502976190476188,42.33217592592593,1030.6712962962968,29.447751322751337,0
2365,4,0,0,36,0.0,0.0,1.0,36,750,500,250,0.6666666666666666,10,5,5,395.58796813165094,0.36769179894179893,0.023162700194581554,0.241362850692928,132874.89819101518,3312.7421982167425,136187.6403892319,2320,42,837.5833333333334,35,1,17,32.048907349199226,0.6511904761904761,42.245370370370374,1031.0185185185192,29.457671957671977,0
2366,4,0,0,36,0.0,0.0,1.0,36,1050,900,150,0.8571428571428571,12,9,3,393.4380126930307,0.3678571428571429,0.025658288450030264,0.24081865172529454,132994.2558299039,3264.9991426611728,136259.25497256508,2321,43,838.5833333333334,35,1,17,31.984029024536213,0.6523809523809523,42.129629629629626,1031.4814814814808,29.470899470899454,0
2367,4,0,0,36,0.0,0.0,1.0,36,750,500,250,0.6666666666666666,10,5,5,391.893275086039,0.36827050264550265,0.01984483080949717,0.24044931503042233,133083.8092233581,3230.9299714934764,136314.7391948516,2322,44,839.5833333333334,35,1,17,31.93365582351841,0.6532738095238095,42.04282407407407,1031.828703703703,29.480820105820086,0
2368,4,1,1,36,0.02702702702702703,0.02702702702702703,0.972972972972973,37,750,500,250,0.6666666666666666,10,5,5,388.225242387694,0.37190315315315314,0.015024835168720108,0.24032242737278717,133414.04537983934,2958.9400211021893,136372.98540094154,2323,0,817.8648648648649,36,1,17,31.69600683089892,0.6545138888888888,41.722972972972975,1033.1081081081084,28.697447447447455,0
2369,4,1,0,37,0.02702702702702703,0.0,1.0,37,950,700,250,0.7368421052631579,12,7,5,391.9455317476869,0.37309184184184185,0.021337781816823664,0.24381482791525172,133595.26643990938,3072.4389119538814,136667.70535186326,2324,0,818.8378378378378,34,3,18,31.417693459235384,0.6605392156862745,41.54761904761905,1033.8095238095243,30.40616246498601,0
2370,4,0,0,37,0.0,0.0,1.0,37,1000,800,200,0.8,12,8,4,391.2078192688855,0.3739364364364364,0.022507488498971995,0.24437129702569002,133749.1514314059,3064.742772108846,136813.89420351473,2325,1,819.8378378378378,34,3,15,31.28212874515672,0.6620710784313726,41.398809523809526,1034.404761904762,30.423669467787114,0
2371,4,1,0,38,0.02631578947368421,0.0,1.0,38,550,400,150,0.7272727272727273,7,4,3,385.14939054246264,0.37762268847795166,0.023762743171777734,0.24250046426343536,134040.92084887266,2725.155794538759,136766.07664341142,2326,0,799.2368421052631,35,3,17,31.14603125814985,0.662797619047619,41.11689814814815,1035.5324074074078,29.586640211640223,0
2372,4,1,0,39,0.02564102564102564,0.0,1.0,39,850,600,250,0.7058823529411765,11,6,5,381.2576244842014,0.38121345029239767,0.023989550871271303,0.2422525154331296,134375.58493882412,2446.3432604902355,136821.92819931437,2327,0,779.7179487179487,36,3,18,30.911489446435674,0.6640625,40.793918918918926,1036.8243243243255,28.80067567567571,0
2373,4,0,0,39,0.0,0.0,1.0,39,800,500,300,0.625,11,5,6,382.001884991643,0.38087606837606836,0.029725658567009594,0.24311370828528292,134433.97102761565,2470.806067892236,136904.7770955079,2328,1,780.7179487179487,36,3,18,30.83374054367104,0.6646412037037036,40.73761261261262,1037.049549549551,28.806931931931974,0
2374,4,0,0,39,0.0,0.0,1.0,39,1000,400,600,0.4,16,4,12,380.86865551128926,0.3798076923076923,0.028852771454285886,0.24378949623696186,134643.43112244905,2456.39396981097,137099.82509226003,2329,2,781.7179487179487,34,5,18,30.653532920394596,0.6709558823529411,40.53571428571429,1037.8571428571433,30.525210084033628,0
2375,4,0,0,39,0.0,0.0,1.0,39,850,600,250,0.7058823529411765,11,6,5,379.8852214388108,0.3795546558704453,0.025373472225897364,0.24378064872464106,134736.11288265316,2436.8516156462683,137172.96449829944,2330,3,782.7179487179487,34,5,21,30.586371975690856,0.671875,40.44642857142858,1038.2142857142865,30.535714285714306,0
2376,4,0,0,39,0.0,0.0,1.0,39,1300,1100,200,0.8461538461538461,15,11,4,376.1906716693621,0.37989203778677466,0.02780104327382249,0.24223347677602852,134859.73816609985,2346.5950963718883,137206.33326247174,2331,4,783.7179487179487,34,5,14,30.558739255014327,0.6731004901960784,40.327380952380956,1038.6904761904768,30.549719887955202,0
2377,4,0,0,39,0.0,0.0,1.0,39,850,600,250,0.7058823529411765,11,6,5,376.29979811489875,0.37927350427350426,0.03049425368398806,0.24292489925642305,134952.49433106591,2356.5192743764364,137309.01360544236,2332,5,784.7179487179487,34,5,14,30.463260006110602,0.6740196078431371,40.23809523809525,1039.0476190476202,30.560224089635888,0
2378,4,0,0,39,0.0,0.0,1.0,39,1000,700,300,0.7,13,7,6,381.0254309683642,0.37876743139901037,0.028600960804350928,0.24681855068366174,135076.2188208618,2493.494897959201,137569.713718821,2333,6,785.7179487179487,34,5,15,30.21692243090549,0.6752450980392156,40.11904761904763,1039.5238095238105,30.57422969187678,0
2379,4,0,0,39,0.0,0.0,1.0,39,1250,1000,250,0.8,15,10,5,381.72244327407344,0.37823324336482234,0.027654964682672478,0.24769419164604442,135138.10232426308,2517.0493197278925,137655.15164399098,2334,7,786.7179487179487,34,5,15,30.13701244179833,0.6758578431372548,40.05952380952381,1039.761904761905,30.581232492997206,0
2380,4,0,0,39,0.0,0.0,1.0,39,1350,1200,150,0.8888888888888888,15,12,3,380.28880239984784,0.3769961763382816,0.02336071467352241,0.24740009430882137,135230.95415249435,2485.363520408162,137716.3176729025,2335,8,787.7179487179487,34,5,16,30.08159742093015,0.6767769607843137,39.970238095238095,1040.1190476190477,30.591736694677873,0
2381,4,0,1,38,0.0,0.02564102564102564,0.9743589743589743,39,950,500,450,0.5263157894736842,14,5,9,379.31807679208475,0.376040260908682,0.016278619573060427,0.24783248335698085,135385.77806122444,2470.854591836731,137856.63265306118,2336,9,788.7179487179487,34,5,19,29.9523850377488,0.6783088235294117,39.82142857142857,1040.7142857142853,30.60924369747898,0
2382,4,0,0,38,0.0,0.0,1.0,38,1050,900,150,0.8571428571428571,12,9,3,387.19643737672584,0.3725254860123281,0.018007759784075317,0.25167768429487175,135200.0,2869.7916666666665,138069.79166666666,2337,10,810.2105263157895,34,4,19,29.93289262820514,0.6764705882352942,40.0,1040.0,30.58823529411765,0
2383,4,0,0,38,0.0,0.0,1.0,38,950,700,250,0.7368421052631579,12,7,5,388.4562268727725,0.3722291370317686,0.020129862307404878,0.25293073848094505,135261.9118480724,2908.6663832199383,138170.57823129234,2338,11,811.2105263157895,34,4,19,29.838302052338445,0.6770833333333334,39.94047619047618,1040.238095238094,30.59523809523806,0
2384,4,0,0,38,0.0,0.0,1.0,38,850,600,250,0.7058823529411765,11,6,5,385.82832815797326,0.3720513276434329,0.022883295194507713,0.25165220806721533,135323.8378684807,2842.354024943309,138166.19189342402,2339,12,812.2105263157895,34,4,19,29.844822654462245,0.6776960784313726,39.88095238095238,1040.4761904761904,30.60224089635854,0
2385,4,0,0,38,0.0,0.0,1.0,38,1100,900,200,0.8181818181818182,13,9,4,387.6144497229266,0.3718587008060692,0.019866328782035092,0.253513945189693,135422.77688025116,2898.3650280778393,138321.141908329,2340,13,813.2105263157895,35,3,19,29.699604321879974,0.6764880952380953,39.785879629629626,1040.856481481481,29.738756613756603,0
2386,4,0,0,38,0.0,0.0,1.0,38,1000,600,400,0.6,14,6,8,387.12488334451143,0.3718142484589853,0.019223341877040667,0.2534062009316254,135452.8959297838,2887.437307098747,138340.33323688252,2341,14,814.2105263157895,35,3,19,29.68228819212808,0.6767857142857143,39.756944444444436,1040.972222222221,29.74206349206346,0
2387,4,0,0,38,0.0,0.0,1.0,38,1100,700,400,0.6363636363636364,15,7,8,370.818158265702,0.37144381223328593,-0.01944526909538169,0.23124891176268117,133687.58680555533,2314.877507716026,136002.46431327137,2342,15,815.2105263157895,34,4,20,31.871138866505518,0.6614583333333335,41.45833333333332,1034.166666666665,30.416666666666615,7
2388,4,0,1,37,0.0,0.02631578947368421,0.9736842105263158,38,750,500,250,0.6666666666666666,10,5,5,369.1728117612747,0.37134009009009006,-0.018131482019967393,0.2304147549268642,133718.36734693855,2273.0371315192497,135991.4044784578,2343,16,816.2105263157895,34,4,15,31.88281729588704,0.661764705882353,41.428571428571416,1034.2857142857126,30.420168067226843,0
2389,4,0,0,37,0.0,0.0,1.0,37,650,600,50,0.9230769230769231,7,6,1,378.01708274119744,0.36780530530530525,-0.014827060346263687,0.23517345943987766,133598.88624567466,2700.5322472126036,136299.41849288726,2344,17,837.4324324324324,33,4,20,31.774043780622723,0.662878787878788,41.54411764705882,1033.8235294117642,31.32798573975043,0
2390,4,0,0,37,0.0,0.0,1.0,37,800,300,500,0.375,13,3,10,378.882073792597,0.367210960960961,-0.015759628838647677,0.23672417356649184,133757.30075271506,2735.6486988177335,136492.9494515328,2345,18,838.4324324324324,33,4,16,31.592697350234968,0.6644570707070707,41.390931372549005,1034.436274509802,31.3465537730243,0
2391,4,0,1,36,0.0,0.02702702702702703,0.972972972972973,37,600,300,300,0.5,9,3,6,381.0979954092177,0.3673360860860861,-0.013097417645025589,0.2387234030590084,133852.39451172622,2802.175845828523,136654.57035755474,2346,19,839.4324324324324,33,4,17,31.43997710405811,0.6654040404040404,41.299019607843135,1034.8039215686272,31.357694592988704,0
2392,4,0,0,36,0.0,0.0,1.0,36,950,500,450,0.5263157894736842,14,5,9,382.8763246473189,0.36562500000000003,-0.0069435972510267785,0.2401252664983989,133896.59098880223,3053.1669281195873,136949.7579169218,2347,20,845.4722222222222,32,4,17,31.349629945915172,0.6682942708333333,41.256313131313135,1034.974747474748,32.342960858585876,0
2393,4,0,0,36,0.0,0.0,1.0,36,650,500,150,0.7692307692307693,8,5,3,382.3965038707164,0.36473214285714284,-0.005722242549904166,0.2402504931215329,133961.9382747934,3045.3153696051477,137007.25364439856,2348,21,846.4722222222222,32,4,17,31.296499573118677,0.6689453125,41.19318181818182,1035.227272727273,32.35085227272728,0
2394,4,0,0,36,0.0,0.0,1.0,36,650,500,150,0.7692307692307693,8,5,3,384.2299587739247,0.36473214285714284,-0.004175301718883251,0.24226274802632622,134092.6806735282,3104.4850334149546,137197.16570694317,2349,22,847.4722222222222,32,4,17,31.11793449550977,0.6702473958333334,41.06691919191919,1035.732323232323,32.3666351010101,0
2395,4,0,0,36,0.0,0.0,1.0,36,850,600,250,0.7058823529411765,11,6,5,383.2990279060224,0.363723544973545,0.0034519168291102797,0.24275605100714753,134256.1983471075,3092.054063360892,137348.2524104684,2350,23,848.4722222222222,32,4,17,30.978161549707604,0.671875,40.909090909090914,1036.363636363637,32.386363636363654,0
2396,4,0,0,36,0.0,0.0,1.0,36,950,700,250,0.7368421052631579,12,7,5,385.4632034065711,0.3639054232804233,0.006282223034141277,0.24478254935586666,134354.35677800732,3157.7321510560128,137512.08892906332,2351,24,849.4722222222222,32,4,18,30.823742540494454,0.6728515625,40.81439393939394,1036.742424242424,32.39820075757575,0
2397,4,0,0,36,0.0,0.0,1.0,36,950,700,250,0.7368421052631579,12,7,5,382.6912415742295,0.3635085978835979,0.007771284798311795,0.24367642312331178,134452.55107897153,3090.76274104683,137543.31382001837,2352,25,850.4722222222222,32,4,18,30.797266861456045,0.673828125,40.71969696969697,1037.1212121212122,32.41003787878788,0
2398,4,0,0,36,0.0,0.0,1.0,36,1150,900,250,0.782608695652174,14,9,5,384.67121498040353,0.3633597883597883,0.009482373940205457,0.24559777571825764,134550.78125,3151.5983700642787,137702.37962006428,2353,26,851.4722222222222,31,5,18,30.64759036144578,0.6774193548387097,40.625,1037.5,33.46774193548387,0
2399,4,0,0,36,0.0,0.0,1.0,36,550,200,350,0.36363636363636365,9,2,7,385.9969997564091,0.36304563492063496,0.013036841885167183,0.24713109116934429,134652.11868286133,3195.0627644856772,137847.18144734701,2354,27,852.4722222222222,31,5,19,30.51177706686739,0.6784274193548387,40.52734375,1037.890625,33.48034274193548,0
2400,4,0,0,36,0.0,0.0,1.0,36,1050,600,450,0.5714285714285714,15,6,9,386.5056040368527,0.362880291005291,0.01280362891425213,0.24791707007126515,134719.69816419808,3213.9836629231672,137933.68182712124,2355,28,853.4722222222222,31,5,19,30.430959697311756,0.6790994623655915,40.46223958333333,1038.1510416666663,33.48874327956988,0
2401,4,0,0,36,0.0,0.0,1.0,36,1050,800,250,0.7619047619047619,13,8,5,384.5000408517476,0.362417328042328,0.017240538771189584,0.24755099482440598,134854.90798950192,3170.3435262044272,138025.25151570636,2356,29,854.4722222222222,31,5,17,30.347796790773476,0.6804435483870968,40.33203125,1038.6718749999998,33.505544354838705,0
2402,4,0,0,36,0.0,0.0,1.0,36,1100,800,300,0.7272727272727273,14,8,6,384.90472006713236,0.36235119047619047,0.015658717231202157,0.24873883164824137,134990.1856316459,3191.6719224717685,138181.85755411768,2357,30,855.4722222222222,31,5,17,30.202068454245502,0.6817876344086022,40.20182291666666,1039.1927083333321,33.522345430107485,0
2403,4,0,0,36,0.0,0.0,1.0,36,700,500,200,0.7142857142857143,9,5,4,385.52659086767574,0.362880291005291,0.012084707781814252,0.24960736211651707,135057.8498840332,3213.6784871419286,138271.52837117514,2358,31,856.4722222222222,31,5,18,30.118298258799957,0.6824596774193549,40.13671875,1039.453125,33.530745967741936,0
2404,4,0,0,36,0.0,0.0,1.0,36,850,600,250,0.7058823529411765,11,6,5,383.68769980208174,0.36240079365079364,0.016065765314638547,0.24958447443151693,135227.08468967007,3176.993815104157,138404.07850477422,2359,32,857.4722222222222,31,5,18,29.99707895176098,0.6841397849462365,39.97395833333333,1040.104166666666,33.55174731182794,0
2405,4,0,0,36,0.0,0.0,1.0,36,750,400,350,0.5333333333333333,11,4,7,384.9194539885231,0.3621362433862434,0.011817372928484504,0.25132976113368266,135362.548828125,3220.735677083334,138583.28450520834,2360,33,858.4722222222222,31,5,19,29.829829829829833,0.685483870967742,39.84375,1040.625,33.568548387096776,0
2406,4,0,0,36,0.0,0.0,1.0,36,700,400,300,0.5714285714285714,10,4,6,384.15932845280656,0.36147486772486775,0.012257252874042557,0.25106995194793813,135396.42545912007,3202.759975857215,138599.1854349773,2361,34,859.4722222222222,31,5,19,29.815802368739316,0.6858198924731183,39.81119791666667,1040.755208333334,33.572748655914,0
2407,4,0,0,36,0.0,0.0,1.0,36,900,600,300,0.6666666666666666,12,6,6,382.94074545805125,0.36167328042328045,0.012459533436149917,0.2512204381811351,135531.97436862526,3180.143059624572,138712.11742824983,2362,35,860.4722222222222,31,5,19,29.712313992747298,0.6871639784946236,39.680989583333336,1041.276041666667,33.58954973118281,0
2408,4,0,0,36,0.0,0.0,1.0,36,1300,800,500,0.6153846153846154,18,8,10,385.19636378137346,0.3620866402116402,0.011748133344436473,0.2548662883003039,135837.2073703343,3264.7996690538407,139102.00703938815,2363,36,861.4722222222222,31,5,22,29.349342160046643,0.6901881720430108,39.38802083333334,1042.4479166666677,33.62735215053767,0
2409,4,0,0,36,0.0,0.0,1.0,36,1150,1000,150,0.8695652173913043,13,10,3,384.7219689495494,0.3622519841269842,0.012394229435427562,0.25552429280977557,135972.97668457046,3262.3582628038357,139235.3349473743,2364,37,862.4722222222222,31,5,18,29.226487723678726,0.691532258064516,39.25781250000001,1042.9687500000011,33.64415322580649,0
2410,4,0,0,36,0.0,0.0,1.0,36,600,200,400,0.3333333333333333,10,2,8,401.164125211415,0.3624338624338624,-0.012003454231433341,0.25637309988676527,134585.64573939185,3629.534902229716,138215.18064162158,2365,38,863.4722222222222,30,6,18,30.18485535405872,0.6805555555555556,40.59139784946237,1037.6344086021509,34.58781362007169,6
2411,4,0,0,36,0.0,0.0,1.0,36,850,700,150,0.8235294117647058,10,7,3,397.3533376027805,0.3624338624338624,0.06540232825892289,0.2220236626190806,129499.41211276597,3091.404724121113,132590.8168368871,2366,39,864.4722222222222,31,5,16,35.4293260415334,0.6266801075268816,45.54036458333334,1017.8385416666678,32.83350134408606,8
2412,4,1,1,36,0.02702702702702703,0.02702702702702703,0.972972972972973,37,700,500,200,0.7142857142857143,9,5,4,391.04737888581667,0.3690565565565565,0.05556151094078721,0.21970544936286698,129715.36705438222,2744.970857565559,132460.33791194778,2367,0,842.081081081081,32,5,16,35.36941208064782,0.6263020833333334,45.32828282828283,1018.6868686868688,31.83396464646465,0
2413,4,1,0,37,0.02702702702702703,0.0,1.0,37,700,300,400,0.42857142857142855,11,3,8,387.19006220705666,0.36752377377377377,0.07202744540205863,0.2187935445991591,129940.55333958278,2662.338186154487,132602.89152573727,2368,0,843.0540540540541,32,5,17,35.238132094943246,0.6285807291666666,45.10732323232324,1019.5707070707077,31.861584595959616,0
2414,4,2,1,38,0.05128205128205128,0.02564102564102564,0.9743589743589743,39,1000,700,300,0.7,13,7,6,371.6483303041666,0.37724921277552853,0.07482243119115295,0.21274945445897617,130444.94224773235,1895.9289965986302,132340.87124433098,2369,0,800.7692307692307,34,5,18,35.12168356446413,0.6289828431372548,44.613095238095234,1021.5476190476185,30.045518207282896,0
2415,4,0,0,38,0.0,0.0,1.0,38,1400,1200,200,0.8571428571428571,16,12,4,383.3978661563339,0.37144381223328593,0.07387231571372643,0.2198604819815347,130512.91120001934,2407.6743319877132,132920.58553200704,2370,1,822.8421052631579,33,5,18,34.75253857839611,0.6319444444444444,44.54656862745099,1021.813725490197,30.96405228758173,0
2416,4,0,0,38,0.0,0.0,1.0,38,1300,1000,300,0.7692307692307693,16,10,6,384.45785613957355,0.3711178283546705,0.07374163138333767,0.2210036511412948,130606.84479827489,2442.5655096597725,133049.41030793465,2371,2,823.8421052631579,33,5,18,34.63001538584503,0.632891414141414,44.45465686274511,1022.1813725490211,30.975193107546094,0
2417,4,0,0,38,0.0,0.0,1.0,38,1150,900,250,0.782608695652174,14,9,5,380.7766519066524,0.3710437411095306,0.06739163344603116,0.21941991598819827,130700.81218762031,2353.5635332564625,133054.37572087676,2372,3,824.8421052631579,33,5,18,34.62867529562162,0.6338383838383838,44.36274509803923,1022.5490196078445,30.986333927510437,0
2418,4,0,0,38,0.0,0.0,1.0,38,700,400,300,0.5714285714285714,10,4,6,382.2972823068674,0.3710289236605026,0.07035098230897807,0.22047483212514238,130732.14215986655,2395.708531574417,133127.85069144095,2373,4,825.8421052631579,33,5,18,34.55799380866787,0.6341540404040403,44.332107843137265,1022.6715686274522,30.990047534165218,0
2419,4,0,0,38,0.0,0.0,1.0,38,900,600,300,0.6666666666666666,12,6,6,382.9651136208877,0.3708362968231389,0.07189326172059674,0.22157835991828095,130857.49959450706,2422.771440071144,133280.2710345782,2374,5,826.8421052631579,33,5,18,34.413677286701,0.6354166666666665,44.20955882352942,1023.1617647058835,31.00490196078435,0
2420,4,0,0,38,0.0,0.0,1.0,38,950,400,550,0.42105263157894735,15,4,11,383.5697802158644,0.3707177572309151,0.0692353263712504,0.2222894680487637,130920.20083922053,2443.4065323433306,133363.60737156385,2375,6,827.8421052631579,33,5,18,34.334585678361876,0.6360479797979798,44.14828431372549,1023.4068627450984,31.01232917409389,0
2421,4,1,0,39,0.02564102564102564,0.0,1.0,39,900,700,200,0.7777777777777778,11,7,4,378.1646895795676,0.37544984255510566,0.07343456280368099,0.2209683287991406,131236.62308673482,2125.8113662131686,133362.434452948,2376,0,807.5897435897435,34,5,19,34.15219201425196,0.6369485294117647,43.83928571428572,1024.6428571428582,30.136554621848774,0
2422,4,1,0,40,0.025,0.0,1.0,40,1600,1200,400,0.75,20,12,8,371.1082342557785,0.3778712606837607,0.07851826792963479,0.21939918809201633,131684.26890432098,1773.8233024691374,133458.0922067901,2377,0,788.375,35,5,14,33.88024357239513,0.6392857142857142,43.40277777777778,1026.388888888889,29.325396825396826,0
2423,4,0,0,40,0.0,0.0,1.0,40,600,300,300,0.5,9,3,6,369.8085465213645,0.3774706196581197,0.07947062803021776,0.21880133416264053,131713.96933138292,1741.790310999663,133455.7596423826,2378,1,789.375,35,5,14,33.883587965572964,0.6395833333333333,43.373842592592595,1026.50462962963,29.328703703703713,0
2424,4,1,2,39,0.024390243902439025,0.04878048780487805,0.9512195121951219,41,600,400,200,0.6666666666666666,8,4,4,361.2519323294582,0.3819613821138212,0.07783743828261014,0.21521245123072819,131975.16453379887,1335.2566414666082,133310.42117526548,2379,0,771.0975609756098,37,4,14,33.83966047735923,0.6382319819819819,43.11951754385965,1027.5219298245615,27.77086296823139,0
2425,4,2,2,39,0.04878048780487805,0.04878048780487805,0.9512195121951219,41,1000,700,300,0.7,13,7,6,357.8075676478468,0.38158028455284554,0.07730167318738057,0.2139543210628962,132116.0357032934,1254.4234764543075,133370.4591797477,2380,0,771.9756097560976,37,4,15,33.7861739192264,0.6396396396396395,42.982456140350884,1028.0701754385973,27.785680417259385,0
2426,4,0,0,39,0.0,0.0,1.0,39,800,600,200,0.75,10,6,4,375.0876759193805,0.37342555105713,0.07757342420852753,0.22227139432737641,131773.38023244598,2085.314187885802,133858.6944203318,2381,4,812.5641025641025,35,4,15,33.688070679742985,0.6401785714285715,43.31597222222222,1026.736111111111,29.33531746031746,0
2427,4,0,0,39,0.0,0.0,1.0,39,1050,900,150,0.8571428571428571,12,9,3,373.38149920386434,0.37306005398110664,0.07583086284911844,0.22177961338253616,131862.52170138885,2047.0052083333292,133909.5269097222,2382,5,813.5641025641025,35,4,15,33.64181879648411,0.6410714285714285,43.229166666666664,1027.083333333333,29.345238095238088,0
2428,4,0,0,39,0.0,0.0,1.0,39,750,500,250,0.6666666666666666,10,5,5,374.2820058891611,0.37294759334233013,0.07876035636288004,0.22266267320859218,131921.96609224967,2075.203617969825,133997.1697102195,2383,6,814.5641025641025,35,4,15,33.55866005708276,0.6416666666666666,43.1712962962963,1027.314814814815,29.35185185185186,0
2429,4,0,0,39,0.0,0.0,1.0,39,1250,1000,250,0.8,15,10,5,373.3382030679329,0.3727789023841655,0.07172557172557159,0.22279860505666949,132040.8950617283,2059.182098765422,134100.07716049373,2384,7,815.5641025641025,35,4,15,33.46283783783783,0.6428571428571428,43.05555555555555,1027.7777777777771,29.365079365079346,0
2430,4,0,0,39,0.0,0.0,1.0,39,1200,800,400,0.6666666666666666,16,8,8,376.08511500086166,0.37289136302294196,0.07066642436200343,0.22603249406644083,132308.68115837197,2151.8651138117366,134460.5462721837,2385,8,816.5641025641025,35,4,15,33.122046911913586,0.6455357142857142,42.79513888888889,1028.819444444445,29.394841269841287,0
2431,4,0,0,39,0.0,0.0,1.0,39,850,400,450,0.47058823529411764,13,4,9,373.93767848760194,0.3730038236617184,0.07036428138790374,0.22491921256798247,132338.45191400888,2097.2666966735223,134435.7186106824,2386,9,817.5641025641025,35,4,15,33.147262842144734,0.6458333333333333,42.7662037037037,1028.935185185185,29.39814814814814,0
2432,4,0,0,39,0.0,0.0,1.0,39,850,500,350,0.5882352941176471,12,5,7,373.88532314893536,0.37269455690508324,0.06428849396808922,0.22577800063881748,132487.35592689048,2107.015576774693,134594.37150366517,2387,10,818.5641025641025,35,4,16,32.99852445193928,0.6473214285714286,42.62152777777778,1029.5138888888891,29.41468253968255,0
2433,4,0,0,39,0.0,0.0,1.0,39,1200,800,400,0.6666666666666666,16,8,8,375.97088666268496,0.37120445344129555,0.06674386049807324,0.22830101180567658,132695.96220207462,2177.9637131344157,134873.92591520902,2388,11,819.5641025641025,35,4,14,32.734685089493,0.6494047619047618,42.418981481481474,1030.324074074073,29.437830687830658,0
2434,4,0,0,39,0.0,0.0,1.0,39,1200,700,500,0.5833333333333334,17,7,10,376.3490156404826,0.3715418353576248,0.0681207618883084,0.22907641724391625,132785.4151261358,2194.732054826799,134980.1471809626,2389,12,820.5641025641025,35,4,14,32.63487273067565,0.6502976190476191,42.33217592592592,1030.671296296295,29.447751322751284,0
2435,4,0,0,39,0.0,0.0,1.0,39,750,400,350,0.5333333333333333,11,4,7,376.0205462557788,0.37109199280251914,0.06553922161377823,0.22905875410081816,132815.239465449,2188.251778978023,135003.49124442702,2390,13,821.5641025641025,35,4,14,32.613313122239674,0.6505952380952382,42.303240740740726,1030.7870370370351,29.451058201058146,0
2436,4,0,1,38,0.0,0.02564102564102564,0.9743589743589743,39,200,0,200,0.0,4,0,4,376.0205462557788,0.37109199280251914,0.06553922161377823,0.22905875410081816,132815.239465449,2188.251778978023,135003.49124442702,2391,14,822.5641025641025,35,4,14,32.613313122239674,0.6505952380952382,42.303240740740726,1030.7870370370351,29.451058201058146,0
2437,4,1,1,38,0.02564102564102564,0.02564102564102564,0.9743589743589743,39,750,500,250,0.6666666666666666,10,5,5,380.16528925619855,0.36991115609536657,0.0709660709660711,0.23232323232323224,132934.57031249988,2307.421874999986,135241.99218749988,2392,0,822.9487179487179,35,4,14,32.38636363636363,0.6517857142857144,42.18749999999999,1031.249999999999,29.464285714285687,0
2438,4,1,0,39,0.02564102564102564,0.0,1.0,39,800,600,200,0.75,10,6,4,378.8480284760825,0.36960188933873145,0.0762931964278013,0.23244529758184956,133083.8092233581,2283.707749271253,135367.51697262935,2393,0,823.9230769230769,35,4,15,32.270167320994574,0.6532738095238095,42.04282407407407,1031.828703703703,29.480820105820086,0
2439,4,0,0,39,0.0,0.0,1.0,39,550,400,150,0.7272727272727273,7,4,3,380.27784401092526,0.36923639226270805,0.07900207900207956,0.23369659097487375,133143.5282305598,2326.306771905005,135469.83500246482,2394,1,824.9230769230769,35,4,15,32.17321315091025,0.6538690476190476,41.9849537037037,1032.060185185185,29.487433862433857,0
2440,4,0,0,39,0.0,0.0,1.0,39,1100,1000,100,0.9090909090909091,12,10,2,381.067779486645,0.36887089518668464,0.07841480344562957,0.23493473813409518,133263.00643272023,2356.447589806225,135619.45402252645,2395,2,825.9230769230769,35,4,16,32.03268037962858,0.6550595238095238,41.869212962962955,1032.5231481481471,29.50066137566135,0
2441,4,0,0,39,0.0,0.0,1.0,39,900,500,400,0.5555555555555556,13,5,8,383.8399505280008,0.3690677013045434,0.07502672137365107,0.23721521596342623,133352.65024862814,2437.2149348422313,135789.86518347036,2396,3,826.9230769230769,35,4,16,31.870984610787378,0.6559523809523811,41.7824074074074,1032.8703703703693,29.51058201058198,0
2442,4,0,0,39,0.0,0.0,1.0,39,900,800,100,0.8888888888888888,10,8,2,383.98531177176767,0.36932073774179036,0.07886231415643175,0.23749611279023033,133382.53821855696,2443.3871045524543,135825.9253231094,2397,4,827.9230769230769,35,4,16,31.837184873949578,0.65625,41.753472222222214,1032.9861111111102,29.51388888888886,0
2443,4,0,0,39,0.0,0.0,1.0,39,600,400,200,0.6666666666666666,8,4,4,385.0972938597537,0.36948942869995505,0.08083558834175042,0.23837575901471278,133412.4295374656,2475.3531164266005,135887.78265389218,2398,5,828.9230769230769,35,4,16,31.778418851295843,0.656547619047619,41.72453703703703,1033.1018518518508,29.517195767195737,0
2444,4,0,0,39,0.0,0.0,1.0,39,1100,900,200,0.8181818181818182,13,9,4,383.71488033298624,0.36937696806117853,0.07919768403639349,0.2379032258064516,133472.2222222223,2443.082347393701,135915.304569616,2399,6,829.9230769230769,33,6,17,31.75403225806451,0.6616161616161615,41.66666666666667,1033.3333333333342,31.31313131313134,0
2445,4,0,0,39,0.0,0.0,1.0,39,900,600,300,0.6666666666666666,12,6,6,384.44603230865505,0.368421052631579,0.07608731989436035,0.23937794646406824,133630.5616379518,2474.747843377551,136105.30948132934,2400,7,830.9230769230769,33,6,18,31.576068705305993,0.6631944444444444,41.513480392156865,1033.9460784313728,31.331699346405237,0
2446,4,0,0,39,0.0,0.0,1.0,39,950,400,550,0.42105263157894735,15,4,11,383.2079243503066,0.3679430949167792,0.08137076193948256,0.2392215149050731,133725.6103421762,2448.9427143406547,136174.55305651686,2401,8,831.9230769230769,33,6,15,31.512638230647713,0.6641414141414141,41.42156862745099,1034.313725490197,31.342840166369605,0
2447,4,0,0,39,0.0,0.0,1.0,39,1000,800,200,0.8,12,8,4,384.8792516787101,0.3674651372019793,0.07836855581908497,0.24102092619534207,133841.5249433106,2502.565192743751,136344.09013605435,2402,9,832.9230769230769,34,5,15,31.353064120263838,0.6629901960784315,41.3095238095238,1034.7619047619041,30.434173669467768,0
2448,4,0,0,39,0.0,0.0,1.0,39,750,600,150,0.8,9,6,3,384.80592556802554,0.36729644624381463,0.07475510800024776,0.24117648961520138,133872.32320011323,2502.9726473922765,136375.2958475055,2403,10,833.9230769230769,34,5,16,31.324053836420102,0.663296568627451,41.2797619047619,1034.8809523809514,30.437675070027982,0
2449,4,0,0,39,0.0,0.0,1.0,39,900,400,500,0.4444444444444444,14,4,10,388.5195069906265,0.36667791273054434,0.07516845814718165,0.24391170493021644,133933.9303429705,2607.1889172335605,136541.11926020405,2404,11,834.9230769230769,34,5,16,31.16613954379912,0.6639093137254901,41.220238095238095,1035.1190476190475,30.444677871148457,0
2450,4,0,0,39,0.0,0.0,1.0,39,800,600,200,0.75,10,6,4,386.29277315365306,0.3657782276203329,0.07547892720306493,0.24353240046643332,134088.01020408154,2559.445861677986,136647.45606575953,2405,12,835.9230769230769,34,5,16,31.069204980842898,0.6654411764705883,41.07142857142856,1035.7142857142849,30.462184873949553,0
2451,4,0,1,38,0.0,0.02564102564102564,0.9743589743589743,39,750,400,350,0.5333333333333333,11,4,7,386.761294417386,0.3656095366621683,0.07701760869004803,0.2443119510465787,134160.80092860505,2577.641005444097,136738.44193404916,2406,13,836.9230769230769,35,4,16,30.98408464603583,0.6639880952380952,41.001157407407405,1035.9953703703698,29.599867724867707,0
2452,4,1,2,37,0.02564102564102564,0.05128205128205128,0.9487179487179487,39,1150,800,350,0.6956521739130435,15,8,7,377.67992822794446,0.3693488529014845,0.058659762242823765,0.24055547295846255,134463.16882761143,2356.8079904228566,136819.97681803428,2407,0,812.5128205128206,36,3,16,30.916576185305814,0.6649305555555556,40.70945945945946,1037.1621621621625,28.81006006006007,0
2453,4,1,1,37,0.02631578947368421,0.02631578947368421,0.9736842105263158,38,1150,800,350,0.6956521739130435,15,8,7,386.0615883144886,0.3704510431484116,0.05730041461609803,0.24607993986304744,134490.74743870035,2784.3423139574834,137275.08975265783,2408,0,820.7894736842105,35,3,16,30.671632076173463,0.6672619047619047,40.682870370370374,1037.2685185185192,29.636243386243404,0
2454,4,0,0,37,0.0,0.0,1.0,37,1000,800,200,0.8,12,8,4,391.29872478858186,0.36423923923923923,0.05813044449408089,0.24919550368114973,134458.16326530627,3122.661564625869,137580.82482993213,2409,16,843.972972972973,34,3,17,30.568468778696044,0.6691176470588235,40.71428571428572,1037.1428571428582,30.504201680672303,0
2455,4,0,0,37,0.0,0.0,1.0,37,550,300,250,0.5454545454545454,8,3,5,392.37390423626357,0.3634884884884885,0.057800743134688304,0.25030352866140587,134519.90504535162,3156.4200680272274,137676.32511337884,2410,17,844.972972972973,34,3,18,30.478731543110694,0.6697303921568627,40.65476190476191,1037.3809523809537,30.511204481792756,0
2456,4,0,0,37,0.0,0.0,1.0,37,800,600,200,0.75,10,6,4,389.59327916476013,0.3630505505505506,0.05837495848446084,0.24918810594981824,134616.28795849922,3089.127297115673,137705.4152556149,2411,18,845.972972972973,32,5,18,30.454333455002637,0.6754557291666666,40.56186868686869,1037.752525252526,32.42976641414144,0
2457,4,0,0,37,0.0,0.0,1.0,37,750,400,350,0.5333333333333333,11,4,7,387.42659513743234,0.3636761761761762,0.056683676237342384,0.24800573198933612,134646.1566014274,3033.1004000865173,137679.25700151394,2412,19,846.972972972973,33,4,18,30.480650017711653,0.6732954545454545,40.53308823529412,1037.8676470588243,31.450534759358312,0
2458,4,0,0,37,0.0,0.0,1.0,37,600,300,300,0.5,9,3,6,386.44911310047996,0.36377002002002,0.05707796785337216,0.24824740980290877,134773.37630058153,3016.610348183398,137789.98664876493,2413,20,847.972972972973,33,4,19,30.378727526653286,0.6745580808080808,40.41053921568628,1038.3578431372553,31.465389185977433,0
2459,4,0,0,37,0.0,0.0,1.0,37,800,600,200,0.75,10,6,4,383.20118142757036,0.36283158158158163,0.053199494917286705,0.24680951472493048,134868.83049788544,2936.3790369088842,137805.20953479433,2414,21,848.972972972973,33,4,15,30.36760657542866,0.6755050505050504,40.318627450980394,1038.7254901960785,31.476530005941772,0
2460,4,0,0,37,0.0,0.0,1.0,37,650,400,250,0.6153846153846154,9,4,5,386.94503438776843,0.3630505505505506,0.05691007672373405,0.2498786707215452,134964.31848627928,3044.7545715590154,138009.0730578383,2415,22,849.972972972973,33,4,15,30.174917443094706,0.6764520202020202,40.22671568627451,1039.0931372549019,31.487670825906118,0
2461,4,0,0,37,0.0,0.0,1.0,37,900,600,300,0.6666666666666666,12,6,6,388.06514773940916,0.3628628628628629,0.06009688934217228,0.2508225954901059,134996.15532487503,3077.4605920799672,138073.615916955,2416,23,850.972972972973,33,4,15,30.113993710691823,0.6767676767676767,40.19607843137255,1039.2156862745096,31.491384432560896,0
2462,4,0,0,37,0.0,0.0,1.0,37,750,500,250,0.6666666666666666,10,5,5,380.48860488637524,0.3627377377377377,0.09131281002202796,0.23529995969092118,133377.26362757105,2749.7057922433523,136126.9694198144,2417,24,851.972972972973,33,4,20,31.932786609720395,0.660669191919192,41.75857843137254,1032.9656862745092,31.301990493166944,4
2463,4,0,0,37,0.0,0.0,1.0,37,950,800,150,0.8421052631578947,11,8,3,375.04665680036663,0.3610172672672673,0.09018033425558492,0.23293868987616068,133537.46588358312,2616.589818536121,136154.05570211925,2418,25,852.972972972973,32,5,21,31.912462334066298,0.6647135416666667,41.60353535353534,1033.585858585857,32.29955808080803,0
2464,4,0,0,37,0.0,0.0,1.0,37,550,300,250,0.5454545454545454,8,3,5,374.9754640345136,0.3605480480480481,0.09282062621908782,0.23351133650027597,133635.36126734497,2621.9963205284967,136257.35758787347,2419,26,853.972972972973,32,5,21,31.81605405625432,0.6656901041666667,41.50883838383837,1033.964646464645,32.31139520202016,0
2465,4,0,0,37,0.0,0.0,1.0,37,1050,700,350,0.6666666666666666,14,7,7,374.82322317487154,0.360767017017017,0.09203049203049218,0.23362269389666634,133668.00103305775,2620.3741965105446,136288.3752295683,2420,27,854.972972972973,32,5,21,31.787240537240535,0.666015625,41.47727272727272,1034.0909090909083,32.315340909090885,0
2466,4,0,0,37,0.0,0.0,1.0,37,1300,1200,100,0.9230769230769231,14,12,2,372.3592891253185,0.35985985985985985,0.09183845141369851,0.23270325368449524,133765.944243572,2561.798381542686,136327.7426251147,2421,28,855.972972972973,32,5,19,31.75271573294275,0.6669921875,41.38257575757575,1034.4696969696963,32.32717803030301,0
2467,4,0,0,37,0.0,0.0,1.0,37,950,800,150,0.8421052631578947,11,8,3,373.774717048643,0.3593280780780781,0.0949451168567601,0.23393476175253464,133820.69283749035,2603.7583201172592,136424.4511576076,2422,29,856.972972972973,33,4,19,31.661213431244832,0.6650883838383839,41.3296568627451,1034.6813725490192,31.353980986333916,0
2468,4,0,0,37,0.0,0.0,1.0,37,900,700,200,0.7777777777777778,11,7,4,373.98964624840954,0.35807682682682684,0.0971769780673406,0.234674335231357,133915.80912389458,2616.62521626297,136532.43434015755,2423,30,857.972972972973,33,4,19,31.560304680716715,0.6660353535353536,41.23774509803921,1035.0490196078426,31.365121806298262,0
2469,4,0,0,37,0.0,0.0,1.0,37,700,600,100,0.8571428571428571,8,6,2,370.22942483877125,0.35807682682682684,0.09505682745119381,0.23291648625932815,134010.9592013888,2522.9600694444343,136533.91927083323,2424,31,858.972972972973,33,4,19,31.562290409121392,0.6669823232323233,41.14583333333333,1035.4166666666658,31.3762626262626,0
2470,4,0,0,37,0.0,0.0,1.0,37,1050,900,150,0.8571428571428571,12,9,3,379.06733174975466,0.35807682682682684,0.1217061121437728,0.229551018937101,132592.99314164382,2662.1000487832957,135255.0931904271,2425,32,859.972972972973,32,5,19,32.758673531935756,0.6552734375,42.5189393939394,1029.9242424242432,32.1851325757576,3
2471,4,0,0,37,0.0,0.0,1.0,37,400,300,100,0.75,5,3,2,380.54924195412246,0.3581393893893894,0.12418915605971281,0.23064789865243177,132625.50536935005,2694.1071064177113,135319.61247576776,2426,33,860.972972972973,32,5,17,32.687750265587965,0.6555989583333334,42.48737373737374,1030.0505050505049,32.18907828282828,0
2472,4,0,0,37,0.0,0.0,1.0,37,950,600,350,0.631578947368421,13,6,7,379.62322529616745,0.35751376376376376,0.12173584830696194,0.23108608412323722,132788.12629132217,2681.891356749294,135470.01764807146,2427,34,861.972972972973,32,5,17,32.54777655273795,0.6572265625,42.329545454545446,1030.681818181817,32.208806818181785,0
2473,4,0,0,37,0.0,0.0,1.0,37,1200,1000,200,0.8333333333333334,14,10,4,380.659554021147,0.35670045045045046,0.12073638472560977,0.23252405218329888,132918.2947690286,2719.323761605949,135637.61853063456,2428,35,862.972972972973,32,5,17,32.39000448961265,0.6585286458333335,42.20328282828282,1031.1868686868681,32.22458964646463,0
2474,4,0,0,37,0.0,0.0,1.0,37,1100,900,200,0.8181818181818182,13,9,4,380.8389351734638,0.3560122622622623,0.11551159482616069,0.233242436309385,133015.96297571657,2731.5315401489415,135747.49451586552,2429,36,863.972972972973,32,5,17,32.287076703386376,0.6595052083333335,42.10858585858585,1031.565656565655,32.23642676767672,0
2475,4,0,0,37,0.0,0.0,1.0,37,850,600,250,0.7058823529411765,11,6,5,382.53809613141266,0.35551176176176175,0.12112553081716104,0.23469229141035317,133081.0950413223,2781.7177456382033,135862.81278696048,2430,37,864.972972972973,32,5,17,32.177710474791986,0.66015625,42.04545454545455,1031.8181818181818,32.24431818181818,0
2476,4,1,0,38,0.02631578947368421,0.0,1.0,38,500,100,400,0.2,9,1,8,373.63423517169605,0.35930832147937414,0.1252122241086584,0.23165322580645173,133472.22222222228,2373.9583333333426,135846.18055555562,2431,0,843.1842105263158,33,5,19,32.014448924731184,0.6616161616161615,41.66666666666667,1033.333333333334,31.313131313131333,0
2477,4,0,0,38,0.0,0.0,1.0,38,900,700,200,0.7777777777777778,11,7,4,376.8991403969929,0.3581081081081081,0.13407392622347514,0.23487998129023846,133662.24078479444,2475.4367310649927,136137.67751585942,2432,1,844.1842105263158,33,5,20,31.739353717310582,0.6635101010101009,41.48284313725491,1034.0686274509815,31.335412953060043,0
2478,4,0,0,38,0.0,0.0,1.0,38,1400,1100,300,0.7857142857142857,17,11,6,383.3678049673711,0.35684862494073016,0.14122765464110287,0.2401452333193236,133852.39451172634,2662.9397347174277,136515.33424644376,2433,2,845.1842105263158,33,5,18,31.38125690825833,0.6654040404040403,41.29901960784314,1034.803921568628,31.35769459298873,0
2479,4,0,0,38,0.0,0.0,1.0,38,850,600,250,0.7058823529411765,11,6,5,383.3702794995409,0.35616702228544334,0.14507326555023914,0.24097560425685433,133979.23875432528,2672.731641676285,136651.97039600156,2434,3,846.1842105263158,33,5,18,31.25394570707072,0.6666666666666665,41.1764705882353,1035.294117647059,31.37254901960785,0
2480,4,0,0,38,0.0,0.0,1.0,38,950,700,250,0.7368421052631579,12,7,5,390.5528415171104,0.35510016595542915,0.14874913588550664,0.24612692495608554,134074.4113592131,2872.6284662149496,136947.03982542804,2435,4,847.1842105263158,33,5,18,30.972542697116715,0.6676136363636362,41.08455882352943,1035.6617647058847,31.383689839572263,0
2481,4,0,0,38,0.0,0.0,1.0,38,800,400,400,0.5,12,4,8,388.9803779077386,0.3548482693219535,0.1508948302156925,0.2459857214068763,134201.3607296475,2840.339202470232,137041.69993211774,2436,5,848.1842105263158,33,5,18,30.885940272028385,0.6688762626262625,40.96200980392158,1036.1519607843159,31.39854426619139,0
2482,4,0,0,38,0.0,0.0,1.0,38,1000,700,300,0.7,13,7,6,386.2848609443176,0.35529279279279274,0.14119187909482878,0.24513005541845337,134328.37017313062,2777.803158640916,137106.17333177154,2437,6,849.1842105263158,33,5,19,30.828481498995142,0.6701388888888888,40.83946078431373,1036.6421568627457,31.413398692810475,0
2483,4,0,0,38,0.0,0.0,1.0,38,950,700,250,0.7368421052631579,12,7,5,387.3118920958018,0.3554261498340446,0.1442299319558642,0.24642355119659232,134423.66667868147,2812.7769367551145,137236.44361543658,2438,7,850.1842105263158,33,5,19,30.706393287638846,0.6710858585858585,40.74754901960785,1037.0098039215702,31.424539512774857,0
2484,4,1,0,39,0.02564102564102564,0.0,1.0,39,1000,800,200,0.8,12,8,4,380.8516166430923,0.3564158794421952,0.13931006500665966,0.24440080564712377,134736.11288265325,2462.8932823129508,137199.0061649662,2439,0,829.3589743589744,34,5,20,30.561288843022613,0.6718749999999998,40.446428571428584,1038.2142857142871,30.535714285714327,0
2485,4,0,1,38,0.0,0.02564102564102564,0.9743589743589743,39,1100,800,300,0.7272727272727273,14,8,6,385.5780225241506,0.35675326135852453,0.13822170493422248,0.24806656847350214,134828.82653061228,2597.4064625850424,137426.2329931973,2440,1,830.3589743589744,34,5,16,30.345884915176537,0.6727941176470588,40.35714285714286,1038.571428571429,30.546218487394967,0
2486,4,0,0,38,0.0,0.0,1.0,38,500,300,200,0.6,7,3,4,394.5789187960159,0.35547060218112847,0.14142406086070114,0.2523636166438571,134614.3610630528,3023.197808535192,137637.558871588,2441,10,853.1842105263158,33,5,19,30.326917020941583,0.6729797979797979,40.563725490196084,1037.7450980392168,31.44682115270354,0
2487,4,0,0,38,0.0,0.0,1.0,38,900,500,400,0.5555555555555556,13,5,8,394.5789187960159,0.35547060218112847,0.14142406086070114,0.2523636166438571,134614.3610630528,3023.197808535192,137637.558871588,2442,11,854.1842105263158,33,5,19,30.326917020941583,0.6729797979797979,40.563725490196084,1037.7450980392168,31.44682115270354,0
2488,4,2,2,38,0.05,0.05,0.95,40,1450,1300,150,0.896551724137931,16,13,3,374.5128915471249,0.36490384615384613,0.12872287145242045,0.24331152064721032,135181.9450472609,2125.476224922847,137307.42127218374,2443,0,812.425,35,5,17,30.28067612687812,0.6741071428571428,40.017361111111114,1039.930555555556,29.712301587301603,0
2489,4,0,0,38,0.0,0.0,1.0,38,800,600,200,0.75,10,6,4,391.8901794390001,0.35538169748696063,0.14233377213680698,0.2524058632921705,134868.83049788536,2970.7540369088697,137839.58453479424,2444,13,856.1842105263158,33,5,17,30.14196948246029,0.6755050505050505,40.31862745098039,1038.7254901960778,31.47653000594175,0
2490,4,0,0,38,0.0,0.0,1.0,38,850,500,350,0.5882352941176471,12,5,7,382.03375358407834,0.35538169748696063,0.14725734791524236,0.22628153096903098,131755.55555555547,2467.0138888888796,134222.56944444435,2445,14,857.1842105263158,34,4,19,33.52780032467533,0.6421568627450981,43.33333333333333,1026.666666666666,30.19607843137253,5
2491,4,0,0,38,0.0,0.0,1.0,38,650,400,250,0.6153846153846154,9,4,5,381.9600924175596,0.35535206258890467,0.14817696414950432,0.2264196424124707,131786.11288265296,2467.4071712018044,134253.52005385477,2446,15,858.1842105263158,34,4,20,33.49879227053139,0.6424632352941178,43.30357142857142,1026.7857142857135,30.199579831932752,0
2492,4,0,0,38,0.0,0.0,1.0,38,1050,900,150,0.8571428571428571,12,9,3,384.31412943465114,0.35489272166903746,0.1562721128272695,0.22836517277976376,131877.806122449,2536.5008503401386,134414.30697278914,2447,16,859.1842105263158,34,4,20,33.345647890588786,0.6433823529411764,43.214285714285715,1027.1428571428573,30.21008403361345,0
2493,4,0,0,38,0.0,0.0,1.0,38,1050,600,450,0.5714285714285714,15,6,9,385.6261311667512,0.35467045993361784,0.15637974235948948,0.23006982656272026,132030.6990504535,2582.897534013605,134613.5965844671,2448,17,860.1842105263158,34,4,20,33.157409552492375,0.6449142156862745,43.06547619047619,1027.7380952380952,30.227591036414566,0
2494,4,1,1,38,0.02564102564102564,0.02564102564102564,0.9743589743589743,39,900,400,500,0.4444444444444444,14,4,10,377.485289055713,0.3594523166891588,0.15446901276860814,0.22741186926039314,132398.00347222236,2195.6597222222417,134593.6631944446,2449,0,839.1025641025641,36,3,21,32.995951417004065,0.6443865740740741,42.70833333333334,1029.1666666666679,28.587962962962997,0
2495,4,0,0,38,0.0,0.0,1.0,38,1050,700,350,0.6666666666666666,14,7,7,381.72821219156185,0.3544926505452821,0.15363044472712906,0.2301604633307199,132429.5361910083,2510.4180183102685,134939.95420931856,2450,19,862.1842105263158,33,5,21,32.85497777513196,0.651199494949495,42.677696078431374,1029.2892156862747,31.190582293523477,0
2496,4,1,1,38,0.02564102564102564,0.02564102564102564,0.9743589743589743,39,700,300,400,0.42857142857142855,11,3,8,375.32508935968343,0.36113922627080525,0.1489158711252545,0.22777442660018915,132673.81660997713,2159.1624149659706,134832.9790249431,2451,0,841.0512820512821,34,5,17,32.7736210615515,0.6513480392156863,42.44047619047618,1030.2380952380938,30.30112044817923,0
2497,4,0,0,38,0.0,0.0,1.0,38,850,700,150,0.8235294117647058,10,7,3,386.4655422120554,0.35410739687055476,0.1612863826828761,0.23379913255636428,132555.70461180786,2645.6424512206695,135201.34706302852,2452,21,864.1842105263158,33,5,21,32.60579059066205,0.6524621212121213,42.55514705882352,1029.7794117647052,31.205436720142583,0
2498,4,0,0,38,0.0,0.0,1.0,38,800,500,300,0.625,11,5,6,382.95555971061543,0.35332207207207206,0.162446623339219,0.23226006024007445,132650.3703503459,2559.8393646674176,135210.20971501333,2453,22,865.1842105263158,33,5,17,32.60072170671741,0.653409090909091,42.46323529411764,1030.1470588235284,31.216577540106922,0
2499,4,0,0,38,0.0,0.0,1.0,38,900,500,400,0.5555555555555556,13,5,8,381.97709924106744,0.3524478425794215,0.1589243354551202,0.23225201934332135,132745.06987997398,2541.115346261046,135286.18522623501,2454,23,866.1842105263158,33,5,17,32.5304980774567,0.6543560606060606,42.37132352941176,1030.5147058823525,31.227718360071286,0
2500,4,1,0,39,0.02564102564102564,0.0,1.0,39,1050,900,150,0.8571428571428571,12,9,3,368.6016602737634,0.3571187584345479,0.15324854369506502,0.22609133684307914,133072.72002551024,2010.1651077097545,135082.88513322,2455,0,844.9487179487179,34,5,18,32.54562324525979,0.6553308823529411,42.05357142857143,1031.7857142857147,30.346638655462197,0
2501,4,0,0,39,0.0,0.0,1.0,39,1100,700,400,0.6363636363636364,15,7,8,365.8228336452974,0.3566408007197481,0.15029722296158288,0.22494212536912972,133164.85969387757,1942.949263038551,135107.80895691612,2456,1,845.9487179487179,34,5,19,32.52475009611688,0.65625,41.964285714285715,1032.1428571428573,30.35714285714286,0
2502,4,0,0,39,0.0,0.0,1.0,39,700,400,300,0.5714285714285714,10,4,6,367.26786221431126,0.35644399460188936,0.15400583731802775,0.22601700732862268,133195.58000283447,1983.6911848072573,135179.27118764172,2457,2,846.9487179487179,34,5,19,32.456608234344365,0.6565563725490196,41.93452380952381,1032.2619047619048,30.360644257703083,0
2503,4,0,0,39,0.0,0.0,1.0,39,900,700,200,0.7777777777777778,11,7,4,367.3995111722336,0.35633153396311296,0.15481597123663593,0.22628469892653474,133226.30385487527,1989.4557823129257,135215.7596371882,2458,3,847.9487179487179,34,5,19,32.422355473554745,0.6568627450980392,41.904761904761905,1032.3809523809523,30.364145658263304,0
2504,4,0,0,39,0.0,0.0,1.0,39,1100,900,200,0.8181818181818182,13,9,4,370.66664451992773,0.3555161943319838,0.15890046552870718,0.22886356876942177,133318.49666950124,2083.3439625850465,135401.8406320863,2459,4,848.9487179487179,34,5,20,32.24543707973102,0.657781862745098,41.8154761904762,1032.738095238096,30.374649859944004,0
2505,4,0,0,39,0.0,0.0,1.0,39,1400,1200,200,0.8571428571428571,16,12,4,344.75664146999196,0.35596603688708955,0.09542850905163247,0.21340483923447612,133412.42953746562,1398.9642275377107,134811.39376500333,2460,5,849.9487179487179,35,4,19,32.8203189185152,0.656547619047619,41.72453703703703,1033.101851851851,29.517195767195744,4
2506,4,0,0,39,0.0,0.0,1.0,39,1100,700,400,0.6363636363636364,15,7,8,344.91735521644637,0.3561347278452542,0.09253739914434189,0.21419415730757055,133532.02830289773,1411.502807784625,134943.53111068235,2461,6,850.9487179487179,35,4,19,32.696435237028744,0.6577380952380952,41.60879629629629,1033.5648148148143,29.530423280423268,0
2507,4,0,0,39,0.0,0.0,1.0,39,1350,900,450,0.6666666666666666,18,9,9,345.40879814289144,0.3560222672064777,0.0918738864358204,0.21571757016093798,133741.45507812512,1439.0950520833476,135180.55013020846,2462,7,851.9487179487179,35,4,17,32.47419436052367,0.6598214285714286,41.40625000000001,1034.375000000001,29.553571428571455,0
2508,4,0,0,39,0.0,0.0,1.0,39,900,600,300,0.6666666666666666,12,6,6,345.8093302024262,0.3547570850202429,0.09332404165196917,0.21667002251856296,133861.20119866688,1458.0904653206455,135319.29166398753,2463,8,852.9487179487179,35,4,17,32.34409368825262,0.6610119047619047,41.29050925925926,1034.8379629629633,29.56679894179895,0
2509,4,0,0,39,0.0,0.0,1.0,39,550,300,250,0.5454545454545454,8,3,5,348.38445118311097,0.35399797570850206,0.09631942473270927,0.21863874715302176,133921.09435281626,1531.2053915895,135452.29974440575,2464,9,853.9487179487179,35,4,17,32.21758638040925,0.6616071428571428,41.232638888888886,1035.069444444444,29.57341269841268,0
2510,4,0,0,39,0.0,0.0,1.0,39,1050,700,350,0.6666666666666666,14,7,7,349.9062787185894,0.35371682411156097,0.09812722488778869,0.22013091205460608,134010.9592013888,1578.2552083333233,135589.2144097221,2465,10,854.9487179487179,35,4,17,32.088363514419854,0.6625,41.14583333333333,1035.4166666666658,29.58333333333331,0
2511,4,0,0,39,0.0,0.0,1.0,39,350,200,150,0.5714285714285714,5,2,3,349.9062787185894,0.35371682411156097,0.09812722488778869,0.22013091205460608,134010.9592013888,1578.2552083333233,135589.2144097221,2466,11,855.9487179487179,35,4,17,32.088363514419854,0.6625,41.14583333333333,1035.4166666666658,29.58333333333331,0
2512,4,0,1,38,0.0,0.02564102564102564,0.9743589743589743,39,1250,900,350,0.72,16,9,7,348.6901196276581,0.35276090868196136,0.0962861072902339,0.2207280857736767,134238.12044330928,1561.501255193884,135799.62169850315,2467,12,856.9487179487179,37,2,17,31.892899340457806,0.6607545045045047,40.92653508771929,1036.2938596491213,28.007942152678954,0
2513,4,0,0,38,0.0,0.0,1.0,38,750,400,350,0.5333333333333333,11,4,7,358.79347826086996,0.34718764817449027,0.099101830663616,0.22671016483516468,134171.3334956576,2027.9598855612153,136199.29338121883,2468,37,880.1842105263158,36,2,17,31.697916666666657,0.6620370370370372,40.99099099099098,1036.0360360360344,28.778778778778733,0
2514,4,0,0,38,0.0,0.0,1.0,38,900,600,300,0.6666666666666666,12,6,6,360.90931660609067,0.34656531531531537,0.10248660333872817,0.22859245978842732,134258.85080604232,2091.05401854555,136349.90482458787,2469,38,881.1842105263158,36,2,17,31.55560686732587,0.6629050925925927,40.90653153153152,1036.3738738738723,28.78816316316312,0
2515,4,0,0,38,0.0,0.0,1.0,38,1100,900,200,0.8181818181818182,13,9,4,359.79607474269636,0.3466245851114272,0.09536293204494117,0.2282510591320825,134317.2115316328,2065.361095893173,136382.57262752598,2470,39,882.1842105263158,36,2,17,31.526118051783445,0.6634837962962964,40.850225225225216,1036.5990990990979,28.794419419419384,0
2516,4,0,0,38,0.0,0.0,1.0,38,450,100,350,0.2222222222222222,8,1,7,359.79607474269636,0.3466245851114272,0.09536293204494117,0.2282510591320825,134317.2115316328,2065.361095893173,136382.57262752598,2471,40,883.1842105263158,36,2,17,31.526118051783445,0.6634837962962964,40.850225225225216,1036.5990990990979,28.794419419419384,0
2517,4,0,0,38,0.0,0.0,1.0,38,400,200,200,0.5,6,2,4,358.7417532577655,0.3469357515410147,0.09444641366614492,0.22776390210282643,134346.39665002818,2039.1323756188394,136385.52902564703,2472,41,884.1842105263158,36,2,17,31.524277645014124,0.6637731481481483,40.82207207207206,1036.7117117117098,28.797547547547495,0
2518,4,0,0,38,0.0,0.0,1.0,38,800,600,200,0.75,10,6,4,360.76497538303994,0.3467134898055951,0.0985349324891871,0.22996582617669037,134492.36979800725,2104.02729587694,136596.39709388418,2473,42,885.1842105263158,36,2,17,31.32599609162958,0.6652199074074074,40.6813063063063,1037.274774774773,28.81318818818814,0
2519,4,0,0,38,0.0,0.0,1.0,38,750,600,150,0.8,9,6,3,360.1924983377359,0.34643195827406353,0.10469553875510273,0.23016406272079928,134581.66099773228,2095.0863042441083,136676.7473019764,2474,43,886.1842105263158,34,4,17,31.251673168119947,0.670343137254902,40.59523809523809,1037.6190476190463,30.518207282913128,0
2520,4,0,0,38,0.0,0.0,1.0,38,900,400,500,0.4444444444444444,14,4,10,360.23803317330396,0.3460763394973921,0.10736407432897432,0.23058408026467395,134643.43112244876,2100.7369614512163,136744.16808389997,2475,44,887.1842105263158,34,4,17,31.188823889271234,0.6709558823529413,40.53571428571427,1037.857142857141,30.52521008403356,0
2521,4,0,0,38,0.0,0.0,1.0,38,1200,800,400,0.6666666666666666,16,8,8,356.9947105215018,0.3453354670459934,0.10720621779166972,0.22928629345865514,134767.0138888888,2022.2222222222035,136789.23611111098,2476,45,888.1842105263158,34,4,17,31.149678972712664,0.6721813725490197,40.41666666666666,1038.3333333333323,30.53921568627448,0
2522,4,0,0,38,0.0,0.0,1.0,38,650,400,250,0.6153846153846154,9,4,5,358.8594739151287,0.34583926031294454,0.10543811385409896,0.2308768473772551,134828.82653061207,2076.920351473903,136905.74688208598,2477,46,889.1842105263158,34,4,17,31.03961294513221,0.6727941176470589,40.35714285714285,1038.571428571427,30.546218487394913,0
2523,4,0,0,38,0.0,0.0,1.0,38,750,300,450,0.4,12,3,9,356.2233276937453,0.3450539355144618,0.08217402803491125,0.22575937009890204,134280.73459201376,1966.786024305537,136247.5206163193,2478,47,890.1842105263158,35,3,17,31.655150753768837,0.6651785714285714,40.88541666666666,1036.4583333333321,29.6130952380952,2
2524,4,0,0,38,0.0,0.0,1.0,38,1050,800,250,0.7619047619047619,13,8,5,356.5940365979477,0.34555772878141294,0.09117265202295854,0.22673711667005064,134400.7218390989,1985.299184456444,136386.02102355534,2479,48,891.1842105263158,35,3,17,31.525677158909104,0.6663690476190476,40.769675925925924,1036.921296296296,29.626322751322746,0
2525,4,0,0,38,0.0,0.0,1.0,38,650,400,250,0.6153846153846154,9,4,5,358.7524443934526,0.34555772878141294,0.09276440571472166,0.2288610789393962,134520.76266986024,2051.930485896774,136572.693155757,2480,49,892.1842105263158,35,3,17,31.349831715571426,0.6675595238095238,40.65393518518518,1037.3842592592591,29.639550264550262,0
2526,4,0,0,38,0.0,0.0,1.0,38,1200,900,300,0.75,15,9,6,359.1478109598023,0.34517247510668564,0.09583384691236274,0.22986998007684128,134640.85708429784,2071.19381751543,136712.05090181326,2481,50,893.1842105263158,35,3,18,31.21968049514889,0.66875,40.53819444444444,1037.8472222222222,29.652777777777775,0
2527,4,0,0,38,0.0,0.0,1.0,38,1150,900,250,0.782608695652174,14,9,5,363.5350835001845,0.34539473684210525,0.0898961450448863,0.2332553432758695,134730.96305941365,2195.8863811728484,136926.8494405865,2482,51,894.1842105263158,35,3,18,31.01588628762542,0.6696428571428571,40.45138888888889,1038.194444444445,29.66269841269843,0
2528,4,0,0,38,0.0,0.0,1.0,38,1150,900,250,0.782608695652174,14,9,5,364.3218162490979,0.34641714082503555,0.09309778624835041,0.23472995698748428,134881.20666420192,2228.033237954403,137109.23990215632,2483,52,895.1842105263158,35,3,17,30.845519962859807,0.6711309523809523,40.30671296296297,1038.773148148149,29.67923280423283,0
2529,4,0,0,38,0.0,0.0,1.0,38,700,400,300,0.5714285714285714,10,4,6,362.9841721115834,0.34618006164058795,0.08434592997696355,0.23464613976889212,135001.46182966843,2200.6787712191635,137202.1406008876,2484,53,896.1842105263158,35,3,17,30.76031573671901,0.6723214285714285,40.190972222222236,1039.236111111113,29.69246031746037,0
2530,4,0,0,38,0.0,0.0,1.0,38,600,300,300,0.5,9,3,6,364.1892748105803,0.34564663347558083,0.08967762352100017,0.23581715047395993,135061.6095062802,2237.597924168402,137299.2074304486,2485,54,897.1842105263158,35,3,17,30.669028133466945,0.6729166666666665,40.13310185185186,1039.467592592594,29.699074074074115,0
2531,4,0,0,38,0.0,0.0,1.0,38,600,400,200,0.6666666666666666,8,4,4,363.4293128228688,0.3460022522522523,0.08551533012649593,0.23571736585471728,135121.770578811,2221.442445773334,137343.21302458434,2486,55,898.1842105263158,35,3,18,30.628803480648642,0.6735119047619047,40.07523148148149,1039.699074074075,29.705687830687857,0
2532,4,0,1,37,0.0,0.02631578947368421,0.9736842105263158,38,700,400,300,0.5714285714285714,10,4,6,363.0358194918995,0.3458688952110005,0.08586024277077331,0.23565851172797891,135151.85613854614,2212.992969821691,137364.84910836784,2487,56,899.1842105263158,35,3,18,30.60904571089344,0.6738095238095237,40.046296296296305,1039.8148148148161,29.708994708994748,0
2533,4,0,0,37,0.0,0.0,1.0,37,1550,1400,150,0.9032258064516129,17,14,3,363.8205239686715,0.345970970970971,0.08959298602195509,0.23715610514535104,135302.33417191805,2445.153222522313,137747.48739444037,2488,57,906.6756756756756,35,2,18,30.43870749434496,0.675297619047619,39.90162037037038,1040.3935185185198,29.725529100529137,0
2534,4,0,0,37,0.0,0.0,1.0,37,400,200,200,0.5,6,2,4,363.5567499431361,0.34537662662662666,0.08965722479235971,0.23738117202169495,135362.54882812515,2442.39366319446,137804.9424913196,2489,58,907.6756756756756,35,2,18,30.38559392726058,0.6758928571428571,39.84375000000001,1040.6250000000011,29.73214285714289,0
2535,4,0,0,37,0.0,0.0,1.0,37,1050,800,250,0.7619047619047619,13,8,5,363.09285131604287,0.3457207207207207,0.08650812253213869,0.23767518957325282,135452.89592978416,2436.395640432125,137889.2915702163,2490,59,908.6756756756756,35,2,18,30.30770513675785,0.6767857142857141,39.75694444444446,1040.972222222224,29.742063492063544,0
2536,4,0,0,37,0.0,0.0,1.0,37,800,500,300,0.625,11,5,6,361.4979827431036,0.34500125125125125,0.0840754077780419,0.23762749062857494,135603.54141214432,2404.0813346622244,138007.62274680653,2491,60,909.6756756756756,35,2,19,30.199304552357678,0.6782738095238094,39.612268518518526,1041.5509259259268,29.758597883597908,0
2537,4,0,0,37,0.0,0.0,1.0,37,700,600,100,0.8571428571428571,8,6,2,360.347213889433,0.34471971971971976,0.08376494423803327,0.2372760322608299,135664.6843112245,2377.2815519276173,138041.96586315212,2492,61,910.6756756756756,34,3,19,30.16845693825468,0.6810661764705882,39.55357142857143,1041.7857142857144,30.640756302521012,0
2538,4,0,0,37,0.0,0.0,1.0,37,1050,900,150,0.8571428571428571,12,9,3,360.66164954094774,0.34331206206206205,0.0872359339696025,0.238516118080101,135819.75623582755,2396.9954648525936,138216.75170068015,2493,62,911.6756756756756,34,3,19,30.006091061367442,0.6825980392156863,39.4047619047619,1042.3809523809516,30.658263305322105,0
2539,4,0,0,37,0.0,0.0,1.0,37,1100,800,300,0.7272727272727273,14,8,6,359.3160197356637,0.3430930930930931,0.08050091653654157,0.23804006814258263,135881.80980725624,2364.902210884353,138246.7120181406,2494,63,912.6756756756756,34,3,17,29.97949493796149,0.6832107843137255,39.345238095238095,1042.6190476190475,30.665266106442573,0
2540,4,0,0,37,0.0,0.0,1.0,37,600,300,300,0.5,9,3,6,361.82300172493296,0.34234234234234234,0.08383037678619365,0.23990974050784916,135912.84190759636,2435.2784863945567,138348.12039399092,2495,64,913.6756756756756,34,3,17,29.883310499676515,0.6835171568627451,39.31547619047619,1042.7380952380952,30.668767507002798,0
2541,4,0,0,37,0.0,0.0,1.0,37,550,300,250,0.5454545454545454,8,3,5,362.0845582869415,0.34240490490490494,0.08391953597433077,0.24029247959042488,135943.8775510205,2444.6357709750687,138388.51332199556,2496,65,914.6756756756756,34,3,17,29.845652587519027,0.6838235294117647,39.28571428571429,1042.8571428571436,30.672268907563048,0
2542,4,0,0,37,0.0,0.0,1.0,37,750,700,50,0.9333333333333333,8,7,1,363.5687367007386,0.3427177177177177,0.08263825719615836,0.24233307811269772,136099.10891439914,2496.2762188208703,138595.38513322,2497,66,915.6756756756756,34,3,18,29.652738163148893,0.6853553921568627,39.136904761904766,1043.4523809523814,30.68977591036416,0
2543,4,0,0,37,0.0,0.0,1.0,37,1150,800,350,0.6956521739130435,15,8,7,365.77089148894424,0.3426238738738739,0.08955591851829037,0.24487104720290373,136254.42885487515,2567.5807823129157,138822.00963718808,2498,67,916.6756756756756,34,3,18,29.44103952869632,0.6868872549019608,38.988095238095234,1044.0476190476181,30.70728291316524,0
2544,4,0,0,37,0.0,0.0,1.0,37,800,400,400,0.5,12,4,8,365.705574040715,0.34296796796796797,0.0873218785231551,0.2456891812123457,136378.7485827665,2574.893707482995,138953.6422902495,2499,68,917.6756756756756,34,3,19,29.31934313502013,0.6881127450980392,38.86904761904762,1044.5238095238099,30.721288515406172,0
2545,4,0,0,37,0.0,0.0,1.0,37,450,400,50,0.8888888888888888,5,4,1,365.705574040715,0.34296796796796797,0.0873218785231551,0.2456891812123457,136378.7485827665,2574.893707482995,138953.6422902495,2500,69,918.6756756756756,34,3,19,29.31934313502013,0.6881127450980392,38.86904761904762,1044.5238095238099,30.721288515406172,0
2546,4,0,0,37,0.0,0.0,1.0,37,1100,800,300,0.7272727272727273,14,8,6,362.62906069000235,0.34240490490490494,0.08724513987671867,0.2444821731748727,136503.12500000003,2499.9999999999995,139003.12500000003,2501,70,919.6756756756756,34,3,19,29.27631578947367,0.6893382352941176,38.75,1045.0000000000002,30.735294117647065,0
2547,4,0,0,37,0.0,0.0,1.0,37,1150,700,450,0.6086956521739131,16,7,9,364.05607069286674,0.3417167167167167,0.08699131933756066,0.24587786928333616,136565.3344671202,2543.487811791382,139108.8222789116,2502,71,920.6756756756756,34,3,19,29.17734434320423,0.6899509803921569,38.69047619047619,1045.2380952380954,30.74229691876751,0
2548,4,0,0,37,0.0,0.0,1.0,37,950,800,150,0.8421052631578947,11,8,3,363.3012995975463,0.3410910910910911,0.09186850785211442,0.24623754750500348,136689.7959183673,2531.9160997732383,139221.71201814053,2503,72,921.6756756756756,34,3,19,29.07369459623558,0.6911764705882353,38.57142857142857,1045.7142857142853,30.756302521008394,0
2549,4,0,0,37,0.0,0.0,1.0,37,1000,700,300,0.7,13,7,6,362.08134608185225,0.3406844344344344,0.09437316242049953,0.24628257502843023,136814.31405895698,2507.582199546493,139321.89625850346,2504,73,922.6756756756756,34,3,20,28.98222955545441,0.6924019607843137,38.452380952380956,1046.1904761904768,30.77030812324932,0
2550,4,0,0,37,0.0,0.0,1.0,37,550,400,150,0.7272727272727273,7,4,3,362.08134608185225,0.3406844344344344,0.09437316242049953,0.24628257502843023,136814.31405895698,2507.582199546493,139321.89625850346,2505,74,923.6756756756756,34,3,20,28.98222955545441,0.6924019607843137,38.452380952380956,1046.1904761904768,30.77030812324932,0
2551,4,0,0,37,0.0,0.0,1.0,37,850,600,250,0.7058823529411765,11,6,5,363.0220447080069,0.3407157157157157,0.09833545002506217,0.24714180874815445,136845.45245181414,2535.5831916099846,139381.0356434241,2506,75,924.6756756756756,34,3,20,28.92678347934918,0.6927083333333333,38.42261904761905,1046.3095238095243,30.77380952380954,0
2552,4,0,0,37,0.0,0.0,1.0,37,950,700,250,0.7368421052631579,12,7,5,364.1523207962082,0.33971471471471476,0.09610224349221252,0.2487949772153116,136970.0414540817,2575.5916950113424,139545.63314909302,2507,76,925.6756756756756,34,3,16,28.773835247734933,0.6939338235294118,38.30357142857143,1046.7857142857147,30.787815126050432,0
2553,4,0,0,37,0.0,0.0,1.0,37,1450,1200,250,0.8275862068965517,17,12,5,365.13152968212097,0.33861986986986986,0.09559155608945313,0.25035557806809183,137094.68714569163,2611.5185657596385,139706.20571145127,2508,77,926.6756756756756,34,3,17,28.62481527793566,0.6951593137254901,38.18452380952381,1047.2619047619048,30.801820728291318,0
2554,4,0,0,37,0.0,0.0,1.0,37,1150,700,450,0.6086956521739131,16,7,9,368.49049843410455,0.33758758758758756,0.09852074549268042,0.253564102949066,137219.38952664396,2712.8082482993186,139932.19777494328,2509,78,927.6756756756756,34,3,17,28.413437866909064,0.6963848039215685,38.06547619047619,1047.7380952380952,30.81582633053221,0
2555,4,0,0,37,0.0,0.0,1.0,37,1050,700,350,0.6666666666666666,14,7,7,366.7761881595045,0.33765015015015015,0.09946756572523441,0.25261064226760255,137250.57397959192,2668.0484693877684,139918.6224489797,2510,79,928.6756756756756,34,3,17,28.427488070892984,0.6966911764705881,38.03571428571429,1047.8571428571436,30.819327731092457,0
2556,4,0,0,37,0.0,0.0,1.0,37,650,400,250,0.6153846153846154,9,4,5,365.6856728473992,0.33730605605605607,0.09890976970381726,0.25208543289550955,137281.76197562367,2640.3946995464976,139922.15667517018,2511,80,929.6756756756756,34,3,17,28.425205422393876,0.6969975490196079,38.00595238095239,1047.9761904761913,30.822829131652686,0
2557,4,0,1,36,0.0,0.02702702702702703,0.972972972972973,37,900,700,200,0.7777777777777778,11,7,4,365.52076250944646,0.33643018018018017,0.10131912516650177,0.2526511644158704,137375.34722222234,2642.7083333333435,140018.05555555568,2512,81,930.6756756756756,34,3,17,28.336976682564913,0.6979166666666666,37.91666666666667,1048.3333333333342,30.833333333333357,0
2558,4,0,0,36,0.0,0.0,1.0,36,1100,900,200,0.8181818181818182,13,9,4,371.4399888596368,0.33544973544973544,0.0936610935734048,0.256410510469449,137330.38562391873,3001.9993812476,140332.38500516632,2513,82,921.3611111111111,33,3,17,28.226328968393158,0.699810606060606,37.95955882352941,1048.1617647058827,31.76247771836008,0
2559,4,0,0,36,0.0,0.0,1.0,36,1150,1100,50,0.9565217391304348,12,11,1,370.4305636574646,0.33559854497354497,0.09450123036153713,0.25581498925521373,137344.14859693873,2975.294075963715,140319.44267290246,2514,83,922.3611111111111,34,2,17,28.239163354154837,0.6976102941176471,37.94642857142857,1048.2142857142853,30.829831932773097,0
2560,4,0,0,36,0.0,0.0,1.0,36,500,200,300,0.4,8,2,6,371.2077363063988,0.3357804232804233,0.09662603780250834,0.2565820506996978,137375.34722222234,2998.9583333333435,140374.30555555568,2515,84,923.3611111111111,34,2,17,28.187930577636454,0.6979166666666666,37.91666666666667,1048.3333333333342,30.833333333333357,0
2561,4,0,0,36,0.0,0.0,1.0,36,900,600,300,0.6666666666666666,12,6,6,371.2713139320344,0.3350694444444444,0.09924509024860972,0.257319355187041,137468.964356576,3007.6566043083976,140476.6209608844,2516,85,924.3611111111111,34,2,17,28.09366367729973,0.6988357843137255,37.827380952380956,1048.6904761904766,30.843837535014018,0
2562,4,0,0,36,0.0,0.0,1.0,36,650,400,250,0.6153846153846154,9,4,5,369.485197014537,0.335218253968254,0.09805776264346089,0.2563121721022103,137500.17715419506,2960.8560090703013,140461.03316326535,2517,86,925.3611111111111,34,2,17,28.109629209231947,0.6991421568627451,37.79761904761905,1048.809523809524,30.84733893557424,0
2563,4,0,0,36,0.0,0.0,1.0,36,550,300,250,0.5454545454545454,8,3,5,369.1230921322002,0.3350694444444444,0.09515929750242691,0.2567546812123979,137593.8368055556,2957.8125000000055,140551.6493055556,2518,87,926.3611111111111,34,2,18,28.0265422292825,0.7000612745098038,37.708333333333336,1049.166666666667,30.85784313725491,0
2564,4,0,0,36,0.0,0.0,1.0,36,950,600,350,0.631578947368421,13,6,7,367.0488959898897,0.33465608465608465,0.09322808344362477,0.2557735982727968,137656.29428854882,2905.3181689342446,140561.61245748305,2519,88,927.3611111111111,34,2,18,28.01923804121762,0.7006740196078431,37.648809523809526,1049.4047619047624,30.864845938375364,0
2565,4,0,0,36,0.0,0.0,1.0,36,950,700,250,0.7368421052631579,12,7,5,368.7554081861361,0.3338128306878307,0.10113782414757733,0.25766126698774544,137750.0070861678,2959.2120181405917,140709.2191043084,2520,89,928.3611111111111,34,2,18,27.88188931730551,0.7015931372549019,37.55952380952381,1049.7619047619048,30.875350140056025,0
2566,4,0,0,36,0.0,0.0,1.0,36,900,700,200,0.7777777777777778,11,7,4,365.2690703724437,0.33389550264550266,0.09697423529259197,0.25592728242203383,137844.67099493,2870.0931383582983,140714.7641332883,2521,90,929.3611111111111,33,3,18,27.87993056365969,0.704861111111111,37.469362745098046,1050.122549019609,31.82189542483664,0
2567,4,0,0,36,0.0,0.0,1.0,36,800,600,200,0.75,10,6,4,362.75710422200643,0.3344080687830688,0.09570349386213417,0.255086170897148,137968.79428854884,2809.8320578231414,140778.62634637198,2522,91,930.3611111111111,34,2,18,27.82341831916903,0.7037377450980391,37.35119047619048,1050.5952380952388,30.89985994397761,0
2568,4,0,0,36,0.0,0.0,1.0,36,1150,800,350,0.6956521739130435,15,8,7,361.3558950400636,0.3339285714285714,0.09016764839148128,0.25479631321195556,138062.61337868494,2777.9478458049985,140840.56122448994,2523,92,931.3611111111111,34,2,18,27.767708805316413,0.704656862745098,37.261904761904766,1050.9523809523819,30.910364145658292,0
2569,4,0,0,36,0.0,0.0,1.0,36,600,400,200,0.6666666666666666,8,4,4,360.3469250733289,0.33407738095238093,0.09162670995834454,0.2543167866884428,138093.89349489793,2752.3419784580447,140846.23547335598,2524,93,932.3611111111111,34,2,18,27.763383924189228,0.7049632352941176,37.232142857142854,1051.0714285714282,30.913865546218478,0
2570,4,0,0,36,0.0,0.0,1.0,36,500,400,100,0.8,6,4,2,359.2451012168622,0.3332175925925926,0.08925942701845768,0.25400268125269104,138156.46435657603,2726.406604308398,140882.87096088444,2525,94,933.3611111111111,34,2,18,27.730674140338955,0.7055759803921569,37.17261904761905,1051.3095238095243,30.92086834733895,0
2571,4,0,0,36,0.0,0.0,1.0,36,1000,700,300,0.7,13,7,6,359.67739771078874,0.3328207671957672,0.08711335018931576,0.25477389366314307,138219.04939058947,2742.8535997732342,140961.9029903627,2526,95,934.3611111111111,34,2,18,27.657647458394653,0.7061887254901962,37.113095238095234,1051.5476190476184,30.927871148459364,0
2572,4,0,0,36,0.0,0.0,1.0,36,850,600,250,0.7058823529411765,11,6,5,358.23395693385396,0.33265542328042325,0.08854500647530017,0.2546833047002788,138344.26197562346,2711.922477324251,141056.18445294772,2527,96,935.3611111111111,34,2,19,27.572281317189095,0.7074142156862746,36.99404761904761,1052.0238095238085,30.94187675070025,0
2573,4,0,0,36,0.0,0.0,1.0,36,750,700,50,0.9333333333333333,8,7,1,358.23395693385396,0.3323412698412698,0.08854500647530017,0.2546833047002788,138344.26197562346,2711.922477324251,141056.18445294772,2528,97,936.3611111111111,34,2,19,27.572281317189095,0.7074142156862746,36.99404761904761,1052.0238095238085,30.94187675070025,0
2574,4,0,1,35,0.0,0.027777777777777776,0.9722222222222222,36,500,300,200,0.6,7,3,4,358.241837767576,0.3321097883597884,0.09278010332993913,0.25515709943816295,138406.8895266439,2716.6276927437507,141123.51721938766,2529,98,937.3611111111111,34,2,19,27.51041784515592,0.7080269607843137,36.9345238095238,1052.2619047619041,30.94887955182071,0
2575,4,0,0,35,0.0,0.0,1.0,35,950,700,250,0.7368421052631579,12,7,5,361.34729298274976,0.33042717086834733,0.10302002035968783,0.2578427293995553,138469.53125,3007.118055555555,141476.64930555556,2530,99,949.2285714285714,34,1,19,27.367049353391394,0.708639705882353,36.875,1052.5,30.955882352941178,0
2576,4,0,0,35,0.0,0.0,1.0,35,850,700,150,0.8235294117647058,10,7,3,362.41507587448007,0.3303921568627451,0.10077228810547045,0.2588428191342611,138500.85742630388,3038.959750566893,141539.81717687077,2531,100,950.2285714285714,34,1,19,27.308112794993587,0.7089460784313726,36.845238095238095,1052.6190476190477,30.959383753501402,0
2577,4,0,0,35,0.0,0.0,1.0,35,600,500,100,0.8333333333333334,7,5,2,362.41507587448007,0.3303921568627451,0.10077228810547045,0.2588428191342611,138500.85742630388,3038.959750566893,141539.81717687077,2532,101,951.2285714285714,34,1,19,27.308112794993587,0.7089460784313726,36.845238095238095,1052.6190476190477,30.959383753501402,0
2578,4,0,0,35,0.0,0.0,1.0,35,650,400,250,0.6153846153846154,9,4,5,362.41507587448007,0.3303921568627451,0.10077228810547045,0.2588428191342611,138500.85742630388,3038.959750566893,141539.81717687077,2533,102,952.2285714285714,34,1,19,27.308112794993587,0.7089460784313726,36.845238095238095,1052.6190476190477,30.959383753501402,0
2579,4,0,0,35,0.0,0.0,1.0,35,700,600,100,0.8571428571428571,8,6,2,360.6534174266873,0.3306372549019608,0.10146524288783731,0.25782200244981357,138532.18714569148,2992.421343537399,141524.60848922888,2534,103,953.2285714285714,34,1,19,27.323636397904174,0.7092524509803921,36.81547619047618,1052.7380952380943,30.962885154061595,0
2580,4,0,0,35,0.0,0.0,1.0,35,550,200,350,0.36363636363636365,9,2,7,360.7627439873942,0.33060224089635853,0.09876591070620933,0.2581380022511743,138563.52040816325,2997.711167800451,141561.2315759637,2535,104,954.2285714285714,34,1,19,27.28992348861751,0.7095588235294118,36.785714285714285,1052.8571428571427,30.96638655462184,0
2581,4,0,0,35,0.0,0.0,1.0,35,1200,900,300,0.75,15,9,6,358.35465567430515,0.33028711484593837,0.09318889947209552,0.25760197790917366,138720.23986678015,2942.2087585034105,141662.44862528355,2536,105,955.2285714285714,34,1,20,27.199165630768064,0.7110906862745098,36.636904761904766,1053.4523809523816,30.983893557422988,0
2582,4,0,0,35,0.0,0.0,1.0,35,800,600,200,0.75,10,6,4,357.8289261729107,0.33000700280112044,0.08824830124118344,0.2577008808426717,138782.95245181414,2932.1109693877634,141715.0634212019,2537,106,956.2285714285714,34,1,20,27.151357662034425,0.711703431372549,36.577380952380956,1053.6904761904768,30.990896358543438,0
2583,4,0,0,35,0.0,0.0,1.0,35,1100,1000,100,0.9090909090909091,12,10,2,357.5524429545742,0.3301470588235294,0.08510102640242745,0.25774057207116385,138814.31405895695,2926.6794217687147,141740.99348072568,2538,107,957.2285714285714,34,1,21,27.127814806446764,0.7120098039215685,36.54761904761905,1053.809523809524,30.99439775910365,0
2584,4,0,0,35,0.0,0.0,1.0,35,850,600,250,0.7058823529411765,11,6,5,357.60540626333693,0.32965686274509803,0.08403664989030846,0.25873802923759087,138939.79591836737,2937.12443310658,141876.92035147393,2539,108,958.2285714285714,34,1,22,27.003114649202047,0.713235294117647,36.42857142857143,1054.2857142857144,31.00840336134454,0
2585,4,0,0,35,0.0,0.0,1.0,35,850,700,150,0.8235294117647058,10,7,3,355.7217739709286,0.32923669467787114,0.08585944934595702,0.2576146976337299,138971.17524092976,2887.014597505672,141858.18983843544,2540,109,959.2285714285714,34,1,22,27.0219412141056,0.7135416666666666,36.398809523809526,1054.4047619047624,31.011904761904777,0
2586,4,0,0,35,0.0,0.0,1.0,35,450,300,150,0.6666666666666666,6,3,3,357.1992723529802,0.32871148459383753,0.08229603353756887,0.25940865188913154,139065.3344671202,2934.807256235829,142000.14172335604,2541,110,960.2285714285714,34,1,22,26.89051918735892,0.7144607843137254,36.30952380952381,1054.7619047619048,31.022408963585434,0
2587,4,0,0,35,0.0,0.0,1.0,35,850,500,350,0.5882352941176471,12,5,7,356.0970587809579,0.32839635854341737,0.07873503006076654,0.25933346195362605,139159.52558106574,2910.859552154195,142070.38513321994,2542,111,961.2285714285714,34,1,18,26.82711835721539,0.7153799019607843,36.220238095238095,1055.1190476190475,31.032913165266102,0
2588,4,0,0,35,0.0,0.0,1.0,35,950,600,350,0.631578947368421,13,6,7,354.070218534647,0.3279761904761905,0.07831762146482979,0.2583401224123166,139222.33737244908,2858.8966836734826,142081.23405612257,2543,112,962.2285714285714,34,1,18,26.81895093062606,0.7159926470588235,36.16071428571429,1055.3571428571436,31.039915966386577,0
2589,4,0,0,35,0.0,0.0,1.0,35,950,700,250,0.7368421052631579,12,7,5,357.6988317991339,0.32727591036414566,0.08447401059871429,0.26196787276849876,139348.00347222234,2968.9236111111213,142316.92708333346,2544,113,963.2285714285714,34,1,18,26.59990791896869,0.7172181372549019,36.04166666666667,1055.8333333333342,31.053921568627477,0
2590,4,0,0,35,0.0,0.0,1.0,35,600,300,300,0.5,9,3,6,356.0130101719817,0.3273809523809524,0.08629408922531812,0.2609781322500397,139379.42885487538,2924.178004535157,142303.60685941053,2545,114,964.2285714285714,34,1,18,26.613585118376555,0.7175245098039216,36.011904761904766,1055.9523809523816,31.057422969187694,0
2591,4,0,0,35,0.0,0.0,1.0,35,500,200,300,0.4,8,2,6,357.75135082021757,0.32703081232493,0.07890389786028251,0.2629931844099249,139473.72626133807,2979.382794784602,142453.1090561227,2546,115,965.2285714285714,34,1,18,26.475215071941093,0.7184436274509803,35.92261904761906,1056.3095238095252,31.067927170868387,0
2592,4,0,0,35,0.0,0.0,1.0,35,1000,800,200,0.8,12,8,4,356.16742709779817,0.3266456582633053,0.08096579476861177,0.2623224826135236,139536.6089143991,2939.678996598645,142476.28791099775,2547,116,966.2285714285714,34,1,18,26.455399061032875,0.7190563725490196,35.86309523809524,1056.5476190476193,31.0749299719888,0
2593,4,0,0,35,0.0,0.0,1.0,35,500,300,200,0.6,7,3,4,355.673257769507,0.32657563025210085,0.08255971158179354,0.2622056342161251,139568.0555555557,2928.12500000002,142496.18055555574,2548,117,967.2285714285714,34,1,18,26.437631440588863,0.7193627450980391,35.83333333333334,1056.6666666666679,31.078431372549055,0
2594,4,0,0,35,0.0,0.0,1.0,35,750,500,250,0.6666666666666666,10,5,5,356.0018494446004,0.3260854341736695,0.07945553714221387,0.2631923747892262,139662.41673752837,2944.015731292519,142606.4324688209,2549,118,968.2285714285714,34,1,18,26.336486841611283,0.720281862745098,35.74404761904762,1057.0238095238096,31.088935574229694,0
2595,4,0,0,35,0.0,0.0,1.0,35,900,800,100,0.8888888888888888,10,8,2,358.73225077514314,0.3262955182072829,0.0817576478914015,0.2659649291640086,139756.80980725624,3027.0549886621316,142783.86479591837,2550,119,969.2285714285714,34,1,19,26.171845680402313,0.7212009803921569,35.654761904761905,1057.3809523809525,31.09943977591037,0
2596,4,0,0,35,0.0,0.0,1.0,35,1150,800,350,0.6956521739130435,15,8,7,357.60756326830705,0.3260854341736695,0.07661285135395901,0.2656342468290671,139819.7562358278,3000.120464852622,142819.87670068044,2551,120,970.2285714285714,34,1,19,26.13992383310822,0.721813725490196,35.5952380952381,1057.6190476190486,31.10644257703084,0
2597,4,0,0,35,0.0,0.0,1.0,35,750,300,450,0.4,12,3,9,356.5103211278988,0.32682072829131653,0.051877517863360145,0.2614510159284344,139393.29412065074,2944.98553404205,142338.2796546928,2552,121,971.2285714285714,33,2,18,26.58685834203705,0.7200126262626263,35.99877450980392,1056.0049019607845,32.000148544266196,4
2598,4,0,0,35,0.0,0.0,1.0,35,800,600,200,0.75,10,6,4,357.4065600422048,0.3276610644257703,0.052449453099105314,0.2628706951846252,139490.37029027307,2970.954680891978,142461.32497116504,2553,122,972.2285714285714,33,2,18,26.46800077339521,0.720959595959596,35.906862745098046,1056.3725490196086,32.011289364230564,0
2599,4,0,0,35,0.0,0.0,1.0,35,900,600,300,0.6666666666666666,12,6,6,368.7126164435261,0.32794117647058824,0.09445354551837126,0.2528906918239468,137105.6880166283,3110.5193915801724,140216.20740820846,2554,123,973.2285714285714,33,2,17,28.52016537951479,0.69760101010101,38.17401960784314,1047.303921568628,31.736482471776608,7
2600,4,0,0,35,0.0,0.0,1.0,35,600,400,200,0.6666666666666666,8,4,4,364.1072546153738,0.32794117647058824,0.0842462401722508,0.24121417064458722,135881.80980725624,2895.110544217686,138776.92035147393,2555,124,974.2285714285714,34,1,19,29.854609119281413,0.6832107843137255,39.345238095238095,1042.6190476190475,30.665266106442573,5
2601,4,0,0,35,0.0,0.0,1.0,35,600,500,100,0.8333333333333334,7,5,2,363.6133933004941,0.3282563025210084,0.08087139432876267,0.24151758443560475,135974.9167375282,2888.4601757369433,138863.37691326515,2556,125,975.2285714285714,34,1,19,29.77494958718564,0.6841299019607844,39.25595238095237,1042.9761904761892,30.675770308123212,0
2602,4,0,0,35,0.0,0.0,1.0,35,950,800,150,0.8421052631578947,11,8,3,364.844359388469,0.32916666666666666,0.08253606063075547,0.2431833315619719,136099.10891439905,2930.9984410430775,139030.10735544213,2557,126,976.2285714285714,34,1,20,29.619461874881154,0.6853553921568627,39.13690476190476,1043.4523809523807,30.68977591036414,0
2603,4,0,0,35,0.0,0.0,1.0,35,750,500,250,0.6666666666666666,10,5,5,365.04859351999323,0.3290966386554622,0.08414979955021074,0.24353241786881702,136130.16581632633,2938.8251133786634,139068.990929705,2558,127,977.2285714285714,34,1,20,29.58328580120162,0.6856617647058825,39.10714285714285,1043.571428571427,30.693277310924326,0
2604,4,0,0,35,0.0,0.0,1.0,35,900,700,200,0.7777777777777778,11,7,4,365.60936911826616,0.328781512605042,0.07898757268270429,0.2449778286123998,136285.50347222228,2965.4513888888932,139250.95486111118,2559,128,978.2285714285714,34,1,20,29.414405426975254,0.6871936274509804,38.958333333333336,1044.166666666667,30.710784313725497,0
2605,4,0,0,35,0.0,0.0,1.0,35,1050,800,250,0.7619047619047619,13,8,5,363.6668306405065,0.32899159663865546,0.07423425770627401,0.24410475173750282,136347.66333616775,2917.024518140578,139264.68785430834,2560,129,979.2285714285714,34,1,21,29.403425282115574,0.6878063725490196,38.89880952380952,1044.4047619047615,30.717787114845926,0
2606,4,0,0,35,0.0,0.0,1.0,35,600,200,400,0.3333333333333333,10,2,8,364.5522357773067,0.32923669467787114,0.08042328042328006,0.2451299516433617,136409.83737244914,2945.702239229042,139355.5396116782,2561,130,980.2285714285714,34,1,21,29.31861348528015,0.6884191176470588,38.83928571428572,1044.6428571428585,30.724789915966426,0
2607,4,0,0,35,0.0,0.0,1.0,35,500,400,100,0.8,6,4,2,361.26496576672906,0.3293067226890756,0.07931769722814552,0.2433478591354243,136472.02558106574,2860.512329931973,139332.53791099772,2562,131,981.2285714285714,34,1,21,29.342789867456627,0.689031862745098,38.779761904761905,1044.8809523809523,30.731792717086833,0
2608,4,0,0,35,0.0,0.0,1.0,35,650,400,250,0.6153846153846154,9,4,5,362.688087914082,0.3293067226890756,0.06608567406314925,0.24381334868924537,136400.6932429833,2894.4080818601715,139295.10132484348,2563,132,982.2285714285714,33,2,20,29.37636868449866,0.6906565656565657,38.84803921568626,1044.6078431372537,31.654783125371324,2
2609,4,0,0,35,0.0,0.0,1.0,35,1100,800,300,0.7272727272727273,14,8,6,361.20399141163085,0.32923669467787114,0.06021066028099198,0.2443640960136892,136624.81264717883,2869.885530805443,139494.69817798428,2564,133,983.2285714285714,33,2,22,29.192918962216233,0.6928661616161617,38.63357843137254,1045.4656862745087,31.68077837195481,0
2610,4,0,0,35,0.0,0.0,1.0,35,750,600,150,0.8,9,6,3,365.49552457386324,0.32906162464985994,0.05162718915654563,0.24393102564819888,136144.78205497886,2952.0617070357566,139096.8437620146,2565,134,984.2285714285714,33,2,20,29.55710818850791,0.6881313131313131,39.09313725490196,1043.6274509803923,31.625074272133098,2
2611,4,0,0,35,0.0,0.0,1.0,35,850,700,150,0.8235294117647058,10,7,3,362.9608665912553,0.3291316526610644,0.05403048647560915,0.2428958069513671,136240.7205912389,2890.010002162627,139130.73059340153,2566,135,985.2285714285714,33,2,20,29.527991352662685,0.6890782828282829,39.00122549019608,1043.9950980392155,31.636215092097437,0
2612,4,0,1,34,0.0,0.02857142857142857,0.9714285714285714,35,1000,900,100,0.9,11,9,2,360.0883731398331,0.3283613445378151,0.05236921942307382,0.2418465882010083,136368.6912035034,2820.956032535556,139189.64723603896,2567,136,986.2285714285714,33,2,20,29.476001212405656,0.6903409090909091,38.87867647058823,1044.4852941176466,31.651069518716564,0
2613,4,0,0,34,0.0,0.0,1.0,34,650,400,250,0.6153846153846154,9,4,5,358.27817098236176,0.32505199049316696,0.06359496291185107,0.24106719870754803,136432.69903702906,2976.171574634762,139408.87061166382,2568,137,999.6470588235294,33,1,20,29.45979960899317,0.6909722222222222,38.817401960784316,1044.730392156863,31.65849673202615,0
2614,4,0,0,34,0.0,0.0,1.0,34,600,300,300,0.5,9,3,6,356.43111804198855,0.3250891265597148,0.06597382708214039,0.24025993229597134,136496.72188881683,2930.335838379473,139427.0577271963,2569,138,1000.6470588235294,33,1,21,29.44458289355381,0.6916035353535352,38.756127450980394,1044.9754901960787,31.665923945335717,0
2615,4,0,0,34,0.0,0.0,1.0,34,900,700,200,0.7777777777777778,11,7,4,359.27510649629016,0.32429070112893643,0.06851713962659622,0.2432805721132022,136656.84472318337,3019.4804882737376,139676.32521145712,2570,139,1001.6470588235294,33,1,21,29.211595561806526,0.6931818181818181,38.60294117647059,1045.5882352941176,31.684491978609625,0
2616,4,0,0,34,0.0,0.0,1.0,34,850,500,350,0.5882352941176471,12,5,7,358.2482817733053,0.32443924539512775,0.06854933208343095,0.24302788844621512,136720.92013888885,2996.0069444444384,139716.92708333328,2571,140,1002.6470588235294,33,1,21,29.174966799468788,0.6938131313131313,38.541666666666664,1045.833333333333,31.691919191919183,0
2617,4,1,1,34,0.02857142857142857,0.02857142857142857,0.9714285714285714,35,750,500,250,0.6666666666666666,10,5,5,349.9381313643557,0.33088235294117646,0.06269335759781658,0.23887081140958183,136938.8888888888,2584.0277777777674,139522.91666666657,2572,0,974.9714285714285,34,1,21,29.176618895966026,0.6936274509803921,38.33333333333333,1046.6666666666658,30.784313725490172,0
2618,4,0,0,34,0.0,0.0,1.0,34,900,600,300,0.6666666666666666,12,6,6,357.9851167346827,0.32432783719548425,0.0711903876097173,0.24373819192031262,136849.11602508643,2997.989355055737,139847.10538014217,2573,142,1004.6470588235294,33,1,22,29.054911376590923,0.6950757575757576,38.41911764705882,1046.3235294117642,31.706773618538307,0
2619,4,0,0,34,0.0,0.0,1.0,34,850,700,150,0.8235294117647058,10,7,3,359.6583356180025,0.3240121806298277,0.07419559185022484,0.2460016942501676,137009.44536055834,3055.3178164648048,140064.76317702315,2574,143,1005.6470588235294,33,1,19,28.852447422841294,0.6966540404040404,38.26593137254901,1046.936274509803,31.725341651812215,0
2620,4,0,0,34,0.0,0.0,1.0,34,1000,700,300,0.7,13,7,6,357.15014654993627,0.32360368389780153,0.06747121453003846,0.24518572711343795,137137.77641111583,2995.7553885524744,140133.5317996683,2575,144,1006.6470588235294,33,1,20,28.791169416169417,0.6979166666666667,38.143382352941174,1047.4264705882347,31.740196078431353,0
2621,4,0,0,34,0.0,0.0,1.0,34,800,500,300,0.625,11,5,6,359.5127878404584,0.32228535353535354,0.0751832647952797,0.24840649331076572,137362.50030036515,3076.7150855440077,140439.21538590916,2576,145,1007.6470588235294,33,1,23,28.507131166705634,0.7001262626262628,37.928921568627445,1048.2843137254895,31.766191325014834,0
2622,4,0,0,34,0.0,0.0,1.0,34,1000,500,500,0.5,15,5,10,361.16523160722,0.3224524658348188,0.07391274452504581,0.24977918806788718,137394.61873137724,3124.4318591407,140519.05059051793,2577,146,1008.6470588235294,33,1,23,28.432081628677185,0.7004419191919192,37.89828431372548,1048.406862745097,31.769904931669604,0
2623,4,0,0,34,0.0,0.0,1.0,34,600,500,100,0.8333333333333334,7,5,2,359.33325771022425,0.32232248960190135,0.07521381624178436,0.24874234247319385,137426.74091695488,3076.399702037663,140503.14061899253,2578,147,1009.6470588235294,33,1,23,28.44835982546361,0.7007575757575758,37.86764705882352,1048.529411764705,31.773618538324392,0
2624,4,0,0,34,0.0,0.0,1.0,34,750,600,150,0.8,9,6,3,359.1754738405102,0.3222110814022579,0.06990104452996171,0.24955698507100366,137555.26720492102,3081.295655517088,140636.5628604381,2579,148,1010.6470588235294,33,1,23,28.325545171339563,0.7020202020202021,37.74509803921568,1049.019607843136,31.78847296494352,0
2625,4,0,0,34,0.0,0.0,1.0,34,550,500,50,0.9090909090909091,6,5,1,358.5662674788254,0.32265671420083186,0.06619536391991998,0.24959710424013837,137619.5528762975,3069.145881391764,140688.69875768927,2580,149,1011.6470588235294,33,1,23,28.278050299774208,0.7026515151515151,37.68382352941176,1049.2647058823525,31.795900178253106,0
2626,4,0,0,34,0.0,0.0,1.0,34,800,500,300,0.625,11,5,6,357.6041786425085,0.321524064171123,0.0685633431326762,0.2493910574832607,137683.8535659361,3047.2642733563907,140731.11783929248,2581,150,1012.6470588235294,33,1,23,28.239821734392034,0.7032828282828283,37.62254901960784,1049.509803921568,31.803327391562664,0
2627,4,0,0,34,0.0,0.0,1.0,34,650,200,450,0.3076923076923077,11,2,9,358.4953169383339,0.32063279857397503,0.07466591586436166,0.2504788649994914,137748.16927383686,3076.414720299873,140824.58399413674,2582,151,1013.6470588235294,33,1,23,28.1529691026539,0.7039141414141414,37.561274509803916,1049.7549019607834,31.810754604872223,0
2628,4,0,0,34,0.0,0.0,1.0,34,500,200,300,0.4,8,2,6,357.50868854320305,0.3209855912061795,0.07176305797210913,0.2500226069183363,137780.33275963564,3051.5332143886826,140831.86597402432,2583,152,1014.6470588235294,33,1,23,28.147129489124932,0.704229797979798,37.530637254901954,1049.8774509803914,31.81446821152701,0
2629,4,0,0,34,0.0,0.0,1.0,34,900,600,300,0.6666666666666666,12,6,6,358.4026203073823,0.3205956625074272,0.0683940242763772,0.2508818342151675,137812.5,3078.4722222222226,140890.97222222222,2584,153,1015.6470588235294,33,1,23,28.09193121693121,0.7045454545454546,37.5,1050.0,31.818181818181817,0
2630,4,0,0,34,0.0,0.0,1.0,34,950,700,250,0.7368421052631579,12,7,5,357.56275815968723,0.3199457813428402,0.06879216509845154,0.2509967567720456,137909.02424848606,3062.2262170799663,140971.25046556603,2585,154,1016.6470588235294,33,1,23,28.01877941119279,0.7054924242424243,37.408088235294116,1050.367647058823,31.829322638146152,0
2631,4,0,0,34,0.0,0.0,1.0,34,850,600,250,0.7058823529411765,11,6,5,357.96595671363315,0.3200943256090315,0.06549056189640035,0.25246020105066774,138069.97308727418,3084.870001922344,141154.8430891965,2586,155,1017.6470588235294,33,1,20,27.84952192164179,0.7070707070707071,37.254901960784316,1050.9803921568632,31.847890671420096,0
2632,4,0,0,34,0.0,0.0,1.0,34,700,400,300,0.5714285714285714,10,4,6,358.1436203112491,0.3201871657754011,0.06702261177293578,0.25282286678268184,138102.1741187284,3092.082522347179,141194.2566410756,2587,156,1018.6470588235294,33,1,20,27.813119389063782,0.7073863636363635,37.224264705882355,1051.102941176471,31.851604278074877,0
2633,4,0,0,34,0.0,0.0,1.0,34,700,400,300,0.5714285714285714,10,4,6,358.1436203112491,0.3201871657754011,0.06702261177293578,0.25282286678268184,138102.1741187284,3092.082522347179,141194.2566410756,2588,157,1019.6470588235294,33,1,20,27.813119389063782,0.7073863636363635,37.224264705882355,1051.102941176471,31.851604278074877,0
2634,4,0,0,34,0.0,0.0,1.0,34,850,600,250,0.7058823529411765,11,6,5,360.32822044284944,0.31907308377896615,0.06149358706307395,0.2553242328340291,138231.015790201,3161.7071859381163,141392.7229761391,2589,158,1020.6470588235294,33,1,20,27.62874859185022,0.7086489898989898,37.10171568627452,1051.5931372549028,31.866458704694026,0
2635,4,0,0,34,0.0,0.0,1.0,34,750,500,250,0.6666666666666666,10,5,5,359.11867936966746,0.3184232026143791,0.06259251137547284,0.255188306598446,138327.68646674365,3135.211216839688,141462.89768358335,2590,159,1021.6470588235294,33,1,20,27.56533473128301,0.7095959595959596,37.00980392156863,1051.9607843137262,31.87759952465837,0
2636,4,0,0,34,0.0,0.0,1.0,34,800,700,100,0.875,9,7,2,359.11867936966746,0.3184232026143791,0.06259251137547284,0.255188306598446,138327.68646674365,3135.211216839688,141462.89768358335,2591,160,1022.6470588235294,33,1,20,27.56533473128301,0.7095959595959596,37.00980392156863,1051.9607843137262,31.87759952465837,0
2637,4,0,0,34,0.0,0.0,1.0,34,1050,600,450,0.5714285714285714,15,6,9,359.219684344672,0.3182560903149138,0.06016307513104269,0.2555013247803656,138359.91753472242,3140.32118055558,141500.238715278,2592,161,1023.6470588235294,33,1,20,27.53094059405941,0.7099116161616161,36.97916666666668,1052.0833333333348,31.881313131313178,0
2638,4,0,0,34,0.0,0.0,1.0,34,1150,900,250,0.782608695652174,14,9,5,355.70370502140184,0.31803327391562686,0.057070056713882655,0.2537195530501497,138456.6332660517,3049.9074875048277,141506.54075355653,2593,162,1024.6470588235295,33,1,20,27.52823707498835,0.7108585858585859,36.887254901960794,1052.4509803921583,31.892453951277524,0
2639,4,0,0,34,0.0,0.0,1.0,34,550,300,250,0.5454545454545454,8,3,5,355.1406115696996,0.31756907308377896,0.054176682898098294,0.25355799773667087,138488.87935229242,3036.6050617551,141525.48441404753,2594,163,1025.6470588235295,33,1,20,27.511327473124542,0.7111742424242424,36.856617647058826,1052.573529411765,31.896167557932277,0
2640,4,0,0,34,0.0,0.0,1.0,34,900,800,100,0.8888888888888888,10,8,2,355.1406115696996,0.31756907308377896,0.054176682898098294,0.25355799773667087,138488.87935229242,3036.6050617551,141525.48441404753,2595,164,1026.6470588235295,33,1,20,27.511327473124542,0.7111742424242424,36.856617647058826,1052.573529411765,31.896167557932277,0
2641,4,0,0,34,0.0,0.0,1.0,34,1100,900,200,0.8181818181818182,13,9,4,355.27505557116046,0.31695632798573975,0.0522510680249757,0.25437693978895104,138585.64013840831,3047.2042003075762,141632.8443387159,2596,165,1027.6470588235295,33,1,22,27.412612507759167,0.7121212121212122,36.76470588235294,1052.9411764705883,31.907308377896616,0
2642,4,0,0,34,0.0,0.0,1.0,34,1100,800,300,0.7272727272727273,14,8,6,357.2017363342528,0.3169748960190137,0.05754029360435298,0.2564869610520387,138682.43471561413,3107.521295895808,141789.95601150993,2597,166,1028.6470588235295,33,1,22,27.266700601124683,0.7130681818181819,36.67279411764706,1053.3088235294115,31.918449197860955,0
2643,4,0,0,34,0.0,0.0,1.0,34,800,500,300,0.625,11,5,6,357.19861478528094,0.3174019607843137,0.05557988667779834,0.2567290378506922,138714.70708381402,3109.740244136882,141824.4473279509,2598,167,1029.6470588235295,33,1,22,27.235051186598415,0.7133838383838383,36.642156862745104,1053.4313725490204,31.922162804515768,0
2644,4,0,0,34,0.0,0.0,1.0,34,450,300,150,0.6666666666666666,6,3,3,357.19861478528094,0.3174019607843137,0.05557988667779834,0.2567290378506922,138714.70708381402,3109.740244136882,141824.4473279509,2599,168,1030.6470588235295,33,1,22,27.235051186598415,0.7133838383838383,36.642156862745104,1053.4313725490204,31.922162804515768,0
2645,4,0,0,34,0.0,0.0,1.0,34,750,700,50,0.9333333333333333,8,7,1,359.04042123213503,0.3176247771836007,0.059104032401516404,0.2585451877515826,138779.26308391,3165.473015186462,141944.73609909645,2600,169,1031.6470588235295,33,1,22,27.12307125688145,0.7140151515151515,36.580882352941174,1053.676470588235,31.9295900178253,0
2646,4,0,0,34,0.0,0.0,1.0,34,850,600,250,0.7058823529411765,11,6,5,360.5300162249864,0.31799613784907904,0.05727770177838565,0.2601139378804433,138843.83410226845,3211.473952326035,142055.30805459447,2601,170,1032.6470588235295,33,1,22,27.020348837209298,0.7146464646464646,36.51960784313726,1053.9215686274515,31.937017231134895,0
2647,4,0,0,34,0.0,0.0,1.0,34,950,900,50,0.9473684210526315,10,9,1,360.41806620943925,0.3178104575163399,0.05661474075796358,0.26053077357425186,138908.42013888893,3213.020833333338,142121.44097222228,2602,171,1033.6470588235295,33,1,23,26.959815546772067,0.7152777777777777,36.458333333333336,1054.166666666667,31.944444444444454,0
2648,4,0,0,34,0.0,0.0,1.0,34,800,600,200,0.75,10,6,4,359.03683575135994,0.317123440285205,0.05681763817412655,0.2607789067773802,139069.95093533737,3186.2470263840833,142256.19796172145,2603,172,1034.6470588235295,33,1,24,26.83753049843151,0.7168560606060606,36.30514705882353,1054.7794117647059,31.963012477718358,0
2649,4,0,0,34,0.0,0.0,1.0,34,1050,600,450,0.5714285714285714,15,6,9,358.34570988815904,0.31636215092097447,0.050481656077064896,0.26102847395406525,139166.91446799316,3173.9733515955513,142340.8878195887,2604,173,1035.6470588235295,33,1,21,26.760549748354634,0.7178030303030303,36.21323529411765,1055.1470588235302,31.974153297682733,0
2650,4,0,0,34,0.0,0.0,1.0,34,600,500,100,0.8333333333333334,7,5,2,358.2005828482232,0.3167520796197267,0.046899656390253064,0.26117402361609227,139199.24315467617,3172.2500060073153,142371.4931606835,2605,174,1036.6470588235295,33,1,22,26.73264332442999,0.7181186868686869,36.18259803921569,1055.269607843138,31.977866904337514,0
2651,4,0,0,34,0.0,0.0,1.0,34,1250,1000,250,0.8,15,10,5,358.46087669167514,0.31645499108734404,0.047205626301594084,0.2623738702377896,139328.59544706377,3188.770094434853,142517.3655414986,2606,175,1037.6470588235295,33,1,22,26.598834397368925,0.7193813131313131,36.06004901960785,1055.7598039215698,31.99272133095666,0
2652,4,0,0,34,0.0,0.0,1.0,34,900,600,300,0.6666666666666666,12,6,6,359.20302018485626,0.31625074272133097,0.0482686110655961,0.26317119233951725,139360.94290657452,3211.7743175701844,142572.7172241447,2607,176,1038.6470588235295,33,1,22,26.547508511296808,0.7196969696969696,36.02941176470589,1055.8823529411775,31.99643493761144,0
2653,4,0,0,34,0.0,0.0,1.0,34,600,300,300,0.5,9,3,6,359.0012746878433,0.3159722222222222,0.046546157049334624,0.2632777858710762,139393.29412065074,3208.4740544502138,142601.76817510097,2608,177,1039.6470588235295,33,1,23,26.521096862790603,0.7200126262626262,35.99877450980392,1056.0049019607845,32.000148544266196,0
2654,4,0,0,34,0.0,0.0,1.0,34,350,300,50,0.8571428571428571,4,3,1,359.0012746878433,0.3159722222222222,0.046546157049334624,0.2632777858710762,139393.29412065074,3208.4740544502138,142601.76817510097,2609,178,1040.6470588235295,33,1,23,26.521096862790603,0.7200126262626262,35.99877450980392,1056.0049019607845,32.000148544266196,0
2655,4,0,0,34,0.0,0.0,1.0,34,900,500,400,0.5555555555555556,13,5,8,359.8957800614769,0.3163250148544266,0.04393339702470356,0.2647015037653527,139490.37029027304,3240.399125336423,142730.76941560948,2610,179,1041.6470588235295,33,1,23,26.402262180974482,0.7209595959595959,35.906862745098046,1056.3725490196084,32.01128936423056,0
2656,4,0,0,34,0.0,0.0,1.0,34,1100,700,400,0.6363636363636364,15,7,8,360.65163421070446,0.3152852049910873,0.043275069248297715,0.2657725119798884,139555.10650951555,3266.155445021142,142821.2619545367,2611,180,1042.6470588235295,33,1,23,26.318816206603255,0.7215909090909091,35.845588235294116,1056.6176470588234,32.018716577540104,0
2657,4,0,0,34,0.0,0.0,1.0,34,450,300,150,0.6666666666666666,6,3,3,360.78107960512483,0.3157865418894831,0.043447570332481034,0.26664411410404487,139652.23899762117,3276.7771109669443,142929.0161085881,2612,181,1043.6470588235295,33,1,23,26.220169082125594,0.7225378787878787,35.75367647058824,1056.9852941176475,32.02985739750447,0
2658,4,0,0,34,0.0,0.0,1.0,34,750,400,350,0.5333333333333333,11,4,7,362.9951694233926,0.31586081402257876,0.045608856591657476,0.26932805820760586,139781.80154567957,3348.023746876206,143129.8252925558,2613,182,1044.6470588235295,33,1,23,26.034665082860123,0.723800505050505,35.631127450980394,1057.4754901960787,32.044711824123596,0
2659,4,0,0,34,0.0,0.0,1.0,34,900,600,300,0.6666666666666666,12,6,6,362.8832113228237,0.314932412358883,0.04452477156737844,0.2702994618938687,139911.42416678692,3354.301380478677,143265.7255472656,2614,183,1045.6470588235295,33,1,23,25.91062878875632,0.7250631313131313,35.508578431372555,1057.9656862745105,32.05956625074274,0
2660,4,0,0,34,0.0,0.0,1.0,34,800,500,300,0.625,11,5,6,362.08072416144813,0.31398544266191325,0.041222788327929694,0.27049559981472915,140008.68055555574,3338.888888888914,143347.56944444464,2615,184,1046.6470588235295,33,1,23,25.836614173228345,0.726010101010101,35.41666666666668,1058.3333333333348,32.070707070707115,0
2661,4,0,0,34,0.0,0.0,1.0,34,850,600,250,0.7058823529411765,11,6,5,362.93109516452165,0.3139297385620915,0.042283881249616906,0.27139704492952155,140041.10686094296,3365.054456218772,143406.16131716175,2616,185,1047.6470588235295,33,1,23,25.782365597622643,0.7263257575757576,35.38602941176471,1058.4558823529417,32.07442067736187,0
2662,4,0,0,34,0.0,0.0,1.0,34,600,300,300,0.5,9,3,6,362.74377692206576,0.31365121806298274,0.04070119771487768,0.2717904153364898,140105.97073541442,3364.5137987793387,143470.48453419376,2617,186,1048.6470588235295,33,1,23,25.723825095497173,0.7269570707070707,35.324754901960794,1058.700980392158,32.081847890671455,0
2663,4,0,0,34,0.0,0.0,1.0,34,750,600,150,0.8,9,6,3,361.2805254313489,0.31387403446226975,0.037499063969992585,0.2712271955041083,140170.84962814787,3328.199640763173,143499.04926891104,2618,187,1049.6470588235295,33,1,23,25.699065501678042,0.7275883838383838,35.263480392156865,1058.9460784313728,32.089275103980995,0
2664,4,0,0,34,0.0,0.0,1.0,34,500,200,300,0.4,8,2,6,360.5353338359656,0.313818330362448,0.036477122670405926,0.2709344656530797,140203.29470636303,3309.648332372183,143512.94303873522,2619,188,1050.6470588235295,33,1,23,25.687051608423978,0.7279040404040403,35.23284313725491,1059.0686274509812,32.092988710635794,0
2665,4,0,0,34,0.0,0.0,1.0,34,750,500,250,0.6666666666666666,10,5,5,359.3199798655084,0.3136697860962567,0.032160400593269856,0.27108905287235485,140333.11256487892,3284.8982362552847,143618.0108011342,2620,189,1051.6470588235295,33,1,19,25.592277739224304,0.7291666666666666,35.11029411764706,1059.558823529412,32.10784313725491,0
2666,4,0,0,34,0.0,0.0,1.0,34,1250,1000,250,0.8,15,10,5,358.2660296033946,0.31326128936423053,0.032934376062563775,0.2713661257503821,140462.99049644364,3264.6235822760405,143727.6140787197,2621,190,1052.6470588235295,33,1,21,25.493256262042394,0.7304292929292929,34.98774509803921,1060.0490196078429,32.12269756387403,0
2667,4,0,0,34,0.0,0.0,1.0,34,1000,800,200,0.8,12,8,4,358.6745240009392,0.31339126559714797,0.035844207062087685,0.27194507512113264,140495.4693657487,3278.4291198096817,143773.89848555837,2622,191,1053.6470588235295,33,1,21,25.450694524717758,0.7307449494949495,34.95710784313725,1060.1715686274504,32.1264111705288,0
2668,4,0,0,34,0.0,0.0,1.0,34,700,500,200,0.7142857142857143,9,5,4,358.6745240009392,0.31339126559714797,0.035844207062087685,0.27194507512113264,140495.4693657487,3278.4291198096817,143773.89848555837,2623,192,1054.6470588235295,33,1,21,25.450694524717758,0.7307449494949495,34.95710784313725,1060.1715686274504,32.1264111705288,0
2669,4,0,0,34,0.0,0.0,1.0,34,950,500,450,0.5263157894736842,14,5,9,359.22531138156864,0.3131870172311349,0.0270055329735317,0.27317538178348805,140592.92850105718,3300.9077037677707,143893.83620482494,2624,193,1055.6470588235295,33,1,21,25.340882828749717,0.7316919191919192,34.86519607843137,1060.5392156862738,32.137551990493144,0
2670,4,0,0,34,0.0,0.0,1.0,34,700,500,200,0.7142857142857143,9,5,4,359.33960523573455,0.31233288770053474,0.024274219854300227,0.2738066569472285,140657.9200307573,3308.792291426361,143966.71232218365,2625,194,1056.6470588235295,33,1,21,25.274376155268026,0.7323232323232325,34.803921568627445,1060.7843137254895,32.14497920380271,0
2671,4,0,0,34,0.0,0.0,1.0,34,750,600,150,0.8,9,6,3,355.1464153755591,0.3108288770053476,0.02564912352194093,0.2719649074772516,140820.46455990468,3202.3766399942137,144022.8411998989,2626,195,1057.6470588235295,33,1,22,25.226951275834203,0.7339015151515152,34.65073529411764,1061.3970588235281,32.163547237076614,0
2672,4,0,0,34,0.0,0.0,1.0,34,1400,1000,400,0.7142857142857143,18,10,8,353.14361860752786,0.3095662507427213,0.03385050801213563,0.27206184377523945,141015.641895545,3159.754811851215,144175.39670739623,2627,196,1058.6470588235295,33,1,23,25.089780200761506,0.7357954545454546,34.466911764705884,1062.1323529411766,32.18582887700535,0
2673,4,0,0,34,0.0,0.0,1.0,34,550,400,150,0.7272727272727273,7,4,3,353.08543281155085,0.3091763220439691,0.03583159151985682,0.2722904387553844,141048.18459246433,3160.411860822748,144208.5964532871,2628,197,1059.6470588235295,33,1,23,25.059606214428555,0.7361111111111112,34.436274509803916,1062.2549019607834,32.189542483660105,0
2674,4,0,0,34,0.0,0.0,1.0,34,650,300,350,0.46153846153846156,10,3,7,353.9408848739684,0.30930629827688655,0.03619726815631097,0.2732247133546242,141080.73104394932,3186.8477568723424,144267.57880082165,2629,198,1060.6470588235295,33,1,23,25.005166878148195,0.7364267676767677,34.405637254901954,1062.3774509803911,32.19325609031488,0
2675,4,0,0,34,0.0,0.0,1.0,34,700,300,400,0.42857142857142855,11,3,8,356.8526587198317,0.31004901960784315,0.03762033010644017,0.27602760069220855,141145.83521061597,3273.6533124278967,144419.48852304387,2630,199,1061.6470588235295,33,1,23,24.86437069926575,0.7370580808080809,34.34436274509803,1062.6225490196066,32.200683303624444,0
2676,4,0,0,34,0.0,0.0,1.0,34,650,600,50,0.9230769230769231,7,6,1,358.0725321244736,0.3097704991087344,0.03226003336543326,0.277810477964909,141243.5196198577,3315.0849432910363,144558.60456314872,2631,200,1062.6470588235295,33,1,23,24.736761202059803,0.7380050505050505,34.252450980392155,1062.990196078431,32.21182412358882,0
2677,4,0,0,34,0.0,0.0,1.0,34,750,600,150,0.8,9,6,3,361.3565030377274,0.3095662507427213,0.03381827549505445,0.2812098992698081,141341.23782018927,3414.915086745474,144756.15290693476,2632,201,1063.6470588235295,33,1,23,24.55425742384081,0.7389520202020202,34.16053921568627,1063.3578431372543,32.222964943553166,0
2678,4,0,0,34,0.0,0.0,1.0,34,750,400,350,0.5333333333333333,11,4,7,361.3565030377274,0.3095662507427213,0.03381827549505445,0.2812098992698081,141341.23782018927,3414.915086745474,144756.15290693476,2633,202,1064.6470588235295,33,1,23,24.55425742384081,0.7389520202020202,34.16053921568627,1063.3578431372543,32.222964943553166,0
2679,4,0,0,34,0.0,0.0,1.0,34,950,700,250,0.7368421052631579,12,7,5,349.5366564622697,0.3095662507427213,0.011123765129644969,0.2596391016731444,139819.7562358278,2974.426020408178,142794.18225623597,2634,203,1065.6470588235295,34,0,21,26.353322452348802,0.7218137254901961,35.5952380952381,1057.6190476190486,31.10644257703084,4
2680,4,0,0,34,0.0,0.0,1.0,34,650,300,350,0.46153846153846156,10,3,7,350.2702099598436,0.30962195484254307,0.011235843499096454,0.26092635003462966,139914.20245181414,3001.5554138322113,142915.75786564636,2635,204,1066.6470588235295,34,0,22,26.241513821687114,0.7227328431372548,35.50595238095239,1057.9761904761913,31.116946778711508,0
2681,4,0,0,34,0.0,0.0,1.0,34,800,600,200,0.75,10,6,4,349.3706987413973,0.30897207367795604,0.015748031496062964,0.26100046317739695,140008.68055555565,2982.9861111111218,142991.66666666677,2636,205,1067.6470588235295,34,0,22,26.17290026246718,0.7236519607843137,35.41666666666667,1058.3333333333342,31.127450980392183,0
2682,4,0,0,34,0.0,0.0,1.0,34,900,600,300,0.6666666666666666,12,6,6,348.58520473086327,0.3089163695781343,0.006259487940529551,0.26169632963330913,140170.84962814776,2972.2968629853794,143143.14649113314,2637,206,1068.6470588235295,33,1,23,26.03515700343324,0.7275883838383839,35.26348039215686,1058.946078431372,32.08927510398097,0
2683,4,0,0,34,0.0,0.0,1.0,34,450,200,250,0.4444444444444444,7,2,5,348.58520473086327,0.3089163695781343,0.006259487940529551,0.26169632963330913,140170.84962814776,2972.2968629853794,143143.14649113314,2638,207,1069.6470588235295,33,1,23,26.03515700343324,0.7275883838383839,35.26348039215686,1058.946078431372,32.08927510398097,0
2684,4,0,0,34,0.0,0.0,1.0,34,700,400,300,0.5714285714285714,10,4,6,355.6805517606107,0.3089163695781343,0.05201658626265604,0.23749058623650218,136161.22626133784,2885.980017006797,139047.20627834465,2639,208,1070.6470588235295,34,0,18,29.79687084141287,0.685968137254902,39.07738095238095,1043.690476190476,30.696778711484587,6
2685,4,0,0,34,0.0,0.0,1.0,34,650,400,250,0.6153846153846154,9,4,5,355.6805517606107,0.3089163695781343,0.05201658626265604,0.23749058623650218,136161.22626133784,2885.980017006797,139047.20627834465,2640,209,1071.6470588235295,34,0,18,29.79687084141287,0.685968137254902,39.07738095238095,1043.690476190476,30.696778711484587,0
2686,4,0,0,34,0.0,0.0,1.0,34,400,200,200,0.5,6,2,4,356.3646706854006,0.3088420974450386,0.05623083992406408,0.23836474425936513,136223.35778061222,2909.0384070294704,139132.3961876417,2641,210,1072.6470588235295,34,0,18,29.717375603451543,0.6865808823529411,39.01785714285714,1043.928571428571,30.703781512605033,0
2687,4,0,0,34,0.0,0.0,1.0,34,750,500,250,0.6666666666666666,10,5,5,356.85171148142905,0.3091577540106952,0.053994231672144455,0.2388999625719183,136254.4288548751,2924.525226757347,139178.95408163243,2642,211,1073.6470588235295,34,0,18,29.673840744963886,0.6868872549019609,38.98809523809523,1044.0476190476177,30.707282913165226,0
2688,4,0,0,34,0.0,0.0,1.0,34,1100,1000,100,0.9090909090909091,12,10,2,359.21029010272883,0.3095476827094474,0.05409310652335719,0.24111337988303286,136347.66333616775,2995.496740362801,139343.16007653056,2643,212,1074.6470588235295,34,0,19,29.519786086097486,0.6878063725490196,38.89880952380952,1044.4047619047615,30.717787114845926,0
2689,4,0,0,34,0.0,0.0,1.0,34,850,600,250,0.7058823529411765,11,6,5,360.6135457616686,0.30982620320855614,0.05279636358760542,0.2422682427651515,136378.74858276636,3036.0048185940927,139414.75340136045,2644,213,1075.6470588235295,34,0,19,29.452311754425953,0.6881127450980393,38.86904761904761,1044.5238095238087,30.72128851540614,0
2690,4,0,0,34,0.0,0.0,1.0,34,700,500,200,0.7142857142857143,9,5,4,359.6747945359222,0.3091763220439691,0.05805614942798343,0.24227672077066686,136472.02558106568,3017.109552154181,139489.13513321985,2645,214,1076.6470588235295,34,0,19,29.384328358208958,0.6890318627450981,38.7797619047619,1044.8809523809518,30.73179271708682,0
2691,4,0,0,34,0.0,0.0,1.0,34,600,500,100,0.8333333333333334,7,5,2,361.357213535506,0.3091577540106952,0.05675954592363297,0.24362470202877673,136503.12500000003,3065.277777777779,139568.4027777778,2646,215,1077.6470588235295,34,0,19,29.309542796384886,0.6893382352941176,38.75,1045.0000000000002,30.735294117647065,0
2692,4,0,0,34,0.0,0.0,1.0,34,500,400,100,0.8,6,4,2,360.48639977861404,0.30899064171123,0.05593227153032321,0.24325212172609165,136534.22796201817,3043.7464569160998,139577.97441893426,2647,216,1078.6470588235295,34,0,19,29.301458024831977,0.6896446078431373,38.720238095238095,1045.1190476190477,30.738795518207287,0
2693,4,0,0,34,0.0,0.0,1.0,34,1150,700,450,0.6086956521739131,16,7,9,360.6243880418014,0.3098447712418301,0.058733093510721535,0.2437754235100119,136596.444515306,3052.0018424036125,139648.44635770962,2648,217,1079.6470588235295,34,0,19,29.236182287514712,0.6902573529411765,38.66071428571428,1045.357142857142,30.745798319327704,0
2694,4,0,0,34,0.0,0.0,1.0,34,350,200,150,0.5714285714285714,5,2,3,363.5832779078346,0.30991904337492576,0.061298229869199305,0.2462106345308025,136658.6752409296,3137.361819727873,139796.03706065746,2649,218,1080.6470588235295,34,0,19,29.09716687540323,0.6908700980392157,38.60119047619047,1045.5952380952372,30.75280112044815,0
2695,4,0,0,34,0.0,0.0,1.0,34,500,300,200,0.6,7,3,4,364.5714098493369,0.3104575163398693,0.058830226079503056,0.24709840000899508,136689.79591836734,3166.6383219954614,139856.4342403628,2650,219,1081.6470588235295,34,0,19,29.04049028536733,0.6911764705882353,38.57142857142857,1045.7142857142856,30.756302521008397,0
2696,4,0,0,34,0.0,0.0,1.0,34,1100,600,500,0.5454545454545454,16,6,10,367.72562706932405,0.3104575163398693,0.06279482320687024,0.24276547054033656,135757.71683673467,3184.318310657598,138942.03514739228,2651,220,1082.6470588235295,34,0,20,29.883719823318874,0.6819852941176471,39.464285714285715,1042.142857142857,30.65126050420168,1
2697,4,0,0,34,0.0,0.0,1.0,34,1050,700,350,0.6666666666666666,14,7,7,367.94024251914186,0.31112596553773025,0.060180272154534364,0.24375345264619103,135881.80980725624,3199.277210884352,139081.0870181406,2652,221,1083.6470588235295,34,0,18,29.75470046433737,0.6832107843137255,39.345238095238095,1042.6190476190475,30.665266106442573,0
2698,4,0,0,34,0.0,0.0,1.0,34,950,700,250,0.7368421052631579,12,7,5,365.91579616771963,0.3103461081402258,0.06275181305398903,0.24283502836585022,135943.87755102038,3148.8024376417216,139092.6799886621,2653,222,1084.6470588235295,34,0,19,29.745766742770172,0.6838235294117647,39.285714285714285,1042.8571428571427,30.67226890756302,0
2699,4,0,0,34,0.0,0.0,1.0,34,650,300,350,0.46153846153846156,10,3,7,365.1321426418505,0.3093805704099822,0.06132765820320385,0.24273807540424056,136005.95946712003,3132.029478458031,139137.98894557805,2654,223,1085.6470588235295,34,0,19,29.70450049455984,0.684436274509804,39.22619047619047,1043.095238095237,30.67927170868344,0
2700,4,0,0,34,0.0,0.0,1.0,34,700,500,200,0.7142857142857143,9,5,4,366.0050922692049,0.3088235294117647,0.05871616271423008,0.2441705204590449,136130.1658163265,3164.866780045345,139295.03259637186,2655,224,1086.6470588235295,34,0,20,29.558331432048053,0.6856617647058824,39.107142857142854,1043.5714285714282,30.69327731092436,0
2701,4,0,0,34,0.0,0.0,1.0,34,400,300,100,0.75,5,3,2,365.8808777052608,0.30828505644682114,0.05577399204235123,0.24430142078004727,136161.2262613378,3163.7577947845734,139324.9840561224,2656,225,1087.6470588235295,34,0,21,29.53072126535113,0.685968137254902,39.07738095238095,1043.6904761904757,30.69677871148458,0
2702,4,0,0,34,0.0,0.0,1.0,34,1100,800,300,0.7272727272727273,14,8,6,366.88324716609895,0.30887923351158647,0.05645274869724415,0.24583139502626855,136285.50347222228,3200.173611111116,139485.6770833334,2657,226,1088.6470588235295,34,0,21,29.381151902101625,0.6871936274509804,38.958333333333336,1044.166666666667,30.710784313725497,0
2703,4,0,0,34,0.0,0.0,1.0,34,500,400,100,0.8,6,4,2,365.43855391974904,0.3087121212121212,0.055390145114133205,0.24507851643608872,136316.5816326531,3163.06689342404,139479.64852607716,2658,227,1089.6470588235295,34,0,21,29.388014895880822,0.6875,38.92857142857143,1044.2857142857147,30.714285714285726,0
2704,4,0,0,34,0.0,0.0,1.0,34,700,300,400,0.42857142857142855,11,3,8,359.8908912098881,0.30900920974450385,0.0548957048635319,0.2422087777038325,136440.9297052153,3020.7695578231155,139461.6992630384,2659,228,1090.6470588235295,34,0,21,29.409516484351265,0.6887254901960784,38.8095238095238,1044.7619047619037,30.72829131652658,0
2705,4,0,0,34,0.0,0.0,1.0,34,600,300,300,0.5,9,3,6,361.039251746882,0.3086007130124777,0.05535228445445184,0.24341033424225272,136503.12500000003,3056.5972222222226,139559.72222222225,2660,229,1091.6470588235295,34,0,21,29.317849548112697,0.6893382352941176,38.75,1045.0000000000002,30.735294117647065,0
2706,4,0,0,34,0.0,0.0,1.0,34,750,600,150,0.8,9,6,3,363.801833687022,0.3082107843137255,0.05826416661642475,0.24592331806048814,136596.4445153061,3138.8073979591827,139735.25191326527,2661,230,1092.6470588235295,34,0,21,29.153143149982927,0.6902573529411764,38.660714285714285,1045.3571428571427,30.745798319327726,0
2707,4,0,0,34,0.0,0.0,1.0,34,950,600,350,0.631578947368421,13,6,7,363.8560395658269,0.30804367201426025,0.05438932575991018,0.24617748378020743,136627.55810657606,3142.552437641735,139770.1105442178,2662,231,1093.6470588235295,34,0,21,29.12088172777652,0.690563725490196,38.63095238095239,1045.4761904761913,30.74929971988798,0
2708,4,0,0,34,0.0,0.0,1.0,34,550,300,250,0.5454545454545454,8,3,5,364.85367739623183,0.3082107843137255,0.05215623765161337,0.24707092124680827,136658.67524092968,3172.08404195011,139830.7592828798,2663,232,1094.6470588235295,34,0,21,29.06395878401457,0.6908700980392157,38.601190476190474,1045.5952380952378,30.752801120448172,0
2709,4,0,0,34,0.0,0.0,1.0,34,850,700,150,0.8235294117647058,10,7,3,364.30399258948523,0.3070595662507427,0.05049237175238841,0.24757456944190304,136783.1792091836,3166.1316609977257,139949.31087018133,2664,233,1095.6470588235295,34,0,21,28.95494290808391,0.6920955882352942,38.482142857142854,1046.071428571428,30.766806722689058,0
2710,4,1,1,34,0.02857142857142857,0.02857142857142857,0.9714285714285714,35,950,700,250,0.7368421052631579,12,7,5,356.1281119910896,0.31495098039215685,0.043444746319580396,0.24326455021506138,136963.118355624,2755.283350480091,139718.40170610408,2665,0,1065.3142857142857,35,0,16,28.990675217455397,0.6916666666666667,38.310185185185176,1046.759259259258,29.907407407407373,0
2711,4,0,0,34,0.0,0.0,1.0,34,350,200,150,0.5714285714285714,5,2,3,364.61925466700677,0.30722667855020797,0.04896382767945617,0.24800882430446242,136814.31405895684,3177.026643990923,139991.34070294775,2666,235,1097.6470588235295,34,0,21,28.915851160673654,0.6924019607843137,38.45238095238095,1046.1904761904757,30.770308123249286,0
2712,4,0,0,34,0.0,0.0,1.0,34,950,600,350,0.631578947368421,13,6,7,364.5571581187523,0.30750519904931667,0.0460196591433748,0.24862854748036875,136907.73986678015,3182.1393140589635,140089.8791808391,2667,236,1098.6470588235295,34,0,21,28.824934592196545,0.6933210784313726,38.36309523809524,1046.5476190476197,30.780812324929993,0
2713,4,0,0,34,0.0,0.0,1.0,34,1050,800,250,0.7619047619047619,13,8,5,364.2008803602582,0.3076351752822341,0.045428999625328315,0.24860668789808926,136938.8888888889,3174.6527777777824,140113.5416666667,2668,237,1099.6470588235295,34,0,22,28.80341029723992,0.6936274509803921,38.333333333333336,1046.6666666666667,30.784313725490197,0
2714,4,0,0,34,0.0,0.0,1.0,34,450,300,150,0.6666666666666666,6,3,3,364.2008803602582,0.3076351752822341,0.045428999625328315,0.24860668789808926,136938.8888888889,3174.6527777777824,140113.5416666667,2669,238,1100.6470588235295,34,0,22,28.80341029723992,0.6936274509803921,38.333333333333336,1046.6666666666667,30.784313725490197,0
2715,4,0,0,34,0.0,0.0,1.0,34,800,600,200,0.75,10,6,4,360.69927266662364,0.307876559714795,0.045520197393496664,0.2473165628720413,137094.68714569166,3089.9907879818606,140184.67793367352,2670,239,1101.6470588235295,34,0,18,28.74085862604675,0.6951593137254901,38.18452380952381,1047.261904761905,30.801820728291325,0
2716,4,0,0,34,0.0,0.0,1.0,34,700,700,0,1.0,7,7,0,360.5014781187165,0.3071338383838384,0.04667976975993282,0.24762314644547934,137157.03125000012,3089.062500000016,140246.09375000015,2671,240,1102.6470588235295,34,0,18,28.684367541766118,0.6957720588235293,38.12500000000001,1047.500000000001,30.808823529411793,0
2717,4,0,0,34,0.0,0.0,1.0,34,850,600,250,0.7058823529411765,11,6,5,359.4395661157027,0.3074866310160428,0.04562165775401117,0.2471147017045455,137188.20861678,3062.174036281179,140250.38265306118,2672,241,1103.6470588235295,34,0,18,28.681344696969706,0.696078431372549,38.095238095238095,1047.6190476190473,30.81232492997198,0
2718,4,0,0,34,0.0,0.0,1.0,34,1050,700,350,0.6666666666666666,14,7,7,356.6841906770312,0.3077465834818776,0.05051179944944861,0.2461009102445597,137312.95351473917,2995.4719387755067,140308.42545351468,2673,242,1104.6470588235295,34,0,19,28.630215432379227,0.6973039215686274,37.976190476190474,1048.0952380952376,30.82633053221287,0
2719,4,0,0,34,0.0,0.0,1.0,34,750,500,250,0.6666666666666666,10,5,5,357.12931519926394,0.30754233511586454,0.046637367334807056,0.2470728891563173,137406.54939058967,3014.3813775510293,140420.9307681407,2674,243,1105.6470588235295,34,0,19,28.526077741190722,0.6982230392156863,37.886904761904766,1048.4523809523816,30.83683473389358,0
2720,4,0,0,34,0.0,0.0,1.0,34,850,500,350,0.5882352941176471,12,5,7,356.54329449688925,0.3076351752822341,0.05047739867797296,0.24733436413524346,137500.17715419497,3004.9532312925085,140505.1303854875,2675,244,1106.6470588235295,34,0,19,28.448968974650025,0.6991421568627452,37.797619047619044,1048.8095238095234,30.847338935574218,0
2721,4,0,0,34,0.0,0.0,1.0,34,600,300,300,0.5,9,3,6,356.37105176525523,0.3076351752822341,0.05716351174060885,0.2423985141573581,136814.3140589571,2951.3321995465085,139765.6462585036,2676,245,1107.6470588235295,34,0,19,29.131580943711135,0.6924019607843136,38.45238095238096,1046.1904761904775,30.77030812324934,1
2722,4,0,0,34,0.0,0.0,1.0,34,800,600,200,0.75,10,6,4,355.0743488890698,0.30815508021390375,0.05457404804925403,0.24194600982441303,136876.5943877553,2920.2735260771206,139796.86791383242,2677,246,1108.6470588235295,34,0,19,29.103858551384146,0.6930147058823528,38.39285714285715,1046.428571428573,30.777310924369793,0
2723,4,0,0,34,0.0,0.0,1.0,34,1150,900,250,0.782608695652174,14,9,5,355.6805396093803,0.30854500891265596,0.05468493847317135,0.2425746798841013,136907.73986678023,2939.0837585034237,139846.82362528367,2678,247,1109.6470588235295,34,0,19,29.057179691350992,0.6933210784313724,38.36309523809525,1046.5476190476204,30.78081232493001,0
2724,4,0,0,34,0.0,0.0,1.0,34,650,400,250,0.6153846153846154,9,4,5,356.5940808957764,0.30904634581105167,0.05479580367178727,0.24341422043755226,136938.88888888917,2966.3194444444807,139905.20833333363,2679,248,1110.6470588235295,34,0,19,29.002454883227184,0.6936274509803919,38.33333333333335,1046.666666666669,30.784313725490264,0
2725,4,0,0,34,0.0,0.0,1.0,34,1000,900,100,0.9,11,9,2,354.68406671702024,0.3081736482471777,0.05909434365993782,0.24319218510597276,137094.68714569174,2925.060232426321,140019.74737811807,2680,249,1111.6470588235295,34,0,16,28.898346027054682,0.6951593137254901,38.18452380952382,1047.2619047619057,30.801820728291347,0
2726,4,0,0,34,0.0,0.0,1.0,34,600,300,300,0.5,9,3,6,355.54072328637363,0.30789512774806893,0.06014067368252163,0.24399744800885487,137125.8574263041,2950.7653061224805,140076.6227324266,2681,250,1112.6470588235295,34,0,16,28.84509737061454,0.6954656862745097,38.15476190476192,1047.3809523809543,30.8053221288516,0
2727,4,0,0,34,0.0,0.0,1.0,34,650,400,250,0.6153846153846154,9,4,5,356.1547174692384,0.3070967023172905,0.051113844015052035,0.24507565820537683,137219.38952664408,2974.266581632667,140193.65610827674,2682,251,1113.6470588235295,34,0,16,28.736554558194147,0.6963848039215685,38.0654761904762,1047.738095238096,30.81582633053224,0
2728,4,0,0,34,0.0,0.0,1.0,34,850,700,150,0.8235294117647058,10,7,3,355.25244671411997,0.30731951871657753,0.04829570133176486,0.24489328805202826,137281.7619756237,2953.9363662131645,140235.69834183686,2683,252,1114.6470588235295,34,0,16,28.69854973683212,0.6969975490196079,38.00595238095239,1047.9761904761915,30.822829131652693,0
2729,4,0,1,33,0.0,0.029411764705882353,0.9705882352941176,34,800,500,300,0.625,11,5,6,355.0483789404559,0.307449494949495,0.0404378372602443,0.24585425485122175,137437.75510204106,2959.4104308390265,140397.16553288008,2684,253,1115.6470588235295,34,0,18,28.549803209203745,0.6985294117647058,37.85714285714287,1048.5714285714305,30.84033613445384,0
2730,4,0,0,33,0.0,0.0,1.0,33,600,500,100,0.8333333333333334,7,5,2,359.9016369139624,0.3045296717171717,0.03853851194587654,0.2489052953758246,137394.61873137744,3289.7096369185097,140684.32836829594,2685,254,1129.2424242424242,33,0,18,28.46520066238068,0.7004419191919191,37.8982843137255,1048.4068627450988,31.76990493166966,0
2731,4,0,0,33,0.0,0.0,1.0,33,750,400,350,0.5333333333333333,11,4,7,362.9618307275744,0.3036616161616162,0.04453412630982756,0.2521877655055226,137555.26720492123,3385.4623221837855,140940.72952710502,2686,255,1130.2424242424242,33,0,18,28.226246105919017,0.702020202020202,37.74509803921569,1049.0196078431377,31.788472964943566,0
2732,4,0,0,33,0.0,0.0,1.0,33,300,200,100,0.6666666666666666,4,2,2,361.4047086148108,0.30314867424242425,0.046449073779136985,0.25157293619187066,137619.5528762975,3347.2708813917648,140966.82375768927,2687,256,1131.2424242424242,33,0,18,28.203593397181354,0.7026515151515151,37.68382352941176,1049.2647058823525,31.795900178253106,0
2733,4,0,0,33,0.0,0.0,1.0,33,450,300,150,0.6666666666666666,6,3,3,361.4047086148108,0.30314867424242425,0.046449073779136985,0.25157293619187066,137619.5528762975,3347.2708813917648,140966.82375768927,2688,257,1132.2424242424242,33,0,18,28.203593397181354,0.7026515151515151,37.68382352941176,1049.2647058823525,31.795900178253106,0
2734,4,0,0,33,0.0,0.0,1.0,33,800,600,200,0.75,10,6,4,361.9941459305222,0.30176767676767674,0.047876311273859384,0.25268784514221043,137716.00954260383,3370.477851066901,141086.48739367074,2689,258,1133.2424242424242,33,0,18,28.09289258610625,0.7035984848484849,37.591911764705884,1049.6323529411766,31.807040998217474,0
2735,4,0,0,33,0.0,0.0,1.0,33,650,400,250,0.6153846153846154,9,4,5,358.02712273904166,0.30188604797979796,0.05194198962433316,0.25085318190930883,137844.6709949298,3270.426188244905,141115.0971831747,2690,259,1134.2424242424242,33,0,18,28.0700538763761,0.7048611111111112,37.46936274509804,1050.1225490196075,31.82189542483659,0
2736,4,0,0,33,0.0,0.0,1.0,33,650,300,350,0.46153846153846156,10,3,7,357.3274658962027,0.3022806186868687,0.048810155227891894,0.2505970853298244,137876.84574442508,3253.4367791233967,141130.2825235485,2691,260,1135.2424242424242,33,0,18,28.05669000388955,0.7051767676767677,37.43872549019607,1050.2450980392146,31.82560903149135,0
2737,4,0,0,33,0.0,0.0,1.0,33,700,500,200,0.7142857142857143,9,5,4,358.4176982694855,0.30176767676767674,0.049279542979963065,0.2518325007841008,137941.2065071126,3288.113946559011,141229.32045367162,2692,261,1136.2424242424242,33,0,19,27.964594027064877,0.7058080808080809,37.377450980392155,1050.490196078431,31.833036244800937,0
2738,4,0,0,33,0.0,0.0,1.0,33,900,700,200,0.7777777777777778,11,7,4,358.21078573403355,0.3016493055555555,0.04350008128874494,0.2521592181349427,138005.5822880622,3287.017613417909,141292.5999014801,2693,262,1137.2424242424242,33,0,19,27.906558587979163,0.706439393939394,37.31617647058823,1050.7352941176464,31.840463458110495,0
2739,4,0,0,33,0.0,0.0,1.0,33,1150,900,250,0.782608695652174,14,9,5,361.4537473551304,0.3021227904040404,0.044440676289591696,0.2553995259318212,138134.37890474824,3385.8377787389504,141520.2166834872,2694,263,1138.2424242424242,33,0,17,27.694392632315214,0.7077020202020202,37.193627450980394,1051.225490196079,31.855317884729665,0
2740,4,0,0,33,0.0,0.0,1.0,33,550,300,250,0.5454545454545454,8,3,5,362.3877288212952,0.3018465909090909,0.044430317157589716,0.25654180802695653,138198.79974048448,3416.309832756633,141615.10957324112,2695,264,1139.2424242424242,33,0,17,27.60635198135198,0.7083333333333333,37.13235294117647,1051.4705882352944,31.862745098039223,0
2741,4,0,0,33,0.0,0.0,1.0,33,800,600,200,0.75,10,6,4,366.5927096626445,0.3018465909090909,0.07525599530596394,0.24232655993802396,135803.27563815654,3370.4896867481593,139173.7653249047,2696,265,1140.2424242424242,31,2,21,29.8679210909848,0.6898521505376343,39.42057291666667,1042.317708333334,33.62315188172045,4
2742,4,0,0,33,0.0,0.0,1.0,33,650,300,350,0.46153846153846156,10,3,7,367.4148029792383,0.30141256313131315,0.07846698755789627,0.24356438263723035,135905.08355034734,3386.707899305565,139291.7914496529,2697,266,1141.2424242424242,31,2,19,29.745254745254734,0.6908602150537635,39.32291666666667,1042.7083333333342,33.63575268817207,0
2743,4,0,0,33,0.0,0.0,1.0,33,700,500,200,0.7142857142857143,9,5,4,366.8165422776888,0.301333648989899,0.07848745918417532,0.24339964267622308,135939.02799818266,3372.93684217667,139311.96484035932,2698,267,1142.2424242424242,31,2,19,29.72710388313147,0.6911962365591398,39.29036458333334,1042.8385416666679,33.63995295698928,0
2744,4,0,0,33,0.0,0.0,1.0,33,700,500,200,0.7142857142857143,9,5,4,364.95178635056465,0.301333648989899,0.08167557487242894,0.24262479339870333,136006.92960951073,3327.1943834092986,139334.12399292004,2699,268,1143.2424242424242,31,2,20,29.708239712062575,0.6918682795698924,39.22526041666667,1043.0989583333342,33.648353494623684,0
2745,4,0,0,33,0.0,0.0,1.0,33,600,400,200,0.6666666666666666,8,4,4,362.39986562073875,0.30200441919191917,0.08052574661009859,0.24162001023998358,136108.8138156468,3265.163167317718,139373.97698296452,2700,269,1144.2424242424242,31,2,21,29.67359204725063,0.6928763440860215,39.12760416666667,1043.4895833333342,33.66095430107529,0
2746,4,0,0,33,0.0,0.0,1.0,33,800,500,300,0.625,11,5,6,362.3796460862333,0.3020833333333333,0.07982003440518737,0.24183787372032992,136142.78369479722,3267.0747545030576,139409.85844930029,2701,270,1145.2424242424242,31,2,21,29.640387814514447,0.6932123655913978,39.09505208333334,1043.6197916666679,33.665154569892515,0
2747,4,0,0,33,0.0,0.0,1.0,33,700,600,100,0.8571428571428571,8,6,2,362.5146045693541,0.30220170454545453,0.07433859734645343,0.24285752832428165,136278.70559692386,3280.6042141384546,139559.30981106233,2702,271,1146.2424242424242,31,2,21,29.501938105333164,0.6945564516129032,38.96484375,1044.1406250000002,33.681955645161295,0
2748,4,0,0,33,0.0,0.0,1.0,33,600,300,300,0.5,9,3,6,361.2938553437665,0.30220170454545453,0.07584049174709495,0.2319218870017011,134747.3492022498,3136.6778581267254,137884.02706037654,2703,272,1147.2424242424242,32,1,23,31.057704000972887,0.6767578125,40.43560606060606,1038.257575757576,32.44554924242425,2
2749,4,0,0,33,0.0,0.0,1.0,33,1000,500,500,0.5,15,5,10,357.7811776144585,0.3020833333333333,0.07040998217468819,0.23070717315139228,134911.26543209876,3053.742283950619,137965.00771604938,2704,273,1148.2424242424242,32,1,17,30.9854055258467,0.6783854166666666,40.27777777777778,1038.888888888889,32.46527777777778,0
2750,4,0,0,33,0.0,0.0,1.0,33,800,600,200,0.75,10,6,4,356.778715595561,0.30097853535353536,0.06647448853742155,0.2306870077036185,135009.66299676054,3033.714831394758,138043.3778281553,2705,274,1149.2424242424242,32,1,17,30.91336613615195,0.6793619791666666,40.18308080808081,1039.267676767677,32.4771148989899,0
2751,4,0,0,33,0.0,0.0,1.0,33,1100,800,300,0.7272727272727273,14,8,6,356.91786684866906,0.30101799242424243,0.0647431438151711,0.2311962862128318,135075.28130101532,3042.1562531884647,138117.4375542038,2706,275,1150.2424242424242,32,1,17,30.844366168670792,0.6800130208333333,40.1199494949495,1039.5202020202028,32.485006313131336,0
2752,4,0,0,33,0.0,0.0,1.0,33,650,400,250,0.6153846153846154,9,4,5,358.30139913271705,0.3013731060606061,0.06689849312800167,0.2325147377350609,135140.9155475206,3084.2358241505926,138225.15137167118,2707,276,1151.2424242424242,32,1,18,30.743017607771705,0.6806640625,40.05681818181818,1039.7727272727268,32.49289772727271,0
2753,4,0,0,33,0.0,0.0,1.0,33,700,400,300,0.5714285714285714,10,4,6,357.08962092249396,0.3016493055555555,0.0629676223266904,0.23236210878037142,135239.39680899895,3058.5169880624258,138297.91379706137,2708,277,1152.2424242424242,32,1,18,30.67643845593591,0.681640625,39.962121212121204,1040.151515151514,32.504734848484816,0
2754,4,0,0,33,0.0,0.0,1.0,33,550,300,250,0.5454545454545454,8,3,5,359.01896788062777,0.30141256313131315,0.06319537160658673,0.23383061473268701,135272.23186728387,3113.0594135802353,138385.2912808641,2709,278,1153.2424242424242,32,1,18,30.593569203382277,0.6819661458333334,39.93055555555555,1040.2777777777771,32.508680555555536,0
2755,4,0,0,33,0.0,0.0,1.0,33,600,400,200,0.6666666666666666,8,4,4,358.0503581864453,0.3010574494949495,0.0600250073551043,0.23341257527344225,135305.07091113148,3089.205820834603,138394.2767319661,2710,279,1154.2424242424242,32,1,18,30.5860639158576,0.6822916666666667,39.898989898989896,1040.4040404040402,32.512626262626256,0
2756,4,0,0,33,0.0,0.0,1.0,33,850,700,150,0.8235294117647058,10,7,3,358.67569201149917,0.30113636363636365,0.05855423547451233,0.23403375913434385,135337.91394054165,3108.483987603291,138446.39792814493,2711,280,1155.2424242424242,32,1,18,30.537101079966014,0.6826171875,39.867424242424235,1040.530303030302,32.51657196969694,0
2757,4,0,0,33,0.0,0.0,1.0,33,650,400,250,0.6153846153846154,9,4,5,360.8570255935618,0.3005050505050505,0.06070899459228918,0.2358877448031506,135403.6119560504,3172.2689330170347,138575.88088906743,2712,281,1156.2424242424242,32,1,18,30.41494803671802,0.6832682291666667,39.80429292929293,1040.7828282828282,32.52446338383838,0
2758,4,0,0,33,0.0,0.0,1.0,33,600,500,100,0.8333333333333334,7,5,2,362.60857835716143,0.3011758207070707,0.060179774950572584,0.2376844465129693,135502.1888710336,3226.851214161817,138729.04008519542,2713,282,1157.2424242424242,32,1,19,30.271242622685733,0.6842447916666667,39.70959595959596,1041.1616161616164,32.53630050505051,0
2759,4,0,0,33,0.0,0.0,1.0,33,1050,700,350,0.6666666666666666,14,7,7,362.21114698807133,0.3006234217171717,0.06234774077626071,0.23764163319098025,135535.0558138199,3218.4616046831834,138753.5174185031,2714,283,1158.2424242424242,32,1,20,30.248878380016986,0.6845703125,39.6780303030303,1041.2878787878778,32.54024621212118,0
2760,4,0,0,33,0.0,0.0,1.0,33,800,700,100,0.875,9,7,2,363.7225816518665,0.29936079545454547,0.061076159730867996,0.23951117487705886,135666.5634405927,3268.9985396898082,138935.5619802825,2715,284,1159.2424242424242,32,1,20,30.078677332040552,0.6858723958333334,39.55176767676767,1041.7929292929284,32.55602904040401,0
2761,4,0,0,33,0.0,0.0,1.0,33,1000,800,200,0.8,12,8,4,363.15358311190005,0.29955808080808083,0.060774920617440165,0.24001864120005867,135798.13483636864,3263.1158491480332,139061.2506855167,2716,285,1160.2424242424242,32,1,20,29.96264889965678,0.6871744791666667,39.425505050505045,1042.297979797979,32.571811868686844,0
2762,4,0,0,33,0.0,0.0,1.0,33,950,700,250,0.7368421052631579,12,7,5,364.26467854245567,0.29940025252525254,0.06027572233967593,0.2409750950357782,135831.0376492194,3295.68985307621,139126.7275022956,2717,286,1161.2424242424242,32,1,20,29.900981104651155,0.6875,39.39393939393939,1042.4242424242418,32.57575757575756,0
2763,4,0,0,33,0.0,0.0,1.0,33,650,300,350,0.46153846153846156,10,3,7,382.1495707411986,0.29936079545454547,0.06856596514791069,0.24835057945565103,135193.22925143762,3735.71238031727,138928.9416317549,2718,287,1162.2424242424242,31,2,19,30.070870372688944,0.6838037634408602,40.00651041666666,1039.9739583333323,33.547547043010724,5
2764,4,0,0,33,0.0,0.0,1.0,33,1000,800,200,0.8,12,8,4,384.25206043965716,0.29896622474747475,0.0681239734938568,0.2501866105014198,135260.9443664551,3794.8593139648438,139055.80368041995,2719,288,1163.2424242424242,31,2,19,29.948601201652263,0.684475806451613,39.94140625,1040.2343750000002,33.55594758064517,0
2765,4,0,0,33,0.0,0.0,1.0,33,500,200,300,0.4,8,2,6,395.3162045773456,0.29896622474747475,0.05890227576974527,0.2523941921532282,134550.78125,4038.0208333333317,138588.80208333334,2720,289,1164.2424242424242,31,2,19,30.371485943775095,0.6774193548387097,40.625,1037.5,33.46774193548387,1
2766,4,0,0,33,0.0,0.0,1.0,33,800,400,400,0.5,12,4,8,395.9893127201587,0.2987294823232323,0.054105222340073755,0.25352857925240035,134652.11868286133,4064.1599867078985,138716.27866956923,2721,290,1165.2424242424242,31,2,20,30.252503868188853,0.6784274193548387,40.52734375,1037.890625,33.48034274193548,0
2767,4,0,0,33,0.0,0.0,1.0,33,750,600,150,0.8,9,6,3,395.98840420200276,0.2997159090909091,0.059306545074570005,0.2544728060846875,134787.29459974496,4074.841139051644,138862.1357387966,2722,291,1166.2424242424242,31,2,14,30.117163009404386,0.679771505376344,40.397135416666664,1038.411458333333,33.49714381720429,0
2768,4,0,0,33,0.0,0.0,1.0,33,550,300,250,0.5454545454545454,8,3,5,400.0150752821904,0.2997553661616162,0.06258069415964163,0.2582621602550064,134956.35986328125,4196.915690104166,139153.2755533854,2723,292,1167.2424242424242,31,2,14,29.843358395989974,0.6814516129032258,40.234375,1039.0625,33.51814516129032,0
2769,4,0,0,33,0.0,0.0,1.0,33,700,500,200,0.7142857142857143,9,5,4,396.1028268962775,0.300228851010101,0.05732677476164438,0.25669520859901596,135091.68836805545,4102.039930555535,139193.72829861098,2724,293,1168.2424242424242,31,2,16,29.809619238476945,0.6827956989247312,40.10416666666666,1039.5833333333323,33.53494623655911,0
2770,4,0,0,33,0.0,0.0,1.0,33,600,300,300,0.5,9,3,6,394.87922167775463,0.299636994949495,0.057926851708731686,0.2560185441964276,135108.09643148654,4070.2759922456785,139178.37242373222,2725,294,1169.2424242424242,32,1,16,29.825014168893194,0.6803385416666667,40.088383838383834,1039.6464646464642,32.48895202020201,0
2771,4,0,0,33,0.0,0.0,1.0,33,950,600,350,0.631578947368421,13,6,7,393.9509158894631,0.2995975378787879,0.06009825026218496,0.25564899860911955,135140.9155475206,4047.7774908172573,139188.69303833783,2726,295,1170.2424242424242,32,1,16,29.81633272616879,0.6806640625,40.05681818181818,1039.7727272727268,32.49289772727271,0
2772,4,0,0,33,0.0,0.0,1.0,33,350,200,150,0.5714285714285714,5,2,3,376.1398796499301,0.2995975378787879,0.03575935741540848,0.22916462518373337,132820.66243240488,3392.7263480767288,136213.3887804816,2727,296,1171.2424242424242,32,1,17,32.60477911154664,0.6575520833333334,42.2979797979798,1030.8080808080808,32.212752525252526,5
2773,4,0,0,33,0.0,0.0,1.0,33,550,400,150,0.7272727272727273,7,4,3,376.41456944553545,0.2997553661616162,0.036592198463142545,0.22993102383408287,132918.29476902867,3406.47653938374,136324.7713084124,2728,297,1172.2424242424242,32,1,17,32.499438798416385,0.6585286458333334,42.20328282828283,1031.1868686868688,32.22458964646465,0
2774,4,0,0,33,0.0,0.0,1.0,33,1000,700,300,0.7,13,7,6,375.00635997105144,0.2998737373737374,0.03354064448177807,0.2298707402343182,133048.52701573816,3378.8087631364115,136427.33577887458,2729,298,1173.2424242424242,32,1,17,32.40474442132747,0.6598307291666667,42.0770202020202,1031.691919191919,32.24037247474747,0
2775,4,0,0,33,0.0,0.0,1.0,33,700,600,100,0.8571428571428571,8,6,2,375.63919986334713,0.29908459595959597,0.026668969437908085,0.23092214169701525,133155.82498317945,3403.709510765082,136559.53449394455,2730,299,1174.2424242424242,33,0,17,32.28053510646718,0.658459595959596,41.97303921568627,1032.1078431372543,31.275995246583467,0
2776,4,0,0,33,0.0,0.0,1.0,33,450,300,150,0.6666666666666666,6,3,3,375.05908113373044,0.29936079545454547,0.02519796085034165,0.23076133238783142,133187.44781153885,3390.6323589484855,136578.08017048734,2731,300,1175.2424242424242,33,0,17,32.26371740076776,0.6587752525252526,41.942401960784316,1032.2303921568628,31.279708853238265,0
2777,4,0,0,33,0.0,0.0,1.0,33,900,700,200,0.7777777777777778,11,7,4,373.9449541232729,0.300228851010101,0.022496233247390585,0.2308596431059942,133313.97667063147,3370.4177780180703,136684.39444864955,2732,301,1176.2424242424242,33,0,18,32.16533661643132,0.6600378787878787,41.81985294117647,1032.720588235294,31.294563279857393,0
2778,4,0,0,33,0.0,0.0,1.0,33,950,800,150,0.8421052631578947,11,8,3,376.2356919875126,0.2999921085858586,0.020039100684261957,0.23326612903225807,133472.2222222223,3443.4027777777865,136915.6250000001,2733,302,1177.2424242424242,33,0,19,31.94724462365591,0.6616161616161615,41.66666666666667,1033.3333333333342,31.31313131313134,0
2779,4,0,0,33,0.0,0.0,1.0,33,700,700,0,1.0,7,7,0,377.43417436353667,0.30011047979797983,0.01885192795394408,0.23421521737418877,133504.84206012147,3477.857967299269,136982.70002742074,2734,303,1178.2424242424242,32,1,19,31.88352677662393,0.6643880208333333,41.63510101010102,1033.4595959595965,32.29561237373739,0
2780,4,0,0,33,0.0,0.0,1.0,33,350,200,150,0.5714285714285714,5,2,3,377.32181937316295,0.3006628787878788,0.020841199683125033,0.23435177643313448,133537.46588358335,3477.3199163350737,137014.78579991843,2735,304,1179.2424242424242,32,1,19,31.85367293753562,0.6647135416666666,41.60353535353536,1033.585858585859,32.29955808080809,0
2781,4,0,0,33,0.0,0.0,1.0,33,700,400,300,0.5714285714285714,10,4,6,380.31545681850224,0.3006628787878788,0.017490488667821324,0.23662788453114714,133602.72548719522,3562.2363151719246,137164.96180236715,2736,305,1180.2424242424242,32,1,19,31.710786109754107,0.6653645833333334,41.54040404040404,1033.838383838384,32.3074494949495,0
2782,4,0,0,33,0.0,0.0,1.0,33,800,400,400,0.5,12,4,8,378.7196930054072,0.3004655934343434,0.018537018537018612,0.23605131550337038,133668.00103305795,3524.5408631772393,137192.5418962352,2737,306,1181.2424242424242,32,1,20,31.68650793650794,0.666015625,41.477272727272734,1034.09090909091,32.315340909090935,0
2783,4,0,0,33,0.0,0.0,1.0,33,600,300,300,0.5,9,3,6,378.5241824577811,0.30097853535353536,0.010829643931071997,0.23655595933459983,133765.94424357222,3526.728937098269,137292.67318067048,2738,307,1182.2424242424242,32,1,15,31.59328084950567,0.6669921875,41.382575757575765,1034.469696969698,32.32717803030306,0
2784,4,0,0,33,0.0,0.0,1.0,33,600,500,100,0.8333333333333334,7,5,2,379.310658396746,0.2992029671717172,0.011948199821812278,0.23788901812380467,133896.5909888022,3557.680817008475,137454.27180581068,2739,308,1183.2424242424242,32,1,16,31.441889309096837,0.6682942708333333,41.256313131313135,1034.9747474747478,32.34296085858587,0
2785,4,0,0,33,0.0,0.0,1.0,33,450,300,150,0.6666666666666666,6,3,3,378.4284791850587,0.29896622474747475,0.014179363776826825,0.23754645270743607,133929.2626390166,3536.5294357718867,137465.7920747885,2740,309,1184.2424242424242,32,1,16,31.4319549483614,0.6686197916666665,41.22474747474749,1035.1010101010115,32.34690656565661,0
2786,4,2,2,33,0.05714285714285714,0.05714285714285714,0.9428571428571428,35,1000,600,400,0.6,14,6,8,361.98925688872174,0.31358543417366946,0.004997458641438746,0.2307251203563595,134489.03238378686,2736.716978458051,137225.7493622449,2741,0,1117.5142857142857,34,1,17,31.297582156930257,0.6694240196078431,40.68452380952381,1037.2619047619048,30.507703081232496,0
2787,4,0,0,33,0.0,0.0,1.0,33,450,200,250,0.4444444444444444,7,2,5,377.8148337154729,0.30011047979797983,0.013242343001056645,0.2388558186031719,134190.7793209877,3539.8533950617407,137730.63271604944,2742,311,1186.2424242424242,32,1,17,31.18576854334229,0.6712239583333333,40.97222222222223,1036.1111111111115,32.378472222222236,0
2788,4,0,0,33,0.0,0.0,1.0,33,600,400,200,0.6666666666666666,8,4,4,399.05898491083667,0.30011047979797983,0.03050505050505059,0.23022633744855966,130746.3842975207,3842.819929088872,134589.20422660955,2743,312,1187.2424242424242,32,1,18,34.11496913580247,0.63671875,44.31818181818182,1022.727272727273,31.96022727272728,6
2789,4,0,1,32,0.0,0.030303030303030304,0.9696969696969697,33,1350,900,450,0.6666666666666666,18,9,9,396.5070148438445,0.30014993686868685,0.039319920148935816,0.22990599873563697,130940.15438475672,3783.7379476584097,134723.89233241513,2744,313,1188.2424242424242,32,1,20,33.98331482852209,0.638671875,44.12878787878788,1023.484848484849,31.98390151515153,0
2790,4,0,0,32,0.0,0.0,1.0,32,450,300,150,0.6666666666666666,6,3,3,400.0984143633174,0.2989961357526882,0.026860687022900676,0.23191545257342724,130928.03955078125,4076.820203993057,135004.8597547743,2745,314,1184.40625,31,1,20,33.903731976251066,0.6411290322580645,44.140625,1023.4375,33.01411290322581,0
2791,4,0,0,32,0.0,0.0,1.0,32,900,600,300,0.6666666666666666,12,6,6,395.59630907329995,0.2991851478494624,0.0205995684340321,0.2301496460964466,131069.41415416806,3970.1152943577345,135039.5294485258,2746,315,1185.40625,32,0,20,33.87535963830661,0.6399739583333333,44.00252525252526,1023.9898989898999,31.99968434343437,0
2792,4,0,0,32,0.0,0.0,1.0,32,1050,900,150,0.8571428571428571,12,9,3,400.47665601267704,0.2985551075268817,0.02186036480157738,0.23377464653862318,131198.73769258245,4108.4063488419615,135307.1440414244,2747,316,1186.40625,32,0,20,33.61910483937228,0.6412760416666666,43.87626262626263,1024.49494949495,32.01546717171719,0
2793,4,1,0,33,0.030303030303030304,0.0,1.0,33,550,300,250,0.5454545454545454,8,3,5,389.37224637742696,0.31013257575757575,0.02149718589987737,0.22905789280918554,131495.00740898986,3640.2288224572844,135135.23623144714,2748,0,1151.4242424242425,31,2,21,33.603238331005876,0.6468413978494623,43.587239583333336,1025.651041666667,33.08551747311829,0
2794,4,0,0,33,0.0,0.0,1.0,33,600,400,200,0.6666666666666666,8,4,4,389.91301372077385,0.3110006313131313,0.019061025280088684,0.22977745961899618,131561.79004245342,3659.530809190549,135221.32085164398,2749,1,1152.4242424242425,31,2,16,33.52172970343107,0.647513440860215,43.52213541666667,1025.911458333334,33.09391801075271,0
2795,4,0,1,32,0.0,0.030303030303030304,0.9696969696969697,33,350,200,150,0.5714285714285714,5,2,3,389.42146680315335,0.3113162878787879,0.019579118170667487,0.22988993107682784,131628.58963012692,3651.7996893988707,135280.3893195258,2750,2,1153.4242424242425,31,2,16,33.466697331133965,0.6481854838709677,43.45703125,1026.1718749999998,33.10231854838709,0
2796,4,0,0,32,0.0,0.0,1.0,32,1000,600,400,0.6,14,6,8,397.07274963245357,0.2999831989247312,0.02176155115511591,0.23379216155489305,131528.39660644528,4045.268419053818,135573.6650254991,2751,320,1190.40625,31,1,21,33.37194296352712,0.6471774193548387,43.5546875,1025.7812499999998,33.08971774193547,0
2797,4,1,0,33,0.030303030303030304,0.0,1.0,33,550,300,250,0.5454545454545454,8,3,5,394.6088120671262,0.3078440656565657,0.04793465272734965,0.23418206928317717,131829.0901184082,3807.049391004776,135636.13950941298,2752,0,1155.3030303030303,31,2,20,33.13059993237818,0.6502016129032258,43.26171875,1026.953125,33.12752016129032,1
2798,4,0,0,33,0.0,0.0,1.0,33,1550,1200,350,0.7741935483870968,19,12,7,395.26227779434413,0.3084753787878788,0.05409910999973078,0.23498297735641174,131895.9575229222,3826.699320475267,135722.65684339748,2753,1,1156.3030303030303,31,2,20,33.04614547682426,0.6508736559139785,43.196614583333336,1027.2135416666674,33.13592069892476,0
2799,4,1,0,34,0.029411764705882353,0.0,1.0,34,950,700,250,0.7368421052631579,12,7,5,386.65789315529264,0.31756907308377896,0.0619214049479353,0.231937790695362,132235.62168401192,3425.98937608408,135661.611060096,2754,0,1123.264705882353,32,2,21,32.92387879531877,0.6516927083333333,42.86616161616162,1028.535353535354,32.141729797979814,0
2800,4,1,0,35,0.02857142857142857,0.0,1.0,35,900,800,100,0.8888888888888888,10,8,2,380.8992240789881,0.3238795518207283,0.0633515241155369,0.23043169042013942,132555.70461180797,3098.0730067762393,135653.77761858422,2755,0,1092.142857142857,33,2,22,32.74909258598119,0.6524621212121213,42.55514705882353,1029.779411764706,31.205436720142607,0
2801,4,0,0,35,0.0,0.0,1.0,35,750,500,250,0.6666666666666666,10,5,5,381.1584474744124,0.32415966386554623,0.059413884544774254,0.2307821032114526,132587.25610342182,3107.350538254516,135694.60664167634,2756,1,1093.142857142857,33,2,22,32.710613993336494,0.6527777777777778,42.52450980392157,1029.901960784314,31.209150326797396,0
2802,4,0,0,35,0.0,0.0,1.0,35,1000,600,400,0.6,14,6,8,381.3195756698944,0.32443977591036416,0.0635600421467657,0.23126784654265015,132650.37035034606,3116.436586889655,135766.8069372357,2757,2,1094.142857142857,33,2,18,32.64285431041319,0.6534090909090909,42.463235294117645,1030.1470588235295,31.216577540106954,0
2803,4,0,1,34,0.0,0.02857142857142857,0.9714285714285714,35,1100,900,200,0.8181818181818182,13,9,4,382.71928714635783,0.32443977591036416,0.06982686567164209,0.2262014135392201,131673.7872002356,3078.819594627083,134752.60679486266,2758,3,1095.142857142857,33,2,18,33.59291044776121,0.6436237373737372,43.41299019607844,1026.348039215687,31.1014557338087,1
2804,4,1,1,34,0.02857142857142857,0.02857142857142857,0.9714285714285714,35,900,400,500,0.4444444444444444,14,4,10,384.3674047672086,0.32303921568627453,0.06936289978678034,0.22717551269762704,131673.78720023562,3122.2223724048604,134796.00957264047,2759,0,1096.0285714285715,33,2,18,33.55062189054726,0.6436237373737372,43.41299019607844,1026.3480392156873,31.101455733808706,0
2805,4,0,0,34,0.0,0.0,1.0,34,750,600,150,0.8,9,6,3,393.6008848580196,0.3190173796791444,0.07100364752200083,0.23249912733473718,131651.87225793296,3563.658682787481,135215.53094072043,2760,6,1129.264705882353,32,2,18,33.3358964895013,0.6458333333333333,43.43434343434344,1026.262626262627,32.070707070707094,0
2806,4,0,0,34,0.0,0.0,1.0,34,700,500,200,0.7142857142857143,9,5,4,393.4109840127005,0.3187017231134878,0.07136034386691081,0.23258457374830854,131684.26890432098,3561.2075617283963,135245.47646604938,2761,7,1130.264705882353,32,2,19,33.30796120884078,0.6461588541666666,43.40277777777778,1026.388888888889,32.07465277777778,0
2807,4,1,0,35,0.02857142857142857,0.0,1.0,35,600,400,200,0.6666666666666666,8,4,4,383.26592637375455,0.3216386554621849,0.06720283533260618,0.22821743797709923,131956.93963860045,3114.9197424067584,135071.8593810072,2762,0,1098.942857142857,33,2,20,33.29258110687023,0.6464646464646465,43.13725490196078,1027.4509803921562,31.134878193701702,0
2808,4,0,0,35,0.0,0.0,1.0,35,800,500,300,0.625,11,5,6,384.4829226865511,0.3207983193277311,0.07390548873973657,0.22932246014576207,132019.90370290264,3151.879685697798,135171.78338860042,2763,1,1099.942857142857,33,2,20,33.19769059543685,0.6470959595959596,43.07598039215686,1027.6960784313717,31.142305407011264,0
2809,4,0,0,35,0.0,0.0,1.0,35,700,500,200,0.7142857142857143,9,5,4,386.06729765396034,0.3206232492997199,0.08152172062054053,0.23084237776329813,132114.37795859764,3201.0081759419454,135315.38613453959,2764,2,1100.942857142857,33,2,20,33.06152401954941,0.6480429292929293,42.98406862745098,1028.063725490196,31.153446226975635,0
2810,4,0,0,35,0.0,0.0,1.0,35,800,600,200,0.75,10,6,4,398.16669128201784,0.3206232492997199,0.042410217456588795,0.2272388166829693,130327.0413255024,3385.623677344812,133712.6650028472,2765,3,1101.942857142857,32,3,18,34.56447590783562,0.6324869791666667,44.72853535353535,1021.0858585858577,31.908933080808055,8
2811,4,1,1,35,0.027777777777777776,0.027777777777777776,0.9722222222222222,36,1000,800,200,0.8,12,8,4,386.8848345915145,0.3301421957671958,0.042034573228389105,0.22275915631449306,130669.48596993937,2910.808493127639,133580.29446306702,2766,0,1072.3055555555557,33,3,15,34.5043499540533,0.6335227272727273,44.393382352941174,1022.4264705882347,30.982620320855595,0
2812,4,0,0,35,0.0,0.0,1.0,35,750,400,350,0.5333333333333333,11,4,7,394.57555529300527,0.3200280112044818,0.05062111801242253,0.2268809442934783,130617.2839506174,3307.6774691358137,133924.9614197532,2767,5,1103.942857142857,32,3,17,34.36084692028984,0.6354166666666666,44.44444444444445,1022.2222222222232,31.944444444444475,0
2813,4,0,1,34,0.0,0.02857142857142857,0.9714285714285714,35,650,500,150,0.7692307692307693,8,5,3,394.18213571816386,0.31971288515406165,0.05547048653988651,0.22703321017394665,130681.82615294353,3302.48826650341,133984.31441944695,2768,6,1104.942857142857,32,3,17,34.30528113937598,0.6360677083333334,44.38131313131313,1022.4747474747471,31.952335858585847,0
2814,4,0,0,34,0.0,0.0,1.0,34,1000,600,400,0.6,14,6,8,398.3812606578817,0.32063279857397503,0.05335470917862839,0.2293320864139066,130661.6550021701,3610.6309678819403,134272.28597005203,2769,7,1100.1764705882354,31,3,17,34.218458142299205,0.6384408602150538,44.401041666666664,1022.3958333333329,32.98051075268816,0
2815,4,2,0,36,0.05555555555555555,0.0,1.0,36,1300,900,400,0.6923076923076923,17,9,8,386.3142877243702,0.3324404761904762,0.0669840890376392,0.22664132756676578,131390.9388816801,2951.6393935024967,134342.5782751826,2770,0,1040.0,33,3,19,33.78705474539804,0.6407828282828283,43.68872549019608,1025.2450980392155,31.06803327391562,0
2816,4,1,1,36,0.02702702702702703,0.02702702702702703,0.972972972972973,37,800,600,200,0.75,10,6,4,379.4617925847107,0.3406218718718719,0.06985717017028614,0.22457783373081408,131725.001771542,2596.921060090708,134321.92283163272,2771,0,1012.8648648648649,34,3,16,33.62470524566081,0.6418504901960784,43.36309523809524,1026.5476190476195,30.192577030812338,0
2817,4,0,0,36,0.0,0.0,1.0,36,650,500,150,0.7692307692307693,8,5,3,387.8370594473545,0.3321924603174603,0.0708301108533127,0.22898325016686277,131633.36167800458,3010.459183673478,134643.82086167808,2772,2,1042.0,34,2,16,33.502513534416096,0.6409313725490196,43.452380952380956,1026.1904761904766,30.182072829131666,0
2818,4,0,0,36,0.0,0.0,1.0,36,950,700,250,0.7368421052631579,12,7,5,385.3279431607352,0.33249007936507935,0.07151875901875893,0.2282327047952049,131755.55555555568,2953.819444444465,134709.37500000015,2773,3,1043.0,34,2,16,33.44324945887446,0.642156862745098,43.33333333333334,1026.6666666666679,30.196078431372584,0
2819,4,0,0,36,0.0,0.0,1.0,36,350,100,250,0.2857142857142857,6,1,5,386.2415458937199,0.3325396825396825,0.07428341384863124,0.22895761741122572,131786.11288265308,2980.2543934240407,134766.36727607713,2774,4,1044.0,34,2,16,33.388888888888886,0.6424632352941175,43.30357142857143,1026.7857142857144,30.199579831932777,0
2820,4,0,0,36,0.0,0.0,1.0,36,500,300,200,0.6,7,3,4,385.63058378141125,0.3318287037037037,0.06950239530211699,0.22914742953622716,131877.8061224491,2971.2230725623754,134849.02919501148,2775,5,1045.0,34,2,17,33.31184322361304,0.6433823529411764,43.21428571428572,1027.1428571428582,30.210084033613477,0
2821,4,0,1,35,0.0,0.027777777777777776,0.9722222222222222,36,450,200,250,0.4444444444444444,7,2,5,386.50454949144864,0.3317956349206349,0.07158998725228893,0.22985167178233704,131908.3776218821,2996.637613378687,134905.0152352608,2776,6,1046.0,34,2,17,33.25848881678063,0.6436887254901961,43.18452380952381,1027.2619047619048,30.21358543417367,0
2822,4,0,0,35,0.0,0.0,1.0,35,750,700,50,0.9333333333333333,8,7,1,395.45264634754875,0.32829131652661064,0.07443034520398406,0.23392029419541446,131705.23356401385,3416.6366301422545,135121.8701941561,2777,7,1076.4857142857143,33,2,17,33.23434017828717,0.6439393939393939,43.38235294117647,1026.4705882352941,31.10516934046346,0
2823,4,0,0,35,0.0,0.0,1.0,35,550,400,150,0.7272727272727273,7,4,3,398.81636582156585,0.3284313725490196,0.0682032049096486,0.23669129926237442,131831.056564783,3515.276576316826,135346.33314109984,2778,8,1077.4857142857143,33,2,17,33.02058472553698,0.6452020202020201,43.25980392156864,1026.9607843137273,31.120023767082646,0
2824,4,0,1,34,0.0,0.02857142857142857,0.9714285714285714,35,650,500,150,0.7692307692307693,8,5,3,398.3960724899479,0.3285014005602241,0.07495910577971632,0.23722675225537831,131956.9396386007,3514.2252979623436,135471.16493656306,2779,9,1078.4857142857143,33,2,17,32.90394402035624,0.6464646464646464,43.137254901960794,1027.4509803921583,31.134878193701766,0
2825,4,1,1,34,0.02857142857142857,0.02857142857142857,0.9714285714285714,35,700,400,300,0.5714285714285714,10,4,6,396.8314068579927,0.3376050420168067,0.07244362695006434,0.23708132768695483,132082.88278546729,3482.9272395232765,135565.81002499055,2780,0,1063.057142857143,33,2,17,32.81672230170084,0.6477272727272727,43.01470588235295,1027.9411764705894,31.14973262032089,0
2826,4,1,0,35,0.02857142857142857,0.0,1.0,35,1300,800,500,0.6153846153846154,18,8,10,394.5457364052527,0.33869047619047615,0.08292384128496577,0.23729269361450608,132334.949298347,3442.4380046136316,135777.38730296062,2781,0,1064.0285714285715,33,2,19,32.620692393203115,0.6502525252525252,42.769607843137265,1028.9215686274524,31.179441473559166,0
2827,4,0,0,35,0.0,0.0,1.0,35,1200,1000,200,0.8333333333333334,14,10,4,396.1338287488664,0.338235294117647,0.08554804669148197,0.23907130153347633,132465.0149875218,3494.80474898102,135959.81973650283,2782,1,1065.0285714285715,31,4,19,32.448456868201355,0.6565860215053763,42.64322916666667,1029.4270833333342,33.20732526881723,0
2828,4,0,0,35,0.0,0.0,1.0,35,800,500,300,0.625,11,5,6,395.1803132486884,0.33764005602240893,0.08813106226179923,0.23913397838438247,132565.56404961488,3477.4602254231854,136043.02427503807,2783,2,1066.0285714285715,31,4,19,32.371480802461335,0.6575940860215054,42.54557291666667,1029.8177083333342,33.219926075268845,0
2829,4,0,0,35,0.0,0.0,1.0,35,900,600,300,0.6666666666666666,12,6,6,397.5454152249135,0.33749999999999997,0.08909663865546236,0.24136685924369747,132690.54178145083,3550.103305785119,136240.64508723596,2784,3,1067.0285714285715,32,3,17,32.18443627450979,0.65625,42.42424242424242,1030.30303030303,32.19696969696969,0
2830,4,0,0,35,0.0,0.0,1.0,35,1000,900,100,0.9,11,9,2,386.68253857464777,0.3384803921568627,0.04164603857591431,0.2245160802973258,130992.77388038543,3130.523667800448,134123.2975481859,2785,4,1068.0285714285715,34,1,19,34.181300151180366,0.6344975490196079,44.07738095238095,1023.6904761904758,30.108543417366935,8
2831,4,1,0,36,0.027777777777777776,0.0,1.0,36,550,300,250,0.5454545454545454,8,3,5,377.2810009816864,0.3456349206349207,0.04843152017065111,0.22080788259701445,131298.4681096749,2707.283495156018,134005.7516048309,2786,0,1039.3333333333333,35,1,20,34.112201204592516,0.6354166666666667,43.778935185185176,1024.8842592592578,29.282407407407366,0
2832,4,0,0,36,0.0,0.0,1.0,36,800,600,200,0.75,10,6,4,376.5466003107818,0.3459160052910053,0.05022062238736669,0.2209004987654259,131389.14399092968,2694.830446485435,134083.9744374151,2787,1,1040.3333333333333,34,2,20,34.039228208701054,0.6384803921568627,43.69047619047619,1025.238095238095,30.154061624649852,0
2833,4,1,3,34,0.02702702702702703,0.08108108108108109,0.9189189189189189,37,600,500,100,0.8333333333333334,7,5,2,366.74134620498705,0.3531969469469469,0.04379730916166369,0.21643440068781356,131616.85333982628,2253.8683954224443,133870.72173524872,2788,0,1013.1891891891892,36,1,18,34.06039654667837,0.6365740740740742,43.468468468468465,1026.1261261261259,28.503503503503495,0
2834,4,0,0,34,0.0,0.0,1.0,34,650,400,250,0.6153846153846154,9,4,5,392.9468516845466,0.33357471776589426,0.07266063564866321,0.22977773243259964,131265.32613658198,3516.059328143011,134781.385464725,2789,3,1102.8529411764705,33,1,20,33.744419197959026,0.6395202020202021,43.811274509803916,1024.7549019607834,31.053178847296465,0
2835,4,0,0,34,0.0,0.0,1.0,34,1250,900,350,0.72,16,9,7,403.08340249114354,0.3341317587641117,0.0753852210100101,0.23686811180097533,131453.76778162242,3797.366397539404,135251.13417916183,2790,4,1103.8529411764705,33,1,20,33.29349904397705,0.6414141414141414,43.627450980392155,1025.4901960784312,31.075460487225186,0
2836,4,1,0,35,0.02857142857142857,0.0,1.0,35,700,400,300,0.5714285714285714,10,4,6,394.551673975375,0.3399159663865546,0.08353432282003692,0.23369599150849157,131755.55555555562,3396.875000000007,135152.43055555562,2791,0,1073.2857142857142,34,1,19,33.20650703463204,0.642156862745098,43.333333333333336,1026.6666666666672,30.196078431372566,0
2837,4,0,0,35,0.0,0.0,1.0,35,1100,900,200,0.8181818181818182,13,9,4,389.90906040838246,0.3396008403361344,0.07777998542949893,0.2316897639947331,131877.80612244896,3284.070294784583,135161.87641723355,2792,1,1074.2857142857142,34,1,19,33.2019780559419,0.6433823529411764,43.214285714285715,1027.142857142857,30.210084033613445,0
2838,4,0,0,35,0.0,0.0,1.0,35,700,400,300,0.5714285714285714,10,4,6,389.0132376616107,0.33956582633053217,0.07687468962092403,0.23152994765653104,131938.95266439908,3265.199829931975,135204.15249433107,2793,2,1075.2857142857142,34,1,19,33.16314213982235,0.6439950980392157,43.154761904761905,1027.3809523809523,30.21708683473389,0
2839,4,0,0,35,0.0,0.0,1.0,35,750,500,250,0.6666666666666666,10,5,5,388.7371686789932,0.33953081232492993,0.07666490136369641,0.23173889779261536,132000.11337868485,3262.6700680272097,135262.78344671207,2794,3,1076.2857142857142,34,1,19,33.10839511893727,0.6446078431372548,43.095238095238095,1027.619047619048,30.22408963585435,0
2840,4,0,0,35,0.0,0.0,1.0,35,1400,1000,400,0.7142857142857143,18,10,8,392.80544703689486,0.3390756302521008,0.06537322813807744,0.2351116178834135,132153.0771683672,3382.0897108843355,135535.16687925154,2795,4,1077.2857142857142,34,1,19,32.84922426768553,0.646139705882353,42.94642857142856,1028.2142857142844,30.241596638655423,0
2841,4,1,1,35,0.027777777777777776,0.027777777777777776,0.9722222222222222,36,750,600,150,0.8,9,6,3,382.4966839577304,0.34505621693121696,0.05552664379425143,0.23080591948237877,132459.2704790247,2933.2731009070044,135392.54357993172,2796,0,1048.3333333333333,34,2,19,32.80521182683782,0.6492034313725491,42.64880952380951,1029.40476190476,30.27661064425765,0
2842,4,0,0,35,0.0,0.0,1.0,35,800,700,100,0.875,9,7,2,366.53477619206245,0.3393557422969187,0.03540520345085274,0.2234268505309874,132839.80320069182,2738.081507112624,135577.88470780445,2797,6,1079.2857142857142,33,2,16,32.83305595181487,0.6553030303030305,42.27941176470587,1030.8823529411748,31.2388591800356,2
2843,4,0,0,35,0.0,0.0,1.0,35,900,600,300,0.6666666666666666,12,6,6,366.1932074042272,0.33928571428571425,0.033601029006778305,0.2238766235527742,132949.91673752788,2737.071286848024,135686.9880243759,2798,7,1080.2857142857142,34,1,16,32.73115548886067,0.6541053921568629,42.17261904761902,1031.3095238095202,30.332633053221183,0
2844,4,0,0,35,0.0,0.0,1.0,35,950,800,150,0.8421052631578947,11,8,3,367.38131229809517,0.33970588235294114,0.03292441630391796,0.224787548711207,132980.61224489764,2770.9183673469024,135751.53061224453,2799,8,1081.2857142857142,34,1,16,32.66966759002771,0.6544117647058825,42.142857142857125,1031.4285714285688,30.336134453781437,0
2845,4,0,0,35,0.0,0.0,1.0,35,650,500,150,0.7692307692307693,8,5,3,368.0959179039626,0.3396008403361344,0.03757212093238005,0.22559541899262614,133042.01388888856,2794.444444444407,135836.45833333296,2800,9,1082.2857142857142,34,1,17,32.58952611739364,0.6550245098039218,42.083333333333314,1031.666666666664,30.343137254901883,0
2846,4,0,0,35,0.0,0.0,1.0,35,350,100,250,0.2857142857142857,6,1,5,367.9493435890298,0.3393207282913165,0.04104897064398627,0.22569122157721977,133072.72002550992,2792.8039965986013,135865.52402210853,2801,10,1083.2857142857142,34,1,18,32.56244952117225,0.6553308823529413,42.05357142857141,1031.785714285712,30.346638655462115,0
2847,4,1,2,34,0.027777777777777776,0.05555555555555555,0.9444444444444444,36,600,400,200,0.6666666666666666,8,4,4,359.099643672646,0.3452380952380953,0.04092879025629559,0.22156895026606782,133292.88435570954,2373.0854552468722,135665.96981095642,2802,0,1054.1666666666667,35,1,18,32.56977135171485,0.6553571428571431,41.84027777777776,1032.6388888888862,29.50396825396818,0
2848,4,0,0,34,0.0,0.0,1.0,34,400,300,100,0.75,5,3,2,376.4921946740129,0.3331662210338681,0.05294117647058849,0.2300785634118967,132934.57031249988,3209.7656249999864,136144.33593749988,2803,17,1116.8529411764705,33,1,18,32.48106060606061,0.65625,42.18749999999999,1031.249999999999,31.24999999999997,0
2849,4,0,0,34,0.0,0.0,1.0,34,650,500,150,0.7692307692307693,8,5,3,377.28584156197144,0.33281342840166367,0.05688045180049217,0.23075854960650807,132966.16685890034,3233.250432525937,136199.41729142627,2804,18,1117.8529411764705,33,1,18,32.428806242078565,0.6565656565656567,42.15686274509803,1031.372549019607,31.25371360665476,0
2850,4,0,0,34,0.0,0.0,1.0,34,750,400,350,0.5333333333333333,11,4,7,379.27901387538225,0.3323306595365419,0.05633965190779966,0.23256737201870664,133060.97902549498,3293.44738201653,136354.42640751152,2805,19,1118.8529411764705,33,1,18,32.28201587678663,0.6575126262626263,42.064950980392155,1031.7401960784312,31.264854426619127,0
2851,4,0,0,34,0.0,0.0,1.0,34,900,600,300,0.6666666666666666,12,6,6,379.14400217584205,0.3324792038027332,0.056612670005658616,0.2328790402861242,133124.20590938564,3294.648842993058,136418.85475237868,2806,20,1119.8529411764705,33,1,18,32.22190060562879,0.6581439393939394,42.003676470588225,1031.9852941176457,31.272281639928657,0
2852,4,0,0,34,0.0,0.0,1.0,34,700,600,100,0.8571428571428571,8,6,2,377.59492854964066,0.33231209150326796,0.05722407699722032,0.23212441520037005,133155.8249831794,3255.7928440984037,136411.6178272778,2807,21,1120.8529411764705,33,1,18,32.23007203356288,0.658459595959596,41.97303921568626,1032.1078431372537,31.275995246583445,0
2853,4,1,1,34,0.02857142857142857,0.02857142857142857,0.9714285714285714,35,800,600,200,0.75,10,6,4,371.16732482335163,0.34005602240896354,0.049497028268493004,0.22955230773287377,133379.97626133775,2901.2577947845643,136281.2340561223,2808,0,1089.8,34,1,18,32.17077715032076,0.6583946078431373,41.75595238095237,1032.9761904761895,30.381652661064397,0
2854,4,0,0,34,0.0,0.0,1.0,34,750,500,250,0.6666666666666666,10,5,5,375.8663195294436,0.3311237373737374,0.05492104271093723,0.2318484339937841,133282.33882401,3219.268430411383,136501.60725442137,2809,23,1122.8529411764705,33,1,18,32.14751958224544,0.6597222222222222,41.85049019607843,1032.5980392156864,31.29084967320262,0
2855,4,0,0,34,0.0,0.0,1.0,34,700,500,200,0.7142857142857143,9,5,4,374.5960903186172,0.3315136660724896,0.051972301914714025,0.23126163026483423,133313.9766706315,3187.7788891291825,136501.75555976067,2810,24,1123.8529411764705,33,1,18,32.148525572564374,0.6600378787878787,41.81985294117647,1032.7205882352941,31.2945632798574,0
2856,4,0,0,34,0.0,0.0,1.0,34,800,400,400,0.5,12,4,8,378.86326442449086,0.3319407308377897,0.0533319377573096,0.23449466366361663,133408.91273788924,3308.7472366397515,136717.659974529,2811,25,1124.8529411764705,33,1,18,31.942961644918935,0.6609848484848485,41.72794117647059,1033.0882352941176,31.305704099821746,0
2857,4,0,0,34,0.0,0.0,1.0,34,850,600,250,0.7058823529411765,11,6,5,379.59698194595956,0.33142082590612004,0.052528707549474474,0.2357648629901083,133537.46588358338,3338.09882348617,136875.56470706954,2812,26,1125.8529411764705,32,2,18,31.79488354100496,0.6647135416666666,41.60353535353536,1033.5858585858591,32.2995580808081,0
2858,4,0,0,34,0.0,0.0,1.0,34,1050,700,350,0.6666666666666666,14,7,7,379.6657278909,0.3308266488413547,0.055245840397712964,0.23622363069686086,133602.7254871952,3344.8752040608133,136947.600691256,2813,27,1126.8529411764705,32,2,19,31.727578977365265,0.6653645833333334,41.54040404040404,1033.8383838383838,32.307449494949495,0
2859,4,0,0,34,0.0,0.0,1.0,34,750,500,250,0.6666666666666666,10,5,5,388.29605235740894,0.3310680332739156,-0.04505195394353112,0.23760228102679215,132983.40292125806,3592.6855359147016,136576.08845717277,2814,28,1127.8529411764705,32,2,15,32.12755539233688,0.6591796875,42.140151515151516,1031.4393939393942,32.23248106060607,6
2860,4,1,0,35,0.02857142857142857,0.0,1.0,35,850,700,150,0.8235294117647058,10,7,3,382.414151925078,0.3357142857142857,-0.023732718894009297,0.2370967741935485,133472.22222222228,3208.3333333333435,136680.55555555562,2815,0,1096.6,33,2,16,31.787634408602152,0.6616161616161615,41.66666666666667,1033.333333333334,31.313131313131333,0
2861,4,0,0,35,0.0,0.0,1.0,35,800,600,200,0.75,10,6,4,381.7352644513208,0.3353641456582633,-0.022137520963561474,0.2368781078085349,133503.882596237,3192.627985630519,136696.51058186754,2816,1,1097.6,33,2,16,31.773365548045366,0.6619318181818181,41.6360294117647,1033.455882352941,31.316844919786092,0
2862,4,0,0,35,0.0,0.0,1.0,35,1050,600,450,0.5714285714285714,15,6,9,380.0239566910249,0.3353991596638655,-0.0240155813362688,0.2362197549512746,133567.21460796337,3151.748275903505,136718.9628838669,2817,2,1098.6,33,2,17,31.753976486860296,0.6625631313131313,41.57475490196079,1033.7009803921574,31.32427213309568,0
2863,4,1,1,35,0.027777777777777776,0.027777777777777776,0.9722222222222222,36,850,700,150,0.8235294117647058,10,7,3,371.89396801282146,0.3412202380952381,-0.008717344993833587,0.22891113186379278,133203.26063368065,2707.4978298611168,135910.75846354177,2818,0,1069.0555555555557,35,1,20,32.329507231752416,0.6544642857142856,41.927083333333336,1032.2916666666674,29.49404761904764,8
2864,4,1,0,36,0.027777777777777776,0.0,1.0,36,1050,800,250,0.7619047619047619,13,8,5,375.05500484133074,0.33776455026455027,-0.004464619293132799,0.23141360672160116,133292.8843557099,2798.4326774691385,136091.31703317902,2819,0,1070.0277777777778,35,1,21,32.15786819098857,0.6553571428571429,41.84027777777778,1032.638888888889,29.503968253968253,0
2865,4,0,0,36,0.0,0.0,1.0,36,700,400,300,0.5714285714285714,10,4,6,374.2443678893511,0.3380456349206349,-0.007306336932023205,0.2310991345797009,133322.76562767907,2779.058829518167,136101.82445719725,2820,1,1071.0277777777778,35,1,21,32.14877750382906,0.6556547619047619,41.81134259259259,1032.7546296296289,29.50727513227511,0
2866,4,0,0,36,0.0,0.0,1.0,36,900,700,200,0.7777777777777778,11,7,4,372.40950802748966,0.3381283068783069,-0.0010394104613238309,0.23052200198705775,133412.4295374657,2736.811449759948,136149.24098722567,2821,2,1072.0277777777778,35,1,21,32.106113227276126,0.6565476190476189,41.72453703703704,1033.101851851852,29.51719576719577,0
2867,4,0,0,36,0.0,0.0,1.0,36,700,600,100,0.8571428571428571,8,6,2,373.5145388276808,0.33837632275132273,-0.0007436864443697289,0.23139238640629484,133442.32420535415,2768.529637131352,136210.8538424855,2822,3,1073.0277777777778,35,1,21,32.047557036705115,0.6568452380952381,41.695601851851855,1033.217592592593,29.52050264550266,0
2868,4,0,0,36,0.0,0.0,1.0,36,900,600,300,0.6666666666666666,12,6,6,375.88706338788836,0.3387400793650794,-0.007847198895233554,0.23361498699493619,133561.9363667053,2840.840808256179,136402.7771749615,2823,4,1074.0277777777778,35,1,22,31.86618239838764,0.6580357142857143,41.579861111111114,1033.6805555555559,29.53373015873017,0
2869,4,0,0,36,0.0,0.0,1.0,36,900,700,200,0.7777777777777778,11,7,4,375.96898214283203,0.33829365079365076,-0.009566104393690544,0.23385480142756102,133591.84777949256,2845.2782064471994,136437.12598593975,2824,5,1075.0277777777778,35,1,22,31.834042394387215,0.6583333333333332,41.55092592592593,1033.796296296297,29.537037037037056,0
2870,4,0,0,36,0.0,0.0,1.0,36,850,700,150,0.8235294117647058,10,7,3,381.61029257474854,0.33829365079365076,0.011888663511381736,0.22666731836066384,131862.52170138882,2864.019097222218,134726.54079861104,2825,6,1076.0277777777778,35,1,20,33.43052738336714,0.6410714285714285,43.229166666666664,1027.0833333333328,29.34523809523808,2
2871,4,0,0,36,0.0,0.0,1.0,36,600,200,400,0.3333333333333333,10,2,8,380.1451880213542,0.33771494708994704,0.017733093011903067,0.2263278896086895,131951.6933111497,2832.16025270061,134783.8535638503,2826,7,1077.0277777777778,35,1,20,33.378041568097316,0.6419642857142858,43.14236111111111,1027.4305555555554,29.355158730158728,0
2872,4,0,0,36,0.0,0.0,1.0,36,850,500,350,0.5882352941176471,12,5,7,378.59751643535435,0.33730158730158727,0.021771771771771586,0.2259372275501308,132040.8950617283,2798.0709876543106,134838.9660493826,2827,8,1078.0277777777778,35,1,21,33.3277027027027,0.6428571428571428,43.05555555555555,1027.7777777777771,29.365079365079346,0
2873,4,0,1,35,0.0,0.027777777777777776,0.9722222222222222,36,400,200,200,0.5,6,2,4,378.59751643535435,0.33730158730158727,0.021771771771771586,0.2259372275501308,132040.8950617283,2798.0709876543106,134838.9660493826,2828,9,1079.0277777777778,35,1,21,33.3277027027027,0.6428571428571428,43.05555555555555,1027.7777777777771,29.365079365079346,0
2874,4,0,0,35,0.0,0.0,1.0,35,1000,600,400,0.6,14,6,8,387.05270326774104,0.33578431372549017,0.027808622604161615,0.23044043238817824,131951.69331114978,3214.4519193672922,135166.14523051708,2829,14,1110.6,35,0,21,33.200616762419735,0.6419642857142855,43.142361111111114,1027.430555555556,29.355158730158745,0
2875,4,0,0,35,0.0,0.0,1.0,35,750,700,50,0.9333333333333333,8,7,1,385.17165814463107,0.33592436974789913,0.025482625482625698,0.2298605056669573,132040.89506172843,3171.6820987654355,135212.57716049388,2830,15,1111.6,35,0,21,33.15878378378379,0.6428571428571428,43.05555555555556,1027.777777777778,29.365079365079374,0
2876,4,0,0,35,0.0,0.0,1.0,35,800,700,100,0.875,9,7,2,388.0096682621636,0.3365196078431372,0.024776484209172223,0.23228287687608237,132159.87761488344,3255.862054183818,135415.73966906726,2831,16,1112.6,35,0,21,32.965631097103405,0.644047619047619,42.93981481481482,1028.240740740741,29.378306878306887,0
2877,4,0,0,35,0.0,0.0,1.0,35,450,300,150,0.6666666666666666,6,3,3,390.6835217732055,0.3362394957983193,0.028243464840358445,0.23425194159761842,132219.3889853395,3331.1873070987635,135550.57629243826,2832,17,1113.6,35,0,21,32.83676569885212,0.6446428571428571,42.88194444444444,1028.4722222222222,29.384920634920633,0
2878,4,0,0,35,0.0,0.0,1.0,35,350,200,150,0.5714285714285714,5,2,3,391.51319261509406,0.3361694677871148,0.03148097542156303,0.23493435130117074,132249.14969403707,3355.457363468778,135604.60705750584,2833,18,1114.6,35,0,21,32.785365327632114,0.6449404761904762,42.85300925925925,1028.587962962962,29.388227513227484,0
2879,4,0,1,34,0.0,0.02857142857142857,0.9714285714285714,35,950,600,350,0.631578947368421,13,6,7,393.87631333082,0.336484593837535,0.03331405436668611,0.2372864619334453,132398.00347222228,3429.938673482515,135827.9421457048,2834,19,1115.6,32,3,21,32.57422402159244,0.6533203125,42.708333333333336,1029.166666666667,32.16145833333334,0
2880,4,0,0,34,0.0,0.0,1.0,34,650,500,150,0.7692307692307693,8,5,3,398.79362061335206,0.32993538324420674,0.055608478209097534,0.24024883973536096,132398.00347222228,3759.8958333333385,136157.89930555562,2835,20,1148.0,31,3,21,32.44770580296896,0.6559139784946236,42.708333333333336,1029.166666666667,33.19892473118281,0
2881,4,0,0,34,0.0,0.0,1.0,34,900,600,300,0.6666666666666666,12,6,6,394.8657222636435,0.32965686274509803,0.05784962991819298,0.2384988962472408,132495.48037190083,3663.584710743808,136159.06508264464,2836,21,1149.0,32,2,21,32.45033112582783,0.654296875,42.61363636363637,1029.5454545454547,32.17329545454546,0
2882,4,0,0,34,0.0,0.0,1.0,34,900,600,300,0.6666666666666666,12,6,6,392.65779357325073,0.32954545454545453,0.05211052305207464,0.23798679643169254,132625.5053693502,3615.287661973284,136240.79303132347,2837,22,1150.0,32,2,19,32.37593977282013,0.6555989583333333,42.487373737373744,1030.050505050506,32.18907828282831,0
2883,4,0,0,34,0.0,0.0,1.0,34,700,600,100,0.8571428571428571,8,6,2,393.620242214533,0.3295083184789067,0.05971020761245738,0.23898371848739502,132690.5417814509,3645.9366391184667,136336.4784205694,2838,23,1151.0,32,2,19,32.28553921568628,0.65625,42.42424242424243,1030.3030303030307,32.19696969696971,0
2884,4,0,0,34,0.0,0.0,1.0,34,1000,900,100,0.9,11,9,2,395.84862068715023,0.32917409387997626,0.06611701284287363,0.24075383323759456,132755.5941358025,3710.223765432106,136465.8179012346,2839,24,1152.0,32,2,19,32.16251123090748,0.6569010416666666,42.361111111111114,1030.5555555555557,32.204861111111114,0
2885,4,0,0,34,0.0,0.0,1.0,34,550,400,150,0.7272727272727273,7,4,3,392.9967423305323,0.3289327094474153,0.06728981109914844,0.23996187155073273,132902.97752066507,3646.0874423298615,136549.06496299492,2840,25,1153.0,33,1,19,32.087394025829965,0.6559343434343434,42.218137254901954,1031.1274509803916,31.2462863933452,0
2886,4,1,0,35,0.02857142857142857,0.0,1.0,35,1000,900,100,0.9,11,9,2,384.4582935156252,0.3370798319327731,0.07540643375994494,0.23698697794321366,133257.03125,3246.3541666666674,136503.38541666666,2841,0,1121.0285714285715,34,1,20,31.951170298627936,0.6571691176470589,41.875,1032.5,30.36764705882353,0
2887,4,0,0,35,0.0,0.0,1.0,35,700,600,100,0.8571428571428571,8,6,2,384.4582935156252,0.3370798319327731,0.07540643375994494,0.23698697794321366,133257.03125,3246.3541666666674,136503.38541666666,2842,1,1122.0285714285715,34,1,20,31.951170298627936,0.6571691176470589,41.875,1032.5,30.36764705882353,0
2888,4,0,0,35,0.0,0.0,1.0,35,800,300,500,0.375,13,3,10,380.5235493811219,0.33721988795518204,0.07386550747546594,0.23514403948935994,133349.23469387757,3148.504818594103,136497.7395124717,2843,2,1123.0285714285715,34,1,20,31.960052635623175,0.6580882352941178,41.785714285714285,1032.857142857143,30.378151260504204,0
2889,4,0,0,35,0.0,0.0,1.0,35,700,500,200,0.7142857142857143,9,5,4,378.9770927950119,0.3367647058823529,0.07181547276049982,0.23438234028384333,133379.976261338,3109.591128117926,136489.56738945591,2844,3,1124.0285714285715,34,1,20,31.969094541124036,0.6583946078431373,41.75595238095239,1032.9761904761915,30.381652661064457,0
2890,4,0,0,35,0.0,0.0,1.0,35,800,500,300,0.625,11,5,6,378.7788997952123,0.3367647058823529,0.07191356542617067,0.23427593074651898,133382.53821855705,3104.4982156635792,136487.03643422062,2845,4,1125.0285714285715,35,0,20,31.97163865546219,0.65625,41.75347222222222,1032.9861111111109,29.513888888888882,0
2891,4,0,0,35,0.0,0.0,1.0,35,1250,1100,150,0.88,14,11,3,376.8586896730752,0.33578431372549017,0.07740339821449749,0.233852047830246,133503.882596237,3062.47993393299,136566.36253016998,2846,5,1126.0285714285715,33,2,20,31.89935867030316,0.6619318181818181,41.6360294117647,1033.455882352941,31.316844919786092,0
2892,4,0,0,35,0.0,0.0,1.0,35,900,600,300,0.6666666666666666,12,6,6,377.1465126221883,0.3360644257703081,0.07946068633761305,0.23423075754459033,133535.54672481734,3072.493151672428,136608.03987648975,2847,6,1127.0285714285715,33,2,20,31.86012963402102,0.6622474747474747,41.60539215686274,1033.5784313725487,31.32055852644087,0
2893,4,0,0,35,0.0,0.0,1.0,35,1000,700,300,0.7,13,7,6,378.19801964734654,0.3362394957983193,0.0722581518978771,0.2356894305601409,133662.2407847942,3110.158953287186,136772.39973808138,2848,7,1128.0285714285715,33,2,20,31.705775460219638,0.663510101010101,41.482843137254896,1034.0686274509796,31.33541295305999,0
2894,4,0,0,35,0.0,0.0,1.0,35,750,400,350,0.5333333333333333,11,4,7,377.9086066801432,0.33609943977591034,0.07244233080034568,0.2361159547732855,133757.3007527153,3109.6070321510965,136866.9077848664,2849,8,1129.0285714285715,33,2,20,31.617872092564077,0.6644570707070707,41.39093137254902,1034.4362745098038,31.346553773024358,0
2895,4,0,0,35,0.0,0.0,1.0,35,950,800,150,0.8421052631578947,11,8,3,362.82899273990716,0.33567927170868345,0.11437539033100097,0.22369021729320707,133263.00643272008,2670.3364786950992,135933.34291141518,2850,9,1130.0285714285715,35,0,19,32.503479617382204,0.6550595238095239,41.86921296296295,1032.523148148146,29.500661375661313,3
2896,4,1,1,35,0.027777777777777776,0.027777777777777776,0.9722222222222222,36,700,400,300,0.5714285714285714,10,4,6,356.4755271906624,0.3422619047619047,0.11488033039757184,0.22172976384867638,133591.84777949232,2324.6089731224083,135916.45675261473,2851,0,1099.611111111111,35,1,19,32.3378489326765,0.6583333333333334,41.55092592592592,1033.7962962962952,29.537037037037006,0
2897,4,0,0,35,0.0,0.0,1.0,35,850,600,250,0.7058823529411765,11,6,5,364.96314737274736,0.33525910364145656,0.12012964577746299,0.2268414465739131,133564.50007086166,2749.2240646258438,136313.72413548752,2852,11,1132.0285714285715,34,1,19,32.145907712388166,0.6602328431372548,41.57738095238095,1033.6904761904761,30.402661064425768,0
2898,4,0,0,35,0.0,0.0,1.0,35,600,400,200,0.6666666666666666,8,4,4,364.96314737274736,0.33525910364145656,0.12012964577746299,0.2268414465739131,133564.50007086166,2749.2240646258438,136313.72413548752,2853,12,1133.0285714285715,34,1,19,32.145907712388166,0.6602328431372548,41.57738095238095,1033.6904761904761,30.402661064425768,0
2899,4,0,0,35,0.0,0.0,1.0,35,700,500,200,0.7142857142857143,9,5,4,364.96314737274736,0.33525910364145656,0.12012964577746299,0.2268414465739131,133564.50007086166,2749.2240646258438,136313.72413548752,2854,13,1134.0285714285715,34,1,19,32.145907712388166,0.6602328431372548,41.57738095238095,1033.6904761904761,30.402661064425768,0
2900,4,0,0,35,0.0,0.0,1.0,35,1200,900,300,0.75,15,9,6,368.1257219468812,0.33466386554621846,0.12729103726082625,0.22990493200833503,133741.45507812497,2846.733940972222,136588.1890190972,2855,14,1135.0285714285715,35,0,17,31.88674890902988,0.6598214285714286,41.40625,1034.3749999999998,29.553571428571423,0
2901,4,0,0,35,0.0,0.0,1.0,35,900,500,400,0.5555555555555556,13,5,8,364.9385162830505,0.3343487394957983,0.13069990412272303,0.2284699114545146,133831.25964506157,2768.036265432081,136599.29591049365,2856,15,1136.0285714285715,35,0,17,31.879194630872483,0.6607142857142858,41.319444444444436,1034.722222222221,29.56349206349203,0
2902,4,0,0,35,0.0,0.0,1.0,35,750,500,250,0.6666666666666666,10,5,5,364.93932355343804,0.33420868347338933,0.1297649671657055,0.22865609613814203,133861.2011986667,2770.243243098408,136631.4444417651,2857,16,1137.0285714285715,35,0,18,31.849182604481236,0.6610119047619047,41.29050925925925,1034.837962962962,29.56679894179891,0
2903,4,0,0,35,0.0,0.0,1.0,35,550,400,150,0.7272727272727273,7,4,3,363.3100433365128,0.33403361344537813,0.12952040131642018,0.22782036518338683,133891.14610125162,2728.7996184842145,136619.94571973584,2858,17,1138.0285714285715,35,0,18,31.861347200477145,0.6613095238095239,41.26157407407407,1034.953703703703,29.570105820105802,0
2904,4,0,0,35,0.0,0.0,1.0,35,450,300,150,0.6666666666666666,6,3,3,363.87813109178126,0.3336484593837535,0.12464744869440203,0.22873435577062445,133981.000902885,2750.551242069617,136731.5521449546,2859,18,1139.0285714285715,35,0,19,31.75668436743059,0.6622023809523809,41.17476851851852,1035.3009259259263,29.580026455026466,0
2905,4,0,0,35,0.0,0.0,1.0,35,700,500,200,0.7142857142857143,9,5,4,368.496685149246,0.33371848739495796,0.1287294669795509,0.23239442109940828,134100.85419077936,2883.144048996915,136983.99823977627,2860,19,1140.0285714285715,35,0,19,31.51713878645658,0.6633928571428571,41.05902777777778,1035.7638888888891,29.593253968253975,0
2906,4,0,0,35,0.0,0.0,1.0,35,800,600,200,0.75,10,6,4,365.73294235010167,0.3336834733893557,0.1303094626298742,0.23102862152263634,134160.80092860505,2813.4048943329854,136974.20582293803,2861,20,1141.0285714285715,35,0,19,31.52871653074144,0.6639880952380952,41.001157407407405,1035.9953703703698,29.599867724867707,0
2907,4,0,0,35,0.0,0.0,1.0,35,650,300,350,0.46153846153846156,10,3,7,364.22817850579725,0.334453781512605,0.12706355411593906,0.2304547619902759,134220.76106234998,2777.3966638803176,136998.1577262303,2862,21,1142.0285714285715,35,0,19,31.50771156781713,0.6645833333333333,40.94328703703704,1036.226851851852,29.606481481481485,0
2908,4,0,0,35,0.0,0.0,1.0,35,950,500,450,0.5263157894736842,14,5,9,359.6422268682526,0.3339285714285714,0.12173802080010265,0.22811301585212954,134310.72638031546,2660.761745541837,136971.48812585732,2863,22,1143.0285714285715,35,0,19,31.536586273634065,0.6654761904761904,40.85648148148148,1036.5740740740737,29.616402116402107,0
2909,4,0,0,35,0.0,0.0,1.0,35,550,300,250,0.5454545454545454,8,3,5,360.95662320568096,0.3337535014005602,0.12239977035690353,0.22932265465790722,134370.7200038581,2700.4002700617352,137071.12027391983,2864,23,1144.0285714285715,35,0,19,31.442565304755536,0.6660714285714285,40.798611111111114,1036.8055555555559,29.623015873015884,0
2910,4,0,0,35,0.0,0.0,1.0,35,550,400,150,0.7272727272727273,7,4,3,363.1485085606059,0.3339285714285714,0.12004973379666506,0.23147488860029533,134490.74743870035,2768.022869513039,137258.7703082134,2865,24,1145.0285714285715,35,0,19,31.265807483448626,0.6672619047619047,40.682870370370374,1037.2685185185192,29.636243386243404,0
2911,4,0,0,35,0.0,0.0,1.0,35,950,600,350,0.631578947368421,13,6,7,365.0962144722814,0.33406862745098037,0.11679706796271216,0.23329205721625124,134580.80317911954,2826.9883562671507,137407.7915353867,2866,25,1146.0285714285715,35,0,19,31.125325339282387,0.6681547619047619,40.59606481481482,1037.615740740741,29.646164021164033,0
2912,4,0,0,35,0.0,0.0,1.0,35,1300,1100,200,0.8461538461538461,15,11,4,364.3801212916018,0.33403361344537813,0.11629922263285364,0.23341149483879192,134670.88906035668,2814.278978052127,137485.1680384088,2867,26,1147.0285714285715,35,0,19,31.053932500743386,0.669047619047619,40.50925925925926,1037.962962962963,29.65608465608466,0
2913,4,0,0,35,0.0,0.0,1.0,35,700,300,400,0.42857142857142855,11,3,8,362.29386056889155,0.3343487394957983,0.11419653805118068,0.23265126865880636,134761.0050824117,2764.6169570901898,137525.62203950188,2868,27,1148.0285714285715,35,0,19,31.018118567235156,0.6699404761904761,40.4224537037037,1038.3101851851852,29.66600529100529,0
2914,4,0,0,35,0.0,0.0,1.0,35,600,500,100,0.8333333333333334,7,5,2,362.33199080350835,0.3346288515406162,0.1144130947073434,0.23286838262815734,134791.05045438948,2767.8219307270097,137558.8723851165,2869,28,1149.0285714285715,35,0,17,30.98714519245058,0.6702380952380953,40.39351851851851,1038.4259259259252,29.66931216931215,0
2915,4,0,0,35,0.0,0.0,1.0,35,900,800,100,0.8888888888888888,10,8,2,360.7821789092266,0.33473389355742295,0.11460405889375291,0.23244939380547783,134881.20666420166,2732.547126843262,137613.75379104493,2870,29,1150.0285714285715,35,0,17,30.93744196843083,0.6711309523809523,40.306712962962955,1038.773148148147,29.679232804232768,0
2916,4,0,0,35,0.0,0.0,1.0,35,600,500,100,0.8333333333333334,7,5,2,360.7821789092266,0.33473389355742295,0.11460405889375291,0.23244939380547783,134881.20666420166,2732.547126843262,137613.75379104493,2871,30,1151.0285714285715,35,0,17,30.93744196843083,0.6711309523809523,40.306712962962955,1038.773148148147,29.679232804232768,0
2917,4,0,0,35,0.0,0.0,1.0,35,700,400,300,0.5714285714285714,10,4,6,360.4546611009886,0.3344187675070028,0.11709925364821183,0.23262411881406003,134941.32754897545,2728.0460980366856,137669.37364701214,2872,31,1152.0285714285715,35,0,17,30.88599105120491,0.6717261904761905,40.24884259259259,1039.0046296296293,29.685846560846553,0
2918,4,0,0,35,0.0,0.0,1.0,35,900,700,200,0.7777777777777778,11,7,4,363.2700234621851,0.33448879551820726,0.12072542157174726,0.23502628319095273,135031.53399348422,2810.5817043895763,137842.11569787379,2873,32,1153.0285714285715,35,0,17,30.722902746844834,0.6726190476190477,40.16203703703704,1039.351851851852,29.6957671957672,0
2919,4,0,0,35,0.0,0.0,1.0,35,1350,900,450,0.6666666666666666,18,9,9,362.5428362511031,0.3341036414565826,0.11904231979905222,0.2357315431658766,135212.03730495553,2804.0310999657167,138016.06840492124,2874,33,1154.0285714285715,35,0,17,30.561892573633045,0.6744047619047618,39.98842592592593,1040.0462962962972,29.715608465608494,0
2920,4,0,0,35,0.0,0.0,1.0,35,750,400,350,0.5333333333333333,11,4,7,348.8761260387491,0.3338235294117647,0.09489216076402718,0.22477840855691117,134881.20666420183,2411.366571287722,137292.57323548954,2875,34,1155.0285714285715,35,0,19,31.24663416898794,0.6711309523809523,40.30671296296296,1038.773148148148,29.6792328042328,1
2921,4,0,0,35,0.0,0.0,1.0,35,900,400,500,0.4444444444444444,14,4,10,349.4069263321628,0.33396358543417365,0.09070577568517679,0.22624539332293842,135061.60950628007,2438.292368612833,137499.9018748929,2876,35,1156.0285714285715,35,0,20,31.053172438110078,0.6729166666666666,40.133101851851855,1039.467592592593,29.699074074074087,0
2922,4,0,0,35,0.0,0.0,1.0,35,750,400,350,0.5333333333333333,11,4,7,350.11162176248115,0.33455882352941174,0.09272597185785858,0.2274586349628267,135181.94504726076,2465.75400270061,137647.69904996137,2877,36,1157.0285714285715,35,0,20,30.91506677796326,0.6741071428571428,40.01736111111111,1039.9305555555552,29.712301587301578,0
2923,4,0,0,35,0.0,0.0,1.0,35,1100,900,200,0.8181818181818182,13,9,4,349.285231047668,0.3346988795518207,0.09201863008472566,0.22730096824224416,135242.1329116298,2447.615928283608,137689.7488399134,2878,37,1158.0285714285715,35,0,20,30.876659804903376,0.6747023809523809,39.95949074074074,1040.1620370370372,29.71891534391535,0
2924,4,0,0,35,0.0,0.0,1.0,35,1000,600,400,0.6,14,6,8,347.46055737819046,0.334453781512605,0.08787883603769697,0.22649187456653772,135302.33417191796,2402.444889188965,137704.77906110694,2879,38,1159.0285714285715,35,0,20,30.864227574442836,0.675297619047619,39.901620370370374,1040.3935185185192,29.72552910052912,0
2925,4,0,0,35,0.0,0.0,1.0,35,850,500,350,0.5882352941176471,12,5,7,348.29899987750565,0.33420868347338933,0.09084379469251558,0.22722844767044817,135332.43982553153,2427.23068844307,137759.6705139746,2880,39,1160.0285714285715,35,0,20,30.81247682610307,0.6755952380952381,39.87268518518518,1040.5092592592591,29.728835978835974,0
2926,4,0,0,35,0.0,0.0,1.0,35,950,800,150,0.8421052631578947,11,8,3,347.5247018790563,0.33389355742296917,0.0894608894608897,0.2269131876975014,135362.548828125,2408.365885416667,137770.91471354166,2881,40,1161.0285714285715,35,0,20,30.80267767767768,0.6758928571428571,39.84375,1040.625,29.732142857142858,0
2927,4,0,0,35,0.0,0.0,1.0,35,900,800,100,0.8888888888888888,10,8,2,345.46936116183315,0.3333333333333333,0.09126084056037342,0.22613911457711247,135452.8959297839,2358.965084876541,137811.86101466045,2882,41,1162.0285714285715,35,0,20,30.766344229486332,0.6767857142857143,39.75694444444444,1040.972222222222,29.742063492063483,0
2928,4,0,0,35,0.0,0.0,1.0,35,750,600,150,0.8,9,6,3,343.01419357191526,0.33326330532212883,0.09054446720335352,0.22509837341841873,135543.27317226076,2298.653308256167,137841.92648051694,2883,42,1163.0285714285715,35,0,20,30.740455151717242,0.6776785714285715,39.670138888888886,1041.3194444444441,29.751984126984116,0
2929,4,0,0,35,0.0,0.0,1.0,35,1150,800,350,0.6956521739130435,15,8,7,342.93385761114996,0.33217787114845937,0.08960995666185134,0.22542452773139063,135603.5414121441,2300.6091124399727,137904.15052458408,2884,43,1164.0285714285715,35,0,20,30.68269159536245,0.6782738095238096,39.61226851851851,1041.5509259259252,29.75859788359786,0
2930,4,0,0,35,0.0,0.0,1.0,35,1200,900,300,0.75,15,9,6,341.38459456089333,0.33217787114845937,0.09048412433950581,0.22516377324774525,135724.11807966826,2266.824604552471,137990.94268422073,2885,44,1165.0285714285715,35,0,20,30.603340553148957,0.6794642857142856,39.49652777777778,1042.0138888888891,29.771825396825403,0
2931,4,0,0,35,0.0,0.0,1.0,35,300,300,0,1.0,3,3,0,342.4135894190667,0.33189775910364144,0.09367265342387499,0.22603313483352455,135754.27061899856,2296.821416323722,138051.09203532228,2886,45,1166.0285714285715,35,0,20,30.546608914556494,0.6797619047619048,39.46759259259259,1042.129629629629,29.77513227513226,0
2932,4,0,0,35,0.0,0.0,1.0,35,600,400,200,0.6666666666666666,8,4,4,342.4135894190667,0.33189775910364144,0.09367265342387499,0.22603313483352455,135754.27061899856,2296.821416323722,138051.09203532228,2887,46,1167.0285714285715,35,0,20,30.546608914556494,0.6797619047619048,39.46759259259259,1042.129629629629,29.77513227513226,0
2933,4,0,0,35,0.0,0.0,1.0,35,550,400,150,0.7272727272727273,7,4,3,342.47405892401696,0.3317927170868347,0.09183469501070829,0.2262640425980022,135784.42650730864,2300.528736925563,138084.9552442342,2888,47,1168.0285714285715,35,0,20,30.515107347769742,0.680059523809524,39.4386574074074,1042.245370370369,29.778439153439116,0
2934,4,0,0,35,0.0,0.0,1.0,35,700,200,500,0.2857142857142857,12,2,10,342.47405892401696,0.3317927170868347,0.09183469501070829,0.2262640425980022,135784.42650730864,2300.528736925563,138084.9552442342,2889,48,1169.0285714285715,35,0,20,30.515107347769742,0.680059523809524,39.4386574074074,1042.245370370369,29.778439153439116,0
2935,4,0,0,35,0.0,0.0,1.0,35,750,500,250,0.6666666666666666,10,5,5,342.6005382229808,0.3320378151260504,0.09865516366404448,0.22692247414063318,135874.91426611802,2310.1637517146846,138185.0780178327,2890,49,1170.0285714285715,35,0,17,30.42203226761397,0.680952380952381,39.351851851851855,1042.592592592593,29.788359788359802,0
2936,4,0,0,35,0.0,0.0,1.0,35,350,300,50,0.8571428571428571,4,3,1,341.0276037648665,0.3321078431372549,0.099785928357357,0.22607194130372932,135905.08355034716,2269.4769965277733,138174.56054687494,2891,50,1171.0285714285715,35,0,17,30.433108558108557,0.68125,39.322916666666664,1042.708333333333,29.791666666666657,0
2937,4,0,0,35,0.0,0.0,1.0,35,650,500,150,0.7692307692307693,8,5,3,341.04865554709085,0.33249299719887954,0.102503289630135,0.22646937620743066,135965.43216574492,2274.165568201292,138239.5977339462,2892,51,1172.0285714285715,35,0,17,30.372715754818174,0.6818452380952381,39.26504629629629,1042.939814814814,29.798280423280403,0
2938,4,0,0,35,0.0,0.0,1.0,35,650,500,150,0.7692307692307693,8,5,3,340.72634622988267,0.3323879551820728,0.10317671675860751,0.22644733275985995,135995.6114969135,2267.4575617283876,138263.0690586419,2893,52,1173.0285714285715,35,0,17,30.3511984021305,0.6821428571428572,39.23611111111111,1043.055555555555,29.801587301587286,0
2939,4,0,0,35,0.0,0.0,1.0,35,550,400,150,0.7272727272727273,7,4,3,341.33083615364677,0.331687675070028,0.10497955561190508,0.22723457585590634,136055.98020619,2288.020297496571,138344.00050368658,2894,53,1174.0285714285715,35,0,17,30.275589823237922,0.6827380952380953,39.17824074074074,1043.2870370370372,29.808201058201064,0
2940,4,0,0,35,0.0,0.0,1.0,35,700,600,100,0.8571428571428571,8,6,2,340.98133726097103,0.33165266106442576,0.1035987639648206,0.22719488214395064,136086.16958429775,2280.5688175154214,138366.73840181317,2895,54,1175.0285714285715,35,0,17,30.254783693843585,0.6830357142857142,39.14930555555555,1043.4027777777771,29.81150793650792,0
2941,4,0,0,35,0.0,0.0,1.0,35,950,500,450,0.5263157894736842,14,5,9,338.34270802840354,0.33112745098039215,0.09992553747682953,0.22582059202754362,136146.55838745285,2212.8390507115882,138359.39743816445,2896,55,1176.0285714285715,35,0,17,30.263784148460317,0.6836309523809524,39.09143518518518,1043.6342592592591,29.81812169312169,0
2942,4,1,0,36,0.027777777777777776,0.0,1.0,36,1050,700,350,0.6666666666666666,14,7,7,330.0554471701665,0.3382275132275132,0.097219229572171,0.2229675881101516,136573.74223886037,1815.3815132700174,138389.1237521304,2897,0,1144.3333333333333,36,0,19,30.05750377073907,0.685763888888889,38.68243243243243,1045.2702702702695,29.035285285285266,0
2943,4,0,0,36,0.0,0.0,1.0,36,800,500,300,0.625,11,5,6,329.3467874977998,0.3389384920634921,0.09264943457189045,0.22304776965113582,136662.03946767718,1801.840734315402,138463.88020199258,2898,1,1145.3333333333333,36,0,20,29.988781188296542,0.6866319444444444,38.597972972972975,1045.6081081081084,29.044669669669677,0
2944,4,0,0,36,0.0,0.0,1.0,36,450,200,250,0.4444444444444444,7,2,5,329.3467874977998,0.3389384920634921,0.09264943457189045,0.22304776965113582,136662.03946767718,1801.840734315402,138463.88020199258,2899,2,1146.3333333333333,36,0,20,29.988781188296542,0.6866319444444444,38.597972972972975,1045.6081081081084,29.044669669669677,0
2945,4,0,0,36,0.0,0.0,1.0,36,800,700,100,0.875,9,7,2,328.72494087395444,0.3392361111111111,0.09019477644975615,0.2229998923226016,136720.92013888896,1788.7152777777878,138509.63541666674,2900,3,1147.3333333333333,36,0,20,29.946879150066394,0.6872106481481481,38.54166666666667,1045.833333333334,29.05092592592594,0
2946,4,0,0,36,0.0,0.0,1.0,36,900,800,100,0.8888888888888888,10,8,2,331.50047784081227,0.33883928571428573,0.08263373156818465,0.22563889667538373,136838.71952611397,1872.4201820063354,138711.13970812032,2901,4,1148.3333333333333,36,0,20,29.757964697018632,0.6883680555555556,38.429054054054056,1046.283783783784,29.063438438438443,0
2947,4,0,0,36,0.0,0.0,1.0,36,800,700,100,0.875,9,7,2,329.2891778540228,0.339021164021164,0.06502949319850693,0.21313738510467287,135047.7906115578,1693.9551882964365,136741.74579985425,2902,5,1149.3333333333333,36,0,16,31.58969844709282,0.6707175925925924,40.14639639639641,1039.4144144144168,28.87262262262269,6
2948,4,0,0,36,0.0,0.0,1.0,36,900,700,200,0.7777777777777778,11,7,4,330.2861597609305,0.3387731481481482,0.07224388365404288,0.21430302973103843,135135.5932579542,1726.683228836977,136862.27648679118,2903,6,1150.3333333333333,36,0,16,31.47654247445756,0.671585648148148,40.06193693693695,1039.7522522522545,28.88200700700707,0
2949,4,0,0,36,0.0,0.0,1.0,36,700,600,100,0.8571428571428571,8,6,2,331.56368702475294,0.3386574074074074,0.07167954179000291,0.215306546131264,135164.86714755322,1763.1523415307474,136928.01948908396,2904,7,1151.3333333333333,36,0,16,31.414248068731492,0.6718749999999998,40.0337837837838,1039.8648648648668,28.88513513513519,0
2950,4,0,1,35,0.0,0.027777777777777776,0.9722222222222222,36,1150,900,250,0.782608695652174,14,9,5,328.37841820867646,0.3374834656084656,0.06350623429402802,0.2144554743933837,135369.87314595006,1690.5089633552539,137060.3821093053,2905,8,1152.3333333333333,36,0,17,31.29351080330412,0.6739004629629629,39.836711711711715,1040.6531531531534,28.90703203203204,0
2951,4,0,0,35,0.0,0.0,1.0,35,750,600,150,0.8,9,6,3,336.4481729967902,0.3310224089635854,0.06752610914177626,0.21894712025504376,135242.1329116298,2100.3937060613853,137342.52661769118,2906,65,1186.0285714285715,35,0,17,31.21047531619746,0.6747023809523809,39.95949074074074,1040.1620370370372,29.71891534391535,0
2952,4,0,0,35,0.0,0.0,1.0,35,800,600,200,0.75,10,6,4,334.82908335921394,0.329796918767507,0.06292706181471486,0.21844074451373965,135332.4398255315,2062.647355109736,137395.08718064125,2907,66,1187.0285714285715,35,0,18,31.162866147571375,0.6755952380952381,39.87268518518518,1040.509259259259,29.728835978835967,0
2953,4,0,0,35,0.0,0.0,1.0,35,500,200,300,0.4,8,2,6,331.84773523581094,0.33028711484593837,0.05718733618211003,0.21704048603459256,135422.77688025116,1987.948361411173,137410.72524166232,2908,67,1188.0285714285715,35,0,18,31.15073297750101,0.6764880952380953,39.785879629629626,1040.856481481481,29.738756613756603,0
2954,4,0,0,35,0.0,0.0,1.0,35,750,500,250,0.6666666666666666,10,5,5,336.4156743038547,0.33028711484593837,0.06355698091639383,0.22095388594059015,135573.40561771262,2121.8037337105598,137695.20935142317,2909,68,1189.0285714285715,35,0,19,30.882325702007858,0.6779761904761905,39.6412037037037,1041.4351851851852,29.755291005291006,0
2955,4,0,0,35,0.0,0.0,1.0,35,900,800,100,0.8888888888888888,10,8,2,337.3782327707642,0.3308473389355742,0.06262161347151918,0.2221464135456948,135663.82304794661,2154.0041741683763,137817.82722211498,2910,69,1190.0285714285715,35,0,19,30.767530459578555,0.6788690476190476,39.554398148148145,1041.782407407407,29.76521164021163,0
2956,4,0,0,35,0.0,0.0,1.0,35,500,400,100,0.8,6,4,2,336.8275661766343,0.3306372549019608,0.05987240930586846,0.22197084558726662,135693.96888931756,2141.0938571673505,137835.0627464849,2911,70,1191.0285714285715,35,0,19,30.751962526845887,0.6791666666666667,39.52546296296296,1041.898148148148,29.768518518518515,0
2957,4,0,0,35,0.0,0.0,1.0,35,700,400,300,0.5714285714285714,10,4,6,336.5877929616041,0.3303921568627451,0.05712381587090021,0.22199999267643378,135724.1180796681,2136.6162712191235,137860.7343508872,2912,71,1192.0285714285715,35,0,20,30.728298900366553,0.6794642857142857,39.49652777777777,1042.013888888888,29.77182539682537,0
2958,4,0,0,35,0.0,0.0,1.0,35,750,600,150,0.8,9,6,3,336.9784217528276,0.3298669467787115,0.05734594148632355,0.22244528661748234,135754.2706189986,2149.2519718792782,137903.52259087787,2913,72,1193.0285714285715,35,0,20,30.68821264623129,0.6797619047619048,39.46759259259259,1042.1296296296293,29.77513227513227,0
2959,4,0,0,35,0.0,0.0,1.0,35,600,200,400,0.3333333333333333,10,2,8,338.4479239294694,0.3291316526610644,0.05686374016746987,0.22417197784975437,135874.9142661179,2197.316529492448,138072.23079561035,2914,73,1194.0285714285715,35,0,16,30.530269390171696,0.680952380952381,39.35185185185185,1042.5925925925922,29.788359788359777,0
2960,4,0,0,35,0.0,0.0,1.0,35,500,200,300,0.4,8,2,6,339.4307989712584,0.3292717086834734,0.05457399743114011,0.22501339719882765,135905.0835503472,2226.0742187499964,138131.1577690972,2915,74,1195.0285714285715,35,0,16,30.474733599733593,0.68125,39.322916666666664,1042.7083333333333,29.791666666666664,0
2961,4,0,0,35,0.0,0.0,1.0,35,1250,1000,250,0.8,15,10,5,340.3040163636922,0.32941176470588235,0.06365825833438965,0.22693646535022546,136116.3623113854,2264.188957475988,138380.5512688614,2916,75,1196.0285714285715,35,0,17,30.242531795326837,0.6833333333333333,39.12037037037037,1043.518518518518,29.8148148148148,0
2962,4,0,0,35,0.0,0.0,1.0,35,1200,900,300,0.75,15,9,6,339.099611113023,0.32888655462184874,0.05747228381374714,0.22690493265871414,136237.16670953357,2239.5940500685806,138476.76075960216,2917,76,1197.0285714285715,35,0,18,30.15428677014042,0.6845238095238095,39.004629629629626,1043.981481481481,29.828042328042315,0
2963,4,0,0,35,0.0,0.0,1.0,35,950,700,250,0.7368421052631579,12,7,5,340.1950383999388,0.3281862745098039,0.05107514963422788,0.22802671890373302,136297.58900248614,2273.552704903964,138571.1417073901,2918,77,1198.0285714285715,35,0,18,30.065857533436787,0.6851190476190476,38.94675925925925,1044.212962962962,29.834656084656054,0
2964,4,0,0,35,0.0,0.0,1.0,35,850,600,250,0.7058823529411765,11,6,5,340.29821186057075,0.3280112044817927,0.04901215805471182,0.22848594224923996,136358.02469135783,2280.478395061707,138638.50308641954,2919,78,1199.0285714285715,35,0,18,30.00332446808511,0.6857142857142857,38.88888888888888,1044.4444444444428,29.841269841269792,0
2965,4,0,0,35,0.0,0.0,1.0,35,500,300,200,0.6,7,3,4,342.2738820500777,0.3275560224089636,0.042847646481593005,0.2302059656769002,136418.47377614884,2338.49612054184,138756.9698966907,2920,79,1200.0285714285715,35,0,18,29.891886402245373,0.6863095238095238,38.83101851851852,1044.675925925926,29.8478835978836,0
2966,4,0,0,35,0.0,0.0,1.0,35,550,200,350,0.36363636363636365,9,2,7,342.2738820500777,0.3275560224089636,0.042847646481593005,0.2302059656769002,136418.47377614884,2338.49612054184,138756.9698966907,2921,80,1201.0285714285715,35,0,18,29.891886402245373,0.6863095238095238,38.83101851851852,1044.675925925926,29.8478835978836,0
2967,4,0,0,35,0.0,0.0,1.0,35,400,300,100,0.75,5,3,2,342.9393788713065,0.3267156862745098,0.050129755047787716,0.23104900839180262,136478.93625685878,2360.8003257887613,138839.73658264754,2922,81,1202.0285714285715,35,0,19,29.81465071629006,0.6869047619047619,38.77314814814815,1044.907407407408,29.854497354497372,0
2968,4,0,0,35,0.0,0.0,1.0,35,400,400,0,1.0,4,4,0,342.4634085065803,0.32699579831932774,0.04989636567884448,0.23092622221104664,136509.1725206833,2349.8793027692027,138859.0518234525,2923,82,1203.0285714285715,35,0,19,29.797158230885668,0.6872023809523808,38.74421296296296,1045.023148148148,29.85780423280423,0
2969,4,0,0,35,0.0,0.0,1.0,35,850,700,150,0.8235294117647058,10,7,3,354.3341835555048,0.32752100840336135,0.04126205864561161,0.22810580797898866,134851.15124528468,2556.4745156035756,137407.62576088824,2924,83,1204.0285714285715,35,0,15,31.13485253695862,0.6708333333333333,40.33564814814815,1038.6574074074078,29.675925925925938,6
2970,4,0,0,35,0.0,0.0,1.0,35,750,400,350,0.5333333333333333,11,4,7,355.6300334017364,0.3274859943977591,0.03689428539601214,0.22951048237580066,134941.32754897542,2597.8377647033512,137539.16531367876,2925,84,1205.0285714285715,35,0,16,31.011311314098982,0.6717261904761905,40.24884259259259,1039.004629629629,29.685846560846546,0
2971,4,0,0,35,0.0,0.0,1.0,35,1050,600,450,0.5714285714285714,15,6,9,363.32306263853286,0.3272408963585434,0.024274476102333464,0.2187022669531669,132367.37528344666,2620.195646577809,134987.57093002446,2926,85,1206.0285714285715,34,1,17,33.391176924263455,0.6482843137254901,42.738095238095234,1029.0476190476186,30.266106442577016,6
2972,4,0,0,35,0.0,0.0,1.0,35,650,500,150,0.7692307692307693,8,5,3,360.9080955123437,0.32692577030812325,0.029661688912382633,0.21795622974795725,132489.9092970521,2563.336167800441,135053.24546485255,2927,86,1207.0285714285715,34,1,18,33.32996068455134,0.6495098039215687,42.61904761904761,1029.523809523809,30.280112044817912,0
2973,4,0,0,35,0.0,0.0,1.0,35,750,400,350,0.5333333333333333,11,4,7,357.02465444501854,0.32685574229691877,0.021885060507503384,0.21649154414244887,132643.15653344675,2471.375425170067,135114.5319586168,2928,87,1208.0285714285715,34,1,14,33.27579066990254,0.6510416666666667,42.470238095238095,1030.1190476190477,30.29761904761905,0
2974,4,0,0,35,0.0,0.0,1.0,35,1000,700,300,0.7,13,7,6,360.86163348492056,0.32762605042016807,0.026095854238183502,0.2193552176576877,132735.14739229027,2579.804421768719,135314.951814059,2929,88,1209.0285714285715,34,1,15,33.08446934688849,0.6519607843137254,42.38095238095239,1030.4761904761908,30.30812324929973,0
2975,4,0,0,35,0.0,0.0,1.0,35,600,500,100,0.8333333333333334,7,5,2,361.01241104740745,0.32759103641456583,0.023836470724102776,0.21998638052494718,132827.1701388888,2590.4513888888837,135417.62152777766,2930,89,1210.0285714285715,34,1,15,32.98807599029913,0.6528799019607843,42.291666666666664,1030.8333333333326,30.31862745098037,0
2976,4,0,0,35,0.0,0.0,1.0,35,500,300,200,0.6,7,3,4,361.01241104740745,0.32759103641456583,0.023836470724102776,0.21998638052494718,132827.1701388888,2590.4513888888837,135417.62152777766,2931,90,1211.0285714285715,34,1,15,32.98807599029913,0.6528799019607843,42.291666666666664,1030.8333333333326,30.31862745098037,0
2977,4,0,0,35,0.0,0.0,1.0,35,1100,800,300,0.7272727272727273,14,8,6,361.5002540695625,0.3275560224089636,0.021792270770448985,0.2206450810779758,132888.53635204062,2607.8479308389806,135496.38428287962,2932,91,1212.0285714285715,34,1,15,32.9138282723319,0.6534926470588236,42.23214285714285,1031.071428571427,30.325630252100797,0
2978,4,1,1,35,0.027777777777777776,0.027777777777777776,0.9722222222222222,36,900,700,200,0.7777777777777778,11,7,4,352.8685475275997,0.33652447089947085,0.017364225211759177,0.21737482347694667,133233.1318587105,2202.756344307264,135435.88820301776,2933,0,1179.3333333333333,35,1,16,32.79054559043348,0.6547619047619049,41.898148148148145,1032.407407407407,29.497354497354483,0
2979,4,0,0,35,0.0,0.0,1.0,35,1150,1100,50,0.9565217391304348,12,11,1,360.6194162596262,0.32839635854341737,0.020297976135539963,0.22137741502396893,133103.42970521544,2599.9362244897984,135703.36592970524,2934,93,1214.0285714285715,34,1,17,32.72068720196892,0.6556372549019608,42.023809523809526,1031.9047619047622,30.350140056022415,0
2980,4,0,0,35,0.0,0.0,1.0,35,600,400,200,0.6666666666666666,8,4,4,363.3575722983677,0.3288515406162465,0.01942764881295611,0.22361061102903793,133195.58000283438,2679.5245181405758,135875.10452097494,2935,94,1215.0285714285715,34,1,17,32.55751931726443,0.6565563725490196,41.9345238095238,1032.2619047619041,30.36064425770306,0
2981,4,0,0,35,0.0,0.0,1.0,35,750,600,150,0.8,9,6,3,349.46555949749757,0.3288515406162465,0.02362363687511393,0.20849593470227357,132030.6990504536,2228.036422902507,134258.73547335612,2936,95,1216.0285714285715,34,1,16,34.08649947874435,0.6449142156862744,43.0654761904762,1027.738095238096,30.22759103641459,3
2982,4,0,0,35,0.0,0.0,1.0,35,500,400,100,0.8,6,4,2,345.86419779992065,0.32923669467787114,0.011150632806683491,0.20668078532888,132091.88102324263,2137.1704931972768,134229.0515164399,2937,96,1217.0285714285715,34,1,21,34.117448369040716,0.6455269607843137,43.00595238095238,1027.9761904761906,30.234593837535016,3
2983,4,1,1,35,0.027777777777777776,0.027777777777777776,0.9722222222222222,36,600,300,300,0.5,9,3,6,336.3920573335059,0.33779761904761907,0.0051280608992392285,0.20217640281524857,132308.68115837156,1701.5178915894712,134010.19904996103,2938,0,1184.1944444444443,35,1,21,34.142971650354376,0.6455357142857144,42.79513888888887,1028.8194444444416,29.39484126984119,0
2984,4,0,0,35,0.0,0.0,1.0,35,500,400,100,0.8,6,4,2,343.8696672014415,0.32941176470588235,0.007019633139814241,0.20582136629375242,132153.0771683672,2088.6869331065577,134241.76410147376,2939,98,1219.0285714285715,34,1,21,34.107135965420085,0.646139705882353,42.94642857142856,1028.2142857142844,30.241596638655423,0
2985,4,0,0,35,0.0,0.0,1.0,35,750,500,250,0.6666666666666666,10,5,5,347.4158189679945,0.32839635854341737,0.02215756934572055,0.20878772653139127,132306.1295351473,2193.048469387748,134499.17800453506,2940,99,1220.0285714285715,34,1,22,33.8620014657101,0.647671568627451,42.797619047619044,1028.8095238095232,30.259103641456562,0
2986,4,0,0,35,0.0,0.0,1.0,35,750,500,250,0.6666666666666666,10,5,5,351.9742187757935,0.3273809523809524,0.030785499487789858,0.21221541809871045,132428.6352040815,2322.2930839002165,134750.92828798172,2941,100,1221.0285714285715,34,1,22,33.62152054900148,0.6488970588235294,42.67857142857142,1029.2857142857133,30.27310924369745,0
2987,4,1,1,35,0.027777777777777776,0.027777777777777776,0.9722222222222222,36,650,300,350,0.46153846153846156,10,3,7,342.6422146440867,0.33326719576719577,0.026679521260000394,0.2082282346058907,132725.77649444845,1895.4907996827585,134621.26729413122,2942,0,1188.0833333333333,35,1,15,33.56324179115655,0.6497023809523811,42.39004629629628,1030.4398148148127,29.441137566137506,0
2988,4,0,0,35,0.0,0.0,1.0,35,850,600,250,0.7058823529411765,11,6,5,350.781597715575,0.3267156862745098,-0.00909288303185174,0.19647904422143495,129595.0414540816,2091.911139455778,131686.95259353737,2943,102,1223.0285714285715,34,1,15,36.51715772243657,0.6204044117647058,45.44642857142857,1018.2142857142853,29.947478991596626,6
2989,4,0,0,35,0.0,0.0,1.0,35,550,400,150,0.7272727272727273,7,4,3,349.6917699309415,0.3270658263305322,-0.009284461885280093,0.19617135027929203,129655.65653344669,2067.9032029478403,131723.55973639453,2944,103,1224.0285714285715,34,1,15,36.48329436976426,0.6210171568627452,45.38690476190476,1018.4523809523807,29.95448179271708,0
2990,4,2,1,36,0.05405405405405406,0.02702702702702703,0.972972972972973,37,950,900,50,0.9473684210526315,10,9,1,336.0780951229999,0.3440315315315315,-0.0055658793104989,0.1909218570476178,130147.653460048,1347.9550919162562,131495.60855196425,2945,0,1158.8108108108108,36,1,16,36.331070889894434,0.6218171296296295,44.90427927927929,1020.3828828828837,28.34396896896899,0
2991,4,2,0,38,0.05263157894736842,0.0,1.0,38,900,500,400,0.5555555555555556,13,5,8,326.6417833842756,0.3504919393077288,0.009245617901928904,0.18735445906630332,130521.37230135548,926.7974900576337,131448.16979141312,2946,0,1129.2631578947369,36,2,15,36.19384137829696,0.6255787037037037,44.53828828828829,1021.8468468468475,28.38463463463465,0
2992,4,1,1,38,0.02564102564102564,0.02564102564102564,0.9743589743589743,39,1000,800,200,0.8,12,8,4,315.0808581420556,0.3557973459289249,0.009088839793800485,0.18206995876343882,130808.47447083422,443.04927770472204,131251.52374853895,2947,0,1101.2820512820513,38,1,15,36.19952132288946,0.6247258771929824,44.25747863247863,1022.9700854700852,26.920265407107507,0
2993,4,0,1,37,0.0,0.02631578947368421,0.9736842105263158,38,1000,700,300,0.7,13,7,6,324.96362783143894,0.3495880749170223,0.0088358761397489,0.18757801487695938,130766.7743921207,898.8890812557745,131665.66347337648,2948,2,1131.2631578947369,37,1,15,35.98886863922239,0.6261261261261261,44.29824561403509,1022.8070175438601,27.643432906590814,0
2994,4,0,0,37,0.0,0.0,1.0,37,750,500,250,0.6666666666666666,10,5,5,333.18981051651934,0.3423110610610611,0.010960845193690227,0.19182183193909194,130665.2529852489,1307.2661766496353,131972.51916189853,2949,3,1162.7567567567567,36,1,15,35.881108418695156,0.6270254629629629,44.39752252252253,1022.409909909911,28.400275275275305,0
2995,4,0,0,37,0.0,0.0,1.0,37,900,600,300,0.6666666666666666,12,6,6,335.40769094871325,0.34196696696696693,0.012094014296172517,0.19353066386252937,130751.61944038629,1371.0197528609672,132122.63919324725,2950,4,1163.7567567567567,36,1,15,35.737126550686334,0.6278935185185186,44.31306306306306,1022.7477477477474,28.409659659659653,0
2996,4,0,0,37,0.0,0.0,1.0,37,1150,800,350,0.6956521739130435,15,8,7,333.2812929257721,0.34156031031031026,0.0033776350608032413,0.19345638267530463,130982.0694850256,1330.774693612534,132312.84417863813,2951,5,1164.7567567567567,36,1,15,35.558764209754294,0.6302083333333334,44.08783783783784,1023.6486486486489,28.43468468468469,0
2997,4,0,0,37,0.0,0.0,1.0,37,1050,800,250,0.7619047619047619,13,8,5,335.3495798424254,0.34156031031031026,0.011376659344857432,0.1898078621908128,130004.05811216628,1319.3612531450478,131323.41936531133,2952,6,1165.7567567567567,36,1,15,36.49514134275619,0.6203703703703705,45.04504504504505,1019.8198198198203,28.32832832832834,1
2998,4,1,1,37,0.02631578947368421,0.02631578947368421,0.9736842105263158,38,1100,900,200,0.8181818181818182,13,9,4,327.24006122979193,0.35086237553342814,0.011507505878097346,0.1867193290546458,130318.55955678658,929.0906817482155,131247.65023853478,2953,0,1136.0526315789473,37,1,16,36.383608963344784,0.6216216216216217,44.73684210526315,1021.0526315789464,27.596017069701254,0
2999,4,1,1,37,0.02631578947368421,0.02631578947368421,0.9736842105263158,38,1150,700,450,0.6086956521739131,16,7,9,330.7666319737918,0.3498696064485538,0.018520192291396897,0.18941319668714296,130458.54403518388,1030.2666445444704,131488.81067972834,2954,0,1137.0263157894738,37,1,17,36.15199366748952,0.6230292792792793,44.59978070175438,1021.6008771929822,27.61083451872925,0
3000,4,1,0,38,0.02631578947368421,0.0,1.0,38,1050,600,450,0.5714285714285714,15,6,9,328.246186141015,0.3493954480796586,0.026496440608116956,0.1887871186547,130626.62459843422,975.5382665820337,131602.16286501626,2955,0,1138.0,37,1,15,36.04649343916476,0.6247184684684683,44.43530701754386,1022.2587719298252,27.628615457562844,0
3001,4,0,0,38,0.0,0.0,1.0,38,900,500,400,0.5555555555555556,13,5,8,329.8204846051336,0.34957325746799434,0.02844881583179526,0.19024339269709845,130738.73842191833,1024.062812596186,131762.8012345145,2956,1,1139.0,37,1,15,35.89299435331117,0.6258445945945945,44.32565789473684,1022.697368421053,27.64046941678522,0
3002,4,0,0,38,0.0,0.0,1.0,38,1400,1200,200,0.8571428571428571,16,12,4,328.34952173377013,0.35047712185870084,0.022582173393190796,0.1900842268498478,130878.94833025562,994.8080178516589,131873.75634810727,2957,2,1140.0,37,1,15,35.789041291613074,0.6272522522522521,44.188596491228076,1023.245614035089,27.655286865813217,0
3003,4,0,1,37,0.0,0.02631578947368421,0.9736842105263158,38,800,700,100,0.875,9,7,2,330.6330867499466,0.34981033665244193,0.024647272030348333,0.1921046130046209,131019.23338190623,1063.8587113342783,132083.0920932405,2958,3,1141.0,37,1,15,35.58903198743351,0.6286599099099097,44.05153508771931,1023.7938596491249,27.670104314841215,0
3004,4,0,0,37,0.0,0.0,1.0,37,800,700,100,0.875,9,7,2,331.5035412701267,0.3510072572572573,0.030254578308239966,0.19300212575611633,131097.37059694855,1291.8485208181405,132389.21911776668,2959,4,1153.8648648648648,36,1,16,35.48791327615276,0.6313657407407407,43.97522522522524,1024.099099099101,28.44719719719725,0
3005,4,0,0,37,0.0,0.0,1.0,37,350,200,150,0.5714285714285714,5,2,3,331.11935253105287,0.3506318818818819,0.03026313834450156,0.1929231589538713,131126.20380092962,1283.6847404837624,132409.88854141338,2960,5,1154.8648648648648,36,1,16,35.46866410115448,0.6316550925925924,43.94707207207209,1024.2117117117143,28.450325325325398,0
3006,4,0,0,37,0.0,0.0,1.0,37,950,600,350,0.631578947368421,13,6,7,331.3879935239782,0.35106981981981983,0.02763317407116861,0.19322469160859682,131155.04017531069,1292.6411208506106,132447.6812961613,2961,6,1155.8648648648648,36,1,16,35.43269935502785,0.6319444444444443,43.91891891891893,1024.3243243243264,28.453453453453513,0
3007,4,0,0,37,0.0,0.0,1.0,37,650,500,150,0.7692307692307693,8,5,3,350.27330733139706,0.35056931931931934,0.0619491064264126,0.19526015502538457,129407.39300679455,1665.705242729453,131073.098249524,2962,7,1156.8648648648648,35,2,18,36.72091248625489,0.6163690476190475,45.630787037037045,1017.476851851853,29.07076719576723,3
3008,4,0,0,37,0.0,0.0,1.0,37,850,600,250,0.7058823529411765,11,6,5,355.3208794522128,0.3499436936936937,0.06268205449651587,0.19881695010570397,129554.63927469152,1806.6936728395287,131361.33294753105,2963,8,1157.8648648648648,35,2,15,36.44270122783084,0.6178571428571427,45.48611111111112,1018.0555555555569,29.087301587301624,0
3009,4,1,0,38,0.02631578947368421,0.0,1.0,38,600,400,200,0.6666666666666666,8,4,4,365.1580594715059,0.3600640113798008,0.13104434822965416,0.19277849468504582,127233.99233270457,1692.10354780459,128926.09588050916,2964,0,1128.3684210526317,36,2,16,38.565734643003324,0.5923032407407407,47.775900900900915,1008.8963963963984,28.024899899899953,7
3010,4,3,3,38,0.07317073170731707,0.07317073170731707,0.926829268292683,41,1100,700,400,0.6363636363636364,15,7,8,348.55608235125743,0.37886178861788616,0.12250394444611934,0.18674296067693197,127828.32031250001,711.0677083333344,128539.38802083334,2965,0,1046.7317073170732,39,2,14,38.37556654305725,0.592948717948718,47.1875,1011.2500000000001,25.929487179487182,0
3011,4,6,4,40,0.13636363636363635,0.09090909090909091,0.9090909090909091,44,950,700,250,0.7368421052631579,12,7,5,334.99183038149795,0.3911975863284003,0.14160770789632715,0.18342058036091877,128697.58204207619,-177.08166021037357,128520.50038186582,2966,0,976.2272727272727,41,3,15,37.831606048755056,0.5985772357723577,46.32936507936508,1014.6825396825406,24.74835462640343,0
3012,4,2,0,42,0.047619047619047616,0.0,1.0,42,950,800,150,0.8421052631578947,11,8,3,348.856376256546,0.3800450058072009,0.1594812837884072,0.19114504035384008,128725.2658420141,581.325954861131,129306.59179687522,2967,0,1023.6666666666666,39,3,18,37.45166974611647,0.6020299145299145,46.30208333333334,1014.7916666666683,26.020299145299187,0
3013,4,1,0,43,0.023255813953488372,0.0,1.0,43,900,400,500,0.4444444444444444,14,4,10,352.99278365593597,0.38623569582871914,0.19713208749452438,0.18629236381459183,127220.1372880724,381.55807968139146,127601.69536775378,2968,0,1000.8372093023256,40,3,17,38.88679023538498,0.5851562500000002,47.789634146341456,1008.8414634146327,25.221036585365816,3
3014,4,1,1,43,0.022727272727272728,0.022727272727272728,0.9772727272727273,44,1000,800,200,0.8,12,8,4,352.9693724222169,0.3897661205073996,0.1932499040101443,0.18765436974572258,127517.50996984425,201.95509337993326,127719.46506322418,2969,0,979.0681818181819,41,3,16,38.582387944864614,0.5866361788617886,47.49503968253968,1010.0198412698398,24.63463027487414,0
3015,4,2,1,44,0.044444444444444446,0.022222222222222223,0.9777777777777777,45,950,600,350,0.631578947368421,13,6,7,369.786666373071,0.3936237373737374,0.24061728395061688,0.1985891356447977,127923.87777176869,460.9088621477234,128384.78663391642,2970,0,958.2666666666667,42,3,18,37.74086047254151,0.5892857142857142,47.09302325581396,1011.6279069767455,24.08637873754156,2
3016,4,2,1,45,0.043478260869565216,0.021739130434782608,0.9782608695652174,46,1300,1000,300,0.7692307692307693,16,10,6,363.0124937890094,0.39960748792270534,0.23711607067217688,0.19657147817250062,128255.575032702,112.8160463547043,128368.39107905672,2971,0,938.3913043478261,37,9,20,37.5726167280075,0.6007882882882885,46.765350877192965,1012.9385964912251,27.376718824087163,0
3017,4,1,0,46,0.021739130434782608,0.0,1.0,46,1650,1100,550,0.6666666666666666,22,11,11,365.59495471933155,0.3990841384863124,0.2537392037076054,0.19970992520744124,128604.67916757952,203.44437139305882,128808.12353897258,2972,0,939.3695652173913,38,8,20,37.150217681342596,0.6025219298245617,46.420940170940156,1014.316239316237,26.692532613585183,0
3018,4,3,0,49,0.061224489795918366,0.0,1.0,49,1150,900,250,0.782608695652174,14,9,5,348.58882166817807,0.40727749433106575,0.26978125843910394,0.19410893332891116,129364.36760354984,-776.8621246987148,128587.50547885112,2973,0,882.795918367347,38,11,23,36.80752467968914,0.6101973684210529,45.6730769230769,1017.3076923076886,26.77125506072865,0
3019,4,0,1,48,0.0,0.02040816326530612,0.9795918367346939,49,1450,900,550,0.6206896551724138,20,9,11,347.45930033066975,0.40701176303854875,0.26905614027225866,0.194588861375795,129589.12854658245,-794.6104129486681,128794.51813363378,2974,1,883.795918367347,40,9,17,36.60773696643046,0.6091145833333336,45.45223577235771,1018.1910569105669,25.454776422764173,0
3020,4,0,0,48,0.0,0.0,1.0,48,1650,1100,550,0.6666666666666666,22,11,11,354.19266186782767,0.40392287234042556,0.2690083913221448,0.19800747664601878,129519.29253472203,-425.04340277780176,129094.24913194423,2975,2,903.1875,39,9,17,36.50736799017599,0.6100427350427352,45.52083333333332,1017.916666666665,26.10042735042731,0
3021,4,1,1,48,0.02040816326530612,0.02040816326530612,0.9795918367346939,49,1300,800,500,0.6153846153846154,18,8,10,352.25631132280967,0.4069231859410431,0.27711259635202645,0.1991468849161623,129958.94451530583,-644.228316326557,129314.71619897928,2976,0,885.734693877551,41,8,19,36.10989492119088,0.6112804878048781,45.0892857142857,1019.6428571428548,24.86933797909402,0
3022,4,1,0,49,0.02040816326530612,0.0,1.0,49,1000,600,400,0.6,14,6,8,365.2461937979033,0.4068168934240363,0.31422276181482967,0.20465381969946028,129609.02829142025,-330.74191338269753,129278.28637803756,2977,0,886.6122448979592,38,11,20,36.13471828769278,0.6126644736842104,45.432692307692314,1018.2692307692319,26.79655870445347,1
3023,4,0,0,49,0.0,0.0,1.0,49,1300,800,500,0.6153846153846154,18,8,10,366.34044143385825,0.40621456916099774,0.3139411191849575,0.20583713076439844,129717.84056770043,-295.8218049163455,129422.0187627841,2978,1,887.6122448979592,38,11,20,35.99611081978675,0.6137609649122806,45.325854700854705,1018.696581196582,26.807804768331106,0
3024,4,1,1,49,0.02,0.02,0.98,50,1050,700,350,0.6666666666666666,14,7,7,367.56317165843717,0.40846938775510205,0.3327413757909776,0.20913960254990527,130209.42382812503,-427.96223958333167,129781.4615885417,2979,0,870.84,39,11,21,35.465145948152674,0.6169871794871795,44.84375,1020.6250000000002,26.1698717948718,0
3025,4,0,0,49,0.0,0.0,1.0,49,1150,1000,150,0.8695652173913043,13,10,3,364.4956858993892,0.405187074829932,0.27201661862655935,0.19795393345857556,128372.67324334451,-432.15086919692544,127940.5223741476,2980,1,889.3673469387755,36,13,18,37.41526836315145,0.6038773148148149,46.64977477477476,1013.4009009008994,28.150025025024984,7
3026,4,2,2,49,0.0392156862745098,0.0392156862745098,0.9607843137254902,51,1350,800,550,0.5925925925925926,19,8,11,348.3140346790843,0.41044117647058825,0.26728310860564286,0.19135674081073004,128830.99500868034,-1225.271267361129,127605.72374131922,2981,0,855.4509803921569,39,12,18,37.35763390108763,0.6030982905982907,46.19791666666666,1015.2083333333317,26.030982905982864,0
3027,4,1,1,49,0.02,0.02,0.98,50,1500,1000,500,0.6666666666666666,20,10,10,360.9731997657021,0.4077721088435374,0.2671135430916558,0.1983995556606974,128848.62075617246,-697.8202160494228,128150.80054012303,2982,0,873.54,38,12,18,37.01835385316915,0.6049890350877194,46.180555555555536,1015.2777777777748,26.717836257309862,0
3028,4,2,2,49,0.0392156862745098,0.0392156862745098,0.9607843137254902,51,1600,1200,400,0.75,20,12,8,357.19400302489555,0.407859477124183,0.29546184407314624,0.19930119698804236,129443.56575963719,-950.295650667676,128493.27010896952,2983,0,857.3725490196078,34,17,19,36.50805256590235,0.6188725490196079,45.595238095238095,1017.6190476190477,29.929971988795522,0
3029,4,0,0,49,0.0,0.0,1.0,49,1650,1200,450,0.7272727272727273,21,12,9,370.8822266939952,0.40534651360544216,0.3032224580804963,0.20583343377124264,129232.53864198866,-213.98966142829386,129018.54898056037,2984,1,893.1632653061224,33,16,19,36.37496986862722,0.6190025252525253,45.802696078431374,1016.7892156862746,30.811794414735594,0
3030,4,0,0,49,0.0,0.0,1.0,49,1750,1100,650,0.6285714285714286,24,11,13,368.04931818188584,0.4058071145124717,0.3029536237199919,0.2051694074912466,129407.39300679442,-274.3394472307931,129133.05355956362,2985,2,894.1632653061224,35,14,19,36.2687454972889,0.6163690476190475,45.63078703703704,1017.476851851852,29.0707671957672,0
3031,4,0,0,49,0.0,0.0,1.0,49,1450,1100,350,0.7586206896551724,18,11,7,371.68917038694184,0.4053642290249433,0.31167059205717496,0.20781985082982546,129525.18332315247,-171.3784132801767,129353.80490987228,2986,3,895.1632653061224,35,14,19,36.056116164487385,0.6175595238095237,45.5150462962963,1017.9398148148151,29.08399470899472,0
3032,4,0,0,49,0.0,0.0,1.0,49,800,400,400,0.5,12,4,8,369.7265345093609,0.40527565192743764,0.3110504774897682,0.20687751892775683,129554.63927469128,-220.04243827161497,129334.59683641966,2987,4,896.1632653061224,35,14,19,36.076057298772156,0.6178571428571429,45.48611111111111,1018.055555555555,29.08730158730157,0
3033,4,0,0,49,0.0,0.0,1.0,49,1200,700,500,0.5833333333333334,17,7,10,370.23097093103485,0.40495677437641725,0.30983681816284814,0.20809533883365075,129731.4453125001,-193.88020833332007,129537.56510416679,2988,5,897.1632653061224,37,12,19,35.883179959100204,0.6157094594594594,45.31250000000001,1018.7500000000008,27.533783783783804,0
3034,4,0,0,49,0.0,0.0,1.0,49,1050,500,550,0.47619047619047616,16,5,11,370.6802693557247,0.4048681972789116,0.31194509889517286,0.20856505774899997,129772.26382725194,-179.19645792240544,129593.06736932954,2989,6,898.1632653061224,38,11,19,35.830187690049286,0.6143092105263157,45.272435897435905,1018.9102564102575,26.813427800269935,0
3035,4,0,0,49,0.0,0.0,1.0,49,1150,700,450,0.6086956521739131,16,7,9,370.55495608123584,0.4049744897959184,0.30844325991585153,0.20907538947197357,129881.14458917755,-174.37963419532616,129706.76495498222,2990,7,899.1632653061224,38,11,19,35.72258323725674,0.6154057017543859,45.1655982905983,1019.3376068376077,26.82467386414757,0
3036,4,0,1,48,0.0,0.02040816326530612,0.9795918367346939,49,1800,1500,300,0.8333333333333334,21,15,6,373.0135845187748,0.4043013038548753,0.3151593970921702,0.211374364560639,130050.0,-97.91666666666777,129952.08333333333,2991,8,900.1632653061224,39,10,19,35.488153594771255,0.6153846153846154,45.0,1020.0,26.153846153846153,0
3037,4,0,0,48,0.0,0.0,1.0,48,1650,1300,350,0.7878787878787878,20,13,7,375.56235713502366,0.4011432476359338,0.3131128076805225,0.21267385996003577,130023.43885633688,166.3818359375084,130189.8206922744,2992,9,919.4375,39,9,19,35.45017958669527,0.6151175213675213,45.02604166666667,1019.895833333334,26.15117521367523,0
3038,4,0,0,48,0.0,0.0,1.0,48,1550,1100,450,0.7096774193548387,20,11,9,376.62402597131376,0.40154957151300236,0.3154594856618018,0.21444153576367858,130236.00396050367,210.00162760418652,130446.00558810786,2993,10,920.4375,39,9,19,35.20693012892473,0.6172542735042734,44.81770833333334,1020.7291666666682,26.172542735042775,0
3039,4,2,1,49,0.04,0.02,0.98,50,1550,1200,350,0.7741935483870968,19,12,7,355.57681479438276,0.4083248299319728,0.30344673049500903,0.2051147572063017,130741.54188368077,-702.2623697916432,130039.27951388912,2994,0,884.58,39,11,18,35.231632375908205,0.6223290598290598,44.32291666666668,1022.7083333333351,26.223290598290642,0
3040,4,0,0,49,0.0,0.0,1.0,49,1200,1000,200,0.8333333333333334,14,10,4,360.3675244466509,0.40589569160997735,0.3127872962808189,0.2077974665062255,130726.51855504428,-378.0816257578995,130348.43692928638,2995,1,903.6326530612245,38,11,18,35.12436446580303,0.6239035087719298,44.33760683760684,1022.6495726495733,26.9118308591993,0
3041,4,1,1,49,0.02,0.02,0.98,50,900,400,500,0.4444444444444444,14,4,10,356.46245251454786,0.4075425170068027,0.31447293447293334,0.2070515947584507,131008.00781250044,-660.1128472221785,130347.89496527826,2996,0,886.54,39,11,18,34.93928910595577,0.6249999999999998,44.06250000000002,1023.7500000000035,26.25000000000009,0
3042,4,0,0,49,0.0,0.0,1.0,49,1050,800,250,0.7619047619047619,13,8,5,362.5933061819466,0.4052579365079365,0.31450967845144717,0.2098853297952428,130874.74093967046,-309.1389973957979,130565.60194227466,2997,3,905.6326530612245,39,10,19,34.9173071702467,0.6236645299145298,44.19270833333335,1023.2291666666692,26.236645299145366,0
3043,4,3,1,51,0.057692307692307696,0.019230769230769232,0.9807692307692307,52,1400,900,500,0.6428571428571429,19,9,10,348.55632259478426,0.41210250125691306,0.33279914529914545,0.2059650997150997,131665.5124653739,-1217.5108191342556,130448.00164623965,2998,0,854.3269230769231,37,15,18,34.4778311965812,0.6351351351351351,43.421052631578945,1026.3157894736837,27.73826458036983,0
3044,4,1,1,51,0.019230769230769232,0.019230769230769232,0.9807692307692307,52,1450,900,550,0.6206896551724138,20,9,11,344.37489506308907,0.4109162895927602,0.3304024022543728,0.2039457395620306,131749.92696069943,-1325.7265456678956,130424.20041503153,2999,0,855.3076923076923,37,15,18,34.500048951546866,0.6359797297297298,43.338815789473685,1026.6447368421052,27.747155049786628,0
3045,4,0,0,51,0.0,0.0,1.0,51,1500,1100,400,0.7333333333333333,19,11,8,350.54862157794156,0.40864379084967317,0.3338560657395151,0.20734916844146262,131703.53366457688,-966.3015633877035,130737.23210118918,3000,2,873.0784313725491,36,15,19,34.38837081733405,0.6374421296296295,43.38400900900901,1026.463963963965,28.512887887887914,0
3046,4,1,0,52,0.019230769230769232,0.0,1.0,52,1450,1100,350,0.7586206896551724,18,11,7,346.33809851937656,0.4104213800904977,0.3472251091249223,0.20698541515238744,132095.80342793468,-1250.038123675965,130845.7653042587,3001,0,857.2692307692307,38,14,20,34.10132162405598,0.6376096491228072,43.00213675213674,1027.9914529914515,27.052406657669778,0
3047,4,0,0,52,0.0,0.0,1.0,52,1000,700,300,0.7,13,7,6,348.4469934888471,0.40965152086475615,0.3531795511221958,0.20854812595377223,132150.72320841518,-1190.495562130209,130960.22764628497,3002,1,858.2692307692307,38,14,20,33.99184330839567,0.6381578947368423,42.948717948717935,1028.2051282051257,27.05802968960857,0
3048,4,0,0,52,0.0,0.0,1.0,52,1250,900,350,0.72,16,9,7,348.2599626071155,0.40955725238813473,0.35330320972265583,0.20889088224415545,132233.1242809005,-1189.6994165023289,131043.42486439816,3003,2,859.2692307692307,38,14,20,33.91373221148851,0.6389802631578949,42.86858974358973,1028.525641025639,27.06646423751682,0
3049,4,1,1,52,0.018867924528301886,0.018867924528301886,0.9811320754716981,53,1250,1000,250,0.8,15,10,5,338.9982805216083,0.4110123367198839,0.34262991888574157,0.2048229736292625,132507.9800044743,-1615.9017961502072,130892.07820832408,3004,0,844.0377358490566,38,15,20,33.87573069074056,0.6417214912280702,42.60149572649572,1029.5940170940162,27.094579397210953,0
3050,4,0,0,52,0.0,0.0,1.0,52,1550,1200,350,0.7741935483870968,19,12,7,353.9258464922846,0.40896021870286575,0.3573171930284371,0.21417986792883617,132567.32840874116,-1016.1992151431181,131551.12919359806,3005,4,861.2692307692307,37,15,20,33.43182140829076,0.6441441441441441,42.54385964912281,1029.8245614035088,27.833096254148888,0
3051,4,0,0,52,0.0,0.0,1.0,52,850,500,350,0.5882352941176471,12,5,7,353.32415397123594,0.40881096028154856,0.35125939634136305,0.21413723241327687,132623.7941001078,-1028.1620306248012,131595.632069483,3006,5,862.2692307692307,37,15,20,33.390550706124465,0.6447072072072071,42.4890350877193,1030.0438596491233,27.839023233760088,0
3052,4,0,0,52,0.0,0.0,1.0,52,1850,1400,450,0.7567567567567568,23,14,9,354.95908829655446,0.4087638260432378,0.35097074664003713,0.21577655315724617,132736.7615516316,-976.7760272391222,131759.98552439245,3007,6,863.2692307692307,37,15,18,33.23490813648294,0.6458333333333333,42.379385964912295,1030.4824561403532,27.85087719298252,0
3053,4,0,0,52,0.0,0.0,1.0,52,1550,1100,450,0.7096774193548387,20,11,9,357.79705309774425,0.40846530920060337,0.3525695546214367,0.21881918604924455,132962.84072983995,-885.2574830717127,132077.58324676825,3008,7,864.2692307692307,37,15,18,32.93465164079666,0.6480855855855856,42.16008771929825,1031.359649122807,27.874585111427216,0
3054,4,0,0,52,0.0,0.0,1.0,52,1000,600,400,0.6,14,6,8,355.3170843167199,0.408512443438914,0.35009484563056015,0.21763171414399096,133019.39058171748,-947.1875961834352,132072.20298553404,3009,8,865.2692307692307,37,15,18,32.94182256235828,0.6486486486486486,42.10526315789474,1031.5789473684213,27.880512091038412,0
3055,4,0,0,52,0.0,0.0,1.0,52,1900,1500,400,0.7894736842105263,23,15,8,356.12592473118474,0.4082060708898944,0.3563290725424171,0.2187896346977748,133132.52635426284,-917.6111880578637,132214.91516620497,3010,9,866.2692307692307,37,15,18,32.80740898144212,0.6497747747747746,41.99561403508772,1032.017543859649,27.892366050260787,0
3056,4,0,1,51,0.0,0.019230769230769232,0.9807692307692307,52,1250,800,450,0.64,17,8,9,357.27488972338693,0.4082060708898944,0.33008645461546715,0.2005272779843229,129675.59880203534,-1126.5186163050062,128549.08018573033,3011,10,867.2692307692307,37,15,16,36.26993845767395,0.6151463963963963,45.367324561403514,1018.5307017543868,27.527856804172615,7
3057,4,0,0,51,0.0,0.0,1.0,51,1000,700,300,0.7,13,7,6,362.0183240798444,0.4066339869281046,0.337841004820147,0.20290067445561344,129619.76431450066,-815.0540310480088,128804.71028345264,3012,14,885.0784313725491,37,14,17,36.20596443056604,0.6145833333333333,45.42214912280702,1018.3114035087723,27.521929824561415,0
3058,4,2,2,51,0.03773584905660377,0.03773584905660377,0.9622641509433962,53,1750,1500,250,0.8571428571428571,20,15,5,347.07043699639274,0.41305333817126266,0.3311170520119884,0.1972100928547946,130156.27170138876,-1565.3211805555652,128590.9505208332,3013,0,852.6415094339623,39,14,17,36.04192187287329,0.6164529914529915,44.89583333333333,1020.4166666666656,26.164529914529886,0
3059,4,3,3,51,0.05555555555555555,0.05555555555555555,0.9444444444444444,54,1150,700,450,0.6086956521739131,16,7,9,341.6474451528487,0.4115857209410669,0.3231770660654685,0.19583371799126217,130496.11363110566,-1883.267235111393,128612.84639599427,3014,0,837.7962962962963,40,14,15,35.836068563092624,0.6182291666666667,44.56300813008129,1021.7479674796735,25.543699186991837,0
3060,4,0,0,51,0.0,0.0,1.0,51,1550,1300,250,0.8387096774193549,18,13,5,363.15631002169016,0.40475490196078434,0.3349155284763523,0.20646889293658346,130178.65022170286,-744.9603483764204,129433.68987332644,3015,17,888.0784313725491,37,14,17,35.60883832957273,0.6202139639639639,44.87390350877193,1020.5043859649126,27.581199620673313,0
3061,4,1,1,51,0.019230769230769232,0.019230769230769232,0.9807692307692307,52,1350,1100,250,0.8148148148148148,16,11,5,356.8616585375312,0.4066899195575666,0.3380142738882683,0.2056305197990795,130699.20562358461,-1071.692942325954,129627.51268125865,3016,0,871.9807692307693,38,14,16,35.2416588304949,0.6236293859649122,44.36431623931624,1022.5427350427349,26.909019343229865,0
3062,4,0,0,51,0.0,0.0,1.0,51,850,400,450,0.47058823529411764,13,4,9,365.277945715526,0.40431372549019606,0.3533197062608826,0.21023775097849176,130654.64854570646,-654.9476762080528,129999.7008694984,3017,1,889.6470588235294,37,14,16,35.07167882167883,0.625,44.40789473684211,1022.3684210526322,27.63157894736844,0
3063,4,1,1,51,0.019230769230769232,0.019230769230769232,0.9807692307692307,52,1750,1400,350,0.8,21,14,7,361.491279107215,0.40639925842131724,0.36070886746562425,0.21007707263095468,131027.14913662434,-926.9656521659687,130100.18348445838,3018,0,873.5192307692307,38,14,17,34.791210129047975,0.6269188596491228,44.04380341880342,1023.8247863247866,26.942757534862807,0
3064,4,0,0,51,0.0,0.0,1.0,51,1350,800,550,0.5925925925925926,19,8,11,367.3711660788804,0.4038398692810457,0.3658198497908167,0.2132946023950513,130991.1703601107,-575.5241997537797,130415.64616035692,3019,1,891.2549019607843,37,14,17,34.677145815481296,0.6283783783783784,44.07894736842105,1023.6842105263149,27.66714082503554,0
3065,4,1,1,51,0.019230769230769232,0.019230769230769232,0.9807692307692307,52,1850,1200,650,0.6486486486486487,25,12,13,357.9158949159504,0.40518947963800905,0.35589254349029154,0.20918777258615973,131246.0064308021,-1004.993630834977,130241.01279996714,3020,0,875.0961538461538,38,14,17,34.66140131373162,0.6291118421052632,43.830128205128204,1024.679487179487,26.96524966261808,0
3066,4,0,0,51,0.0,0.0,1.0,51,1600,1100,500,0.6875,21,11,10,359.73892986896396,0.4031372549019608,0.3421647310609641,0.21024141961385037,131243.84576263846,-757.2958746922172,130486.54988794624,3021,3,893.2549019607843,37,14,18,34.616885143570535,0.6309121621621622,43.83223684210526,1024.6710526315785,27.693812233285904,0
3067,4,1,0,52,0.019230769230769232,0.0,1.0,52,1100,700,400,0.6363636363636364,15,7,8,357.9576724553201,0.4052130467571644,0.35829069464920593,0.2119549101921691,131743.6731074247,-968.1871279719426,130775.48597945274,3022,0,877.0576923076923,35,17,16,34.15774145058246,0.6398809523809523,43.34490740740741,1026.6203703703713,29.33201058201061,0
3068,4,0,0,52,0.0,0.0,1.0,52,1950,1500,450,0.7692307692307693,24,15,9,357.3481098710136,0.40492238562091504,0.35950866418074123,0.21185306019531253,131790.2425229285,-981.0011869977877,130809.24133593072,3023,1,878.0576923076923,36,16,16,34.126407472398924,0.6383101851851851,43.29954954954956,1026.8018018018033,28.522272272272314,0
3069,4,0,0,52,0.0,0.0,1.0,52,850,400,450,0.47058823529411764,13,4,9,359.1196245350594,0.40526018099547506,0.3633141608966626,0.2133895827611909,131876.9799148813,-928.077697630043,130948.90221725125,3024,2,879.0576923076923,36,16,16,33.99344004677852,0.6391782407407407,43.2150900900901,1027.139639639641,28.531656656656693,0
3070,4,0,0,52,0.0,0.0,1.0,52,1450,1100,350,0.7586206896551724,18,11,7,361.13546690048224,0.40531517094017094,0.3633738576198027,0.2150783289817234,131963.74584043518,-868.6422063955617,131095.1036340396,3025,3,880.0576923076923,36,16,16,33.85416666666667,0.6400462962962962,43.13063063063064,1027.4774774774787,28.541041041041076,0
3071,4,0,0,52,0.0,0.0,1.0,52,700,500,200,0.7142857142857143,9,5,4,367.66631917865413,0.40540158371040724,0.34202398330735395,0.21207320711065597,130738.7384219183,-761.2411146418651,129977.49730727644,3026,4,881.0576923076923,37,15,15,34.92537346771023,0.6258445945945945,44.32565789473684,1022.6973684210528,27.640469416785212,5
3072,4,1,0,53,0.018867924528301886,0.0,1.0,53,1300,900,400,0.6923076923076923,17,9,8,362.7571271038913,0.4084724238026125,0.3476397816020458,0.21070786319013282,131008.00781250012,-1095.1822916666533,129912.82552083346,3027,0,865.4150943396227,39,14,16,34.77818477818478,0.625,44.06250000000001,1023.7500000000009,26.250000000000025,0
3073,4,1,0,54,0.018518518518518517,0.0,1.0,54,1200,800,400,0.6666666666666666,16,8,8,374.0374672950814,0.4115711623573259,0.3918380388747982,0.21637592109921916,130850.90033712289,-988.5856705909581,129862.31466653194,3028,0,850.3703703703703,37,17,17,34.648729146572364,0.6269707207207207,44.21600877192982,1023.1359649122801,27.65232337600757,2
3074,4,0,0,54,0.0,0.0,1.0,54,1550,800,750,0.5161290322580645,23,8,15,309.53825917050307,0.4113309457255998,0.26366345935788993,0.17625009123438318,130237.26974875585,-2728.2241076575965,127509.04564109824,3029,1,851.3703703703703,41,13,18,36.917561635403494,0.6140752032520326,44.816468253968246,1020.734126984126,24.895954316685998,7
3075,4,1,0,55,0.01818181818181818,0.0,1.0,55,1250,900,350,0.72,16,9,7,303.474903569472,0.41324354657687995,0.2745290427324789,0.1743838221682246,130591.93244716852,-3073.722718253983,127518.20972891455,3030,0,836.8727272727273,41,14,12,36.714528939791,0.6176321138211383,44.469246031746025,1022.1230158730147,24.92982965543938,0
3076,4,0,0,55,0.0,0.0,1.0,55,1450,1200,250,0.8275862068965517,17,12,5,302.349756952513,0.413692480359147,0.2695776386562039,0.17453672979733528,130769.44464128233,-3092.3780391786395,127677.06660210369,3031,1,837.8727272727273,41,14,12,36.56441965729068,0.619410569105691,44.29563492063492,1022.8174603174594,24.946767324816083,0
3077,4,0,1,54,0.0,0.01818181818181818,0.9818181818181818,55,800,500,300,0.625,11,5,6,326.8266034634569,0.41341189674523005,0.2783814908779192,0.18203461590253778,129373.8462701311,-2515.7911529844287,126858.05511714666,3032,2,838.8727272727273,42,13,20,37.351374734101675,0.6039186507936507,45.663759689922486,1017.3449612403108,24.222499077150257,6
3078,4,0,0,54,0.0,0.0,1.0,54,1500,1200,300,0.8,18,12,6,326.7271043254743,0.41358024691358025,0.26403919867692105,0.18243566064489417,129472.44498715535,-2339.5685918814816,127132.87639527387,3033,3,825.4074074074074,42,12,16,37.25384017264909,0.6049107142857142,45.566860465116285,1017.732558139536,24.231727574750856,0
3079,4,1,1,54,0.01818181818181818,0.01818181818181818,0.9818181818181818,55,1600,1200,400,0.75,20,12,8,321.4082162401174,0.4148989898989899,0.2714301058389035,0.18070795111343957,129743.23666838145,-2659.891546639222,127083.34512174223,3034,0,811.3818181818182,44,11,18,37.11468841831016,0.6048768939393938,45.30092592592593,1018.7962962962971,23.154461279461298,0
3080,4,1,1,54,0.01818181818181818,0.01818181818181818,0.9818181818181818,55,1900,1400,500,0.7368421052631579,24,14,10,319.9070947138337,0.41505331088664427,0.28116434963510883,0.18084275805897024,129955.57270233204,-2685.258058984906,127270.31464334713,3035,0,812.290909090909,44,11,19,36.93792378011866,0.6070075757575757,45.092592592592595,1019.6296296296302,23.17340067340069,0
3081,4,0,0,54,0.0,0.0,1.0,54,1250,1000,250,0.8,15,10,5,327.1053500971073,0.4130124621476823,0.28990099146145965,0.18476475336544898,129924.46212838618,-2300.202665863173,127624.25946252301,3036,2,828.3333333333334,43,11,19,36.785946498235205,0.6080426356589147,45.12310606060606,1019.5075757575761,23.70947850599014,0
3082,4,0,0,54,0.0,0.0,1.0,54,1650,1400,250,0.8484848484848485,19,14,5,326.47618949090844,0.41292511064523646,0.29436706901887955,0.1848658549325492,130021.02434142568,-2310.246283861335,127710.77805756436,3037,3,829.3333333333334,43,11,19,36.70419374806562,0.6090116279069768,45.02840909090909,1019.8863636363642,23.718287526427073,0
3083,4,0,0,54,0.0,0.0,1.0,54,1550,1100,450,0.7096774193548387,20,11,9,334.7977761385816,0.412051595620778,0.3058965794382871,0.1908841350220315,130288.5239027697,-2075.26582448961,128213.25807828008,3038,4,830.3333333333334,40,14,19,36.221091313292185,0.6161458333333333,44.76626016260163,1020.9349593495949,25.523373983739873,0
3084,4,1,1,54,0.01818181818181818,0.01818181818181818,0.9818181818181818,55,1500,1100,400,0.7333333333333333,19,11,8,330.72794831032996,0.4130050505050505,0.31110797384698197,0.190044063103253,130591.93244716852,-2361.91962317336,128230.01282399516,3039,0,816.2181818181818,41,14,15,36.01812983273481,0.6176321138211383,44.469246031746025,1022.1230158730147,24.92982965543938,0
3085,4,0,1,53,0.0,0.018518518518518517,0.9814814814814815,54,1550,1000,550,0.6451612903225806,21,10,11,333.39496539210427,0.41053022361984626,0.3022825450487774,0.19148790216724126,130574.00238160166,-2093.456998975469,128480.5453826262,3040,6,832.3333333333334,40,14,15,35.96810679128964,0.6190104166666666,44.486788617886184,1022.0528455284561,25.551321138211403,0
3086,4,0,0,53,0.0,0.0,1.0,53,1800,1500,300,0.8333333333333334,21,15,6,331.1796989983473,0.41081579583938077,0.2985474663962011,0.1906780993227355,130667.99433893917,-1945.0825932224836,128722.91174571669,3041,7,847.6415094339623,41,12,15,35.9297173167734,0.6183943089430894,44.394841269841265,1022.420634920634,24.93708865660083,0
3087,4,0,0,53,0.0,0.0,1.0,53,750,500,250,0.6666666666666666,10,5,5,331.5304261070965,0.4109065070149976,0.3031988773987122,0.19132332682123554,130757.64607182542,-1929.9723762093747,128827.67369561605,3042,8,848.6415094339623,42,11,15,35.83017527238277,0.6178075396825398,44.30717054263565,1022.7713178294558,24.35169804355847,0
3088,4,1,1,53,0.018518518518518517,0.018518518518518517,0.9814814814814815,54,1150,800,350,0.6956521739130435,15,8,7,327.38309467892503,0.4123427672955975,0.31134441258389023,0.1901847735934369,131012.85515847402,-2221.721207099395,128791.13395137462,3043,0,833.9074074074074,43,11,16,35.67864906114143,0.6189437984496123,44.057765151515156,1023.7689393939401,23.80857998590558,0
3089,4,0,0,53,0.0,0.0,1.0,53,1200,900,300,0.75,15,9,6,331.9606991230009,0.41036223996129656,0.30817144533050356,0.19248021653011751,130940.15438475656,-1906.602961432515,129033.55142332405,3044,1,850.4716981132076,43,10,16,35.63486923266715,0.6182170542635659,44.128787878787875,1023.4848484848477,23.801973220577853,0
3090,4,0,0,53,0.0,0.0,1.0,53,1800,1400,400,0.7777777777777778,22,14,8,333.0054345638094,0.4108913884857281,0.31237633954587163,0.19381704894365087,131085.57610910235,-1869.5581525482148,129216.01795655413,3045,2,851.4716981132076,43,10,16,35.46136181493126,0.6196705426356589,43.98674242424242,1024.05303030303,23.815186751233256,0
3091,4,0,0,53,0.0,0.0,1.0,53,1400,1100,300,0.7857142857142857,17,11,6,335.3040547142924,0.4109065070149976,0.25896924692035794,0.19039438932907207,130129.69970703124,-1814.2201713512977,128315.47953567994,3046,3,852.4716981132076,39,14,20,36.369002041858074,0.6161858974358976,44.921875,1020.3124999999999,26.16185897435897,8
3092,4,2,1,54,0.03636363636363636,0.01818181818181818,0.9818181818181818,55,1050,500,550,0.47619047619047616,16,5,11,323.37534781007855,0.41470258136924804,0.26257523287468376,0.18653931638069016,130741.54188368034,-2544.1460503472435,128197.3958333331,3047,0,822.4363636363636,39,16,12,36.054950091668374,0.6223290598290598,44.32291666666666,1022.7083333333317,26.223290598290557,0
3093,4,0,0,54,0.0,0.0,1.0,54,1250,900,350,0.72,16,9,7,332.21162220232077,0.41200791986955504,0.26721124928879125,0.19115652512651876,130644.58832137112,-2119.6698763605887,128524.91844501054,3048,1,838.6666666666666,38,16,12,35.926995157975405,0.6230811403508772,44.41773504273504,1022.3290598290595,26.90339631129104,0
3094,4,1,1,54,0.01818181818181818,0.01818181818181818,0.9818181818181818,55,1150,800,350,0.6956521739130435,15,8,7,329.627260844192,0.41409932659932663,0.2655270655270654,0.19146434512864768,131008.0078125,-2363.2378472222226,128644.76996527778,3049,0,824.4,39,16,13,35.62610229276894,0.625,44.0625,1023.75,26.25,0
3095,4,0,1,53,0.0,0.018518518518518517,0.9814814814814815,54,1800,1400,400,0.7777777777777778,22,14,8,338.5417789852529,0.41102521546703935,0.27340615505925436,0.19660044401434512,130999.80481591065,-1930.218606180136,129069.58620973052,3050,3,840.6666666666666,38,16,16,35.40623043206012,0.6266447368421052,44.070512820512825,1023.7179487179493,26.9399460188934,0
3096,4,0,0,53,0.0,0.0,1.0,53,1350,1000,350,0.7407407407407407,17,10,7,357.49726088041126,0.4096819061441703,0.26086889369827126,0.19998973844214454,129545.80213758703,-1233.8930911252623,128311.90904646176,3051,4,855.7358490566038,39,14,13,36.396300180770154,0.610309829059829,45.49479166666668,1018.0208333333352,26.10309829059834,8
3097,4,0,1,52,0.0,0.018867924528301886,0.9811320754716981,53,1700,1200,500,0.7058823529411765,22,12,10,358.31094420083497,0.40957607643928395,0.2622981193836269,0.2008513641345968,129625.34722222245,-1310.7638888888632,128314.58333333359,3052,5,856.7358490566038,39,14,13,36.29466721222042,0.6111111111111109,45.41666666666668,1018.3333333333352,26.11111111111116,0
3098,4,0,0,52,0.0,0.0,1.0,52,1200,900,300,0.75,15,9,6,365.3090680637,0.40769544997486173,0.2734610139676754,0.20497300446446476,129663.42872242325,-926.554738293504,128736.87398412975,3053,6,873.5576923076923,38,14,13,36.077747473687914,0.6132127192982455,45.37927350427351,1018.482905982907,26.80218173639229,0
3099,4,1,0,53,0.018867924528301886,0.0,1.0,53,1800,1300,500,0.7222222222222222,23,13,10,358.26310052726467,0.41102745524915335,0.27567716555163013,0.20260181924098186,129970.32470703138,-1287.285698784707,128683.03900824668,3054,0,858.0566037735849,39,14,15,35.94521486702764,0.6145833333333333,45.07812500000001,1019.687500000001,26.14583333333336,0
3100,4,1,1,53,0.018518518518518517,0.018518518518518517,0.9814814814814815,54,1550,1100,450,0.7096774193548387,20,11,9,351.97736172339046,0.41299062427207084,0.2704773197554118,0.20096771943561323,130344.39718934908,-1623.688125359552,128720.70906398953,3055,0,843.1481481481482,38,16,15,35.725962544465375,0.6200657894736842,44.71153846153846,1021.1538461538458,26.87246963562752,0
3101,4,1,1,53,0.018518518518518517,0.018518518518518517,0.9814814814814815,54,800,400,400,0.5,12,4,8,350.8405429931688,0.4125393081761006,0.26971179989124505,0.20099556341571242,130475.34722222215,-1644.7916666666763,128830.55555555547,3056,0,844.1296296296297,39,15,15,35.62228113104946,0.6196581196581197,44.58333333333333,1021.666666666666,26.196581196581178,0
3102,4,1,0,54,0.018518518518518517,0.0,1.0,54,1350,1200,150,0.8888888888888888,15,12,3,349.5305017505465,0.4131143722338691,0.2727967396841571,0.20121066713675126,130661.65500216994,-1665.9532335069634,128995.70176866297,3057,0,845.1111111111111,39,15,14,35.46707845134997,0.6215277777777779,44.40104166666666,1022.3958333333317,26.215277777777736,0
3103,4,1,1,54,0.01818181818181818,0.01818181818181818,0.9818181818181818,55,1400,1000,400,0.7142857142857143,18,10,8,344.68631692807,0.4148709315375982,0.27693446088795026,0.2002906976744185,131023.24263038508,-1967.616213151964,129055.62641723311,3058,0,830.7272727272727,41,14,16,35.225290697674424,0.6219512195121952,44.04761904761903,1023.8095238095206,24.97096399535416,0
3104,4,0,1,53,0.0,0.018518518518518517,0.9814814814814815,54,850,600,250,0.7058823529411765,11,6,5,347.7699881164223,0.4131216515257396,0.2899604815733843,0.2021801863977467,131041.82287535506,-1685.517363176707,129356.30551217835,3059,1,846.5555555555555,40,14,16,35.12758478081058,0.6236979166666667,44.029471544715435,1023.8821138211364,25.59705284552841,0
3105,4,0,0,53,0.0,0.0,1.0,53,1500,1100,400,0.7333333333333333,19,11,8,348.547976814285,0.41107281083696173,0.2872670516856122,0.20359563744157702,131223.97898902764,-1452.4295227708385,129771.54946625681,3060,2,863.433962264151,40,13,17,34.923626264630045,0.6255208333333333,43.85162601626016,1024.593495934959,25.614837398373975,2
3106,4,0,1,52,0.0,0.018867924528301886,0.9811320754716981,53,1050,700,350,0.6666666666666666,14,7,7,347.9067490043111,0.410951862602806,0.28266152795577204,0.20363549412121182,131302.08462431433,-1463.8237201731677,129838.26090414116,3061,3,864.433962264151,40,13,17,34.86117997025285,0.6263020833333333,43.775406504065046,1024.8983739837406,25.622459349593516,0
3107,4,0,0,52,0.0,0.0,1.0,52,1700,1200,500,0.7058823529411765,22,12,10,353.96411116700926,0.40726338612368024,0.2851505580604059,0.20689971784909886,131250.0116188281,-1108.441259336371,130141.57035949174,3062,4,881.9807692307693,40,12,17,34.758587060729276,0.62578125,43.826219512195124,1024.6951219512198,25.617378048780495,0
3108,4,0,0,52,0.0,0.0,1.0,52,1050,500,550,0.47619047619047616,16,5,11,351.9588677553478,0.4072555304172951,0.28139054796167895,0.20629476701970406,131355.5035635361,-1153.606663156565,130201.89690037954,3063,5,882.9807692307693,38,14,17,34.70340455098141,0.6302083333333335,43.72329059829058,1025.1068376068351,26.97649572649566,0
3109,4,0,0,52,0.0,0.0,1.0,52,800,500,300,0.625,11,5,6,351.275307326365,0.4074990573152338,0.28026100618847694,0.2060414333193026,131382.884980641,-1169.6873402002007,130213.19764044082,3064,6,883.9807692307693,38,14,17,34.69327497568433,0.630482456140351,43.69658119658118,1025.213675213672,26.979307242465055,0
3110,4,0,0,52,0.0,0.0,1.0,52,1050,700,350,0.6666666666666666,14,7,7,350.434679025508,0.4070669934640523,0.28275832434881787,0.20611588110425028,131488.33007812488,-1184.3858506944594,130303.94422743043,3065,7,884.9807692307693,39,13,17,34.608385808111585,0.6298076923076924,43.59374999999999,1025.624999999999,26.2980769230769,0
3111,4,1,0,53,0.018867924528301886,0.0,1.0,53,1550,1100,450,0.7096774193548387,20,11,9,344.16557659609947,0.40909228350266086,0.28454839679601984,0.20393576658946572,131771.20642681263,-1529.7773522704847,130241.42907454215,3066,0,869.2641509433962,40,13,16,34.483981655613846,0.6309895833333334,43.318089430894304,1026.7276422764219,25.668191056910548,0
3112,4,0,0,53,0.0,0.0,1.0,53,1650,1200,450,0.7272727272727273,21,12,9,346.2451396477673,0.4091829946782777,0.2784071135081949,0.20593730161129423,131913.47321625412,-1465.1202089632102,130448.3530072909,3067,1,870.2641509433962,41,12,16,34.28728070175438,0.6308434959349594,43.179563492063494,1027.2817460317463,25.055652342237714,0
3113,4,0,1,52,0.0,0.018867924528301886,0.9811320754716981,53,1600,1200,400,0.75,20,12,8,346.1907673289582,0.4093644170295114,0.2838183099540543,0.20673674583834803,132066.3868122482,-1455.9672422209492,130610.41957002725,3068,2,871.2641509433962,41,12,17,34.13471592188656,0.6323678861788617,43.030753968253975,1027.8769841269855,25.070170344560623,0
3114,4,0,0,52,0.0,0.0,1.0,52,1050,700,350,0.6666666666666666,14,7,7,351.998755492747,0.4073733660130719,0.28174473155112056,0.20589734678596133,131277.28666698167,-1157.6958734882778,130119.5907934934,3069,3,888.8269230769231,41,11,16,34.781381090674394,0.6244918699186992,43.79960317460318,1024.801587301588,24.99516066589239,2
3115,4,0,0,52,0.0,0.0,1.0,52,1150,800,350,0.6956521739130435,15,8,7,359.7388956929085,0.40760903720462544,0.2920276150560561,0.21145950151599655,131465.04635336742,-941.3523548253615,130523.69399854206,3070,4,889.8269230769231,38,14,17,34.39333958398444,0.6313048245614037,43.61645299145298,1025.5341880341862,26.98774179037332,0
3116,4,0,0,52,0.0,0.0,1.0,52,950,500,450,0.5263157894736842,14,5,9,361.5918736375253,0.4075619029663147,0.296108979032633,0.2128536835557249,131519.83486969437,-888.69929779388,130631.1355719005,3071,5,890.8269230769231,38,14,17,34.29048189424712,0.6318530701754387,43.56303418803417,1025.747863247861,26.99336482231213,0
3117,4,0,0,52,0.0,0.0,1.0,52,1200,800,400,0.6666666666666666,16,8,8,358.1306255728234,0.40769544997486173,0.2886297551246009,0.2111189930862995,131574.63480029564,-975.8187458908856,130598.81605440476,3072,6,891.8269230769231,38,14,15,34.32390919504322,0.6324013157894738,43.50961538461537,1025.9615384615365,26.99898785425096,0
3118,4,0,0,52,0.0,0.0,1.0,52,1350,900,450,0.6666666666666666,18,9,9,355.7925372219241,0.4072869532428356,0.2805723000072047,0.21064759643656608,131739.1030777449,-1025.6420529257139,130713.46102481917,3073,7,892.8269230769231,38,14,15,34.21792069934435,0.634046052631579,43.34935897435897,1026.602564102564,27.015856950067473,0
3119,4,0,0,52,0.0,0.0,1.0,52,1600,1200,400,0.75,20,12,8,356.477787537809,0.40726338612368024,0.2759344317390715,0.21166281479931798,131848.80566741546,-999.7658932354404,130849.03977418003,3074,8,893.8269230769231,38,14,15,34.089687575852146,0.6351425438596492,43.24252136752137,1027.0299145299148,27.027103013945126,0
3120,4,0,0,52,0.0,0.0,1.0,52,1000,800,200,0.8,12,8,4,355.4518218170223,0.4073733660130719,0.2812612504500174,0.21135864358507542,131903.6740836621,-1022.9197485207153,130880.75433514139,3075,9,894.8269230769231,38,14,15,34.06071242849713,0.6356907894736842,43.18910256410256,1027.2435897435898,27.032726045883944,0
3121,4,0,0,52,0.0,0.0,1.0,52,1400,1200,200,0.8571428571428571,16,12,4,352.8555037561888,0.4078604198089492,0.2730738049951664,0.2107734934059366,132076.58420138896,-1079.2100694444391,130997.37413194453,3076,10,895.8269230769231,39,13,16,33.953182002432094,0.6356837606837606,43.020833333333336,1027.9166666666672,26.35683760683762,0
3122,4,0,0,52,0.0,0.0,1.0,52,1050,700,350,0.6666666666666666,14,7,7,353.75953429582734,0.4079389768728004,0.27676296659888266,0.21206240935656992,132210.46142578137,-1045.8577473958183,131164.60367838555,3077,11,896.8269230769231,39,13,16,33.79513572369089,0.6370192307692307,42.89062500000001,1028.437500000001,26.37019230769233,0
3123,4,0,0,52,0.0,0.0,1.0,52,1350,800,550,0.5925925925925926,19,8,11,356.176957498074,0.4073419431875314,0.27538150109000314,0.21457489878542527,132398.00347222236,-968.1776258680355,131429.82584635433,3078,12,897.8269230769231,36,16,16,33.54419703103915,0.6443865740740741,42.70833333333334,1029.1666666666679,28.587962962962997,0
3124,4,0,0,52,0.0,0.0,1.0,52,1600,1200,400,0.75,20,12,8,352.76735246084195,0.4073419431875314,0.2647036209863436,0.19722304617355732,129521.75842985688,-1261.7904385253394,128259.96799133155,3079,13,898.8269230769231,42,10,15,36.541131207361566,0.605406746031746,45.518410852713174,1017.9263565891465,24.236341823551108,7
3125,4,1,1,52,0.018867924528301886,0.018867924528301886,0.9811320754716981,53,1300,900,400,0.6923076923076923,17,9,8,346.1630909927082,0.40821540880503143,0.2602834131640033,0.19497804398494092,129813.99605624142,-1612.6371742112506,128201.35888203017,3080,0,882.8490566037735,44,9,15,36.41233569568115,0.6055871212121213,45.23148148148148,1019.0740740740739,23.16077441077441,0
3126,4,1,1,52,0.018867924528301886,0.018867924528301886,0.9811320754716981,53,1450,1100,350,0.7586206896551724,18,11,7,342.8268084253354,0.4106041364296081,0.26430517711171664,0.19356529029553557,129908.37191358031,-1692.7854938271532,128215.58641975316,3081,0,883.8301886792453,44,9,15,36.40156675749319,0.6065340909090909,45.13888888888889,1019.4444444444449,23.16919191919193,0
3127,4,0,0,52,0.0,0.0,1.0,52,1850,1300,550,0.7027027027027027,24,13,11,346.50850354028995,0.40687060080442433,0.26853068922162526,0.1959665738509371,129972.73875114789,-1392.6681588613358,128580.07059228655,3082,16,901.8269230769231,43,9,15,36.242415799900925,0.6085271317829457,45.07575757575758,1019.69696969697,23.713883016208605,0
3128,4,1,0,53,0.018867924528301886,0.0,1.0,53,1150,600,550,0.5217391304347826,17,6,11,343.35693461057895,0.40747460087082726,0.27308432807085103,0.19563360227812066,130262.58680555562,-1654.687499999991,128607.89930555563,3083,0,885.7924528301887,44,9,16,36.02891156462586,0.6100852272727272,44.79166666666667,1020.8333333333339,23.20075757575759,0
3129,4,1,1,53,0.018518518518518517,0.018518518518518517,0.9814814814814815,54,1300,800,500,0.6153846153846154,18,8,10,338.2182449096654,0.4102317726531563,0.27900283609390963,0.19388251078328103,130498.9979852539,-1972.5715877914845,128526.4263974624,3084,0,870.3703703703703,44,10,15,35.92074460051351,0.6124526515151515,44.56018518518519,1021.7592592592603,23.22180134680137,0
3130,4,0,0,53,0.0,0.0,1.0,53,1100,800,300,0.7272727272727273,14,8,6,339.60596093962596,0.40841194968553457,0.28556338828681227,0.1945835747518654,130480.18470392848,-1737.6302980084943,128742.55440591999,3085,1,887.4528301886793,43,10,17,35.90433543423857,0.6136143410852714,44.578598484848484,1021.685606060606,23.760130373502466,0
3131,4,0,0,53,0.0,0.0,1.0,53,1400,1000,400,0.7142857142857143,18,10,8,335.0783100665762,0.40880503144654085,0.28330903611719993,0.19258973795839318,130601.15089101244,-1847.677413337924,128753.47347767452,3086,2,888.4528301886793,43,10,15,35.89764375270211,0.6148255813953488,44.46022727272727,1022.1590909090912,23.771141649048634,0
3132,4,0,1,52,0.0,0.018867924528301886,0.9811320754716981,53,1250,900,350,0.72,16,9,7,339.4710951324817,0.4093644170295114,0.06296744756760853,0.18766649312885259,129078.2754660927,-1694.1064890758294,127384.16897701687,3087,3,889.4528301886793,42,11,16,37.33034550713581,0.6009424603174605,45.95445736434108,1016.1821705426349,24.194813584348452,8
3133,4,2,0,54,0.037037037037037035,0.0,1.0,54,1350,900,450,0.6666666666666666,18,9,9,336.7200197838526,0.4112654320987654,0.1129330394006196,0.18900392384882406,129678.39084201408,-2066.703197533557,127611.68764448052,3088,0,873.8703703703703,39,15,15,36.79049907956638,0.6116452991452991,45.36458333333334,1018.5416666666682,26.11645299145303,0
3134,4,0,0,54,0.0,0.0,1.0,54,1450,1100,350,0.7586206896551724,18,11,7,338.5068999434304,0.41135278360121125,0.11634884398862733,0.1906512954603674,129811.04736328138,-2011.6129557291506,127799.43440755222,3089,1,874.8703703703703,39,15,15,36.61038280690996,0.6129807692307692,45.23437500000001,1019.062500000001,26.12980769230772,0
3135,4,3,2,55,0.05263157894736842,0.03508771929824561,0.9649122807017544,57,1150,700,450,0.6086956521739131,16,7,9,320.51282051282067,0.41906850459482037,0.1300044984255515,0.18333333333333343,130414.54081632657,-3039.309574741348,127375.23124158522,3090,0,829.7719298245614,41,16,17,36.45833333333336,0.6158536585365852,44.642857142857146,1021.4285714285717,24.912891986062725,0
3136,4,0,0,55,0.0,0.0,1.0,55,1550,1100,450,0.7096774193548387,20,11,9,331.53337116002393,0.4134680134680135,0.1253518762314565,0.18877403740262808,130237.2697487561,-2364.399781903488,127872.86996685261,3091,1,860.9454545454546,41,14,19,36.356282599539966,0.6140752032520325,44.81646825396826,1020.7341269841279,24.895954316686048,0
3137,4,2,1,56,0.03508771929824561,0.017543859649122806,0.9824561403508771,57,1200,1000,200,0.8333333333333334,14,10,4,317.93744519780273,0.41735850041771094,0.13436676674223347,0.1832941378690688,130718.71456916103,-3087.920249118166,127630.79432004287,3092,0,831.7017543859649,41,16,14,36.21701590997282,0.6189024390243902,44.345238095238095,1022.6190476190479,24.941927990708486,0
3138,4,0,1,55,0.0,0.017857142857142856,0.9821428571428571,56,950,500,450,0.5263157894736842,14,5,9,321.43339682096934,0.41599025974025977,0.13055295186968285,0.18486555395209422,130625.94112507426,-2802.4920062462934,127823.44911882796,3093,1,847.5535714285714,40,16,14,36.22129436325679,0.6195312500000001,44.43597560975609,1022.2560975609748,25.55640243902437,0
3139,4,1,1,55,0.017857142857142856,0.017857142857142856,0.9821428571428571,56,1000,700,300,0.7,13,7,6,320.7407283516086,0.41660579004329,0.1332993738196997,0.18471508116459828,130677.89019639429,-2817.2556637913976,127860.6345326029,3094,0,848.4821428571429,40,16,14,36.18655368916279,0.6200520833333334,44.385162601626014,1022.4593495934955,25.56148373983739,0
3140,4,0,0,55,0.0,0.0,1.0,55,1250,900,350,0.72,16,9,7,326.06802126910713,0.4145763187429854,0.12306865660580146,0.18744613314081715,130608.41064453124,-2482.554796006945,128125.8558485243,3095,3,864.9090909090909,39,16,15,36.12055861272463,0.6209935897435898,44.453125,1022.1874999999999,26.209935897435894,0
3141,4,1,0,56,0.017857142857142856,0.0,1.0,56,1200,1000,200,0.8333333333333334,14,10,4,321.71044306742004,0.4178977272727273,0.13408918765385347,0.1864931778088964,130931.13864100724,-2775.6170752959456,128155.5215657113,3096,0,850.4464285714286,42,14,16,35.906236192640264,0.6195436507936507,44.13759689922481,1023.4496124031015,24.367847914359558,0
3142,4,0,0,56,0.0,0.0,1.0,56,1850,1500,350,0.8108108108108109,22,15,7,320.4260801765631,0.4177150974025974,0.1307249890984048,0.18614327527075894,131012.85515847395,-2804.0128737660743,128208.84228470788,3097,1,851.4464285714286,43,13,16,35.85670844510219,0.6189437984496124,44.05776515151515,1023.7689393939395,23.80857998590557,0
3143,4,1,1,56,0.017543859649122806,0.017543859649122806,0.9824561403508771,57,1450,1000,450,0.6896551724137931,19,10,9,317.34907734021,0.4194078947368421,0.12970853226307533,0.18564585560261332,131280.67558299046,-3067.6397462277064,128213.03583676275,3098,0,837.4912280701755,44,13,17,35.66569539814479,0.6202651515151516,43.7962962962963,1024.8148148148152,23.2912457912458,0
3144,4,0,0,56,0.0,0.0,1.0,56,1150,800,350,0.6956521739130435,15,8,7,323.9041735063984,0.4182224025974026,0.13267498976667969,0.1891159877585389,131206.82253106352,-2700.3125179350354,128506.51001312849,3099,1,853.2678571428571,43,13,17,35.57216085898263,0.6208817829457365,43.86837121212121,1024.5265151515155,23.82619802677943,0
3145,4,0,0,56,0.0,0.0,1.0,56,700,300,400,0.42857142857142855,11,3,8,321.9840363612867,0.41763392857142856,0.13393929594382348,0.18847123988849132,131303.86002245464,-2744.4506320305322,128559.4093904241,3100,2,854.2678571428571,43,13,17,35.523595583479626,0.6218507751937985,43.77367424242424,1024.905303030303,23.835007047216347,0
3146,4,0,0,56,0.0,0.0,1.0,56,1700,1300,400,0.7647058823529411,21,13,8,323.868358575838,0.4173430735930736,0.13577613012894107,0.19032559537228155,131455.26389085708,-2685.155407744879,128770.1084831122,3101,3,855.2678571428571,41,15,17,35.32284915030151,0.6262703252032521,43.625992063492056,1025.4960317460302,25.01209833526903,0
3147,4,0,0,56,0.0,0.0,1.0,56,1750,1400,350,0.8,21,14,7,324.76542438940334,0.41703192640692643,0.14014335432548886,0.1917450656326479,131633.36167800464,-2650.0070861677923,128983.35459183685,3102,4,856.2678571428571,41,15,14,35.120601314771854,0.6280487804878048,43.452380952380956,1026.190476190477,25.029036004645782,0
3148,4,0,0,56,0.0,0.0,1.0,56,1100,700,400,0.6363636363636364,15,7,8,322.71232992811474,0.41695075757575756,0.13521804795167047,0.19099521917644957,131725.71228441797,-2698.0976954510033,129027.61458896697,3103,5,857.2678571428571,42,14,14,35.08039141652508,0.6274801587301587,43.36240310077519,1026.5503875968989,24.44167589516426,0
3149,4,1,1,56,0.017543859649122806,0.017543859649122806,0.9824561403508771,57,1050,600,450,0.5714285714285714,15,6,9,317.3957947345776,0.41808949456975775,0.14585477117426393,0.1892947837592197,132017.10498113866,-3019.66520919066,128997.439771948,3104,0,843.2105263157895,44,13,15,34.92412980148362,0.6276041666666666,43.07870370370371,1027.6851851851861,23.356481481481502,0
3150,4,0,1,55,0.0,0.017857142857142856,0.9821428571428571,56,1550,1100,450,0.7096774193548387,20,11,9,326.10989288293683,0.416112012987013,0.1450695322376736,0.19394956787248352,131911.15702479339,-2596.4933425160757,129314.66368227731,3105,1,859.0535714285714,43,13,15,34.806723205506394,0.627906976744186,43.18181818181818,1027.2727272727273,23.890063424947144,0
3151,4,0,0,55,0.0,0.0,1.0,55,1000,600,400,0.6,14,6,8,333.4257108791428,0.413692480359147,0.14571877117880705,0.19772312580784998,131800.32680014736,-2210.8764685114975,129589.45033163586,3106,2,875.5454545454545,42,13,15,34.73034821175803,0.6282242063492063,43.28972868217055,1026.841085271319,24.448597268364736,0
3152,4,0,1,54,0.0,0.01818181818181818,0.9818181818181818,55,1200,800,400,0.6666666666666666,16,8,8,327.2643306837049,0.4129349046015713,0.1405516602952015,0.19521740670592683,132024.29710504191,-2358.63135478636,129665.66575025556,3107,3,876.5454545454545,42,13,18,34.66335879062166,0.6304563492063492,43.071705426356594,1027.7131782945748,24.469361387966067,0
3153,4,0,0,54,0.0,0.0,1.0,54,1600,1300,300,0.8125,19,13,6,325.58724751104603,0.41256114605171207,0.13363589727483083,0.19511335165639368,132198.6276835076,-2191.562537557838,130007.06514594976,3108,4,878.425925925926,42,12,18,34.53135305757092,0.6321924603174602,42.90213178294574,1028.391472868217,24.485511258767072,0
3154,4,0,0,54,0.0,0.0,1.0,54,1650,1100,550,0.6666666666666666,22,11,11,324.37837040436676,0.41233548800372705,0.13937621832358693,0.1954181889997037,132398.0034722221,-2210.4400464215,130187.5634258006,3109,5,879.425925925926,41,13,18,34.362348178137644,0.6356707317073171,42.70833333333333,1029.1666666666656,25.101626016260138,0
3155,4,0,0,54,0.0,0.0,1.0,54,1850,1300,550,0.7027027027027027,24,13,11,324.8756087162903,0.41228453296063355,0.14346944747792678,0.19624907259939794,132500.12302374636,-2190.7883755354233,130309.33464821093,3110,6,880.425925925926,41,13,18,34.24712532922205,0.6366869918699187,42.60912698412697,1029.5634920634907,25.111304684475382,0
3156,4,1,1,54,0.01818181818181818,0.01818181818181818,0.9818181818181818,55,1500,1200,300,0.8,18,12,6,322.290602741443,0.4124158249158249,0.15563703177851074,0.19631411364524926,132812.52802348757,-2439.1540583390893,130373.37396514848,3111,0,865.4,43,12,15,34.00063160312356,0.6368701550387598,42.305871212121204,1030.7765151515139,23.971546863988696,0
3157,4,0,0,54,0.0,0.0,1.0,54,1350,1200,150,0.8888888888888888,15,12,3,343.5920528278199,0.41235004658746793,0.19344740340494893,0.20559977110320599,132142.87682665663,-1706.4158949803864,130436.46093167625,3112,8,882.425925925926,41,13,16,34.124533642094434,0.6331300813008129,42.95634920634921,1028.1746031746036,25.077429345722038,3
3158,4,0,0,54,0.0,0.0,1.0,54,950,700,250,0.7368421052631579,12,7,5,342.56558769851375,0.41222629862566973,0.19082451796833944,0.20540066209777283,132219.3889853395,-1741.2374614197558,130478.15152391973,3113,9,883.425925925926,41,13,16,34.07396466351563,0.6338922764227642,42.88194444444444,1028.4722222222222,25.084688346883468,0
3159,4,1,1,54,0.01818181818181818,0.01818181818181818,0.9818181818181818,55,1300,1100,200,0.8461538461538461,15,11,4,335.5586780737529,0.4133557800224467,0.18754818706240584,0.20229745564653806,132424.80604383704,-2112.379738136549,130312.4263057005,3114,0,868.3454545454546,39,16,16,34.04777266133658,0.6391559829059827,42.68229166666668,1029.2708333333353,26.39155982905988,0
3160,4,1,1,54,0.01818181818181818,0.01818181818181818,0.9818181818181818,55,1450,1000,450,0.6896551724137931,19,10,9,335.60456900349146,0.4132996632996633,0.18219336803192743,0.20304692589770634,132558.85959201408,-2102.528211805537,130456.33138020855,3115,0,869.3272727272728,39,16,18,33.91201362195698,0.6404914529914529,42.55208333333334,1029.7916666666683,26.404914529914574,0
3161,4,1,0,55,0.01818181818181818,0.0,1.0,55,1700,1100,600,0.6470588235294118,23,11,12,336.5993077747768,0.41411335578002245,0.19318405908822034,0.20490937451691393,132790.50684942823,-2060.561463084142,130729.94538634409,3116,0,870.3090909090909,40,15,16,33.65398836521398,0.6411458333333333,42.327235772357724,1030.691056910569,25.767276422764223,0
3162,4,0,0,55,0.0,0.0,1.0,55,1200,800,400,0.6666666666666666,16,8,8,333.4197372420234,0.413692480359147,0.19374114436650514,0.20361720028752006,132908.99490583275,-2137.103568279162,130771.89133755359,3117,1,871.3090909090909,41,14,16,33.61715092040279,0.6407520325203251,42.21230158730159,1031.150793650794,25.150019357336436,0
3163,4,0,0,55,0.0,0.0,1.0,55,1300,800,500,0.6153846153846154,18,8,10,332.9939517903677,0.4140291806958474,0.1949968085199405,0.2037750510161537,132985.7285072593,-2143.3113465293586,130842.41716072995,3118,2,872.3090909090909,41,14,16,33.55124475008817,0.6415142276422765,42.13789682539682,1031.448412698412,25.157278358497855,0
3164,4,0,0,55,0.0,0.0,1.0,55,1500,900,600,0.6,21,9,12,310.7190466774706,0.4144079685746352,0.07451300234377056,0.18329827215976208,131601.4017055012,-2802.5884982452276,128798.81320725597,3119,3,873.3090909090909,42,13,14,35.513071741115,0.6262400793650794,43.483527131782935,1026.065891472866,24.430140273163477,5
3165,4,1,0,56,0.017857142857142856,0.0,1.0,56,1500,800,700,0.5333333333333333,22,8,14,310.0888954957635,0.4161255411255411,0.0774818959842003,0.18465776707623663,131959.8013157139,-3016.146192033979,128943.65512367993,3120,0,858.6964285714286,43,13,15,35.16935483870967,0.6283914728682171,43.134469696969695,1027.4621212121208,23.8944679351656,0
3166,4,0,1,55,0.0,0.017857142857142856,0.9821428571428571,56,1450,1100,350,0.7586206896551724,18,11,7,308.8852497878857,0.41590909090909095,0.07705190976335219,0.18441366893276756,132057.11680010348,-3041.900898186396,129015.21590191708,3121,1,859.6964285714286,43,13,15,35.1026503286039,0.629360465116279,43.039772727272734,1027.8409090909106,23.90327695560257,0
3167,4,0,1,54,0.0,0.01818181818181818,0.9818181818181818,55,1750,1200,550,0.6857142857142857,23,12,11,313.1443699898496,0.4151936026936027,0.08234565213751055,0.1874377932386875,132154.46815455708,-2723.314465679507,129431.15368887757,3122,2,871.2363636363636,43,12,16,34.8955455271075,0.630329457364341,42.945075757575765,1028.2196969696981,23.912085976039492,0
3168,4,0,0,54,0.0,0.0,1.0,54,1550,1000,550,0.6451612903225806,21,10,11,315.9841103331745,0.41325267877940836,0.08053434714759988,0.1888605874098394,132098.99612590892,-2451.7632466498408,129647.23287925907,3123,3,888.0370370370371,42,12,16,34.878208753574015,0.6312003968253967,42.99903100775194,1028.0038759689924,24.476282761166484,0
3169,4,0,0,54,0.0,0.0,1.0,54,1550,1200,350,0.7741935483870968,19,12,7,319.0806883752835,0.41232092941998605,0.08804669401881116,0.19159279342715005,132273.37599903863,-2358.8240265008026,129914.55197253783,3124,4,889.0370370370371,42,12,17,34.62364198693796,0.6329365079365079,42.82945736434109,1028.6821705426364,24.492432631967535,0
3170,4,0,0,54,0.0,0.0,1.0,54,1250,700,550,0.56,18,7,11,319.225428302579,0.4118477754484044,0.08917756442372249,0.19218962489551977,132373.63985200037,-2348.5936244547547,130025.04622754562,3125,5,890.0370370370371,43,11,18,34.519359068740215,0.6325096899224805,42.732007575757585,1029.0719696969716,23.931906272022594,0
3171,4,0,0,54,0.0,0.0,1.0,54,1150,700,450,0.6086956521739131,16,7,9,320.5816577151982,0.41197880270207315,0.08689513609995525,0.19326174891314232,132423.5296693908,-2309.4845838597657,130114.04508553102,3126,6,891.0370370370371,41,13,18,34.43443775100402,0.6359247967479675,42.68353174603174,1029.265873015872,25.104045683313952,0
3172,4,1,1,54,0.01818181818181818,0.01818181818181818,0.9818181818181818,55,1100,700,400,0.6363636363636364,15,7,8,316.00373095774887,0.41501122334455665,0.09303947885855002,0.19202192428598297,132722.3095441981,-2611.851000540826,130110.45854365727,3127,0,875.8181818181819,42,13,16,34.25294652372893,0.6374007936507936,42.39341085271318,1030.4263565891476,24.533960871170184,0
3173,4,0,0,54,0.0,0.0,1.0,54,1200,700,500,0.5833333333333334,17,7,10,319.8382242301738,0.41102521546703935,0.08748271453998857,0.19422272063046522,132697.3488390875,-2311.6631174508493,130385.68572163665,3128,8,893.0370370370371,42,12,16,34.179167058528485,0.6371527777777777,42.41763565891474,1030.3294573643434,24.531653746770083,0
3174,4,0,0,54,0.0,0.0,1.0,54,1200,900,300,0.75,15,9,6,316.66562135858476,0.41088690892150015,0.08515663892109027,0.19306622038017143,132847.14828022692,-2386.3750488251585,130460.77323140176,3129,9,894.0370370370371,42,12,16,34.11093617821223,0.6386408730158729,42.27228682170544,1030.9108527131812,24.54549649317098,0
3175,4,1,0,55,0.01818181818181818,0.0,1.0,55,1100,600,500,0.5454545454545454,16,6,10,313.1763319585889,0.4130611672278339,0.08860717264386975,0.19264232609190893,133178.82303145123,-2658.3089416895905,130520.51408976164,3130,0,878.7636363636364,43,12,18,33.869266055045856,0.640503875968992,41.95075757575759,1032.1969696969727,24.00458069062727,0
3176,4,0,0,55,0.0,0.0,1.0,55,1250,1000,250,0.8,15,10,5,318.32075547264753,0.41254208754208754,0.08331318319394998,0.19619283193432904,133252.1425637772,-2516.615462149887,130735.5271016273,3131,1,879.7636363636364,43,12,18,33.663231067901805,0.6412306201550386,41.87973484848486,1032.4810606060623,24.01118745595494,0
3177,4,0,0,55,0.0,0.0,1.0,55,1650,1000,650,0.6060606060606061,23,10,13,319.9050128239696,0.4118686868686869,0.08041606886657116,0.19732194153832497,133280.9327846367,-2472.5522976680195,130808.38048696869,3132,2,880.7636363636364,44,11,18,33.59356318747012,0.6401515151515151,41.85185185185186,1032.5925925925942,23.468013468013506,0
3178,4,0,0,55,0.0,0.0,1.0,55,1750,1600,150,0.9142857142857143,19,16,3,323.05708909164,0.4126543209876543,0.08334596299102892,0.19990837176901993,133400.4726080248,-2380.806327160484,131019.66628086433,3133,3,881.7636363636364,44,11,18,33.392713094917994,0.6413352272727273,41.736111111111114,1033.0555555555563,23.47853535353537,0
3179,4,0,0,55,0.0,0.0,1.0,55,1150,800,350,0.6956521739130435,15,8,7,324.8364746434244,0.4126543209876543,0.08406224406224427,0.2012742749584855,133449.3213133771,-2330.1585842009977,131119.16272917608,3134,4,882.7636363636364,46,9,18,33.2979407979408,0.6392663043478262,41.68882978723404,1033.2446808510638,22.461840888066604,0
3180,4,0,0,55,0.0,0.0,1.0,55,1050,600,450,0.5714285714285714,15,6,9,324.8895742890592,0.41299102132435467,0.08564772400073295,0.20184999848048338,133549.1182149942,-2322.246943211998,131226.8712717822,3135,5,883.7636363636364,41,14,18,33.19686390248583,0.6471036585365855,41.5922619047619,1033.6309523809514,25.21051103368174,0
3181,4,0,0,55,0.0,0.0,1.0,55,1350,1000,350,0.7407407407407407,17,10,7,325.81798353491905,0.41273849607182944,0.09858322362398364,0.20355327227792655,133754.28245661664,-2284.0898801650524,131470.19257645158,3136,6,884.7636363636364,41,14,13,32.96799574821777,0.6491361788617886,41.393849206349195,1034.424603174601,25.22986837011222,0
3182,4,0,0,55,0.0,0.0,1.0,55,1200,1000,200,0.8333333333333334,14,10,4,324.96486896450176,0.4126964085297418,0.10241628399397062,0.20387002272439222,133908.25897778073,-2296.904033604194,131611.35494417654,3137,7,885.7636363636364,41,14,14,32.836412505191866,0.650660569105691,41.24503968253968,1035.0198412698398,25.24438637243512,0
3183,4,0,1,54,0.0,0.01818181818181818,0.9818181818181818,55,1100,600,500,0.5454545454545454,16,6,10,326.18244679343695,0.41255611672278336,0.104774099140297,0.2052059190586558,134010.95920138876,-2257.5954861111213,131753.36371527764,3138,8,886.7636363636364,41,14,14,32.70246478873239,0.6516768292682926,41.14583333333333,1035.4166666666656,25.25406504065038,0
3184,4,0,0,54,0.0,0.0,1.0,54,1300,900,400,0.6923076923076923,17,9,8,332.80684741907675,0.41229909154437455,0.10353717157172837,0.20899941725096913,133945.2014756429,-1884.423953995635,132060.77752164728,3139,9,901.074074074074,40,14,14,32.59661954316381,0.6526041666666667,41.209349593495936,1035.162601626017,25.879065040650424,0
3185,4,0,1,53,0.0,0.018518518518518517,0.9814814814814815,54,1250,700,550,0.56,18,7,11,330.3044071001955,0.41178954111344046,0.11098870687911755,0.20808978308502932,134062.3240760422,-1943.7247063177435,132118.59936972446,3140,10,902.074074074074,41,13,14,32.54452453938754,0.6521849593495936,41.096230158730144,1035.6150793650772,25.258904374757982,0
3186,4,0,2,51,0.0,0.03773584905660377,0.9622641509433962,53,1250,900,350,0.72,16,9,7,334.1951456465831,0.40925858732462506,0.11720001407363112,0.21032207158696928,134024.11268300927,-1641.9584283495428,132382.15425465972,3141,11,919.2641509433962,40,13,15,32.48192495174534,0.6533854166666667,41.133130081300806,1035.4674796747954,25.886686991869887,0
3187,4,0,0,51,0.0,0.0,1.0,51,1500,1000,500,0.6666666666666666,20,10,10,340.5836595421757,0.40514705882352936,0.12368764509534391,0.21388317855096198,133945.20147564288,-1076.0906206623022,132869.1108549806,3142,22,953.0,40,11,15,32.39536291642122,0.6526041666666667,41.209349593495936,1035.1626016260168,25.87906504065042,0
3188,4,0,0,51,0.0,0.0,1.0,51,800,400,400,0.5,12,4,8,342.51999063909403,0.40477124183006535,0.12655236775770207,0.21571561833203742,134050.42158272176,-1017.0101708639148,133033.41141185784,3143,23,954.0,40,11,16,32.2401455675499,0.6536458333333334,41.10772357723577,1035.5691056910557,25.889227642276392,0
3189,4,0,0,51,0.0,0.0,1.0,51,1150,600,550,0.5217391304347826,17,6,11,345.0182101977108,0.40477124183006535,0.12571157495256213,0.21391129032258074,133472.22222222228,-989.9305555555447,132482.29166666674,3144,24,955.0,40,11,17,32.75369623655915,0.6479166666666667,41.66666666666667,1033.333333333334,25.83333333333335,1
3190,4,0,0,51,0.0,0.0,1.0,51,1200,900,300,0.75,15,9,6,345.9207347596934,0.4046078431372549,0.12620729242057505,0.21512801367509113,133585.55036164934,-957.9976531240782,132627.55270852527,3145,25,956.0,37,14,17,32.6169389053882,0.6542792792792795,41.55701754385963,1033.7719298245581,27.939781887150218,0
3191,4,0,1,50,0.0,0.0196078431372549,0.9803921568627451,51,750,300,450,0.4,12,3,9,345.66921076099123,0.4043627450980392,0.12945750940885437,0.215301232329996,133642.2324657583,-960.798995844912,132681.4334699134,3146,26,957.0,37,14,19,32.56671968893603,0.6548423423423425,41.50219298245612,1033.9912280701724,27.945708866761414,0
3192,4,0,0,50,0.0,0.0,1.0,50,1450,1100,350,0.7586206896551724,18,11,7,350.25343044695256,0.4028656462585034,0.1325291498834007,0.218827209459374,133755.63274276687,-630.3261580486436,133125.30658471823,3147,27,973.14,37,13,16,32.33472899441735,0.6559684684684686,41.392543859649116,1034.4298245614025,27.95756282598385,0
3193,4,0,0,50,0.0,0.0,1.0,50,1450,1200,250,0.8275862068965517,17,12,5,351.1232517763178,0.4028656462585034,0.13737232464505245,0.22004656376260867,133869.0811114958,-599.0905855647945,133269.990525931,3148,28,974.14,37,13,17,32.19873560782652,0.6570945945945945,41.2828947368421,1034.868421052631,27.969416785206242,0
3194,4,0,2,48,0.0,0.04,0.96,50,1300,900,400,0.6923076923076923,17,9,8,348.4388502205026,0.4025340136054422,0.13553578991952642,0.21937710009882827,134039.34383656498,-659.0970298553473,133380.24680670962,3149,29,975.14,37,13,17,32.09798108146266,0.6587837837837838,41.118421052631575,1035.5263157894726,27.9871977240398,0
3195,4,0,1,47,0.0,0.020833333333333332,0.9791666666666666,48,900,500,400,0.5555555555555556,13,5,8,355.35151747259783,0.40172502955082745,0.15124126614440003,0.22407546288692642,134096.12212411506,-69.74790320098793,134026.37422091406,3150,30,1010.5416666666666,37,11,18,31.86225209965419,0.6593468468468469,41.06359649122807,1035.7456140350873,27.99312470365101,0
3196,4,0,0,47,0.0,0.0,1.0,47,1100,800,300,0.7272727272727273,14,8,6,354.26465028355364,0.4012488436632748,0.1452867715078634,0.2238485427615864,134171.333495658,106.43210778348072,134277.76560344148,3151,31,1024.6170212765958,36,11,18,31.81521739130434,0.662037037037037,40.990990990991,1036.0360360360376,28.778778778778822,0
3197,4,0,0,47,0.0,0.0,1.0,47,1050,700,350,0.6666666666666666,14,7,7,348.32954548911897,0.4012295713845205,0.15122881446722847,0.21754165954131746,133741.45507812485,-74.85394759203103,133666.60113053283,3152,32,1025.6170212765958,35,12,16,32.39866565961732,0.6598214285714286,41.40624999999999,1034.3749999999989,29.553571428571395,2
3198,4,0,0,47,0.0,0.0,1.0,47,1250,900,350,0.72,16,9,7,345.7320430377439,0.4004394079555967,0.1478017271317109,0.2167310692712732,133879.8152037171,-142.69159362066387,133737.12361009643,3153,33,1026.6170212765958,36,11,17,32.32748458469349,0.6591435185185186,41.272522522522515,1034.909909909909,28.74749749749747,0
3199,4,0,0,47,0.0,0.0,1.0,47,950,600,350,0.631578947368421,13,6,7,348.48014724681906,0.4004972247918594,0.15569821206244638,0.21914681763250704,133996.38447569183,-60.9840414739117,133935.4004342179,3154,34,1027.6170212765958,36,11,18,32.13984663911248,0.6603009259259259,41.159909909909906,1035.3603603603597,28.760010010009992,0
3200,4,0,0,47,0.0,0.0,1.0,47,1050,800,250,0.7619047619047619,13,8,5,348.82712778084385,0.40020814061054577,0.1558772084069857,0.2197133059638795,134054.68813408003,-47.61763452641986,134007.0704995536,3155,35,1028.6170212765958,36,11,18,32.07259496882703,0.6608796296296295,41.1036036036036,1035.5855855855855,28.766266266266264,0
3201,4,0,0,47,0.0,0.0,1.0,47,1100,1000,100,0.9090909090909091,12,10,2,349.47256309345096,0.4001117792167746,0.1590481632539753,0.22029466502881898,134083.84471887434,-28.275023334137472,134055.5696955402,3156,36,1029.6170212765958,36,11,18,32.026747852560625,0.6611689814814814,41.075450450450454,1035.6981981981987,28.76939439439441,0
3202,4,0,0,47,0.0,0.0,1.0,47,1000,400,600,0.4,16,4,12,347.45751029310884,0.40001541782300337,0.15982462607962966,0.21933255337252475,134135.4372123601,-78.72698882316422,134056.71022353694,3157,37,1030.6170212765958,38,9,18,32.027382425742566,0.6578947368421053,41.025641025641015,1035.8974358974342,27.260458839406162,0
3203,4,0,0,47,0.0,0.0,1.0,47,1300,800,500,0.6153846153846154,18,8,10,345.60133155415434,0.39959142769041006,0.15180462900827685,0.2191519031855166,134301.497781065,-117.04470742932699,134184.45307363567,3158,38,1031.6170212765958,38,9,20,31.909657802514953,0.6595394736842106,40.86538461538461,1036.538461538461,27.277327935222658,0
3204,4,0,0,47,0.0,0.0,1.0,47,1250,800,450,0.64,17,8,9,343.76589726842025,0.3990903484427999,0.15210595770986113,0.21864952810532673,134412.2618982394,-158.72963693477197,134253.53226130464,3159,39,1032.6170212765958,38,9,20,31.84670993886942,0.6606359649122808,40.758547008547005,1036.9658119658116,27.288573999100304,0
3205,4,0,0,47,0.0,0.0,1.0,47,750,500,250,0.6666666666666666,10,5,5,341.6711544284394,0.3986663583102066,0.14782714608988878,0.21765960874241647,134469.73876953122,-211.11382378472217,134258.6249457465,3160,40,1033.6170212765958,39,8,20,31.84369873790633,0.6594551282051282,40.703125,1037.1874999999998,26.594551282051277,0
3206,4,0,0,47,0.0,0.0,1.0,47,1200,800,400,0.6666666666666666,16,8,8,340.81724059697785,0.3971245760098674,0.15035910577603961,0.2181092077248409,134636.11549948066,-222.68929802919558,134413.42620145145,3161,41,1034.6170212765958,37,10,21,31.700013206550448,0.6646959459459458,40.54276315789474,1037.8289473684215,28.04943100995734,0
3207,4,0,0,47,0.0,0.0,1.0,47,1950,1500,450,0.7692307692307693,24,15,9,340.12141760637314,0.3976449275362319,0.14607892466935013,0.2188607382858401,134835.33394890733,-227.92301477378476,134607.41093413354,3162,42,1035.6170212765958,37,10,16,31.519654420045022,0.6666666666666667,40.35087719298245,1038.59649122807,28.070175438596483,0
3208,4,0,0,47,0.0,0.0,1.0,47,1550,1300,250,0.8387096774193549,18,13,5,345.88786729446986,0.39783765032377433,0.15177619275334053,0.22344780629513894,134977.7230133309,-62.56865093106944,134915.15436239983,3163,43,1036.6170212765958,37,10,17,31.228126868558956,0.6680743243243243,40.21381578947368,1039.1447368421043,28.08499288762444,0
3209,4,0,0,47,0.0,0.0,1.0,47,1150,700,450,0.6086956521739131,16,7,9,345.7403603998259,0.3972787542399013,0.15339347820859595,0.22448905455446952,135161.1139076079,-53.869553108372656,135107.24435449953,3164,44,1037.6170212765958,38,9,18,31.049436624541936,0.6680372807017545,40.037393162393144,1039.8504273504243,27.364484930274322,0
3210,4,0,0,47,0.0,0.0,1.0,47,1250,1200,50,0.96,13,12,1,350.5697850805972,0.3973558433549183,0.15492997755873095,0.2283276252394497,135272.23186728384,84.47145061727286,135356.70331790112,3165,45,1038.6170212765958,38,9,19,30.813306631063636,0.6691337719298246,39.93055555555555,1040.277777777777,27.375730994152025,0
3211,4,0,0,47,0.0,0.0,1.0,47,1350,900,450,0.6666666666666666,18,9,9,348.7072956563634,0.39720166512488436,0.1518202435731053,0.2272899360844486,135300.0184911241,36.020710059156386,135336.03920118324,3166,46,1039.6170212765958,38,9,19,30.834103512014778,0.6694078947368423,39.903846153846146,1040.384615384614,27.378542510121424,0
3212,4,0,0,47,0.0,0.0,1.0,47,1550,1400,150,0.9032258064516129,17,14,3,347.93220984052545,0.3961802343509096,0.14377589147473047,0.2276630974127762,135438.99441385415,24.71772499816592,135463.7121388523,3167,47,1040.6170212765958,38,9,20,30.716069656847647,0.6707785087719298,39.77029914529914,1040.918803418803,27.3926000899685,0
3213,4,0,0,47,0.0,0.0,1.0,47,900,400,500,0.4444444444444444,14,4,10,346.3290691238093,0.39658495220474865,0.13816362481418198,0.22731780718853667,135550.2265162722,-11.003246219588334,135539.2232700526,3168,48,1041.6170212765958,38,9,20,30.647250436031605,0.671875,39.66346153846154,1041.346153846154,27.40384615384616,0
3214,4,0,0,47,0.0,0.0,1.0,47,1300,1000,300,0.7692307692307693,16,10,6,345.5850135468593,0.3961031452358927,0.14114177375184345,0.22718636097666312,135606.55517578125,-27.281358506944116,135579.2738172743,3169,49,1042.6170212765958,39,8,20,30.610665233189987,0.6706730769230769,39.609375,1041.5625,26.70673076923077,0
3215,4,0,0,47,0.0,0.0,1.0,47,1500,1100,400,0.7333333333333333,19,11,8,354.1129984950425,0.39637295713845205,0.1464847954157411,0.22158724263540427,133813.7344359343,81.599265199493,133895.33370113382,3170,50,1043.6170212765958,40,7,18,32.17676718069606,0.6513020833333334,41.33638211382114,1034.6544715447155,25.866361788617887,6
3216,4,0,1,46,0.0,0.02127659574468085,0.9787234042553191,47,1150,800,350,0.6956521739130435,15,8,7,355.6608072084451,0.39658495220474865,0.15323829243984055,0.2228734769109904,133866.31350593225,122.20022390771976,133988.51372983996,3171,51,1044.6170212765958,40,7,18,32.08411077285672,0.6518229166666667,41.28556910569105,1034.8577235772352,25.87144308943088,0
3217,4,0,0,46,0.0,0.0,1.0,46,1250,800,450,0.64,17,8,9,357.13433754158086,0.3959138486312399,0.15846509226771177,0.22434899156057056,133957.03667534704,368.1315104166481,134325.1681857637,3172,52,1064.5652173913043,39,7,18,31.95520560810357,0.654380341880342,41.19791666666666,1035.208333333332,26.543803418803382,0
3218,4,0,0,46,0.0,0.0,1.0,46,750,400,350,0.5333333333333333,11,4,7,357.9779101457416,0.396256038647343,0.16034987335791784,0.22504379816182943,133983.99658203113,392.6622178819316,134376.65879991307,3173,53,1065.5652173913043,39,7,18,31.906399872555912,0.6546474358974359,41.17187499999999,1035.312499999999,26.546474358974336,0
3219,4,0,0,46,0.0,0.0,1.0,46,1050,500,550,0.47619047619047616,16,5,11,335.9728880243847,0.3962962962962963,0.10386938120012745,0.20545730258244113,132960.14817964204,-265.79900478711784,132694.34917485493,3174,54,1066.5652173913043,41,5,17,33.50006412722841,0.6412601626016261,42.162698412698404,1031.349206349205,25.154858691444023,4
3220,4,0,0,46,0.0,0.0,1.0,46,1600,1500,100,0.9375,17,15,2,338.5387891292261,0.39606481481481487,0.1035461407923226,0.2078796035727395,133113.66705246904,-187.17206790124095,132926.4949845678,3175,55,1067.5652173913043,41,5,17,33.28005832211754,0.6427845528455285,42.013888888888886,1031.944444444444,25.169376693766925,0
3221,4,0,0,46,0.0,0.0,1.0,46,1200,800,400,0.6666666666666666,16,8,8,340.4870669460788,0.39556159420289855,0.10374962403502308,0.20994012990371966,133267.2745023935,-124.84331695642186,133142.43118543708,3176,56,1068.5652173913043,41,5,17,33.07591916474506,0.6443089430894309,41.86507936507936,1032.539682539682,25.183894696089805,0
3222,4,1,2,45,0.02127659574468085,0.0425531914893617,0.9574468085106383,47,1150,800,350,0.6956521739130435,15,8,7,336.4538188810769,0.3986663583102066,0.11113969981857164,0.20906812444922407,133555.03420857986,-412.3498603638288,133142.68434821605,3177,0,1046.8085106382978,38,9,17,32.892118863049085,0.6521381578947368,41.58653846153846,1033.653846153846,27.20141700404858,0
3223,4,0,0,45,0.0,0.0,1.0,45,800,400,400,0.5,12,4,8,349.46673004189194,0.393939393939394,0.10981095419562137,0.21562532264410514,133292.8843557099,316.2856867283965,133609.1700424383,3178,58,1091.0,41,4,17,32.81845438242547,0.6445630081300813,41.84027777777778,1032.638888888889,25.186314363143634,0
3224,4,0,0,45,0.0,0.0,1.0,45,1200,800,400,0.6666666666666666,16,8,8,349.8062432928853,0.39387626262626263,0.10425429751272453,0.21643092165233613,133395.34837372453,332.50513747165934,133727.85351119618,3179,59,1092.0,41,4,17,32.70701286852973,0.6455792682926829,41.74107142857143,1033.0357142857147,25.195993031358896,0
3225,4,0,1,44,0.0,0.022222222222222223,0.9777777777777777,45,950,700,250,0.7368421052631579,12,7,5,350.0908181794923,0.3939604377104377,0.10936363151437556,0.21690635760496216,133446.59514558152,343.6855355568284,133790.28068113836,3180,60,1093.0,41,4,17,32.64832373179708,0.6460873983739837,41.69146825396826,1033.2341269841281,25.20083236546654,0
3226,4,0,0,44,0.0,0.0,1.0,44,1150,800,350,0.6956521739130435,15,8,7,351.1966701352755,0.39506254404510216,0.11253665689149561,0.2177419354838711,133472.22222222245,575.0000000000241,134047.22222222248,3181,61,1109.5227272727273,40,4,17,32.59408602150538,0.6479166666666666,41.66666666666668,1033.333333333335,25.83333333333338,0
3227,4,1,1,44,0.022222222222222223,0.022222222222222223,0.9777777777777777,45,1650,1300,350,0.7878787878787878,20,13,7,341.5958385019818,0.3962962962962963,0.11158913496520784,0.21391107683763783,133840.7145107148,143.88621979839326,133984.6007305132,3182,0,1085.8444444444444,37,8,16,32.47357475892761,0.6568130630630631,41.310307017543856,1034.7587719298242,27.966453295400655,0
3228,4,1,0,45,0.022222222222222223,0.0,1.0,45,1350,1000,350,0.7407407407407407,17,10,7,355.5590765052058,0.396969696969697,0.07730496453900737,0.21646731341638187,132793.2633117883,567.998085949527,133361.26139773784,3183,0,1086.8222222222223,37,8,17,33.16267730496453,0.6463963963963963,42.324561403508774,1030.7017543859654,27.85680417259366,8
3229,4,0,0,45,0.0,0.0,1.0,45,1300,1100,200,0.8461538461538461,15,11,4,354.9339848049616,0.39675925925925926,0.08262982153137677,0.2165052435757191,132865.71905361954,431.7118215355287,133297.43087515506,3184,1,1087.8222222222223,38,7,17,33.10600172711572,0.6452850877192983,42.2542735042735,1030.9829059829049,27.131129104813287,0
3230,4,0,0,45,0.0,0.0,1.0,45,1250,900,350,0.72,16,9,7,353.41895675173333,0.3968644781144781,0.09143857522809151,0.21613348306355218,132961.4271375867,398.2177734374901,133359.6449110242,3185,2,1088.8222222222223,39,6,17,33.04895549271117,0.6444978632478633,42.16145833333333,1031.3541666666658,26.444978632478612,0
3231,4,0,0,45,0.0,0.0,1.0,45,1400,1100,300,0.7857142857142857,17,11,6,363.8914192448872,0.39692760942760946,0.08752122140304652,0.21486812572321104,131637.38031173035,582.3011798101138,132219.68149154045,3186,3,1089.8222222222223,37,8,17,34.11277469102823,0.6348536036036037,43.44846491228069,1026.2061403508758,27.73530109056421,2
3232,4,0,0,45,0.0,0.0,1.0,45,1750,1300,450,0.7428571428571429,22,13,9,360.42801924978335,0.39572811447811446,0.08378468971416053,0.21400831062681672,131848.8056674152,504.40077343119856,132353.2064408464,3187,4,1090.8222222222223,38,7,18,33.98826242241409,0.6351425438596492,43.242521367521356,1027.0299145299127,27.027103013945073,0
3233,4,0,0,45,0.0,0.0,1.0,45,1650,1300,350,0.7878787878787878,20,13,7,357.6812010212631,0.39537037037037037,0.08224787124651933,0.2129919572892557,131958.55391418256,439.8188098107559,132398.37272399332,3188,5,1091.8222222222223,38,7,18,33.94813004748535,0.6362390350877194,43.13568376068374,1027.457264957262,27.038349077822684,0
3234,4,0,0,45,0.0,0.0,1.0,45,600,200,400,0.3333333333333333,10,2,8,355.2712542699607,0.39551767676767674,0.08643541139642608,0.21186324828411304,132013.44515897767,380.1164484257078,132393.5616074034,3189,6,1092.8222222222223,38,7,18,33.95471635998197,0.6367872807017545,43.08226495726494,1027.6709401709375,27.043972109761512,0
3235,4,0,0,45,0.0,0.0,1.0,45,950,700,250,0.7368421052631579,12,7,5,354.3018055731627,0.3950126262626263,0.0847322142286171,0.2117870696063924,132103.35422091998,360.8913845485918,132464.24560546858,3190,7,1093.8222222222223,39,6,18,33.88905073124598,0.6359508547008548,42.99479166666666,1028.020833333332,26.35950854700851,0
3236,4,0,0,45,0.0,0.0,1.0,45,1350,1000,350,0.7407407407407407,17,10,7,356.0580524392128,0.39425505050505055,0.08792690694252259,0.2131713239396424,132162.78029777252,411.52443155529375,132574.30472932782,3191,8,1094.8222222222223,40,5,18,33.78405646702246,0.6348958333333332,42.9369918699187,1028.2520325203254,25.706300813008134,0
3237,4,0,0,45,0.0,0.0,1.0,45,900,700,200,0.7777777777777778,11,7,4,355.1869723446391,0.39408670033670035,0.09076836939696409,0.21309112905157618,132241.16478493283,394.06778785775555,132635.23257279058,3192,9,1095.8222222222223,40,5,19,33.72752198399368,0.6356770833333334,42.860772357723576,1028.5569105691052,25.71392276422763,0
3238,4,0,0,45,0.0,0.0,1.0,45,1450,1200,250,0.8275862068965517,17,12,5,354.3981536899866,0.3938973063973064,0.08971067347434958,0.21366748843842198,132426.97934420907,386.74719816444957,132813.72654237354,3193,10,1096.8222222222223,36,9,19,33.56081327498176,0.6446759259259259,42.68018018018018,1029.2792792792793,28.59109109109109,0
3239,4,0,0,45,0.0,0.0,1.0,45,750,500,250,0.6666666666666666,10,5,5,354.9047635614407,0.39391835016835014,0.08909309703533541,0.21413758704390298,132455.95838659603,401.8501186997763,132857.8085052958,3194,11,1097.8222222222223,36,9,19,33.51862487692812,0.6449652777777779,42.652027027027025,1029.3918918918916,28.594219219219212,0
3240,4,0,0,45,0.0,0.0,1.0,45,800,600,200,0.75,10,6,4,350.07809794881854,0.39406565656565656,0.08814184593391894,0.21167206449377104,132535.4812714587,279.5538388486936,132815.0351103074,3195,12,1098.8222222222223,38,7,19,33.562893408037624,0.6419956140350878,42.57478632478632,1029.7008547008536,27.09739091318036,0
3241,4,0,0,45,0.0,0.0,1.0,45,1200,1000,200,0.8333333333333334,14,10,4,351.5753860987244,0.3937079124579124,0.08931765790686974,0.2128886131904334,132590.49236613332,323.11070932864766,132913.60307546196,3196,13,1099.8222222222223,38,7,19,33.46905255878285,0.6425438596491229,42.521367521367516,1029.914529914529,27.103013945119187,0
3242,4,0,0,45,0.0,0.0,1.0,45,1250,1000,250,0.8,15,10,5,353.75778985584446,0.3938131313131313,0.08764421078646101,0.21479547571910118,132692.98095703128,388.2351345486119,133081.2160915799,3197,14,1100.8222222222223,39,6,14,33.309848178478745,0.6418269230769231,42.421875,1030.3125000000002,26.418269230769237,0
3243,4,0,2,43,0.0,0.044444444444444446,0.9555555555555556,45,900,700,200,0.7777777777777778,11,7,4,352.9418833125719,0.39358164983164984,0.08954622143342328,0.2148581380886018,132790.50684942823,373.46631469363695,133163.97316412188,3198,15,1101.8222222222223,40,5,14,33.23288470387171,0.6411458333333333,42.327235772357724,1030.691056910569,25.767276422764223,0
3244,4,0,0,43,0.0,0.0,1.0,43,900,500,400,0.5555555555555556,13,5,8,351.95605573008737,0.39271871539313397,0.08984634761297139,0.2146216317659072,132854.01611328128,751.75509982639,133605.77121310766,3199,16,1109.3953488372092,39,4,14,33.19450759489406,0.6434294871794872,42.265625,1030.9375000000002,26.43429487179488,0
3245,4,0,0,43,0.0,0.0,1.0,43,1150,1000,150,0.8695652173913043,13,10,3,351.629707736691,0.39258028792912514,0.08872536329334024,0.21541298510773377,133026.28772762566,755.1989349923903,133781.48666261806,3200,17,1110.3953488372092,40,3,15,33.029997044626136,0.6434895833333334,42.09857723577235,1031.60569105691,25.79014227642275,0
3246,4,0,0,43,0.0,0.0,1.0,43,1350,900,450,0.6666666666666666,18,9,9,349.4330767112468,0.39248800295311925,0.085941900700089,0.21486416844585135,133164.85969387725,706.4413265305856,133871.30102040785,3201,18,1111.3953488372092,41,2,15,32.94766435986159,0.6432926829268294,41.9642857142857,1032.1428571428548,25.174216027874508,0
3247,4,0,0,43,0.0,0.0,1.0,43,1050,800,250,0.7619047619047619,13,8,5,348.55813052161824,0.39204964931709113,0.08630977656003469,0.2146210595389323,133216.06217718552,686.7083175862758,133902.7704947718,3202,19,1112.3953488372092,41,2,15,32.91890896277787,0.6438008130081301,41.91468253968253,1032.3412698412685,25.179055361982158,0
3248,4,0,0,43,0.0,0.0,1.0,43,850,700,150,0.8235294117647058,10,7,3,347.13175487273077,0.39202657807308966,0.08865231586074684,0.21388988590648345,133241.66710955207,650.4827451813994,133892.14985473346,3203,20,1113.3953488372092,41,2,15,32.93005909484001,0.6440548780487805,41.88988095238095,1032.4404761904757,25.181475029035994,0
3249,4,0,0,43,0.0,0.0,1.0,43,1000,700,300,0.7,13,7,6,348.5047652936321,0.39158822443706165,0.08262480486154367,0.21562567563889443,133395.34837372456,697.7829152494378,134093.131288974,3204,21,1114.3953488372092,41,2,16,32.74062469989434,0.6455792682926829,41.74107142857143,1033.035714285715,25.1959930313589,0
3250,4,0,0,43,0.0,0.0,1.0,43,950,700,250,0.7368421052631579,12,7,5,350.09081817949243,0.3915651531930602,0.08280543491609804,0.21690635760496216,133446.59514558138,743.6855355568136,134190.2806811382,3205,22,1115.3953488372092,41,2,17,32.648323731797085,0.6460873983739838,41.69146825396825,1033.234126984127,25.20083236546651,0
3251,4,0,0,43,0.0,0.0,1.0,43,1150,900,250,0.782608695652174,14,9,5,350.5833710968124,0.3916112956810631,0.08686358245477499,0.2176776100139285,133526.04709201408,762.4072646998819,134288.45435671395,3206,23,1116.3953488372092,39,4,18,32.55602029160787,0.6501068376068375,41.61458333333334,1033.5416666666683,26.501068376068417,0
3252,4,0,0,43,0.0,0.0,1.0,43,650,400,250,0.6153846153846154,9,4,5,347.97759011223945,0.39188815060908083,0.08859469275379284,0.21653150983473238,133606.80474175367,698.4347873264085,134305.23952908008,3207,24,1117.3953488372092,39,4,18,32.542506297229224,0.6509081196581196,41.53645833333334,1033.8541666666683,26.50908119658124,0
3253,4,0,0,43,0.0,0.0,1.0,43,1150,800,350,0.6956521739130435,15,8,7,347.5292970664787,0.3906653746770026,0.09165072011280095,0.2168836197720345,133714.51958550356,693.9425998263995,134408.46218532996,3208,25,1118.3953488372092,39,4,13,32.4463062745493,0.6519764957264957,41.43229166666667,1034.2708333333342,26.51976495726498,0
3254,4,0,0,43,0.0,0.0,1.0,43,1250,900,350,0.72,16,9,7,345.0003107844998,0.39059616094499816,0.08918154700725833,0.21603894000047844,133840.02267995258,634.9698839976388,134474.99256395022,3209,26,1119.3953488372092,40,3,14,32.38619622863877,0.6515624999999999,41.310975609756106,1034.756097560977,25.868902439024424,0
3255,4,0,0,43,0.0,0.0,1.0,43,1650,1400,250,0.8484848484848485,19,14,5,348.6136963434994,0.3904808047249908,0.09294301723792064,0.21885892344452906,133933.93034297053,738.2405045351477,134672.17084750568,3210,27,1120.3953488372092,41,2,14,32.19882116158711,0.6509146341463414,41.220238095238095,1035.1190476190477,25.24680603948897,0
3256,4,0,2,41,0.0,0.046511627906976744,0.9534883720930233,43,1050,600,450,0.5714285714285714,15,6,9,349.4575089523037,0.3895810262089332,0.09348667881666728,0.22000226046104623,134036.64040847824,768.0220930965006,134804.66250157473,3211,28,1121.3953488372092,41,2,15,32.07431180941432,0.651930894308943,41.12103174603175,1035.5158730158732,25.256484707704224,0
3257,4,0,0,41,0.0,0.0,1.0,41,750,400,350,0.5333333333333333,11,4,7,359.0783688006311,0.38805894308943084,0.10129142144711878,0.2255702167598403,133957.03667534728,1420.2148437500105,135377.25151909728,3212,29,1160.2439024390244,39,2,16,31.904893674112838,0.6543803418803419,41.19791666666667,1035.208333333334,26.543803418803435,0
3258,4,0,1,40,0.0,0.024390243902439025,0.975609756097561,41,1450,1100,350,0.7586206896551724,18,11,7,359.1536579098786,0.38772865853658534,0.09657987167160509,0.22661319633602992,134118.8368055555,1433.8541666666624,135552.69097222216,3213,30,1161.2439024390244,39,2,18,31.741083400375423,0.6559829059829061,41.041666666666664,1035.833333333333,26.559829059829053,0
3259,4,0,0,40,0.0,0.0,1.0,40,1000,700,300,0.7,13,7,6,357.0977607887513,0.3860977564102564,0.09122436670687595,0.2259801860258586,134226.7578125,1586.4149305555559,135813.17274305556,3214,31,1169.125,39,1,18,31.686436134566403,0.6570512820512822,40.9375,1036.25,26.57051282051282,0
3260,4,0,0,40,0.0,0.0,1.0,40,1000,600,400,0.6,14,6,8,356.56357423866865,0.3862980769230769,0.08982058498341572,0.22580846595165585,134253.74484592004,1573.999023437491,135827.74386935754,3215,32,1170.125,39,1,18,31.67330468723825,0.6573183760683762,40.91145833333333,1036.3541666666658,26.57318376068374,0
3261,4,0,0,40,0.0,0.0,1.0,40,1200,800,400,0.6666666666666666,16,8,8,360.0820917897873,0.38608440170940167,0.09666398713826396,0.22854189907474243,134334.72222222213,1674.3055555555468,136009.02777777766,3216,33,1171.125,39,1,19,31.501205787781345,0.6581196581196582,40.83333333333333,1036.6666666666658,26.58119658119656,0
3262,4,0,0,40,0.0,0.0,1.0,40,1050,700,350,0.6666666666666666,14,7,7,361.31497673733924,0.3852297008547008,0.09446564885496223,0.23000331895121134,134442.73003472204,1715.2343749999814,136157.96440972202,3217,34,1172.125,39,1,19,31.361323155216283,0.6591880341880343,40.72916666666666,1037.083333333332,26.591880341880305,0
3263,4,0,0,40,0.0,0.0,1.0,40,750,500,250,0.6666666666666666,10,5,5,363.70381122885146,0.3848023504273504,0.09427710843373549,0.2322108948614971,134550.78124999974,1787.3697916666374,136338.15104166637,3218,35,1173.125,38,2,19,31.191432396251674,0.6620065789473686,40.624999999999986,1037.499999999998,27.302631578947313,0
3264,4,1,0,41,0.024390243902439025,0.0,1.0,41,350,200,150,0.5714285714285714,5,2,3,357.12353367050684,0.38838922764227646,0.09814822064753548,0.22936903245023244,134767.01388888873,1425.6944444444255,136192.70833333317,3219,0,1145.4878048780488,39,2,20,31.146334938469767,0.6623931623931625,40.41666666666666,1038.333333333332,26.623931623931586,0
3265,4,0,0,41,0.0,0.0,1.0,41,750,500,250,0.6666666666666666,10,5,5,357.0088399602017,0.3883638211382114,0.09442963035447782,0.22963729899375532,134821.09917534704,1426.464843749976,136247.56401909702,3220,1,1146.4878048780488,39,2,17,31.09536944165829,0.6629273504273505,40.36458333333332,1038.5416666666652,26.629273504273467,0
3266,4,0,0,41,0.0,0.0,1.0,41,950,800,150,0.8421052631578947,11,8,3,358.6107517001594,0.3875762195121952,0.09599593088371217,0.23135728573463055,134929.30230034716,1477.4197048611068,136406.72200520826,3221,2,1147.4878048780488,39,2,17,30.945875944121386,0.6639957264957266,40.260416666666664,1038.958333333333,26.639957264957257,0
3267,4,0,0,41,0.0,0.0,1.0,41,1450,1100,350,0.7586206896551724,18,11,7,357.79925676282176,0.3875762195121952,0.11764467035992832,0.21214118795481032,131793.94866544288,1234.8229103887988,133028.77157583166,3222,3,1148.4878048780488,38,3,15,34.11108798945653,0.6345942982456141,43.29594017094016,1026.816239316238,27.02147998200626,6
3268,4,1,1,41,0.023809523809523808,0.023809523809523808,0.9761904761904762,42,750,500,250,0.6666666666666666,10,5,5,381.4171539419075,0.3905705574912892,0.16935058416181414,0.2153026885366068,129899.05698147502,1511.9079770871913,131410.96495856222,3223,0,1122.1190476190477,37,5,16,35.427534867878535,0.6173986486486487,45.14802631578947,1019.4078947368417,27.551564722617343,6
3269,4,1,0,42,0.023809523809523808,0.0,1.0,42,1050,600,450,0.5714285714285714,15,6,9,383.52762758431015,0.39404277971351137,0.17745335830442177,0.2178942675396576,130150.67737188366,1583.276104185906,131733.95347606958,3224,0,1116.9761904761904,37,5,17,35.11757647395945,0.6199324324324323,44.901315789473685,1020.3947368421054,27.578236130867715,0
3270,4,0,0,42,0.0,0.0,1.0,42,1550,1100,450,0.7096774193548387,20,11,9,387.8044930893632,0.3939822880371661,0.180013546750168,0.22130400114620546,130323.35778061222,1708.1410155243955,132031.4987961366,3225,1,1117.9761904761904,34,8,17,34.832740663013475,0.6277573529411764,44.732142857142854,1021.0714285714284,30.031512605042014,0
3271,4,1,1,42,0.023255813953488372,0.023255813953488372,0.9767441860465116,43,1100,800,300,0.7272727272727273,14,8,6,379.06870274102096,0.3986480251015135,0.1781471183013148,0.21796450407608703,130617.28395061723,1302.584876543208,131919.86882716045,3226,0,1092.953488372093,35,8,16,34.75713315217393,0.6285714285714286,44.44444444444444,1022.2222222222218,29.206349206349195,0
3272,4,1,0,43,0.023255813953488372,0.0,1.0,43,900,500,400,0.5555555555555556,13,5,8,377.68612813215265,0.39597176079734214,0.1868440532059925,0.2184866250217678,130850.9003371229,1284.1139821868226,132135.01431930973,3227,0,1093.9302325581396,37,6,18,34.55540224341801,0.6269707207207207,44.21600877192982,1023.1359649122802,27.652323376007573,0
3273,4,1,0,44,0.022727272727272728,0.0,1.0,44,900,600,300,0.6666666666666666,12,6,6,370.7709631524662,0.3970886187455955,0.1875705116658295,0.21639213424643933,131191.27498584634,928.3830767404577,132119.6580625868,3228,0,1070.0454545454545,38,6,19,34.38749261306359,0.628563596491228,43.88354700854701,1024.4658119658122,26.95962663067927,0
3274,4,0,0,44,0.0,0.0,1.0,44,950,600,350,0.631578947368421,13,6,7,372.23561156938797,0.39695648343904155,0.1843228954859697,0.21741742728007749,131221.37586805577,969.0538194444707,132190.42968750023,3229,1,1071.0454545454545,39,5,19,34.31950657448829,0.6271367521367521,43.85416666666668,1024.583333333335,26.271367521367566,0
3275,4,1,0,45,0.022222222222222223,0.0,1.0,45,1100,800,300,0.7272727272727273,14,8,6,368.177710188804,0.4005050505050505,0.20151725611710702,0.21739906559350256,131637.38031173043,693.3200600184621,132330.70037174888,3230,0,1048.2222222222222,37,8,17,34.00280923887881,0.6348536036036037,43.4484649122807,1026.2061403508765,27.735301090564228,0
3276,4,1,1,45,0.021739130434782608,0.021739130434782608,0.9782608695652174,46,1600,1100,500,0.6875,21,11,10,358.3390254137006,0.40316022544283414,0.20025001017220445,0.21338367847700052,131958.55391418288,257.17992092191093,132215.7338351048,3231,0,1026.4130434782608,38,8,18,33.93123288620847,0.6362390350877192,43.13568376068376,1027.4572649572647,27.038349077822755,0
3277,4,0,1,44,0.0,0.022222222222222223,0.9777777777777777,45,1600,1300,300,0.8125,19,13,6,356.06758170296916,0.4027146464646465,0.18165034335247077,0.21299315341868535,132130.12695312515,409.45095486112655,132539.57790798627,3232,1,1018.4222222222222,39,6,19,33.81670043904087,0.6362179487179487,42.96875000000001,1028.1250000000011,26.362179487179517,0
3278,4,1,1,44,0.022222222222222223,0.022222222222222223,0.9777777777777777,45,1150,700,450,0.6086956521739131,16,7,9,355.72924731141086,0.405702861952862,0.17985752388669418,0.21324316082000977,132210.4614257814,406.2255859375148,132616.68701171892,3233,0,1019.3111111111111,39,6,19,33.74449255545428,0.6370192307692307,42.89062500000001,1028.4375000000011,26.37019230769234,0
3279,4,0,0,44,0.0,0.0,1.0,44,1000,600,400,0.6,14,6,8,363.49369462121115,0.40093155391120505,0.186912510746035,0.21739588709384186,132123.26189139092,805.1945220615137,132928.45641345243,3234,3,1043.4772727272727,38,6,19,33.63274619834426,0.6378837719298245,42.97542735042735,1028.0982905982908,27.05521817363923,0
3280,4,0,0,44,0.0,0.0,1.0,44,1100,800,300,0.7272727272727273,14,8,6,368.7368765367239,0.40093155391120505,0.20426814435698137,0.2151847993430734,131187.67463305994,875.0320337179568,132062.7066667779,3235,4,1044.4772727272727,37,7,20,34.443232901637586,0.6303490990990992,43.88706140350876,1024.451754385963,27.68788525367468,3
3281,4,0,0,44,0.0,0.0,1.0,44,750,500,250,0.6666666666666666,10,5,5,369.15856963447703,0.4000506518675124,0.20380635624538068,0.2162214479287649,131328.12499999988,896.4811288088516,132224.60612880872,3236,5,1045.4772727272727,33,11,20,34.29031165311653,0.6401515151515152,43.74999999999999,1024.999999999999,31.060606060606034,0
3282,4,0,0,44,0.0,0.0,1.0,44,1100,800,300,0.7272727272727273,14,8,6,365.449446166184,0.4001387420718816,0.1913554343264794,0.2049096541680037,129636.22708013728,675.0974779019577,130311.32455803924,3237,6,1046.4772727272727,38,6,19,36.10185865155965,0.6129385964912281,45.4059829059829,1018.3760683760679,26.79937022042284,5
3283,4,0,0,44,0.0,0.0,1.0,44,750,600,150,0.8,9,6,3,369.017191375907,0.40021582100070474,0.19267531105496527,0.20734112668056984,129717.84056770017,773.6226395280685,130491.46320722824,3238,7,1047.4772727272727,38,6,19,35.927940919419676,0.6137609649122808,45.32585470085469,1018.6965811965797,26.807804768331046,0
3284,4,3,1,46,0.06382978723404255,0.02127659574468085,0.9787234042553191,47,1500,900,600,0.6,21,9,12,353.00427559667537,0.4071268886833179,0.21366979052070834,0.20287952263330503,130598.60365689445,-175.0611947382132,130423.54246215624,3239,0,981.5531914893617,37,10,18,35.442144032038904,0.6244369369369369,44.46271929824562,1022.1491228070178,27.625651967757236,0
3285,4,0,0,46,0.0,0.0,1.0,46,1300,900,400,0.6923076923076923,17,9,8,357.0535157478758,0.40414653784219,0.21523853256891345,0.20458374901719217,130480.80490037623,117.72602545840124,130598.53092583462,3240,1,1003.8913043478261,38,8,21,35.45805883788212,0.6214364035087719,44.577991452991455,1021.6880341880343,26.886527215474587,0
3286,4,1,0,47,0.02127659574468085,0.0,1.0,47,750,500,250,0.6666666666666666,10,5,5,347.73337222098877,0.4073581560283688,0.22279762080904297,0.20093479476328796,130807.80805902586,-302.7519581598126,130505.05610086604,3241,0,983.5106382978723,40,7,19,35.36513179680772,0.6213541666666667,44.25813008130082,1022.9674796747979,25.574186991869947,0
3287,4,1,0,48,0.020833333333333332,0.0,1.0,48,1350,1100,250,0.8148148148148148,16,11,5,342.83815453574897,0.41087655141843976,0.2242661305948459,0.19948001302807217,131074.03175390526,-612.5641691861925,130461.46758471907,3242,0,964.0,41,7,20,35.22129109345733,0.6224593495934959,43.99801587301587,1024.0079365079366,24.97580332946187,0
3288,4,0,0,48,0.0,0.0,1.0,48,1650,1500,150,0.9090909090909091,18,15,3,346.54325212841366,0.4107565011820331,0.22381764933681847,0.20257188744959762,131251.87119118506,-503.1099418933992,130748.76124929165,3243,1,965.0,41,7,21,34.9468123729306,0.6242378048780487,43.82440476190477,1024.7023809523828,24.992740998838606,0
3289,4,0,0,48,0.0,0.0,1.0,48,1150,800,350,0.6956521739130435,15,8,7,348.18853981794194,0.4108119089834515,0.21914020907946918,0.20380372832063243,131302.70460325354,-456.38060200930465,130846.32400124424,3244,2,966.0,41,7,21,34.8533338173136,0.6247459349593495,43.774801587301596,1024.900793650795,24.99758033294622,0
3290,4,1,1,48,0.02040816326530612,0.02040816326530612,0.9795918367346939,49,1000,600,400,0.6,14,6,8,341.62864811699757,0.41230867346938777,0.21384300674747325,0.20157382654973907,131609.25116381957,-807.6895866681368,130801.56157715144,3245,0,947.265306122449,37,12,16,34.71227826458645,0.6345720720720721,43.47587719298245,1026.0964912280697,27.73233760075864,0
3291,4,0,0,48,0.0,0.0,1.0,48,1400,1100,300,0.7857142857142857,17,11,6,349.1028227654435,0.4105256353427896,0.21957184092366866,0.20537784931748151,131496.76462950127,-418.821656663607,131077.94297283766,3246,4,968.0,37,11,21,34.63402465968211,0.633445945945946,43.585526315789465,1025.6578947368412,27.720483641536248,0
3292,4,1,1,48,0.02040816326530612,0.02040816326530612,0.9795918367346939,49,900,600,300,0.6666666666666666,12,6,6,305.760323452766,0.4136196145124717,0.08293610797456741,0.17335001074911566,130069.31889921954,-1842.9147263048449,128226.40417291468,3247,0,949.2244897959183,43,6,17,37.183593266493375,0.6094961240310077,44.98106060606061,1020.0757575757582,23.72269203664554,8
3293,4,0,0,48,0.0,0.0,1.0,48,1050,600,450,0.5714285714285714,15,6,9,309.8881184376078,0.4101008421985815,0.08865201900237585,0.17544768405356753,130015.40927716177,-1541.9538902409731,128473.4553869208,3248,1,969.8958333333334,42,6,18,37.132818685669065,0.6103670634920635,45.03391472868217,1019.8643410852709,24.282484311554068,0
3294,4,1,2,47,0.02040816326530612,0.04081632653061224,0.9591836734693877,49,700,400,300,0.5714285714285714,10,4,6,322.2330136340152,0.41170634920634924,0.10734500435245198,0.185363047646612,130633.79322907297,-1380.6263520821872,129253.16687699078,3249,0,951.0816326530612,42,7,15,36.192930489731445,0.6165674603174602,44.42829457364342,1022.2868217054279,24.340162421557807,2
3295,4,0,0,47,0.0,0.0,1.0,47,900,700,200,0.7777777777777778,11,7,4,334.62566828119725,0.4073003391921061,0.11773345947330238,0.19168044690774222,130470.15587819759,-668.267379701226,129801.88849849637,3250,1,991.9574468085107,40,7,19,36.04168739016547,0.61796875,44.588414634146346,1021.6463414634154,25.541158536585385,0
3296,4,0,1,46,0.0,0.02127659574468085,0.9787234042553191,47,1200,1100,100,0.9166666666666666,13,11,2,335.39315675583885,0.40768578476719086,0.11893147404627613,0.19276482118001317,130599.97046235719,-639.5327268821331,129960.43773547506,3251,2,992.9574468085107,40,7,15,35.89079174123418,0.6192708333333332,44.461382113821145,1022.1544715447164,25.553861788617912,0
3297,4,0,1,45,0.0,0.021739130434782608,0.9782608695652174,46,950,600,350,0.631578947368421,13,6,7,348.06157337336526,0.40606884057971016,0.11955329782023516,0.1964775263088476,129899.73855054837,-153.33000776656806,129746.4085427818,3252,3,1014.9565217391304,40,6,17,36.27691655866813,0.6122395833333335,45.14735772357722,1019.4105691056891,25.485264227642226,3
3298,4,3,2,46,0.0625,0.041666666666666664,0.9583333333333334,48,1450,1200,250,0.8275862068965517,17,12,5,334.19212244937574,0.4153461140661938,0.13424533591599608,0.19158916008801413,130501.9544813366,-875.9367760824814,129626.01770525411,3253,0,937.5833333333334,39,9,13,36.02059758045332,0.6199252136752138,44.55729166666666,1021.7708333333317,26.199252136752094,0
3299,4,2,2,46,0.041666666666666664,0.041666666666666664,0.9583333333333334,48,1100,700,400,0.6363636363636364,15,7,8,332.06536602358955,0.4138593380614657,0.13649489576083074,0.1907242367846507,130574.00238160131,-928.1792211977188,129645.8231604036,3254,0,938.5416666666666,40,8,13,36.00207981173977,0.6190104166666668,44.48678861788617,1022.0528455284533,25.551321138211332,0
3300,4,0,0,46,0.0,0.0,1.0,46,1100,800,300,0.7272727272727273,14,8,6,345.81396320947147,0.40935990338164246,0.14273580847034428,0.1974382225592572,130342.3516167534,-185.15896267361603,130157.19265407979,3255,2,980.3478260869565,39,7,19,35.885379475670725,0.6183226495726496,44.713541666666664,1021.1458333333327,26.18322649572648,0
3301,4,1,3,44,0.02127659574468085,0.06382978723404255,0.9361702127659575,47,1050,700,350,0.6666666666666666,14,7,7,336.7046231556983,0.4110777058279371,0.140793536652426,0.19377851881843947,130651.91436975336,-601.7792815123357,130050.13508824102,3256,0,960.468085106383,40,7,14,35.80475480450631,0.6197916666666667,44.41056910569105,1022.357723577235,25.558943089430876,0
3302,4,0,0,44,0.0,0.0,1.0,44,950,700,250,0.7368421052631579,12,7,5,353.7942426273278,0.40572145877378435,0.15624821737559613,0.20257368550913227,130453.51765103365,430.74069508363687,130884.25834611728,3257,4,1023.2727272727273,38,6,19,35.56896221153175,0.6211622807017544,44.60470085470085,1021.5811965811964,26.88371569950517,0
3303,4,0,0,44,0.0,0.0,1.0,44,1150,700,450,0.6086956521739131,16,7,9,355.5617615079808,0.40615089852008457,0.1595851351993538,0.20401609171108792,130535.38795976694,482.6784964204775,131018.06645618741,3258,5,1024.2727272727273,38,6,17,35.44084335250042,0.621984649122807,44.52457264957265,1021.9017094017091,26.892150247413397,0
3304,4,0,1,43,0.0,0.022727272727272728,0.9772727272727273,44,750,700,50,0.9333333333333333,8,7,1,359.0216486764979,0.4059637068357999,0.16464979047293316,0.2062918986719551,130589.98243343178,576.9261587771057,131166.9085922089,3259,6,1025.2727272727273,38,6,17,35.29711508309816,0.6225328947368423,44.47115384615384,1022.1153846153833,26.89777327935219,0
3305,4,0,0,43,0.0,0.0,1.0,43,1300,1000,300,0.7692307692307693,16,10,6,366.9624391269365,0.40605389442598744,0.168912749534734,0.2109015941764055,130598.60365689422,984.9564289011755,131583.56008579538,3204,7,974.3255813953489,37,6,17,35.08546091682757,0.624436936936937,44.4627192982456,1022.1491228070158,27.625651967757186,0
3306,4,0,0,43,0.0,0.0,1.0,43,700,300,400,0.42857142857142855,11,3,8,368.07613078509905,0.4059154669619786,0.1744447908223703,0.21200184802785949,130682.67549871097,1020.2347116420256,131702.910210353,3205,8,975.3255813953489,37,6,17,34.9717381590706,0.6252815315315317,44.38048245614034,1022.4780701754372,27.63454243717398,0
3307,4,0,0,43,0.0,0.0,1.0,43,1350,900,450,0.6666666666666666,18,9,9,370.634436506378,0.4052464008859358,0.1773424063411353,0.21425150511799873,130822.85534972265,1097.4910549399444,131920.3464046626,3206,9,976.3255813953489,37,6,17,34.764201500535904,0.6266891891891893,44.24342105263156,1023.0263157894709,27.649359886201918,0
3308,4,0,0,43,0.0,0.0,1.0,43,900,500,400,0.5555555555555556,13,5,8,370.9247129444536,0.4050387596899225,0.17037985658831722,0.21504417829959782,130935.05333371782,1113.409414435183,132048.462748153,3207,10,977.3255813953489,37,6,17,34.643061209913576,0.6278153153153154,44.13377192982455,1023.4649122806998,27.661213845424317,0
3309,4,0,0,43,0.0,0.0,1.0,43,1250,900,350,0.72,16,9,7,366.4558964459466,0.4047619047619047,0.16401573626811383,0.21338516663373677,131103.44048168653,1008.7257617728378,132112.16624345936,3208,11,978.3255813953489,37,6,17,34.586902212705205,0.6295045045045047,43.96929824561403,1024.1228070175428,27.678994784257913,0
3310,4,0,0,43,0.0,0.0,1.0,43,1700,1300,400,0.7647058823529411,21,13,8,368.04531367282823,0.4042312661498708,0.16368668365721595,0.21493846318493137,131215.75869498288,1058.6690135426063,132274.4277085255,3209,12,979.3255813953489,37,6,17,34.43252354452055,0.6306306306306307,43.85964912280701,1024.5614035087704,27.69084874348028,0
3311,4,0,0,43,0.0,0.0,1.0,43,1000,800,200,0.8,12,8,4,367.34510662405813,0.4042312661498708,0.1627533689200793,0.21468668051293416,131243.8457626382,1042.3569030855297,132286.20266572374,3210,13,980.3255813953489,37,6,17,34.42203941501694,0.6309121621621623,43.832236842105246,1024.6710526315765,27.69381223328585,0
3312,4,0,1,42,0.0,0.023255813953488372,0.9767441860465116,43,950,600,350,0.631578947368421,13,6,7,368.1760881496332,0.4037236987818383,0.1657679849486977,0.2153381120445899,131273.37643363254,1066.3436427057873,132339.72007633833,3211,14,981.3255813953489,38,5,17,34.37087329719211,0.6293859649122808,43.803418803418786,1024.7863247863222,26.968061178587426,0
3313,4,0,0,42,0.0,0.0,1.0,42,1050,700,350,0.6666666666666666,14,7,7,347.88013193887866,0.4038303329461866,0.07339067138383992,0.20678560126925233,131890.67790089268,776.4292859341468,132667.10718682682,3212,15,978.7857142857143,37,5,19,34.26825362937661,0.6373873873873873,43.20175438596492,1027.1929824561412,27.761972498814625,3
3314,4,0,0,42,0.0,0.0,1.0,42,1550,1000,550,0.6451612903225806,21,10,11,374.7404034993545,0.4038303329461866,0.11791421771020572,0.2140022381925439,130351.21588059406,1388.4254015925749,131739.64128218664,3213,16,979.7857142857143,35,7,18,35.137920775246506,0.6258928571428571,44.70486111111111,1021.180555555555,29.176587301587286,3
3315,4,2,2,42,0.045454545454545456,0.045454545454545456,0.9545454545454546,44,600,300,300,0.5,9,3,6,359.03481304785123,0.4090358527131783,0.11300281684649627,0.20709447750756377,130738.73842191818,587.9517014850576,131326.69012340324,3214,0,936.2045454545455,37,7,16,35.146058932847275,0.6258445945945947,44.325657894736835,1022.6973684210518,27.640469416785184,0
3316,4,0,0,42,0.0,0.0,1.0,42,1050,800,250,0.7619047619047619,13,8,5,378.74966421352326,0.40356416957026714,0.12527545174085475,0.21756531344316077,130578.91506371248,1491.3440467494656,132070.25911046195,3215,18,981.7857142857143,36,6,16,34.804245629499036,0.6261574074074073,44.48198198198199,1022.0720720720731,28.39089089089092,0
3317,4,0,0,42,0.0,0.0,1.0,42,1100,1000,100,0.9090909090909091,12,10,2,316.59727045789526,0.4040602013162989,0.07383216637057188,0.1821719351179554,130644.5883213711,-127.65598747170054,130516.9323338994,3216,19,982.7857142857143,38,4,14,36.326070296443376,0.6230811403508772,44.41773504273504,1022.3290598290594,26.903396311291036,8
3318,4,0,0,42,0.0,0.0,1.0,42,1300,800,500,0.6153846153846154,18,8,10,323.3640988392715,0.4037698412698412,0.0833998403830809,0.19006086884015677,131461.62245008672,103.77729545334739,131565.39974554008,3217,20,983.7857142857143,39,3,19,35.32937616387338,0.6295405982905983,43.619791666666664,1025.5208333333328,26.29540598290597,4
3319,4,1,0,43,0.023255813953488372,0.0,1.0,43,1550,1300,250,0.8387096774193549,18,13,5,318.0517480849891,0.4075535252860834,0.09101181777383971,0.18872066438043517,131823.38271077056,-214.66853807259315,131608.71417269798,3218,0,961.8837209302326,40,3,17,35.10184727032823,0.6315104166666667,43.26727642276422,1026.9308943089418,25.673272357723544,0
3320,4,0,0,43,0.0,0.0,1.0,43,1200,900,300,0.75,15,9,6,317.79727651568294,0.40702288667404946,0.09178135119222874,0.1894791309036899,132006.0810364199,-209.7653926234588,131796.31564379644,3219,1,962.8837209302326,40,3,19,34.924882977320664,0.6333333333333334,43.08943089430893,1027.6422764227625,25.691056910569063,0
3321,4,1,1,43,0.022727272727272728,0.022727272727272728,0.9772727272727273,44,600,200,400,0.3333333333333333,10,2,8,314.0066774233701,0.4106214763918252,0.0940549996930824,0.18827687824453884,132219.38898533944,-496.4457947530873,131722.94319058635,3220,0,941.9772727272727,41,3,19,34.80826581138871,0.6338922764227642,42.88194444444444,1028.4722222222217,25.084688346883457,0
3322,4,3,1,45,0.06521739130434782,0.021739130434782608,0.9782608695652174,46,1250,600,650,0.48,19,6,13,306.642297833947,0.4130736714975845,0.11519856048876487,0.18675342757882216,132806.71788391267,-1054.9274455152552,131751.7904383974,3221,0,901.9565217391304,41,5,15,34.40968880333655,0.6397357723577236,42.31150793650793,1030.753968253967,25.140340689121146,0
3323,4,0,0,45,0.0,0.0,1.0,45,750,500,250,0.6666666666666666,10,5,5,314.08816995981294,0.4091540404040404,0.12117028270874419,0.1909384918101023,132738.13950029755,-661.704136096228,132076.43536420132,3222,1,923.0,40,5,15,34.286448060486514,0.640625,42.37804878048781,1030.4878048780497,25.762195121951244,0
3324,4,0,0,45,0.0,0.0,1.0,45,1100,800,300,0.7272727272727273,14,8,6,312.942957962185,0.4090909090909091,0.12981983462022884,0.19090837694085203,132869.07723783806,-683.9115894969786,132185.1656483411,3223,2,924.0,40,5,16,34.184943321833416,0.6419270833333333,42.25101626016261,1030.9959349593507,25.774898373983767,0
3325,4,0,0,45,0.0,0.0,1.0,45,1300,1000,300,0.7692307692307693,16,10,6,311.14991604006167,0.4087121212121212,0.11688350530880887,0.1910614773700546,133113.6670524693,-716.3387345678751,132397.32831790144,3224,3,925.0,41,4,17,33.986653207716486,0.6427845528455283,42.0138888888889,1031.944444444446,25.169376693766974,0
3326,4,0,0,45,0.0,0.0,1.0,45,850,600,250,0.7058823529411765,11,6,5,313.58048341800884,0.4090909090909091,0.11913366653851032,0.19281863767618027,133164.85969387778,-648.4197845804805,132516.4399092973,3225,4,926.0,41,4,17,33.87278931180315,0.6432926829268292,41.96428571428572,1032.142857142859,25.174216027874607,0
3327,4,0,0,45,0.0,0.0,1.0,45,1150,600,550,0.5217391304347826,17,6,11,313.5800423484832,0.40883838383838383,0.10995163511738837,0.19321654829607288,133241.66710955245,-643.6144770407919,132598.05263251165,3226,5,927.0,41,4,17,33.79606274622849,0.6440548780487804,41.88988095238096,1032.4404761904784,25.181475029036058,0
3328,4,0,0,45,0.0,0.0,1.0,45,1050,600,450,0.5714285714285714,15,6,9,326.18011463623907,0.40904882154882155,0.05474587845088297,0.19249696920760428,131616.85333982637,-289.67699148230287,131327.17634834407,3227,6,928.0,36,9,16,35.10092003219199,0.6365740740740741,43.46846846846847,1026.1261261261266,28.503503503503516,7
3329,4,0,0,45,0.0,0.0,1.0,45,1650,1300,350,0.7878787878787878,20,13,7,322.8465274467066,0.4083964646464646,0.06206681236340894,0.1911418534957119,131739.10307774486,-493.69760848126964,131245.40546926358,3228,7,929.0,38,7,16,35.06348215214901,0.634046052631579,43.34935897435897,1026.6025641025637,27.015856950067466,0
3330,4,0,0,45,0.0,0.0,1.0,45,1250,1000,250,0.8,15,10,5,322.5275561718006,0.4076388888888889,0.06472842010367352,0.19157359661770826,131862.521701389,-494.14062499998954,131368.381076389,3229,8,930.0,39,6,18,34.947599729546994,0.6335470085470085,43.22916666666667,1027.0833333333342,26.335470085470106,0
3331,4,1,1,45,0.021739130434782608,0.021739130434782608,0.9782608695652174,46,1000,800,200,0.8,12,8,4,315.77394879719463,0.409188808373591,0.06968853022842181,0.1892088296665732,132193.88247197017,-851.3231449987541,131342.55932697142,3230,0,910.7608695652174,41,5,20,34.78841083027847,0.6336382113821138,42.906746031746025,1028.373015873015,25.082268679829635,0
3332,4,1,1,45,0.021739130434782608,0.021739130434782608,0.9782608695652174,46,850,600,250,0.7058823529411765,11,6,5,315.0440797453698,0.4107890499194847,0.07089484961444437,0.18915414376836928,132270.4093935027,-865.798119016133,131404.61127448655,3231,0,910.9347826086956,41,5,21,34.73042643134986,0.6344004065040652,42.832341269841265,1028.6706349206343,25.08952768099108,0
3333,4,0,0,45,0.0,0.0,1.0,45,1000,800,200,0.8,12,8,4,314.6280464287093,0.40778619528619525,0.0681068739160029,0.18888879513353454,132267.29811124314,-676.9996777711808,131590.29843347197,3232,2,932.1777777777778,40,5,21,34.74424520845683,0.6359375,42.83536585365853,1028.6585365853646,25.716463414634113,0
3334,4,0,0,45,0.0,0.0,1.0,45,900,600,300,0.6666666666666666,12,6,6,313.915107704165,0.40726010101010096,0.06811501049835034,0.1888589035445241,132346.95845930948,-690.8580561854545,131656.10040312403,3233,3,933.1777777777778,41,4,21,34.68271950122124,0.6351626016260163,42.7579365079365,1028.9682539682526,25.0967866821525,0
3335,4,0,0,45,0.0,0.0,1.0,45,1000,800,200,0.8,12,8,4,316.221184099692,0.40683922558922564,0.0738926559390074,0.1906395070219073,132424.80604383693,-624.8745219297102,131799.93152190722,3234,4,934.1777777777778,39,6,21,34.545360624768065,0.639155982905983,42.68229166666667,1029.2708333333344,26.391559829059855,0
3336,4,0,0,45,0.0,0.0,1.0,45,800,500,300,0.625,11,5,6,314.9803928792646,0.4073232323232323,0.06591356151295402,0.19043309991507842,132532.0434570313,-651.0009765624984,131881.0424804688,3235,5,935.1777777777778,39,6,22,34.469840667678284,0.640224358974359,42.578125,1029.6875000000005,26.402243589743602,0
3337,4,0,0,45,0.0,0.0,1.0,45,1000,700,300,0.7,13,7,6,315.2721483855424,0.40669191919191916,0.07094570298453773,0.1910178310806524,132612.50000000017,-638.1944444444282,131974.30555555574,3236,6,936.1777777777778,39,6,22,34.38174217907226,0.641025641025641,42.50000000000001,1030.0000000000014,26.410256410256444,0
3338,4,0,0,45,0.0,0.0,1.0,45,1000,600,400,0.6,14,6,8,318.4318821387069,0.4053872053872054,0.07561531807816291,0.19334620909969,132692.98095703128,-549.2648654513878,132143.7160915799,3237,7,937.1777777777778,39,6,15,34.21976628584909,0.6418269230769231,42.421875,1030.3125000000002,26.418269230769237,0
3339,4,0,0,45,0.0,0.0,1.0,45,1150,800,350,0.6956521739130435,15,8,7,319.14434559335905,0.40454545454545454,0.07015889057324154,0.1943343569013099,132800.32687717004,-523.5053168402869,132276.82156032976,3238,8,938.1777777777778,39,6,15,34.09392369883779,0.6428952991452992,42.31770833333333,1030.7291666666658,26.42895299145297,0
3340,4,0,0,45,0.0,0.0,1.0,45,1150,800,350,0.6956521739130435,15,8,7,320.3747893118418,0.4046296296296296,0.07404563872894032,0.19564404931510918,132907.7162000867,-483.9436848958372,132423.77251519085,3239,9,939.1777777777778,39,6,16,33.95471343906793,0.6439636752136753,42.213541666666664,1031.1458333333326,26.43963675213673,0
3341,4,0,0,45,0.0,0.0,1.0,45,950,800,150,0.8421052631578947,11,8,3,320.0807590574875,0.40446127946127947,0.07649698960043749,0.19594811245075366,133000.07952442317,-485.84671822329176,132514.23280619987,3240,10,940.1777777777778,40,5,16,33.86986863711001,0.6432291666666667,42.12398373983739,1031.5040650406495,25.787601626016237,0
3342,4,1,1,45,0.021739130434782608,0.021739130434782608,0.9782608695652174,46,1000,700,300,0.7,13,7,6,309.1844659975295,0.40603864734299516,0.07611551769160485,0.19066375403180952,133272.0389399673,-958.8711615888689,132313.1677783784,3241,0,920.7173913043479,42,4,16,33.8791916916917,0.642857142857143,41.86046511627906,1032.5581395348815,24.58471760797337,0
3343,4,0,1,44,0.0,0.022222222222222223,0.9777777777777777,45,1000,700,300,0.7,13,7,6,313.7811273891483,0.40401936026936025,0.07220087112477569,0.19347357665084447,133267.2745023935,-636.6488725119771,132630.6256298815,3242,12,942.1777777777778,41,4,17,33.76529272354599,0.6443089430894309,41.86507936507936,1032.539682539682,25.183894696089805,0
3344,4,0,0,44,0.0,0.0,1.0,44,1000,600,400,0.6,14,6,8,323.75119206888564,0.40179043340380555,0.0717605640103427,0.19973502505233462,133288.51176754918,-169.53708523364384,133118.97468231554,3243,22,964.3181818181819,40,4,20,33.48669750352658,0.6460937499999999,41.84451219512196,1032.621951219513,25.815548780487823,0
3345,4,0,0,44,0.0,0.0,1.0,44,850,500,350,0.5882352941176471,12,5,7,324.5716702447006,0.4013940274841437,0.08032240754818232,0.20080773146910433,133393.4736784488,-140.85148968866417,133252.6221887601,3244,23,965.3181818181819,40,4,20,33.36059190031153,0.6471354166666666,41.742886178861795,1033.0284552845537,25.825711382113845,0
3346,4,0,1,43,0.0,0.022727272727272728,0.9772727272727273,44,1200,900,300,0.75,15,9,6,324.5716702447006,0.4013940274841437,0.08032240754818232,0.20080773146910433,133393.4736784488,-140.85148968866417,133252.6221887601,3245,24,966.3181818181819,40,4,20,33.36059190031153,0.6471354166666666,41.742886178861795,1033.0284552845537,25.825711382113845,0
3347,4,0,0,43,0.0,0.0,1.0,43,700,300,400,0.42857142857142855,11,3,8,323.23100936524423,0.4007705795496493,0.08458364591147727,0.20040322580645162,133472.22222222234,28.47222222223172,133500.69444444455,3246,25,983.8837209302326,40,3,20,33.316532258064505,0.6479166666666667,41.66666666666667,1033.3333333333344,25.83333333333336,0
3348,4,0,0,43,0.0,0.0,1.0,43,1600,1300,300,0.8125,19,13,6,323.7639590874941,0.39989387227759315,0.08675763982317863,0.2019352528329213,133693.1112572136,57.002200672047024,133750.11345788566,3247,26,984.8837209302326,38,5,20,33.08217114325067,0.6535087719298247,41.45299145299144,1034.1880341880326,27.215474583895595,0
3349,4,0,0,43,0.0,0.0,1.0,43,950,700,250,0.7368421052631579,12,7,5,324.56976491308836,0.39936323366555926,0.09389420746911292,0.2031475409503281,133822.27783203125,86.93305121527783,133909.21088324653,3248,27,985.8837209302326,39,4,18,32.932418034162225,0.6530448717948718,41.328125,1034.6875,26.53044871794872,0
3350,4,0,0,43,0.0,0.0,1.0,43,1250,1000,250,0.8,15,10,5,325.0494089792004,0.3989479512735327,0.10065425264217409,0.20374548127497494,133876.17323133672,103.27419704860586,133979.44742838532,3249,28,986.8837209302326,39,4,18,32.86623469216575,0.6535790598290598,41.276041666666664,1034.8958333333328,26.535790598290586,0
3351,4,0,0,43,0.0,0.0,1.0,43,700,400,300,0.5714285714285714,10,4,6,325.8194938467588,0.3988095238095238,0.0926207198373008,0.20452737273248506,133930.07948133667,127.40614149304554,134057.4856228297,3250,29,987.8837209302326,39,4,19,32.79253044178325,0.6541132478632479,41.22395833333333,1035.1041666666656,26.541132478632452,0
3352,4,0,0,43,0.0,0.0,1.0,43,1150,700,450,0.6086956521739131,16,7,9,325.58390870900683,0.3988095238095238,0.09769360541161576,0.20467922002902084,133983.99658203125,124.60666232638903,134108.60324435763,3251,30,988.8837209302326,39,4,19,32.74484773786766,0.6546474358974359,41.171875,1035.3125,26.546474358974358,0
3353,4,0,0,43,0.0,0.0,1.0,43,950,500,450,0.5263157894736842,14,5,9,326.74922776093206,0.3982788851974899,0.10051003696598237,0.20556248885719383,134010.95920138876,157.59548611110188,134168.55468749985,3252,31,989.8837209302326,39,4,19,32.68779342723005,0.65491452991453,41.14583333333333,1035.4166666666656,26.549145299145273,0
3354,4,0,0,43,0.0,0.0,1.0,43,1100,800,300,0.7272727272727273,14,8,6,341.61297069972915,0.39811738648947953,0.030117374375499217,0.20478110866535668,132210.46142578122,487.21516927083354,132697.67659505206,3253,32,990.8837209302326,39,4,15,34.10743526114995,0.6370192307692308,42.890625,1028.4374999999998,26.370192307692303,7
3355,4,0,0,43,0.0,0.0,1.0,43,950,600,350,0.631578947368421,13,6,7,345.7384076913348,0.39837117017349577,0.0278309876992735,0.19609641733535532,130085.41907793196,395.10513117282636,130480.52420910478,3254,33,991.8837209302326,41,2,14,36.14774790106649,0.6125508130081301,44.96527777777777,1020.1388888888878,24.881436314363118,4
3356,4,0,0,43,0.0,0.0,1.0,43,1450,1000,450,0.6896551724137931,19,10,9,347.86307551588055,0.3982327427094869,0.021223840317159404,0.19807211864874896,130237.26974875596,460.9474403187181,130698.21718907468,3255,34,992.8837209302326,41,2,15,35.93957543655035,0.6140752032520325,44.81646825396825,1020.7341269841269,24.895954316686023,0
3357,4,0,0,43,0.0,0.0,1.0,43,1300,1000,300,0.7692307692307693,16,10,6,345.74384881586093,0.3979097452934662,0.01925055142275589,0.19810356058874062,130480.80490037627,422.59451799430514,130903.39941837058,3256,35,993.8837209302326,38,5,17,35.74693262225939,0.6214364035087719,44.577991452991455,1021.6880341880346,26.886527215474597,0
3358,4,1,1,43,0.022727272727272728,0.022727272727272728,0.9772727272727273,44,1550,1100,450,0.7096774193548387,20,11,9,340.0676922675278,0.40274841437632136,0.0248478983581355,0.19603314944159272,130714.91021050367,90.38357204863118,130805.2937825523,3257,0,972.2727272727273,39,5,13,35.65509235679605,0.6220619658119657,44.34895833333334,1022.6041666666682,26.2206196581197,0
3359,4,1,0,44,0.022727272727272728,0.0,1.0,44,1700,1200,500,0.7058823529411765,22,12,10,337.7555050534481,0.4014270613107822,0.029435577145500824,0.19577863346018443,130928.03955078126,44.33322482638977,130972.37277560766,3258,0,973.25,39,5,14,35.49883375742154,0.624198717948718,44.140625,1023.4375000000001,26.241987179487182,0
3360,4,0,0,44,0.0,0.0,1.0,44,800,700,100,0.875,9,7,2,339.5662207221017,0.400997621564482,0.0332352832352838,0.1972374005470934,131008.00781250025,97.17881944447532,131105.18663194473,3259,1,974.25,39,5,14,35.37172703839372,0.6249999999999998,44.062500000000014,1023.7500000000019,26.25000000000005,0
3361,4,0,0,44,0.0,0.0,1.0,44,1450,800,650,0.5517241379310345,21,8,13,343.4893313947897,0.401338971106413,0.0366987165032604,0.20023302320000513,131145.8965913975,209.44326706988412,131355.33985846737,3260,2,975.25,40,4,14,35.13204021562986,0.6247395833333333,43.92784552845529,1024.2886178861804,25.60721544715451,0
3362,4,0,0,44,0.0,0.0,1.0,44,1500,900,600,0.6,21,9,12,331.3046027481231,0.4014160500352361,0.03827728398911945,0.18395293657348166,129250.65068956191,-119.68921274694179,129130.96147681496,3261,3,976.25,42,2,19,37.362619909789736,0.6026785714285714,45.78488372093023,1016.8604651162789,24.210963455149496,7
3363,4,1,1,44,0.022222222222222223,0.022222222222222223,0.9777777777777777,45,1200,900,300,0.75,15,9,6,327.70950361360065,0.40389309764309766,0.04062313610125434,0.1829281439419546,129460.39201817571,-514.9198388202906,128945.47217935542,3262,0,955.5333333333333,44,1,15,37.24107603190491,0.6020359848484849,45.57870370370371,1017.6851851851861,23.129208754208776,0
3364,4,0,0,44,0.0,0.0,1.0,44,800,300,500,0.375,13,3,10,335.5865195126846,0.401338971106413,0.04258851897288363,0.18712387919895143,129418.09900317088,-113.80611871557156,129304.29288445531,3263,5,978.25,43,1,19,37.08362416627889,0.6029554263565892,45.62026515151515,1017.5189393939391,23.66323114869626,0
3365,4,0,0,44,0.0,0.0,1.0,44,1000,700,300,0.7,13,7,6,332.92242292413573,0.4010747004933051,0.042970170586692946,0.18609376619924772,129514.47289837293,-176.34557578627687,129338.12732258665,3264,6,979.25,43,1,17,37.05354374050299,0.6039244186046512,45.52556818181818,1017.8977272727273,23.672040169133194,0
3366,4,1,0,45,0.022222222222222223,0.0,1.0,45,1400,900,500,0.6428571428571429,19,9,10,316.92062163317905,0.4071969696969697,0.030462068741260673,0.17608418928789824,129277.04480229606,-788.9682587265164,128488.07654356955,3265,0,958.4666666666667,41,4,18,37.70150473124572,0.6044207317073169,45.75892857142858,1016.9642857142869,24.804006968641144,3
3367,4,1,1,45,0.021739130434782608,0.021739130434782608,0.9782608695652174,46,650,500,150,0.7692307692307693,8,5,3,313.653215642046,0.40865539452495975,0.03354114145440845,0.17513555150921936,129472.44498715551,-1078.1102585481367,128394.33472860737,3266,0,938.6086956521739,42,4,13,37.586483227014526,0.6049107142857142,45.56686046511629,1017.7325581395372,24.231727574750884,0
3368,4,0,0,45,0.0,0.0,1.0,45,1000,700,300,0.7,13,7,6,325.88781362925204,0.40723905723905723,-0.05448833634115313,0.1772303736716555,128427.65239771307,-583.5099928629713,127844.1424048501,3267,2,960.4666666666667,40,5,16,38.33738553572623,0.5973958333333333,46.59552845528456,1013.6178861788624,25.34044715447156,5
3369,4,1,2,44,0.021739130434782608,0.043478260869565216,0.9565217391304348,46,1050,600,450,0.5714285714285714,15,6,9,317.9398650824502,0.40929951690821254,-0.04754876929910845,0.17424302496119826,128733.87008180088,-1014.0741429301179,127719.79593887077,3268,0,940.5652173913044,42,4,16,38.2272669403864,0.5974702380952381,46.29360465116279,1014.8255813953481,24.16251384274638,0
3370,4,1,0,45,0.022222222222222223,0.0,1.0,45,1450,900,550,0.6206896551724138,20,9,11,322.9971329658206,0.4078914141414141,-0.03692457854589004,0.1770145983019904,128733.87008180088,-683.8658095967837,128050.0042722041,3269,0,962.2222222222222,42,3,17,38.098960819886074,0.5974702380952381,46.29360465116279,1014.8255813953481,24.16251384274638,0
3371,4,1,0,46,0.021739130434782608,0.0,1.0,46,1150,900,250,0.782608695652174,14,9,5,321.4605034703373,0.4107890499194847,-0.013545929737833973,0.17761437704617505,129057.01636392335,-902.6533086547261,128154.36305526862,3270,0,942.2826086956521,43,3,18,37.809490525007774,0.5993217054263567,45.97537878787879,1016.098484848485,23.63019732205779,0
3372,4,0,0,46,0.0,0.0,1.0,46,1450,1200,250,0.8275862068965517,17,12,5,321.00434238517505,0.41036634460547505,-0.011940014340170224,0.17768641602991692,129129.19253795074,-909.7936933252802,128219.39884462547,3271,1,943.2826086956521,43,3,18,37.747775552035776,0.600048449612403,45.90435606060607,1016.3825757575775,23.63680408738552,0
3373,4,2,1,47,0.041666666666666664,0.020833333333333332,0.9791666666666666,48,1050,700,350,0.6666666666666666,14,7,7,309.11056705060685,0.4173130910165485,0.010425799642799216,0.17329437306250545,129630.3985280453,-1585.894093155338,128044.50443488997,3272,0,904.9375,41,7,16,37.54211316772205,0.6079776422764228,45.41170634920634,1018.3531746031732,24.83788230739447,0
3374,4,3,2,48,0.06,0.04,0.96,50,950,500,450,0.5263157894736842,14,5,9,303.59386675634335,0.4206207482993198,0.0372818464269864,0.17246519964751433,130147.02896089325,-2097.6320461825208,128049.39691471073,3273,0,869.68,45,5,17,37.16036026039355,0.6076388888888888,44.90489130434783,1020.3804347826091,22.67512077294687,0
3375,4,1,4,45,0.02040816326530612,0.08163265306122448,0.9183673469387755,49,1000,600,400,0.6,14,6,8,311.45061690665347,0.4177295918367347,0.03190697226430994,0.17670251787216848,130097.22650891644,-1696.2277091906599,128400.99879972578,3274,0,888.4081632653061,44,5,18,37.010271071579844,0.6084280303030303,44.95370370370371,1020.1851851851861,23.18602693602696,0
3376,4,0,0,45,0.0,0.0,1.0,45,1000,700,300,0.7,13,7,6,326.01029037263635,0.4137626262626262,0.05080230093854121,0.18407042548731928,129908.3719135803,-529.7067901234483,129378.66512345684,3275,1,941.0444444444445,41,4,18,36.83015440508629,0.6107723577235772,45.13888888888889,1019.4444444444448,24.86449864498646,0
3377,4,0,1,44,0.0,0.022222222222222223,0.9777777777777777,45,600,300,300,0.5,9,3,6,322.4522636232931,0.4140151515151515,0.05379684578050181,0.18241534495232967,129984.23450688148,-617.2578695830182,129366.97663729846,3276,2,942.0444444444445,41,4,18,36.844030709861535,0.6115345528455285,45.06448412698413,1019.7420634920636,24.87175764614789,0
3378,4,0,0,44,0.0,0.0,1.0,44,1200,700,500,0.5833333333333334,17,7,10,343.5557680486305,0.41373766737138834,0.07438016528925617,0.18074020840819266,127092.01388888895,-53.24044548373894,127038.77344340521,3277,3,963.2045454545455,37,7,18,39.25619834710743,0.5889639639639639,47.91666666666667,1008.3333333333339,27.25225225225227,7
3379,4,5,2,47,0.10204081632653061,0.04081632653061224,0.9591836734693877,49,1250,1000,250,0.8,15,10,5,324.87381947643803,0.42750850340136054,0.1515831317116949,0.17706168862170465,128513.9377170138,-1436.816406250004,127077.1213107638,3278,0,865.8163265306123,39,10,16,38.2752037531676,0.5998931623931625,46.510416666666664,1013.9583333333326,25.998931623931604,0
3380,4,2,2,47,0.04081632653061224,0.04081632653061224,0.9591836734693877,49,850,500,350,0.5882352941176471,12,5,7,327.58044832538127,0.4267644557823129,0.1561363841152028,0.17913003853121207,128645.99745008684,-1371.6172960069398,127274.3801540799,3279,0,866.7755102040817,39,10,16,38.072119827497694,0.6012286324786325,46.380208333333336,1014.479166666667,26.012286324786334,0
3381,4,2,1,48,0.04081632653061224,0.02040816326530612,0.9795918367346939,49,1050,800,250,0.7619047619047619,13,8,5,329.637473757874,0.4254357993197279,0.16453060386544238,0.1806146383211029,128725.26584201395,-1313.4657118055518,127411.8001302084,3280,0,867.734693877551,39,10,17,37.939249298569756,0.6020299145299146,46.302083333333336,1014.7916666666672,26.02029914529916,0
3382,4,2,2,48,0.04,0.04,0.96,50,950,700,250,0.7368421052631579,12,7,5,323.0915107378602,0.4292942176870748,0.16757378689344682,0.17811912023303428,128969.02394614647,-1666.2406429704527,127302.78330317601,3281,0,851.34,40,10,17,37.857470401867594,0.6028645833333333,46.0619918699187,1015.7520325203252,25.39380081300813,0
3383,4,2,1,49,0.04,0.02,0.98,50,1150,600,550,0.5217391304347826,17,6,11,324.815259803808,0.4289540816326531,0.1706390639063904,0.17953719086668207,129072.27143441419,-1615.0713241126152,127457.20011030156,3282,0,852.3,40,10,18,37.708770877087694,0.6039062499999999,45.960365853658544,1016.1585365853671,25.403963414634177,0
3384,4,2,2,49,0.0392156862745098,0.0392156862745098,0.9607843137254902,51,1150,600,550,0.5217391304347826,17,6,11,318.6167324048834,0.4326143790849673,0.1691062889214312,0.17756424384293762,129396.54659366336,-1954.1608317906307,127442.38576187272,3283,0,836.5490196078431,37,14,18,37.53715827855012,0.612331081081081,45.64144736842105,1017.4342105263152,27.498221906116626,0
3385,4,2,2,49,0.0392156862745098,0.0392156862745098,0.9607843137254902,51,1050,800,250,0.7619047619047619,13,8,5,324.03306229348016,0.4323856209150327,0.17447208109604895,0.1811470872272246,129519.29253472213,-1806.2934027777865,127712.99913194435,3284,0,837.5098039215686,39,12,12,37.27486696684403,0.6100427350427351,45.52083333333333,1017.9166666666658,26.100427350427328,2
3386,4,0,0,49,0.0,0.0,1.0,49,1250,900,350,0.72,16,9,7,345.31986546696686,0.4273136337868481,0.1801998798872788,0.19217350881445985,129340.77222077922,-867.2123874654023,128473.55983331382,3285,3,872.6938775510204,37,12,19,36.91465901333046,0.6117680180180181,45.69627192982455,1017.2149122806998,27.492294926505398,0
3387,4,0,1,48,0.0,0.02040816326530612,0.9795918367346939,49,1350,800,550,0.5925925925925926,19,8,11,366.867079017828,0.4272604875283447,0.1707927349798355,0.19629613390005754,127775.6564670141,-421.3903857436714,127354.26608127043,3286,4,873.6938775510204,39,10,15,37.96663575795041,0.5924145299145298,47.23958333333334,1011.0416666666683,25.92414529914534,5
3388,4,2,0,50,0.04,0.0,1.0,50,1500,1100,400,0.7333333333333333,19,11,8,361.9686405451329,0.430671768707483,0.23472077990886975,0.19030072762252995,127065.08333561591,-792.3113805450853,126272.77195507083,3287,0,857.1,38,12,17,38.8197167178835,0.5868969298245614,47.943376068376054,1008.2264957264935,26.532276203328774,6
3389,4,2,2,50,0.038461538461538464,0.038461538461538464,0.9615384615384616,52,1550,800,750,0.5161290322580645,23,8,15,353.38376383062,0.4336349924585219,0.2487504448880431,0.18828196034319516,127604.89477989289,-1381.3003998942468,126223.59437999864,3288,0,825.0961538461538,40,12,16,38.482364380071076,0.5890625,47.40853658536585,1010.3658536585363,25.259146341463406,0
3390,4,0,0,50,0.0,0.0,1.0,50,1250,700,550,0.56,18,7,11,367.05991417251977,0.43027210884353745,0.24570672313393294,0.19400564573919682,127280.60766171741,-656.0782151727722,126624.52944654463,3289,1,859.08,38,12,17,38.4698694194459,0.5890899122807018,47.72970085470085,1009.0811965811964,26.554768331084116,0
3391,4,5,4,51,0.09090909090909091,0.07272727272727272,0.9272727272727272,55,1400,900,500,0.6428571428571429,19,9,10,340.20094420022184,0.4412037037037037,0.2609032041039445,0.18480262345750748,128381.94580078125,-2253.179947246079,126128.76585353517,3290,0,781.8909090909091,39,16,16,38.02131514030218,0.5985576923076923,46.640625,1013.4375,25.985576923076923,0
3392,4,1,0,52,0.019230769230769232,0.0,1.0,52,1250,800,450,0.64,17,8,9,361.72765029295374,0.4361095399698341,0.26587080239701555,0.1952105061469904,128119.42087309447,-1131.1325861363187,126988.28828695815,3291,0,825.9230769230769,41,11,21,37.74446758125102,0.5927337398373984,46.89980158730158,1012.4007936507925,24.69270228416567,0
3393,4,2,2,52,0.037037037037037035,0.037037037037037035,0.962962962962963,54,1100,700,400,0.6363636363636364,15,7,8,331.3647512479539,0.4398002562310738,0.21980941072597515,0.18036027735710813,128461.13281250023,-2277.3979788674433,126183.73483363279,3292,0,796.2962962962963,39,15,17,38.16447458555968,0.5993589743589742,46.562500000000014,1013.7500000000018,25.99358974358979,1
3394,4,2,4,50,0.037037037037037035,0.07407407407407407,0.9259259259259259,54,1250,800,450,0.64,17,8,9,330.92508892885076,0.43707780107151173,0.22505110539769446,0.18102055686447796,128659.52934967629,-2284.6667616828468,126374.86258799344,3293,0,797.2407407407408,40,14,18,37.973513305953446,0.5997395833333332,46.366869918699194,1014.5325203252046,25.363313008130113,0
3395,4,2,0,52,0.038461538461538464,0.0,1.0,52,1450,900,550,0.6206896551724138,20,9,11,340.8302923392272,0.43552036199095023,0.23937358820528987,0.1870727098506641,128794.39153928324,-1620.5939760026477,127173.79756328059,3294,0,826.1153846153846,38,14,20,37.58485948847487,0.6044407894736843,46.23397435897435,1015.0641025641016,26.712213225371094,0
3396,4,0,1,51,0.0,0.019230769230769232,0.9807692307692307,52,1850,1100,750,0.5945945945945946,26,11,15,324.35649838197503,0.43543394922071393,0.18903227332208683,0.17962943877476248,129148.44292534732,-2021.9726562499882,127126.47026909734,3295,1,827.1153846153846,39,13,19,37.643045022887215,0.6063034188034189,45.88541666666667,1016.4583333333342,26.06303418803421,1
3397,4,1,1,51,0.019230769230769232,0.019230769230769232,0.9807692307692307,52,1800,1300,500,0.7222222222222222,23,13,10,328.4583428129229,0.43410633484162897,0.19469487664194696,0.18289943510319578,129364.3676035501,-1901.827988884802,127462.5396146653,3296,0,828.0769230769231,38,14,20,37.31949695442135,0.6101973684210527,45.67307692307691,1017.3076923076907,26.771255060728702,0
3398,4,1,1,51,0.019230769230769232,0.019230769230769232,0.9807692307692307,52,1400,1000,400,0.7142857142857143,18,10,8,332.58502129645603,0.43528469079939663,0.19628466221999696,0.18570954940621548,129473.0771513622,-1787.8387756593133,127685.23837570289,3297,0,829.0,38,14,16,37.10415354468471,0.6112938596491229,45.566239316239304,1017.7350427350411,26.782501124606345,0
3399,4,2,2,51,0.03773584905660377,0.03773584905660377,0.9622641509433962,53,1050,700,350,0.6666666666666666,14,7,7,332.3959652637735,0.4370162070633769,0.20739449481001593,0.18470015986740032,129280.82817925357,-2000.715163135655,127280.11301611792,3298,0,814.3207547169811,39,14,20,37.304214039400456,0.607638888888889,45.755208333333336,1016.9791666666674,26.076388888888907,4
3400,4,2,1,52,0.03773584905660377,0.018867924528301886,0.9811320754716981,53,1250,900,350,0.72,16,9,7,330.8066452778497,0.4363056361877116,0.21450603275281588,0.18456025800795636,129439.78000217023,-2036.0921223958285,127403.6878797744,3299,0,815.2830188679245,39,14,16,37.18320281843925,0.6092414529914529,45.598958333333336,1017.6041666666674,26.09241452991455,0
3401,4,0,1,51,0.0,0.019230769230769232,0.9807692307692307,52,1200,900,300,0.75,15,9,6,337.18155031686666,0.43466408999497236,0.21461635403034296,0.18775688433433915,129364.36760355011,-1676.144395134801,127688.22320841531,3300,1,831.9615384615385,38,14,21,37.09764230203739,0.6101973684210527,45.67307692307691,1017.3076923076908,26.771255060728706,0
3402,4,0,0,51,0.0,0.0,1.0,51,1750,1000,750,0.5714285714285714,25,10,15,334.18007759465274,0.43531045751633984,0.2088388625104709,0.18672924335743404,129500.26167223655,-1544.718501168851,127955.5431710677,3301,2,841.6470588235294,38,13,17,37.03596795073649,0.6115679824561404,45.5395299145299,1017.8418803418781,26.78531264057574,0
3403,4,0,1,50,0.0,0.0196078431372549,0.9803921568627451,51,1300,900,400,0.6923076923076923,17,9,8,334.7726007940495,0.4353431372549019,0.2080887753275691,0.18757893346079252,129609.02829141995,-1522.0897024983747,128086.93858892158,3302,3,842.6470588235294,38,13,17,36.910476340363026,0.6126644736842106,45.4326923076923,1018.2692307692294,26.796558704453403,0
3404,4,0,0,50,0.0,0.0,1.0,50,900,500,400,0.5555555555555556,13,5,8,342.10587718426257,0.4325765306122449,0.21577859142795597,0.1916040516003051,129591.85157933188,-1133.1731879039958,128458.67839142788,3303,4,860.26,37,13,17,36.74124129513964,0.6143018018018018,45.44956140350876,1018.2017543859631,27.51896633475576,0
3405,4,0,1,49,0.0,0.02,0.98,50,1550,1200,350,0.7741935483870968,19,12,7,345.001343724805,0.43296768707482997,0.14327868852459047,0.19131892697466482,129201.38888888904,-1061.9613727300534,128139.42751615898,3304,5,861.26,39,11,15,37.064549180327866,0.6068376068376068,45.83333333333334,1016.6666666666679,26.0683760683761,5
3406,4,1,1,49,0.02,0.02,0.98,50,850,500,350,0.5882352941176471,12,5,7,345.07297739709867,0.43253401360544214,0.137093574816731,0.19190029606327877,129312.88954293642,-1075.5232379193474,128237.36630501707,3305,0,861.9,37,13,15,36.94929567342245,0.6114864864864864,45.72368421052632,1017.1052631578958,27.48933143669989,0
3407,4,0,1,48,0.0,0.02040816326530612,0.9795918367346939,49,1600,1300,300,0.8125,19,13,6,351.71996775060444,0.42998866213151926,0.1313148210103714,0.19504470938897178,129201.38888888905,-711.4583333333145,128489.93055555574,3306,7,880.4897959183673,39,10,16,36.89378415300546,0.6068376068376068,45.83333333333334,1016.666666666668,26.068376068376104,0
3408,4,0,2,46,0.0,0.041666666666666664,0.9583333333333334,48,1200,700,500,0.5833333333333334,17,7,10,362.2270541531915,0.4270925679669031,0.14163898117386498,0.20116299501865462,129258.6399744341,-235.8047236425379,129022.83525079157,3307,8,899.125,36,12,16,36.56838316722037,0.6128472222222221,45.77702702702704,1016.8918918918936,28.246996996997044,0
3409,4,0,0,46,0.0,0.0,1.0,46,1250,800,450,0.64,17,8,9,368.606919962865,0.4248389694041868,0.14873609706774493,0.2047060570273478,129258.6399744341,329.1258319130174,129587.76580634712,3308,9,932.9565217391304,36,10,17,36.40619232188999,0.6128472222222221,45.77702702702704,1016.8918918918936,28.246996996997044,0
3410,4,0,0,46,0.0,0.0,1.0,46,1550,1100,450,0.7096774193548387,20,11,9,365.97131223274715,0.4242652979066022,0.15285235868121716,0.20413066526759907,129430.4693206721,273.56774003734256,129704.03706070944,3309,10,933.9565217391304,36,10,14,36.29809465840342,0.6145833333333334,45.60810810810811,1017.5675675675682,28.26576576576578,0
3411,4,1,1,46,0.02127659574468085,0.02127659574468085,0.9787234042553191,47,1650,1300,350,0.7878787878787878,20,13,7,356.6054842503645,0.4262257169287697,0.15297434852021286,0.20015156152275745,129675.59880203521,-151.39405874884963,129524.20474328636,3310,0,915.063829787234,37,10,14,36.286983708328854,0.6151463963963963,45.36732456140351,1018.5307017543857,27.527856804172586,0
3412,4,1,2,45,0.02127659574468085,0.0425531914893617,0.9574468085106383,47,800,500,300,0.625,11,5,6,360.30141972440924,0.4273435090965156,0.1563367252543948,0.2026586435883297,129759.37307633105,-49.502731609738504,129709.8703447213,3311,0,916.0425531914893,37,10,14,36.107673267326746,0.615990990990991,45.28508771929824,1018.859649122806,27.536747273589352,0
3413,4,2,1,46,0.0425531914893617,0.02127659574468085,0.9787234042553191,47,1050,700,350,0.6666666666666666,14,7,7,355.1490943209527,0.4284613012642615,0.17540489709329776,0.20136363138815047,130071.79578493665,-161.02390605597586,129910.77187888068,3312,0,916.2978723404256,38,9,15,35.92157170786203,0.6173245614035088,44.97863247863247,1020.0854700854688,26.84435447593339,0
3414,4,1,3,44,0.02127659574468085,0.06382978723404255,0.9361702127659575,47,1050,600,450,0.5714285714285714,15,6,9,355.95571272641877,0.4294249152019735,0.17953338961944532,0.20224467651695577,130153.54624379064,-134.22033658412028,130019.32590720651,3313,0,917.2765957446809,38,9,15,35.818020800614256,0.6181469298245614,44.89850427350427,1020.4059829059829,26.852789023841655,0
3415,4,0,0,44,0.0,0.0,1.0,44,1500,1000,500,0.6666666666666666,20,10,10,376.0352603008714,0.4239781536293164,0.18786824856715523,0.21299257989649736,130032.77084094235,979.3813661634675,131012.15220710581,3314,2,976.5,36,8,16,35.428627948916116,0.6206597222222222,45.016891891891895,1019.932432432433,28.331456456456472,0
3416,4,0,0,44,0.0,0.0,1.0,44,900,600,300,0.6666666666666666,12,6,6,375.9177381778825,0.4237689393939394,0.19152976949091305,0.2132397489138033,130090.20580969493,980.6431854151558,131070.8489951101,3315,3,977.5,36,8,16,35.373201604297755,0.6212384259259258,44.96058558558559,1020.1576576576584,28.337712712712733,0
3417,4,2,2,44,0.043478260869565216,0.043478260869565216,0.9565217391304348,46,1300,900,400,0.6923076923076923,17,9,8,359.6467437894928,0.4246074879227053,0.18257767140894376,0.20632365827923524,130528.56445312488,189.17703863067743,130717.74149175556,3316,0,935.9565217391304,35,11,15,35.343399592252815,0.6276785714285715,44.53124999999999,1021.8749999999991,29.196428571428545,0
3418,4,1,2,43,0.022222222222222223,0.044444444444444446,0.9555555555555556,45,950,600,350,0.631578947368421,13,6,7,365.68990969476306,0.4251473063973064,0.1929784824462064,0.20995070888197373,130558.13426997588,548.7584662208387,131106.89273619672,3317,0,957.7333333333333,35,10,16,35.15902227255568,0.6279761904761905,44.50231481481481,1021.9907407407399,29.199735449735424,0
3419,4,0,0,43,0.0,0.0,1.0,43,1250,800,450,0.64,17,8,9,382.1276999335507,0.4215808416389812,0.20069685338368992,0.21756315780136337,130233.84871357857,1353.1922124827668,131587.04092606134,3318,6,1002.6976744186046,36,7,18,35.06867828773169,0.6226851851851851,44.81981981981983,1020.7207207207217,28.35335335335338,0
3420,4,0,0,43,0.0,0.0,1.0,43,1150,900,250,0.782608695652174,14,9,5,378.62312987603167,0.4213039867109634,0.19519926777950758,0.216422850780991,130387.71896626304,1273.570761680979,131661.289727944,3319,7,1003.6976744186046,33,10,18,35.00169986401087,0.6306818181818181,44.669117647058826,1021.3235294117653,30.949197860962585,0
3421,4,1,0,44,0.022727272727272728,0.0,1.0,44,800,400,400,0.5,12,4,8,371.80323777029264,0.4227669133192389,0.20125865421214506,0.21460648022051468,130765.21675936655,923.7861957733352,131689.00295513988,3320,0,981.8636363636364,35,9,17,34.7927511221757,0.6300595238095237,44.299768518518526,1022.800925925927,29.22288359788363,0
3422,4,0,0,44,0.0,0.0,1.0,44,950,700,250,0.7368421052631579,12,7,5,374.7015826866773,0.4224696088794926,0.2039901275195395,0.21677761720878444,130854.01663237308,1006.241426611794,131860.25805898488,3321,1,982.8636363636364,35,9,17,34.62858220211161,0.6309523809523809,44.21296296296296,1023.1481481481479,29.232804232804227,0
3423,4,1,1,44,0.022222222222222223,0.022222222222222223,0.9777777777777777,45,1250,900,350,0.72,16,9,7,368.7579580773724,0.425,0.19623682770760498,0.21503975308107423,131159.59357686967,673.2287819328892,131832.82235880254,3322,0,962.0,37,8,19,34.471116106472564,0.6300675675675675,43.91447368421052,1024.3421052631568,27.684921763869102,0
3424,4,1,1,44,0.022222222222222223,0.022222222222222223,0.9777777777777777,45,1800,1400,400,0.7777777777777778,22,14,8,368.2056244294144,0.425273569023569,0.2003085374572,0.2161652502862945,131417.11576485346,677.9206469244918,132095.03641177795,3323,0,962.9777777777778,35,10,19,34.224729089061974,0.6366071428571427,43.66319444444445,1025.3472222222229,29.29563492063494,0
3425,4,0,0,44,0.0,0.0,1.0,44,2250,1800,450,0.8,27,18,9,375.83203223128623,0.42207320295983086,0.20931736362580633,0.22030562488383992,131358.63272392302,1073.7563775510334,132432.38910147405,3324,4,985.8636363636364,34,10,19,34.088423721596406,0.638174019607843,43.7202380952381,1025.1190476190484,30.15056022408966,0
3426,4,1,1,44,0.022222222222222223,0.022222222222222223,0.9777777777777777,45,1500,1300,200,0.8666666666666667,17,13,4,366.11416290949217,0.42243265993265994,0.21060894154356213,0.21672056552486565,131732.4334469605,645.8219198928673,132378.25536685335,3325,0,964.9333333333333,36,9,16,33.959750255960195,0.6377314814814814,43.35585585585586,1026.5765765765768,28.516016016016025,0
3427,4,1,0,45,0.022222222222222223,0.0,1.0,45,1300,1000,300,0.7692307692307693,16,10,6,364.48075045929886,0.4217171717171717,0.22409107079331192,0.21697488130899792,131946.99931709742,618.4282663896436,132565.42758348706,3326,0,965.9111111111112,37,8,17,33.78512984702952,0.6379504504504505,43.1469298245614,1027.4122807017534,27.767899478425768,0
3428,4,0,0,45,0.0,0.0,1.0,45,1300,600,700,0.46153846153846156,20,6,14,362.66130031634987,0.42196969696969694,0.2207333119954482,0.21637328885201432,132031.50398439897,576.543383541082,132608.04736794005,3327,1,966.9111111111112,37,8,19,33.74664372843985,0.638795045045045,43.06469298245614,1027.7412280701747,27.77678994784256,0
3429,4,0,0,45,0.0,0.0,1.0,45,1100,800,300,0.7272727272727273,14,8,6,362.66130031634987,0.4214646464646465,0.2207333119954482,0.21637328885201432,132031.50398439897,576.543383541082,132608.04736794005,3328,2,967.9111111111112,37,8,19,33.74664372843985,0.638795045045045,43.06469298245614,1027.7412280701747,27.77678994784256,0
3430,4,1,2,44,0.021739130434782608,0.043478260869565216,0.9565217391304348,46,900,600,300,0.6666666666666666,12,6,6,356.52629047465655,0.4234500805152979,0.2156329425361041,0.2144724986609255,132343.03232750745,236.75407717875586,132579.7864046862,3329,0,947.8478260869565,38,8,19,33.59053230886374,0.6400767543859649,42.761752136752136,1028.9529914529912,27.077710301394507,0
3431,4,0,0,44,0.0,0.0,1.0,44,1100,700,400,0.6363636363636364,15,7,8,362.7356113122223,0.4200140944326991,0.22662323442461352,0.21752228090049444,132224.21481870406,792.4862785082585,133016.70109721232,3330,4,989.4090909090909,36,8,19,33.55049454359648,0.6426504629629628,42.87725225225226,1028.4909909909927,28.569194194194242,0
3432,4,0,0,44,0.0,0.0,1.0,44,500,200,300,0.4,8,2,6,361.56826583189746,0.4196066772374912,0.23153455739662632,0.21715490521856576,132282.13168827622,765.804191015349,133047.93587929156,3331,5,990.4090909090909,36,8,19,33.522167487684726,0.6432291666666665,42.82094594594595,1028.716216216217,28.57545045045047,0
3433,4,0,0,44,0.0,0.0,1.0,44,1200,800,400,0.6666666666666666,16,8,8,361.33134285953577,0.41978285764622975,0.23142477858956223,0.21703013179949834,132285.18029586025,759.7563673437953,133044.93666320405,3332,6,991.4090909090909,37,7,19,33.525190080295594,0.6413288288288288,42.81798245614035,1028.7280701754385,27.80346135609293,0
3434,4,2,1,45,0.043478260869565216,0.021739130434782608,0.9782608695652174,46,1250,800,450,0.64,17,8,9,346.3220564213481,0.4224235104669887,0.22647817763103117,0.2111621254522386,132849.77709487555,1.8577831640728562,132851.63487803962,3333,0,949.2608695652174,37,9,18,33.34396936821953,0.6469594594594594,42.269736842105274,1030.9210526315806,27.86273115220488,0
3435,4,0,0,45,0.0,0.0,1.0,45,800,700,100,0.875,9,7,2,347.25352794563423,0.42024410774410775,0.21818181818181848,0.20254396167362826,131168.01757812523,120.53200864692201,131288.54958677216,3334,1,971.3555555555556,39,6,21,35.013304182767286,0.6266025641025641,43.906250000000014,1024.3750000000018,26.26602564102569,5
3436,4,0,0,45,0.0,0.0,1.0,45,1000,800,200,0.8,12,8,4,348.9496267485534,0.4192550505050505,0.21667061919119956,0.20424243769060213,131301.4336480036,163.5172526041755,131464.9509006078,3335,2,972.3555555555556,39,6,21,34.83511620422128,0.6279380341880341,43.77604166666667,1024.8958333333346,26.279380341880376,0
3437,4,0,0,45,0.0,0.0,1.0,45,1000,700,300,0.7,13,7,6,349.0391028965054,0.41870791245791245,0.21819824091950912,0.20457973863040568,131354.8190646702,169.59364149305998,131524.41270616328,3336,3,973.3555555555556,39,6,21,34.77892236561325,0.6284722222222222,43.723958333333336,1025.1041666666672,26.284722222222236,0
3438,4,0,0,45,0.0,0.0,1.0,45,950,500,450,0.5263157894736842,14,5,9,349.7765388921894,0.41858164983164986,0.21619547429603325,0.20558507614290147,131461.6224500866,196.43825954859048,131658.0607096352,3337,4,974.3555555555556,39,6,21,34.65221347553751,0.6295405982905984,43.61979166666666,1025.5208333333317,26.29540598290594,0
3439,4,0,0,45,0.0,0.0,1.0,45,1600,1200,400,0.75,20,12,8,352.35673246177737,0.41824494949494945,0.21040376349544831,0.20768171502190544,131568.4692382811,271.80718315970785,131840.27642144082,3338,5,975.3555555555556,39,6,17,34.47822536974989,0.6306089743589745,43.51562499999999,1025.9374999999989,26.306089743589716,0
3440,4,0,0,45,0.0,0.0,1.0,45,900,800,100,0.8888888888888888,10,8,2,354.5837753618144,0.41811868686868686,0.20922410584373852,0.209287284067659,131621.90890841995,334.19867621525844,131956.1075846352,3339,6,976.3555555555556,39,6,18,34.367175075288465,0.6311431623931625,43.46354166666666,1026.1458333333317,26.311431623931583,0
3441,4,1,0,46,0.021739130434782608,0.0,1.0,46,1150,700,450,0.6086956521739131,16,7,9,348.34269854797776,0.42063204508856683,0.21050061312737967,0.20669424361874994,131823.3827107706,-16.057426961481383,131807.3252838091,3340,0,956.1086956521739,40,6,19,34.32417944911758,0.6315104166666667,43.26727642276422,1026.930894308942,25.67327235772355,0
3442,4,0,0,46,0.0,0.0,1.0,46,1100,1000,100,0.9090909090909091,12,10,2,342.7707725626466,0.4204307568438003,0.20747547385670106,0.2039476009320652,131927.7662622279,-155.80352716640132,131771.9627350615,3341,1,957.1086956521739,40,6,19,34.36211956342531,0.6325520833333336,43.16565040650405,1027.3373983739814,25.683434959349533,0
3443,4,1,2,45,0.02127659574468085,0.0425531914893617,0.9574468085106383,47,1050,800,250,0.7619047619047619,13,8,5,341.90906102552253,0.4216389145852606,0.21158791500854823,0.20500701189425022,132219.3889853393,-358.5985725308804,131860.79041280842,3342,0,937.7234042553191,41,6,19,34.09084514967364,0.6338922764227644,42.881944444444436,1028.4722222222206,25.08468834688343,0
3444,4,0,1,44,0.0,0.022222222222222223,0.9777777777777777,45,850,600,250,0.7058823529411765,11,6,5,351.7506612969978,0.4183922558922559,0.22422706538266635,0.20966889871268163,131996.2904188367,285.956488715268,132282.24690755198,3343,3,979.3777777777777,39,6,19,34.062447203919575,0.6348824786324787,43.09895833333333,1027.6041666666658,26.348824786324766,0
3445,4,0,0,44,0.0,0.0,1.0,44,1300,900,400,0.6923076923076923,17,9,8,359.3133674214759,0.4174925123326286,0.2389434889434896,0.2144289450741063,132040.89506172814,688.8117283950355,132729.70679012316,3344,4,1002.25,38,6,19,33.82319819819819,0.637061403508772,43.05555555555554,1027.7777777777758,27.046783625730942,0
3446,4,0,0,44,0.0,0.0,1.0,44,1150,800,350,0.6956521739130435,15,8,7,359.66715466351843,0.416963971106413,0.24192443919716644,0.21541981105391175,132178.18737900854,708.0305126378651,132886.2178916464,3345,5,1003.25,38,6,20,33.67575757575756,0.6384320175438598,42.92200854700854,1028.3119658119647,27.06084120557802,0
3447,4,2,1,45,0.043478260869565216,0.021739130434782608,0.9782608695652174,46,1150,800,350,0.6956521739130435,15,8,7,347.08090977000546,0.4197161835748792,0.22881646802412847,0.21011457225861613,132581.09941998805,3.273720999391628,132584.37314098745,3346,0,960.5869565217391,40,6,21,33.59421255180579,0.6390625000000001,42.53048780487804,1029.8780487804872,25.74695121951218,0
3448,4,0,0,45,0.0,0.0,1.0,45,1100,700,400,0.6363636363636364,15,7,8,353.94905581993504,0.41746632996632993,0.22783005610082352,0.2136883639992926,132478.4193250869,378.12228732639414,132856.5416124133,3347,1,982.9333333333333,39,6,22,33.520628857634314,0.639690170940171,42.630208333333336,1029.4791666666674,26.396901709401728,0
3449,4,0,0,45,0.0,0.0,1.0,45,1400,900,500,0.6428571428571429,19,9,10,360.0189425534482,0.41769781144781143,0.23103342097160007,0.21624185141078442,132285.18029586028,536.1750956424069,132821.35539150267,3348,2,983.9333333333333,37,8,21,33.55894265615006,0.6413288288288288,42.81798245614035,1028.7280701754387,27.80346135609294,2
3450,4,0,2,43,0.0,0.044444444444444446,0.9555555555555556,45,1500,1200,300,0.8,18,12,6,355.16023295038656,0.4176136363636364,0.21092632077706708,0.21300530595106304,132228.78674207444,411.7180286241854,132640.50477069864,3349,3,984.9333333333333,37,8,17,33.74067164179104,0.6407657657657657,42.872807017543856,1028.5087719298242,27.797534376481735,3
3451,4,0,0,43,0.0,0.0,1.0,43,1250,1100,150,0.88,14,11,3,365.25374267061005,0.4174510889627168,0.221697396877929,0.21831653717364477,132100.37964034645,1050.0316143690109,133150.41125471547,3350,10,1024.953488372093,35,8,17,33.610579449073036,0.6434523809523809,42.99768518518519,1028.00925925926,29.371693121693145,0
3452,4,0,1,42,0.0,0.023255813953488372,0.9767441860465116,43,1400,900,500,0.6428571428571429,19,9,10,366.740094351469,0.4169435215946844,0.22173612710108181,0.2202422944997203,132278.9137517149,1102.3962620027623,133381.31001371765,3351,11,1025.953488372093,35,8,17,33.39240174017401,0.6452380952380952,42.82407407407408,1028.7037037037053,29.391534391534435,0
3453,4,0,0,42,0.0,0.0,1.0,42,950,700,250,0.7368421052631579,12,7,5,366.0672390773942,0.416545683313976,0.22348347157507464,0.2207125069081696,132428.6352040817,1295.6105564653892,133724.24576054708,3352,12,1041.047619047619,34,8,18,33.25887693731205,0.6488970588235294,42.67857142857143,1029.2857142857147,30.27310924369749,0
3454,4,0,1,41,0.0,0.023809523809523808,0.9761904761904762,42,1200,800,400,0.6666666666666666,16,8,8,402.49694032370667,0.4166545683313976,0.2323915474718934,0.23028290291504866,130423.75299714321,2119.9967328146513,132543.74972995787,3353,13,1042.047619047619,32,10,19,34.35542851256696,0.6334635416666666,44.63383838383839,1021.464646464647,31.92077020202022,6
3455,4,1,0,42,0.023809523809523808,0.0,1.0,42,1450,900,550,0.6206896551724138,20,9,11,401.71467764060355,0.4175982384823848,0.2382716049382716,0.231758467869579,130746.38429752068,2104.548324150602,132850.9326216713,3354,0,1042.2380952380952,32,10,16,34.04706790123457,0.63671875,44.31818181818182,1022.7272727272729,31.960227272727277,0
3456,4,0,0,42,0.0,0.0,1.0,42,800,500,300,0.625,11,5,6,401.4800430090415,0.41738046844754156,0.23928556733148798,0.23181680886787204,130778.6693481532,2101.0051589123505,132879.67450706556,3355,1,1043.2380952380952,32,10,17,34.02023412747397,0.6370442708333334,44.28661616161616,1022.853535353535,31.96417297979797,0
3457,4,0,0,42,0.0,0.0,1.0,42,850,700,150,0.8235294117647058,10,7,3,401.9751621603803,0.41652148664343785,0.24460958022601909,0.2324914160589265,130843.25140610656,2119.1474403122193,132962.39884641877,3356,2,1044.2380952380952,32,10,17,33.94190423300011,0.6376953125,44.22348484848485,1023.1060606060609,31.9720643939394,0
3458,4,0,0,42,0.0,0.0,1.0,42,1200,900,300,0.75,15,9,6,403.8337975841773,0.4167876500193573,0.2407120242941141,0.23435079434609346,130972.46334876542,2178.2214506172822,133150.6847993827,3357,3,1045.2380952380952,32,10,17,33.76300316598823,0.6389973958333334,44.09722222222222,1023.6111111111111,31.98784722222222,0
3459,4,0,0,42,0.0,0.0,1.0,42,950,500,450,0.5263157894736842,14,5,9,403.21260838562233,0.41594076655052264,0.24026187540367538,0.23458064949837862,131069.41415416797,2169.7680721354973,133239.18222630347,3358,4,1046.2380952380952,32,10,17,33.680384299219064,0.6399739583333334,44.00252525252525,1023.9898989898992,31.99968434343435,0
3460,4,0,0,42,0.0,0.0,1.0,42,1100,800,300,0.7272727272727273,14,8,6,398.85419289851444,0.41586817653890823,0.24258373205741668,0.23285063216700974,131202.54229142627,2066.1368223759996,133268.67911380227,3359,5,1047.2380952380952,33,9,17,33.656798245614034,0.638888888888889,43.87254901960784,1024.509803921568,31.045751633986907,0
3461,4,0,0,42,0.0,0.0,1.0,42,1200,800,400,0.6666666666666666,16,8,8,397.82314315473695,0.4150575880758807,0.24665540560355192,0.23320766059735082,131360.48179076108,2051.708023513057,133412.18981427414,3360,6,1048.2380952380952,32,10,18,33.52296054522314,0.6429036458333334,43.71843434343434,1025.1262626262621,32.03519570707069,0
3462,4,1,1,42,0.023255813953488372,0.023255813953488372,0.9767441860465116,43,950,700,250,0.7368421052631579,12,7,5,389.8503843701336,0.41643595422665186,0.23730037093800682,0.2306064138053842,131705.23356401388,1669.0671856978092,133374.3007497117,3361,0,1024.8372093023256,33,10,16,33.37810410697231,0.6439393939393939,43.38235294117647,1026.4705882352944,31.105169340463465,0
3463,4,0,0,42,0.0,0.0,1.0,42,1150,700,450,0.6086956521739131,16,7,9,404.28769448528806,0.4139082462253194,0.24766415361814542,0.23901488497970222,131684.2689043209,2247.665895061716,133931.9347993826,3362,8,1050.2380952380952,32,10,17,33.02886783942263,0.6461588541666667,43.40277777777777,1026.3888888888882,32.07465277777776,0
3464,4,0,0,42,0.0,0.0,1.0,42,1350,1000,350,0.7407407407407407,17,10,7,407.45137583296366,0.4139082462253194,0.2496165419696279,0.24191310153469528,131846.31191970196,2344.1922380369206,134190.50415773888,3363,9,1051.2380952380952,32,10,18,32.78342963691501,0.6477864583333335,43.24494949494949,1027.0202020202012,32.09438131313129,0
3465,4,0,0,42,0.0,0.0,1.0,42,1000,800,200,0.8,12,8,4,409.03564270040965,0.41370257452574527,0.24843967402106948,0.2437643115879839,131988.41979346875,2397.593623846588,134386.01341731535,3364,10,1052.2380952380952,33,9,18,32.59876267143709,0.6467803030303031,43.10661764705882,1027.573529411764,31.138591800356483,0
3466,4,0,0,42,0.0,0.0,1.0,42,800,600,200,0.75,10,6,4,411.0989727540451,0.4135452961672474,0.2500312163005851,0.2460142925396887,132145.8768862936,2465.0068483275504,134610.88373462117,3365,11,1053.2380952380952,33,9,18,32.386273341279306,0.6483585858585859,42.95343137254901,1028.1862745098028,31.157159833630388,0
3467,4,1,1,42,0.023255813953488372,0.023255813953488372,0.9767441860465116,43,1200,900,300,0.75,15,9,6,406.0056712943992,0.41569767441860467,0.24385651068637593,0.24459366051150394,132398.00347222228,2151.3486399461785,134549.35211216845,3366,0,1029.7209302325582,32,11,18,32.26214574898786,0.6533203125,42.708333333333336,1029.166666666667,32.16145833333334,0
3468,4,1,0,43,0.023255813953488372,0.0,1.0,43,1200,900,300,0.75,15,9,6,408.8551258420005,0.41555924695459584,0.25542906506325025,0.247589551706993,132592.99314164364,2242.264979338836,134835.25812098247,3367,0,1030.6976744186047,32,11,19,31.991694250337133,0.6552734375,42.51893939393939,1029.9242424242418,32.18513257575756,0
3469,4,1,2,42,0.022727272727272728,0.045454545454545456,0.9545454545454546,44,1800,1500,300,0.8333333333333334,21,15,6,401.2403318320544,0.4180540873854827,0.2453978715812013,0.24510181624324778,132919.22477324257,1866.5107709750503,134785.73554421763,3368,0,1008.25,34,10,16,31.858500731162927,0.6537990196078431,42.20238095238095,1031.1904761904757,30.32913165266105,0
3470,4,1,1,42,0.023255813953488372,0.023255813953488372,0.9767441860465116,43,800,600,200,0.75,10,6,4,407.23410732242337,0.41562846068660025,0.2443996120896923,0.24774600612018366,132765.8180980724,2213.353883219937,134979.17198129234,3369,0,1031.860465116279,34,9,16,31.85885218127911,0.6522671568627452,42.35119047619047,1030.595238095237,30.31162464985991,0
3471,4,1,1,42,0.023255813953488372,0.023255813953488372,0.9767441860465116,43,700,400,300,0.5714285714285714,10,4,6,406.8378843153622,0.41812015503875966,0.247766550092132,0.24770762323504933,132796.4923469386,2205.328798185923,135001.82114512453,3370,0,1032.8372093023256,34,9,16,31.83808808808808,0.6525735294117647,42.32142857142856,1030.7142857142844,30.31512605042013,0
3472,4,0,0,42,0.0,0.0,1.0,42,800,400,400,0.5,12,4,8,411.6437149741637,0.4136178861788618,0.25207735050723024,0.24986922106771087,132681.93310565647,2523.536770713182,135205.46987636967,3371,4,1058.4285714285713,33,9,17,31.829997819277573,0.6537247474747474,42.432598039215684,1030.2696078431372,31.220291146761735,0
3473,4,0,0,42,0.0,0.0,1.0,42,750,500,250,0.6666666666666666,10,5,5,408.6539861808815,0.4135090011614402,0.2452126153671932,0.2486816225601456,132776.64389898113,2451.940960207604,135228.58485918873,3372,5,1059.4285714285713,33,9,17,31.81133571145461,0.6546717171717171,42.3406862745098,1030.6372549019604,31.231431966726074,0
3474,4,0,1,41,0.0,0.023809523809523808,0.9761904761904762,42,1150,1000,150,0.8695652173913043,13,10,3,409.5532495494135,0.4135090011614402,0.22763377807994134,0.24818277306869646,132618.81134960108,2462.893027921951,135081.70437752304,3373,6,1060.4285714285713,33,9,19,31.94762542137616,0.6530934343434343,42.493872549019606,1030.0245098039213,31.212863933452162,1
3475,4,0,1,40,0.0,0.024390243902439025,0.975609756097561,41,1150,900,250,0.782608695652174,14,9,5,426.3300173010381,0.40940040650406506,0.24173242467718792,0.25884322478991595,132690.54178145083,3113.9921946740096,135804.53397612483,3374,7,1086.8292682926829,32,9,16,31.443014705882348,0.65625,42.42424242424242,1030.30303030303,32.19696969696969,0
3476,4,0,0,40,0.0,0.0,1.0,40,900,600,300,0.6666666666666666,12,6,6,433.57493674891833,0.4079861111111111,0.2560240202275601,0.26260166536630514,132599.0888807509,3498.3283148871587,136097.41719563806,3375,8,1113.45,31,9,20,31.349030762747585,0.6579301075268817,42.513020833333336,1029.947916666667,33.22412634408603,0
3477,4,0,0,40,0.0,0.0,1.0,40,1400,1000,400,0.7142857142857143,18,10,8,433.65243925832004,0.4079594017094017,0.25856086461888506,0.26288309938487125,132632.61795043945,3503.2916598849833,136135.90961032442,3376,9,1114.45,31,9,16,31.313071461677833,0.658266129032258,42.48046875,1030.078125,33.228326612903224,0
3478,4,0,0,40,0.0,0.0,1.0,40,800,600,200,0.75,10,6,4,432.8404239943813,0.407545405982906,0.2566654030831437,0.26309517016064016,132733.2305908203,3490.46156141493,136223.69215223525,3377,10,1115.45,31,9,17,31.232099233426002,0.6592741935483871,42.3828125,1030.46875,33.24092741935484,0
3479,4,0,0,40,0.0,0.0,1.0,40,700,600,100,0.8571428571428571,8,6,2,431.1578672052659,0.40727831196581193,0.2551212938005394,0.2622288012018913,132755.59413580253,3447.7237654321057,136203.31790123464,3378,11,1116.45,32,8,17,31.252807726864344,0.6569010416666666,42.361111111111114,1030.5555555555559,32.20486111111112,0
3480,4,1,1,40,0.024390243902439025,0.024390243902439025,0.975609756097561,41,1000,700,300,0.7,13,7,6,421.67892227732045,0.41148373983739833,0.24732217379207966,0.2579105966486869,132966.16685890054,3013.805988081521,135979.97284698207,3379,0,1090.1951219512196,33,8,17,31.284161121672998,0.6565656565656566,42.156862745098046,1031.3725490196089,31.253713606654813,0
3481,4,0,0,40,0.0,0.0,1.0,40,950,700,250,0.7368421052631579,12,7,5,428.8399584653478,0.4076388888888889,0.2542467850581758,0.26149949670422445,132853.20255905014,3394.5523734823055,136247.75493253244,3380,13,1118.45,32,8,18,31.213768115942035,0.6578776041666666,42.266414141414145,1030.9343434343439,32.216698232323246,0
3482,4,0,0,40,0.0,0.0,1.0,40,1100,800,300,0.7272727272727273,14,8,6,426.23348203013234,0.4071581196581197,0.25988073394495426,0.26218650982666136,133178.8230314508,3353.0546946740033,136531.8777261248,3381,14,1119.45,32,8,18,30.951834862385322,0.6611328125,41.95075757575757,1032.196969696969,32.25615530303028,0
3483,4,0,0,40,0.0,0.0,1.0,40,1450,1100,350,0.7586206896551724,18,11,7,424.1808319548879,0.40630341880341886,0.2561812179016878,0.2616101692101864,133276.58689164364,3306.6747015610563,136583.2615932047,3382,15,1120.45,32,8,18,30.90608950843727,0.662109375,41.8560606060606,1032.575757575757,32.26799242424241,0
3484,4,0,0,40,0.0,0.0,1.0,40,1150,900,250,0.782608695652174,14,9,5,430.41581340561874,0.4056623931623931,0.2591175751649968,0.26638897014256974,133406.9945031119,3484.0960106111606,136891.09051372306,3383,16,1121.45,32,8,18,30.61344007170211,0.6634114583333334,41.72979797979798,1033.0808080808079,32.283775252525245,0
3485,4,0,0,40,0.0,0.0,1.0,40,1050,800,250,0.7619047619047619,13,8,5,429.2858674710681,0.4049412393162393,0.2628852906749901,0.2664067017744184,133506.94670265348,3462.5609702340353,136969.50767288753,3384,17,1122.45,30,10,18,30.54173711362552,0.6697916666666668,41.63306451612903,1033.467741935484,34.4489247311828,0
3486,4,0,0,40,0.0,0.0,1.0,40,1150,900,250,0.782608695652174,14,9,5,430.008835926462,0.4046340811965812,0.26402248797608263,0.2678589453264995,133645.88978855926,3493.7826988669076,137139.67248742617,3385,18,1123.45,30,10,18,30.382869708392917,0.6711805555555556,41.49865591397849,1034.005376344085,34.46684587813617,0
3487,4,0,0,40,0.0,0.0,1.0,40,800,500,300,0.625,11,5,6,431.2477308189368,0.40400641025641026,0.26799636174636166,0.2693898162648162,133750.14452537856,3535.8892646548593,137286.03379003343,3386,19,1124.45,30,10,16,30.245690401940404,0.6722222222222223,41.397849462365585,1034.4086021505368,34.480286738351225,0
3488,4,0,0,40,0.0,0.0,1.0,40,1150,900,250,0.782608695652174,14,9,5,395.838349374222,0.4043002136752137,0.23440160832544965,0.25053960196919306,134233.10745866972,2640.092212692546,136873.19967136226,3387,20,1125.45,33,7,18,30.676442762535476,0.6691919191919192,40.931372549019606,1036.2745098039213,31.4022578728461,2
3489,4,0,0,40,0.0,0.0,1.0,40,1450,800,650,0.5517241379310345,21,8,13,393.68341935688534,0.40439369658119656,0.2352611315701374,0.2507318493857176,134460.73555651997,2586.9924286265323,137047.7279851465,3388,21,1126.45,35,5,18,30.504059256779378,0.6669642857142857,40.71180555555555,1037.152777777777,29.632936507936485,0
3490,4,0,0,40,0.0,0.0,1.0,40,500,200,300,0.4,8,2,6,397.4701354766915,0.40409989316239314,0.23692123173044788,0.2535604857137072,134520.7626698602,2693.59715256344,137214.35982242366,3389,22,1127.45,35,5,18,30.34570363345607,0.6675595238095238,40.65393518518518,1037.384259259259,29.639550264550255,0
3491,4,0,0,40,0.0,0.0,1.0,40,1050,900,150,0.8571428571428571,12,9,3,366.3074329648743,0.40411324786324787,0.17350462207721606,0.2305405096585911,134025.53471968576,1828.079421584047,135853.61414126982,3390,23,1128.45,36,4,16,31.649220590900853,0.6605902777777779,41.13175675675675,1035.472972972972,28.76313813813811,3
3492,4,0,0,40,0.0,0.0,1.0,40,1500,1100,400,0.7333333333333333,19,11,8,362.9078867927043,0.40292467948717947,0.16927298413388403,0.2296752664557403,134229.67519884746,1742.6015542569558,135972.2767531044,3391,24,1129.45,36,4,18,31.533000072448033,0.6626157407407407,40.93468468468468,1036.2612612612609,28.785035035035023,0
3493,4,0,0,40,0.0,0.0,1.0,40,950,700,250,0.7368421052631579,12,7,5,364.39714720712664,0.40225694444444443,0.16711755758365943,0.2309856296759223,134288.0295836376,1786.8349768687474,136074.86456050634,3392,25,1130.45,36,4,18,31.43606040851802,0.6631944444444444,40.87837837837837,1036.4864864864858,28.791291291291273,0
3494,4,0,0,40,0.0,0.0,1.0,40,850,500,350,0.5882352941176471,12,5,7,364.6431204730445,0.40189636752136754,0.16995926127104877,0.2313259768404115,134317.21153163278,1795.569429226506,136112.7809608593,3393,26,1131.45,36,4,18,31.40050697084918,0.6634837962962964,40.850225225225216,1036.5990990990977,28.79441941941938,0
3495,4,0,0,40,0.0,0.0,1.0,40,850,500,350,0.5882352941176471,12,5,7,364.56767560182686,0.4014690170940171,0.1684629167119125,0.2320182256128003,134433.9710276154,1802.056067892208,136236.0270955076,3394,27,1132.45,36,4,19,31.28574401853259,0.6646412037037038,40.73761261261261,1037.049549549549,28.806931931931917,0
3496,4,0,0,40,0.0,0.0,1.0,40,1100,900,200,0.8181818181818182,13,9,4,364.6375618659425,0.40089476495726495,0.16731353816089478,0.2324343655603594,134492.36979800728,1808.1939625436069,136300.5637605509,3395,28,1133.45,36,4,20,31.225572684833352,0.6652199074074074,40.6813063063063,1037.2747747747733,28.813188188188146,0
3497,4,1,1,40,0.024390243902439025,0.024390243902439025,0.975609756097561,41,1350,1200,150,0.8888888888888888,15,12,3,357.36491727359396,0.4034806910569106,0.1610110537717464,0.2296349757616591,134784.5538739752,1433.4668705867934,136218.020744562,3396,0,1106.780487804878,36,5,16,31.122573473592897,0.668113425925926,40.39977477477477,1038.4009009008998,28.84446946946944,0
3498,4,0,0,40,0.0,0.0,1.0,40,1150,600,550,0.5217391304347826,17,6,11,361.86075702255255,0.3996527777777778,0.1669071382078542,0.23196331420263483,134696.86536198354,1748.3019336904376,136445.16729567398,3397,30,1135.45,36,4,20,31.093377088305466,0.6672453703703705,40.48423423423423,1038.0630630630626,28.835085085085073,0
3499,4,0,0,40,0.0,0.0,1.0,40,900,500,400,0.5555555555555556,13,5,8,359.6190290075581,0.39911858974358977,0.16097223728445997,0.2310834192668077,134784.5538739752,1694.2180778751624,136478.77195185036,3398,31,1136.45,36,4,16,31.064056682210904,0.668113425925926,40.39977477477477,1038.4009009008998,28.84446946946944,0
3500,4,0,0,40,0.0,0.0,1.0,40,850,500,350,0.5882352941176471,12,5,7,360.76375161027795,0.39938568376068373,0.1624335899381979,0.23219288772516347,134843.02873397042,1729.2953849119335,136572.32411888236,3399,32,1137.45,36,4,16,30.976002023925695,0.6686921296296298,40.343468468468465,1038.6261261261259,28.85072572572572,0
3501,4,0,0,40,0.0,0.0,1.0,40,1200,1100,100,0.9166666666666666,13,11,2,365.1461160128194,0.39887820512820515,0.1683340559288964,0.23558308156183722,134930.7648019642,1853.8889396152986,136784.6537415795,3400,33,1138.45,36,4,16,30.774667606040893,0.6695601851851851,40.25900900900901,1038.9639639639645,28.860110110110124,0
3502,4,0,0,40,0.0,0.0,1.0,40,1000,700,300,0.7,13,7,6,366.5852929603609,0.3989316239316239,0.1737110051993065,0.2376626000428408,135106.32253875505,1905.5981657333089,137011.92070448835,3401,34,1139.45,36,4,19,30.562175043327564,0.6712962962962963,40.090090090090094,1039.63963963964,28.878878878878893,0
3503,4,0,0,40,0.0,0.0,1.0,40,700,400,300,0.5714285714285714,10,4,6,365.61590110037287,0.3991319444444445,0.17013159319831028,0.23722639598452167,135135.5932579539,1881.5443399480596,137017.13759790198,3402,35,1140.45,36,4,19,30.5581880212282,0.6715856481481481,40.06193693693694,1039.7522522522524,28.88200700700701,0
3504,4,0,0,40,0.0,0.0,1.0,40,1150,900,250,0.782608695652174,14,9,5,365.92244696162686,0.3988247863247863,0.17316439246263804,0.23761799403963899,135164.86714755307,1891.9717859751763,137056.83893352826,3403,36,1141.45,36,4,19,30.521036387264452,0.671875,40.03378378378379,1039.864864864866,28.885135135135165,0
3505,4,0,0,40,0.0,0.0,1.0,40,950,700,250,0.7368421052631579,12,7,5,363.2081801491911,0.3985309829059829,0.17087031825070365,0.2366232135555874,135281.99440995057,1827.105399318244,137109.0998092688,3404,37,1142.45,36,4,19,30.474895359745965,0.6730324074074073,39.921171171171174,1040.315315315316,28.897647647647666,0
3506,4,0,0,40,0.0,0.0,1.0,40,1200,900,300,0.75,15,9,6,363.4674211381593,0.3979567307692307,0.16500324569944858,0.23775862516489787,135428.4748219504,1844.7676984416967,137273.2425203921,3405,38,1143.45,36,4,19,30.322270907713946,0.6744791666666665,39.78040540540541,1040.878378378379,28.913288288288307,0
3507,4,0,0,40,0.0,0.0,1.0,40,1050,700,350,0.6666666666666666,14,7,7,364.78428703559547,0.3979433760683761,0.1635434688581312,0.239596952166562,135575.03449395366,1891.128459540652,137466.16295349432,3406,39,1144.45,36,4,19,30.142102797001154,0.6759259259259258,39.639639639639654,1041.4414414414434,28.928928928928983,0
3508,4,0,0,40,0.0,0.0,1.0,40,950,600,350,0.631578947368421,13,6,7,363.84000000000003,0.39747596153846154,0.16500000000000004,0.23936842105263167,135633.6805555557,1869.7916666666865,137503.4722222224,3407,40,1145.45,36,4,19,30.108333333333338,0.6765046296296295,39.58333333333334,1041.6666666666679,28.93518518518522,0
3509,4,0,0,40,0.0,0.0,1.0,40,900,500,400,0.5555555555555556,13,5,8,361.65250597307903,0.3974358974358974,0.16079915457557425,0.2385489363061312,135726.70245181408,1817.1804138322032,137543.88286564627,3408,41,1146.45,34,6,20,30.072784569100126,0.6816789215686274,39.49404761904762,1042.0238095238096,30.64775910364146,0
3510,4,0,0,40,0.0,0.0,1.0,40,1000,800,200,0.8,12,8,4,362.91899448173706,0.3972222222222222,0.1638635065676759,0.23980043748585714,135788.73476473923,1856.06221655329,137644.79698129251,3409,42,1147.45,34,6,20,29.978107747953562,0.6822916666666666,39.43452380952381,1042.2619047619048,30.654761904761905,0
3511,4,0,0,40,0.0,0.0,1.0,40,850,600,250,0.7058823529411765,11,6,5,362.22980049214016,0.3967280982905983,0.16133093525179842,0.2397616298495596,135850.78125000012,1841.8402777777933,137692.6215277779,3410,43,1148.45,34,6,20,29.934385824673605,0.6829044117647058,39.37500000000001,1042.500000000001,30.66176470588238,0
3512,4,0,0,40,0.0,0.0,1.0,40,950,600,350,0.631578947368421,13,6,7,357.3220614857068,0.39627403846153847,0.15449400798934776,0.23747687449182808,135995.6114969136,1718.8464506172909,137714.4579475309,3411,44,1149.45,35,5,19,29.91844207723038,0.6821428571428572,39.236111111111114,1043.0555555555557,29.801587301587304,0
3513,4,0,0,40,0.0,0.0,1.0,40,750,700,50,0.9333333333333333,8,7,1,358.2381945713812,0.3960202991452992,0.1594353228311518,0.2384903313047585,136055.98020618997,1748.089741941014,137804.069948131,3412,45,1150.45,35,5,19,29.8346091265439,0.6827380952380953,39.17824074074074,1043.287037037037,29.808201058201057,0
3514,4,0,0,40,0.0,0.0,1.0,40,650,300,350,0.46153846153846156,10,3,7,360.9771194944095,0.395713141025641,0.16354940667627815,0.2409275119527085,136146.55838745294,1829.1584951560467,137975.71688260898,3413,46,1151.45,35,5,19,29.67323296735796,0.6836309523809523,39.09143518518519,1043.63425925926,29.818121693121714,0
3515,4,0,0,40,0.0,0.0,1.0,40,1000,600,400,0.6,14,6,8,358.44419776977537,0.395045405982906,0.1618473561689393,0.24005383133490318,136267.37618152014,1768.850067515444,138036.2262490356,3414,47,1152.45,35,5,20,29.61942966411707,0.6848214285714285,38.97569444444445,1044.0972222222229,29.831349206349223,0
3516,4,0,1,39,0.0,0.025,0.975,40,900,600,300,0.6666666666666666,12,6,6,357.4526821490827,0.39487179487179486,0.16168320034505057,0.2398709243307231,136338.4224596218,1746.9069576333104,138085.3294172551,3415,48,1153.45,36,4,20,29.574841851771986,0.6834490740740741,38.90765765765766,1044.3693693693695,29.010260260260264,0
3517,4,0,0,39,0.0,0.0,1.0,39,900,700,200,0.7777777777777778,11,7,4,363.4412513444685,0.3912505623031939,0.17170563124896998,0.2436082444004305,136297.5890024863,2107.233260459535,138404.82226294582,3416,76,1182.7948717948718,35,4,20,29.45900761102491,0.6851190476190476,38.94675925925926,1044.2129629629628,29.834656084656082,0
3518,4,0,0,39,0.0,0.0,1.0,39,750,400,350,0.5333333333333333,11,4,7,362.4917868528015,0.3916722896986055,0.17117877137817317,0.244012927659973,136448.70334201382,2092.306857638879,138541.0101996527,3417,77,1183.7948717948718,35,4,20,29.333873379860417,0.6866071428571429,38.80208333333333,1044.791666666666,29.85119047619046,0
3519,4,0,0,39,0.0,0.0,1.0,39,1250,800,450,0.64,17,8,9,364.2299753865852,0.3915317139001349,0.17119005025981804,0.24581440042906305,136539.41213348767,2146.349344135804,138685.76147762348,3418,78,1184.7948717948718,35,4,20,29.198504983388702,0.6875,38.71527777777778,1045.138888888889,29.86111111111111,0
3520,4,0,0,39,0.0,0.0,1.0,39,1400,1300,100,0.9285714285714286,15,13,2,365.3582517995014,0.3907726045883941,0.16398449163558748,0.2474247711211916,136660.40407450276,2186.001264574762,138846.40533907752,3419,79,1185.7948717948718,35,4,20,29.049055420264178,0.6886904761904762,38.59953703703704,1045.6018518518522,29.874338624338634,0
3521,4,0,0,39,0.0,0.0,1.0,39,850,600,250,0.7058823529411765,11,6,5,367.7719401279342,0.39032276203328836,0.1644703238328733,0.24948853235705834,136720.920138889,2256.423611111121,138977.34375000012,3420,80,1186.7948717948718,35,4,20,28.925962815405036,0.6892857142857143,38.54166666666667,1045.8333333333342,29.880952380952404,0
3522,4,0,0,39,0.0,0.0,1.0,39,1150,800,350,0.6956521739130435,15,8,7,370.5805778215412,0.3886920827710301,0.16294636997628742,0.25273652906355054,136907.7398667799,2347.069869614503,139254.8097363944,3421,81,1187.7948717948718,34,5,21,28.66733970348462,0.6933210784313726,38.363095238095234,1046.5476190476181,30.780812324929943,0
3523,4,0,0,39,0.0,0.0,1.0,39,700,500,200,0.7142857142857143,9,5,4,373.2818326883511,0.3881860098965362,0.16545080270347445,0.2552597540172129,137001.19756235823,2428.0116213151814,139429.2091836734,3422,82,1188.7948717948718,34,5,18,28.504046319460233,0.6942401960784315,38.27380952380952,1046.9047619047615,30.791316526610633,0
3524,4,0,0,39,0.0,0.0,1.0,39,750,600,150,0.8,9,6,3,374.40072082043173,0.3875674763832659,0.16541901330441577,0.2564819891227817,137063.52040816325,2463.3361678004567,139526.8565759637,3423,83,1189.7948717948718,34,5,18,28.41300970137943,0.6948529411764706,38.214285714285715,1047.142857142857,30.798319327731093,0
3525,4,0,0,39,0.0,0.0,1.0,39,950,600,350,0.631578947368421,13,6,7,375.2624028604002,0.387089518668466,0.16774949502015524,0.2573018985162075,137094.68714569166,2489.296343537416,139583.98348922908,3424,84,1190.7948717948718,34,5,18,28.359573339396004,0.6951593137254901,38.18452380952381,1047.261904761905,30.801820728291325,0
3526,4,0,0,39,0.0,0.0,1.0,39,1050,900,150,0.8571428571428571,12,9,3,373.58963203927726,0.3864428699955016,0.16173973324944568,0.25753402747390436,137281.76197562367,2457.408588435387,139739.17056405905,3425,85,1191.7948717948718,34,5,19,28.21812639630429,0.6969975490196079,38.00595238095239,1047.9761904761913,30.822829131652686,0
3527,4,0,0,39,0.0,0.0,1.0,39,700,500,200,0.7142857142857143,9,5,4,373.58963203927726,0.38621794871794873,0.16173973324944568,0.25753402747390436,137281.76197562367,2457.408588435387,139739.17056405905,3426,86,1192.7948717948718,34,5,19,28.21812639630429,0.6969975490196079,38.00595238095239,1047.9761904761913,30.822829131652686,0
3528,4,0,0,39,0.0,0.0,1.0,39,700,600,100,0.8571428571428571,8,6,2,359.2311784119981,0.3866959064327486,0.1328415174569031,0.2381393440996089,135905.0835503469,1973.849162060623,137878.93271240752,3427,87,1193.7948717948718,35,4,16,29.958583083583083,0.6812500000000001,39.32291666666665,1042.7083333333308,29.791666666666593,3
3529,4,0,0,39,0.0,0.0,1.0,39,900,500,400,0.5555555555555556,13,5,8,360.15223514697414,0.3866959064327486,0.13006548218440872,0.2397645677706661,136055.98020618974,2000.173075274319,138056.15328146407,3428,88,1194.7948717948718,35,4,17,29.784686783521916,0.6827380952380954,39.178240740740726,1043.287037037035,29.808201058200996,0
3530,4,0,0,39,0.0,0.0,1.0,39,850,500,350,0.5882352941176471,12,5,7,358.8435375140267,0.386555330634278,0.12912671067015347,0.2390140456554605,136073.93024358802,1965.850098409194,138039.78034199722,3429,89,1195.7948717948718,36,3,17,29.80099838100376,0.6808449074074076,39.16103603603602,1043.3558558558545,28.98210710710707,0
3531,4,0,0,39,0.0,0.0,1.0,39,800,600,200,0.75,10,6,4,357.6040925092551,0.38630229419703105,0.12974076748761165,0.23858294638468408,136132.68409879453,1936.3209915996865,138069.00509039423,3430,90,1196.7948717948718,36,3,17,29.77500809323405,0.6814236111111113,39.10472972972972,1043.5810810810794,28.98836336336332,0
3532,4,0,0,39,0.0,0.0,1.0,39,800,600,200,0.75,10,6,4,357.5922609384765,0.3855994152046784,0.13066135590407435,0.23916884984846146,136220.8386596055,1942.303536644746,138163.14219625026,3431,91,1197.7948717948718,36,3,17,29.687837108953616,0.6822916666666667,39.02027027027027,1043.9189189189185,28.997747747747738,0
3533,4,0,0,39,0.0,0.0,1.0,39,1650,1300,350,0.7878787878787878,20,13,7,357.54013866048894,0.3860773729194782,0.13557222185349893,0.23953122584248923,136279.62421881326,1945.0871479587522,138224.711366772,3432,92,1198.7948717948718,36,3,17,29.630877911993082,0.6828703703703705,38.963963963963955,1044.144144144143,29.00400400400397,0
3534,4,0,0,39,0.0,0.0,1.0,39,800,500,300,0.625,11,5,6,357.07744058819674,0.3855994152046784,0.1366950031100973,0.2398184838128547,136367.82633562604,1938.7748813002013,138306.60121692624,3433,93,1199.7948717948718,36,3,17,29.555480682839168,0.683738425925926,38.879504504504496,1044.481981981981,29.013388388388364,0
3535,4,0,0,39,0.0,0.0,1.0,39,750,600,150,0.8,9,6,3,357.96635439916355,0.3853182636077373,0.13679636448071153,0.24061564517439418,136397.23338203062,1965.1240767794743,138362.3574588101,3434,94,1200.7948717948718,36,3,17,29.503108380048868,0.6840277777777779,38.85135135135135,1044.5945945945941,29.016516516516504,0
3536,4,0,0,39,0.0,0.0,1.0,39,850,800,50,0.9411764705882353,9,8,1,357.96635439916355,0.3849527665317139,0.13679636448071153,0.24061564517439418,136397.23338203062,1965.1240767794743,138362.3574588101,3435,95,1201.7948717948718,36,3,17,29.503108380048868,0.6840277777777779,38.85135135135135,1044.5945945945941,29.016516516516504,0
3537,4,0,0,39,0.0,0.0,1.0,39,1500,1300,200,0.8666666666666667,17,13,4,361.0012431248881,0.38433423301844355,0.1352584132456991,0.24366927545033332,136544.31617005504,2058.533575805517,138602.84974586056,3436,96,1202.7948717948718,36,3,19,29.278005243687815,0.6854745370370372,38.71058558558558,1045.1576576576565,29.032157157157126,0
3538,4,0,0,39,0.0,0.0,1.0,39,1200,700,500,0.5833333333333334,17,7,10,360.7884008143952,0.3844748088169141,0.141181668806871,0.24434137866970515,136662.03946767707,2061.215734315387,138723.25520199246,3437,97,1203.7948717948718,36,3,20,29.166891042900744,0.6866319444444444,38.59797297297297,1045.6081081081074,29.044669669669652,0
3539,4,0,0,39,0.0,0.0,1.0,39,550,400,150,0.7272727272727273,7,4,3,369.5286322087073,0.3844748088169141,0.1352974524324133,0.22987010330232183,133595.26643990926,2193.965294755586,135789.23173466485,3438,98,1204.7948717948718,34,5,19,31.997063565177335,0.6605392156862746,41.547619047619044,1033.8095238095234,30.406162464985982,8
3540,4,0,0,39,0.0,0.0,1.0,39,700,700,0,1.0,7,7,0,369.5286322087073,0.3845310391363023,0.1352974524324133,0.22987010330232183,133595.26643990926,2073.4552154194935,135668.72165532876,3439,99,1205.7948717948718,34,5,19,31.997063565177335,0.6605392156862746,41.547619047619044,1033.8095238095234,30.406162464985982,0
3541,4,0,0,39,0.0,0.0,1.0,39,450,200,250,0.4444444444444444,7,2,5,370.83438150133486,0.38467161493477287,0.13825782737699877,0.2308743084830888,133626.03635204062,2110.6257086167566,135736.66206065737,3440,100,1206.7948717948718,34,5,19,31.93245058530033,0.6608455882352942,41.51785714285713,1033.9285714285697,30.409663865546168,0
3542,4,0,0,39,0.0,0.0,1.0,39,750,500,250,0.6666666666666666,10,5,5,373.03532598916496,0.3845310391363023,0.14389546464583902,0.23301969428611446,133749.15143140577,2178.631660997721,135927.7830924035,3441,101,1207.7948717948718,34,5,16,31.752071584762344,0.6620710784313726,41.39880952380952,1034.404761904761,30.42366946778709,0
3543,4,0,0,39,0.0,0.0,1.0,39,950,700,250,0.7368421052631579,12,7,5,400.22473395465653,0.3847559604138551,0.16114238065457553,0.23441734417344173,131328.12500000012,2716.943027210898,134045.068027211,3442,102,1208.7948717948718,33,6,14,33.49424119241191,0.6401515151515151,43.75000000000001,1025.000000000001,31.060606060606087,8
3544,4,0,0,39,0.0,0.0,1.0,39,650,600,50,0.9230769230769231,7,6,1,399.8810973768894,0.3845872694556905,0.16196913268042956,0.23440822561721664,131359.53006355738,2705.638606545572,134065.16867010295,3443,103,1209.7948717948718,33,6,15,33.47118449890417,0.6404671717171717,43.719362745098046,1025.1225490196086,31.064319667260868,0
3545,4,1,1,39,0.025,0.025,0.975,40,1100,800,300,0.7272727272727273,14,8,6,393.4047957848506,0.3873263888888889,0.16351061361790964,0.2324566651447019,131663.90483276662,2359.4423185941246,134023.34715136074,3444,0,1180.525,34,6,12,33.32874183196071,0.6412377450980391,43.42261904761906,1026.3095238095252,30.18557422969192,0
3546,4,0,0,39,0.0,0.0,1.0,39,1150,900,250,0.782608695652174,14,9,5,404.0332331965835,0.3848403058929375,0.1729490701185432,0.23840523337244535,131610.9057363757,2835.035953719756,134445.94169009544,3445,105,1211.7948717948718,33,6,12,33.109772482981015,0.6429924242424241,43.47426470588237,1026.1029411764728,31.094028520499176,0
3547,4,0,0,39,0.0,0.0,1.0,39,1150,900,250,0.782608695652174,14,9,5,402.0435427915658,0.3848403058929375,0.17084221095682417,0.2378189770072147,131705.23356401408,2790.2477412533926,134495.4813052675,3446,106,1212.7948717948718,33,6,12,33.06520614453996,0.6439393939393938,43.382352941176485,1026.470588235296,31.105169340463515,0
3548,4,0,0,39,0.0,0.0,1.0,39,850,500,350,0.5882352941176471,12,5,7,401.2511505486584,0.38444669365721995,0.16792009868290192,0.2375463525191602,131736.68368235795,2771.899179402181,134508.58286176014,3447,107,1213.7948717948718,33,6,12,33.05367374955235,0.6442550505050504,43.351715686274524,1026.5931372549037,31.108882947118293,0
3549,4,0,0,39,0.0,0.0,1.0,39,850,500,350,0.5882352941176471,12,5,7,400.95479066160317,0.3845872694556905,0.1683206795988752,0.23776363701016115,131799.5951827424,2769.1358191561194,134568.73100189853,3448,108,1214.7948717948718,33,6,12,32.997548434578526,0.6448863636363635,43.2904411764706,1026.8382352941192,31.116310160427854,0
3550,4,1,0,40,0.025,0.0,1.0,40,800,700,100,0.875,9,7,2,391.2082665415822,0.3885149572649573,0.17155471916618392,0.23377739664958944,132091.88102324287,2335.0871598639715,134426.96818310683,3449,0,1185.4,34,6,13,32.95213279289711,0.6455269607843136,43.005952380952394,1027.9761904761924,30.234593837535073,0
3551,4,0,0,40,0.0,0.0,1.0,40,1100,700,400,0.6363636363636364,15,7,8,390.506450668786,0.38840811965811967,0.17151499363204836,0.23373556579530894,132153.07716836754,2321.325821995489,134474.40299036304,3450,1,1186.4,34,6,13,32.90832079039791,0.6461397058823528,42.946428571428584,1028.2142857142871,30.241596638655505,0
3552,4,0,0,40,0.0,0.0,1.0,40,1050,600,450,0.5714285714285714,15,6,9,389.43837750939014,0.3880208333333333,0.16884187984720467,0.23347384755750333,132214.28748582775,2297.863520408172,134512.15100623592,3451,2,1187.4,34,6,14,32.87393409731063,0.6467524509803921,42.886904761904766,1028.4523809523816,30.24859943977593,0
3553,4,0,0,40,0.0,0.0,1.0,40,600,500,100,0.8333333333333334,7,5,2,388.56202846364886,0.38784722222222223,0.17135416666666692,0.23313721707818935,132244.8979591837,2277.0691609977403,134521.96712018145,3452,3,1188.4,34,6,14,32.86554783950618,0.6470588235294117,42.85714285714286,1028.571428571429,30.252100840336144,0
3554,4,0,0,40,0.0,0.0,1.0,40,800,500,300,0.625,11,5,6,389.0779308984433,0.38788728632478636,0.16989701457995854,0.23382555485565698,132306.12953514743,2295.4790249433177,134601.60856009074,3453,4,1189.4,34,6,15,32.7904420273085,0.647671568627451,42.79761904761905,1028.809523809524,30.25910364145659,0
3555,4,0,1,39,0.0,0.025,0.975,40,850,700,150,0.8235294117647058,10,7,3,388.24318441361197,0.3879139957264957,0.1678331790837575,0.2337029307849069,132367.37528344677,2278.146258503407,134645.52154195018,3454,5,1190.4,34,6,15,32.75007712478791,0.6482843137254901,42.73809523809524,1029.0476190476195,30.266106442577044,0
3556,4,0,0,39,0.0,0.0,1.0,39,800,700,100,0.875,9,7,2,395.1875952728285,0.3881016644174539,0.18104432679331484,0.23807642934728943,132398.00347222228,2664.4097222222267,135062.4131944445,3455,6,1214.6666666666667,33,6,15,32.540485829959515,0.6508838383838383,42.708333333333336,1029.166666666667,31.186868686868696,0
3557,4,1,1,39,0.025,0.025,0.975,40,1150,900,250,0.782608695652174,14,9,5,384.51068107929916,0.3913595085470085,0.1739830116722525,0.2331584389193535,132643.15653344672,2200.5420918367345,134843.69862528346,3456,0,1185.275,34,6,13,32.567943680419134,0.6510416666666666,42.470238095238095,1030.1190476190475,30.297619047619044,0
3558,4,0,0,39,0.0,0.0,1.0,39,1250,900,350,0.72,16,9,7,388.6875563663731,0.3865834457939721,0.16746604181159164,0.2353407942149134,132587.25610342177,2507.003316032294,135094.25941945406,3457,8,1216.6666666666667,33,6,17,32.516757893066796,0.6527777777777778,42.52450980392157,1029.9019607843136,31.20915032679738,0
3559,4,0,0,39,0.0,0.0,1.0,39,600,200,400,0.3333333333333333,10,2,8,386.67355904982895,0.3863585245164192,0.1663739051940767,0.23490977489096534,132713.49961553246,2463.360246059203,135176.85986159166,3458,9,1217.6666666666667,33,6,13,32.441325721535044,0.6540404040404041,42.40196078431372,1030.3921568627447,31.22400475341651,0
3560,4,0,0,39,0.0,0.0,1.0,39,800,600,200,0.75,10,6,4,388.7524309745672,0.385768106162843,0.17917017203750452,0.23696996009841012,132839.80320069208,2528.359284890431,135368.16248558252,3459,10,1218.6666666666667,33,6,13,32.26046124583928,0.6553030303030303,42.279411764705884,1030.8823529411768,31.23885918003566,0
3561,4,0,0,39,0.0,0.0,1.0,39,850,500,350,0.5882352941176471,12,5,7,389.90008402119565,0.38579622132253716,0.1812274654304844,0.2378701527824742,132871.38848339583,2561.3131067377963,135432.70159013363,3460,11,1219.6666666666667,33,6,13,32.19905206228456,0.6556186868686869,42.24877450980392,1031.0049019607845,31.24257278669044,0
3562,4,1,1,39,0.025,0.025,0.975,40,1250,900,350,0.72,16,9,7,382.1189908946385,0.3912526709401709,0.17921619197129424,0.23501635591712994,133173.3927576302,2177.616490912196,135351.0092485424,3461,0,1190.15,35,5,13,32.095667937504665,0.6541666666666668,41.95601851851851,1032.1759259259252,29.49074074074072,0
3563,4,0,0,39,0.0,0.0,1.0,39,850,400,450,0.47058823529411764,13,4,9,391.5847385302784,0.384980881691408,0.17903152313491577,0.2399910427230123,133042.01388888893,2619.4444444444503,135661.45833333337,3462,13,1221.6666666666667,34,5,13,31.983710285406577,0.6550245098039216,42.083333333333336,1031.666666666667,30.34313725490197,0
3564,4,0,0,39,0.0,0.0,1.0,39,800,600,200,0.75,10,6,4,392.7302321770803,0.38467161493477287,0.18202791556119524,0.24128833329150298,133134.14292800444,2657.160572562347,135791.30350056678,3463,14,1222.6666666666667,34,5,13,31.861373860883607,0.6559436274509804,41.99404761904761,1032.0238095238087,30.353641456582608,0
3565,4,0,0,39,0.0,0.0,1.0,39,1050,600,450,0.5714285714285714,15,6,9,392.38193070771575,0.3845029239766082,0.1879829493387255,0.24207118541669462,133287.76218820864,2659.9418934240366,135947.70408163266,3464,15,1223.6666666666667,34,5,13,31.71571170547997,0.6574754901960784,41.845238095238095,1032.6190476190477,30.371148459383758,0
3566,4,0,0,39,0.0,0.0,1.0,39,850,800,50,0.9411764705882353,9,8,1,392.7123824442671,0.3842780026990553,0.1862475697460717,0.24307832060280649,133410.72137188193,2678.408446712001,136089.12981859394,3465,16,1224.6666666666667,34,5,13,31.583458170085265,0.6587009803921569,41.72619047619047,1033.095238095237,30.385154061624615,0
3567,4,0,0,39,0.0,0.0,1.0,39,1050,600,450,0.5714285714285714,15,6,9,387.62757590203455,0.38441857849752586,0.16172254938774766,0.23371744508264108,132429.53619100832,2471.5185001696786,134901.054691178,3466,17,1225.6666666666667,33,6,19,32.70317398896693,0.651199494949495,42.677696078431374,1029.289215686275,31.190582293523484,2
3568,4,0,0,39,0.0,0.0,1.0,39,1100,900,200,0.8181818181818182,13,9,4,387.8351358856816,0.3847559604138551,0.1604379909545346,0.2344309936483092,132524.15687475973,2479.504877931565,135003.6617526913,3467,18,1226.6666666666667,33,6,19,32.602356581766244,0.6521464646464646,42.58578431372549,1029.6568627450981,31.201723113487823,0
3569,4,0,0,39,0.0,0.0,1.0,39,950,500,450,0.5263157894736842,14,5,9,384.86059042300224,0.38408119658119655,0.15966139974925087,0.2329901307032465,132581.8470096372,2405.1055839002274,134986.95259353743,3468,19,1227.6666666666667,34,5,19,32.62074711979347,0.6504289215686274,42.529761904761905,1029.8809523809525,30.290616246498605,0
3570,4,0,0,39,0.0,0.0,1.0,39,850,500,350,0.5882352941176471,12,5,7,387.7563708114259,0.38467161493477287,0.16474373788910435,0.23531862784025803,132673.8166099773,2489.0235260770964,135162.8401360544,3469,20,1228.6666666666667,34,5,15,32.453441568446195,0.6513480392156863,42.44047619047619,1030.2380952380952,30.30112044817927,0
3571,4,0,0,39,0.0,0.0,1.0,39,1050,600,450,0.5714285714285714,15,6,9,386.6936720354242,0.3846434997750787,0.1617019763969858,0.23505761412490392,132735.1473922902,2465.5683106575934,135200.7157029478,3470,21,1229.6666666666667,34,5,15,32.41898682994454,0.6519607843137255,42.38095238095238,1030.4761904761904,30.308123249299715,0
3572,4,0,0,39,0.0,0.0,1.0,39,750,500,250,0.6666666666666666,10,5,5,369.73356774423246,0.3846434997750787,0.036527152822417586,0.2175972964265238,131511.22448979603,2020.117630385497,133531.34212018154,3471,22,1230.6666666666667,34,5,21,34.09040351284431,0.6397058823529411,43.57142857142858,1025.7142857142865,30.168067226890777,8
3573,4,0,0,39,0.0,0.0,1.0,39,1200,900,300,0.75,15,9,6,372.4490562807116,0.38340643274853803,0.01612669195530958,0.22695541015726087,132827.17013888867,2094.270833333301,134921.440972222,3472,23,1231.6666666666667,34,5,18,32.69334411209916,0.6528799019607845,42.29166666666665,1030.8333333333314,30.318627450980337,4
3574,4,1,0,40,0.025,0.0,1.0,40,1250,1000,250,0.8,15,10,5,366.1493135659123,0.38529647435897435,0.026065261269343054,0.22519445368143448,133173.39275763012,1752.2692686899593,134925.6620263201,3473,0,1201.85,35,5,20,32.50775584959257,0.6541666666666668,41.956018518518505,1032.1759259259243,29.490740740740694,0
3575,4,0,0,40,0.0,0.0,1.0,40,650,500,150,0.7692307692307693,8,5,3,366.3547100493749,0.38505608974358974,0.02515136226034298,0.22550156376331074,133203.26063368036,1759.9283854166436,134963.18901909702,3474,1,1202.85,35,5,20,32.472460477632026,0.6544642857142858,41.92708333333332,1032.2916666666652,29.494047619047574,0
3576,4,1,1,40,0.024390243902439025,0.024390243902439025,0.975609756097561,41,1350,1100,250,0.8148148148148148,16,11,5,356.7247658688868,0.38831300813008135,0.022816679779701143,0.2211693548387095,133472.22222222196,1322.8407118055227,134795.0629340275,3475,0,1174.4878048780488,35,6,20,32.451276881720425,0.6571428571428573,41.66666666666665,1033.3333333333312,29.52380952380946,0
3577,4,0,0,40,0.0,0.0,1.0,40,600,400,200,0.6666666666666666,8,4,4,362.21387882643785,0.38353365384615384,0.023140878857267566,0.22369451062069096,133326.80389426582,1658.563758014763,134985.36765228058,3476,3,1204.85,36,4,20,32.45533929415186,0.6536458333333335,41.80743243243243,1032.7702702702697,28.688063063063048,0
3578,4,0,0,40,0.0,0.0,1.0,40,1000,700,300,0.7,13,7,6,356.9349931775751,0.38279914529914527,0.03590750436300194,0.21991801192553811,133239.59094229355,1511.5744967940827,134751.16543908764,3477,4,1205.85,36,4,18,32.67911031122746,0.6527777777777779,41.89189189189189,1032.4324324324316,28.678678678678654,2
3579,4,0,0,40,0.0,0.0,1.0,40,1450,1000,450,0.6896551724137931,19,10,9,355.27479963764637,0.3823985042735043,0.04376362843436543,0.21958089368439976,133355.8812190569,1475.596796120445,134831.47801517736,3478,5,1206.85,36,4,19,32.605347797645,0.6539351851851851,41.77927927927928,1032.882882882883,28.691191191191194,0
3580,4,0,0,40,0.0,0.0,1.0,40,1150,1000,150,0.8695652173913043,13,10,3,360.65069600313467,0.3827457264957265,0.0044460485509569825,0.2117039961283936,131412.43128895422,1478.7969615650882,132891.2282505193,3479,6,1207.85,37,3,21,34.423123195380164,0.6326013513513513,43.66776315789473,1025.3289473684206,27.711593172119475,4
3581,4,0,0,40,0.0,0.0,1.0,40,850,800,50,0.9411764705882353,9,8,1,361.7585623546714,0.38230502136752137,0.05583169005915822,0.21375740685809616,131663.90483276648,1537.1550523198734,133201.05988508635,3480,7,1208.85,34,6,20,34.140712601013036,0.6412377450980392,43.42261904761905,1026.309523809524,30.185574229691884,1
3582,4,0,0,40,0.0,0.0,1.0,40,800,600,200,0.75,10,6,4,372.552747966259,0.38215811965811963,0.018118304611085323,0.2144425602904984,130657.85147392303,1735.388321995481,132393.23979591852,3481,8,1209.85,34,6,17,34.88249107281479,0.6311274509803921,44.40476190476191,1022.3809523809534,30.070028011204514,2
3583,4,0,0,40,0.0,0.0,1.0,40,1000,500,500,0.5,15,5,10,371.2888803061357,0.3818376068376068,0.017853817504655645,0.21438938572515584,130779.59183673479,1711.4016439909433,132490.99348072574,3482,9,1210.85,34,6,17,34.79132720360026,0.6323529411764706,44.28571428571429,1022.8571428571436,30.0840336134454,0
3584,4,0,0,40,0.0,0.0,1.0,40,900,600,300,0.6666666666666666,12,6,6,370.73602815614646,0.38122329059829063,0.01966092823077803,0.21491690047595371,130931.84700963728,1708.230583900237,132640.0775935375,3483,10,1211.85,34,6,19,34.65113799387384,0.6338848039215685,44.136904761904766,1023.4523809523816,30.10154061624652,0
3585,4,0,1,39,0.0,0.025,0.975,40,750,500,250,0.6666666666666666,10,5,5,368.63169280692256,0.3809695512820513,0.01854651162790688,0.21420490257699562,131023.24263038556,1659.86394557824,132683.10657596381,3484,11,1212.85,34,6,19,34.61240310077519,0.6348039215686274,44.04761904761905,1023.8095238095243,30.112044817927185,0
3586,4,1,0,40,0.025,0.0,1.0,40,1050,700,350,0.6666666666666666,14,7,7,362.2850437160442,0.38537660256410255,0.0313291139240508,0.21236463658535448,131358.63272392293,1517.8535997732426,132876.48632369618,3485,0,1204.9,34,6,22,34.43560562071768,0.6381740196078431,43.720238095238095,1025.1190476190477,30.150560224089638,0
3587,4,0,0,40,0.0,0.0,1.0,40,650,500,150,0.7692307692307693,8,5,3,360.3600566853973,0.38498931623931626,0.027902926149558915,0.21140468720535702,131389.14399092968,1469.4798752834463,132858.6238662131,3486,1,1205.9,34,6,22,34.45410473757549,0.6384803921568627,43.69047619047619,1025.238095238095,30.154061624649852,0
3588,4,1,1,40,0.024390243902439025,0.024390243902439025,0.975609756097561,41,900,800,100,0.8888888888888888,10,8,2,352.3438293474806,0.3879319105691057,0.02625203160363987,0.2084681402590264,131713.96933138292,1081.720866555218,132795.69019793815,3487,0,1177.4634146341464,35,6,16,34.33177829142707,0.6395833333333333,43.373842592592595,1026.50462962963,29.328703703703713,0
3589,4,1,2,39,0.024390243902439025,0.04878048780487805,0.9512195121951219,41,950,600,350,0.631578947368421,13,6,7,355.6482293815417,0.3880081300813008,0.03292353031735917,0.21091651678295734,131803.0907064473,1175.107167352554,132978.19787379986,3488,0,1178.439024390244,35,6,16,34.15708596333033,0.6404761904761904,43.287037037037045,1026.8518518518529,29.338624338624367,0
3590,4,0,0,39,0.0,0.0,1.0,39,850,800,50,0.9411764705882353,9,8,1,372.99071885343045,0.3803418803418803,0.039933699152244095,0.2193646750586339,131485.18786344197,2008.5509479527186,133493.7388113947,3489,16,1239.7948717948718,33,6,22,34.033212849006254,0.6417297979797979,43.5968137254902,1025.6127450980396,31.07917409387999,0
3591,4,0,0,39,0.0,0.0,1.0,39,1400,1000,400,0.7142857142857143,18,10,8,372.93717192700535,0.37975146198830406,0.04629714684646613,0.22023807318171662,131642.34459102261,2018.864739523249,133661.20933054585,3490,17,1240.7948717948718,33,6,17,33.875686649152144,0.6433080808080809,43.44362745098039,1026.2254901960778,31.09774212715387,0
3592,4,0,0,39,0.0,0.0,1.0,39,950,600,350,0.631578947368421,13,6,7,373.13640273181414,0.3797795771479982,0.046557738204516586,0.22145064128134567,131831.05656478272,2038.1932429834642,133869.24980776617,3491,18,1241.7948717948718,33,6,18,33.679892601431995,0.6452020202020202,43.259803921568626,1026.960784313725,31.12002376708258,0
3593,4,1,0,40,0.025,0.0,1.0,40,850,600,250,0.7058823529411765,11,6,5,369.72309149768347,0.3841746794871795,0.05994561444110169,0.22219380783887216,132306.12953514745,1783.3262471655394,134089.455782313,3492,0,1211.725,34,6,20,33.28825310499113,0.647671568627451,42.79761904761905,1028.8095238095243,30.259103641456598,0
3594,4,0,0,40,0.0,0.0,1.0,40,850,700,150,0.8235294117647058,10,7,3,368.89730040401116,0.383573717948718,0.055946321147616995,0.22205767859974038,132367.37528344663,1765.9934807256145,134133.36876417225,3493,1,1212.725,34,6,20,33.247773021749204,0.6482843137254901,42.738095238095234,1029.0476190476184,30.266106442577012,0
3595,4,0,0,40,0.0,0.0,1.0,40,750,400,350,0.5333333333333333,11,4,7,363.90123291790604,0.3836538461538461,0.05205202312138768,0.22012207445733456,132551.19756235814,1647.1088435374013,134198.30640589554,3494,2,1213.725,34,6,20,33.191233140655115,0.6501225490196079,42.5595238095238,1029.7619047619037,30.287114845938344,0
3596,4,0,0,40,0.0,0.0,1.0,40,750,500,250,0.6666666666666666,10,5,5,364.56390363731754,0.3839342948717949,0.05551670327129821,0.22070275229996011,132581.84700963704,1666.9111394557685,134248.7581490928,3495,3,1214.725,34,6,20,33.14332639771895,0.6504289215686274,42.5297619047619,1029.8809523809514,30.29061624649857,0
3597,4,0,1,39,0.0,0.025,0.975,40,800,600,200,0.75,10,6,4,367.4423742666522,0.3840945512820513,0.06390814558058944,0.22317289468616655,132704.4802295917,1752.2498582766275,134456.73008786832,3496,4,1215.725,34,6,18,32.94579241286346,0.651654411764706,42.41071428571428,1030.3571428571418,30.304621848739462,0
3598,4,1,1,39,0.025,0.025,0.975,40,900,600,300,0.6666666666666666,12,6,6,365.092968450062,0.3879674145299145,0.07134568756494652,0.2228379281004924,132888.53635204077,1703.334041950107,134591.8703939909,3497,0,1202.3,34,6,18,32.82121964361313,0.6534926470588236,42.232142857142854,1031.0714285714282,30.32563025210083,0
3599,4,0,0,39,0.0,0.0,1.0,39,1250,900,350,0.72,16,9,7,372.2837477061853,0.38455915429599635,0.06879894605869907,0.22616775655445148,132713.49961553264,2081.415801614786,134794.91541714742,3498,6,1234.128205128205,33,6,18,32.81200444021568,0.654040404040404,42.40196078431374,1030.3921568627463,31.224004753416555,0
3600,4,0,0,39,0.0,0.0,1.0,39,850,500,350,0.5882352941176471,12,5,7,369.32097341498934,0.3850371120107962,0.06407056234703923,0.22531525375926814,132871.38848339595,2014.4381067378104,134885.82659013374,3499,7,1235.128205128205,33,6,19,32.729481160109344,0.6556186868686869,42.24877450980393,1031.0049019607854,31.242572786690467,0
3601,4,0,0,39,0.0,0.0,1.0,39,900,600,300,0.6666666666666666,12,6,6,356.43788017628026,0.38506522717049035,0.03683607003109102,0.2202603310832909,133349.2346938774,1706.1437074829776,135055.3784013604,3500,8,1236.128205128205,34,5,22,32.58197902259105,0.6580882352941178,41.78571428571428,1032.8571428571418,30.37815126050417,4
3602,4,0,0,39,0.0,0.0,1.0,39,1200,800,400,0.6666666666666666,16,8,8,355.62453361332973,0.3853182636077373,0.03930363252787772,0.22012194741059002,133410.72137188193,1688.8251133786678,135099.5464852606,3501,9,1237.128205128205,34,5,22,32.541340170546206,0.6587009803921569,41.72619047619047,1033.095238095237,30.385154061624615,0
3603,4,0,0,39,0.0,0.0,1.0,39,1050,900,150,0.8571428571428571,12,9,3,350.0151052154488,0.3847559604138551,0.04371052188626745,0.21755054821658848,133564.50007086163,1549.9185090702888,135114.41857993192,3502,10,1238.128205128205,34,5,23,32.53219893278052,0.6602328431372548,41.57738095238095,1033.690476190476,30.40266106442576,0
3604,4,0,0,39,0.0,0.0,1.0,39,850,500,350,0.5882352941176471,12,5,7,350.0466828341405,0.3840249662618083,0.04968779062043338,0.2179322896354486,133626.03635204074,1555.0701530612173,135181.10650510195,3503,11,1239.128205128205,34,5,23,32.469775474956826,0.6608455882352942,41.51785714285714,1033.9285714285706,30.409663865546197,0
3605,4,0,0,39,0.0,0.0,1.0,39,1350,1100,250,0.8148148148148148,16,11,5,352.87839281954473,0.38281601439496177,0.059661857130212104,0.22061246284905336,133779.93905895692,1641.6099773242663,135421.54903628118,3504,12,1240.128205128205,34,5,18,32.24252013808976,0.6623774509803921,41.36904761904762,1034.5238095238094,30.427170868347336,0
3606,4,0,0,39,0.0,0.0,1.0,39,1300,1100,200,0.8461538461538461,15,11,4,353.28193838310756,0.382619208277103,0.0587968124200009,0.2216041249857676,133903.12500000012,1661.1111111111268,135564.23611111124,3505,13,1241.128205128205,34,5,18,32.108829844337095,0.6636029411764706,41.25000000000001,1035.000000000001,30.44117647058826,0
3607,4,0,0,39,0.0,0.0,1.0,39,1000,600,400,0.6,14,6,8,353.1022627540159,0.38259109311740885,0.06352463850163925,0.2218625200078701,133964.73922902497,1660.6505102040805,135625.38973922905,3506,14,1242.128205128205,34,5,18,32.05185334253296,0.6642156862745099,41.19047619047619,1035.2380952380954,30.44817927170869,0
3608,4,0,1,38,0.0,0.02564102564102564,0.9743589743589743,39,1150,900,250,0.782608695652174,14,9,5,353.64601848792296,0.38211313540260905,0.06712600572552274,0.2223904137953339,133995.5516581634,1677.3986678004662,135672.95032596387,3507,15,1243.128205128205,34,5,18,32.00696600360277,0.6645220588235293,41.16071428571429,1035.3571428571438,30.451680672268935,0
3609,4,0,0,38,0.0,0.0,1.0,38,1000,800,200,0.8,12,8,4,356.6769075846924,0.381593764817449,0.07513637382618832,0.22497262857506128,134106.1430699731,1966.5128796616705,136072.65594963476,3508,16,1270.7105263157894,33,5,18,31.817912920018927,0.6679292929292928,41.05392156862745,1035.7843137254904,31.387403446226983,0
3610,4,0,0,38,0.0,0.0,1.0,38,1100,800,300,0.7272727272727273,14,8,6,356.51268049138366,0.38027501185395923,0.07767793804681977,0.22604079847047398,134296.61218041144,1975.6890378700596,136272.3012182815,3509,17,1271.7105263157894,33,5,19,31.631788444864824,0.6698232323232323,40.87009803921569,1036.5196078431377,31.409685086155687,0
3611,4,0,0,38,0.0,0.0,1.0,38,950,800,150,0.8421052631578947,11,8,3,354.6838186529933,0.37969713134186817,0.07894736842105265,0.22546805331502454,134391.8974222655,1933.3262747501021,136325.2236970156,3510,18,1272.7105263157894,33,5,19,31.584007997478633,0.670770202020202,40.77818627450981,1036.8872549019611,31.420825906120033,0
3612,4,0,0,38,0.0,0.0,1.0,38,850,600,250,0.7058823529411765,11,6,5,355.3513423694168,0.37913406827880514,0.07175902895234287,0.2264829639920741,134487.21645520956,1958.042579777011,136445.25903498658,3511,19,1273.7105263157894,33,5,19,31.471526465028347,0.6717171717171717,40.68627450980392,1037.2549019607845,31.43196672608438,0
3613,4,0,0,38,0.0,0.0,1.0,38,1200,800,400,0.6666666666666666,16,8,8,355.7393396766084,0.37845246562351825,0.07703908146079996,0.22753475741650134,134616.287958499,1977.6768958767177,136593.9648543757,3512,20,1274.7105263157894,32,6,19,31.33263373484202,0.6754557291666667,40.56186868686868,1037.7525252525243,32.42976641414138,0
3614,4,0,0,38,0.0,0.0,1.0,38,850,600,250,0.7058823529411765,11,6,5,351.39741993143605,0.3779634898055951,0.04510587922641096,0.22416377139696445,134519.90504535148,1853.989512471657,136373.89455782314,3513,21,1275.7105263157894,34,4,19,31.541437150944844,0.6697303921568627,40.654761904761905,1037.3809523809525,30.51120448179272,2
3615,4,0,0,38,0.0,0.0,1.0,38,800,600,200,0.75,10,6,4,352.2907776942215,0.37756341868183974,0.048943204628645764,0.2255140284423551,134646.15660142718,1886.9233876148319,136533.07998904202,3514,22,1276.7105263157894,33,5,20,31.392308222143498,0.6732954545454546,40.53308823529411,1037.8676470588223,31.450534759358252,0
3616,4,0,0,38,0.0,0.0,1.0,38,650,400,250,0.6153846153846154,9,4,5,375.4722383112421,0.37756341868183974,0.04783776322064082,0.2243205936577417,132082.88278546694,2334.554167868102,134417.43695333504,3515,23,1277.7105263157894,33,5,22,33.365621522810365,0.6477272727272729,43.01470588235293,1027.9411764705867,31.14973262032081,7
3617,4,1,0,39,0.02564102564102564,0.0,1.0,39,1000,700,300,0.7,13,7,6,366.33939254864055,0.38351889338731443,0.04380774421260236,0.2206971462427173,132398.00347222204,1900.520833333311,134298.52430555536,3516,0,1245.923076923077,34,5,23,33.28272604588393,0.6485906862745099,42.70833333333332,1029.1666666666652,30.26960784313721,0
3618,4,0,0,39,0.0,0.0,1.0,39,1250,1000,250,0.8,15,10,5,366.47717791369087,0.3839125056230319,0.03915534049669134,0.22131945772329562,132489.90929705193,1910.9056122448726,134400.8149092968,3517,1,1246.923076923077,34,5,23,33.186623111316685,0.6495098039215688,42.619047619047606,1029.5238095238076,30.28011204481787,0
3619,4,0,0,39,0.0,0.0,1.0,39,800,400,400,0.5,12,4,8,362.23334230628114,0.3839125056230319,0.06219288088530961,0.21995915506210886,132695.96220207473,1813.3803798010963,134509.34258187583,3518,2,1247.923076923077,35,4,19,33.08853815621958,0.6494047619047618,42.41898148148148,1030.324074074074,29.437830687830683,1
3620,4,0,0,39,0.0,0.0,1.0,39,1200,900,300,0.75,15,9,6,360.63706856034105,0.3830128205128205,0.06076934590630145,0.2200380141599669,132874.89819101506,1783.9227537722832,134658.82094478735,3519,3,1248.923076923077,35,4,19,32.949782966621754,0.6511904761904762,42.24537037037037,1031.0185185185182,29.45767195767195,0
3621,4,0,0,39,0.0,0.0,1.0,39,950,500,450,0.5263157894736842,14,5,9,357.0457690585118,0.3830128205128205,0.03794973309984839,0.2077170299455564,131068.54056336732,1559.4935729648432,132628.03413633216,3520,4,1249.923076923077,36,3,19,34.86312731405109,0.631076388888889,44.00337837837837,1023.9864864864858,28.444069069069048,5
3622,4,1,1,39,0.025,0.025,0.975,40,1200,800,400,0.6666666666666666,16,8,8,352.8332584058894,0.38616452991452993,0.036919147533780006,0.20681527052600193,131356.98356718203,1269.6793076860592,132626.66287486808,3521,0,1219.65,36,4,20,34.679501263319764,0.6339699074074074,43.721846846846844,1025.1126126126126,28.47535035035035,0
3623,4,0,1,38,0.0,0.02564102564102564,0.9743589743589743,39,650,300,350,0.46153846153846156,10,3,7,363.5402207680613,0.3823099415204678,0.04481967896602046,0.21293070073557877,131328.125,1748.6111111111104,133076.73611111112,3522,6,1251.923076923077,35,4,20,34.43428184281843,0.6357142857142857,43.75,1025.0,29.285714285714285,0
3624,4,2,2,38,0.05,0.05,0.95,40,950,800,150,0.8421052631578947,11,8,3,354.6594079810659,0.38464209401709404,0.039034619083235134,0.2094168706179681,131637.3803117305,1337.2870739073496,132974.66738563785,3523,0,1221.425,37,3,17,34.34962335719627,0.6348536036036037,43.4484649122807,1026.206140350877,27.735301090564242,0
3625,4,0,0,38,0.0,0.0,1.0,38,1000,700,300,0.7,13,7,6,369.08313966105595,0.37542970602181125,0.040207484165369234,0.21651248020646582,131387.4488275891,2098.5784250685797,133486.0272526577,3524,32,1286.7105263157894,35,3,20,34.23223827801611,0.6363095238095239,43.692129629629626,1025.231481481481,29.29232804232803,0
3626,4,0,0,38,0.0,0.0,1.0,38,1150,800,350,0.6956521739130435,15,8,7,368.30964743769414,0.375607515410147,0.04618034929309722,0.2163941297279819,131446.78605109727,2082.623885459519,133529.4099365568,3525,33,1287.7105263157894,35,3,20,34.19206170052672,0.6369047619047619,43.63425925925925,1025.462962962962,29.29894179894177,0
3627,4,2,2,38,0.05,0.05,0.95,40,900,700,200,0.7777777777777778,11,7,4,353.28760795073964,0.38617788461538466,0.04114349775784798,0.20968895665821435,131834.3685076175,1315.0897391504855,133149.458246768,3526,0,1224.275,37,3,17,34.18615203929105,0.6368243243243243,43.25657894736841,1026.9736842105247,27.75604551920337,0
3628,4,1,0,39,0.02564102564102564,0.0,1.0,39,900,500,400,0.5555555555555556,13,5,8,365.06570462585165,0.3783175888439046,0.04954491536381456,0.21708796333748498,131905.8987196656,1830.8639720801903,133736.7626917458,3527,0,1256.6410256410256,36,3,18,33.8115727545129,0.6394675925925926,43.18693693693694,1027.2522522522522,28.534784784784783,0
3629,4,0,0,39,0.0,0.0,1.0,39,800,500,300,0.625,11,5,6,364.38120327032686,0.3773335582546109,0.051034827631737834,0.21750864893710098,132050.54029959018,1823.346953372296,133873.88725296248,3528,1,1257.6410256410256,36,3,18,33.683256637814544,0.6409143518518519,43.046171171171174,1027.8153153153157,28.550425425425438,0
3630,4,0,0,39,0.0,0.0,1.0,39,1050,800,250,0.7619047619047619,13,8,5,363.79846928937707,0.37792397660818716,0.05044532048474282,0.2179926260859969,132195.26113951797,1818.4867299732268,134013.7478694912,3529,2,1258.6410256410256,36,3,19,33.55234340779676,0.642361111111111,42.90540540540541,1028.378378378379,28.566066066066085,0
3631,4,0,0,39,0.0,0.0,1.0,39,750,500,250,0.6666666666666666,10,5,5,364.04861673523925,0.3776990553306343,0.051989544817749866,0.21830965309540018,132224.21481870403,1827.20850073048,134051.4233194345,3530,3,1259.6410256410256,36,3,19,33.5167341873791,0.6426504629629628,42.87725225225226,1028.4909909909925,28.569194194194235,0
3632,4,0,0,39,0.0,0.0,1.0,39,850,700,150,0.8235294117647058,10,7,3,365.399788676884,0.377895861448493,0.05122030625533269,0.21962450456263263,132311.0948786626,1869.2892216541056,134180.3841003167,3531,4,1260.6410256410256,36,3,19,33.39444687682429,0.6435185185185184,42.7927927927928,1028.8288288288302,28.578578578578615,0
3633,4,1,1,39,0.025,0.025,0.975,40,1600,1300,300,0.8125,19,13,6,356.2272566237674,0.3829861111111111,0.050650415391342296,0.2160986036866201,132658.90045450884,1451.3717687282206,134110.27222323706,3532,0,1230.1,36,4,18,33.28049846961084,0.6469907407407407,42.45495495495497,1030.1801801801826,28.61611611611618,0
3634,4,0,0,39,0.0,0.0,1.0,39,1000,600,400,0.6,14,6,8,361.6941657053713,0.3768556005398111,0.05460172553901499,0.2189356929555369,132576.73852237652,1790.446566358023,134367.18508873455,3533,6,1262.6410256410256,35,4,19,33.22235333782872,0.6482142857142856,42.53472222222222,1029.8611111111109,29.424603174603167,0
3635,4,0,0,39,0.0,0.0,1.0,39,650,500,150,0.7692307692307693,8,5,3,397.9033811361541,0.3768556005398111,0.11205877309362022,0.21781185083002208,128687.51594387768,2478.8964081002937,131166.41235197798,3534,7,1263.6410256410256,34,5,14,36.246040126715954,0.6112132352941175,46.33928571428572,1014.6428571428581,29.842436974789944,7
3636,4,3,2,40,0.07142857142857142,0.047619047619047616,0.9523809523809523,42,900,600,300,0.6666666666666666,12,6,6,372.87536708048566,0.3920707510646535,0.11403215469921135,0.20757133626728008,129352.72285997734,1249.5606575963734,130602.28351757371,3535,0,1174.3095238095239,34,8,15,36.201726155646575,0.617953431372549,45.68452380952381,1017.2619047619048,29.919467787114847,0
3637,4,0,0,40,0.0,0.0,1.0,40,900,700,200,0.7777777777777778,11,7,4,389.9959008099792,0.38146367521367525,0.11916856492027339,0.21562745649317494,129083.74592764063,2068.4263545953404,131152.17228223596,3536,1,1234.025,35,5,16,36.041192103265004,0.6130952380952381,45.949074074074076,1016.2037037037039,29.034391534391542,0
3638,4,0,0,40,0.0,0.0,1.0,40,800,600,200,0.75,10,6,4,388.0005374899218,0.3817975427350427,0.11823770491803276,0.21516393442622955,129201.38888888905,2026.0416666666856,131227.43055555574,3537,2,1235.025,36,4,17,35.971653005464475,0.6122685185185185,45.83333333333334,1016.666666666668,28.240740740740776,0
3639,4,1,1,40,0.024390243902439025,0.024390243902439025,0.975609756097561,41,1300,1000,300,0.7692307692307693,16,10,6,381.7563988651645,0.38663617886178864,0.11327313080545309,0.21372184378516068,129575.43372741247,1693.2501922337474,131268.68391964622,3538,0,1205.878048780488,33,8,14,35.74867597496389,0.6224747474747474,45.4656862745098,1018.1372549019603,30.85264408793819,0
3640,4,0,0,40,0.0,0.0,1.0,40,750,600,150,0.8,9,6,3,390.7177440789567,0.38147702991452986,0.1112299962783776,0.21826581670273512,129490.37606175386,2118.8375229568364,131609.2135847107,3539,4,1237.025,32,8,14,35.60739982632428,0.6240234375,45.54924242424242,1017.80303030303,31.80634469696969,0
3641,4,0,0,40,0.0,0.0,1.0,40,550,200,350,0.36363636363636365,9,2,7,387.46201352808544,0.3812767094017094,0.08465346534653428,0.20596664929650849,127512.4999999999,1894.1990932047597,129406.69909320466,3540,5,1238.025,34,6,16,37.71658415841583,0.599264705882353,47.49999999999999,1009.9999999999992,29.705882352941153,6
3642,4,1,0,41,0.024390243902439025,0.0,1.0,41,850,500,350,0.5882352941176471,12,5,7,379.9004026831581,0.38732215447154467,0.09003739465312255,0.20395144468371015,127910.26341735253,1518.632115912207,129428.89553326473,3541,0,1208.8048780487804,35,6,17,37.49904652936689,0.601190476190476,47.10648148148148,1011.5740740740739,28.9021164021164,0
3643,4,1,1,41,0.023809523809523808,0.023809523809523808,0.9761904761904762,42,950,700,250,0.7368421052631579,12,7,5,377.73790269906095,0.3935104529616725,0.08600868650233973,0.20443982672796512,128234.94897959194,1288.2688054645848,129523.21778505652,3542,0,1181.0,34,8,17,37.22085096379878,0.6066176470588235,46.78571428571429,1012.8571428571436,29.789915966386577,0
3644,4,2,2,41,0.046511627906976744,0.046511627906976744,0.9534883720930233,43,850,500,350,0.5882352941176471,12,5,7,366.0785015331844,0.3952565522332964,0.09327802679872321,0.19987201924830514,128584.36113522387,814.3940489969259,129398.75518422079,3543,0,1154.4883720930231,35,8,13,37.15872132831223,0.6080357142857142,46.44097222222223,1014.2361111111119,28.978174603174626,0
3645,4,2,2,41,0.046511627906976744,0.046511627906976744,0.9534883720930233,43,1150,800,350,0.6956521739130435,15,8,7,354.9257464567128,0.39604097452934667,0.08101762472689922,0.18879401883657368,127538.80343966992,453.36100260414264,127992.16444227406,3544,0,1155.4418604651162,39,4,16,38.51115894950327,0.5900106837606839,47.47395833333332,1010.1041666666649,25.900106837606792,4
3646,4,1,1,41,0.023809523809523808,0.023809523809523808,0.9761904761904762,42,1400,1100,300,0.7857142857142857,17,11,6,366.8939766172312,0.39215543941153697,0.07861549696557635,0.19521567523443537,127550.2698905141,959.4851477463455,128509.75503826045,3545,0,1183.857142857143,38,4,16,38.19716199541688,0.5918311403508772,47.46260683760683,1010.1495726495712,26.582883490778187,0
3647,4,3,2,42,0.06818181818181818,0.045454545454545456,0.9545454545454546,44,1200,900,300,0.75,15,9,6,353.3908493197039,0.3993018851303735,0.0796801110117038,0.19021978797435707,128015.94309769299,247.93257155130766,128263.8756692443,3546,0,1130.9772727272727,40,4,17,38.0613158599451,0.5932291666666667,47.002032520325194,1011.9918699186977,25.29979674796744,0
3648,4,0,0,42,0.0,0.0,1.0,42,900,400,500,0.4444444444444444,14,4,10,367.19317060184176,0.39389759969028265,0.09011395366387442,0.19668836218146207,127820.2174761671,986.9421844181555,128807.15966058525,3547,1,1185.8333333333333,38,4,17,37.912704701531965,0.5945723684210527,47.195512820512825,1011.2179487179495,26.610998650472357,0
3649,4,2,0,44,0.045454545454545456,0.0,1.0,44,950,600,350,0.631578947368421,13,6,7,352.24906866627765,0.3986301973220578,0.1010688532331212,0.19114114172313984,128338.88942992072,242.68359668814864,128581.57302660886,3548,0,1132.8863636363637,37,7,19,37.760050319229535,0.6016328828828829,46.68311403508772,1013.267543859649,27.385609293504025,0
3650,4,1,2,43,0.022222222222222223,0.044444444444444446,0.9555555555555556,45,1000,900,100,0.9,11,9,2,345.2905488497637,0.40347222222222223,0.09956066778496675,0.18856388525800055,128593.16541883688,-119.59906684026743,128473.56635199662,3549,0,1108.6888888888889,39,6,15,37.67683834856732,0.6006944444444444,46.43229166666667,1014.270833333334,26.006944444444464,0
3651,4,1,0,44,0.022727272727272728,0.0,1.0,44,700,500,200,0.7142857142857143,9,5,4,348.06403872344214,0.4022969520789288,0.09384916931118159,0.1904575133239508,128672.41753472216,157.24826388888465,128829.66579861105,3550,0,1094.9318181818182,39,5,16,37.52566735112938,0.6014957264957266,46.354166666666664,1014.5833333333328,26.01495726495725,0
3652,4,1,1,44,0.022222222222222223,0.022222222222222223,0.9777777777777777,45,1000,800,200,0.8,12,8,4,341.4047628096568,0.4060816498316498,0.09714273008249386,0.18809256888201278,128943.21852898407,-195.6342124396879,128747.58431654438,3551,0,1071.5777777777778,40,5,18,37.41870122073244,0.6026041666666667,46.08739837398374,1015.650406504065,25.391260162601625,0
3653,4,0,0,44,0.0,0.0,1.0,44,650,400,250,0.6153846153846154,9,4,5,348.4624997466176,0.4013169485553207,0.0985237184570178,0.19131082028342458,128804.55864800335,176.7116970486021,128981.27034505195,3552,1,1096.8181818181818,39,5,18,37.3808149478365,0.6028311965811967,46.22395833333333,1015.1041666666656,26.028311965811938,0
3654,4,1,0,45,0.022222222222222223,0.0,1.0,45,1100,900,200,0.8181818181818182,13,9,4,344.9912948090492,0.4039351851851852,0.10996210732184375,0.19068921817554896,129072.27143441388,-94.23799077931054,128978.03344363457,3553,0,1073.4222222222222,40,5,19,37.1962196219622,0.6039062500000001,45.96036585365853,1016.1585365853646,25.403963414634113,0
3655,4,1,2,44,0.021739130434782608,0.043478260869565216,0.9565217391304348,46,1250,700,550,0.56,18,7,11,344.79481522755947,0.40854468599033816,0.04696915545286107,0.18768175634290976,128463.58861396546,-341.21959103083503,128122.36902293462,3554,0,1051.0652173913043,42,4,13,37.82160039508062,0.5947420634920635,46.560077519379846,1013.7596899224802,24.137135474344767,8
3656,4,2,3,43,0.043478260869565216,0.06521739130434782,0.9347826086956522,46,850,600,250,0.7058823529411765,11,6,5,357.73108070006475,0.406622383252818,0.09842251791367373,0.19678026218666558,128881.41605259603,20.97764932997086,128902.393701926,3555,0,1051.8260869565217,42,4,14,37.06718993542641,0.5989583333333334,46.14825581395349,1015.4069767441863,24.176356589147293,0
3657,4,0,0,43,0.0,0.0,1.0,43,1250,900,350,0.72,16,9,7,371.71316492571844,0.3970791805094131,0.11643418807498174,0.20407576294090873,128804.55864800363,975.6700303819623,129780.2286783856,3556,1,1125.7906976744187,39,4,14,36.790768770309555,0.6028311965811965,46.22395833333334,1015.104166666668,26.028311965812,0
3658,4,3,3,43,0.06521739130434782,0.06521739130434782,0.9347826086956522,46,1050,800,250,0.7619047619047619,13,8,5,352.06952423948167,0.4097121578099839,0.12893890116761253,0.1963939914323079,129433.96297053664,-84.82854418150382,129349.13442635513,3557,0,1053.304347826087,40,6,13,36.648190685442266,0.6075520833333334,45.604674796747965,1017.5813008130075,25.439532520325187,0
3659,4,2,2,43,0.044444444444444446,0.044444444444444446,0.9555555555555556,45,1300,1000,300,0.7692307692307693,16,10,6,359.8146138445923,0.40446127946127947,0.12117701884029075,0.20084635134000797,129459.81744497307,316.30684447086725,129776.12428944393,3558,0,1077.6666666666667,40,5,13,36.424838559350235,0.6078125000000001,45.57926829268292,1017.682926829267,25.442073170731675,0
3660,4,1,0,44,0.022727272727272728,0.0,1.0,44,1650,1300,350,0.7878787878787878,20,13,7,367.71079660754145,0.40204369274136714,0.11781090313392983,0.20487343699177715,129386.78521050328,715.3835720485908,130102.16878255187,3559,0,1103.1363636363637,39,5,17,36.298355858161834,0.6087072649572651,45.65104166666666,1017.3958333333318,26.087072649572608,0
3661,4,0,1,43,0.0,0.022727272727272728,0.9772727272727273,44,1350,1000,350,0.7407407407407407,17,10,7,361.86530464994036,0.402792459478506,0.11355013796108038,0.20225685777755587,129511.53413973156,573.146151431017,130084.68029116259,3560,1,1104.1363636363637,40,4,13,36.320012979233205,0.6083333333333334,45.52845528455284,1017.886178861788,25.4471544715447,0
3662,4,1,1,43,0.022727272727272728,0.022727272727272728,0.9772727272727273,44,1600,1000,600,0.625,22,10,12,355.7902120744525,0.40247313248766736,0.09911685460532915,0.19951727561265153,129640.87106095887,424.9906016590449,130065.86166261791,3561,0,1105.090909090909,40,4,13,36.343054585370716,0.6096354166666668,45.40142276422763,1018.3943089430877,25.459857723577194,0
3663,4,1,1,43,0.022727272727272728,0.022727272727272728,0.9772727272727273,44,800,600,200,0.75,10,6,4,353.5982985180444,0.40223088442565186,0.10869870777601465,0.19881227945279809,129744.38707325315,375.4789022737589,130119.8659755269,3562,0,1106.0681818181818,40,4,14,36.2936408977556,0.6106770833333335,45.29979674796747,1018.8008130081284,25.470020325203212,0
3664,4,0,0,43,0.0,0.0,1.0,43,1150,900,250,0.782608695652174,14,9,5,358.47522924656585,0.3997785160575858,0.11312533594638197,0.20121531524528807,129678.39084201379,697.2981770833236,130375.68901909712,3563,8,1132.7906976744187,39,4,14,36.23653439694553,0.6116452991452992,45.36458333333333,1018.5416666666658,26.11645299145297,0
3665,4,0,1,42,0.0,0.023255813953488372,0.9767441860465116,43,1250,800,450,0.64,17,8,9,364.2521192970356,0.39982465854558874,0.12055559121304404,0.205151323148123,129811.0473632811,856.7898220485965,130667.8371853297,3564,9,1133.7906976744187,39,4,14,35.954483116971616,0.6129807692307694,45.23437499999999,1019.0624999999989,26.12980769230766,0
3666,4,3,2,43,0.06666666666666667,0.044444444444444446,0.9555555555555556,45,850,400,450,0.47058823529411764,13,4,9,348.8875357096541,0.4087962962962963,0.1254277755670512,0.19971625905201829,130444.20070725089,103.63907182087405,130547.83977907176,3565,0,1047.8,40,5,15,35.70371567847194,0.6177083333333333,44.61382113821138,1021.5447154471539,25.538617886178848,0
3667,4,1,0,44,0.022727272727272728,0.0,1.0,44,1600,900,700,0.5625,23,9,14,353.51576238833513,0.4050828047921071,0.13076873157436086,0.20225061645157605,130422.14084201383,421.2565104166616,130843.39735243049,3566,0,1072.590909090909,39,5,16,35.60787613026038,0.6191239316239316,44.635416666666664,1021.4583333333328,26.1912393162393,0
3668,4,0,0,44,0.0,0.0,1.0,44,1100,600,500,0.5454545454545454,16,6,10,353.95358004907575,0.4047855003523608,0.1355498489972331,0.20288764502927056,130496.11363110569,437.913320444164,130934.02695154985,3567,1,1073.590909090909,40,4,13,35.521724355148855,0.6182291666666667,44.56300813008129,1021.7479674796738,25.543699186991844,0
3669,4,0,1,43,0.0,0.022727272727272728,0.9772727272727273,44,1050,700,350,0.6666666666666666,14,7,7,355.6569673660467,0.40466437632135305,0.14130493723395587,0.20454850970469204,130625.94112507439,491.6052159759429,131117.54634105033,3568,2,1074.590909090909,40,4,14,35.34666302150645,0.61953125,44.4359756097561,1022.2560975609758,25.556402439024396,0
3670,4,0,0,43,0.0,0.0,1.0,43,1050,700,350,0.6666666666666666,14,7,7,361.0162120012782,0.4008397932816537,0.13756292721773988,0.20739409087567587,130581.79253472232,828.4288194444548,131410.22135416677,3569,4,1100.5348837209303,39,4,14,35.25445033292567,0.6207264957264957,44.47916666666667,1022.0833333333342,26.20726495726498,0
3671,4,0,1,42,0.0,0.023255813953488372,0.9767441860465116,43,1050,900,150,0.8571428571428571,12,9,3,335.266283639098,0.4012320044296789,0.10772399940375954,0.1860483511016499,129228.54487407774,67.32153211520313,129295.86640619294,3570,5,1101.5348837209303,38,5,16,37.28437707961192,0.6088267543859649,45.80662393162393,1016.7735042735044,26.757197480881693,5
3672,4,3,1,44,0.06666666666666667,0.022222222222222223,0.9777777777777777,45,850,600,250,0.7058823529411765,11,6,5,325.22999765980114,0.40580808080808084,0.1367269183058657,0.18371099867810406,129925.63950029762,-548.8569138739979,129376.78258642362,3571,0,1053.1555555555556,40,5,15,36.83255249867094,0.6124999999999999,45.121951219512205,1019.5121951219527,25.487804878048816,0
3673,4,1,0,45,0.022222222222222223,0.0,1.0,45,950,600,350,0.631578947368421,13,6,7,326.70548639485304,0.40637626262626264,0.14636641424206132,0.18503477773469237,130029.2691189108,-503.7448773877926,129525.524241523,3572,0,1054.1333333333334,40,5,17,36.68999933572471,0.6135416666666667,45.020325203252035,1019.9186991869927,25.49796747967482,0
3674,4,2,1,46,0.0425531914893617,0.02127659574468085,0.9787234042553191,47,600,300,300,0.5,9,3,6,315.1545090746765,0.4114246068455134,0.15335510780844275,0.1806219415114131,130490.55103812355,-1174.8537508338186,129315.69728728973,3573,0,1010.2340425531914,41,6,14,36.51841198174579,0.6166158536585367,44.56845238095238,1021.7261904761903,24.92015098722415,0
3675,4,0,0,46,0.0,0.0,1.0,46,1350,1100,250,0.8148148148148148,16,11,5,322.6018179402646,0.40783011272141706,0.1516116195781938,0.18466933222867501,130444.2007072507,-783.6927424152524,129660.50796483544,3574,1,1033.195652173913,40,6,18,36.37501658044834,0.6177083333333334,44.61382113821137,1021.5447154471523,25.538617886178805,0
3676,4,1,1,46,0.02127659574468085,0.02127659574468085,0.9787234042553191,47,1400,1100,300,0.7857142857142857,17,11,6,315.2626418999775,0.41100061671292015,0.15257550642096174,0.18163287032213873,130693.35322381239,-1159.453636778813,129533.89958703358,3575,0,1012.1914893617021,41,6,15,36.310982018692805,0.61864837398374,44.37003968253967,1022.5198412698389,24.939508323654607,0
3677,4,0,0,46,0.0,0.0,1.0,46,1150,700,450,0.6086956521739131,16,7,9,319.0955511648418,0.4069645732689211,0.14618156805320526,0.1833598139236677,130591.93244716852,-865.739067617803,129726.19337955072,3576,3,1035.195652173913,41,5,15,36.31537335403928,0.6176321138211383,44.469246031746025,1022.1230158730147,24.92982965543938,0
3678,4,0,0,46,0.0,0.0,1.0,46,1250,900,350,0.72,16,9,7,324.0501525249752,0.40674315619967794,0.13637791370474472,0.18288667406452466,129891.90853915027,-779.6321858089161,129112.27635334135,3577,4,1036.195652173913,42,4,16,36.896783903675555,0.6091269841269842,45.15503875968992,1019.3798449612401,24.270948689553336,2
3679,4,0,0,46,0.0,0.0,1.0,46,1450,900,550,0.6206896551724138,20,9,11,330.91927939923636,0.40683373590982286,0.15106268718372418,0.18735478298423672,130015.40927716177,-595.0788902409724,129420.3303869208,3578,5,1037.195652173913,42,4,17,36.59659540775931,0.6103670634920635,45.03391472868217,1019.8643410852709,24.282484311554068,0
3680,4,0,0,46,0.0,0.0,1.0,46,1500,1100,400,0.7333333333333333,19,11,8,328.6567044598235,0.40702495974235103,0.15324755230894405,0.18654589979824676,130114.25212013988,-647.4157389880551,129466.83638115182,3579,6,1038.195652173913,42,4,17,36.55419951245765,0.611359126984127,44.93701550387596,1020.2519379844949,24.291712809154642,0
3681,4,1,1,46,0.02127659574468085,0.02127659574468085,0.9787234042553191,47,1000,800,200,0.8,12,8,4,324.88445648847033,0.40984427998766576,0.15339546692416972,0.1857429793509886,130395.54172092021,-926.9650393441797,129468.57668157603,3580,0,1017.0851063829788,39,8,17,36.365906000339955,0.6188568376068376,44.661458333333336,1021.3541666666673,26.188568376068392,0
3682,4,1,0,47,0.02127659574468085,0.0,1.0,47,1100,800,300,0.7272727272727273,14,8,6,327.20787200687573,0.40832176996608077,0.16192250712003498,0.18758515584543806,130501.9544813369,-859.7466362847124,129642.20784505218,3581,0,1018.063829787234,39,8,15,36.19900516532436,0.6199252136752136,44.55729166666667,1021.7708333333342,26.199252136752158,0
3683,4,1,1,47,0.020833333333333332,0.020833333333333332,0.9791666666666666,48,850,600,250,0.7058823529411765,11,6,5,322.3394295358892,0.4112828752955083,0.16677225148232777,0.18588548306129826,130729.84959556157,-1172.1229716108105,129557.72662395076,3582,0,997.8333333333334,40,8,15,36.09323760310047,0.6205729166666667,44.334349593495936,1022.6626016260168,25.56656504065042,0
3684,4,0,0,47,0.0,0.0,1.0,47,1100,800,300,0.7272727272727273,14,8,6,331.32714381109986,0.4074737897008942,0.16628437880752167,0.19060050347960944,130635.03146701396,-743.413628472217,129891.61783854174,3583,2,1020.063829787234,39,8,15,35.95925888186944,0.6212606837606838,44.427083333333336,1022.2916666666673,26.212606837606852,0
3685,4,0,0,47,0.0,0.0,1.0,47,1000,600,400,0.6,14,6,8,338.3151840197971,0.4073003391921061,0.17446331894095812,0.19556170819649357,130821.45317925344,-548.2231987847251,130273.22998046872,3584,3,1021.063829787234,39,8,15,35.592204629535345,0.623130341880342,44.244791666666664,1023.020833333333,26.23130341880341,0
3686,4,0,0,47,0.0,0.0,1.0,47,1150,800,350,0.6956521739130435,15,8,7,360.9469682712936,0.4069341658957755,0.2140712700691818,0.20287708906283053,129731.4453125,44.232855902777544,129775.67816840278,3585,4,1022.063829787234,39,8,19,36.11963190184049,0.6121794871794872,45.3125,1018.75,26.121794871794872,5
3687,4,1,0,48,0.020833333333333332,0.0,1.0,48,1350,900,450,0.6666666666666666,18,9,9,356.41300723533135,0.4091866134751773,0.2153871064168984,0.20186009822876919,130029.26911891082,-331.17543294334644,129698.09368596747,3586,0,1001.75,40,8,20,35.93251793543242,0.6135416666666667,45.020325203252035,1019.9186991869929,25.49796747967482,0
3688,4,4,3,49,0.07692307692307693,0.057692307692307696,0.9423076923076923,52,1300,800,500,0.6153846153846154,18,8,10,328.54535091641924,0.41478129713423834,0.22138509279704,0.189908052614917,130820.18455530376,-1803.299894949149,129016.88466035461,3587,0,925.6153846153846,41,11,16,35.84335402120507,0.6199186991869918,44.246031746031754,1023.0158730158743,24.95160665892376,0
3689,4,0,0,49,0.0,0.0,1.0,49,1000,800,200,0.8,12,8,4,348.24385952626847,0.4092439058956916,0.22388779779694268,0.19911550819803422,130398.95171305457,-717.8731554532521,129681.07855760131,3588,1,983.2857142857143,38,11,21,35.76599546722455,0.6206140350877192,44.65811965811967,1021.3675213675238,26.878092667566413,0
3690,4,0,0,49,0.0,0.0,1.0,49,1100,800,300,0.7272727272727273,14,8,6,349.1772871098997,0.4084467120181406,0.22725305456603517,0.20004268878352238,130475.34722222252,-688.1944444444093,129787.15277777812,3589,2,984.2857142857143,39,10,21,35.66476345840132,0.6196581196581195,44.58333333333335,1021.666666666669,26.196581196581256,0
3691,4,0,0,49,0.0,0.0,1.0,49,850,600,250,0.7058823529411765,11,6,5,348.7181515549812,0.4083049886621315,0.22351639391998068,0.20032918636167937,130581.7925347226,-692.7517361110714,129889.04079861153,3590,3,985.2857142857143,39,10,17,35.56869139828781,0.6207264957264955,44.479166666666686,1022.0833333333363,26.207264957265036,0
3692,4,2,1,50,0.0392156862745098,0.0196078431372549,0.9803921568627451,51,1550,900,650,0.5806451612903226,22,9,13,340.7036366908284,0.41434640522875815,0.24479611716854088,0.1987630368626835,131175.63952664414,-1261.5965136054247,129914.04301303871,3591,0,947.6078431372549,41,10,20,35.173348828200666,0.6234756097560974,43.89880952380953,1024.404761904763,24.985481997677148,0
3693,4,0,0,50,0.0,0.0,1.0,50,1100,800,300,0.7272727272727273,14,8,6,344.3230123945703,0.41241496598639454,0.23765032744592185,0.20058308201806277,131119.87428944436,-970.4819799722111,130149.39230947214,3592,1,967.46,40,10,20,35.136973275120724,0.6244791666666665,43.95325203252034,1024.1869918699208,25.60467479674802,0
3694,4,1,1,50,0.0196078431372549,0.0196078431372549,0.9803921568627451,51,1450,1200,250,0.8275862068965517,17,12,5,341.4512123601493,0.4140522875816994,0.24571691722968003,0.20067467582564208,131458.3656078561,-1222.5110921078374,130235.85451574827,3593,0,949.4705882352941,40,11,21,34.868942622138555,0.6278645833333332,43.62296747967481,1025.5081300813033,25.637703252032583,0
3695,4,0,0,50,0.0,0.0,1.0,50,1200,800,400,0.6666666666666666,16,8,8,339.846412834961,0.4133248299319728,0.23543460601137234,0.20016791110040086,131541.75347222245,-1059.2013888888637,130482.55208333359,3594,1,966.58,39,11,21,34.826022204170044,0.6303418803418803,43.54166666666668,1025.8333333333353,26.303418803418854,0
3696,4,0,0,50,0.0,0.0,1.0,50,1400,1000,400,0.7142857142857143,18,10,8,338.0961031582536,0.41354591836734694,0.2353893005786214,0.19955570474607304,131621.90890842024,-1099.8291015624898,130522.07980685776,3595,2,967.58,39,11,16,34.790143978614694,0.6311431623931624,43.46354166666667,1026.1458333333342,26.311431623931647,0
3697,4,0,2,48,0.0,0.04,0.96,50,1150,800,350,0.6956521739130435,15,8,7,339.9728010725844,0.4131292517006803,0.23886983869331435,0.2015100360897455,131782.29302300356,-1039.520941840267,130742.77208116329,3596,3,968.58,39,11,17,34.58043775996753,0.6327457264957265,43.30729166666667,1026.7708333333342,26.327457264957285,0
3698,4,0,0,48,0.0,0.0,1.0,48,1150,700,450,0.6086956521739131,16,7,9,342.32107604047394,0.4129174054373523,0.25122906045156657,0.20296408771283103,131793.94866544288,-576.830735444531,131217.11792999835,3597,4,1006.3333333333334,38,10,17,34.50841917247598,0.6345942982456141,43.29594017094016,1026.816239316238,27.02147998200626,0
3699,4,0,0,48,0.0,0.0,1.0,48,1200,900,300,0.75,15,9,6,342.47521199949017,0.4130651595744681,0.25183326399001493,0.2034954689841221,131876.2384487543,-567.1314559135204,131309.1069928408,3598,5,1007.3333333333334,38,10,17,34.421590042299435,0.6354166666666667,43.21581196581196,1027.1367521367508,27.029914529914496,0
3700,4,0,1,47,0.0,0.020833333333333332,0.9791666666666666,48,1550,1100,450,0.7096774193548387,20,11,9,339.7092709435559,0.41273271276595747,0.25263828238719066,0.20243641684852048,131985.99810979617,-632.6265614727166,131353.37154832346,3599,6,1008.3333333333334,38,10,17,34.382148055728834,0.6365131578947368,43.10897435897436,1027.5641025641025,27.04116059379217,0
3701,4,0,0,47,0.0,0.0,1.0,47,900,600,300,0.6666666666666666,12,6,6,349.76486222942725,0.40997918593894545,0.25885805532778083,0.20775190009531028,131862.52170138882,-175.82465277778175,131686.69704861104,3600,7,1030.6170212765958,37,10,17,34.24822515212982,0.6371058558558559,43.229166666666664,1027.0833333333328,27.759009009008995,0
3702,4,1,1,47,0.020833333333333332,0.020833333333333332,0.9791666666666666,48,1050,600,450,0.5714285714285714,15,6,9,342.64043262911287,0.41095966312056736,0.25644088925825814,0.2053709093703516,132205.6544031707,-540.199475856506,131665.4549273142,3601,0,1010.125,38,10,17,34.0858525521158,0.638706140350877,42.895299145299155,1028.4188034188053,27.06365272154751,0
3703,4,0,1,46,0.0,0.02127659574468085,0.9787234042553191,47,700,500,200,0.7142857142857143,9,5,4,348.91878399999973,0.4085144927536232,0.2550785815602836,0.20848397705544947,132087.8554579296,-182.41321849027844,131905.44223943932,3602,9,1032.6170212765958,37,10,17,34.043000000000006,0.639358108108108,43.009868421052644,1027.9605263157914,27.782716927453823,0
3704,4,0,1,45,0.0,0.021739130434782608,0.9782608695652174,46,1550,1200,350,0.7741935483870968,19,12,7,354.0167747565606,0.4076489533011272,0.25321180515280717,0.21090217395065045,131975.16453379902,144.28441924440244,132119.4489530434,3603,10,1055.7391304347825,37,9,17,34.02551755415644,0.6382319819819819,43.11951754385966,1027.5219298245627,27.770862968231423,0
3705,4,1,0,46,0.021739130434782608,0.0,1.0,46,1250,900,350,0.72,16,9,7,345.50311619432006,0.40951086956521743,0.24344961325723347,0.20594490883727928,131996.29041883693,-78.97406684025833,131917.31635199668,3604,0,1056.2391304347825,39,7,17,34.22294728839332,0.6348824786324785,43.09895833333334,1027.6041666666679,26.34882478632482,2
3706,4,0,0,46,0.0,0.0,1.0,46,1050,800,250,0.7619047619047619,13,8,5,345.29728369072467,0.40942028985507245,0.2399058881584739,0.2062586922191327,132076.58420138896,-78.8628472222178,131997.72135416674,3605,1,1057.2391304347825,39,7,17,34.147412511822715,0.6356837606837606,43.020833333333336,1027.9166666666672,26.35683760683762,0
3707,4,0,0,46,0.0,0.0,1.0,46,1400,900,500,0.6428571428571429,19,9,10,342.0333389280996,0.4096115136876006,0.23687594120703426,0.20517844402041674,132237.24500868062,-154.090711805551,132083.15429687506,3606,2,1058.2391304347825,39,7,18,34.06969482141651,0.6372863247863249,42.864583333333336,1028.5416666666672,26.37286324786326,0
3708,4,0,0,46,0.0,0.0,1.0,46,1200,900,300,0.75,15,9,6,348.44649291266586,0.4094706119162641,0.24630595813204526,0.20962690081644328,132345.71358194525,23.07994993059299,132368.79353187585,3607,3,1059.2391304347825,40,6,18,33.79567901234568,0.63671875,42.75914634146341,1028.9634146341461,25.724085365853654,0
3709,4,0,0,46,0.0,0.0,1.0,46,900,700,200,0.7777777777777778,11,7,4,348.44649291266586,0.409561191626409,0.24630595813204526,0.20962690081644328,132345.71358194525,23.07994993059299,132368.79353187585,3608,4,1060.2391304347825,40,6,18,33.79567901234568,0.63671875,42.75914634146341,1028.9634146341461,25.724085365853654,0
3710,4,1,1,46,0.02127659574468085,0.02127659574468085,0.9787234042553191,47,950,600,350,0.631578947368421,13,6,7,340.1124920636662,0.41198350292938635,0.24398052424464756,0.20621535463014073,132639.32427300353,-377.5211194792453,132261.8031535243,3609,0,1038.659574468085,39,8,17,33.71517595307918,0.6412927350427351,42.473958333333336,1030.104166666667,26.41292735042736,0
3711,4,0,0,46,0.0,0.0,1.0,46,1200,900,300,0.75,15,9,6,324.34739115918654,0.40916867954911434,0.11562877676801175,0.19298574321531564,131927.76626222808,-625.633171263596,131302.1330909645,3610,6,1062.2391304347825,40,6,15,34.83529528143241,0.6325520833333333,43.165650406504064,1027.337398373983,25.683434959349576,6
3712,4,1,1,46,0.02127659574468085,0.02127659574468085,0.9787234042553191,47,700,300,400,0.42857142857142855,11,3,8,317.8622814310936,0.4116751464693185,0.11706746312775174,0.19033174737338435,132168.3784190759,-997.7315405328922,131170.646878543,3611,0,1040.6170212765958,41,6,16,34.760311143270606,0.6333841463414633,42.93154761904761,1028.2738095238087,25.079849012775824,0
3713,4,0,2,44,0.0,0.043478260869565216,0.9565217391304348,46,700,400,300,0.5714285714285714,10,4,6,323.1441182932997,0.40893719806763285,0.11679462819509823,0.1929326807803087,132058.30379569024,-665.2271713266057,131393.07662436363,3612,8,1064.2391304347825,40,6,16,34.735061960319044,0.6338541666666667,43.038617886178855,1027.845528455283,25.696138211382078,0
3714,4,1,0,45,0.022222222222222223,0.0,1.0,45,900,700,200,0.7777777777777778,11,7,4,312.043288241788,0.410563973063973,0.10120628910974383,0.1812389961668219,131005.52780970195,-800.8186596799876,130204.70915002195,3566,0,1007.7333333333333,42,3,18,36.078640164063735,0.6202876984126984,44.064922480620154,1023.7403100775194,24.374769287559985,4
3715,4,0,0,45,0.0,0.0,1.0,45,1150,800,350,0.6956521739130435,15,8,7,311.49066169644914,0.4105008417508418,0.09983045100033916,0.18118066298675103,131061.33355034716,-835.1236979166712,130226.20985243049,3567,1,1008.7333333333333,43,2,18,36.036580196676844,0.6194282945736433,44.010416666666664,1023.9583333333328,23.81298449612402,0
3716,4,2,1,46,0.0425531914893617,0.02127659574468085,0.9787234042553191,47,800,500,300,0.625,11,5,6,302.5166662231547,0.4148743447425223,0.11039626579074113,0.17789631942064707,131480.69905045364,-1443.8943806689222,130036.80466978472,3568,0,966.7659574468086,41,6,20,35.84469916811763,0.6265243902439024,43.60119047619048,1025.595238095239,25.0145180023229,0
3717,4,0,0,46,0.0,0.0,1.0,46,800,400,400,0.5,12,4,8,305.98080493264024,0.4126207729468599,0.11111757531879296,0.1795834986018271,131406.26161882802,-1158.4412593363768,130247.82035949164,3569,1,988.7826086956521,40,6,20,35.83069019063669,0.62734375,43.673780487804876,1025.3048780487802,25.632621951219505,0
3718,4,0,0,46,0.0,0.0,1.0,46,850,600,250,0.7058823529411765,11,6,5,304.0272575038741,0.41212761674718196,0.11417349962102907,0.1792908406401351,131588.67076475636,-1198.691461762186,130389.97930299418,3570,2,989.7826086956521,40,6,15,35.69751221605917,0.6291666666666667,43.49593495934959,1026.0162601626012,25.650406504065028,0
3719,4,1,1,46,0.02127659574468085,0.02127659574468085,0.9787234042553191,47,900,600,300,0.6666666666666666,12,6,6,298.92414731943643,0.4131012950971323,0.11156492229140147,0.17731597987985617,131811.58002842354,-1519.6671666351565,130291.91286178838,3571,0,969.7021276595744,41,6,15,35.60475235887033,0.6298272357723576,43.27876984126985,1026.8849206349219,25.045973674022484,0
3720,4,0,0,46,0.0,0.0,1.0,46,900,600,300,0.6666666666666666,12,6,6,303.32247748222983,0.411664653784219,0.10540347464592958,0.1797341343110248,131771.20642681292,-1206.1662411593443,130565.04018565358,3572,4,991.7826086956521,40,6,15,35.532350127024976,0.6309895833333332,43.31808943089432,1026.7276422764241,25.668191056910604,0
3721,4,0,2,44,0.0,0.043478260869565216,0.9565217391304348,46,1300,800,500,0.6153846153846154,18,8,10,303.61242288434624,0.41141304347826085,0.1060922923336427,0.18002933807649282,131797.29327781094,-1196.9408916650061,130600.35238614594,3573,5,992.7826086956521,40,6,16,35.498729875956705,0.6312499999999999,43.29268292682927,1026.8292682926838,25.670731707317096,0
3722,4,0,0,44,0.0,0.0,1.0,44,1250,900,350,0.72,16,9,7,318.36262072752316,0.4069767441860465,0.12224188176519601,0.1883514815240173,131711.68456424863,-413.58458433779253,131298.09997991082,3574,6,1037.0454545454545,38,6,17,35.20612163474882,0.6337719298245614,43.376068376068375,1026.495726495726,27.013045434098057,0
3723,4,0,0,44,0.0,0.0,1.0,44,1150,600,550,0.5217391304347826,17,6,11,318.1263472623385,0.4059526955602537,0.12576402909533413,0.18909245993694515,131889.27001953125,-408.5096571180554,131480.7603624132,3575,7,1038.0454545454545,39,5,18,35.033739816786664,0.6338141025641026,43.203125,1027.1875,26.338141025641026,0
3724,4,1,1,44,0.022222222222222223,0.022222222222222223,0.9777777777777777,45,1450,1200,250,0.8275862068965517,17,12,5,312.0440420667582,0.4089646464646464,0.13774924554183832,0.18772703065513524,132345.71358194525,-740.461716736072,131605.25186520917,3576,0,1015.9555555555555,40,5,19,34.7320987654321,0.63671875,42.75914634146341,1028.9634146341461,25.724085365853654,0
3725,4,0,0,44,0.0,0.0,1.0,44,750,500,250,0.6666666666666666,10,5,5,319.05800815616016,0.4065142706131078,0.14021673080818298,0.1913960372134829,132237.24500868062,-361.7296006944395,131875.51540798618,3577,1,1039.8181818181818,39,5,19,34.660471946526236,0.6372863247863249,42.864583333333336,1028.5416666666672,26.37286324786326,0
3726,4,1,0,45,0.022222222222222223,0.0,1.0,45,1100,900,200,0.8181818181818182,13,9,4,315.5896926963621,0.40808080808080804,0.10961421091516499,0.19051042705701832,132474.5894451529,-638.477005385505,131836.1124397674,3578,0,1017.6888888888889,41,4,21,34.51172063216729,0.6364329268292683,42.63392857142856,1029.4642857142844,25.10888501742157,1
3727,4,0,0,45,0.0,0.0,1.0,45,1600,1000,600,0.625,22,10,12,318.6166074581379,0.4076178451178451,0.10042706226118248,0.19286058320833388,132576.73852237637,-551.7698688271757,132024.9686535492,3579,1,1018.6888888888889,41,4,21,34.331450887839964,0.6374491869918699,42.534722222222214,1029.8611111111097,25.118563685636822,0
3728,4,0,0,45,0.0,0.0,1.0,45,1300,900,400,0.6923076923076923,17,9,8,313.62368577109964,0.4075968013468014,0.08788154278608507,0.1904489235182238,132697.34883908703,-676.593673006448,132020.75516608058,3580,2,1019.6888888888889,42,3,16,34.339242609486185,0.6371527777777779,42.41763565891472,1030.3294573643398,24.531653746769994,0
3729,4,0,1,44,0.0,0.022222222222222223,0.9777777777777777,45,1400,1100,300,0.7857142857142857,17,11,6,330.71034203476444,0.4069444444444445,0.015878374651088656,0.19174345737663284,130937.79047070198,-206.12642962651762,130731.66404107546,3581,3,1020.6888888888889,40,5,14,35.669248336808664,0.62265625,44.13109756097561,1023.4756097560977,25.58689024390244,7
3730,4,2,1,45,0.043478260869565216,0.021739130434782608,0.9782608695652174,46,1150,800,350,0.6956521739130435,15,8,7,323.2203053737853,0.4086855877616747,0.052315305761752695,0.18931475029035982,131328.1249999999,-709.2547838588285,130618.87021614109,3582,0,999.3913043478261,39,7,15,35.46747967479674,0.6282051282051283,43.74999999999999,1024.9999999999993,26.282051282051263,0
3731,4,1,1,45,0.021739130434782608,0.021739130434782608,0.9782608695652174,46,1600,1100,500,0.6875,21,11,10,323.50192437113594,0.40828301127214167,0.055713922775167735,0.19090584046612263,131614.73954202188,-684.4756965100179,130930.26384551186,3583,0,1000.3695652173913,40,6,14,35.17175068502196,0.6294270833333333,43.47052845528455,1026.1178861788615,25.652947154471537,0
3732,4,1,0,46,0.021739130434782608,0.0,1.0,46,1300,800,500,0.6153846153846154,18,8,10,327.4307966912659,0.40869565217391307,0.07023196153630917,0.19375386510711642,131719.04047070208,-574.2259278537791,131144.8145428483,3584,0,1001.3478260869565,40,6,15,34.96600996600995,0.6304687499999999,43.368902439024396,1026.5243902439033,25.663109756097583,0
3733,4,0,1,45,0.0,0.021739130434782608,0.9782608695652174,46,1000,700,300,0.7,13,7,6,328.5877308547237,0.40860507246376815,0.07433040036142202,0.1949723441155013,131823.38271077088,-536.8907602947872,131286.4919504761,3585,1,1002.3478260869565,40,6,15,34.83135411512452,0.6315104166666666,43.26727642276423,1026.9308943089443,25.673272357723608,0
3734,4,0,0,45,0.0,0.0,1.0,45,550,400,150,0.7272727272727273,7,4,3,333.8901128772065,0.4062289562289562,0.07880940301031614,0.19762685059488716,131728.82080078125,-203.40983072916765,131525.4109700521,3586,2,1023.8,39,6,15,34.79039827498732,0.6322115384615385,43.359375,1026.5625,26.322115384615383,0
3735,4,0,1,44,0.0,0.022222222222222223,0.9777777777777777,45,1150,900,250,0.782608695652174,14,9,5,332.6271398348329,0.4064183501683502,0.08336151123734825,0.19729472590203262,131809.033203125,-231.34765625000068,131577.685546875,3587,3,1024.8,39,6,15,34.74208764455265,0.6330128205128205,43.28125,1026.875,26.330128205128204,0
3736,4,1,1,44,0.022222222222222223,0.022222222222222223,0.9777777777777777,45,850,600,250,0.7058823529411765,11,6,5,331.34216156056755,0.40549242424242427,0.08698500637558815,0.19701215112083617,131901.66650142102,-259.0833415956188,131642.5831598254,3588,0,1025.5333333333333,40,5,16,34.68189387943543,0.6322916666666667,43.1910569105691,1027.235772357723,25.680894308943074,0
3737,4,0,0,44,0.0,0.0,1.0,44,1150,900,250,0.782608695652174,14,9,5,341.3097706456994,0.40250616631430586,0.08352793994995844,0.20300187679702547,131913.47321625397,204.67145770344064,132118.1446739574,3589,5,1049.840909090909,41,3,16,34.414031063898285,0.6308434959349594,43.17956349206349,1027.2817460317451,25.055652342237686,0
3738,4,0,0,44,0.0,0.0,1.0,44,1000,500,500,0.5,15,5,10,341.26688946505607,0.4022749295278365,0.08622142631412677,0.20311263835058138,131938.9526643989,205.27919501132345,132144.23185941024,3590,6,1050.840909090909,41,3,16,34.38948435689456,0.6310975609756098,43.1547619047619,1027.380952380951,25.058072009291486,0
3739,4,0,0,44,0.0,0.0,1.0,44,700,300,400,0.42857142857142855,11,3,8,342.86048883291716,0.40217582804792107,0.090020363917245,0.2041981646257919,131964.43457301887,249.07810925294234,132213.5126822718,3591,7,1051.840909090909,41,3,16,34.32290158025166,0.6313516260162602,43.12996031746031,1027.4801587301574,25.060491676345304,0
3740,4,0,0,44,0.0,0.0,1.0,44,1050,700,350,0.6666666666666666,14,7,7,342.4053038070543,0.401823467230444,0.08876997604191339,0.20420129776265228,132015.40577168344,240.5550240929462,132255.9607957764,3592,8,1052.840909090909,41,3,16,34.28329230620717,0.6318597560975611,43.08035714285713,1027.6785714285695,25.065331010452915,0
3741,4,0,0,44,0.0,0.0,1.0,44,1000,500,500,0.5,15,5,10,343.56161822748584,0.40231897463002114,0.08844135788928797,0.20516668164005614,132066.3868122477,274.5883133345632,132340.97512558228,3593,9,1053.840909090909,41,3,16,34.20227696811761,0.632367886178862,43.030753968253954,1027.8769841269816,25.070170344560527,0
3742,4,0,0,44,0.0,0.0,1.0,44,1350,1000,350,0.7407407407407407,17,10,7,338.87924336256356,0.40153717406624384,0.08281147217471396,0.20291642735141321,132168.37841907569,157.82401502264838,132326.20243409835,3594,10,1054.840909090909,41,3,16,34.220031355523396,0.6333841463414636,42.931547619047606,1028.2738095238074,25.07984901277579,0
3743,4,0,0,44,0.0,0.0,1.0,44,1000,700,300,0.7,13,7,6,338.7568159891671,0.4015922304439747,0.07979320505849552,0.20297995112969353,132193.88247196996,156.31574389011809,132350.1982158601,3595,11,1055.840909090909,41,3,16,34.197536819088036,0.633638211382114,42.90674603174602,1028.3730158730134,25.082268679829596,0
3744,4,0,1,43,0.0,0.022727272727272728,0.9772727272727273,44,1200,900,300,0.75,15,9,6,335.467271975464,0.4021538054968288,0.07932393908003643,0.20183155587011042,132348.14544085375,79.69426041101491,132427.83970126478,3596,12,1056.840909090909,42,2,18,34.12711491979785,0.6336805555555556,42.756782945736425,1028.9728682170528,24.499354005167923,0
3745,4,0,0,43,0.0,0.0,1.0,43,950,700,250,0.7368421052631579,12,7,5,335.4483577167669,0.40051679586563305,0.08974311331108553,0.20223851855409683,132426.21678064388,284.4783348411379,132710.69511548502,3597,13,1074.4186046511627,37,6,18,34.04919480842298,0.6427364864864865,42.68092105263157,1029.2763157894724,27.818278805120876,0
3746,4,0,0,43,0.0,0.0,1.0,43,1250,1000,250,0.8,15,10,5,346.0861399429682,0.4005398671096345,0.05168847610060934,0.2089413146644081,132478.41932508702,569.7889539930758,133048.20827908008,3598,14,1075.4186046511627,39,4,18,33.722996559749056,0.6396901709401708,42.63020833333334,1029.4791666666686,26.396901709401757,3
3747,4,0,1,42,0.0,0.023255813953488372,0.9767441860465116,43,1450,900,550,0.6206896551724138,20,9,11,351.2596367666659,0.401578073089701,0.05685381321073124,0.21373695240894192,132773.48632812517,727.5933159722363,133501.07964409742,3599,15,1076.4186046511627,39,4,16,33.29332592143386,0.6426282051282051,42.34375000000001,1030.6250000000014,26.426282051282087,0
3748,4,1,1,42,0.023255813953488372,0.023255813953488372,0.9767441860465116,43,1350,1100,250,0.8148148148148148,16,11,5,346.9176255701244,0.4028931339977852,0.05764060904170987,0.21276898336050057,133068.88156467024,632.7880859375091,133701.66965060774,3600,0,1046.5813953488373,39,4,16,33.10880447585394,0.6455662393162394,42.05729166666667,1031.7708333333342,26.455662393162413,0
3749,4,0,0,42,0.0,0.0,1.0,42,1250,900,350,0.72,16,9,7,353.4189567517327,0.40018873403019745,0.05809177524155795,0.21613348306355232,132961.427137587,998.2177734375193,133959.64491102452,3601,17,1072.5,39,3,16,33.04895549271118,0.6444978632478633,42.16145833333334,1031.3541666666683,26.444978632478676,0
3750,4,0,0,42,0.0,0.0,1.0,42,1200,1000,200,0.8333333333333334,14,10,4,353.58862302208456,0.399753193960511,0.0609587263130571,0.2170166604496144,133095.75195312526,1012.2287326389182,134107.98068576417,3602,18,1073.5,39,3,16,32.90976849047716,0.6458333333333333,42.031250000000014,1031.875000000002,26.458333333333385,0
3751,4,0,0,42,0.0,0.0,1.0,42,1050,500,550,0.47619047619047616,16,5,11,354.4208675251834,0.3995112272551297,0.06474941136898726,0.21815595013506656,133203.26063368074,1042.003038194464,134245.2636718752,3603,19,1074.5,39,3,16,32.78044063235789,0.6469017094017093,41.92708333333334,1032.2916666666683,26.469017094017136,0
3752,4,0,0,42,0.0,0.0,1.0,42,1050,600,450,0.5714285714285714,15,6,9,358.0483503703771,0.3992692605497484,0.060083383767064014,0.22102685837932257,133310.81271701396,1146.3433159722313,134457.15603298618,3604,20,1075.5,39,3,16,32.57892878757314,0.6479700854700854,41.82291666666667,1032.708333333334,26.47970085470087,0
3753,4,0,2,40,0.0,0.047619047619047616,0.9523809523809523,42,1400,1200,200,0.8571428571428571,16,12,4,360.5979275970423,0.3990635888501742,0.06486588989865516,0.22340854739756802,133445.31385633687,1224.0207248263946,134669.33458116328,3605,21,1076.5,39,3,16,32.37820092751285,0.6493055555555556,41.692708333333336,1033.2291666666672,26.493055555555568,0
3754,4,0,1,39,0.0,0.025,0.975,40,1300,1000,300,0.7692307692307693,16,10,6,361.8526289046913,0.39325587606837603,0.07492764109985517,0.22468307650988317,133527.42735955864,1663.4501241872892,135190.87748374592,3606,22,1128.125,38,2,17,32.263455309765,0.6518640350877194,41.61324786324786,1033.5470085470076,27.19860548807915,0
3755,4,0,0,39,0.0,0.0,1.0,39,1150,600,550,0.5217391304347826,17,6,11,365.2895757668484,0.39324673864147547,0.0646015701694993,0.22734755180895116,133613.8899108378,1961.5522324176573,135575.44214325547,3607,23,1067.6666666666667,37,2,17,32.087951178986806,0.6545608108108107,41.52960526315789,1033.8815789473674,27.942745376955877,0
3756,4,0,0,39,0.0,0.0,1.0,39,600,400,200,0.6666666666666666,8,4,4,364.8305480242321,0.3929655870445344,0.06672648666286052,0.22723593579052215,133642.2324657586,1951.3537819328953,135593.5862476915,3608,24,1068.6666666666667,37,2,17,32.071403322728905,0.6548423423423424,41.50219298245614,1033.9912280701747,27.94570886676148,0
3757,4,0,0,39,0.0,0.0,1.0,39,1000,700,300,0.7,13,7,6,365.5099022259056,0.3927406657669816,0.06787586176899141,0.2280085580552077,133698.92659279777,1973.6563173284053,135672.58291012616,3609,25,1069.6666666666667,37,2,17,31.99701371218546,0.6554054054054055,41.44736842105263,1034.2105263157891,27.951635846372678,0
3758,4,0,0,39,0.0,0.0,1.0,39,1150,900,250,0.782608695652174,14,9,5,357.88357681898435,0.3927406657669816,0.07922340496753044,0.2068035756211089,130808.4744708342,1562.840944371387,132371.31541520558,3610,26,1070.6666666666667,38,1,17,35.10487380330723,0.6247258771929824,44.25747863247863,1022.9700854700851,26.920265407107504,8
3759,4,0,0,39,0.0,0.0,1.0,39,1750,1400,350,0.8,21,14,7,353.35227157661797,0.39304993252361675,0.0811327975507079,0.20505560956847832,130972.46334876539,1455.883487654317,132428.34683641972,3611,27,1071.6666666666667,38,1,18,35.05483943916779,0.6263706140350876,44.09722222222222,1023.6111111111109,26.93713450292397,0
3760,4,1,0,40,0.025,0.0,1.0,40,1450,1300,150,0.896551724137931,16,13,3,346.63571869741264,0.3979433760683761,0.0772309177761965,0.20288809257964588,131301.43364800359,1102.7533637152862,132404.18701171887,3612,0,1045.85,39,1,19,34.894404072229555,0.6279380341880341,43.77604166666667,1024.8958333333344,26.27938034188037,0
3761,4,0,0,40,0.0,0.0,1.0,40,450,100,350,0.2222222222222222,8,1,7,344.7022275100799,0.39760950854700855,0.07337398373983728,0.2018970189701897,131328.12500000012,1053.819444444457,132381.94444444458,3613,1,1046.85,39,1,19,34.9170054200542,0.6282051282051282,43.75000000000001,1025.000000000001,26.282051282051306,0
3762,4,0,0,40,0.0,0.0,1.0,40,1300,1100,200,0.8461538461538461,15,11,4,341.85237958074566,0.39788995726495724,0.06365529148892968,0.2010680125060945,131488.33007812497,989.9197048611093,132478.24978298607,3614,2,1047.85,39,1,19,34.82844132981246,0.6298076923076923,43.59375,1025.6249999999998,26.298076923076916,0
3763,4,0,0,40,0.0,0.0,1.0,40,1000,600,400,0.6,14,6,8,341.47044887909993,0.3973157051282051,0.0640801096558028,0.2012652573913977,131568.46923828122,985.3488498263878,132553.8180881076,3615,3,1048.85,39,1,15,34.757441533827475,0.6306089743589745,43.515625,1025.9374999999998,26.306089743589737,0
3764,4,1,1,40,0.024390243902439025,0.024390243902439025,0.975609756097561,41,950,600,350,0.631578947368421,13,6,7,333.7238025864909,0.39933943089430896,0.06011288964180839,0.1982919737061532,131875.569322576,602.0032925176995,132477.5726150937,3616,0,1024.2439024390244,40,1,15,34.64698558754659,0.6320312499999998,43.216463414634156,1027.1341463414647,25.678353658536615,0
3765,4,0,1,39,0.0,0.025,0.975,40,950,600,350,0.631578947368421,13,6,7,328.9193397108994,0.3969684829059829,-0.015215403373297853,0.19292158173031385,131381.5158420137,642.7842881944257,132024.30013020814,3617,5,1050.85,39,1,15,35.26764546501389,0.6287393162393163,43.69791666666666,1025.2083333333317,26.28739316239312,7
3766,4,1,0,40,0.025,0.0,1.0,40,300,100,200,0.3333333333333333,5,1,4,329.9672088525011,0.394284188034188,-0.00542153377348864,0.19394192066584287,131461.6224500866,675.6049262152594,132137.22737630186,3618,0,1051.7,39,1,16,35.16008549178941,0.6295405982905984,43.61979166666666,1025.5208333333317,26.29540598290594,0
3767,4,0,1,39,0.0,0.025,0.975,40,750,400,350,0.5333333333333333,11,4,7,331.94284660515615,0.3942307692307692,-0.0027546460851020083,0.19537604366532987,131515.0404188367,731.0953776041572,132246.13579644085,3619,1,1052.7,39,1,17,35.05562184760163,0.6300747863247864,43.56770833333333,1025.7291666666658,26.300747863247842,0
3768,4,1,0,40,0.025,0.0,1.0,40,800,600,200,0.75,10,6,4,331.8269551499594,0.3938568376068376,0.055857611817808905,0.1825422775847521,128883.87586805574,553.4288194444642,129437.3046875002,3620,0,1052.8,39,1,16,37.7222678156203,0.6036324786324785,46.14583333333334,1015.4166666666681,26.036324786324823,5
3769,4,1,0,41,0.024390243902439025,0.0,1.0,41,1150,800,350,0.6956521739130435,15,8,7,331.38879091961815,0.3957571138211382,0.06538873746824092,0.18414051028732112,129280.82817925356,368.8340928819498,129649.66227213551,3621,0,1028.0975609756097,39,2,19,37.32982092253063,0.607638888888889,45.755208333333336,1016.9791666666673,26.076388888888907,0
3770,4,1,1,41,0.023809523809523808,0.023809523809523808,0.9761904761904762,42,900,300,600,0.3333333333333333,15,3,12,326.0266477417909,0.40069686411149824,0.07345349798933354,0.1824656400601823,129563.26116233734,48.21514145020885,129611.47630378755,3622,0,1004.5952380952381,40,2,16,37.179535170027286,0.6088541666666667,45.47764227642277,1018.0894308943099,25.452235772357746,0
3771,4,1,0,42,0.023809523809523808,0.0,1.0,42,700,400,300,0.5714285714285714,10,4,6,325.9936888745587,0.3970915602013163,0.0829044720372929,0.18280821243491632,129640.8710609592,52.42115721463088,129693.29221817382,3623,0,1005.5714285714286,40,2,17,37.10166982669726,0.6096354166666667,45.40142276422765,1018.3943089430903,25.459857723577258,0
3772,4,0,0,42,0.0,0.0,1.0,42,800,500,300,0.625,11,5,6,326.970148809717,0.39676490514905144,0.08488468227043389,0.18347675427609106,129666.74619109007,79.43105955451145,129746.17725064459,3624,1,1006.5714285714286,40,2,17,37.05057207476883,0.6098958333333333,45.37601626016261,1018.4959349593505,25.462398373983763,0
3773,4,0,0,42,0.0,0.0,1.0,42,1100,900,200,0.8181818181818182,13,9,4,328.0428770314566,0.3961115950445219,0.08679660155674962,0.18468758719788977,129796.16057117141,115.74118828080273,129911.90175945222,3625,2,1007.5714285714286,40,2,18,36.89205810977029,0.6111979166666666,45.248983739837406,1019.0040650406515,25.47510162601629,0
3774,4,1,0,43,0.023255813953488372,0.0,1.0,43,1500,1100,400,0.7333333333333333,19,11,8,322.85054967915136,0.3984403839055002,0.09854388356494193,0.18359113347426376,130186.64301658169,-193.83414824262542,129992.80886833907,3626,0,985.1162790697674,41,2,20,36.629058520462706,0.6135670731707317,44.86607142857143,1020.5357142857148,24.891114982578408,0
3775,4,1,1,43,0.022727272727272728,0.022727272727272728,0.9772727272727273,44,950,800,150,0.8421052631578947,11,8,3,314.8818374809452,0.40149312896405914,0.09028356964136797,0.18064273834433203,130528.56445312526,-579.718723426842,129948.84572969843,3627,0,963.7045454545455,39,5,17,36.48700305810399,0.6201923076923076,44.531250000000014,1021.875000000002,26.20192307692313,0
3776,4,0,0,43,0.0,0.0,1.0,43,1450,1000,450,0.6896551724137931,19,10,9,316.5151087487048,0.39892488002953114,0.08614914915152161,0.18170448987323268,130555.177137587,-335.46278211803593,130219.71435546897,3628,2,987.1162790697674,39,4,17,36.41841215642307,0.6204594017094016,44.50520833333334,1021.9791666666682,26.204594017094056,0
3777,4,0,0,43,0.0,0.0,1.0,43,1000,600,400,0.6,14,6,8,314.98410871110417,0.3988556662975267,0.07856982075371066,0.1813236965982109,130661.65500217053,-368.73101128468164,130292.92399088586,3629,3,988.1162790697674,39,4,17,36.3500806588555,0.6215277777777777,44.401041666666686,1022.3958333333364,26.215277777777857,0
3778,4,0,0,43,0.0,0.0,1.0,43,700,400,300,0.5714285714285714,10,4,6,315.9088931531707,0.3988556662975267,0.0818407535869301,0.1819813201403479,130688.28125000025,-342.8819444444139,130345.39930555584,3630,4,989.1162790697674,39,4,17,36.299578918772085,0.6217948717948717,44.375000000000014,1022.5000000000019,26.21794871794877,0
3779,4,0,0,43,0.0,0.0,1.0,43,950,700,250,0.7368421052631579,12,7,5,314.9789476519608,0.39853266888150607,0.0833126093928005,0.18182118089327484,130768.17626953137,-362.155490451373,130406.02077907999,3631,5,990.1162790697674,39,4,17,36.24276487761822,0.6225961538461537,44.29687500000001,1022.8125000000009,26.22596153846156,0
3780,4,0,0,43,0.0,0.0,1.0,43,1150,700,450,0.6086956521739131,16,7,9,311.8678554934212,0.39793281653746765,0.06819990185007807,0.17317713340880414,129254.345703125,-484.01421440972223,128770.33148871528,3632,6,991.1162790697674,39,4,19,37.85298436112818,0.6073717948717949,45.78125,1016.875,26.07371794871795,6
3781,4,1,1,43,0.022727272727272728,0.022727272727272728,0.9772727272727273,44,1200,800,400,0.6666666666666666,16,8,8,305.89913965131825,0.4044441508104299,0.06806836334591893,0.17097576912654028,129511.5341397316,-876.5066263467608,128635.02751338483,3633,0,969.5681818181819,40,4,15,37.74419262513312,0.6083333333333334,45.52845528455284,1017.8861788617883,25.447154471544707,0
3782,4,0,0,43,0.0,0.0,1.0,43,800,500,300,0.625,11,5,6,311.68251567003233,0.39818660022148394,0.0745042964937761,0.17400789589121213,129466.2814670138,-529.5247395833385,128936.75672743046,3634,8,993.1162790697674,39,4,16,37.64286932787446,0.6095085470085471,45.572916666666664,1017.7083333333326,26.09508547008545,0
3783,4,0,0,43,0.0,0.0,1.0,43,1250,900,350,0.72,16,9,7,310.4924745390202,0.3980481727574751,0.07648843157080787,0.17392916553690124,129598.82948133702,-552.1077473958135,129046.7217339412,3635,9,994.1162790697674,39,4,16,37.53889599317987,0.610844017094017,45.44270833333334,1018.2291666666683,26.108440170940213,0
3784,4,0,0,43,0.0,0.0,1.0,43,1200,1000,200,0.8333333333333334,14,10,4,311.1947158284596,0.39811738648947953,0.07297555036064418,0.17479455060807098,129704.91672092055,-527.3030598957932,129177.61366102475,3636,10,995.1162790697674,39,4,16,37.41361165081636,0.6119123931623931,45.338541666666686,1018.6458333333367,26.119123931624017,0
3785,4,1,0,44,0.022727272727272728,0.0,1.0,44,900,600,300,0.6666666666666666,12,6,6,306.0730845063676,0.40190054615926707,0.07739686307911176,0.17300457785083895,129951.54303200827,-845.0660775662388,129106.47695444203,3637,0,973.4772727272727,40,4,17,37.29463603441975,0.6127604166666666,45.096544715447166,1019.6138211382131,25.49034552845533,0
3786,4,0,0,44,0.0,0.0,1.0,44,1450,1300,150,0.896551724137931,16,13,3,306.53982687957256,0.40123986962649755,0.07167274900614906,0.1739600521223308,130107.01844346963,-823.4034181042857,129283.61502536535,3638,1,974.4772727272727,40,4,18,37.125626722449134,0.6143229166666666,44.94410569105692,1020.2235772357734,25.505589430894336,0
3787,4,0,0,44,0.0,0.0,1.0,44,950,700,250,0.7368421052631579,12,7,5,310.03748438150757,0.40121784707540525,0.07263450834879404,0.17664926435690562,130262.58680555566,-722.7430555555455,129539.84375000012,3639,2,975.4772727272727,40,4,19,36.87925170068028,0.6158854166666666,44.79166666666667,1020.8333333333343,25.520833333333357,0
3788,4,1,1,44,0.022222222222222223,0.022222222222222223,0.9777777777777777,45,1100,600,500,0.5454545454545454,16,6,10,306.7246299067985,0.4044402356902357,0.0674888933094624,0.17581581693745446,130496.11363110582,-994.7255684447097,129501.3880626611,3640,0,954.7777777777778,40,5,15,36.728126450500625,0.6182291666666667,44.5630081300813,1021.7479674796748,25.54369918699187,0
3789,4,2,1,45,0.043478260869565216,0.021739130434782608,0.9782608695652174,46,1250,900,350,0.72,16,9,7,302.31575783475165,0.40778985507246374,0.07553783953558013,0.17486160462982553,130845.55820302642,-1288.6651825082038,129556.89302051821,3641,0,934.9782608695652,41,5,17,36.48863489446976,0.6201727642276423,44.22123015873015,1023.115079365078,24.954026325977512,0
3790,4,0,0,45,0.0,0.0,1.0,45,1000,600,400,0.6,14,6,8,308.3056999843789,0.4039351851851852,0.08131589115195714,0.17803194895827731,130781.8193225759,-935.8439297045308,129845.97539287138,3642,1,956.7555555555556,40,5,17,36.39965226030802,0.62109375,44.28353658536586,1022.865853658537,25.571646341463428,0
3791,4,0,0,45,0.0,0.0,1.0,45,1400,1000,400,0.7142857142857143,18,10,8,306.1810938779903,0.4041456228956229,0.074435949205089,0.17752157722770517,130937.79047070196,-981.8648167426761,129955.92565395929,3643,2,957.7555555555556,40,5,17,36.296875517161496,0.62265625,44.13109756097561,1023.4756097560976,25.586890243902438,0
3792,4,1,0,46,0.021739130434782608,0.0,1.0,46,1200,1100,100,0.9166666666666666,13,11,2,299.2124602106454,0.40574677938808373,0.0797676836995469,0.17467309647231943,131201.0476210158,-1348.6023518203724,129852.44526919544,3644,0,937.9130434782609,41,5,18,36.21039911558698,0.623729674796748,43.87400793650793,1024.5039682539668,24.9879016647309,0
3793,4,1,0,47,0.02127659574468085,0.0,1.0,47,1350,1000,350,0.7407407407407407,17,10,7,295.0570561037715,0.4088613937711995,0.08307863529629977,0.17376347283030777,131536.5409561111,-1637.7200673367845,129898.82088877431,3645,0,918.936170212766,40,7,20,35.97991381018428,0.6286458333333332,43.54674796747969,1025.8130081300837,25.645325203252092,0
3794,4,0,1,46,0.0,0.02127659574468085,0.9787234042553191,47,1200,900,300,0.75,15,9,6,294.1522691906922,0.4084952204748689,0.07892801527312687,0.17358594167261396,131614.7395420222,-1657.0451409544316,129957.69440106777,3646,1,919.936170212766,40,7,14,35.92465583836785,0.6294270833333332,43.470528455284565,1026.117886178864,25.652947154471597,0
3795,4,1,1,46,0.02127659574468085,0.02127659574468085,0.9787234042553191,47,950,600,350,0.631578947368421,13,6,7,292.9225686033014,0.4081097748997842,0.08288557275312636,0.17329158475347972,131709.7262081917,-1683.8497378117795,130025.87647037994,3647,0,920.8936170212766,41,6,14,35.860937953029875,0.628810975609756,43.3779761904762,1026.488095238096,25.036295005807222,0
3796,4,0,0,46,0.0,0.0,1.0,46,1550,1200,350,0.7741935483870968,19,12,7,295.81099892167407,0.40456924315619963,0.07886784330606944,0.1749233658728872,131692.96136558952,-1408.7547094982906,130284.20665609124,3648,4,941.9130434782609,40,6,16,35.8036303630363,0.6302083333333333,43.39430894308944,1026.4227642276442,25.660569105691103,0
3797,4,0,1,45,0.0,0.021739130434782608,0.9782608695652174,46,1550,1100,450,0.7096774193548387,20,11,9,295.9920341608555,0.404579307568438,0.08823225695415493,0.17563120993514098,131823.38271077102,-1396.265760294771,130427.11695047625,3649,5,942.9130434782609,40,6,16,35.668192314035956,0.6315104166666665,43.26727642276424,1026.9308943089454,25.673272357723636,0
3798,4,0,0,45,0.0,0.0,1.0,45,1050,700,350,0.6666666666666666,14,7,7,300.6120456409927,0.4030723905723906,0.0781103782625856,0.17792983241993918,131728.8208007815,-1080.145941840247,130648.67485894126,3650,9,964.7555555555556,39,6,16,35.64444867241673,0.6322115384615383,43.359375000000014,1026.562500000002,26.322115384615437,0
3799,4,0,0,45,0.0,0.0,1.0,45,1650,1300,350,0.7878787878787878,20,13,7,303.54759384942037,0.4034090909090909,0.08175722126427076,0.18017313231555923,131835.7760959203,-996.3134765624802,130839.46261935782,3651,10,965.7555555555556,39,6,16,35.46178195895459,0.6332799145299145,43.25520833333334,1026.979166666668,26.332799145299184,0
3800,4,1,1,45,0.021739130434782608,0.021739130434782608,0.9782608695652174,46,950,700,250,0.7368421052631579,12,7,5,295.49754587465884,0.4066727053140096,0.08198434077691918,0.17658278952440692,132091.8810232427,-1393.434665532868,130698.44635770982,3652,0,945.7391304347826,41,5,16,35.41184134337003,0.6326219512195121,43.00595238095239,1027.976190476191,25.072590011614416,0
3801,4,0,0,45,0.0,0.0,1.0,45,750,400,350,0.5333333333333333,11,4,7,300.5720457754018,0.4030723905723906,0.08156061105615997,0.17896250782033674,131953.86860499723,-1067.6711530834668,130886.19745191376,3653,12,967.7555555555556,40,5,16,35.41975766567754,0.6328125,43.14024390243903,1027.4390243902455,25.685975609756138,0
3802,4,0,0,45,0.0,0.0,1.0,45,750,500,250,0.6666666666666666,10,5,5,300.4757174592563,0.4028409090909091,0.08193936197101093,0.17902828398530016,131979.97352972784,-1068.6445526802636,130911.32897704758,3654,13,968.7555555555556,40,5,16,35.396062044637844,0.6330729166666667,43.11483739837399,1027.5406504065054,25.688516260162636,0
3803,4,0,0,45,0.0,0.0,1.0,45,850,500,350,0.5882352941176471,12,5,7,301.4523105765712,0.4023358585858586,0.08775954122997787,0.179981621556756,132058.3037956906,-1038.1438379932429,131020.15995769735,3655,14,969.7555555555556,40,5,16,35.29245764946278,0.6338541666666666,43.03861788617887,1027.845528455286,25.696138211382152,0
3804,4,1,0,46,0.021739130434782608,0.0,1.0,46,1150,500,650,0.43478260869565216,18,5,13,296.3177531644448,0.4048409822866345,0.10221075902726584,0.17839538200716556,132373.07328285553,-1355.101669070376,131017.97161378516,3656,0,949.6521739130435,42,4,17,35.109267106089135,0.6339285714285714,42.73255813953488,1029.06976744186,24.501661129568095,0
3805,4,2,1,47,0.041666666666666664,0.020833333333333332,0.9791666666666666,48,1250,900,350,0.72,16,9,7,286.39507947203435,0.40866947399527187,0.10835979090500913,0.17489955675865607,132908.99490583278,-1987.0965261843337,130921.89837964844,3657,0,911.0416666666666,41,7,14,34.82938874991981,0.6407520325203251,42.21230158730159,1031.1507936507942,25.150019357336443,0
3806,4,1,1,47,0.020833333333333332,0.020833333333333332,0.9791666666666666,48,1150,800,350,0.6956521739130435,15,8,7,286.2828052844729,0.4079861111111111,0.11363964223889234,0.17531028323603953,133011.31129535157,-1984.2297335600833,131027.08156179148,3658,0,912.0208333333334,41,7,15,34.730236583958465,0.6417682926829268,42.11309523809524,1031.5476190476197,25.1596980255517,0
3807,4,1,0,48,0.020833333333333332,0.0,1.0,48,1500,1100,400,0.7333333333333333,19,11,8,287.7265522116553,0.4063885195035461,0.12085254932103529,0.1774086466480397,133267.2745023936,-1931.0933169564064,131336.1811854372,3659,0,913.0,41,7,17,34.437852293107866,0.6443089430894309,41.86507936507937,1032.5396825396829,25.183894696089826,0
3808,4,0,0,48,0.0,0.0,1.0,48,1100,800,300,0.7272727272727273,14,8,6,289.1504512954384,0.4060930112293144,0.12887901385110867,0.17891079287641734,133397.13588613967,-1885.6315914007523,131511.50429473893,3660,1,914.0,42,6,18,34.2717224775662,0.6440972222222222,41.73934108527132,1033.042635658915,24.596253229974167,0
3809,4,0,0,48,0.0,0.0,1.0,48,1350,800,550,0.5925925925925926,19,8,11,291.4485000908195,0.40541888297872336,0.13161528501655395,0.18082610112407213,133498.47690073695,-1818.3715760053062,131680.10532473164,3661,2,915.0,40,8,18,34.111433441505234,0.6481770833333333,41.641260162601625,1033.434959349593,25.835873983739827,0
3810,4,0,0,48,0.0,0.0,1.0,48,1300,900,400,0.6923076923076923,17,9,8,293.3768624092932,0.4047539893617021,0.13713468973199627,0.182669289972592,133629.789022738,-1759.2223544186481,131870.56666831934,3662,3,916.0,40,8,20,33.930853155101225,0.6494791666666666,41.51422764227643,1033.943089430896,25.8485772357724,0
3811,4,1,2,47,0.02040816326530612,0.04081632653061224,0.9591836734693877,49,1100,900,200,0.8181818181818182,13,9,4,288.9871901408767,0.40722434807256236,0.13966280464069003,0.18129905921465833,133908.25897778096,-2060.4457002708486,131847.8132775101,3663,0,898.2857142857143,41,8,13,33.767352790823985,0.650660569105691,41.245039682539684,1035.0198412698417,25.244386372435162,0
3812,4,0,0,47,0.0,0.0,1.0,47,1650,1200,450,0.7272727272727273,21,12,9,301.8665611292023,0.4017113783533765,0.1290904378484785,0.18893765291092426,133822.27783203137,-1320.7058376735959,132501.57199435777,3664,5,936.6170212765958,39,8,15,33.51968606329073,0.6530448717948718,41.32812500000001,1034.687500000001,26.53044871794874,0
3813,4,0,0,47,0.0,0.0,1.0,47,1000,700,300,0.7,13,7,6,302.5871211826542,0.4017884674683934,0.13060609175317772,0.1898046487418469,133903.12500000015,-1296.5277777777633,132606.5972222224,3665,6,937.6170212765958,39,8,16,33.42055823939884,0.6538461538461537,41.25000000000001,1035.0000000000011,26.53846153846157,0
3814,4,0,0,47,0.0,0.0,1.0,47,1100,600,500,0.5454545454545454,16,6,10,303.6200475472017,0.40115248226950356,0.13158914189462512,0.19115179814228864,134037.92453342036,-1260.6797960069207,132777.24473741345,3666,7,938.6170212765958,39,8,16,33.25966955034705,0.6551816239316238,41.11979166666668,1035.520833333335,26.551816239316285,0
3815,4,0,0,47,0.0,0.0,1.0,47,1300,800,500,0.6153846153846154,18,8,10,301.2086703954419,0.4008826703669442,0.13257120364863884,0.19033173035279974,134172.79188368074,-1317.1983506944248,132855.5935329863,3667,8,939.6170212765958,39,8,16,33.18796501105974,0.6565170940170939,40.98958333333334,1036.041666666668,26.565170940170976,0
3816,4,0,0,47,0.0,0.0,1.0,47,1300,900,400,0.6923076923076923,17,9,8,301.3964293830962,0.4002274128893,0.1357853095263548,0.19101238677463753,134280.73459201402,-1305.6532118055459,132975.0813802085,3668,9,940.6170212765958,39,8,16,33.07579564489111,0.65758547008547,40.88541666666667,1036.4583333333344,26.575854700854727,0
3817,4,0,1,46,0.0,0.02127659574468085,0.9787234042553191,47,1650,1100,550,0.6666666666666666,22,11,11,316.4341761952005,0.40053576934936785,0.1370301070152542,0.19719033691712234,133660.65673828134,-941.0400390624858,132719.61669921884,3669,10,941.6170212765958,39,8,19,33.304057116953786,0.6514423076923077,41.48437500000001,1034.0625000000007,26.514423076923094,2
3818,4,0,0,46,0.0,0.0,1.0,46,750,400,350,0.5333333333333333,11,4,7,329.37249331017193,0.39789653784219,0.15267543690443985,0.2006501621408453,132816.69439693642,-450.7668426531789,132365.92755428323,3670,11,962.4782608695652,40,6,13,33.81396036675538,0.64140625,42.301829268292686,1030.79268292683,25.76981707317075,2
3819,4,0,0,46,0.0,0.0,1.0,46,1500,1200,300,0.8,18,12,6,331.50253585381836,0.39815821256038647,0.15488113086313948,0.2029403340721506,133000.07952442332,-382.02727377883434,132618.05225064448,3671,12,963.4782608695652,40,6,13,33.57532840722496,0.6432291666666667,42.1239837398374,1031.5040650406506,25.787601626016265,0
3820,4,0,0,46,0.0,0.0,1.0,46,1100,900,200,0.8181818181818182,13,9,4,332.6774371546411,0.3988526570048309,0.15478586292829477,0.20423256933907072,133104.9278290041,-343.79874743867913,132761.12908156542,3672,13,964.4782608695652,40,6,14,33.44002363600551,0.6442708333333333,42.022357723577244,1031.9105691056925,25.79776422764231,0
3821,4,0,0,46,0.0,0.0,1.0,46,950,500,450,0.5263157894736842,14,5,9,331.923874427179,0.398329307568438,0.15515322480533889,0.20420053255947057,133183.5911680383,-358.6372818758556,132824.95388616246,3673,14,965.4782608695652,40,6,16,33.38071444980474,0.6450520833333333,41.94613821138212,1032.2154471544723,25.805386178861806,0
3822,4,0,0,46,0.0,0.0,1.0,46,1000,800,200,0.8,12,8,4,330.446517143034,0.3983091787439614,0.1537658336186234,0.2037218819279873,133262.2777447289,-392.7888905413212,132869.48885418757,3674,15,966.4782608695652,40,6,16,33.34010006561681,0.6458333333333333,41.869918699187004,1032.5203252032538,25.813008130081347,0
3823,4,0,0,46,0.0,0.0,1.0,46,1100,700,400,0.6363636363636364,15,7,8,330.9689993976779,0.39789653784219,0.150163407080403,0.20462097991958642,133367.22932778118,-371.91631138871503,132995.31301639247,3675,16,967.4782608695652,40,6,17,33.221623704578256,0.6468749999999999,41.768292682926834,1032.9268292682934,25.823170731707336,0
3824,4,0,0,46,0.0,0.0,1.0,46,1150,600,550,0.5217391304347826,17,6,11,331.0353798126947,0.39735305958132044,0.15550490883590418,0.205241935483871,133472.22222222248,-363.19444444442183,133109.02777777807,3676,17,968.4782608695652,40,6,18,33.11491935483871,0.6479166666666666,41.66666666666668,1033.3333333333353,25.833333333333382,0
3825,4,0,0,46,0.0,0.0,1.0,46,900,700,200,0.7777777777777778,11,7,4,330.65014186972076,0.3969806763285024,0.16057626680931847,0.2056312359859981,133585.55036164992,-365.98376423513275,133219.56659741479,3677,18,969.4782608695652,37,9,20,33.01159666242398,0.6542792792792792,41.55701754385966,1033.771929824563,27.93978188715035,0
3826,4,0,0,46,0.0,0.0,1.0,46,1200,900,300,0.75,15,9,6,327.67188695787235,0.39678945249597425,0.15509213371259434,0.20424808763381982,133670.578026412,-439.98189346721205,133230.59613294477,3678,19,970.4782608695652,37,9,20,33.00363605838901,0.6551238738738738,41.47478070175439,1034.1008771929828,27.9486723565671,0
3827,4,0,0,46,0.0,0.0,1.0,46,1500,1200,300,0.8,18,12,6,325.5685072151587,0.3964170692431562,0.14951987761947771,0.20371780066858344,133812.3509156664,-486.9825330870986,133325.3683825793,3679,20,971.4782608695652,37,9,15,32.91649003815176,0.6565315315315314,41.33771929824562,1034.6491228070179,27.963489805595078,0
3828,4,0,0,46,0.0,0.0,1.0,46,1050,900,150,0.8571428571428571,12,9,3,325.0572114126183,0.39618558776167473,0.1488613275221029,0.20355440637696604,133840.7145107148,-498.8221135349413,133341.89239717988,3680,21,972.4782608695652,37,9,15,32.90141199533749,0.6568130630630631,41.310307017543856,1034.7587719298242,27.966453295400655,0
3829,4,0,0,46,0.0,0.0,1.0,46,1650,1500,150,0.9090909090909091,18,15,3,326.3330425864334,0.39559178743961354,0.1510835913312698,0.20506920769536574,133969.4793721236,-456.26643655489477,133513.2129355687,3681,22,973.4782608695652,38,8,16,32.73993808049536,0.65625,41.18589743589744,1035.2564102564104,27.243589743589748,0
3830,4,0,0,46,0.0,0.0,1.0,46,1600,1400,200,0.875,18,14,4,328.0430533771199,0.3948671497584541,0.15107081360309893,0.20707717744430684,134135.43721236027,-399.5603221564835,133735.87689020377,3682,23,974.4782608695652,38,8,16,32.53016707920791,0.6578947368421053,41.02564102564102,1035.8974358974356,27.260458839406198,0
3831,4,0,0,46,0.0,0.0,1.0,46,750,500,250,0.6666666666666666,10,5,5,330.9503666702096,0.39423309178743965,0.1549663827879877,0.20954429221286086,134246.13284388903,-314.2386222514683,133931.89422163757,3683,24,975.4782608695652,38,8,17,32.344501718213046,0.6589912280701755,40.91880341880341,1036.3247863247846,27.271704903283805,0
3832,4,0,0,46,0.0,0.0,1.0,46,1100,800,300,0.7272727272727273,14,8,6,335.0473846606405,0.3936694847020934,0.16193927557136312,0.21310418843487366,134412.26189823926,-193.10463693478601,134219.15726130447,3684,25,976.4782608695652,38,8,17,32.07272992650594,0.6606359649122808,40.758547008547,1036.9658119658104,27.288573999100276,0
3833,4,0,0,46,0.0,0.0,1.0,46,1600,1200,400,0.75,20,12,8,337.440164873505,0.39317632850241546,0.16709187098853362,0.21593503040719503,134633.92710387876,-113.8210880999635,134520.1060157788,3685,26,977.4782608695652,38,8,19,31.78981367099032,0.6628289473684212,40.54487179487178,1037.8205128205107,27.311066126855543,0
3834,4,0,0,46,0.0,0.0,1.0,46,1050,600,450,0.5714285714285714,15,6,9,340.77292598188535,0.3925523349436393,0.1685638347852938,0.2185670311396683,134717.09863987484,-18.41202333993425,134698.6866165349,3686,27,978.4782608695652,38,8,19,31.620484717505413,0.6636513157894738,40.46474358974358,1038.1410256410238,27.319500674763784,0
3835,4,0,0,46,0.0,0.0,1.0,46,1200,900,300,0.75,15,9,6,343.23623380398914,0.39242149758454103,0.15523084179083657,0.2184948813140991,134442.73003472202,29.123263888869346,134471.8532986109,3687,28,979.4782608695652,39,7,18,31.830052229811173,0.6591880341880343,40.72916666666666,1037.0833333333317,26.591880341880298,2
3836,4,0,1,45,0.0,0.021739130434782608,0.9782608695652174,46,900,300,600,0.3333333333333333,15,3,12,342.9018340629178,0.39203904991948474,0.15571368327788693,0.21861330545160526,134498.06791798852,23.92683339942485,134521.99475138795,3688,29,980.4782608695652,40,6,18,31.783539074491365,0.6580729166666668,40.67581300813008,1037.296747967479,25.932418699186975,0
3837,4,0,0,45,0.0,0.0,1.0,45,1000,700,300,0.7,13,7,6,336.94799593121735,0.3903409090909091,0.17039087733175196,0.20117426392256946,132058.30379569015,-100.64383799328516,131957.65995769686,3689,30,1002.5777777777778,40,5,18,34.38035561268209,0.6338541666666668,43.03861788617885,1027.8455284552824,25.69613821138206,7
3838,4,0,0,45,0.0,0.0,1.0,45,1600,1300,300,0.8125,19,13,6,334.7716693286628,0.39053030303030306,0.16787733105030433,0.20112128241032906,132293.4340195151,-142.3812504131521,132151.05276910192,3690,31,1003.5777777777778,40,5,19,34.199965425269184,0.6361979166666669,42.80995934959348,1028.7601626016228,25.719004065040572,0
3839,4,1,0,46,0.021739130434782608,0.0,1.0,46,950,600,350,0.631578947368421,13,6,7,332.02199272593157,0.39368961352657,0.17443646442024696,0.20099826011257965,132581.09941998785,-395.9905231674553,132185.1088968204,3691,0,982.7391304347826,40,6,20,33.98193375435825,0.6390625000000001,42.530487804878035,1029.8780487804856,25.74695121951214,0
3840,4,0,1,45,0.0,0.021739130434782608,0.9782608695652174,46,1300,1000,300,0.7692307692307693,16,10,6,334.70126525163016,0.3932165861513688,0.1770848076997309,0.20304408892015396,132659.6078413146,-319.7322815453929,132339.87555976922,3692,1,983.7391304347826,40,6,15,33.83418006642332,0.6398437500000002,42.45426829268292,1030.1829268292674,25.754573170731685,0
3841,4,0,0,45,0.0,0.0,1.0,45,1400,1200,200,0.8571428571428571,16,12,4,326.2649959357284,0.3934132996632997,0.1078698301568779,0.18517159040855605,130110.72137188223,-507.40393879640555,129603.31743308583,3693,2,1004.1555555555556,41,4,18,36.61877674056787,0.6128048780487805,44.9404761904762,1020.2380952380964,24.883855981416986,6
3842,4,1,0,46,0.021739130434782608,0.0,1.0,46,1050,800,250,0.7619047619047619,13,8,5,320.562821600294,0.39646739130434777,0.11369873242854767,0.18343754582483657,130430.54112803943,-837.320657140967,129593.22047089846,3694,0,983.304347826087,37,9,19,36.440890224703026,0.6227477477477477,44.627192982456144,1021.4912280701757,27.607871028923668,0
3843,4,0,1,45,0.0,0.021739130434782608,0.9782608695652174,46,1450,1000,450,0.6896551724137931,19,10,9,319.4217758146845,0.39673913043478265,0.11399917589355679,0.1836254180474225,130608.4106445314,-856.1659071180404,129752.24473741335,3695,1,984.304347826087,39,7,14,36.290401338360674,0.6209935897435896,44.45312500000001,1022.1875000000011,26.209935897435926,0
3844,4,0,0,45,0.0,0.0,1.0,45,1150,700,450,0.6086956521739131,16,7,9,325.6369260970348,0.39425505050505055,0.10704768542719378,0.18684566275453746,130535.38795976709,-498.57150357950627,130036.81645618759,3696,5,1007.1555555555556,38,7,16,36.2053493640007,0.6219846491228069,44.524572649572654,1021.9017094017104,26.89215024741343,0
3845,4,1,0,46,0.021739130434782608,0.0,1.0,46,1150,900,250,0.782608695652174,14,9,5,319.38617954129626,0.39790660225442837,0.11237929902748234,0.18480345147251578,130859.79327781106,-841.0381138872142,130018.75516392384,3697,0,986.2391304347826,40,6,17,36.03765229770892,0.621875,44.20731707317074,1023.1707317073189,25.579268292682972,0
3846,4,0,0,46,0.0,0.0,1.0,46,1150,900,250,0.782608695652174,14,9,5,316.6797942818066,0.3973429951690821,0.1046767620955209,0.1837326548390756,130963.79469892252,-905.2824872760985,130058.51221164642,3698,1,987.2391304347826,40,6,17,36.0020353455123,0.6229166666666668,44.105691056910565,1023.5772357723571,25.589430894308926,0
3847,4,0,0,46,0.0,0.0,1.0,46,1050,700,350,0.6666666666666666,14,7,7,319.61686852329603,0.3976147342995169,0.1035041536303809,0.18581303810572466,131041.82287535533,-823.3645853988986,130218.45828995643,3699,2,988.2391304347826,40,6,17,35.84822167080232,0.6236979166666667,44.02947154471545,1023.8821138211385,25.597052845528463,0
3848,4,0,0,46,0.0,0.0,1.0,46,1200,700,500,0.5833333333333334,17,7,10,317.8313570798689,0.39816827697262475,0.10626725327812281,0.185401624963257,131171.9214753124,-861.8900373454886,130310.03143796693,3700,3,989.2391304347826,40,6,17,35.762855489418,0.625,43.90243902439025,1024.3902439024396,25.60975609756099,0
3849,4,0,0,46,0.0,0.0,1.0,46,700,500,200,0.7142857142857143,9,5,4,317.6483557285779,0.39837962962962964,0.10841100132405801,0.1854205601679092,131197.94894118904,-865.0374487738821,130332.91149241515,3701,4,990.2391304347826,40,6,17,35.74132857190094,0.6252604166666667,43.8770325203252,1024.4918699186987,25.61229674796747,0
3850,4,0,0,46,0.0,0.0,1.0,46,1200,1000,200,0.8333333333333334,14,10,4,321.08065217796593,0.39820853462157807,0.11480761216835678,0.18768772248705212,131251.87119118476,-771.5127196712072,130480.35847151355,3702,5,991.2391304347826,41,5,17,35.59910204279213,0.6242378048780488,43.82440476190476,1024.7023809523805,24.99274099883855,0
3851,4,0,0,46,0.0,0.0,1.0,46,1350,1100,250,0.8148148148148148,16,11,5,319.2544120563158,0.39842995169082124,0.11770943796394495,0.1869918699186993,131328.12500000012,-814.5611890589421,130513.56381094118,3703,6,992.2391304347826,40,6,18,35.569105691056926,0.6265624999999999,43.75000000000001,1025.000000000001,25.62500000000002,0
3852,4,1,1,46,0.02127659574468085,0.02127659574468085,0.9787234042553191,47,1200,1000,200,0.8333333333333334,14,10,4,310.97914237266264,0.40155720012334256,0.11896183360513812,0.18364136723269855,131640.81090124924,-1212.4907049375358,130428.3201963117,3704,0,972.1063829787234,40,7,15,35.46680035650626,0.6296875,43.44512195121951,1026.2195121951218,25.655487804878042,0
3853,4,0,1,45,0.0,0.021739130434782608,0.9782608695652174,46,900,800,100,0.8888888888888888,10,8,2,314.3538551851274,0.3983997584541063,0.120771230464354,0.18554223052298902,131621.90890842007,-924.829101562505,130697.07980685757,3705,8,994.2391304347826,39,7,15,35.39921919940446,0.6311431623931625,43.463541666666664,1026.1458333333328,26.31143162393161,0
3854,4,0,0,45,0.0,0.0,1.0,45,1100,700,400,0.6363636363636364,15,7,8,313.8622755638041,0.3982112794612795,0.12812845319441668,0.18564218867981533,131702.08875868047,-732.7365451388935,130969.35221354158,3706,9,1012.9555555555555,39,6,15,35.33125295988093,0.6319444444444444,43.385416666666664,1026.4583333333328,26.319444444444432,0
3855,4,0,0,45,0.0,0.0,1.0,45,1300,900,400,0.6923076923076923,17,9,8,317.66670459972823,0.3969486531986532,0.1419770612226503,0.18895229437650915,131916.02105034734,-618.9344618055512,131297.08658854177,3707,10,1013.9555555555555,39,6,15,35.01867437301424,0.6340811965811965,43.177083333333336,1027.2916666666674,26.340811965811984,0
3856,4,0,0,45,0.0,0.0,1.0,45,1250,1000,250,0.8,15,10,5,317.380445428468,0.3968644781144781,0.1447598450031542,0.18904835227695704,131969.53124999997,-623.0902777777778,131346.4409722222,3708,11,1014.9555555555555,39,6,15,34.97228980805623,0.6346153846153846,43.125,1027.4999999999998,26.34615384615384,0
3857,4,0,0,45,0.0,0.0,1.0,45,1600,1100,500,0.6875,21,11,10,319.25492675630903,0.39684343434343433,0.15209349325600763,0.1908736902521764,132110.53688280797,-564.6120447484889,131545.92483805947,3709,12,1015.9555555555555,40,5,16,34.7825639251351,0.634375,42.987804878048784,1028.0487804878057,25.701219512195145,0
3858,4,0,0,45,0.0,0.0,1.0,45,600,400,200,0.6666666666666666,8,4,4,318.7772743589144,0.3968644781144781,0.15223660944724537,0.19071967384323713,132136.65729930936,-575.5673086456368,131561.08999066372,3710,13,1016.9555555555555,40,5,16,34.76862376857436,0.6346354166666666,42.962398373983746,1028.1504065040658,25.703760162601647,0
3859,4,0,0,45,0.0,0.0,1.0,45,1300,1100,200,0.8461538461538461,15,11,4,320.0685791440414,0.3966329966329966,0.15226866032122377,0.19202217483798736,132241.16478493303,-534.7516565866773,131706.41312834635,3711,14,1017.9555555555555,40,5,16,34.63055363435759,0.6356770833333333,42.86077235772358,1028.5569105691068,25.713922764227668,0
3860,4,0,0,45,0.0,0.0,1.0,45,1200,800,400,0.6666666666666666,16,8,8,318.81750450869146,0.39640151515151517,0.14927784362790297,0.1916691458222084,132319.5725097494,-562.8408189569784,131756.73169079243,3712,15,1018.9555555555555,40,5,16,34.58407414724089,0.6364583333333333,42.78455284552845,1028.8617886178854,25.721544715447134,0
3861,4,0,2,43,0.0,0.044444444444444446,0.9555555555555556,45,1250,900,350,0.72,16,9,7,319.0362366436503,0.39621212121212124,0.14938442293765175,0.19206664282126082,132371.857236103,-553.7161659726219,131818.1410701304,3713,16,1019.9555555555555,40,5,16,34.52601389163209,0.6369791666666667,42.73373983739838,1029.0650406504078,25.726626016260195,0
3862,4,0,0,43,0.0,0.0,1.0,43,800,700,100,0.875,9,7,2,332.4128048574802,0.3931570690291621,0.1506976744186046,0.1990960327786711,132178.1873790085,187.54440152675284,132365.73178053525,3714,17,1056.6744186046512,38,5,16,34.37640692640692,0.6384320175438598,42.92200854700854,1028.3119658119645,27.06084120557801,0
3863,4,0,0,43,0.0,0.0,1.0,43,1000,800,200,0.8,12,8,4,331.52027140867955,0.3933185677371724,0.154594273373579,0.19885019643933668,132233.1242809006,167.59225016435175,132400.71653106497,3715,18,1057.6744186046512,38,5,17,34.344162251999585,0.6389802631578948,42.86858974358974,1028.52564102564,27.06646423751684,0
3864,4,0,0,43,0.0,0.0,1.0,43,650,400,250,0.6153846153846154,9,4,5,330.26584444701325,0.3929032853451458,0.1545331810156818,0.19838613949970607,132288.07259706687,138.04640130761152,132426.11899837447,3716,19,1058.6744186046512,38,5,17,34.32123446533041,0.6395285087719298,42.81517094017094,1028.7393162393155,27.072087269455672,0
3865,4,0,0,43,0.0,0.0,1.0,43,500,200,300,0.4,8,2,6,331.26619500975335,0.3928340716131414,0.15506773889734093,0.19913192621372813,132315.55103550298,166.33382642998208,132481.88486193298,3717,20,1059.6744186046512,38,5,17,34.26791277258567,0.6398026315789473,42.78846153846154,1028.846153846154,27.074898785425106,0
3866,4,0,0,43,0.0,0.0,1.0,43,1100,600,500,0.5454545454545454,16,6,10,328.94988335590403,0.3923957179771133,0.156640000772458,0.19831684457138782,132425.49332493232,112.27011651689634,132537.7634414492,3718,21,1060.6744186046512,38,5,18,34.21713895232165,0.6408991228070176,42.681623931623925,1029.2735042735032,27.086144849302716,0
3867,4,0,0,43,0.0,0.0,1.0,43,400,400,0,1.0,4,4,0,329.90634549214474,0.39271871539313397,0.1601863361533169,0.19903867494156627,132452.98603121116,139.41611421578966,132592.40214542695,3719,22,1061.6744186046512,38,5,18,34.164936862134574,0.6411732456140351,42.65491452991453,1029.3803418803416,27.088956365272146,0
3868,4,0,0,43,0.0,0.0,1.0,43,1200,900,300,0.75,15,9,6,332.33240040145836,0.3928340716131414,0.16043833554093512,0.20108926600562804,132562.98539201173,210.9950279421364,132773.98041995388,3720,23,1062.6744186046512,38,5,18,33.992115364664386,0.6422697368421053,42.54807692307692,1029.8076923076915,27.100202429149775,0
3869,4,0,1,42,0.0,0.023255813953488372,0.9767441860465116,43,1350,1200,150,0.8888888888888888,15,12,3,333.7316632390417,0.3933185677371724,0.15752304597617983,0.2023799180472226,132645.51487508212,253.6016600920384,132899.11653517417,3721,24,1063.6744186046512,38,5,15,33.8732887367766,0.6430921052631579,42.467948717948715,1030.1282051282046,27.108636977058016,0
3870,4,1,0,43,0.023255813953488372,0.0,1.0,43,900,700,200,0.7777777777777778,11,7,4,328.79643246697856,0.39361849390919157,0.17896314110844425,0.20122016528356157,132988.2866753474,145.2148437500233,133133.50151909742,3722,0,1053.5348837209303,39,4,16,33.65692116070829,0.6447649572649572,42.13541666666668,1031.4583333333348,26.447649572649613,0
3871,4,0,0,43,0.0,0.0,1.0,43,850,500,350,0.5882352941176471,12,5,7,329.3045670365189,0.3935723514211886,0.1772654168085186,0.20196667099050908,133068.88156467018,164.0380859375108,133232.91965060768,3723,1,1054.5348837209303,39,4,16,33.56312047787313,0.6455662393162394,42.05729166666667,1031.7708333333337,26.455662393162402,0
3872,4,0,0,43,0.0,0.0,1.0,43,1150,900,250,0.782608695652174,14,9,5,325.95325708981494,0.39334163898117386,0.16818161549167154,0.20048856762898692,133176.3793945314,81.854926215293,133258.23432074668,3724,2,1055.5348837209303,39,4,16,33.54200306119017,0.6466346153846153,41.95312500000001,1032.1875000000011,26.46634615384618,0
3873,4,0,0,43,0.0,0.0,1.0,43,1500,1300,200,0.8666666666666667,17,13,4,325.96127601667865,0.39318014027316356,0.1717439044991269,0.20092836864908706,133257.03125000003,87.32638888888914,133344.3576388889,3725,3,1056.5348837209303,39,4,16,33.46112456281946,0.6474358974358975,41.875,1032.5000000000002,26.47435897435898,0
3874,4,0,0,43,0.0,0.0,1.0,43,1050,700,350,0.6666666666666666,14,7,7,325.07886706752635,0.39294942783314873,0.1729934148017982,0.2005293596291469,133283.92062717024,65.55718315972763,133349.47781032996,3726,4,1057.5348837209303,39,4,16,33.45701351760312,0.6477029914529915,41.848958333333336,1032.6041666666674,26.477029914529933,0
3875,4,1,0,44,0.022727272727272728,0.0,1.0,44,850,600,250,0.7058823529411765,11,6,5,323.2751699672072,0.3964499647639183,0.1840574798966903,0.20130673382023226,133633.72938368074,-159.77376302080984,133473.95562065992,3727,0,1034.4772727272727,39,5,18,33.15409026798309,0.6511752136752136,41.51041666666668,1033.9583333333348,26.511752136752175,0
3876,4,0,0,44,0.0,0.0,1.0,44,1250,800,450,0.64,17,8,9,326.1914223262231,0.39504052149400987,0.19014442217402072,0.20416253295314288,133822.27783203137,-69.66417100693042,133752.61366102443,3728,1,1035.4772727272727,39,5,15,32.8904703177959,0.6530448717948718,41.32812500000001,1034.687500000001,26.53044871794874,0
3877,4,0,0,44,0.0,0.0,1.0,44,1650,1200,450,0.7272727272727273,21,12,9,326.7467554360095,0.39439085623678644,0.18315429295407704,0.20563450840874012,134024.1126830096,-41.61120612729053,133982.5014768823,3729,2,1036.4772727272727,40,4,16,32.674739097719765,0.6533854166666666,41.13313008130082,1035.4674796747977,25.886686991869944,0
3878,4,0,1,43,0.0,0.022727272727272728,0.9772727272727273,44,1150,900,250,0.782608695652174,14,9,5,325.1520954656465,0.394567036645525,0.18431122448979576,0.20507117308080902,134103.0471280325,-79.22264359836163,134023.82448443412,3730,3,1037.4772727272727,40,4,17,32.63732175562532,0.6541666666666666,41.0569105691057,1035.772357723579,25.894308943089477,0
3879,4,0,0,43,0.0,0.0,1.0,43,1000,700,300,0.7,13,7,6,328.0866820405047,0.3945644149132521,0.180059495968119,0.20701103846515118,134118.83680555565,200.52083333334326,134319.357638889,3731,4,1056.9767441860465,39,4,17,32.54558862965942,0.655982905982906,41.04166666666667,1035.8333333333342,26.55982905982908,0
3880,4,0,0,43,0.0,0.0,1.0,43,1400,1100,300,0.7857142857142857,17,11,6,327.57758642458515,0.3943106312292359,0.17197615986911297,0.20760490349838373,134280.734592014,197.4717881944556,134478.20638020846,3732,5,1057.9767441860465,39,4,17,32.39740368509212,0.65758547008547,40.88541666666667,1036.4583333333342,26.575854700854723,0
3881,4,0,0,43,0.0,0.0,1.0,43,550,400,150,0.7272727272727273,7,4,3,330.11892557332357,0.39421834625323,0.1740132109285737,0.20967923843211797,134361.72010633672,271.0693359374959,134632.78944227422,3733,6,1058.9767441860465,39,4,17,32.2508498275227,0.6583867521367521,40.807291666666664,1036.7708333333328,26.58386752136751,0
3882,4,0,0,43,0.0,0.0,1.0,43,1000,700,300,0.7,13,7,6,329.3543419087375,0.3943106312292359,0.17193792220654602,0.20965804527131662,134442.7300347223,255.85937500001012,134698.5894097223,3734,7,1059.9767441860465,39,4,17,32.18996919780368,0.6591880341880341,40.72916666666667,1037.0833333333342,26.591880341880362,0
3883,4,0,0,43,0.0,0.0,1.0,43,1150,700,450,0.6086956521739131,16,7,9,329.7984422538806,0.3939645625692137,0.1736379832190338,0.2107238467874794,134578.49368105773,276.7989181550853,134855.29259921281,3735,8,1060.9767441860465,38,5,18,32.04326263042285,0.6622807017543859,40.598290598290596,1037.6068376068372,27.305443094916768,0
3884,4,0,0,43,0.0,0.0,1.0,43,900,600,300,0.6666666666666666,12,6,6,326.31161462678705,0.39382613510520487,0.16578753279247116,0.20895687198851592,134658.87586805565,188.1510416666722,134847.02690972234,3736,9,1061.9767441860465,39,4,18,32.053726749632006,0.6613247863247864,40.520833333333336,1037.9166666666674,26.61324786324788,0
3885,4,0,0,43,0.0,0.0,1.0,43,1150,800,350,0.6956521739130435,15,8,7,330.46373322517496,0.3935954226651901,0.1641581376680712,0.2119306026590794,134712.93945312503,303.54817708333417,135016.48763020837,3737,10,1062.9767441860465,39,4,18,31.892183423640372,0.6618589743589745,40.46875,1038.1250000000002,26.618589743589748,0
3886,4,0,0,43,0.0,0.0,1.0,43,1250,800,450,0.64,17,8,9,330.0706723795441,0.3935723514211886,0.16626227182798936,0.21199384421902673,134767.01388888882,296.5277777777728,135063.5416666666,3738,11,1063.9767441860465,39,4,18,31.84858212948101,0.6623931623931625,40.416666666666664,1038.3333333333328,26.62393162393161,0
3887,4,0,0,43,0.0,0.0,1.0,43,1100,800,300,0.7272727272727273,14,8,6,330.22442447454256,0.3935262089331857,0.16568513806317364,0.21256731674859033,134848.14588758687,306.03027343751035,135154.17616102437,3739,12,1064.9767441860465,39,4,15,31.763886103032128,0.6631944444444444,40.33854166666667,1038.645833333334,26.63194444444446,0
3888,4,0,0,43,0.0,0.0,1.0,43,1150,900,250,0.782608695652174,14,9,5,328.3022544398414,0.3927417866371355,0.173420237515862,0.21221358115687855,134999.26155892664,264.11238350188864,135263.37394242853,3740,13,1065.9767441860465,40,3,15,31.663569985005545,0.6630208333333333,40.19308943089431,1039.2276422764232,25.98069105691058,0
3889,4,0,0,43,0.0,0.0,1.0,43,1350,900,450,0.6666666666666666,18,9,9,329.8116127177765,0.392672572905131,0.17388102279210704,0.21396972794645333,135131.30954003893,313.57502561305455,135444.88456565197,3741,14,1066.9767441860465,40,3,15,31.493133613527515,0.6643229166666667,40.0660569105691,1039.7357723577231,25.993394308943078,0
3890,4,0,0,43,0.0,0.0,1.0,43,1050,500,550,0.47619047619047616,16,5,11,326.79868287933294,0.3916343669250646,0.16940373610546344,0.2129495936750944,135289.85232211318,242.50910916121455,135532.3614312744,3742,15,1067.9767441860465,40,3,16,31.414029175214086,0.6658854166666668,39.91361788617886,1040.3455284552847,26.008638211382117,0
3891,4,0,0,43,0.0,0.0,1.0,43,1300,1000,300,0.7692307692307693,16,10,6,326.9641031437719,0.39131136950904394,0.1676335766887609,0.21321391643222526,135316.28515599182,248.71356335515003,135564.99871934697,3743,16,1068.9767441860465,40,3,17,31.383489613856874,0.6661458333333332,39.88821138211382,1040.4471544715448,26.01117886178862,0
3892,4,0,0,43,0.0,0.0,1.0,43,1150,900,250,0.782608695652174,14,9,5,326.30882263183594,0.3914267257290513,0.16353561046511622,0.21309963926977046,135369.15856963446,234.43015070394358,135603.5887203384,3744,17,1069.9767441860465,40,3,17,31.348063151041664,0.6666666666666667,39.83739837398374,1040.6504065040647,26.01626016260162,0
3893,4,0,0,43,0.0,0.0,1.0,43,700,400,300,0.5714285714285714,10,4,6,335.4206196470228,0.3914267257290513,0.07971522744672033,0.20476399560401312,132895.27253123155,315.16293211714265,133210.4354633487,3745,18,1070.9767441860465,40,3,14,33.579325185623254,0.6421874999999999,42.22560975609757,1031.0975609756108,25.77743902439027,7
3894,4,1,0,44,0.022727272727272728,0.0,1.0,44,1450,1100,350,0.7586206896551724,18,11,7,335.25936355493707,0.39386231501057084,0.10685350918511549,0.201174570047239,132248.45754649668,67.50674163212341,132315.9642881288,3746,0,1047.6136363636363,42,2,17,34.2326110849427,0.6326884920634921,42.85368217054264,1028.5852713178301,24.490125507567384,4
3895,4,0,0,44,0.0,0.0,1.0,44,800,700,100,0.875,9,7,2,336.7996736381761,0.3936090556730092,0.10908919641022119,0.202232202225276,132273.3759990386,109.9259734991951,132383.3019725378,3747,1,1048.6136363636363,42,2,17,34.16796188143683,0.6329365079365079,42.82945736434109,1028.6821705426362,24.492432631967528,0
3896,4,0,0,44,0.0,0.0,1.0,44,850,600,250,0.7058823529411765,11,6,5,335.7070501937757,0.39323467230443976,0.10801073749646761,0.20170921063425679,132298.2967989454,82.69419280692563,132380.99099175233,3748,2,1049.6136363636363,42,2,17,34.17102288782142,0.6331845238095237,42.80523255813954,1028.7790697674423,24.49473975636767,0
3897,4,0,0,44,0.0,0.0,1.0,44,650,400,250,0.6153846153846154,9,4,5,334.2790211740576,0.39337781888653983,0.10969365913799867,0.20098384183613502,132323.21994621717,46.57528844420392,132369.79523466137,3749,3,1050.6136363636363,42,2,17,34.18271645633201,0.6334325396825395,42.781007751937985,1028.875968992248,24.49704688076781,0
3898,4,1,0,45,0.022222222222222223,0.0,1.0,45,1150,800,350,0.6956521739130435,15,8,7,325.52666529204384,0.3966961279461279,0.12205998421468056,0.19734080618422006,132633.43578557743,-364.7926096454669,132268.64317593197,3750,0,1028.2444444444445,40,5,16,34.096701525914234,0.6395833333333333,42.47967479674797,1030.0813008130087,25.75203252032522,0
3899,4,0,0,45,0.0,0.0,1.0,45,1300,1000,300,0.7692307692307693,16,10,6,322.3722649778703,0.3965698653198653,0.12472943044586549,0.1961528266764659,132772.23799651448,-439.5825821765682,132332.6554143379,3751,1,1029.2444444444445,42,3,17,34.038877397517865,0.6378968253968255,42.34496124031007,1030.6201550387584,24.53857511997044,0
3900,4,0,0,45,0.0,0.0,1.0,45,1000,700,300,0.7,13,7,6,325.2362754291387,0.3963173400673401,0.12480030072361648,0.1985564662559643,132897.10020619223,-355.40842272102316,132541.6917834712,3752,2,1030.2444444444445,42,3,17,33.840021301256144,0.6391369047619049,42.22383720930231,1031.1046511627883,24.55011074197115,0
3901,4,0,0,45,0.0,0.0,1.0,45,900,400,500,0.4444444444444444,14,4,10,324.4447639286621,0.39602272727272725,0.12951401640347693,0.1985310319500549,132983.40292125757,-370.84624655651714,132612.55667470105,3753,3,1031.2444444444445,43,2,17,33.7740237483168,0.6385658914728685,42.140151515151494,1031.4393939393904,23.986962649753263,0
3902,4,0,0,45,0.0,0.0,1.0,45,800,300,500,0.375,13,3,10,329.6808047380122,0.3961700336700336,0.10325868795525839,0.19499847838465587,131702.0887586804,-278.94436194331615,131423.14439673707,3754,4,1032.2444444444445,39,6,19,34.92532643258237,0.6319444444444446,43.38541666666666,1026.458333333332,26.319444444444407,4
3903,4,1,1,45,0.021739130434782608,0.021739130434782608,0.9782608695652174,46,1150,800,350,0.6956521739130435,15,8,7,322.3734574373871,0.39961755233494367,0.10128512259845968,0.1918112584599494,131927.7662622279,-693.997971610846,131233.76829061707,3755,0,1010.7826086956521,40,6,19,34.88599267979027,0.6325520833333336,43.16565040650405,1027.3373983739814,25.683434959349533,0
3904,4,0,0,45,0.0,0.0,1.0,45,1000,700,300,0.7,13,7,6,326.04143372303855,0.3958754208754209,0.09493924843894441,0.19338847494835792,131809.03320312474,-404.9587673611402,131404.07443576358,3756,6,1034.2444444444445,39,6,19,34.911155068641364,0.6330128205128207,43.281249999999986,1026.874999999998,26.33012820512815,0
3905,4,0,1,44,0.0,0.022222222222222223,0.9777777777777777,45,1000,700,300,0.7,13,7,6,326.73540483788184,0.39511784511784515,0.09283295959196303,0.19427302777066502,131901.66650142087,-380.61111937340945,131521.05538204746,3757,7,1035.2444444444445,40,5,19,34.800199511937734,0.6322916666666668,43.191056910569095,1027.2357723577218,25.680894308943046,0
3906,4,0,0,44,0.0,0.0,1.0,44,650,500,150,0.7692307692307693,8,5,3,327.3082917418853,0.3933668076109937,0.09962544627199854,0.19474747034836448,131927.76626222793,-163.78963827751198,131763.9766239504,3758,8,1056.7954545454545,40,4,19,34.75924918389552,0.6325520833333336,43.16565040650405,1027.3373983739816,25.68343495934954,0
3907,4,1,0,45,0.022222222222222223,0.0,1.0,45,1150,900,250,0.782608695652174,14,9,5,318.01673671887283,0.39503367003367007,0.09673126988718583,0.19119719284124195,132321.43964356545,-583.9135133220243,131737.52613024344,3759,0,1034.2888888888888,41,4,20,34.60279866936652,0.634908536585366,42.78273809523808,1028.8690476190452,25.094367015098662,0
3908,4,0,0,45,0.0,0.0,1.0,45,950,700,250,0.7368421052631579,12,7,5,326.104885896543,0.39480218855218857,0.054809548885378145,0.19659465978334464,132424.1522903035,-363.1452412104451,132061.00704909305,3760,1,1035.2888888888888,40,5,19,34.29169135071091,0.6375,42.6829268292683,1029.2682926829277,25.731707317073194,2
3909,4,0,0,45,0.0,0.0,1.0,45,800,500,300,0.625,11,5,6,323.042158190638,0.3950126262626263,0.057473760405356566,0.19515444869584722,132502.61423631787,-439.2139062396517,132063.4003300782,3761,2,1036.2888888888888,40,5,20,34.29181883986443,0.6382812499999999,42.60670731707318,1029.5731707317088,25.73932926829272,0
3910,4,0,0,45,0.0,0.0,1.0,45,1300,900,400,0.6923076923076923,17,9,8,324.6619511707664,0.39429713804713806,0.05388294969340879,0.19678721768862031,132627.8278238378,-388.15812783447404,132239.66969600334,3762,3,1037.2888888888888,41,4,15,34.12459067706826,0.6379573170731707,42.485119047619044,1030.0595238095234,25.123403019744472,0
3911,4,0,1,44,0.0,0.022222222222222223,0.9777777777777777,45,1250,1200,50,0.96,13,12,1,316.89850542481673,0.39438131313131314,0.04221905515967239,0.17941671703045717,130015.40927716199,-754.3033091751987,129261.10596798679,3763,4,1038.2888888888888,42,3,17,36.95407759303245,0.6103670634920635,45.03391472868218,1019.8643410852727,24.28248431155411,8
3912,4,0,1,43,0.0,0.022727272727272728,0.9772727272727273,44,1150,800,350,0.6956521739130435,15,8,7,322.1987418760214,0.39229871388301624,0.04175290558828171,0.1821539421893152,129958.94451530617,-425.4783163265298,129533.46619897964,3764,14,1062.7954545454545,41,3,17,36.87609457092819,0.6112804878048781,45.089285714285715,1019.6428571428576,24.869337979094087,0
3913,4,0,0,43,0.0,0.0,1.0,43,1000,700,300,0.7,13,7,6,328.7857265690464,0.38925802879291255,0.04666001994017943,0.18547361290706058,129873.84018276159,-59.86701863970052,129813.97316412188,3765,19,1088.1860465116279,40,3,17,36.79440844134264,0.6119791666666667,45.172764227642276,1019.308943089431,25.482723577235774,0
3914,4,0,0,43,0.0,0.0,1.0,43,1300,1000,300,0.7692307692307693,16,10,6,332.45845373280247,0.38925802879291255,0.044425488909852984,0.18791862908739182,129951.543032008,40.69781132261963,129992.24084333063,3766,20,1089.1860465116279,40,3,17,36.62206385594206,0.6127604166666667,45.09654471544715,1019.6138211382109,25.490345528455272,0
3915,4,1,2,42,0.022727272727272728,0.045454545454545456,0.9545454545454546,44,1150,700,450,0.6086956521739131,16,7,9,330.5335933423187,0.39324568357998596,0.05169466067026551,0.1882047671222531,130237.26974875583,-190.44144857018483,130046.82830018565,3767,0,1065.409090909091,41,3,18,36.38179528298828,0.6140752032520326,44.816468253968246,1020.7341269841259,24.895954316685998,0
3916,4,0,0,42,0.0,0.0,1.0,42,1100,700,400,0.6363636363636364,15,7,8,339.51999316893034,0.3871588269454123,0.07167854018247755,0.19307032447367511,130186.6430165815,440.1936295351372,130626.83664611663,3768,22,1114.047619047619,41,1,19,36.20376445999808,0.6135670731707317,44.86607142857142,1020.5357142857132,24.891114982578372,0
3917,4,2,3,41,0.045454545454545456,0.06818181818181818,0.9318181818181819,44,1100,800,300,0.7272727272727273,14,8,6,325.02071681010966,0.39482029598308666,0.07231164292899805,0.18664233135884897,130566.58340419496,-312.58680555556646,130253.9965986394,3769,0,1064.3636363636363,41,3,13,36.1895748398369,0.6173780487804879,44.49404761904761,1022.0238095238091,24.927409988385588,0
3918,4,0,0,41,0.0,0.0,1.0,41,1200,1000,200,0.8333333333333334,14,10,4,342.6747905971047,0.38561991869918694,0.06768630833739575,0.19551898350665847,130317.12420784937,731.2786498283306,131048.40285767769,3770,24,1136.8292682926829,38,3,19,35.991071117156714,0.6197916666666666,44.738247863247864,1021.0470085470085,26.86965811965812,0
3919,4,0,0,41,0.0,0.0,1.0,41,950,700,250,0.7368421052631579,12,7,5,342.9183225083595,0.3857469512195122,0.06817022145116836,0.1960705241136312,130398.95171305421,743.2379556578152,131142.18966871203,3771,25,1137.8292682926829,38,3,20,35.90197873082286,0.6206140350877194,44.65811965811965,1021.3675213675208,26.878092667566335,0
3920,4,1,1,41,0.023809523809523808,0.023809523809523808,0.9761904761904762,42,750,500,250,0.6666666666666666,10,5,5,336.08771109662325,0.3904616724738676,0.070671480985383,0.1930733384824395,130581.79253472215,377.3871527777728,130959.17968749991,3772,0,1111.7142857142858,39,3,14,35.891425465416496,0.6207264957264957,44.479166666666664,1022.0833333333327,26.20726495726494,0
3921,4,0,0,41,0.0,0.0,1.0,41,1100,700,400,0.6363636363636364,15,7,8,343.341719024762,0.3850863821138211,0.07769991125256293,0.19686571946959375,130508.09500328731,761.7747370151208,131269.86974030244,3773,27,1139.8292682926829,38,3,16,35.78066185696361,0.6217105263157894,44.55128205128205,1021.7948717948717,26.889338731443992,0
3922,4,0,0,41,0.0,0.0,1.0,41,1250,900,350,0.72,16,9,7,345.2859168241964,0.3849593495934959,0.08642629904559862,0.198539402173913,130617.28395061729,820.0617283950576,131437.34567901236,3774,28,1140.8292682926829,38,3,16,35.620471014492736,0.6228070175438596,44.44444444444444,1022.2222222222223,26.900584795321638,0
3923,4,0,0,41,0.0,0.0,1.0,41,1350,900,450,0.6666666666666666,18,9,9,345.93828360691305,0.38478150406504064,0.09007039615993229,0.19961827540500152,130753.83434007216,846.5514053254315,131600.3857453976,3775,29,1141.8292682926829,38,3,18,35.46563250809568,0.6241776315789473,44.31089743589743,1022.756410256409,26.914642375168658,0
3924,4,1,1,41,0.023809523809523808,0.023809523809523808,0.9761904761904762,42,1150,800,350,0.6956521739130435,15,8,7,344.60926945409955,0.3884533488192025,0.09287191633850167,0.20058340603926925,131088.0004882815,634.8280164930839,131722.8285047746,3776,0,1115.6190476190477,39,3,19,35.161839249991544,0.6258012820512819,43.984375000000014,1024.062500000002,26.258012820512874,0
3925,4,0,0,41,0.0,0.0,1.0,41,1200,900,300,0.75,15,9,6,349.3541969985292,0.38455284552845526,0.09061644498606358,0.20278226189631132,130981.34901258703,951.7768012153022,131933.12581380233,3777,31,1143.8292682926829,39,2,19,35.148167463790244,0.6247329059829059,44.08854166666668,1023.6458333333352,26.247329059829106,0
3926,4,0,1,40,0.0,0.024390243902439025,0.975609756097561,41,850,600,250,0.7058823529411765,11,6,5,352.29745775561975,0.38488313008130076,0.08489065458362388,0.2047741994251916,131034.66932508697,1032.6361762152965,132067.30550130227,3778,32,1144.8292682926829,39,2,19,35.01892783260421,0.6252670940170939,44.03645833333334,1023.854166666668,26.252670940170976,0
3927,4,0,0,40,0.0,0.0,1.0,40,800,700,100,0.875,9,7,2,350.3841340513959,0.38429487179487176,0.10113458528951469,0.2039120780135171,131081.84633875726,1185.799843852709,132267.64618260995,3779,33,1171.4,38,2,19,35.020213875847666,0.627467105263158,43.990384615384606,1024.0384615384603,26.948380566801585,0
3928,4,0,1,39,0.0,0.025,0.975,40,750,400,350,0.5333333333333333,11,4,7,351.786664822106,0.3847889957264958,0.10201108512152923,0.20504554091261226,131141.34250217024,1226.7550998263978,132368.09760199665,3780,34,1172.4,39,1,19,34.92417115834435,0.62633547008547,43.93229166666667,1024.2708333333342,26.263354700854723,0
3929,4,1,3,37,0.025,0.075,0.925,40,750,600,150,0.8,9,6,3,345.6076689039729,0.38890224358974357,0.1181246567819878,0.2028857398691602,131414.71021274658,1083.985094284529,132498.6953070311,3781,0,1169.45,36,4,19,34.80642504118614,0.6345486111111112,43.66554054054054,1025.3378378378382,28.481606606606615,0
3930,4,1,0,38,0.02631578947368421,0.0,1.0,38,700,400,300,0.5714285714285714,10,4,6,354.21775474470115,0.3866761498340446,0.12248814630842175,0.20779211069725587,131387.4488275892,1707.953425068596,133095.40225265778,3782,0,1192.8157894736842,35,3,20,34.613249793030796,0.6363095238095238,43.69212962962963,1025.2314814814818,29.29232804232805,0
3931,4,0,0,38,0.0,0.0,1.0,38,850,700,150,0.8235294117647058,10,7,3,352.06639246542665,0.3861279042200095,0.11762976775120704,0.20733318514425764,131535.8170037081,1661.8681144976122,133197.6851182057,3783,1,1193.8157894736842,35,3,20,34.51862142239272,0.6377976190476189,43.54745370370371,1025.810185185186,29.308862433862455,0
3932,4,0,0,38,0.0,0.0,1.0,38,1100,700,400,0.6363636363636364,15,7,8,350.26913227796615,0.38569819819819817,0.11373431322497507,0.20675673280801946,131624.87809713668,1620.8263674554416,133245.70446459213,3784,2,1194.8157894736842,35,3,17,34.47486653131814,0.6386904761904761,43.46064814814816,1026.157407407409,29.318783068783112,0
3933,4,0,0,38,0.0,0.0,1.0,38,1250,1100,150,0.88,14,11,3,347.7450257382626,0.3848091512565197,0.10872763513834172,0.20622953665440294,131803.09070644728,1566.7738340192213,133369.86454046651,3785,3,1195.8157894736842,35,3,19,34.35997144574694,0.6404761904761904,43.287037037037045,1026.8518518518526,29.33862433862436,0
3934,4,0,0,38,0.0,0.0,1.0,38,850,600,250,0.7058823529411765,11,6,5,336.57668949932935,0.3848091512565197,0.09314462627156117,0.187161803973926,129310.02995105548,1104.5483599970662,130414.57831105254,3786,4,1196.8157894736842,38,0,21,37.16824229691877,0.6096491228070176,45.72649572649572,1017.0940170940162,26.7656320287899,5
3935,4,2,2,38,0.05,0.05,0.95,40,1200,900,300,0.75,15,9,6,323.43037565724273,0.39447115384615383,0.08096947935368037,0.1819704234758427,129770.27253123141,394.3295987837911,130164.6021300152,3787,0,1137.925,40,0,15,37.03579027860896,0.6109375000000001,45.27439024390244,1018.9024390243903,25.47256097560976,0
3936,4,1,2,37,0.02564102564102564,0.05128205128205128,0.9487179487179487,39,600,400,200,0.6666666666666666,8,4,4,329.7236574321891,0.3902665317139002,0.09940780005190653,0.1854529668398067,129757.97661675337,756.8549262152688,130514.83154296863,3788,0,1168.076923076923,39,0,15,36.887950277749376,0.6124465811965812,45.28645833333333,1018.8541666666657,26.124465811965788,0
3937,4,1,1,37,0.02631578947368421,0.02631578947368421,0.9736842105263158,38,600,400,200,0.6666666666666666,8,4,4,338.9998994486227,0.38637980085348506,0.10314839764118622,0.19007923773789828,129636.22708013731,1189.33358901307,130825.56066915038,3789,0,1199.6315789473683,38,0,16,36.77524828647363,0.6129385964912281,45.4059829059829,1018.3760683760681,26.799370220422844,0
3938,4,0,0,37,0.0,0.0,1.0,37,500,300,200,0.6,7,3,4,348.46681137195753,0.37997372372372373,0.10553466003702994,0.19488951064923193,129536.03512619254,1627.801823638028,131163.83694983055,3790,63,1233.054054054054,37,0,17,36.63605845181673,0.6137387387387387,45.504385964912274,1017.9824561403498,27.51303935514459,0
3939,4,0,1,36,0.0,0.02702702702702703,0.972972972972973,37,600,400,200,0.6666666666666666,8,4,4,347.12966269803087,0.37916041041041043,0.1068391242847413,0.19441773509130963,129591.85157933201,1597.035145429352,131188.88672476137,3791,64,1234.054054054054,37,0,18,36.61336061454519,0.6143018018018018,45.44956140350877,1018.2017543859641,27.51896633475579,0
3940,4,0,0,36,0.0,0.0,1.0,36,1100,800,300,0.7272727272727273,14,8,6,351.52143547024633,0.37438822751322753,0.11174710270496213,0.19678670576386975,129573.74762854063,1909.5899531288023,131483.33758166945,3792,70,1267.5555555555557,36,0,18,36.5199738229547,0.6160300925925927,45.46734234234234,1018.13063063063,28.28140640640639,0
3941,4,0,0,36,0.0,0.0,1.0,36,850,400,450,0.47058823529411764,13,4,9,353.0513024695103,0.3749834656084656,0.11149507906668177,0.19793198563123257,129631.0811444891,1953.284407718531,131584.36555220763,3793,71,1268.5555555555557,36,0,19,36.42273950385197,0.6166087962962963,45.41103603603604,1018.3558558558559,28.287662662662665,0
3942,4,0,0,36,0.0,0.0,1.0,36,700,500,200,0.7142857142857143,9,5,4,351.0218318882454,0.3731481481481482,0.11268297475194045,0.19751526958487847,129774.47041636238,1910.7344675756906,131685.20488393807,3794,72,1269.5555555555557,36,0,19,36.32870063365754,0.6180555555555556,45.270270270270274,1018.9189189189194,28.303303303303316,0
3943,4,0,0,36,0.0,0.0,1.0,36,650,500,150,0.7692307692307693,8,5,3,353.3973460952593,0.37270171957671955,0.11323841799584988,0.19899767173715002,129803.15778193735,1974.4182949841752,131777.5760769215,3795,73,1270.5555555555557,36,0,19,36.23904114635135,0.6183449074074074,45.24211711711712,1019.0315315315315,28.30643143143143,0
3944,4,0,0,36,0.0,0.0,1.0,36,1100,900,200,0.8181818181818182,13,9,4,353.3973460952593,0.37270171957671955,0.11323841799584988,0.19899767173715002,129803.15778193735,1974.4182949841752,131777.5760769215,3796,74,1271.5555555555557,36,0,19,36.23904114635135,0.6183449074074074,45.24211711711712,1019.0315315315315,28.30643143143143,0
3945,4,1,0,37,0.02702702702702703,0.0,1.0,37,950,600,350,0.631578947368421,13,6,7,350.19670426160314,0.37681431431431434,0.11721684069883942,0.19881515150422324,130122.70752779715,1713.7086651662187,131836.41619296337,3797,0,1238.162162162162,37,0,20,35.99621619201147,0.6196509009009008,44.928728070175445,1020.2850877192993,27.575272641062146,0
3946,4,1,1,37,0.02631578947368421,0.02631578947368421,0.9736842105263158,38,1000,800,200,0.8,12,8,4,341.6348059040853,0.38252726410621146,0.1139112669189517,0.19508466120517917,130348.82010388772,1306.4890578302995,131655.309161718,3798,0,1206.5526315789473,36,2,21,35.98551683575946,0.6238425925925926,44.70720720720721,1021.1711711711715,28.365865865865874,0
3947,4,1,1,37,0.02631578947368421,0.02631578947368421,0.9736842105263158,38,750,500,250,0.6666666666666666,10,5,5,342.4853411552583,0.38073435277382645,0.11546854234494575,0.1957151580930711,130377.57087746535,1330.4813681925207,131708.05224565786,3799,0,1207.5263157894738,36,2,21,35.934685926416,0.6241319444444444,44.679054054054056,1021.2837837837842,28.368993993994007,0
3948,4,0,0,37,0.0,0.0,1.0,37,1000,700,300,0.7,13,7,6,348.9602355500926,0.3770332832832833,0.12594332312020917,0.19926772140857935,130348.82010388775,1697.3109934258669,132046.1310973136,3800,3,1241.162162162162,36,1,22,35.79850389648581,0.6238425925925926,44.70720720720721,1021.1711711711717,28.36586586586588,0
3949,4,0,0,37,0.0,0.0,1.0,37,950,800,150,0.8421052631578947,11,8,3,371.6526649339499,0.3770332832832833,0.1087076107185796,0.19214934567001013,126382.47796820951,2054.3684468378037,128436.84641504732,3801,4,1242.162162162162,33,4,19,39.27876802762544,0.5899621212121211,48.621323529411775,1005.5147058823543,30.470142602495585,7
3950,4,1,1,37,0.02631578947368421,0.02631578947368421,0.9736842105263158,38,1300,1000,300,0.7692307692307693,16,10,6,363.7626001894913,0.38389046941678523,0.0982088957761551,0.18954653788062423,126702.18431122464,1617.903202947864,128320.08751417251,3802,0,1210.4473684210527,34,4,19,39.147796697016275,0.5909926470588234,48.30357142857144,1006.7857142857156,29.611344537815164,0
3951,4,3,0,40,0.075,0.0,1.0,40,1400,1000,400,0.7142857142857143,18,10,8,346.95672537550774,0.3917067307692308,0.128259075907591,0.1844348908575068,127512.50000000001,849.4614512471662,128361.96145124717,3803,0,1150.85,34,6,22,38.739342684268415,0.599264705882353,47.5,1010.0000000000001,29.70588235294118,0
3952,4,2,0,42,0.047619047619047616,0.0,1.0,42,1150,700,450,0.6086956521739131,16,7,9,331.41966841098065,0.39805942702284164,0.1472663139329804,0.17896662094192958,128144.53125000001,95.48611111111154,128240.01736111112,3804,0,1097.0,35,7,24,38.48593964334706,0.6035714285714285,46.875,1012.5000000000001,28.92857142857143,0
3953,4,1,1,42,0.023255813953488372,0.023255813953488372,0.9767441860465116,43,800,600,200,0.75,10,6,4,340.9811109108029,0.40134736064968624,0.15799531278168377,0.17880716791664017,126960.75439453099,75.60492621524827,127036.35932074624,3805,0,1072.4651162790697,39,4,19,39.45574935400514,0.5841346153846155,48.046874999999986,1007.812499999998,25.8413461538461,8
3954,4,3,2,43,0.06666666666666667,0.044444444444444446,0.9555555555555556,45,1050,800,250,0.7619047619047619,13,8,5,324.8153049008106,0.4067550505050505,0.15512305197094745,0.17271113006368166,127523.29082657595,-715.4932311213776,126807.79759545457,3806,0,1025.6888888888889,38,7,17,39.28738276567237,0.5915570175438598,47.48931623931623,1010.0427350427339,26.580071974808785,0
3955,4,3,3,43,0.06521739130434782,0.06521739130434782,0.9347826086956522,46,1350,1000,350,0.7407407407407407,17,10,7,319.0161364501032,0.40650161030595816,0.149325522652765,0.17091659231002201,127828.32031249987,-1044.140625000015,126784.17968749985,3807,0,1004.3260869565217,39,7,18,39.12237330037083,0.5929487179487181,47.18749999999999,1011.249999999999,25.929487179487154,0
3956,4,4,4,43,0.0851063829787234,0.0851063829787234,0.9148936170212766,47,1250,700,550,0.56,18,7,11,314.771908723839,0.4119449583718779,0.16084887600503261,0.17053798397433598,128276.40109591992,-1324.0478515625193,126952.35324435741,3808,0,983.8085106382979,39,8,19,38.77302913453299,0.5974893162393163,46.74479166666666,1013.0208333333316,25.974893162393116,0
3957,4,0,0,43,0.0,0.0,1.0,43,900,900,0,1.0,9,9,0,347.49346007240143,0.3992017349575489,0.17776500078175106,0.18609667182274575,127811.6884522158,282.74517159123286,128094.43362380704,3809,1,1076.0697674418604,37,6,20,38.41944986626184,0.5962837837837839,47.20394736842104,1011.1842105263137,27.329302987197668,0
3958,4,3,2,44,0.06521739130434782,0.043478260869565216,0.9565217391304348,46,1150,700,450,0.6086956521739131,16,7,9,328.4812729012232,0.40962157809983896,0.18175484977314071,0.17926534041290978,128566.75347222229,-753.2130078485645,127813.54046437373,3810,0,1006.8260869565217,39,7,16,38.129964393316904,0.6004273504273505,46.458333333333336,1014.1666666666672,26.004273504273517,0
3959,4,1,1,44,0.022222222222222223,0.022222222222222223,0.9777777777777777,45,1100,800,300,0.7272727272727273,14,8,6,339.0602592856766,0.40507154882154883,0.19129885178552652,0.18508907656118015,128577.58881446758,-280.8898796479183,128296.69893481967,3811,0,1030.1777777777777,38,7,17,37.85069700481056,0.6022478070175439,46.44764957264956,1014.2094017093998,26.689721097615784,0
3960,4,2,1,45,0.043478260869565216,0.021739130434782608,0.9782608695652174,46,1200,1000,200,0.8333333333333334,14,10,4,334.0129169532433,0.41004428341384863,0.18417719543141575,0.1838674154363165,128910.3203667533,-588.4575737847425,128321.86279296855,3812,0,1008.6304347826087,39,7,19,37.63986477245529,0.6038995726495727,46.11979166666666,1015.5208333333319,26.03899572649569,0
3961,4,2,2,45,0.0425531914893617,0.0425531914893617,0.9574468085106383,47,1400,600,800,0.42857142857142855,22,6,16,329.89251389557006,0.4127736663583102,0.19654414608572734,0.18306630056817141,129228.54487407765,-873.0376258709244,128355.50724820672,3813,0,988.1276595744681,38,9,20,37.42097474694403,0.6088267543859649,45.806623931623925,1016.7735042735037,26.757197480881675,0
3962,4,0,0,45,0.0,0.0,1.0,45,1550,1200,350,0.7741935483870968,19,12,7,344.2149558433901,0.4083754208754209,0.19640871388205272,0.18986336252176145,128989.67013888898,-119.96527777776768,128869.70486111121,3814,1,1032.911111111111,39,6,20,37.30004101722723,0.6047008547008547,46.04166666666667,1015.833333333334,26.047008547008566,0
3963,4,2,2,45,0.0425531914893617,0.0425531914893617,0.9574468085106383,47,1150,700,450,0.6086956521739131,16,7,9,327.89185340195587,0.41458526056120876,0.18937644341801407,0.18308896808364808,129473.0771513626,-908.8457201037126,128564.23143125889,3815,0,989.9148936170212,38,9,19,37.223563580376506,0.6112938596491228,45.566239316239326,1017.7350427350442,26.782501124606426,0
3964,4,0,1,44,0.0,0.022222222222222223,0.9777777777777777,45,950,700,250,0.7368421052631579,12,7,5,344.0948039572776,0.4070707070707071,0.19275993601574992,0.19109323983605317,129258.63997443422,-104.55472364252279,129154.0852507917,3816,3,1034.911111111111,36,9,20,37.029346622369886,0.612847222222222,45.777027027027046,1016.8918918918945,28.24699699699707,0
3965,4,0,0,44,0.0,0.0,1.0,44,800,600,200,0.75,10,6,4,347.6213469693913,0.4046533650458069,0.1908564588398587,0.19264263061182796,129174.91455078126,180.79155815972297,129355.70610894098,3817,4,1059.1363636363637,39,5,21,37.024904361785694,0.6065705128205128,45.859375,1016.5625000000001,26.06570512820513,0
3966,4,0,0,44,0.0,0.0,1.0,44,1350,800,550,0.5925925925925926,19,8,11,351.2069771017878,0.4043560606060606,0.1920998067477253,0.1953264419447876,129315.90374157965,283.33766687403994,129599.24140845369,3818,5,1060.1363636363637,36,8,21,36.790255019191044,0.6134259259259258,45.720720720720735,1017.117117117119,28.253253253253305,0
3967,4,2,1,45,0.043478260869565216,0.021739130434782608,0.9782608695652174,46,1000,700,300,0.7,13,7,6,337.7390446939325,0.4112822061191626,0.19506857309600223,0.1898985572052679,129745.05077069197,-436.00609978813054,129309.04467090384,3819,0,1015.0,38,8,20,36.69690296420582,0.6140350877192982,45.29914529914531,1018.8034188034203,26.810616284300533,0
3968,4,0,0,45,0.0,0.0,1.0,45,1100,700,400,0.6363636363636364,15,7,8,341.00872578160187,0.4060816498316498,0.18906140718981645,0.19120559847942536,129636.22708013744,-158.58307765358268,129477.64400248385,3820,1,1038.5555555555557,38,7,20,36.72410476989789,0.612938596491228,45.40598290598291,1018.3760683760692,26.799370220422873,0
3969,4,2,3,44,0.0425531914893617,0.06382978723404255,0.9361702127659575,47,1300,900,400,0.6923076923076923,17,9,8,325.23689832964936,0.41177150786308975,0.18229577094825333,0.18472192769208234,130138.96869929686,-934.8010936842767,129204.16760561259,3821,0,995.3191489361702,42,5,20,36.616413421968986,0.6116071428571428,44.91279069767442,1020.3488372093019,24.294019933554807,0
3970,4,0,0,44,0.0,0.0,1.0,44,1050,500,550,0.47619047619047616,16,5,11,341.51608142631943,0.40574348132487664,0.1905183388624052,0.19234610389140377,129811.04736328125,66.512044270833,129877.55940755208,3822,3,1057.4318181818182,39,5,20,36.53371920678729,0.6129807692307692,45.234375,1019.0625,26.129807692307693,0
3971,4,0,1,43,0.0,0.022727272727272728,0.9772727272727273,44,800,600,200,0.75,10,6,4,343.57229227575266,0.40574348132487664,0.19560319598643527,0.19376685186848663,129864.1289605036,123.54329427084375,129987.67225477444,3823,4,1058.4318181818182,39,5,20,36.42746125021291,0.6135149572649572,45.18229166666667,1019.2708333333344,26.1351495726496,0
3972,4,3,2,44,0.06521739130434782,0.043478260869565216,0.9565217391304348,46,1900,1500,400,0.7894736842105263,23,15,8,329.6683010396973,0.4114533011272142,0.20315453686200358,0.18955927309782616,130617.2839506174,-586.0933280285376,130031.19062258887,3824,0,1013.1086956521739,38,8,16,36.01958786231882,0.6228070175438596,44.44444444444445,1022.2222222222232,26.900584795321663,0
3973,4,1,0,45,0.022222222222222223,0.0,1.0,45,750,500,250,0.6666666666666666,10,5,5,321.12051804229463,0.4083754208754209,0.1901484434449785,0.18085906896993487,129811.04736328124,-661.0728322723767,129149.97453100886,3825,0,1036.6,39,6,20,37.05332805206312,0.6129807692307692,45.234375,1019.0624999999999,26.12980769230769,2
3974,4,0,0,45,0.0,0.0,1.0,45,1450,1200,250,0.8275862068965517,17,12,5,321.53877279524824,0.4086279461279461,0.18816343675851188,0.18158684185499666,129917.22140842004,-645.3152126736212,129271.90619574641,3826,1,1037.6,39,6,20,36.93515632982529,0.6140491452991453,45.13020833333333,1019.4791666666658,26.14049145299143,0
3975,4,0,0,45,0.0,0.0,1.0,45,800,500,300,0.625,11,5,6,324.9551454568756,0.4083964646464646,0.18736383442265825,0.1841412490922295,130049.99999999999,-547.9166666666671,129502.08333333331,3827,2,1038.6,39,6,20,36.713643790849666,0.6153846153846154,45.0,1019.9999999999999,26.15384615384615,0
3976,4,1,1,45,0.021739130434782608,0.021739130434782608,0.9782608695652174,46,950,600,350,0.631578947368421,13,6,7,319.366930445648,0.4105475040257649,0.18376220053238712,0.18196487897484584,130262.58680555546,-879.513888888894,129383.07291666657,3828,0,1017.0,39,7,21,36.64115646258505,0.6175213675213675,44.791666666666664,1020.8333333333326,26.175213675213655,0
3977,4,2,2,45,0.0425531914893617,0.0425531914893617,0.9574468085106383,47,1000,600,400,0.6,14,6,8,332.43153096394,0.41379509713228496,0.1674718755150011,0.1909729614647648,130581.79253472232,-648.6545138888779,129933.13802083344,3829,0,996.3191489361702,39,8,13,35.98484848484848,0.6207264957264957,44.47916666666667,1022.0833333333342,26.20726495726498,4
3978,4,1,1,45,0.021739130434782608,0.021739130434782608,0.9782608695652174,46,800,400,400,0.5,12,4,8,337.8493653628743,0.41246980676328504,0.1759856011780847,0.19398961759071165,130562.68376981515,-377.8960296588583,130184.78774015629,3830,0,1018.5652173913044,38,8,13,35.86573977280645,0.6222587719298246,44.49786324786324,1022.0085470085468,26.89496176338281,0
3979,4,0,0,45,0.0,0.0,1.0,45,1050,800,250,0.7619047619047619,13,8,5,346.8109816201994,0.40885942760942756,0.17920854645825157,0.19888809462883938,130514.55886667053,52.77645525546404,130567.33532192599,3831,2,1042.2,37,8,13,35.68549468827126,0.6235923423423423,44.54495614035088,1021.8201754385966,27.61676149834045,0
3980,4,0,1,44,0.0,0.022222222222222223,0.9777777777777777,45,1250,800,450,0.64,17,8,9,348.3360175766866,0.4086700336700337,0.1757757757757754,0.20048673011635965,130654.64854570637,102.343990458598,130756.99253616497,3832,3,1043.2,37,8,14,35.50470112970112,0.625,44.4078947368421,1022.3684210526316,27.63157894736842,0
3981,4,0,1,43,0.0,0.022727272727272728,0.9772727272727273,44,1150,800,350,0.6956521739130435,15,8,7,357.899967689075,0.4048075229034531,0.18208367563668393,0.205283458079056,130521.37230135538,542.7189858777641,131064.09128723315,3833,4,1067.7272727272727,36,8,14,35.39531445154653,0.6255787037037037,44.538288288288285,1021.8468468468467,28.38463463463463,0
3982,4,0,1,42,0.0,0.023255813953488372,0.9767441860465116,43,1100,600,500,0.5454545454545454,16,6,10,354.7807116252789,0.4039774824658546,0.19680479102042248,0.20425200259010196,130665.25298524876,671.5022877607319,131336.7552730095,3834,5,1090.3953488372092,36,7,16,35.329239637258134,0.627025462962963,44.39752252252252,1022.40990990991,28.400275275275277,0
3983,4,2,0,44,0.045454545454545456,0.0,1.0,44,1250,900,350,0.72,16,9,7,341.51053706921596,0.40976259689922484,0.20316085958689745,0.1988894294256078,131109.19922017682,155.0346080794863,131264.2338282563,3835,0,1057.2954545454545,38,6,18,35.219764934974606,0.6277412280701754,43.96367521367522,1024.1452991452995,26.95119208277104,0
3984,4,0,1,43,0.0,0.022727272727272728,0.9772727272727273,44,850,500,350,0.5882352941176471,12,5,7,336.86216757286616,0.4098286645525018,0.15062561678934605,0.19142235566492027,130158.86423631733,45.86900704833647,130204.73324336567,3836,1,1058.2954545454545,40,4,16,36.299712844006244,0.6148437500000001,44.89329268292681,1020.4268292682899,25.510670731707247,8
3985,4,1,1,43,0.022727272727272728,0.022727272727272728,0.9772727272727273,44,1300,700,600,0.5384615384615384,19,7,12,335.74561693213803,0.4124823819591261,0.14802988563319186,0.1914277365649727,130289.1723632811,-51.15497767379139,130238.01738560731,3837,0,1059.25,39,5,19,36.19624273033365,0.6177884615384617,44.76562499999999,1020.9374999999989,26.177884615384585,0
3986,4,0,0,43,0.0,0.0,1.0,43,1150,700,450,0.6086956521739131,16,7,9,340.9888443988909,0.4072074566260613,0.14366633089534186,0.19469363051162453,130344.3971893489,289.19707429321,130633.59426364212,3838,3,1084.8837209302326,38,5,19,36.00648671270141,0.6200657894736843,44.71153846153845,1021.1538461538445,26.872469635627485,0
3987,4,1,1,43,0.022727272727272728,0.022727272727272728,0.9772727272727273,44,1150,800,350,0.6956521739130435,15,8,7,332.0991509518787,0.4092781007751938,0.14658303376199888,0.19078201809952153,130581.792534722,-126.7795138889089,130455.0130208331,3839,0,1061.2045454545455,39,5,16,35.993341486615044,0.6207264957264957,44.47916666666666,1022.0833333333316,26.20726495726491,0
3988,4,0,0,43,0.0,0.0,1.0,43,900,500,400,0.5555555555555556,13,5,8,337.5465653188469,0.4071151716500554,0.14248290657540497,0.1931348121492215,130426.23325525952,204.98541255751132,130631.21866781703,3840,5,1086.8837209302326,38,5,19,36.01153122058363,0.620888157894737,44.63141025641025,1021.4743589743575,26.880904183535723,0
3989,4,2,2,43,0.044444444444444446,0.044444444444444446,0.9555555555555556,45,750,500,250,0.6666666666666666,10,5,5,324.5085129719144,0.41254208754208754,0.13625492857604593,0.1878215938716228,130870.93431122415,-506.2535430839323,130364.68076814021,3841,0,1039.5333333333333,41,4,16,35.89538491370951,0.6204268292682928,44.196428571428555,1023.2142857142829,24.95644599303129,0
3990,4,1,2,42,0.022727272727272728,0.045454545454545456,0.9545454545454546,44,1150,900,250,0.782608695652174,14,9,5,332.8021152189707,0.41123810782241016,0.1407528493759369,0.1923068939032238,130807.8080590257,-93.37695815982661,130714.43110086587,3842,0,1064.1363636363637,40,4,18,35.746986555401016,0.6213541666666667,44.25813008130081,1022.9674796747967,25.574186991869915,0
3991,4,1,0,43,0.023255813953488372,0.0,1.0,43,1150,700,450,0.6086956521739131,16,7,9,337.8562356183187,0.41145256552233295,0.14025467270910585,0.1954313278117273,130848.09570312513,241.56901041668138,131089.6647135418,3843,0,1063.5813953488373,39,4,20,35.57702097332518,0.6233974358974359,44.21875000000001,1023.125000000001,26.233974358974386,0
3992,4,1,0,44,0.022727272727272728,0.0,1.0,44,1200,800,400,0.6666666666666666,16,8,8,333.5276690116466,0.4154334038054968,0.1540499228972585,0.19468977598763298,131197.94894118956,-48.37078210717007,131149.5781590824,3844,0,1040.3863636363637,40,4,21,35.334622887940995,0.6252604166666664,43.87703252032522,1024.4918699187028,25.61229674796757,0
3993,4,3,2,45,0.06382978723404255,0.0425531914893617,0.9574468085106383,47,1150,900,250,0.782608695652174,14,9,5,313.7118202770772,0.42277597903176073,0.15512360822796678,0.1861544160860287,131825.20300012061,-1128.9105726424807,130696.29242747814,3845,0,974.9148936170212,42,5,16,35.21143926527018,0.6284722222222221,43.26550387596901,1026.9379844961275,24.45090439276494,0
3994,4,0,0,45,0.0,0.0,1.0,45,1100,900,200,0.8181818181818182,13,9,4,323.1657680619544,0.41786616161616164,0.16352475247524723,0.19109919539963374,131692.96136558952,-488.26859838717866,131204.69276720233,3846,1,1019.2444444444444,40,5,17,35.10169141914192,0.6302083333333333,43.39430894308944,1026.4227642276442,25.660569105691103,0
3995,4,1,0,46,0.021739130434782608,0.0,1.0,46,1250,1000,250,0.8,15,10,5,315.77488912590564,0.41884057971014493,0.16625114896939008,0.18831963595021634,132015.40577168373,-862.5699759070219,131152.83579577671,3847,0,998.0652173913044,41,5,18,34.96747996910897,0.631859756097561,43.080357142857146,1027.678571428572,25.065331010452976,0
3996,4,0,1,45,0.0,0.021739130434782608,0.9782608695652174,46,1100,500,600,0.45454545454545453,17,5,12,313.7027930158145,0.4188003220611916,0.15873508633564337,0.18771453503556024,132142.87682665663,-909.2820924666096,131233.59473419003,3848,1,999.0652173913044,41,5,19,34.892818088254224,0.6331300813008129,42.95634920634921,1028.1746031746036,25.077429345722038,0
3997,4,0,1,44,0.0,0.022222222222222223,0.9777777777777777,45,1500,1100,400,0.7333333333333333,19,11,8,317.79186776550836,0.4158249158249158,0.15508330313114316,0.19013011982162345,132136.65729930942,-601.6089753123001,131535.04832399712,3849,2,1022.1555555555556,40,5,19,34.793952423313875,0.6346354166666666,42.962398373983746,1028.1504065040663,25.703760162601657,0
3998,4,0,0,44,0.0,0.0,1.0,44,1100,700,400,0.6363636363636364,15,7,8,322.56085055409216,0.41624823819591267,0.15583388740139048,0.1931166086335091,132162.78029777255,-273.8922351113732,131888.88806266116,3850,3,1043.5,40,4,21,34.645145615075435,0.6348958333333334,42.9369918699187,1028.2520325203257,25.70630081300814,0
3999,4,0,0,44,0.0,0.0,1.0,44,850,400,450,0.47058823529411764,13,4,9,319.80154890109384,0.4160720577871741,0.15420153730110275,0.19226074115645328,132319.5725097495,-336.79915229030775,131982.7733574592,3851,4,1044.5,40,4,22,34.5587630053997,0.6364583333333333,42.78455284552845,1028.861788617886,25.721544715447152,0
4000,4,0,0,44,0.0,0.0,1.0,44,1150,700,450,0.6086956521739131,16,7,9,319.13324263633285,0.4156095842142354,0.15669856459330256,0.1922583193443271,132398.00347222207,-349.4559290105173,132048.54754321155,3852,5,1045.5,39,5,22,34.49730094466937,0.6388888888888891,42.70833333333333,1029.1666666666654,26.388888888888857,0
4001,4,0,0,44,0.0,0.0,1.0,44,1050,700,350,0.6666666666666666,14,7,7,318.8935558684594,0.41559857293868924,0.154781396889057,0.19252443571459876,132478.41932508667,-350.6971571180642,132127.7221679686,3853,6,1046.5,39,5,22,34.422851529562564,0.639690170940171,42.63020833333333,1029.4791666666656,26.396901709401682,0
4002,4,0,0,44,0.0,0.0,1.0,44,1050,600,450,0.5714285714285714,15,6,9,319.88828010552334,0.41571969696969696,0.14845143729424537,0.1935382825656796,132558.85959201396,-319.19487847221654,132239.66471354174,3854,7,1047.5,39,5,22,34.31662620540832,0.6404914529914529,42.552083333333336,1029.7916666666672,26.404914529914542,0
4003,4,0,0,44,0.0,0.0,1.0,44,850,600,250,0.7058823529411765,11,6,5,322.07671647986314,0.4148277836504581,0.14939332659251847,0.19541955374146286,132666.15125868047,-254.26432291667072,132411.88693576382,3855,8,1048.5,39,5,16,34.15276373441186,0.6415598290598291,42.447916666666664,1030.2083333333328,26.415598290598275,0
4004,4,1,0,45,0.022222222222222223,0.0,1.0,45,1050,700,350,0.6666666666666666,14,7,7,317.06892522184125,0.4170664983164983,0.1581188140540304,0.19088227923878523,132371.857236103,-603.3580930559523,131768.49914304705,3856,0,1026.1777777777777,40,5,18,34.57662617683849,0.6369791666666667,42.73373983739838,1029.0650406504078,25.726626016260195,2
4005,4,1,1,45,0.021739130434782608,0.021739130434782608,0.9782608695652174,46,950,600,350,0.631578947368421,13,6,7,311.43071251474595,0.41867954911433175,0.16085669548057746,0.18866409272785128,132607.2663118019,-940.4023316147741,131666.86398018713,3857,0,1004.8478260869565,40,6,19,34.485898700871566,0.6393229166666667,42.50508130081301,1029.9796747967484,25.74949186991871,0
4006,4,0,1,44,0.0,0.022222222222222223,0.9777777777777777,45,1550,1000,550,0.6451612903225806,21,10,11,314.42421278018503,0.41603535353535354,0.1561517722101664,0.19087620773446212,132685.78247901384,-656.0754593826405,132029.7070196312,3858,1,1027.0,40,5,14,34.33020155191687,0.6401041666666667,42.42886178861789,1030.2845528455287,25.757113821138216,0
4007,4,0,0,44,0.0,0.0,1.0,44,1300,900,400,0.6923076923076923,17,9,8,318.23865777142316,0.4135394644115575,0.15405215296486663,0.19267762457967322,132585.67843967024,-361.2223307291564,132224.45610894109,3859,3,1051.3181818181818,39,5,19,34.33222497555711,0.6407585470085471,42.52604166666667,1029.8958333333342,26.40758547008549,0
4008,4,0,0,44,0.0,0.0,1.0,44,1200,800,400,0.6666666666666666,16,8,8,318.7044422668174,0.41344036293164205,0.15019483145241375,0.1936501439129825,132719.81336805545,-340.32118055556646,132379.49218749988,3860,4,1052.3181818181818,39,5,14,34.18587410702251,0.6420940170940173,42.39583333333333,1030.4166666666658,26.42094017094015,0
4009,4,0,1,43,0.0,0.022727272727272728,0.9772727272727273,44,950,400,550,0.42105263157894735,15,4,11,318.9598341343646,0.41337429527836506,0.1595685561281195,0.19450064562093694,132854.01611328125,-324.98101128472337,132529.03510199653,3861,5,1053.3181818181818,39,5,14,34.04493364992757,0.6434294871794872,42.265625,1030.9375,26.434294871794872,0
4010,4,1,0,44,0.022727272727272728,0.0,1.0,44,950,700,250,0.7368421052631579,12,7,5,317.7254470053058,0.4131981148696265,0.1572918196504629,0.19472480365968758,133042.01388888902,-345.8333333333155,132696.1805555557,3862,0,1054.1818181818182,39,5,16,33.888664512654834,0.6452991452991452,42.08333333333334,1031.6666666666679,26.452991452991483,0
4011,4,0,0,44,0.0,0.0,1.0,44,900,600,300,0.6666666666666666,12,6,6,315.3036463100844,0.41240530303030304,0.1520111521834473,0.19397571990136458,133183.5911680383,-401.34561520918743,132782.24555282912,3863,1,1055.1818181818182,40,4,16,33.80960585474715,0.6450520833333333,41.94613821138212,1032.2154471544723,25.805386178861806,0
4012,4,0,1,43,0.0,0.022727272727272728,0.9772727272727273,44,1200,600,600,0.5,18,6,12,315.2265615483848,0.4127356412966878,0.14718944835544234,0.19475061063928495,133340.98755907547,-393.47579565732553,132947.51176341815,3864,2,1056.1818181818182,40,4,17,33.654350749450614,0.6466145833333332,41.79369918699188,1032.825203252034,25.820630081300852,0
4013,4,0,1,42,0.0,0.023255813953488372,0.9767441860465116,43,1450,900,550,0.6206896551724138,20,9,11,322.58498721034084,0.41152177925433736,0.154698534897451,0.19915605346485363,133314.74837233167,1.0672797277062784,133315.81565205936,3865,3,1081.3488372093022,40,3,18,33.490577642196406,0.6463541666666666,41.819105691056926,1032.7235772357753,25.818089430894382,0
4014,4,0,0,42,0.0,0.0,1.0,42,1100,800,300,0.7272727272727273,14,8,6,323.5561914672214,0.41183943089430897,0.15495391705069106,0.20060483870967757,133472.22222222245,237.15277777780236,133709.37500000026,3866,4,1093.2380952380952,39,3,19,33.30813172043012,0.6495726495726495,41.66666666666668,1033.333333333335,26.49572649572654,0
4015,4,0,0,42,0.0,0.0,1.0,42,1200,900,300,0.75,15,9,6,321.3115786467008,0.4120692992644212,0.15088117961925018,0.200129999117463,133642.23246575872,188.1593374884649,133830.39180324718,3867,5,1094.2380952380952,37,5,21,33.19635913750442,0.6548423423423423,41.502192982456144,1033.9912280701758,27.945708866761507,0
4016,4,0,0,42,0.0,0.0,1.0,42,1300,800,500,0.6153846153846154,18,8,10,320.4000667143399,0.4115127758420441,0.14880826190980945,0.2001757767803366,133755.63274276705,171.06273084025983,133926.6954736073,3868,6,1095.2380952380952,37,5,15,33.1067592396297,0.6559684684684685,41.39254385964912,1034.4298245614036,27.95756282598388,0
4017,4,0,0,42,0.0,0.0,1.0,42,900,600,300,0.6666666666666666,12,6,6,321.9436236832068,0.4109804490902052,0.138301092846548,0.20175988846760295,133869.08111149565,219.65941443519074,134088.74052593083,3869,7,1096.2380952380952,37,5,15,32.95366249911705,0.6570945945945947,41.282894736842096,1034.8684210526299,27.969416785206214,0
4018,4,0,1,41,0.0,0.023809523809523808,0.9761904761904762,42,1000,600,400,0.6,14,6,8,324.2226590775592,0.4102666473093302,0.14077655212068985,0.2036584247738677,133954.1989482338,286.1973155201317,134240.39626375394,3870,8,1097.2380952380952,37,5,15,32.809796808247704,0.6579391891891893,41.20065789473683,1035.1973684210504,27.978307254622983,0
4019,4,0,1,40,0.0,0.024390243902439025,0.975609756097561,41,800,600,200,0.75,10,6,4,339.01348839049103,0.4065294715447154,0.09472311704249137,0.19114590302868106,129853.92011834319,604.4460880999362,130458.36620644313,3871,26,1124.8048780487804,38,3,15,36.553983228511534,0.6151315789473684,45.19230769230769,1019.2307692307692,26.821862348178136,8
4020,4,0,0,40,0.0,0.0,1.0,40,750,500,250,0.6666666666666666,10,5,5,344.6820524199849,0.4046741452991453,0.09649467341009332,0.19401152714348407,129787.30384589494,947.0708535318598,130734.3746994268,3872,27,1152.275,37,3,15,36.47716471179022,0.6162725225225224,45.25767543859649,1018.9692982456145,27.539710763394986,0
4021,4,1,0,41,0.024390243902439025,0.0,1.0,41,1250,1000,250,0.8,15,10,5,336.1291498479493,0.40990853658536586,0.09856233459695307,0.19057963911806544,130071.7957849369,544.1844272773875,130615.98021221429,3873,0,1125.1463414634147,38,3,17,36.406620932830606,0.6173245614035088,44.978632478632484,1020.0854700854708,26.844354475933443,0
4022,4,0,0,41,0.0,0.0,1.0,41,1300,1000,300,0.7692307692307693,16,10,6,336.35324941851843,0.40932418699186995,0.09909781115814087,0.191508876337576,130235.3223847615,561.0147746365698,130796.33715939807,3874,1,1126.1463414634147,38,3,17,36.23525922824646,0.6189692982456141,44.81837606837607,1020.7264957264958,26.86122357174989,0
4023,4,0,0,41,0.0,0.0,1.0,41,1150,900,250,0.782608695652174,14,9,5,337.0262390670555,0.4091971544715447,0.10174216027874605,0.19202657807308984,130262.5868055556,580.3819444444551,130842.96875000006,3875,2,1127.1463414634147,38,3,17,36.19047619047619,0.6192434210526315,44.79166666666667,1020.8333333333338,26.864035087719312,0
4024,4,0,0,41,0.0,0.0,1.0,41,1050,600,450,0.5714285714285714,15,6,9,334.53897052140564,0.40955284552845533,0.10552000754013546,0.19143519959320732,130430.54112803948,526.8197907048402,130957.36091874432,3876,3,1128.1463414634147,37,4,17,36.08397738657507,0.6227477477477477,44.627192982456144,1021.491228070176,27.607871028923675,0
4025,4,2,1,42,0.046511627906976744,0.023255813953488372,0.9767441860465116,43,800,600,200,0.75,10,6,4,323.83246249571056,0.4148671096345515,0.12062252204272439,0.18770819728733665,130928.03955078126,-120.25010850694353,130807.78944227433,3877,0,1076.6279069767443,39,4,16,35.85506785411365,0.624198717948718,44.140625,1023.4375000000001,26.241987179487182,0
4026,4,0,0,42,0.0,0.0,1.0,42,1200,700,500,0.5833333333333334,17,7,10,330.46248276129984,0.41048441734417346,0.12248879195444085,0.1915512621315499,130928.03955078125,253.36100260416714,131181.4005533854,3878,1,1103.2619047619048,39,3,16,35.68543256997455,0.624198717948718,44.140625,1023.4375,26.24198717948718,0
4027,4,0,1,41,0.0,0.023809523809523808,0.9761904761904762,42,850,600,250,0.7058823529411765,11,6,5,331.96010749881214,0.41008517228029423,0.12631696277126725,0.19255253933195582,130954.69292534742,294.3467881944649,131249.0397135419,3879,2,1104.2619047619048,39,3,16,35.62020829092884,0.624465811965812,44.11458333333334,1023.5416666666682,26.24465811965816,0
4028,4,1,0,42,0.023809523809523808,0.0,1.0,42,900,700,200,0.7777777777777778,11,7,4,350.3540191586839,0.4096496322106078,0.17580174927113723,0.1996203132415758,130262.58680555562,743.4244791666761,131006.01128472229,3880,0,1105.095238095238,37,5,19,35.85034013605442,0.6210585585585585,44.79166666666667,1020.8333333333339,27.590090090090108,2
4029,4,1,1,42,0.023255813953488372,0.023255813953488372,0.9767441860465116,43,1050,600,450,0.5714285714285714,15,6,9,342.1481128183707,0.4117524916943522,0.16968921129364922,0.1962849699852758,130528.564453125,332.02039930555503,130860.58485243056,3881,0,1080.3720930232557,39,4,14,35.7904349303432,0.6201923076923077,44.53125,1021.875,26.201923076923077,0
4030,4,0,0,42,0.0,0.0,1.0,42,1400,1100,300,0.7857142857142857,17,11,6,346.6673960853833,0.40904471544715443,0.17217840712194565,0.19877260048924464,130508.09500328716,648.5802925706615,131156.67529585783,3882,2,1107.095238095238,38,4,14,35.6957078628189,0.6217105263157896,44.551282051282044,1021.7948717948706,26.889338731443964,0
4031,4,1,2,41,0.023255813953488372,0.046511627906976744,0.9534883720930233,43,750,400,350,0.5333333333333333,11,4,7,341.06381683452383,0.41297526762643044,0.16741248569756761,0.19660736875305454,130714.91021050341,316.4252387152676,131031.33544921868,3883,0,1082.3255813953488,39,4,14,35.62962632847781,0.6220619658119659,44.34895833333333,1022.6041666666661,26.22061965811964,0
4032,4,1,0,42,0.023809523809523808,0.0,1.0,42,1050,500,550,0.47619047619047616,16,5,11,344.83599169781377,0.4084397986837011,0.16598490164170987,0.19842066172918693,130644.5883213711,610.1912347505214,131254.77955612162,3884,0,1109.0,38,4,15,35.60433866304385,0.6230811403508772,44.41773504273504,1022.3290598290594,26.903396311291036,0
4033,4,1,2,41,0.023255813953488372,0.046511627906976744,0.9534883720930233,43,550,400,150,0.7272727272727273,7,4,3,339.11595274599836,0.4096760797342193,0.12233051830020858,0.19560510150042837,130738.73842191831,292.27828213376927,131031.01670405209,3885,0,1084.1860465116279,37,6,14,35.65533308316357,0.6258445945945945,44.32565789473684,1022.6973684210529,27.640469416785216,2
4034,4,1,0,42,0.023809523809523808,0.0,1.0,42,750,500,250,0.6666666666666666,10,5,5,340.6196598901793,0.40541521486643434,0.11624109566672769,0.1971875103036698,130878.94833025559,515.9885734072129,131394.9369036628,3886,0,1024.3333333333333,37,5,16,35.47515716530932,0.6272522522522521,44.188596491228076,1023.2456140350888,27.65528686581321,0
4035,4,0,1,41,0.0,0.023809523809523808,0.9761904761904762,42,850,500,350,0.5882352941176471,12,5,7,341.4222829358818,0.4043747580332946,0.11781999095431961,0.19813245868011417,130972.4633487654,543.3834876543193,131515.84683641972,3887,1,1025.3333333333333,38,4,17,35.36013116236996,0.6263706140350876,44.09722222222222,1023.611111111111,26.93713450292397,0
4036,4,0,0,41,0.0,0.0,1.0,41,1050,700,350,0.6666666666666666,14,7,7,339.8465676417716,0.4033028455284553,0.12093392551422966,0.19767406863423775,131061.33355034742,708.1488715278012,131769.48242187523,3888,2,1042.9756097560976,39,2,19,35.310698541878615,0.6255341880341879,44.01041666666668,1023.958333333335,26.255341880341923,0
4037,4,0,0,41,0.0,0.0,1.0,41,1000,600,400,0.6,14,6,8,337.88626825847825,0.40294715447154467,0.1191160675971652,0.19694343069268655,131141.34250217036,662.1717664930799,131803.51426866345,3889,3,1043.9756097560976,39,2,19,35.280115427641626,0.62633547008547,43.93229166666668,1024.270833333335,26.263354700854745,0
4038,4,3,2,42,0.06818181818181818,0.045454545454545456,0.9545454545454546,44,1050,700,350,0.6666666666666666,14,7,7,319.35008233189063,0.4084742776603241,0.12306475855010168,0.18955282731547948,131835.77609592033,-379.24804687498016,131456.52804904536,3890,0,973.7272727272727,39,5,16,35.05606129762991,0.6332799145299144,43.25520833333334,1026.9791666666683,26.332799145299187,0
4039,4,0,0,42,0.0,0.0,1.0,42,1050,500,550,0.47619047619047616,16,5,11,333.1914114036251,0.40115660085172283,0.12688335117560778,0.1971245739387948,131711.6845642485,377.04041566219337,132088.7249799107,3891,1,1021.0952380952381,38,4,17,34.82557937829586,0.6337719298245614,43.37606837606837,1026.4957264957252,27.013045434098032,0
4040,4,0,1,41,0.0,0.023809523809523808,0.9761904761904762,42,950,700,250,0.7368421052631579,12,7,5,333.1000322058838,0.4008783391405342,0.12197581144621061,0.19749687905803484,131793.94866544288,380.1137089999111,132174.0623744428,3892,2,1022.0952380952381,38,4,17,34.74512711129609,0.6345942982456141,43.29594017094016,1026.816239316238,27.02147998200626,0
4041,4,0,0,41,0.0,0.0,1.0,41,1350,900,450,0.6666666666666666,18,9,9,332.2221422552339,0.3992632113821138,0.12440784589835241,0.19008832448248295,130426.23325525966,467.4776508510457,130893.7109061107,3893,3,1047.878048780488,38,3,20,36.14750026147892,0.6208881578947368,44.631410256410255,1021.4743589743587,26.880904183535755,2
4042,4,1,1,41,0.023809523809523808,0.023809523809523808,0.9761904761904762,42,1100,800,300,0.7272727272727273,14,8,6,325.9318546016955,0.40203977932636464,0.10935795032953632,0.18814373194203685,130768.17626953122,124.30284288194397,130892.47911241316,3894,0,1023.9047619047619,39,3,17,35.96269562413008,0.622596153846154,44.296875,1022.8124999999998,26.225961538461533,0
4043,4,0,1,40,0.0,0.024390243902439025,0.975609756097561,41,1050,600,450,0.5714285714285714,15,6,9,322.71711345186503,0.398755081300813,0.11266956862203159,0.18082403341033063,129609.02829142011,175.50415600858372,129784.53244742869,3895,5,1049.878048780488,38,3,16,37.21736963592486,0.6126644736842106,45.43269230769231,1018.2692307692307,26.79655870445344,5
4044,4,1,0,41,0.024390243902439025,0.0,1.0,41,1450,1300,150,0.896551724137931,16,13,3,322.4340373769149,0.40259146341463414,0.12803280322919575,0.18192449146145123,129881.14458917717,175.6203658046286,130056.7649549818,3896,0,1050.7317073170732,38,3,17,36.94886979002897,0.6154057017543861,45.165598290598275,1019.3376068376047,26.824673864147492,0
4045,4,0,0,41,0.0,0.0,1.0,41,550,300,250,0.5454545454545454,8,3,5,322.6729043209938,0.40276930894308943,0.13002507264934393,0.18231305659770508,129935.60209155135,185.3396203155558,130120.94171186691,3897,1,1051.7317073170732,38,3,17,36.88764015508752,0.6159539473684212,45.112179487179475,1019.5512820512799,26.830296896086313,0
4046,4,0,0,41,0.0,0.0,1.0,41,1100,700,400,0.6363636363636364,15,7,8,323.2987566374496,0.40238821138211384,0.13470589137066713,0.18304922484348113,130017.30974687698,206.88691650229146,130224.19666337928,3898,2,1052.7317073170732,38,3,18,36.7889692017599,0.6167763157894738,45.03205128205128,1019.8717948717942,26.838731443994586,0
4047,4,0,0,41,0.0,0.0,1.0,41,1000,900,100,0.9,11,9,2,323.2864496561152,0.4030741869918699,0.1352223816355813,0.18319565480513195,130049.99999999999,208.6805555555551,130258.68055555555,3899,3,1053.7317073170732,39,2,18,36.75619553376906,0.6153846153846154,45.0,1019.9999999999999,26.15384615384615,0
4048,4,1,1,41,0.023809523809523808,0.023809523809523808,0.9761904761904762,42,1050,600,450,0.5714285714285714,15,6,9,318.42303821353596,0.404991773132017,0.13847712332560858,0.1815511458714871,130289.1723632811,-102.41156684029312,130186.76079644081,3900,0,1029.6190476190477,39,3,18,36.638374485596714,0.6177884615384617,44.76562499999999,1020.9374999999989,26.177884615384585,0
4049,4,2,2,41,0.046511627906976744,0.046511627906976744,0.9534883720930233,43,1100,600,500,0.5454545454545454,16,6,10,309.47176051395195,0.4097914359542267,0.13482314807750573,0.17798607427157465,130625.94112507424,-514.9920062462933,130110.94911882795,3901,0,1006.6279069767442,40,3,13,36.526990754548166,0.6195312500000001,44.43597560975609,1022.2560975609747,25.556402439024367,0
4050,4,0,0,41,0.0,0.0,1.0,41,1000,800,200,0.8,12,8,4,325.23383698424226,0.4029725609756098,0.148514927257839,0.18608980941988856,130426.23325525953,283.80485700195646,130710.03811226149,3902,6,1056.7317073170732,38,3,20,36.325959627654015,0.620888157894737,44.63141025641025,1021.4743589743576,26.880904183535726,0
4051,4,0,0,41,0.0,0.0,1.0,41,950,700,250,0.7368421052631579,12,7,5,322.4592404264192,0.40261686991869916,0.1489072466799124,0.18476199617722258,130480.80490037611,214.94824768060914,130695.75314805673,3903,7,1057.7317073170732,38,3,20,36.34167276656558,0.621436403508772,44.57799145299145,1021.6880341880334,26.886527215474562,0
4052,4,1,0,42,0.023809523809523808,0.0,1.0,42,1200,800,400,0.6666666666666666,16,8,8,320.06777337143126,0.4032012195121952,0.15560194141804984,0.18501386711482218,130821.45317925356,-25.65375434026663,130795.79942491329,3904,0,1033.5238095238096,39,3,14,36.05889166072701,0.6231303418803419,44.24479166666667,1023.020833333334,26.23130341880344,0
4053,4,1,0,43,0.023255813953488372,0.0,1.0,43,1050,800,250,0.7619047619047619,13,8,5,316.6757182358343,0.40794573643410853,0.16357766131023732,0.18435246751372045,131093.8545694526,-297.1518895829244,130796.70267986969,3905,0,1010.4651162790698,40,3,15,35.87108431742253,0.62421875,43.978658536585364,1024.0853658536578,25.602134146341445,0
4054,4,0,0,43,0.0,0.0,1.0,43,1500,1100,400,0.7333333333333333,19,11,8,316.71956359912696,0.4078765227021041,0.16489857291772325,0.18525522501935024,131276.04683059032,-284.4615473593682,130991.58528323095,3906,1,1011.4651162790698,40,3,17,35.686483538278466,0.6260416666666666,43.800813008130085,1024.7967479674803,25.619918699187007,0
4055,4,0,0,43,0.0,0.0,1.0,43,1100,800,300,0.7272727272727273,14,8,6,315.4172355673286,0.406999815430048,0.164516689350082,0.18462468736002396,131303.29574732587,-316.93548689982214,130986.36026042605,3907,2,1012.4651162790698,42,1,17,35.69242223692918,0.6232638888888888,43.77422480620155,1024.9031007751937,24.402454780361754,0
4056,4,0,1,42,0.0,0.023255813953488372,0.9767441860465116,43,1250,700,550,0.56,18,7,11,316.36578113011007,0.4069767441860465,0.16294665009475273,0.18555852311576546,131381.515842014,-287.06978082183133,131094.44606119217,3908,3,1013.4651162790698,39,4,18,35.5893957867642,0.6287393162393162,43.69791666666667,1025.2083333333342,26.287393162393183,0
4057,4,0,0,42,0.0,0.0,1.0,42,950,600,350,0.631578947368421,13,6,7,313.9669019003966,0.4055966898954704,0.16288775442299164,0.1757162247619091,129563.26116233716,-260.36775785536264,129302.8934044818,3909,4,1036.2142857142858,40,2,15,37.486482664537185,0.6088541666666667,45.47764227642276,1018.0894308943084,25.45223577235771,5
4058,4,0,0,42,0.0,0.0,1.0,42,1250,700,550,0.56,18,7,11,317.2287695200175,0.4057781649245064,0.16135982478394983,0.17812795276745846,129692.62390318258,-171.55370067420142,129521.07020250839,3910,5,1037.2142857142858,40,2,15,37.272398483488,0.61015625,45.35060975609756,1018.5975609756093,25.464939024390233,0
4059,4,0,0,42,0.0,0.0,1.0,42,1800,1300,500,0.7222222222222222,23,13,10,312.44987126440884,0.40629839334107626,0.14894105213388853,0.17607227249036042,129832.5314645534,-286.76845159359846,129545.7630129598,3911,6,1038.2142857142858,41,1,15,37.252486290924445,0.610010162601626,45.21329365079365,1019.1468253968252,24.857239643825004,0
4060,4,1,1,42,0.023255813953488372,0.023255813953488372,0.9767441860465116,43,900,800,100,0.8888888888888888,10,8,2,306.77807880361814,0.4110603543743079,0.14771318934036737,0.17390699168366663,130064.82600392109,-619.79251171804,129445.03349220305,3912,0,1015.046511627907,42,1,16,37.162178208416464,0.6108630952380951,44.98546511627907,1020.0581395348842,24.287098560354384,0
4061,4,1,1,42,0.023255813953488372,0.023255813953488372,0.9767441860465116,43,1100,800,300,0.7272727272727273,14,8,6,304.13772394881255,0.4093761535622001,0.13934938487256887,0.17284805023771982,130163.68762581887,-682.46246093984,129481.22516487903,3913,0,1016.0232558139535,42,1,16,37.12966479916437,0.6118551587301586,44.88856589147287,1020.4457364341093,24.296327057954983,0
4062,4,0,0,42,0.0,0.0,1.0,42,1000,800,200,0.8,12,8,4,309.70439224805256,0.40685491676345337,0.1381406204415052,0.17565859158779515,130085.41907793212,-342.39486882715926,129743.02420910496,3914,9,1041.2142857142858,41,1,16,37.06674041297935,0.6125508130081301,44.96527777777778,1020.138888888889,24.881436314363146,0
4063,4,2,1,43,0.045454545454545456,0.022727272727272728,0.9772727272727273,44,900,600,300,0.6666666666666666,12,6,6,298.3567117860354,0.41370463354474984,0.14248616639161282,0.17121852301437043,130541.23682169618,-1010.1880393361141,129531.04878236006,3915,0,994.8409090909091,41,3,13,36.896397598938606,0.6171239837398375,44.5188492063492,1021.9246031746025,24.924990321331766,0
4064,4,1,1,43,0.022727272727272728,0.022727272727272728,0.9772727272727273,44,800,500,300,0.625,11,5,6,295.5999228762908,0.41344036293164205,0.14031361651449048,0.17008136265997614,130642.63791454061,-1076.4092616213366,129566.22865291928,3916,0,995.8181818181819,41,3,13,36.86468947113052,0.618140243902439,44.41964285714285,1022.3214285714268,24.934668989546996,0
4065,4,1,0,44,0.022727272727272728,0.0,1.0,44,1400,1100,300,0.7857142857142857,17,11,6,299.4771523700549,0.41328620507399577,0.15290781728684055,0.17382838668336575,130980.72907277194,-954.8528483865275,130025.87622438541,3917,0,996.7954545454545,42,2,15,36.42520194370819,0.6200396825396826,44.0891472868217,1023.6434108527121,24.372462163159813,0
4066,4,0,0,44,0.0,0.0,1.0,44,1100,800,300,0.7272727272727273,14,8,6,298.9064348243645,0.4136165433403805,0.15418940164616712,0.17386096179428992,131061.33355034712,-964.984809027784,130096.34874131934,3918,1,997.7954545454545,43,1,15,36.35872329603256,0.6194282945736435,44.010416666666664,1023.9583333333325,23.81298449612401,0
4067,4,0,1,43,0.0,0.022727272727272728,0.9772727272727273,44,850,500,350,0.5882352941176471,12,5,7,299.50382064860844,0.41313204721634955,0.15066141679343126,0.17464866997067352,131158.3172366418,-943.5165755567226,130214.80066108507,3919,2,998.7954545454545,43,1,16,36.24589766108904,0.6203972868217056,43.91571969696969,1024.3371212121197,23.821793516560923,0
4068,4,2,2,43,0.044444444444444446,0.044444444444444446,0.9555555555555556,45,850,600,250,0.7058823529411765,11,6,5,297.5398181247511,0.4146254208754209,0.15538139009837093,0.17462089837134012,131404.40095308935,-1180.0621317096288,130224.33882137973,3920,0,977.2444444444444,41,4,16,36.04892356071599,0.6257621951219513,43.67559523809523,1025.2976190476174,25.0072590011614,0
4069,4,0,0,43,0.0,0.0,1.0,43,800,500,300,0.625,11,5,6,311.1260444508297,0.407484311554079,0.16469532552421207,0.18175949138249026,131228.82207349324,-434.2591340664642,130794.56293942677,3921,4,1023.6976744186046,42,1,16,35.87730912300609,0.6225198412698414,43.8468992248062,1024.6124031007755,24.39553340716132,0
4070,4,1,1,43,0.022727272727272728,0.022727272727272728,0.9772727272727273,44,1550,1300,250,0.8387096774193549,18,13,5,327.57241273619314,0.40971855179704014,0.07864329647669543,0.17935817117054498,128697.582042076,-363.1840625975653,128334.39797947844,3922,0,1001.4090909090909,41,3,19,38.01981488723765,0.5985772357723578,46.329365079365076,1014.6825396825388,24.748354626403387,8
4071,4,0,0,43,0.0,0.0,1.0,43,1000,800,200,0.8,12,8,4,330.219739480803,0.409952934662237,0.10482050675898424,0.18115164367979045,128773.0903269872,-95.3167320168834,128677.77359497032,3923,1,1025.2790697674418,41,2,19,37.875798227608904,0.599339430894309,46.254960317460316,1014.9801587301581,24.75561362756483,0
4072,4,0,0,43,0.0,0.0,1.0,43,1500,1200,300,0.8,18,12,6,329.8968877383293,0.4100452196382429,0.10317793866753289,0.18166511241405478,128924.17332963273,-93.66329286344836,128830.51003676928,3924,2,1026.2790697674418,41,2,19,37.73027172674285,0.6008638211382114,46.10615079365079,1015.5753968253964,24.770131629887718,0
4073,4,0,0,43,0.0,0.0,1.0,43,850,400,450,0.47058823529411764,13,4,9,314.5708002731529,0.4097683647102252,0.1429341710427603,0.1652829628553853,127040.78260294789,-606.740434919381,126434.0421680285,3925,3,1027.2790697674418,40,3,20,40.03927251344084,0.5833333333333335,47.96747967479674,1008.1300813008123,25.203252032520307,6
4074,4,7,3,47,0.14,0.06,0.94,50,1000,700,300,0.7,13,7,6,286.53830648980033,0.42918367346938774,0.18208701867238397,0.15606925861510154,128488.68184369103,-2636.5934845860384,125852.088359105,3926,0,884.32,45,5,13,39.2725922451532,0.5909722222222222,46.53532608695652,1013.8586956521747,22.530193236714993,0
4075,4,2,2,47,0.04081632653061224,0.04081632653061224,0.9591836734693877,49,1000,400,600,0.4,16,4,12,294.5933959534471,0.42690617913832196,0.2060004284689685,0.16096112980897834,128613.7099194103,-2222.2500857338673,126391.45983367643,3927,0,903.3265306122449,44,5,14,38.94150311881943,0.5935132575757576,46.412037037037045,1014.3518518518531,23.05345117845121,0
4076,4,2,2,47,0.04081632653061224,0.04081632653061224,0.9591836734693877,49,1600,1400,200,0.875,18,14,4,297.10547510402193,0.4259318310657596,0.20881325897743275,0.1631996206934117,128825.12002743495,-2145.0703017832548,126680.0497256517,3928,0,904.0408163265306,44,5,17,38.66327678462848,0.5956439393939392,46.20370370370371,1015.185185185186,23.072390572390592,0
4077,4,3,1,49,0.06,0.02,0.98,50,600,400,200,0.6666666666666666,8,4,4,295.9553883364683,0.42878401360544216,0.23278688524590097,0.1641207153502236,129201.38888888914,-2352.4305555555366,126848.9583333336,3929,0,886.04,45,5,19,38.31113387978142,0.5981481481481479,45.83333333333334,1016.6666666666687,22.592592592592638,0
4078,4,2,4,47,0.0392156862745098,0.0784313725490196,0.9215686274509804,51,850,400,450,0.47058823529411764,13,4,9,290.1604815897164,0.43415032679738563,0.23434146654749544,0.1619681997538132,129460.39201817605,-2687.142061042482,126773.24995713356,3930,0,869.6274509803922,44,7,11,38.19640311770235,0.6020359848484846,45.578703703703724,1017.685185185189,23.12920875420884,0
4079,4,2,0,49,0.04081632653061224,0.0,1.0,49,800,400,400,0.5,12,4,8,306.33611460550713,0.42871315192743764,0.25394277318583813,0.17083566327522207,129423.14093391328,-1870.6035732528053,127552.53736066047,3931,0,903.734693877551,42,7,20,37.82258832492143,0.6044146825396826,45.61531007751938,1017.5387596899229,24.227113325950548,0
4080,4,1,1,49,0.02,0.02,0.98,50,1350,1000,350,0.7407407407407407,17,10,7,301.2282484599847,0.430765306122449,0.25615541922290386,0.16931104999647423,129731.44531250013,-2184.2447916666524,127547.20052083347,3932,0,886.64,43,7,15,37.64059304703478,0.6061046511627907,45.31250000000001,1018.750000000001,23.691860465116303,0
4081,4,0,0,49,0.0,0.0,1.0,49,1700,1300,400,0.7647058823529411,21,13,8,303.95603591100866,0.4276325113378685,0.2515700079955909,0.1711135799593236,129793.15020130988,-1909.7177152815495,127883.43248602832,3933,1,905.6734693877551,42,7,16,37.508716875871684,0.6081349206349207,45.25193798449612,1018.9922480620144,24.261720191952723,0
4082,4,0,1,48,0.0,0.02040816326530612,0.9795918367346939,49,2150,1800,350,0.8372093023255814,25,18,7,301.1035629736208,0.4274907879818594,0.24089554105605493,0.17039328794865582,129996.88042534712,-1971.4952256944541,128025.38519965266,3934,2,906.6734693877551,43,6,17,37.37551072522983,0.6087693798449614,45.05208333333333,1019.7916666666657,23.71608527131781,0
4083,4,0,1,47,0.0,0.020833333333333332,0.9791666666666666,48,1000,800,200,0.8,12,8,4,307.5497733278847,0.4248300827423168,0.24327249061629708,0.17385719219130752,129955.57270233218,-1606.4386145404476,128349.13408779174,3935,3,926.4375,44,4,17,37.252921055817914,0.6070075757575757,45.0925925925926,1019.6296296296314,23.173400673400714,0
4084,4,0,1,46,0.0,0.02127659574468085,0.9787234042553191,47,1300,1100,200,0.8461538461538461,15,11,4,313.07476157817746,0.42385522664199815,0.2424022039438578,0.17683960562175546,129924.46212838619,-1264.7859991965051,128659.67612918968,3936,4,946.8723404255319,43,4,17,37.14355378041985,0.6080426356589147,45.12310606060606,1019.5075757575762,23.709478505990145,0
4085,4,1,2,45,0.02127659574468085,0.0425531914893617,0.9574468085106383,47,950,800,150,0.8421052631578947,11,8,3,304.32765543414126,0.42213999383287076,0.1513826630469095,0.17382783030729781,130359.27456382014,-1465.6135215794181,128893.66104224072,3937,0,947.6382978723404,43,4,17,36.927392433234424,0.6124031007751938,44.6969696969697,1021.2121212121222,23.749119097956328,4
4086,4,0,1,44,0.0,0.022222222222222223,0.9777777777777777,45,1100,800,300,0.7272727272727273,14,8,6,317.4756305706804,0.418476430976431,0.16352145517466976,0.18042827121100033,130163.68762581884,-735.2402387176147,129428.44738710123,3938,7,990.6444444444444,42,3,17,36.78939955053336,0.6118551587301586,44.88856589147287,1020.4457364341091,24.29632705795498,0
4087,4,0,0,44,0.0,0.0,1.0,44,550,400,150,0.7272727272727273,7,4,3,319.3280386280021,0.4155214940098661,0.17734166475173674,0.18147006659268666,130161.33334120682,-487.1673437893734,129674.16599741744,3939,8,1013.6818181818181,41,3,17,36.74452330027868,0.6133130081300813,44.89087301587301,1020.4365079365076,24.888695315524576,0
4088,4,0,0,44,0.0,0.0,1.0,44,1100,800,300,0.7272727272727273,14,8,6,319.4738802345362,0.4157307082452431,0.17823466599098636,0.1821472531689077,130288.52390276971,-475.2045761515085,129813.3193266182,3940,9,1014.6818181818181,40,4,18,36.61220883933903,0.6161458333333333,44.76626016260163,1020.934959349595,25.523373983739877,0
4089,4,0,0,44,0.0,0.0,1.0,44,900,600,300,0.6666666666666666,12,6,6,320.51282051282055,0.4156095842142354,0.18004344140707773,0.18333333333333332,130414.54081632645,-440.0935374149733,129974.44727891148,3941,10,1015.6818181818181,41,3,20,36.45833333333334,0.6158536585365854,44.64285714285714,1021.4285714285708,24.9128919860627,0
4090,4,0,0,44,0.0,0.0,1.0,44,1100,700,400,0.6363636363636364,15,7,8,323.2929573172429,0.4160500352360817,0.19102955582423586,0.18552873277576146,130541.2368216962,-359.3874992126572,130181.84932248355,3942,11,1016.6818181818181,41,3,15,36.25932352846,0.6171239837398375,44.5188492063492,1021.9246031746027,24.924990321331773,0
4091,4,1,1,44,0.022222222222222223,0.022222222222222223,0.9777777777777777,45,1150,700,450,0.6086956521739131,16,7,9,318.7259670569333,0.41914983164983166,0.18329545454545482,0.18452555987506641,130881.55759870184,-656.92979688722,130224.62780181461,3943,0,995.0666666666667,42,3,18,36.032591540404034,0.6190476190476191,44.1860465116279,1023.2558139534871,24.363233665559214,0
4092,4,0,0,44,0.0,0.0,1.0,44,1600,1400,200,0.875,18,14,4,321.85534766787066,0.41601700140944325,0.18370881590776822,0.1862859739532224,130870.93431122466,-375.69798752833424,130495.23632369633,3944,13,1018.6818181818181,41,3,18,35.96325382974596,0.6204268292682926,44.19642857142858,1023.214285714287,24.95644599303139,0
4093,4,0,0,44,0.0,0.0,1.0,44,1150,900,250,0.782608695652174,14,9,5,326.37830908338407,0.4151471106412967,0.1950986955104772,0.1897774945380061,131048.63596190794,-245.713557413702,130802.92240449424,3945,14,1019.6818181818181,41,3,19,35.66827746019442,0.6222052845528455,44.02281746031746,1023.9087301587305,24.97338366240806,0
4094,4,0,0,44,0.0,0.0,1.0,44,1150,700,450,0.6086956521739131,16,7,9,325.8142486379249,0.4154884601832276,0.18589879034388024,0.19007671929012496,131175.63952664402,-252.22151360543762,130923.41801303858,3946,15,1020.6818181818181,41,3,19,35.55466782878171,0.6234756097560975,43.898809523809526,1024.4047619047622,24.985481997677127,0
4095,4,1,1,44,0.022222222222222223,0.022222222222222223,0.9777777777777777,45,1700,1000,700,0.5882352941176471,24,10,14,314.458984375,0.418560606060606,0.18059722222222208,0.18497587316176473,131492.4391847469,-729.8499158045827,130762.58926894232,3947,0,998.9777777777778,38,7,19,35.526692708333336,0.631578947368421,43.58974358974359,1025.6410256410259,26.990553306342786,0
4096,4,0,0,44,0.0,0.0,1.0,44,1250,900,350,0.72,16,9,7,320.4958368736749,0.41427721987315014,0.17275691805254478,0.18840965193459966,131468.65051025315,-372.96896641274736,131095.68154384042,3948,17,1022.6818181818181,37,7,21,35.39584001568123,0.6331644144144144,43.612938596491226,1025.548245614035,27.717520151730678,0
4097,4,0,0,44,0.0,0.0,1.0,44,900,700,200,0.7777777777777778,11,7,4,323.9654213964775,0.4140790169133193,0.1786581752115577,0.19101099231297028,131581.12502164117,-274.4530769082909,131306.6719447329,3949,18,1023.6818181818181,37,7,15,35.1936829824374,0.6342905405405406,43.503289473684205,1025.9868421052624,27.72937411095304,0
4098,4,0,0,44,0.0,0.0,1.0,44,1450,1000,450,0.6896551724137931,19,10,9,322.43419634869076,0.41309901338971106,0.18841986718962356,0.19109327940564197,131778.07113727316,-302.0487072945341,131476.02242997862,3950,19,1024.6818181818182,37,7,15,35.034885376619684,0.6362612612612611,43.31140350877194,1026.7543859649136,27.750118539592258,0
4099,4,0,0,44,0.0,0.0,1.0,44,1400,1200,200,0.8571428571428571,16,12,4,324.8444292432911,0.4127906976744186,0.1885917242450117,0.19309280540299198,131890.6779008927,-231.20960295474265,131659.46829793797,3951,20,1025.6818181818182,37,7,15,34.85980643324794,0.6373873873873873,43.20175438596492,1027.1929824561414,27.761972498814632,0
4100,4,0,0,44,0.0,0.0,1.0,44,1650,1100,550,0.6666666666666666,22,11,11,325.07614446497024,0.4122181113460183,0.18378993218924888,0.19366106483033949,131975.16453379908,-219.60446964448795,131755.5600641546,3952,21,1026.6818181818182,37,7,15,34.76894586134528,0.6382319819819819,43.11951754385966,1027.5219298245631,27.770862968231437,0
4101,4,0,0,44,0.0,0.0,1.0,44,1000,500,500,0.5,15,5,10,326.5981548998824,0.4119428294573643,0.18635587961526534,0.19529236609319503,132116.0357032934,-170.22930132346994,131945.80640196992,3953,22,1027.6818181818182,37,7,16,34.58831058020479,0.6396396396396395,42.982456140350884,1028.0701754385973,27.785680417259385,0
4102,4,0,0,44,0.0,0.0,1.0,44,1000,700,300,0.7,13,7,6,327.58807243102177,0.41123810782241016,0.18947470440007708,0.19646906134290193,132228.78674207453,-136.68532625422358,132092.1014158203,3954,23,1028.6818181818182,37,7,16,34.44962686567164,0.6407657657657657,42.87280701754386,1028.5087719298251,27.79753437648176,0
4103,4,0,1,43,0.0,0.022727272727272728,0.9772727272727273,44,750,600,150,0.8,9,6,3,327.49823209584366,0.41073158914728686,0.18375834439460137,0.19685559972807823,132313.38158135198,-133.52028989689381,132179.86129145508,3955,24,1029.6818181818182,37,7,16,34.3670068208462,0.6416103603603605,42.790570175438596,1028.8377192982457,27.806424845898533,0
4104,4,0,0,43,0.0,0.0,1.0,43,1400,1100,300,0.7857142857142857,17,11,6,333.1458741578611,0.40759966777408635,0.18984439106258777,0.19995146804062042,132256.98201610122,212.17357744691577,132469.15559354814,3956,25,1054.0232558139535,37,6,18,34.278395160430655,0.6410472972972973,42.84539473684211,1028.6184210526324,27.800497866287362,0
4105,4,0,0,43,0.0,0.0,1.0,43,1050,800,250,0.7619047619047619,13,8,5,334.05883500071195,0.40732281284606864,0.18979401143582275,0.20079910626596284,132313.38158135198,240.09082121421898,132553.4724025662,3957,26,1055.0232558139535,37,6,18,34.198261927599546,0.6416103603603605,42.790570175438596,1028.8377192982457,27.806424845898533,0
4106,4,1,1,43,0.022727272727272728,0.022727272727272728,0.9772727272727273,44,800,400,400,0.5,12,4,8,323.3466576106496,0.4110839499647639,0.18331981782350026,0.19593872570862805,132618.00219382346,-223.68245032507954,132394.31974349837,3958,0,1032.0227272727273,38,6,19,34.16830895826852,0.6428179824561404,42.49465811965812,1030.0213675213672,27.10582546108861,0
4107,4,0,0,43,0.0,0.0,1.0,43,1050,800,250,0.7619047619047619,13,8,5,330.7703557993484,0.40663067552602433,0.18974922530121652,0.20076991363634844,132680.2718144043,177.34014312094166,132857.61195752522,3959,28,1057.0232558139535,37,6,14,33.91469774372072,0.6452702702702704,42.43421052631578,1030.2631578947357,27.844950213371238,0
4108,4,0,0,43,0.0,0.0,1.0,43,1000,600,400,0.6,14,6,8,329.73834314169324,0.40605389442598744,0.18946066303809972,0.20074743688678187,132793.26331178803,157.40612496150044,132950.66943674954,3960,29,1058.0232558139535,37,6,14,33.82801418439717,0.6463963963963965,42.32456140350876,1030.7017543859633,27.856804172593606,0
4109,4,0,0,43,0.0,0.0,1.0,43,1250,700,550,0.56,18,7,11,332.1590801564845,0.40580011074197125,0.18917234625542845,0.20283272660984258,132906.30290089245,229.20706371189573,133135.50996460434,3961,30,1059.0232558139535,37,6,14,33.65234651921168,0.6475225225225225,42.214912280701746,1031.1403508771918,27.868658131815994,0
4110,4,0,0,43,0.0,0.0,1.0,43,1450,1200,250,0.8275862068965517,17,12,5,332.8031361354067,0.4051310446659284,0.19358092074038935,0.20384192088293637,133019.39058171725,253.85407048320343,133273.24465220046,3962,31,1060.0232558139535,37,6,14,33.522445436507944,0.6486486486486487,42.105263157894726,1031.5789473684194,27.880512091038362,0
4111,4,0,1,42,0.0,0.023255813953488372,0.9767441860465116,43,1400,1200,200,0.8571428571428571,16,12,4,335.26116798206283,0.4052925433739387,0.19479338597930407,0.20597115620412348,133132.52635426272,326.8332563865672,133459.3596106493,3963,32,1061.0232558139535,37,6,15,33.34572885677858,0.6497747747747749,41.99561403508771,1032.0175438596482,27.89236605026076,0
4112,4,0,0,42,0.0,0.0,1.0,42,1000,500,500,0.5,15,5,10,339.89633872062035,0.4051006581494387,0.198980891057722,0.20860483266557536,133094.2994303423,647.6530161918415,133741.95244653415,3964,33,1083.4761904761904,36,6,15,33.264442140492555,0.6513310185185187,42.032657657657644,1031.8693693693676,28.66303803803799,0
4113,4,1,1,42,0.023255813953488372,0.023255813953488372,0.9767441860465116,43,900,500,400,0.5555555555555556,13,5,8,334.16088634134866,0.4058231819859727,0.1987840129547298,0.2067058247026815,133387.2576778429,314.5608504539465,133701.81852829683,3965,0,1059.2558139534883,37,6,15,33.119161978558516,0.6523085585585587,41.74890350877191,1033.00438596491,27.91903745851108,0
4114,4,0,0,42,0.0,0.0,1.0,42,1050,800,250,0.7619047619047619,13,8,5,342.0305987685414,0.4048223964382501,0.20439947868799702,0.21122980614857162,133326.80389426573,720.3693135703053,134047.17320783602,3966,35,1085.4761904761904,36,6,17,32.97645658416022,0.6536458333333335,41.80743243243242,1032.7702702702688,28.688063063063023,0
4115,4,1,0,43,0.023255813953488372,0.0,1.0,43,1200,1100,100,0.9166666666666666,13,11,2,332.0358741414746,0.40776116648209676,0.20000506662613393,0.2065101168440878,133588.61395178954,271.32170176932834,133859.93565355887,3967,0,1061.2093023255813,36,7,19,32.97272149600581,0.65625,41.55405405405405,1033.783783783783,28.716216216216196,0
4116,4,0,0,43,0.0,0.0,1.0,43,1450,1200,250,0.8275862068965517,17,12,5,330.77441600643493,0.4077380952380953,0.1963429788744906,0.20634023093734705,133698.92659279745,244.83687288393426,133943.76346568138,3968,1,1062.2093023255813,37,6,19,32.89510884930733,0.6554054054054055,41.447368421052616,1034.2105263157869,27.951635846372618,0
4117,4,0,1,42,0.0,0.023255813953488372,0.9767441860465116,43,1050,600,450,0.5714285714285714,15,6,9,330.49197157259215,0.4073689553340716,0.20075047366566756,0.20727665911453103,133897.4507180091,250.40649526774396,134147.85721327685,3969,2,1063.2093023255813,37,6,14,32.70418388247344,0.6573761261261263,41.255482456140335,1034.9780701754362,27.97238027501179,0
4118,4,0,0,42,0.0,0.0,1.0,42,1250,900,350,0.72,16,9,7,339.11279860217843,0.40427797135114213,0.2084758587806046,0.2122458033758046,133821.54959013048,676.120038957858,134497.66962908834,3970,39,1089.4761904761904,36,6,15,32.556958351472936,0.6585648148148149,41.32882882882882,1034.6846846846831,28.741241241241198,0
4119,4,0,0,42,0.0,0.0,1.0,42,950,600,350,0.631578947368421,13,6,7,339.2482011364484,0.40375774293457223,0.2101611482460235,0.21266650535088408,133879.81520371707,683.6972952682263,134563.51249898528,3971,40,1090.4761904761904,36,6,15,32.495239390642006,0.6591435185185186,41.272522522522515,1034.9099099099087,28.747497497497463,0
4120,4,0,0,42,0.0,0.0,1.0,42,1000,600,400,0.6,14,6,8,341.04794287033883,0.4036004645760743,0.21025143064294727,0.2146431098352339,134025.53471968597,741.8265816492197,134767.3613013352,3972,41,1091.4761904761904,36,6,15,32.30310857350009,0.6605902777777778,41.13175675675676,1035.4729729729736,28.763138138138157,0
4121,4,0,0,42,0.0,0.0,1.0,42,600,400,200,0.6666666666666666,8,4,4,341.70379222585944,0.40280197444831595,0.20886986957444753,0.2153975172790424,134083.8447188742,763.3916433325155,134847.23636220672,3973,42,1092.4761904761904,36,6,15,32.2279004023051,0.6611689814814815,41.07545045045045,1035.6981981981976,28.76939439439438,0
4122,4,0,0,42,0.0,0.0,1.0,42,1650,1200,450,0.7272727272727273,21,12,9,343.5527916479309,0.4018704026325977,0.20706600214262427,0.21725286845035158,134200.5027620527,820.9914728918268,135021.49423494452,3974,43,1093.4761904761904,36,6,16,32.063543817700975,0.6623263888888888,40.962837837837846,1036.1486486486497,28.781906906906936,0
4123,4,0,0,42,0.0,0.0,1.0,42,700,300,400,0.42857142857142855,11,3,8,345.0687511733986,0.4017010259388308,0.2127696455089696,0.2185593748829175,134258.8508060427,865.7067963233726,135124.55760236608,3975,44,1094.4761904761904,36,6,16,31.966025571371656,0.6629050925925926,40.90653153153154,1036.3738738738753,28.7881631631632,0
4124,4,0,0,42,0.0,0.0,1.0,42,1250,900,350,0.72,16,9,7,348.45284227036836,0.4007573557878436,0.21775431813490798,0.2219539013491863,134465.4740521123,970.9753241382055,135436.4493762505,3976,45,1095.4761904761904,37,5,16,31.672106811854665,0.6630067567567567,40.70723684210527,1037.1710526315796,28.031650071123774,0
4125,4,0,1,41,0.0,0.023809523809523808,0.9761904761904762,42,1100,800,300,0.7272727272727273,14,8,6,352.48175491700846,0.3999467673248161,0.2237253970074895,0.2254279866186033,134612.54428854876,1089.7743237126328,135702.31861226138,3977,46,1096.4761904761904,34,8,16,31.42088256663225,0.6706495098039216,40.56547619047619,1037.7380952380954,30.521708683473395,0
4126,4,0,0,41,0.0,0.0,1.0,41,950,700,250,0.7368421052631579,12,7,5,356.15894108246476,0.398729674796748,0.22739460125738353,0.22799017929156407,134646.1566014272,1391.0865111975988,136037.2431126248,3978,47,1120.1463414634147,33,8,16,31.291942181288608,0.6732954545454546,40.53308823529411,1037.8676470588225,31.45053475935826,0
4127,4,0,0,41,0.0,0.0,1.0,41,1000,600,400,0.6,14,6,8,358.2818217733168,0.39766260162601624,0.23179801388381005,0.22975059138847587,134709.7589418733,1452.8115688677387,136162.57051074103,3979,48,1121.1463414634147,33,8,16,31.173390587494588,0.6739267676767677,40.47181372549019,1038.1127450980389,31.457961972667846,0
4128,4,0,0,41,0.0,0.0,1.0,41,1500,1400,100,0.9333333333333333,16,14,2,356.0001376777452,0.3974339430894309,0.22987727985728768,0.22884224030677755,134797.91843820858,1397.6155045351425,136195.53394274373,3980,49,1122.1463414634147,34,7,16,31.144674997134004,0.6724877450980392,40.38690476190476,1038.4523809523807,30.542717086834728,0
4129,4,0,0,41,0.0,0.0,1.0,41,1100,700,400,0.6363636363636364,15,7,8,359.8974212811935,0.39667174796747967,0.23863204489056855,0.2323361459276816,134952.49433106568,1513.8109410430748,136466.30527210876,3981,50,1123.1463414634147,34,7,16,30.88933127100519,0.6740196078431373,40.238095238095234,1039.0476190476184,30.560224089635835,0
4130,4,0,0,41,0.0,0.0,1.0,41,1050,600,450,0.5714285714285714,15,6,9,358.5329858069131,0.3956554878048781,0.23905902595443762,0.23224851869925559,135076.21882086172,1485.856009070298,136562.074829932,3982,51,1124.1463414634147,34,7,16,30.801458237898924,0.6752450980392157,40.11904761904762,1039.5238095238096,30.574229691876752,0
4131,4,0,0,41,0.0,0.0,1.0,41,1200,900,300,0.75,15,9,6,351.51972668880705,0.3953252032520325,0.21763301100105692,0.22576988631662567,134767.01388888896,1274.6527777777883,136041.66666666674,3983,52,1125.1463414634147,34,7,20,31.29180042803638,0.6721813725490196,40.41666666666667,1038.333333333334,30.539215686274527,1
4132,4,0,0,41,0.0,0.0,1.0,41,650,500,150,0.7692307692307693,8,5,3,351.51972668880705,0.3953252032520325,0.21763301100105692,0.22576988631662567,134767.01388888896,1274.6527777777883,136041.66666666674,3984,53,1126.1463414634147,34,7,20,31.29180042803638,0.6721813725490196,40.41666666666667,1038.333333333334,30.539215686274527,0
4133,4,0,0,41,0.0,0.0,1.0,41,1350,1200,150,0.8888888888888888,15,12,3,353.0593338040519,0.3950711382113821,0.2185148447584755,0.2274736195901913,134881.20666420183,1324.213793509943,136205.42045771176,3985,54,1127.1463414634147,35,6,16,31.137999071494896,0.6711309523809523,40.30671296296296,1038.773148148148,29.6792328042328,0
4134,4,0,0,41,0.0,0.0,1.0,41,800,400,400,0.5,12,4,8,351.0557983343336,0.394994918699187,0.21300450866424048,0.22712399632869718,135031.53399348422,1280.7205932784655,136312.2545867627,3986,55,1128.1463414634147,35,6,16,31.040274684484032,0.6726190476190477,40.16203703703704,1039.351851851852,29.6957671957672,0
4135,4,0,0,41,0.0,0.0,1.0,41,900,400,500,0.4444444444444444,14,4,10,352.82930617308006,0.39486788617886176,0.2165825420917018,0.22884228572944249,135121.77057881086,1334.984112439986,136456.75469125086,3987,56,1129.1463414634147,35,6,17,30.90432390812275,0.6735119047619047,40.07523148148148,1039.699074074074,29.705687830687825,0
4136,4,0,1,40,0.0,0.024390243902439025,0.975609756097561,41,1050,600,450,0.5714285714285714,15,6,9,354.7409807192911,0.3947408536585366,0.22245682788417964,0.23085135363680442,135242.13291162977,1395.1853727280513,136637.3182843578,3988,57,1130.1463414634147,35,6,17,30.734788212603387,0.6747023809523809,39.95949074074074,1040.162037037037,29.71891534391534,0
4137,4,0,0,40,0.0,0.0,1.0,40,1450,1100,350,0.7586206896551724,18,11,7,356.0473950319258,0.3943643162393162,0.21784161135271218,0.2318287733076727,135261.91184807254,1631.9302721088425,136893.8421201814,3989,58,1116.95,34,6,17,30.681124589913782,0.6770833333333333,39.94047619047619,1040.2380952380952,30.595238095238095,0
4138,4,0,0,40,0.0,0.0,1.0,40,1500,1200,300,0.8,18,12,6,356.5261088881553,0.3939236111111111,0.21932892249527414,0.23318103979863125,135422.77688025116,1656.351139188951,137079.1280194401,3990,59,1117.95,35,5,19,30.508566848289405,0.6764880952380952,39.785879629629626,1040.856481481481,29.738756613756603,0
4139,4,0,0,40,0.0,0.0,1.0,40,1050,900,150,0.8571428571428571,12,9,3,356.14294461386015,0.39413728632478634,0.2125958652884301,0.23371393673894206,135543.27317226064,1654.5560860339297,137197.82925829457,3991,60,1118.95,35,5,21,30.398674558186062,0.6776785714285715,39.67013888888888,1041.319444444443,29.751984126984084,0
4140,4,0,0,40,0.0,0.0,1.0,40,850,600,250,0.7058823529411765,11,6,5,357.01698702159746,0.39379006410256406,0.21373208134237132,0.23468194786028904,135603.54141214423,1682.5535568844325,137286.09496902867,3992,61,1119.95,35,5,22,30.315984183427794,0.6782738095238094,39.61226851851852,1041.550925925926,29.75859788359789,0
4141,4,0,0,40,0.0,0.0,1.0,40,1200,1000,200,0.8333333333333334,14,10,4,356.82691041485936,0.39408386752136754,0.20528780264961188,0.23598009271846734,135819.75623582763,1692.8321471657096,137512.58838299333,3993,62,1120.95,34,6,23,30.10602253692707,0.6825980392156863,39.404761904761905,1042.3809523809523,30.658263305322127,0
4142,4,0,0,40,0.0,0.0,1.0,40,1250,800,450,0.64,17,8,9,348.06127055500207,0.39403044871794873,0.16514799154334092,0.22187733284705646,134493.90677900886,1362.4240150815608,135856.33079409043,3994,63,1121.95,37,3,18,31.653893587033117,0.6632882882882883,40.67982456140351,1037.2807017543855,28.034613560929337,4
4143,4,0,0,40,0.0,0.0,1.0,40,1100,1000,100,0.9090909090909091,12,10,2,347.13288941607993,0.3946981837606838,0.16662391255855447,0.22199668234697387,134610.82845721886,1345.5932116696013,135956.42166888845,3995,64,1122.95,35,5,19,31.561361439512226,0.6684523809523808,40.56712962962963,1037.731481481482,29.649470899470913,0
4144,4,0,1,39,0.0,0.025,0.975,40,700,400,300,0.5714285714285714,10,4,6,346.65429506119875,0.39424412393162395,0.16628010704727902,0.2220568370077738,134670.8890603568,1336.8484224965869,136007.73748285338,3996,65,1123.95,35,5,19,31.51390127862029,0.6690476190476189,40.50925925925927,1037.962962962964,29.656084656084683,0
4145,4,0,0,39,0.0,0.0,1.0,39,1250,1000,250,0.8,15,10,5,353.4242653924369,0.3936965811965812,0.16020717407854868,0.22718643087827767,134797.9184382087,1728.1710600907131,136526.0894982994,3997,66,1124.871794871795,34,5,17,31.2115480148267,0.6724877450980392,40.386904761904766,1038.4523809523816,30.542717086834756,0
4146,4,1,1,39,0.025,0.025,0.975,40,1500,1200,300,0.8,18,12,6,343.7756973632629,0.39595352564102565,0.15568883353189622,0.22305558775509554,135135.59325795408,1291.2665621702968,136426.85982012437,3998,0,1097.725,36,4,18,31.125898046860904,0.6715856481481481,40.061936936936945,1039.7522522522536,28.882007007007044,0
4147,4,0,0,39,0.0,0.0,1.0,39,1150,700,450,0.6086956521739131,16,7,9,349.19055118894164,0.39341542959964015,0.1621144052610084,0.22583599137510488,135018.52940355917,1629.4389406298415,136647.968344189,3999,68,1126.871794871795,36,3,18,31.101690323978772,0.6704282407407407,40.17454954954956,1039.3018018018033,28.869494494494536,0
4148,4,0,0,39,0.0,0.0,1.0,39,1200,1000,200,0.8333333333333334,14,10,4,347.94029222830994,0.3928812415654521,0.16058268494915673,0.2259409745735735,135164.86714755304,1605.8606748640657,136770.7278224171,4000,69,1127.871794871795,36,3,18,30.98851165980796,0.671875,40.03378378378379,1039.8648648648657,28.885135135135158,0
4149,4,0,0,39,0.0,0.0,1.0,39,1150,1000,150,0.8695652173913043,13,10,3,347.68885515638755,0.3917847503373819,0.16552336552336544,0.2268817105681513,135340.57706355015,1611.2820590861243,136951.8591226363,4001,70,1128.871794871795,36,3,19,30.82025613275611,0.6736111111111112,39.86486486486487,1040.5405405405415,28.90390390390393,0
4150,4,0,0,39,0.0,0.0,1.0,39,850,600,250,0.7058823529411765,11,6,5,347.23506866881127,0.3914192532613585,0.15516634078018643,0.22751156696266187,135487.08917955117,1609.173742999757,137096.26292255093,4002,71,1129.871794871795,36,3,19,30.686407066883007,0.6750578703703705,39.7240990990991,1041.1036036036035,28.91954454454454,0
4151,4,0,0,39,0.0,0.0,1.0,39,1450,1000,450,0.6896551724137931,19,10,9,349.0594771197564,0.3905195681511471,0.1635864968087566,0.23022582216184323,135724.11807966794,1675.237197889021,137399.35527755696,4003,72,1130.871794871795,35,4,19,30.403407197600803,0.6794642857142859,39.496527777777764,1042.0138888888869,29.77182539682534,0
4152,4,0,0,39,0.0,0.0,1.0,39,950,700,250,0.7368421052631579,12,7,5,347.6385496500005,0.3901821862348178,0.1612258494337111,0.22987024802848008,135814.5857445985,1642.8771219135488,137457.46286651204,4004,73,1131.871794871795,35,4,20,30.350599600266488,0.680357142857143,39.40972222222221,1042.361111111109,29.78174603174597,0
4153,4,0,0,39,0.0,0.0,1.0,39,900,800,100,0.8888888888888888,10,8,2,347.04056646466324,0.3902103013945119,0.15838962857948147,0.2296689479902437,135844.74833086826,1628.7276823988066,137473.47601326706,4005,74,1132.871794871795,35,4,20,30.336243107212916,0.680654761904762,39.380787037037024,1042.47685185185,29.785052910052855,0
4154,4,0,0,39,0.0,0.0,1.0,39,1100,800,300,0.7272727272727273,14,8,6,345.4986571869691,0.3901821862348178,0.15312892235969167,0.229035864797454,135905.08355034693,1591.0047743055216,137496.08832465246,4006,75,1133.871794871795,35,4,16,30.316558441558435,0.6812500000000001,39.32291666666665,1042.708333333331,29.7916666666666,0
4155,4,0,0,39,0.0,0.0,1.0,39,1000,600,400,0.6,14,6,8,344.8741748285603,0.38987291947818264,0.15152394775036293,0.22881563440392677,135935.2561835561,1576.111861282563,137511.36804483866,4007,76,1134.871794871795,35,4,16,30.30290418054014,0.6815476190476191,39.293981481481474,1042.824074074073,29.794973544973516,0
4156,4,0,0,39,0.0,0.0,1.0,39,1050,800,250,0.7619047619047619,13,8,5,345.79693083002985,0.3895636527215474,0.15862504480210338,0.23020779427635762,136055.98020618974,1609.5480752743183,137665.52828146407,4008,77,1135.871794871795,35,4,17,30.159104356186674,0.6827380952380954,39.178240740740726,1043.287037037035,29.808201058200996,0
4157,4,0,0,39,0.0,0.0,1.0,39,900,600,300,0.6666666666666666,12,6,6,349.7595627109057,0.3888326585695007,0.15753109166282853,0.23363938789088473,136176.75781249985,1725.8246527777624,137902.5824652776,4009,78,1136.871794871795,35,4,17,29.935961410512313,0.6839285714285714,39.06249999999999,1043.7499999999989,29.821428571428537,0
4158,4,0,0,39,0.0,0.0,1.0,39,1150,800,350,0.6956521739130435,15,8,7,349.4298353231082,0.38790485829959515,0.15295943249833743,0.2342166399914621,136297.58900248614,1725.288816015076,138022.8778185012,4010,79,1137.871794871795,35,4,17,29.824780166999194,0.6851190476190476,38.94675925925925,1044.212962962962,29.834656084656054,0
4159,4,0,0,39,0.0,0.0,1.0,39,850,600,250,0.7058823529411765,11,6,5,348.1327491348285,0.38739878542510126,0.14631152780737233,0.23394624429946595,136388.24755926355,1696.243114497597,138084.49067376115,4011,80,1138.871794871795,35,4,17,29.768813481071096,0.6860119047619048,38.8599537037037,1044.5601851851852,29.84457671957672,0
4160,4,0,0,39,0.0,0.0,1.0,39,700,400,300,0.5714285714285714,10,4,6,345.32493782938684,0.38714574898785425,0.1476779948371485,0.23285577771930802,136509.17252068332,1628.0043027692018,138137.17682345252,4012,81,1139.871794871795,35,4,17,29.722399121349717,0.6872023809523808,38.74421296296296,1045.0231481481483,29.857804232804238,0
4161,4,0,0,39,0.0,0.0,1.0,39,1100,500,600,0.45454545454545453,17,5,12,347.83999999999963,0.38753936122357174,0.16041025641025608,0.228842105263158,135633.68055555577,1635.763888888908,137269.44444444467,4013,82,1140.871794871795,36,3,18,30.524999999999984,0.6765046296296295,39.58333333333334,1041.6666666666683,28.935185185185233,2
4162,4,0,0,39,0.0,0.0,1.0,39,1000,700,300,0.7,13,7,6,348.2105631013773,0.38717386414754834,0.15902592228003587,0.22948334700777498,135695.6916099771,1650.1346371881814,137345.8262471653,4014,83,1141.871794871795,34,5,18,30.453753427787937,0.6813725490196079,39.52380952380951,1041.90476190476,30.64425770308118,0
4163,4,0,0,39,0.0,0.0,1.0,39,700,500,200,0.7142857142857143,9,5,4,348.2105631013773,0.38703328834907785,0.15902592228003587,0.22948334700777498,135695.6916099771,1650.1346371881814,137345.8262471653,4015,84,1142.871794871795,34,5,18,30.453753427787937,0.6813725490196079,39.52380952380951,1041.90476190476,30.64425770308118,0
4164,4,0,0,39,0.0,0.0,1.0,39,600,300,300,0.5,9,3,6,348.2105631013773,0.38703328834907785,0.15902592228003587,0.22948334700777498,135695.6916099771,1650.1346371881814,137345.8262471653,4016,85,1143.871794871795,34,5,18,30.453753427787937,0.6813725490196079,39.52380952380951,1041.90476190476,30.64425770308118,0
4165,4,1,1,39,0.025,0.025,0.975,40,700,500,200,0.7142857142857143,9,5,4,339.44624359910875,0.3893696581196581,0.1525915649278582,0.2252143339343127,135935.2561835561,1228.5424168381178,137163.79860039422,4017,0,1116.25,35,5,17,30.444413614502405,0.6815476190476191,39.293981481481474,1042.824074074073,29.794973544973516,0
4166,4,0,0,39,0.0,0.0,1.0,39,650,400,250,0.6153846153846154,9,4,5,344.0705332824984,0.3867240215924426,0.1299033390686417,0.21149607226922174,133152.40652392252,1362.7639041068005,134515.17042802932,4018,87,1145.871794871795,36,3,18,33.098517912347695,0.6519097222222223,41.97635135135135,1032.0945945945941,28.669294294294282,4
4167,4,0,0,39,0.0,0.0,1.0,39,900,700,200,0.7777777777777778,11,7,4,345.272488816982,0.38593679712100765,0.1336398956121878,0.21256634687610962,133210.52629910302,1398.7859903822557,134609.31228948527,4019,88,1146.871794871795,36,3,18,33.00925420893785,0.652488425925926,41.920045045045036,1032.3198198198186,28.675550550550515,0
4168,4,0,0,39,0.0,0.0,1.0,39,900,500,400,0.5555555555555556,13,5,8,342.77270840741164,0.3859930274403958,0.12920616279394914,0.21152259327698267,133297.72973987486,1338.1647694992107,134635.89450937408,4020,89,1147.871794871795,36,3,18,32.986414031261354,0.6533564814814816,41.83558558558558,1032.6576576576565,28.6849349349349,0
4169,4,0,0,39,0.0,0.0,1.0,39,1250,1000,250,0.8,15,10,5,340.9265493098919,0.38554318488529016,0.12892335638929708,0.21120871640231287,133443.1322158304,1298.8613190893313,134741.99353491975,4021,90,1148.871794871795,36,3,18,32.888510445049945,0.6548032407407409,41.694819819819806,1033.2207207207186,28.700575575575517,0
4170,4,1,0,40,0.025,0.0,1.0,40,1200,900,300,0.75,15,9,6,335.32674858064644,0.38835470085470086,0.13023637905448382,0.20950149311985503,133755.63274276664,970.368286395772,134726.0010291624,4022,0,1121.125,37,3,18,32.72074411702351,0.6559684684684687,41.3925438596491,1034.4298245614007,27.957562825983803,0
4171,4,0,0,40,0.0,0.0,1.0,40,1550,1400,150,0.9032258064516129,17,14,3,335.97825827992995,0.3881543803418803,0.13184177081126958,0.2112055069693137,133982.57757194483,1003.0466104954974,134985.6241824403,4023,1,1122.125,37,3,18,32.477229400550726,0.6582207207207209,41.17324561403507,1035.3070175438565,27.981270744428556,0
4172,4,0,1,39,0.0,0.025,0.975,40,900,300,600,0.3333333333333333,15,3,12,337.59669319598004,0.38715277777777773,0.13445273631840848,0.21304448634752288,134124.5157764886,1055.9986005309024,135180.5143770195,4024,2,1123.125,37,3,18,32.2936514237324,0.6596283783783785,41.0361842105263,1035.8552631578923,27.996088193456547,0
4173,4,0,0,39,0.0,0.0,1.0,39,1150,800,350,0.6956521739130435,15,8,7,342.9985873704584,0.3848403058929375,0.13399575669881258,0.2162137085706718,134083.84471887417,1398.1138655547372,135481.9585844289,4025,3,1148.3333333333333,36,3,18,32.194374977347685,0.6611689814814815,41.07545045045045,1035.6981981981974,28.76939439439437,0
4174,4,0,0,39,0.0,0.0,1.0,39,1250,900,350,0.72,16,9,7,345.123795650105,0.38377192982456143,0.14030952022692955,0.21842016283165533,134229.6751988476,1465.1709987014156,135694.84619754902,4026,4,1149.3333333333333,36,3,18,31.99372419039341,0.6626157407407407,40.93468468468469,1036.261261261262,28.785035035035055,0
4175,4,0,0,39,0.0,0.0,1.0,39,950,700,250,0.7368421052631579,12,7,5,346.7883044283097,0.382619208277103,0.14300595486778378,0.2201746986597946,134346.3966500285,1517.9518200633124,135864.34847009182,4027,5,1150.3333333333333,36,3,19,31.834084654935175,0.6637731481481481,40.822072072072075,1036.7117117117123,28.797547547547563,0
4176,4,0,0,39,0.0,0.0,1.0,39,850,700,150,0.8235294117647058,10,7,3,347.02004742331724,0.3826754385964912,0.13940340822061303,0.22049783137518844,134375.58493882394,1526.2043716013332,135901.7893104253,4028,6,1151.3333333333333,36,3,19,31.79894826400204,0.6640625,40.79391891891892,1036.8243243243242,28.80067567567567,0
4177,4,0,0,39,0.0,0.0,1.0,39,1050,700,350,0.6666666666666666,14,7,7,347.33807962595546,0.38216936572199733,0.13189676772738657,0.22122985569537007,134463.1688276115,1540.8357682006485,136004.00459581215,4029,7,1152.3333333333333,36,3,21,31.70331161780674,0.6649305555555556,40.70945945945947,1037.162162162163,28.81006006006008,0
4178,4,0,0,39,0.0,0.0,1.0,39,950,600,350,0.631578947368421,13,6,7,348.2201899969353,0.3817476383265857,0.1361342807125938,0.22232519822881272,134550.78125000015,1570.6597222222372,136121.4409722224,4030,8,1153.3333333333333,36,3,22,31.593038821954487,0.665798611111111,40.62500000000001,1037.5000000000011,28.819444444444475,0
4179,4,1,1,39,0.025,0.025,0.975,40,1250,900,350,0.72,16,9,7,342.77243962378446,0.38397435897435894,0.13482585751978915,0.22108705687102487,134920.7583703639,1249.4235005001522,136170.18187086406,4031,0,1125.475,37,3,18,31.365765171503966,0.6675112612612613,40.26864035087719,1038.925438596491,28.07906590801327,0
4180,4,0,0,39,0.0,0.0,1.0,39,1050,800,250,0.7619047619047619,13,8,5,348.3484703377373,0.38118533513270353,0.1415219996718753,0.22384120174106445,134784.55387397538,1590.3986334307328,136374.95250740612,4032,10,1155.3333333333333,36,3,18,31.356640639120844,0.6681134259259258,40.39977477477478,1038.4009009009012,28.844469469469477,0
4181,4,0,0,39,0.0,0.0,1.0,39,950,800,150,0.8421052631578947,11,8,3,348.4194306808499,0.3804262258209627,0.13876614028359113,0.22479144527702954,134930.7648019642,1602.5000507264112,136533.2648526906,4033,11,1156.3333333333333,36,3,19,31.20912818845292,0.6695601851851851,40.25900900900901,1038.9639639639645,28.860110110110124,0
4182,4,0,0,39,0.0,0.0,1.0,39,750,400,350,0.5333333333333333,11,4,7,347.92969836688263,0.3798639226270805,0.13467233380559485,0.22520274305233706,135047.79061155755,1597.4274105186303,136645.21802207618,4034,12,1157.3333333333333,36,3,20,31.105317804261475,0.6707175925925927,40.1463963963964,1039.4144144144148,28.872622622622632,0
4183,4,0,0,39,0.0,0.0,1.0,39,1050,900,150,0.8571428571428571,12,9,3,348.26705795721307,0.3795546558704453,0.13313556049987674,0.2256037341756515,135077.05498995614,1608.5777077753414,136685.6326977315,4035,13,1158.3333333333333,36,3,20,31.067417759000474,0.6710069444444444,40.11824324324324,1039.5270270270269,28.875750750750747,0
4184,4,0,0,39,0.0,0.0,1.0,39,1100,800,300,0.7272727272727273,14,8,6,347.2128093696256,0.37938596491228066,0.12535982656151523,0.2260186554014963,135252.70783875094,1592.2945327083817,136845.00237145933,4036,14,1159.3333333333333,36,3,21,30.920031756342244,0.6727430555555556,39.94932432432432,1040.202702702703,28.894519519519527,0
4185,4,0,0,39,0.0,0.0,1.0,39,900,700,200,0.7777777777777778,11,7,4,348.7707451563175,0.37947031039136303,0.12320904180614134,0.22721749955952464,135281.9944099504,1636.4803993182295,136918.47480926863,4037,15,1160.3333333333333,36,3,21,30.850382478169877,0.6730324074074074,39.92117117117117,1040.3153153153146,28.897647647647627,0
4186,4,0,0,39,0.0,0.0,1.0,39,900,600,300,0.6666666666666666,12,6,6,350.2543992803734,0.37958277103013943,0.11603396603396643,0.22855583681854869,135340.57706355,1680.7265035305554,137021.30356708055,4038,16,1161.3333333333333,36,3,21,30.753517316017323,0.6736111111111112,39.86486486486486,1040.5405405405402,28.903903903903895,0
4187,4,0,0,39,0.0,0.0,1.0,39,1350,1300,50,0.9629629629629629,14,13,1,349.7978384819708,0.38025753486279806,0.10549846764016602,0.22919071699261634,135487.08917955097,1678.6181874441731,137165.70736699514,4039,17,1162.3333333333333,36,3,21,30.61970434469081,0.6750578703703705,39.724099099099085,1041.1036036036019,28.919544544544497,0
4188,4,0,0,39,0.0,0.0,1.0,39,950,600,350,0.631578947368421,13,6,7,350.3863760705906,0.3788236617183986,0.09827396986930115,0.23089563756446596,135692.33929875816,1708.949405486563,137401.2887042447,4040,18,1163.3333333333333,36,3,22,30.400408920593758,0.6770833333333335,39.527027027027025,1041.8918918918914,28.941441441441427,0
4189,4,0,0,39,0.0,0.0,1.0,39,900,600,300,0.6666666666666666,12,6,6,353.2147431126224,0.37876743139901037,0.10321247083728169,0.2331418853612131,135751.01072356146,1789.851676000325,137540.86239956177,4041,19,1164.3333333333333,36,3,22,30.26844247532597,0.6776620370370371,39.47072072072072,1042.1171171171175,28.947697697697706,0
4190,4,0,2,37,0.0,0.05128205128205128,0.9487179487179487,39,1050,900,150,0.8571428571428571,12,9,3,353.4484674474039,0.37879554655870445,0.10650887573964485,0.23367992962094092,135809.69482996516,1800.3457004301645,137610.04053039532,4042,20,1165.3333333333333,36,3,22,30.204056828003445,0.6782407407407407,39.414414414414416,1042.3423423423428,28.953953953953967,0
4191,4,0,0,37,0.0,0.0,1.0,37,1300,1000,300,0.7692307692307693,16,10,6,363.2514093942087,0.37571946946946944,0.09244706834104721,0.23960358601563753,135726.70245181414,2460.5831916099814,138187.2856434241,4043,21,1114.945945945946,34,3,22,30.031132183251437,0.6816789215686274,39.49404761904762,1042.02380952381,30.647759103641473,0
4192,4,0,0,37,0.0,0.0,1.0,37,1000,600,400,0.6,14,6,8,361.96009068490196,0.3752502502502502,0.08791887261333309,0.23916683727896731,135788.73476473923,2430.0205498866235,138218.75531462586,4044,22,1115.945945945946,34,3,22,30.00309347039788,0.6822916666666666,39.43452380952381,1042.2619047619048,30.654761904761905,0
4193,4,0,0,37,0.0,0.0,1.0,37,1350,1100,250,0.8148148148148148,16,11,5,364.0584008246811,0.3743743743743744,0.09182832792833961,0.24139194041055137,135912.84190759645,2496.0423752834604,138408.8842828799,4045,23,1116.945945945946,34,3,19,29.825037104692328,0.683517156862745,39.3154761904762,1042.7380952380959,30.66876750700282,0
4194,4,0,0,37,0.0,0.0,1.0,37,1150,700,450,0.6086956521739131,16,7,9,362.33660552759727,0.37440565565565564,0.09378171688410264,0.24066952244331172,135974.91673752843,2453.7379535147516,138428.6546910432,4046,24,1117.945945945946,34,3,20,29.8082410683712,0.6841299019607843,39.25595238095239,1042.9761904761913,30.675770308123273,0
4195,4,0,0,37,0.0,0.0,1.0,37,750,200,550,0.26666666666666666,13,2,11,361.9742083410754,0.37374874874874875,0.08862028029170088,0.24127026130110457,136099.10891439905,2452.873441043078,138551.98235544213,4047,25,1118.945945945946,34,3,20,29.694333523483547,0.6853553921568627,39.13690476190476,1043.4523809523807,30.68977591036414,0
4196,4,0,0,37,0.0,0.0,1.0,37,700,600,100,0.8571428571428571,8,6,2,361.94838577143776,0.37324824824824826,0.08940183056488671,0.24231201093248142,136254.42885487518,2463.41411564625,138717.84297052142,4048,26,1119.945945945946,34,3,20,29.54081147852528,0.6868872549019608,38.988095238095234,1044.0476190476184,30.707282913165244,0
4197,4,0,0,37,0.0,0.0,1.0,37,950,700,250,0.7368421052631579,12,7,5,360.1953874149768,0.3730292792792793,0.08649511442807545,0.2413501713534577,136285.50347222225,2417.8819444444484,138703.3854166667,4049,27,1120.945945945946,34,3,20,29.55573290768822,0.6871936274509804,38.958333333333336,1044.1666666666667,30.710784313725494,0
4198,4,0,0,37,0.0,0.0,1.0,37,1200,900,300,0.75,15,9,6,363.5976980706326,0.3721221221221221,0.09751289751289782,0.24448810732335646,136409.83737244896,2519.6605725623594,138929.49794501133,4050,28,1121.945945945946,34,3,20,29.34354226020892,0.6884191176470589,38.839285714285715,1044.642857142857,30.724789915966387,0
4199,4,0,0,37,0.0,0.0,1.0,37,650,400,250,0.6153846153846154,9,4,5,364.66249213692123,0.3718718718718719,0.09590036709453353,0.24542009440135118,136440.9297052153,2550.9778911564485,138991.90759637175,4051,29,1122.945945945946,34,3,20,29.284886812518998,0.6887254901960784,38.8095238095238,1044.7619047619037,30.72829131652658,0
4200,4,0,1,36,0.0,0.02702702702702703,0.972972972972973,37,1200,900,300,0.75,15,9,6,366.2807893275772,0.37115240240240244,0.09613371914055269,0.24738041002277886,136565.33446712006,2604.251700680256,139169.58616780033,4052,30,1123.945945945946,34,3,20,29.119210326499626,0.6899509803921569,38.69047619047618,1045.2380952380943,30.74229691876748,0
4201,4,0,0,36,0.0,0.0,1.0,36,850,700,150,0.8235294117647058,10,7,3,374.8737668930112,0.3702215608465609,0.0958686785765479,0.25269158974677497,136496.7218888167,3033.8080606016797,139530.5299494184,4053,31,1144.1666666666667,33,3,20,28.962779992963522,0.6916035353535354,38.75612745098039,1044.9754901960778,31.66592394533569,0
4202,4,0,0,36,0.0,0.0,1.0,36,1100,700,400,0.6363636363636364,15,7,8,372.6634396443268,0.3705026455026455,0.09611326064016912,0.2516584700496011,136560.7597588668,2978.2404904363716,139539.00024930318,4054,32,1145.1666666666667,33,3,21,28.956965451205683,0.6922348484848485,38.69485294117647,1045.2205882352941,31.67335115864528,0
4203,4,0,0,36,0.0,0.0,1.0,36,950,700,250,0.7368421052631579,12,7,5,373.746473815012,0.3705026455026455,0.09810302731286447,0.2530929282588471,136658.67524092956,3015.1395975056507,139673.8148384352,4055,33,1146.1666666666667,34,2,21,28.831502144293893,0.6908700980392157,38.60119047619047,1045.595238095237,30.752801120448144,0
4204,4,0,0,36,0.0,0.0,1.0,36,550,400,150,0.7272727272727273,7,4,3,373.48613514071195,0.37023809523809526,0.09462151394422325,0.2533649187035642,136720.92013888896,3012.6877834467227,139733.60792233568,4056,34,1147.1666666666667,33,3,21,28.776560424966807,0.6938131313131313,38.54166666666667,1045.833333333334,31.69191919191921,0
4205,4,0,0,36,0.0,0.0,1.0,36,950,600,350,0.631578947368421,13,6,7,376.5396503611366,0.3704695767195767,0.088448922211809,0.2559030617422502,136785.01057285664,3100.996011149565,139886.00658400622,4057,35,1148.1666666666667,33,3,21,28.63314198687911,0.6944444444444444,38.48039215686275,1046.0784313725494,31.69934640522877,0
4206,4,0,0,36,0.0,0.0,1.0,36,1000,700,300,0.7,13,7,6,379.035699203089,0.37040343915343915,0.08960447567004959,0.25854352006344883,136913.23649557863,3179.0008650519067,140092.23736063053,4058,36,1149.1666666666667,33,3,21,28.440671350507415,0.6957070707070707,38.3578431372549,1046.5686274509806,31.714200831847897,0
4207,4,0,0,36,0.0,0.0,1.0,36,750,500,250,0.6666666666666666,10,5,5,379.035699203089,0.37040343915343915,0.08960447567004959,0.25854352006344883,136913.23649557863,3179.0008650519067,140092.23736063053,4059,37,1150.1666666666667,33,3,21,28.440671350507415,0.6957070707070707,38.3578431372549,1046.5686274509806,31.714200831847897,0
4208,4,0,0,36,0.0,0.0,1.0,36,850,500,350,0.5882352941176471,12,5,7,378.78237360684057,0.37040343915343915,0.10204490777866848,0.24473659061540448,134983.42013888905,3025.868055555575,138009.2881944446,4060,38,1151.1666666666667,34,2,16,30.3678829190056,0.6743259803921567,40.20833333333334,1039.166666666668,30.56372549019612,3
4209,4,0,0,36,0.0,0.0,1.0,36,1050,900,150,0.8571428571428571,12,9,3,381.78738258893975,0.3703042328042328,0.10878542613166386,0.24710049202253775,135045.282383787,3111.7169784580674,138156.9993622451,4061,39,1152.1666666666667,34,2,16,30.22801893635704,0.674938725490196,40.14880952380953,1039.404761904763,30.57072829131656,0
4210,4,0,0,36,0.0,0.0,1.0,36,500,400,100,0.8,6,4,2,385.39433057153934,0.37003968253968256,0.11040179650622806,0.24986256042177102,135107.15880102056,3213.906604308407,138321.06540532896,4062,40,1153.1666666666667,34,2,16,30.072474140234366,0.6755514705882353,40.08928571428572,1039.6428571428582,30.577731092437006,0
4211,4,0,0,36,0.0,0.0,1.0,36,1200,800,400,0.6666666666666666,16,8,8,384.78214412546873,0.36904761904761907,0.10584296669337334,0.25032327574268204,135230.9541524943,3206.8912981859394,138437.84545068024,4063,41,1154.1666666666667,34,2,16,29.96475716302316,0.6767769607843137,39.970238095238095,1040.1190476190473,30.59173669467786,0
4212,4,0,0,36,0.0,0.0,1.0,36,850,500,350,0.5882352941176471,12,5,7,385.56831116418203,0.3694940476190476,0.10253426922001019,0.25105036534669306,135261.91184807252,3230.5413832199524,138492.45323129246,4064,42,1155.1666666666667,34,2,16,29.913405050736248,0.6770833333333333,39.94047619047619,1040.238095238095,30.595238095238088,0
4213,4,0,0,36,0.0,0.0,1.0,36,800,500,300,0.625,11,5,6,384.866130104886,0.3689980158730159,0.10059115179252487,0.2510246251579631,135323.83786848083,3216.3123582766552,138540.15022675748,4065,43,1156.1666666666667,34,2,16,29.86985125858123,0.6776960784313726,39.88095238095239,1040.4761904761913,30.602240896358566,0
4214,4,0,0,36,0.0,0.0,1.0,36,1050,800,250,0.7619047619047619,13,8,5,383.0301306074,0.36797288359788355,0.09737470773609846,0.25068978009214876,135447.73242630393,3176.112528344679,138623.8449546486,4066,44,1157.1666666666667,34,2,16,29.794001601097897,0.678921568627451,39.761904761904766,1040.9523809523816,30.61624649859946,0
4215,4,0,0,36,0.0,0.0,1.0,36,400,0,400,0.0,8,0,8,383.0301306074,0.36797288359788355,0.09737470773609846,0.25068978009214876,135447.73242630393,3176.112528344679,138623.8449546486,4067,45,1158.1666666666667,34,2,16,29.794001601097897,0.678921568627451,39.761904761904766,1040.9523809523816,30.61624649859946,0
4216,4,0,0,36,0.0,0.0,1.0,36,800,400,400,0.5,12,4,8,382.5971318340845,0.3676587301587302,0.09790975953660341,0.2510560474233112,135540.69054705222,3171.495890022681,138712.1864370749,4068,46,1159.1666666666667,34,2,16,29.71256811859304,0.6798406862745099,39.67261904761905,1041.3095238095243,30.626750700280127,0
4217,4,0,0,36,0.0,0.0,1.0,36,1300,1000,300,0.7692307692307693,16,10,6,398.56584653378695,0.3676587301587302,0.1347553112061357,0.24732838922509837,133504.84206012142,3452.3265047142213,136957.16856483565,4069,47,1160.1666666666667,32,4,19,31.337558542048466,0.6643880208333334,41.63510101010101,1033.459595959596,32.29561237373738,3
4218,4,0,0,36,0.0,0.0,1.0,36,850,600,250,0.7058823529411765,11,6,5,394.6094932257555,0.36784060846560845,0.13624274005319426,0.24552146888544735,133602.72548719522,3344.180759616368,136946.9062468116,4070,48,1161.1666666666667,32,4,19,31.341343022309065,0.6653645833333334,41.54040404040404,1033.838383838384,32.3074494949495,0
4219,4,0,0,36,0.0,0.0,1.0,36,500,400,100,0.8,6,4,2,394.6094932257555,0.36759259259259264,0.13624274005319426,0.24552146888544735,133602.72548719522,3344.180759616368,136946.9062468116,4071,49,1162.1666666666667,32,4,19,31.341343022309065,0.6653645833333334,41.54040404040404,1033.838383838384,32.3074494949495,0
4220,4,1,0,37,0.02702702702702703,0.0,1.0,37,950,600,350,0.631578947368421,13,6,7,385.90301460032913,0.3716841841841842,0.14498000959539414,0.24298662245698802,134042.683403018,2945.4951220684247,136988.1785250864,4072,0,1131.7297297297298,33,4,17,31.124753451676522,0.6672979797979799,41.11519607843137,1035.539215686274,31.379976232917393,0
4221,4,0,0,37,0.0,0.0,1.0,37,1050,900,150,0.8571428571428571,12,9,3,387.109253705553,0.3719657157157157,0.14403234672107512,0.24466316884527406,134180.5006377549,2988.5026927437434,137169.00333049867,4073,1,1132.7297297297298,34,3,17,30.955321919644557,0.6663602941176471,40.98214285714285,1036.071428571427,30.472689075630207,0
4222,4,0,0,37,0.0,0.0,1.0,37,700,600,100,0.8571428571428571,8,6,2,390.1017219786428,0.37215340340340336,0.14634206915392345,0.24717799065109602,134273.02295918346,3076.0274943310433,137349.0504535145,4074,2,1133.7297297297298,34,3,18,30.785042882303397,0.667279411764706,40.89285714285713,1036.4285714285697,30.483193277310875,0
4223,4,0,0,37,0.0,0.0,1.0,37,950,600,350,0.631578947368421,13,6,7,391.51017145090367,0.3723098098098098,0.14225894666919148,0.24827961127625756,134303.87081916092,3116.266298185932,137420.13711734687,4075,3,1134.7297297297298,34,3,18,30.717621836836265,0.6675857843137255,40.863095238095234,1036.5476190476184,30.486694677871128,0
4224,4,0,0,37,0.0,0.0,1.0,37,800,600,200,0.75,10,6,4,393.414012688479,0.37271646646646645,0.1423961274707548,0.2501194197457406,134396.43565759613,3174.6882086167557,137571.12386621287,4076,4,1135.7297297297298,34,3,18,30.57548794489093,0.6685049019607844,40.77380952380951,1036.90476190476,30.497198879551767,0
4225,4,0,0,37,0.0,0.0,1.0,37,950,700,250,0.7368421052631579,12,7,5,393.9388881994607,0.37271646646646645,0.14166467626814216,0.25108921235419895,134489.03238378678,3196.0919784580374,137685.12436224482,4077,5,1136.7297297297298,34,3,18,30.469078771184797,0.6694240196078433,40.6845238095238,1037.2619047619041,30.507703081232474,0
4226,4,0,0,37,0.0,0.0,1.0,37,1000,600,400,0.6,14,6,8,397.2098569998983,0.3725913413413413,0.14479744891933355,0.2538245931485389,134582.56927924367,3291.518791953069,137874.08807119675,4078,6,1137.7297297297298,33,4,18,30.290515137199318,0.6726641414141414,40.594362745098046,1037.6225490196089,31.443107546048754,0
4227,4,0,0,37,0.0,0.0,1.0,37,1000,700,300,0.7,13,7,6,395.96371309538836,0.3720908408408408,0.140991714025422,0.2543148384107495,134767.01388888885,3272.56944444444,138039.58333333328,4079,7,1138.7297297297298,34,3,19,30.138108614232202,0.6721813725490196,40.416666666666664,1038.333333333333,30.539215686274503,0
4228,4,0,0,37,0.0,0.0,1.0,37,1400,1000,400,0.7142857142857143,18,10,8,396.7882037093293,0.37077702702702703,0.13917757298846145,0.25549646327408826,134859.7381660997,3302.150651927432,138161.88881802713,4080,8,1139.7297297297298,34,3,17,30.023877745940787,0.6731004901960784,40.32738095238095,1038.6904761904757,30.549719887955167,0
4229,4,0,0,37,0.0,0.0,1.0,37,700,400,300,0.5714285714285714,10,4,6,397.28991378198026,0.3706519019019019,0.13623455012248442,0.25625639893387586,134921.57206632648,3320.59594671201,138242.1680130385,4081,9,1140.7297297297298,34,3,17,29.948961078644814,0.6737132352941178,40.26785714285714,1038.9285714285709,30.556722689075613,0
4230,4,0,0,37,0.0,0.0,1.0,37,1150,1000,150,0.8695652173913043,13,10,3,399.7777100533404,0.37030780780780775,0.133896499616023,0.2580813500995232,134952.4943310657,3390.1998299319644,138342.69416099766,4082,10,1141.7297297297298,34,3,17,29.85339329361441,0.6740196078431373,40.238095238095234,1039.0476190476186,30.56022408963584,0
4231,4,0,0,37,0.0,0.0,1.0,37,1050,800,250,0.7619047619047619,13,8,5,398.4998837930206,0.36936936936936937,0.13251941667930667,0.25791715977738033,135045.28238378678,3363.105867346929,138408.3882511337,4083,11,1142.7297297297298,34,3,17,29.79374260298553,0.6749387254901962,40.14880952380952,1039.4047619047612,30.570728291316506,0
4232,4,0,0,37,0.0,0.0,1.0,37,1150,800,350,0.6956521739130435,15,8,7,395.0317424221653,0.3697447447447448,0.1306631261973068,0.25611077999797843,135107.15880102044,3274.32327097506,138381.4820719955,4084,12,1143.7297297297298,34,3,17,29.821987480438185,0.6755514705882353,40.089285714285715,1039.6428571428573,30.57773109243698,0
4233,4,1,0,38,0.02631578947368421,0.0,1.0,38,950,600,350,0.631578947368421,13,6,7,385.52274787594695,0.3728514698909436,0.12775183455637085,0.25235746684106725,135452.8959297838,2844.0345293209716,138296.93045910477,4085,0,1114.6052631578948,35,3,19,29.7239826551034,0.6767857142857143,39.756944444444436,1040.972222222221,29.74206349206346,0
4234,4,0,0,38,0.0,0.0,1.0,38,900,500,400,0.5555555555555556,13,5,8,386.5632214183654,0.37298482693219537,0.1366157140099329,0.2536768273596668,135543.2731722607,2879.2088638117084,138422.4820360724,4086,1,1115.6052631578948,35,3,19,29.6067439146382,0.6776785714285715,39.67013888888888,1041.3194444444434,29.751984126984098,0
4235,4,0,0,38,0.0,0.0,1.0,38,1150,900,250,0.782608695652174,14,9,5,389.4734255007396,0.3727477477477477,0.1431419002206762,0.2568998412515428,135726.702451814,2972.418887983423,138699.12133979742,4087,2,1116.6052631578948,34,4,19,29.34803305533339,0.6816789215686274,39.49404761904761,1042.023809523809,30.64775910364144,0
4236,4,0,0,38,0.0,0.0,1.0,38,900,700,200,0.7777777777777778,11,7,4,387.50482342356776,0.3721995021337126,0.14123247818037532,0.25626829561153736,135819.75623582746,2926.162131519246,138745.9183673467,4088,3,1117.6052631578948,34,4,19,29.306570732450133,0.6825980392156864,39.40476190476189,1042.3809523809507,30.65826330532208,0
4237,4,0,0,38,0.0,0.0,1.0,38,1300,700,600,0.5384615384615384,19,7,12,385.82751940339347,0.37258475580844,0.13736613742623316,0.25560343532034163,135881.80980725607,2885.3883219954496,138767.1981292515,4089,4,1118.6052631578948,34,4,18,29.28846007459846,0.6832107843137256,39.34523809523809,1042.6190476190463,30.66526610644254,0
4238,4,0,0,38,0.0,0.0,1.0,38,1050,700,350,0.6666666666666666,14,7,7,384.99649592157607,0.37258475580844,0.1186991527716812,0.2539468220649249,135726.70245181397,2853.443877551008,138580.14632936497,4090,5,1119.6052631578948,34,4,19,29.464659735709652,0.6816789215686274,39.49404761904761,1042.0238095238087,30.647759103641434,3
4239,4,0,0,38,0.0,0.0,1.0,38,1300,900,400,0.6923076923076923,17,9,8,380.3448799799886,0.3712808202939782,0.11883416155413085,0.25219082541595145,135912.84190759624,2738.750708616764,138651.59261621302,4091,6,1120.6052631578948,34,4,16,29.400473798378805,0.6835171568627452,39.31547619047618,1042.7380952380943,30.668767507002773,0
4240,4,0,0,38,0.0,0.0,1.0,38,950,700,250,0.7368421052631579,12,7,5,386.9591401361655,0.37028805120910385,0.12451656297292746,0.25769832098429746,136068.0555555555,2930.555555555551,138998.61111111107,4092,7,1121.6052631578948,34,4,17,29.073482428115007,0.6850490196078431,39.166666666666664,1043.333333333333,30.686274509803912,0
4241,4,0,0,38,0.0,0.0,1.0,38,750,600,150,0.8,9,6,3,387.9075358005019,0.37033250355618774,0.1251508003673225,0.25946309545649104,136223.35778061207,2968.4134070294554,139191.77118764154,4093,8,1122.6052631578948,34,4,18,28.89416315049227,0.6865808823529412,39.01785714285713,1043.92857142857,30.703781512604998,0
4242,4,0,0,38,0.0,0.0,1.0,38,1150,1000,150,0.8695652173913043,13,10,3,386.30988739555016,0.37030286865813183,0.12813458226572005,0.258848282837767,136285.50347222213,2929.687499999991,139215.19097222213,4094,9,1123.6052631578948,34,4,18,28.874035647778662,0.6871936274509804,38.95833333333333,1044.1666666666658,30.710784313725465,0
4243,4,0,0,38,0.0,0.0,1.0,38,800,500,300,0.625,11,5,6,386.267857653522,0.37005097202465626,0.13321674755679824,0.2592752804280294,136347.6633361676,2933.3439625850074,139281.0072987526,4095,10,1124.6052631578948,34,4,18,28.813309776207298,0.6878063725490197,38.89880952380951,1044.4047619047603,30.71778711484589,0
4244,4,0,1,37,0.0,0.02631578947368421,0.9736842105263158,38,1050,800,250,0.7619047619047619,13,8,5,387.66180819811564,0.369606448553817,0.13455922476808402,0.26112875599039587,136472.02558106562,2980.9984410430698,139453.0240221087,4096,11,1125.6052631578948,34,4,18,28.65325092096769,0.6890318627450981,38.7797619047619,1044.8809523809514,30.731792717086805,0
4245,4,0,0,37,0.0,0.0,1.0,37,1250,1000,250,0.8,15,10,5,395.23155595605584,0.36486486486486486,0.145416053952639,0.2666562269931366,136528.73894655914,3392.093185313358,139920.8321318725,4097,12,1156.3783783783783,33,4,20,28.399097091932468,0.6919191919191918,38.72549019607844,1045.0980392156873,31.669637551990526,0
4246,4,0,0,37,0.0,0.0,1.0,37,900,800,100,0.8888888888888888,10,8,2,395.1956004922972,0.3646771771771771,0.14808314351158058,0.2673603225852331,136624.8126471791,3398.704975249917,140023.517622429,4098,13,1157.3783783783783,33,4,20,28.304492439338883,0.6928661616161615,38.633578431372555,1045.4656862745107,31.680778371954872,0
4247,4,0,0,37,0.0,0.0,1.0,37,1000,900,100,0.9,11,9,2,396.11718515265534,0.3643330830830831,0.14552527210755062,0.2682279225176553,136656.8447231835,3426.424932718198,140083.26965590168,4099,14,1158.3783783783783,33,4,20,28.24855446163463,0.6931818181818181,38.602941176470594,1045.5882352941185,31.68449197860965,0
4248,4,0,0,37,0.0,0.0,1.0,37,750,600,150,0.8,9,6,3,396.11718515265534,0.3643330830830831,0.14552527210755062,0.2682279225176553,136656.8447231835,3426.424932718198,140083.26965590168,4100,15,1159.3783783783783,33,4,20,28.24855446163463,0.6931818181818181,38.602941176470594,1045.5882352941185,31.68449197860965,0
4249,4,0,0,37,0.0,0.0,1.0,37,1050,900,150,0.8571428571428571,12,9,3,395.3894654414905,0.36377002002002,0.1496806252506575,0.26974347975675034,136919.06637396695,3427.2863107323615,140346.35268469932,4101,16,1160.3783783783783,32,5,20,28.006997225238262,0.6982421875,38.35227272727273,1046.5909090909092,32.705965909090914,0
4250,4,0,0,37,0.0,0.0,1.0,37,600,400,200,0.6666666666666666,8,4,4,395.3894654414905,0.36377002002002,0.1496806252506575,0.26974347975675034,136919.06637396695,3427.2712924701545,140346.33766643712,4102,17,1161.3783783783783,32,5,20,28.006997225238262,0.6982421875,38.35227272727273,1046.5909090909092,32.705965909090914,0
4251,4,0,0,37,0.0,0.0,1.0,37,900,700,200,0.7777777777777778,11,7,4,394.56231511216595,0.36383258258258255,0.15197730903400397,0.2694334095782419,136952.1046959494,3407.227897663508,140359.33259361293,4103,18,1162.3783783783783,32,5,17,27.99582830719743,0.6985677083333334,38.32070707070707,1046.7171717171718,32.70991161616162,0
4252,4,0,0,37,0.0,0.0,1.0,37,1250,1000,250,0.8,15,10,5,390.0866955343634,0.3633008008008008,0.14633498331567374,0.2673047965790805,137073.60337670607,3294.117797241442,140367.7211739475,4104,19,1163.3783783783783,33,4,17,27.992368831675435,0.6972853535353536,38.2046568627451,1047.1813725490194,31.732768865121802,0
4253,4,0,0,37,0.0,0.0,1.0,37,1200,900,300,0.75,15,9,6,388.6423012620105,0.3620182682682683,0.1481919295040568,0.2677905171709469,137266.16753472216,3269.4878472222117,140535.65538194438,4105,20,1164.3783783783783,33,4,17,27.83921471172962,0.6991792929292929,38.02083333333333,1047.916666666666,31.755050505050487,0
4254,4,0,0,37,0.0,0.0,1.0,37,850,600,250,0.7058823529411765,11,6,5,389.6855948006627,0.3623936436436436,0.14556417970823965,0.2687573553818763,137298.27470203757,3300.6319684736523,140598.90667051123,4106,21,1165.3783783783783,33,4,17,27.780051449953227,0.6994949494949496,37.99019607843137,1048.0392156862738,31.758764111705265,0
4255,4,0,0,37,0.0,0.0,1.0,37,950,600,350,0.631578947368421,13,6,7,390.0149256546328,0.36151776776776773,0.14618030441333008,0.27023139423697895,137458.8668570981,3322.201947568226,140781.0688046663,4107,22,1166.3783783783783,33,4,17,27.612261890849588,0.7010732323232324,37.83700980392156,1048.6519607843127,31.777332144979173,0
4256,4,0,0,37,0.0,0.0,1.0,37,850,600,250,0.7058823529411765,11,6,5,386.60784156421636,0.3617992992992993,0.14393573384109692,0.26836792505661994,137523.13000108115,3233.5040909746053,140756.63409205576,4108,23,1167.3783783783783,33,4,17,27.637939595747156,0.7017045454545455,37.77573529411764,1048.8970588235281,31.78475935828873,0
4257,4,0,0,37,0.0,0.0,1.0,37,1100,800,300,0.7272727272727273,14,8,6,384.42751845762314,0.3612987987987988,0.14641507527852604,0.2673504456145987,137587.40816332653,3178.4771782487433,140765.88534157528,4109,24,1168.3783783783783,33,4,18,27.631482887513148,0.7023358585858587,37.71446078431372,1049.1421568627445,31.792186571598318,0
4258,4,0,0,37,0.0,0.0,1.0,37,800,700,100,0.875,9,7,2,381.5620431682236,0.3604542042042042,0.14433770529053125,0.26609913173393046,137683.8535659361,3106.9864955786134,140790.8400615147,4110,25,1169.3783783783783,33,4,19,27.611221391872963,0.7032828282828283,37.62254901960784,1049.509803921568,31.803327391562664,0
4259,4,0,0,37,0.0,0.0,1.0,37,1100,1000,100,0.9090909090909091,12,10,2,379.92129235744585,0.3602352352352352,0.14145174826939977,0.265449085671605,137748.16927383686,3066.69249807765,140814.8617719145,4111,26,1170.3783783783783,33,4,19,27.590668534516308,0.7039141414141414,37.561274509803916,1049.7549019607834,31.810754604872223,0
4260,4,0,0,37,0.0,0.0,1.0,37,950,700,250,0.7368421052631579,12,7,5,379.92129235744585,0.35985985985985985,0.14145174826939977,0.265449085671605,137748.16927383686,3066.69249807765,140814.8617719145,4112,27,1171.3783783783783,33,4,19,27.590668534516308,0.7039141414141414,37.561274509803916,1049.7549019607834,31.810754604872223,0
4261,4,0,0,37,0.0,0.0,1.0,37,850,700,150,0.8235294117647058,10,7,3,378.64902228893953,0.35832707707707706,0.14185484048977215,0.2657985888647421,137909.02424848612,3043.8234393021876,140952.8476877883,4113,28,1172.3783783783783,33,4,19,27.46507117022518,0.7054924242424243,37.408088235294116,1050.3676470588234,31.829322638146163,0
4262,4,0,0,37,0.0,0.0,1.0,37,700,300,400,0.42857142857142855,11,3,8,378.65329616572615,0.3583896396396396,0.1382810382110593,0.2665495370545924,138005.58228806223,3051.25372452902,141056.83601259126,4114,29,1173.3783783783783,33,4,19,27.36956690770546,0.706439393939394,37.31617647058823,1050.7352941176466,31.840463458110502,0
4263,4,0,0,37,0.0,0.0,1.0,37,1150,800,350,0.6956521739130435,15,8,7,376.84988644790224,0.3578578578578579,0.13959027808409963,0.26627828055602176,138134.3789047481,3011.1850009611576,141145.56390570925,4115,30,1174.3783783783783,33,4,17,27.28977228569207,0.7077020202020202,37.19362745098039,1051.2254901960778,31.85531788472963,0
4264,4,0,0,37,0.0,0.0,1.0,37,950,500,450,0.5263157894736842,14,5,9,376.3757563749877,0.35792042042042044,0.1356864499421908,0.26619353783520344,138166.58744533343,3000.510771097642,141167.09821643107,4116,31,1175.3783783783783,33,4,17,27.27044235924933,0.7080176767676768,37.162990196078425,1051.3480392156855,31.85903149138441,0
4265,4,0,0,37,0.0,0.0,1.0,37,950,600,350,0.631578947368421,13,6,7,379.29240179634905,0.35723223223223227,0.1415407483922979,0.26901548696002187,138263.23559448277,3088.4389417531556,141351.67453623592,4117,32,1176.3783783783783,33,4,17,27.09838421502369,0.7089646464646465,37.07107843137254,1051.715686274509,31.870172311348757,0
4266,4,0,0,37,0.0,0.0,1.0,37,1100,900,200,0.8181818181818182,13,9,4,375.8646388460785,0.35723223223223227,0.1468048195512246,0.2594649117070629,137330.3856239187,2923.5271590253774,140253.91278294407,4118,33,1177.3783783783783,33,4,18,28.110385244943302,0.6998106060606061,37.95955882352941,1048.1617647058824,31.762477718360074,1
4267,4,0,0,37,0.0,0.0,1.0,37,800,600,200,0.75,10,6,4,377.01944847148445,0.3573886386386386,0.13828133884234872,0.26098530753414406,137426.740916955,2962.5108131487877,140389.25173010377,4119,34,1178.3783783783783,33,4,19,27.984747545582046,0.7007575757575758,37.86764705882353,1048.5294117647056,31.773618538324413,0
4268,4,0,0,37,0.0,0.0,1.0,37,950,600,350,0.631578947368421,13,6,7,374.1128644000131,0.3565753253253254,0.13448162659196816,0.2592887665224009,137468.96435657592,2885.7816043083826,140354.7459608843,4120,35,1179.3783783783783,34,3,19,28.019166004465117,0.6988357843137255,37.82738095238095,1048.690476190476,30.843837535013996,0
4269,4,0,0,37,0.0,0.0,1.0,37,750,500,250,0.6666666666666666,10,5,5,372.0104462862731,0.3568255755755756,0.13151517010767888,0.25806393951039885,137500.17715419494,2830.300453514731,140330.47760770968,4121,36,1180.3783783783783,34,3,19,28.043416572077195,0.6991421568627452,37.797619047619044,1048.8095238095232,30.84733893557421,0
4270,4,0,0,37,0.0,0.0,1.0,37,650,500,150,0.7692307692307693,8,5,3,370.1990832944715,0.3568255755755756,0.15431000824259233,0.23776704009531532,134767.013888889,2585.299744897969,137352.31363378695,4122,37,1181.3783783783783,34,3,20,30.806915462814334,0.6721813725490196,40.41666666666667,1038.3333333333342,30.539215686274535,5
4271,4,0,0,37,0.0,0.0,1.0,37,950,800,150,0.8421052631578947,11,8,3,370.5897315918066,0.3565127627627627,0.15589394826245973,0.2390344854103248,134921.5720663265,2600.1098356008984,137521.6819019274,4123,38,1182.3783783783783,34,3,17,30.642450632137795,0.6737132352941178,40.26785714285714,1038.928571428571,30.55672268907562,0
4272,4,0,0,37,0.0,0.0,1.0,37,600,400,200,0.6666666666666666,8,4,4,372.99462575457756,0.35573073073073075,0.1592578946227705,0.240997045759564,134983.42013888893,2669.618055555561,137653.0381944445,4124,39,1183.3783783783783,34,3,17,30.518243785084213,0.6743259803921569,40.208333333333336,1039.166666666667,30.563725490196088,0
4273,4,0,0,37,0.0,0.0,1.0,37,650,500,150,0.7692307692307693,8,5,3,375.35949751044745,0.35566816816816815,0.15871993858478817,0.24294023519375213,135045.28238378686,2738.1058673469424,137783.38825113382,4125,40,1184.3783783783783,34,3,17,30.39504829534609,0.6749387254901961,40.148809523809526,1039.404761904762,30.570728291316527,0
4274,4,0,0,37,0.0,0.0,1.0,37,1250,900,350,0.72,16,9,7,375.7569187209137,0.35438563563563563,0.15558258361418797,0.2436143408455634,135107.15880102044,2753.4899376417256,137860.64873866216,4126,41,1185.3783783783783,34,3,17,30.32296080003054,0.6755514705882353,40.089285714285715,1039.6428571428573,30.57773109243698,0
4275,4,0,0,37,0.0,0.0,1.0,37,650,200,450,0.3076923076923077,11,2,9,377.2260142252859,0.3540728228228229,0.1571553234021752,0.24477652364365873,135138.10232426302,2795.5215419501155,137933.62386621314,4127,42,1186.3783783783783,34,3,17,30.253892832608205,0.6758578431372548,40.05952380952381,1039.7619047619046,30.581232492997195,0
4276,4,0,0,37,0.0,0.0,1.0,37,1100,800,300,0.7272727272727273,14,8,6,377.2260142252859,0.3540728228228229,0.1571553234021752,0.24477652364365873,135138.10232426302,2795.5215419501155,137933.62386621314,4128,43,1187.3783783783783,34,3,17,30.253892832608205,0.6758578431372548,40.05952380952381,1039.7619047619046,30.581232492997195,0
4277,4,0,0,37,0.0,0.0,1.0,37,800,400,400,0.5,12,4,8,378.5287228796845,0.3543230730730731,0.15120408870408886,0.24604366987179485,135200.0,2835.416666666667,138035.41666666666,4129,44,1188.3783783783783,34,3,18,30.158253205128215,0.6764705882352942,40.0,1040.0,30.58823529411765,0
4278,4,0,0,37,0.0,0.0,1.0,37,1000,800,200,0.8,12,8,4,374.4063847036885,0.3536036036036036,0.14661162441783193,0.244056489637524,135302.3341719178,2731.6115558556166,138033.94572777342,4130,45,1189.3783783783783,35,2,18,30.163370971928646,0.675297619047619,39.90162037037037,1040.3935185185182,29.725529100529094,0
4279,4,0,0,37,0.0,0.0,1.0,37,1300,1000,300,0.7692307692307693,16,10,6,368.5079612404978,0.3525713213213213,0.14021142178732027,0.2410920796730559,135433.87298255207,2581.692083140943,138015.56506569302,4131,46,1190.3783783783783,37,0,18,30.18572895817972,0.6725788288288289,39.7752192982456,1040.8991228070156,28.132408724513937,0
4280,4,0,0,37,0.0,0.0,1.0,37,1000,600,400,0.6,14,6,8,367.6290476127705,0.3517892892892893,0.1425314964327289,0.24128355668130447,135548.0307041587,2566.278686711265,138114.30939086998,4132,47,1191.3783783783783,37,0,18,30.094920325716885,0.673704954954955,39.66557017543858,1041.3377192982434,28.144262683736308,0
4281,4,0,0,37,0.0,0.0,1.0,37,900,600,300,0.6666666666666666,12,6,6,353.1635855991992,0.3518205705705706,0.08501529973922617,0.22566725195273146,134580.8031791195,2124.593629043389,136705.39680816288,4133,48,1192.3783783783783,35,2,22,31.43486242796059,0.6681547619047619,40.59606481481482,1037.6157407407409,29.646164021164026,8
4282,4,0,0,37,0.0,0.0,1.0,37,850,600,250,0.7058823529411765,11,6,5,353.022977862064,0.35213338338338335,0.0813794724801753,0.22594982458880283,134640.8570842978,2106.263261959873,136747.12034625767,4134,49,1193.3783783783783,35,2,23,31.37859652057545,0.66875,40.53819444444444,1037.847222222222,29.65277777777777,0
4283,4,0,0,37,0.0,0.0,1.0,37,750,600,150,0.8,9,6,3,353.10005005407305,0.3524461961961962,0.0802131301685276,0.22618580349178033,134670.8890603565,2110.459533607667,136781.34859396418,4135,50,1194.3783783783783,35,2,23,31.346639904846867,0.6690476190476191,40.50925925925925,1037.9629629629617,29.65608465608462,0
4284,4,0,0,37,0.0,0.0,1.0,37,500,300,200,0.6,7,3,4,353.10005005407305,0.3524461961961962,0.0802131301685276,0.22618580349178033,134670.8890603565,2110.459533607667,136781.34859396418,4136,51,1195.3783783783783,35,2,23,31.346639904846867,0.6690476190476191,40.50925925925925,1037.9629629629617,29.65608465608462,0
4285,4,0,0,37,0.0,0.0,1.0,37,550,400,150,0.7272727272727273,7,4,3,357.5019841786478,0.3516328828828829,0.08140641756335065,0.22976416920134846,134791.05045438942,2237.6135973936757,137028.6640517831,4137,52,1196.3783783783783,35,2,20,31.11253529499183,0.6702380952380953,40.39351851851851,1038.4259259259247,29.669312169312136,0
4286,4,0,0,37,0.0,0.0,1.0,37,700,400,300,0.5714285714285714,10,4,6,358.2078972075016,0.35160160160160164,0.08506512083113749,0.23079080240038213,134881.2066642017,2263.1026823988177,137144.3093466005,4138,53,1197.3783783783783,35,2,21,31.004294336118846,0.6711309523809523,40.306712962962955,1038.7731481481471,29.679232804232775,0
4287,4,0,0,37,0.0,0.0,1.0,37,1000,700,300,0.7,13,7,6,358.8301613592614,0.35197697697697694,0.08828788690673317,0.23176814307075155,134971.3930148318,2286.361346879267,137257.75436171106,4139,54,1198.3783783783783,35,2,21,30.898214153115017,0.6720238095238096,40.2199074074074,1039.120370370369,29.6891534391534,0
4288,4,0,0,37,0.0,0.0,1.0,37,450,300,150,0.6666666666666666,6,3,3,360.9757207935334,0.35260260260260257,0.08414159622265638,0.2337363337019985,135061.6095062798,2350.7923686128033,137412.40187489262,4140,55,1199.3783783783783,35,2,21,30.752537764911107,0.6729166666666668,40.13310185185184,1039.467592592591,29.69907407407403,0
4289,4,0,0,37,0.0,0.0,1.0,37,1000,700,300,0.7,13,7,6,357.496216565729,0.35279029029029024,0.07861751567928521,0.23225621878836358,135181.9450472605,2265.406780478358,137447.35182773886,4141,56,1200.3783783783783,35,2,22,30.723080133555925,0.674107142857143,40.01736111111109,1039.9305555555532,29.712301587301518,0
4290,4,0,0,37,0.0,0.0,1.0,37,900,800,100,0.8888888888888888,10,8,2,362.04136259185367,0.3532282282282282,0.0625831862012769,0.22944659603751238,134280.73459201385,2323.03602430555,136603.7706163194,4142,57,1201.3783783783783,35,2,20,31.50439698492462,0.6651785714285714,40.885416666666664,1036.458333333333,29.61309523809523,4
4291,4,0,0,37,0.0,0.0,1.0,37,900,400,500,0.4444444444444444,14,4,10,363.21767713495757,0.3534784784784785,0.07059973570355371,0.23075914551595383,134370.72000385798,2361.164158950609,136731.8841628086,4143,58,1202.3783783783783,35,2,22,31.38395847287341,0.6660714285714285,40.79861111111111,1036.805555555555,29.623015873015856,0
4292,4,0,0,37,0.0,0.0,1.0,37,1000,600,400,0.6,14,6,8,364.4393862932192,0.3540415415415415,0.0687587833314236,0.23229770838974606,134490.74743870032,2402.7450917352608,136893.4925304356,4144,59,1203.3783783783783,35,2,22,31.232332812616228,0.6672619047619047,40.682870370370374,1037.268518518519,29.636243386243397,0
4293,4,0,0,37,0.0,0.0,1.0,37,1200,1000,200,0.8333333333333334,14,10,4,364.4393862932192,0.3540415415415415,0.0687587833314236,0.23229770838974606,134490.74743870032,2402.7450917352608,136893.4925304356,4145,60,1204.3783783783783,35,2,22,31.232332812616228,0.6672619047619047,40.682870370370374,1037.268518518519,29.636243386243397,0
4294,4,0,0,37,0.0,0.0,1.0,37,850,500,350,0.5882352941176471,12,5,7,368.219867421493,0.3546046046046046,0.06729621187452528,0.23509422304603037,134550.78125000012,2508.8541666666806,137059.6354166668,4146,61,1205.3783783783783,35,2,22,31.074297188755022,0.6678571428571427,40.62500000000001,1037.500000000001,29.642857142857167,0
4295,4,0,0,37,0.0,0.0,1.0,37,1400,1100,300,0.7857142857142857,17,11,6,364.756491456948,0.35397897897897895,0.05913711877014638,0.23387327981651368,134705.2154195011,2426.9203514739183,137132.135770975,4147,62,1206.3783783783783,34,3,22,31.00989105504587,0.6715686274509804,40.476190476190474,1038.0952380952378,30.532212885154053,0
4296,4,0,0,37,0.0,0.0,1.0,37,650,500,150,0.7692307692307693,8,5,3,366.03355684410906,0.3539164164164164,0.06123770829653208,0.23489173283572284,134736.112882653,2463.587726757364,137199.70060941036,4148,63,1207.3783783783783,34,3,22,30.945896877269444,0.671875,40.44642857142857,1038.214285714285,30.535714285714267,0
4297,4,0,0,37,0.0,0.0,1.0,37,600,400,200,0.6666666666666666,8,4,4,367.22913974446084,0.35397897897897895,0.05105518172918466,0.23626157928692287,134828.8265306122,2502.61479591836,137331.44132653056,4149,64,1208.3783783783783,34,3,17,30.822300550206336,0.6727941176470589,40.357142857142854,1038.571428571428,30.546218487394942,0
4298,4,0,0,37,0.0,0.0,1.0,37,950,700,250,0.7368421052631579,12,7,5,365.7643974610524,0.3531969469469469,0.0471664514290846,0.2359220914000445,134921.57206632648,2469.901502267565,137391.47356859405,4150,65,1209.3783783783783,34,3,17,30.767780069516057,0.6737132352941178,40.26785714285714,1038.9285714285709,30.556722689075613,0
4299,4,0,0,37,0.0,0.0,1.0,37,800,400,400,0.5,12,4,8,363.62716926420035,0.3529466966966967,0.05049620285169909,0.23506179645955758,135001.46182966817,2418.039882330245,137419.50171199843,4151,66,1210.3783783783783,35,2,18,30.74361009021049,0.6723214285714285,40.19097222222222,1039.2361111111109,29.69246031746031,0
4300,4,0,0,37,0.0,0.0,1.0,37,900,700,200,0.7777777777777778,11,7,4,364.0717374683111,0.35213338338338335,0.055600518697479506,0.23613403737746091,135121.77057881074,2438.803556884415,137560.57413569515,4152,67,1211.3783783783783,35,2,19,30.612105272922918,0.6735119047619048,40.075231481481474,1039.699074074073,29.7056878306878,0
4301,4,0,0,37,0.0,0.0,1.0,37,600,500,100,0.8333333333333334,7,5,2,365.52295004751966,0.351758008008008,0.05241167711952355,0.23747098381612147,135181.94504726058,2482.4206693672604,137664.36571662786,4153,68,1212.3783783783783,35,2,19,30.51439899833055,0.6741071428571429,40.0173611111111,1039.9305555555538,29.71230158730154,0
4302,4,0,0,37,0.0,0.0,1.0,37,800,500,300,0.625,11,5,6,367.25711231889704,0.35213338338338335,0.052905247519690723,0.23899635542432482,135242.13291162963,2533.727039394704,137775.85995102432,4154,69,1213.3783783783783,35,2,20,30.409318089091656,0.674702380952381,39.95949074074073,1040.1620370370358,29.71891534391531,0
4303,4,0,0,37,0.0,0.0,1.0,37,1000,800,200,0.8,12,8,4,365.2221653793846,0.35197697697697694,0.053260202792913214,0.2378707842340512,135272.23186728384,2480.8834876543087,137753.11535493814,4155,70,1214.3783783783783,35,2,20,30.432242990654206,0.675,39.93055555555555,1040.277777777777,29.722222222222197,0
4304,4,1,1,37,0.02631578947368421,0.02631578947368421,0.9736842105263158,38,600,400,200,0.6666666666666666,8,4,4,358.061380146909,0.35739687055476527,0.048368921872153914,0.2351812246874016,135575.03449395343,2108.836792873955,137683.87128682737,4156,0,1183.3947368421052,36,2,20,30.3171406430219,0.6759259259259259,39.63963963963964,1041.4414414414416,28.928928928928933,0
4305,4,0,0,37,0.0,0.0,1.0,37,450,300,150,0.6666666666666666,6,3,3,365.97576651764814,0.3512887887887888,0.05229874002115986,0.23916090788711405,135392.66117969813,2510.0865912208396,137902.74777091897,4157,72,1216.3783783783783,35,2,20,30.292667556346377,0.6761904761904762,39.81481481481481,1040.74074074074,29.735449735449713,0
4306,4,0,0,37,0.0,0.0,1.0,37,800,500,300,0.625,11,5,6,367.4230530982812,0.35119494494494496,0.05005695120228637,0.2403080375645704,135422.77688025116,2551.490028077839,137974.266908329,4158,73,1217.3783783783783,35,2,20,30.225012973053108,0.6764880952380953,39.785879629629626,1040.856481481481,29.738756613756603,0
4307,4,0,0,37,0.0,0.0,1.0,37,900,600,300,0.6666666666666666,12,6,6,370.35075488608504,0.3506006006006006,0.04534340964658812,0.24324205054488995,135573.4056177126,2641.942622599448,138215.34824031204,4159,74,1218.3783783783783,35,2,20,29.998796028747137,0.6779761904761905,39.6412037037037,1041.435185185185,29.755291005291,0
4308,4,0,0,37,0.0,0.0,1.0,37,800,500,300,0.625,11,5,6,369.50083728067966,0.34953703703703703,0.05143463859060193,0.2435268308961502,135697.51567906578,2628.0959239027266,138325.6116029685,4160,75,1219.3783783783783,33,4,20,29.89737708774406,0.6837121212121212,39.52205882352941,1041.9117647058824,31.573083778966133,0
4309,4,0,0,37,0.0,0.0,1.0,37,500,400,100,0.8,6,4,2,368.7236110017179,0.3498185685685686,0.048168111667641345,0.2434491916116931,135761.36582083814,2611.6842079969247,138373.05002883507,4161,76,1220.3783783783783,33,4,22,29.854088272185642,0.6843434343434343,39.46078431372549,1042.156862745098,31.580510992275695,0
4310,4,0,0,37,0.0,0.0,1.0,37,1300,1000,300,0.7692307692307693,16,10,6,367.3014112018472,0.34944319319319317,0.04093863216950666,0.2433302389792571,135881.80980725624,2581.916099773243,138463.7259070295,4162,77,1221.3783783783783,34,3,19,29.771351906828045,0.6832107843137254,39.345238095238095,1042.6190476190475,30.665266106442573,0
4311,4,0,0,37,0.0,0.0,1.0,37,1100,900,200,0.8181818181818182,13,9,4,365.20937801661466,0.34909909909909914,0.045879003075670166,0.24257766192597124,135974.9167375283,2531.8629535147375,138506.77969104305,4163,78,1222.3783783783783,34,3,20,29.73333523570369,0.6841299019607843,39.25595238095238,1042.9761904761904,30.675770308123248,0
4312,4,0,0,37,0.0,0.0,1.0,37,650,500,150,0.7692307692307693,8,5,3,366.5445191846401,0.34944319319319317,0.051895345825058614,0.24410305213785605,136068.0555555555,2574.9999999999955,138643.0555555555,4164,79,1223.3783783783783,34,3,20,29.605963791267296,0.6850490196078431,39.166666666666664,1043.333333333333,30.686274509803912,0
4313,4,0,0,37,0.0,0.0,1.0,37,950,700,250,0.7368421052631579,12,7,5,364.4725948538814,0.3492242242242242,0.05322178930755572,0.2435743682682037,136192.29024943316,2527.671485260779,138719.96173469393,4165,80,1224.3783783783783,34,3,20,29.536619905717753,0.6862745098039216,39.04761904761905,1043.8095238095243,30.700280112044833,0
4314,4,0,0,37,0.0,0.0,1.0,37,1250,600,650,0.48,19,6,13,363.69855204651697,0.3483796296296296,0.05513254675265844,0.24369747899159672,136285.50347222228,2513.3680555555616,138798.87152777784,4166,81,1225.3783783783783,34,3,20,29.46428571428572,0.6871936274509804,38.958333333333336,1044.166666666667,30.710784313725497,0
4315,4,0,0,37,0.0,0.0,1.0,37,850,500,350,0.5882352941176471,12,5,7,367.4158488973302,0.3483483483483483,0.06033726033726028,0.24705548460337748,136409.8373724491,2623.8272392290423,139033.66461167816,4167,82,1226.3783783783783,34,3,21,29.24382716049383,0.6884191176470588,38.83928571428572,1044.6428571428582,30.72478991596642,0
4316,4,0,0,37,0.0,0.0,1.0,37,950,600,350,0.631578947368421,13,6,7,366.6269387252002,0.3477227227227227,0.06122174018485094,0.24679652318213155,136448.70334201393,2605.154079861117,139053.85742187506,4168,83,1227.3783783783783,35,2,22,29.225864074443336,0.6866071428571427,38.802083333333336,1044.791666666667,29.851190476190485,0
4317,4,0,0,37,0.0,0.0,1.0,37,650,500,150,0.7692307692307693,8,5,3,369.1710155194422,0.3475663163163163,0.06365075896585481,0.2489354069548201,136509.17252068315,2679.0459694358547,139188.218490119,4169,84,1228.3783783783783,35,2,22,29.09940654188356,0.6872023809523811,38.744212962962955,1045.023148148147,29.8578042328042,0
4318,4,0,0,37,0.0,0.0,1.0,37,1300,1000,300,0.7692307692307693,16,10,6,382.05069382245375,0.3473786286286286,0.04304232753124837,0.22939438654833158,132271.91014273348,2727.98009138371,134999.8902341172,4170,85,1229.3783783783783,33,4,19,33.005718370264475,0.6496212121212122,42.830882352941174,1028.6764705882347,31.172014260249536,8
4319,4,0,0,37,0.0,0.0,1.0,37,800,600,200,0.75,10,6,4,382.51696838971105,0.3466591591591592,0.03935525435178322,0.22988258976522152,132306.12953514743,2721.867913832207,135027.99744897964,4171,86,1230.3783783783783,34,3,19,32.959191545167016,0.647671568627451,42.79761904761905,1028.809523809524,30.25910364145659,0
4320,4,1,1,37,0.02631578947368421,0.02631578947368421,0.9736842105263158,38,1250,1000,250,0.8,15,10,5,374.3807668541385,0.3535887861545756,0.026102878555612108,0.22683069991750754,132612.5,2329.5457766439913,134942.045776644,4172,0,1198.9736842105262,34,4,19,32.85969525350592,0.650735294117647,42.5,1030.0,30.294117647058822,0
4321,4,0,0,37,0.0,0.0,1.0,37,650,300,350,0.46153846153846156,10,3,7,384.5600516443384,0.3453453453453454,0.029619717313123184,0.23245133481408156,132524.15687475976,2792.6993223760096,135316.85619713578,4173,88,1232.3783783783783,33,4,19,32.68666190589541,0.6521464646464646,42.58578431372549,1029.6568627450984,31.20172311348783,0
4322,4,0,0,37,0.0,0.0,1.0,37,700,600,100,0.8571428571428571,8,6,2,386.0687358822127,0.34496996996997,0.030641779332878816,0.23375516256153572,132587.2561034218,2837.5588715878494,135424.81497500965,4174,89,1233.3783783783783,33,4,19,32.58418610185624,0.6527777777777778,42.52450980392157,1029.9019607843138,31.20915032679739,0
4323,4,0,0,37,0.0,0.0,1.0,37,800,600,200,0.75,10,6,4,387.0795341596911,0.3460960960960961,0.030208567663978725,0.23555274112033264,132776.64389898092,2879.024293540923,135655.66819252184,4175,90,1234.3783783783783,33,4,19,32.36722156163298,0.6546717171717172,42.34068627450979,1030.6372549019588,31.231431966726024,0
4324,4,0,0,37,0.0,0.0,1.0,37,850,600,250,0.7058823529411765,11,6,5,390.5533891198053,0.3458458458458458,0.02900915892714262,0.238268721005433,132871.38848339574,2978.6742178488935,135850.06270124463,4176,91,1235.3783783783783,33,4,19,32.18221304330599,0.6556186868686871,42.248774509803916,1031.0049019607839,31.24257278669042,0
4325,4,0,0,37,0.0,0.0,1.0,37,850,600,250,0.7058823529411765,11,6,5,388.899091929395,0.345970970970971,0.02893802893802877,0.23766055617907467,132934.5703124999,2939.626736111097,135874.197048611,4177,92,1236.3783783783783,33,4,19,32.161195286195266,0.65625,42.18749999999999,1031.2499999999993,31.24999999999998,0
4326,4,0,0,37,0.0,0.0,1.0,37,1000,600,400,0.6,14,6,8,381.96861313416855,0.345970970970971,0.04213762088791362,0.21279685579169533,129383.00028344683,2485.1341057256386,131868.13438917248,4178,93,1237.3783783783783,34,3,21,35.93957211951011,0.6182598039215685,45.65476190476191,1017.3809523809534,29.9229691876751,5
4327,4,0,1,36,0.0,0.02702702702702703,0.972972972972973,37,1250,900,350,0.72,16,9,7,384.6858862555995,0.34628378378378377,0.05146198830409321,0.2149715246722471,129504.14540816352,2563.6833900227016,132067.8287981862,4179,94,1238.3783783783783,34,3,20,35.74683235867446,0.619485294117647,45.5357142857143,1017.8571428571449,29.93697478991603,0
4328,4,0,0,36,0.0,0.0,1.0,36,950,800,150,0.8421052631578947,11,8,3,382.88764896697455,0.3462962962962963,0.060692853246044676,0.21462784726497408,129625.34722222241,2726.388888888913,132351.73611111133,4180,95,1263.9444444444443,34,2,20,35.668985270049106,0.6207107843137254,45.41666666666668,1018.3333333333348,29.950980392156907,0
4329,4,2,1,37,0.05263157894736842,0.02631578947368421,0.9736842105263158,38,1000,600,400,0.6,14,6,8,367.576837818083,0.3591601469890944,0.062476397418095075,0.20850836404471004,130090.20580969503,1963.6292965262794,132053.83510622132,4181,0,1198.3684210526317,36,2,21,35.58592743864298,0.6212384259259258,44.9605855855856,1020.1576576576593,28.337712712712758,0
4330,4,0,0,37,0.0,0.0,1.0,37,1000,600,400,0.6,14,6,8,375.4929670812622,0.3543230730730731,0.06795541996903309,0.21313396682687244,130114.93866008674,2371.448875814491,132486.38753590125,4182,1,1231.7567567567567,35,2,21,35.358881641142,0.6235119047619047,44.9363425925926,1020.2546296296309,29.15013227513231,0
4331,4,0,0,37,0.0,0.0,1.0,37,1300,900,400,0.6923076923076923,17,9,8,372.6780508121613,0.35410410410410414,0.061996690568119295,0.21233981964878984,130262.58680555574,2309.201388888912,132571.78819444464,4183,2,1232.7567567567567,35,2,21,35.280612244897966,0.6249999999999998,44.79166666666668,1020.8333333333348,29.16666666666671,0
4332,4,2,1,38,0.05128205128205128,0.02564102564102564,0.9743589743589743,39,650,500,150,0.7692307692307693,8,5,3,355.49933213490283,0.36648110661268557,0.061672604125434516,0.20520406993529544,130766.77439212067,1497.5001923668844,132264.27458448755,4184,0,1170.4871794871794,37,2,20,35.20806532304173,0.6261261261261261,44.29824561403509,1022.8070175438598,27.643432906590807,0
4333,4,0,0,38,0.0,0.0,1.0,38,1150,900,250,0.782608695652174,14,9,5,363.8958315681809,0.35781175912754865,0.06893803719738689,0.20981193945845417,130722.82745160707,1913.898400089281,132636.72585169633,4185,1,1202.2894736842106,36,2,20,35.037899643945224,0.6276041666666666,44.34121621621622,1022.6351351351356,28.40653153153154,0
4334,4,0,0,38,0.0,0.0,1.0,38,1050,800,250,0.7619047619047619,13,8,5,363.0509297149494,0.3579154812707444,0.06804329184917335,0.2097935525146694,130809.21292914552,1898.0812738414254,132707.29420298696,4186,2,1203.2894736842106,36,2,21,34.97197453397916,0.6284722222222221,44.256756756756765,1022.9729729729743,28.415915915915953,0
4335,4,0,0,38,0.0,0.0,1.0,38,900,600,300,0.6666666666666666,12,6,6,364.44531058116183,0.3579302987197724,0.07872148181612859,0.2110716722275983,130895.62694028488,1940.8594827936063,132836.4864230785,4187,3,1204.2894736842106,36,2,21,34.848776640622155,0.6293402777777778,44.1722972972973,1023.3108108108108,28.4253003003003,0
4336,4,1,1,38,0.02564102564102564,0.02564102564102564,0.9743589743589743,39,950,800,150,0.8421052631578947,11,8,3,356.59310334436356,0.36445681511470984,0.08743774211400157,0.20841465290528896,131246.00643080217,1560.2841469428133,132806.29057774498,4188,0,1174.3846153846155,38,1,22,34.69528724846211,0.629111842105263,43.83012820512821,1024.6794871794878,26.9652496626181,0
4337,4,0,0,38,0.0,0.0,1.0,38,1100,900,200,0.8181818181818182,13,9,4,356.32669623580375,0.3636794689426268,0.09611738044584239,0.20902050531770341,131385.8453047642,1763.3082021530602,133149.15350691727,4189,1,1198.6052631578948,36,2,23,34.5608157586409,0.6342592592592593,43.693693693693696,1025.2252252252251,28.478478478478475,0
4338,4,0,0,38,0.0,0.0,1.0,38,1300,900,400,0.6923076923076923,17,9,8,355.8205869505766,0.36307195353247984,0.09394396394064386,0.2091759867849619,131468.65051025312,1755.8504780316975,133224.50098828482,4190,2,1199.6052631578948,37,1,23,34.49015912897823,0.6331644144144144,43.612938596491226,1025.5482456140348,27.71752015173067,0
4339,4,1,1,38,0.02564102564102564,0.02564102564102564,0.9743589743589743,39,750,400,350,0.5333333333333333,11,4,7,347.3611447163448,0.3695456590193433,0.08948739298447927,0.20550775113513775,131711.6845642486,1350.3043045510963,133061.9888687997,4191,0,1169.820512820513,38,1,17,34.46195011101861,0.6337719298245614,43.376068376068375,1026.4957264957259,27.01304543409805,0
4340,4,0,0,38,0.0,0.0,1.0,38,450,200,250,0.4444444444444444,7,2,5,375.46252812857807,0.36313122332859177,0.10544763488782039,0.20217386101207505,128030.5363429308,2017.7007312932951,130048.2370742241,4192,4,1201.6052631578948,36,2,19,37.48794555098105,0.6004050925925926,46.987612612612615,1012.0495495495499,28.112487487487495,7
4341,4,1,0,39,0.02564102564102564,0.0,1.0,39,650,500,150,0.7692307692307693,8,5,3,364.8337857198662,0.3679430949167792,0.10349298070155943,0.1981375520635533,128372.67324334485,1566.988398871863,129939.66164221671,4193,0,1171.7692307692307,36,3,15,37.40670259658481,0.6038773148148147,46.649774774774784,1013.4009009009021,28.15002502502506,0
4342,4,1,1,39,0.025,0.025,0.975,40,800,500,300,0.625,11,5,6,359.5233713146216,0.3738782051282051,0.09999189276834941,0.19645308375850956,128616.79945993012,1248.1490699061458,129864.94852983626,4194,0,1143.45,37,3,15,37.29180178719418,0.6044481981981981,46.408991228070185,1014.3640350877205,27.415244191560014,0
4343,4,0,0,39,0.0,0.0,1.0,39,800,500,300,0.625,11,5,6,366.63116086103014,0.36819613135402607,0.09971098677372936,0.19997053928247024,128543.91289515898,1625.640801274279,130169.55369643326,4195,2,1173.7692307692307,36,3,15,37.18605404404959,0.6056134259259258,46.48085585585587,1014.0765765765791,28.168793793793864,0
4344,4,1,1,39,0.025,0.025,0.975,40,700,600,100,0.8571428571428571,8,6,2,361.14178464477834,0.3729967948717949,0.10110949141561387,0.19872454352913207,128895.0100631926,1309.8747932056126,130204.88485639822,4196,0,1145.4,37,3,16,36.96673775330239,0.6072635135135135,46.13486842105264,1015.4605263157902,27.44487908961595,0
4345,4,0,0,39,0.0,0.0,1.0,39,950,700,250,0.7368421052631579,12,7,5,369.52872018375945,0.3687303193882141,0.1026778856821009,0.20285821460026854,128800.98637488855,1719.132730703692,130520.11910559225,4197,1,1175.5641025641025,36,3,16,36.84985393092226,0.6082175925925926,46.227477477477485,1015.0900900900914,28.196946946946984,0
4346,4,0,0,39,0.0,0.0,1.0,39,1000,700,300,0.7,13,7,6,372.4915315067279,0.36979869545659017,0.10416169196657021,0.20537124781116675,128972.5113627142,1808.2336559532662,130780.74501866747,4198,2,1176.5641025641025,36,3,18,36.599454915003705,0.6099537037037037,46.058558558558566,1015.7657657657668,28.215715715715746,0
4347,4,2,0,41,0.04878048780487805,0.0,1.0,41,1000,700,300,0.7,13,7,6,355.3950262258971,0.38109756097560976,0.12300580154977747,0.1992459530167878,129631.0811444891,1014.4541078240425,130645.53525231314,4199,0,1120.121951219512,36,5,16,36.36307088355634,0.6166087962962963,45.41103603603604,1018.3558558558559,28.287662662662665,0
4348,4,1,2,40,0.023809523809523808,0.047619047619047616,0.9523809523809523,42,1150,700,450,0.6086956521739131,16,7,9,347.00019476304675,0.38395276809910955,0.12239980844631981,0.19646879354733351,130017.309746877,623.2063609467357,130640.51610782373,4200,0,1094.4285714285713,38,4,16,36.184658495705,0.6167763157894738,45.03205128205128,1019.8717948717944,26.83873144399459,0
4349,4,0,0,40,0.0,0.0,1.0,40,900,500,400,0.5555555555555556,13,5,8,356.7804635612966,0.38126335470085465,0.1232543365373997,0.20119750627372543,129860.54202428772,1266.340876349314,131126.88290063702,4201,2,1133.25,36,4,17,36.094538356719326,0.6189236111111112,45.18581081081081,1019.2567567567561,28.31268768768767,0
4350,4,0,0,40,0.0,0.0,1.0,40,1250,1000,250,0.8,15,10,5,360.2967671210011,0.3811965811965812,0.11677522631927562,0.2042282926521919,130061.4867401185,1372.1466398831271,131433.63338000164,4202,3,1134.25,36,4,17,35.800765437550595,0.6209490740740742,44.98873873873874,1020.0450450450451,28.334584584584587,0
4351,4,0,0,40,0.0,0.0,1.0,40,1250,800,450,0.64,17,8,9,363.53881144716297,0.3812900641025641,0.11858946802794179,0.20638978892714163,130122.70752779701,1460.9308873884265,131583.63841518544,4203,4,1135.25,37,3,17,35.655897367007,0.6196509009009008,44.92872807017544,1020.2850877192983,27.575272641062117,0
4352,4,1,1,40,0.024390243902439025,0.024390243902439025,0.975609756097561,41,550,300,250,0.5454545454545454,8,3,5,355.6081509047086,0.3865599593495935,0.11492043816579911,0.20324865600343064,130384.14292800444,1073.433368037882,131457.57629604233,4204,0,1108.5365853658536,34,7,17,35.59296926603722,0.6283700980392157,44.672619047619044,1021.3095238095231,30.038515406162443,0
4353,4,1,0,41,0.024390243902439025,0.0,1.0,41,1050,800,250,0.7619047619047619,13,8,5,364.1774943894899,0.3844004065040651,0.1502942507922138,0.21004388645075278,130735.62349965703,1322.1943587105604,132057.81785836758,4205,0,1109.5121951219512,35,6,15,35.01773049645391,0.6297619047619047,44.3287037037037,1022.6851851851849,29.21957671957671,0
4354,4,0,0,41,0.0,0.0,1.0,41,1300,1100,200,0.8461538461538461,15,11,4,365.0362374117842,0.38478150406504064,0.1548660481514894,0.21134809266257923,130883.62328800155,1355.4530767746933,132239.07636477624,4206,1,1110.5121951219512,35,6,15,34.845817780794036,0.6312499999999999,44.18402777777778,1023.2638888888889,29.23611111111111,0
4355,4,2,1,42,0.046511627906976744,0.023255813953488372,0.9767441860465116,43,900,500,400,0.5555555555555556,13,5,8,348.0071386079714,0.3922572905131045,0.15182454150122893,0.20383275261324046,131328.12500000012,540.6250000000143,131868.75000000012,4207,0,1059.8139534883721,37,6,17,34.832317073170735,0.6317567567567567,43.75000000000001,1025.000000000001,27.702702702702727,0
4356,4,0,0,42,0.0,0.0,1.0,42,1150,900,250,0.782608695652174,14,9,5,353.1996135732399,0.3877758420441347,0.1487598116169544,0.2065627560100568,131270.41737683638,872.9321382193102,132143.34951505568,4208,1,1085.857142857143,36,6,18,34.75755494505495,0.6331018518518519,43.80630630630631,1024.7747747747753,28.46596596596598,0
4357,4,1,0,43,0.023255813953488372,0.0,1.0,43,1000,700,300,0.7,13,7,6,347.2851456964006,0.3911729420450351,0.15802825816199428,0.20495221810787584,131616.85333982637,541.7282992451993,132158.58163907158,4209,0,1061.5813953488373,36,7,14,34.559509438103596,0.6365740740740741,43.46846846846847,1026.1261261261266,28.503503503503516,0
4358,4,0,0,43,0.0,0.0,1.0,43,1550,1300,250,0.8387096774193549,18,13,5,345.6070173018151,0.3902039497969731,0.15936626975750823,0.20497844946367952,131806.21831957917,510.6307950523295,132316.8491146315,4210,1,1062.5813953488373,37,6,15,34.41170581954084,0.6365427927927928,43.28399122807018,1026.86403508772,27.753082029397834,0
4359,4,1,3,41,0.022727272727272728,0.06818181818181818,0.9318181818181819,44,1250,1000,250,0.8,15,10,5,335.8238440703575,0.39202343199436224,0.15491014909015322,0.20070167873571312,132095.8034279349,72.18409854628763,132167.98752648119,4211,0,1039.409090909091,38,6,15,34.371535716760214,0.6376096491228069,43.00213675213676,1027.9914529914536,27.05240665766983,0
4360,4,0,1,40,0.0,0.024390243902439025,0.975609756097561,41,900,500,400,0.5555555555555556,13,5,8,360.49125844865995,0.38292682926829263,0.1594251539176792,0.21279064563287756,131624.87809713656,1289.92358967765,132914.8016868142,4212,3,1116.2682926829268,35,6,15,34.21262876908038,0.6386904761904761,43.46064814814815,1026.157407407408,29.318783068783087,0
4361,4,4,1,43,0.09090909090909091,0.022727272727272728,0.9772727272727273,44,850,400,450,0.47058823529411764,13,4,9,334.3590368087585,0.3977162614517266,0.1597417419683449,0.20216765349829433,132535.4812714587,65.15108250438661,132600.6323539631,4213,0,1028.5,38,6,18,33.967541675313,0.6419956140350878,42.57478632478632,1029.7008547008536,27.09739091318036,0
4362,4,2,0,45,0.044444444444444446,0.0,1.0,45,1100,1000,100,0.9090909090909091,12,10,2,355.03595153044654,0.39999999999999997,0.2259912784134801,0.20840810940120547,131412.43128895416,361.6408508192337,131774.0721397734,4214,0,1006.6,37,8,18,34.56704719637829,0.6326013513513513,43.66776315789473,1025.3289473684201,27.711593172119464,3
4363,4,3,4,44,0.0625,0.08333333333333333,0.9166666666666666,48,1550,1100,450,0.7096774193548387,20,11,9,330.3747208655418,0.4085124852245863,0.21499077186737825,0.1972497005214931,132058.30379569053,-874.2549491043537,131184.04884658617,4215,0,944.625,40,8,17,34.54926339727112,0.6338541666666666,43.03861788617887,1027.8455284552856,25.69613821138214,0
4364,4,0,0,44,0.0,0.0,1.0,44,850,600,250,0.7058823529411765,11,6,5,353.13595765246293,0.3968243481324876,0.21884145128753985,0.2075782031540718,131465.04635336768,485.0070083643879,131950.05336173208,4216,2,1031.4545454545455,38,6,17,34.56262805153317,0.6313048245614035,43.616452991452995,1025.5341880341882,26.987741790373374,0
4365,4,0,0,44,0.0,0.0,1.0,44,1050,600,450,0.5714285714285714,15,6,9,356.15139403581793,0.39629580690627203,0.219412967538553,0.20995223062774457,131574.63480029584,572.097920775795,132146.73272107163,4217,3,1032.4545454545455,38,6,17,34.37467458086013,0.6324013157894737,43.50961538461538,1025.961538461538,26.998987854251002,0
4366,4,0,1,43,0.0,0.022727272727272728,0.9772727272727273,44,1250,900,350,0.72,16,9,7,356.94568457724034,0.39632884073291047,0.21489991008470977,0.21072300555404994,131629.44614517127,596.9125529622288,132226.3586981335,4218,4,1033.4545454545455,38,6,17,34.29897622765921,0.6329495614035088,43.45619658119658,1026.1752136752134,27.004610886189827,0
4367,4,0,0,43,0.0,0.0,1.0,43,1100,800,300,0.7272727272727273,14,8,6,360.4010106589802,0.39354928017718716,0.21914232237141773,0.21301926562825063,131675.35942925367,891.1865234375176,132566.5459526912,4219,5,1057.6976744186047,39,4,17,34.163981359315265,0.6316773504273504,43.41145833333334,1026.3541666666683,26.31677350427355,0
4368,4,0,0,43,0.0,0.0,1.0,43,1150,800,350,0.6956521739130435,15,8,7,363.1251054140662,0.39401070505721664,0.22244035034732668,0.21508179320679333,131755.5555555557,968.7500000000198,132724.30555555574,4220,6,1058.6976744186047,39,4,17,34.01312229437231,0.6324786324786325,43.33333333333334,1026.666666666668,26.324786324786363,0
4369,4,0,1,42,0.0,0.023255813953488372,0.9767441860465116,43,800,500,300,0.625,11,5,6,362.6840678217148,0.3940337763012181,0.22199160337751778,0.21542559691097066,131862.52170138908,964.8871527778034,132827.4088541669,4221,7,1059.6976744186047,39,4,17,33.916497633536196,0.6335470085470085,43.22916666666668,1027.0833333333348,26.335470085470124,0
4370,4,1,1,42,0.023255813953488372,0.023255813953488372,0.9767441860465116,43,800,600,200,0.75,10,6,4,362.93047884915654,0.39472591362126247,0.21987529320241816,0.21633288059498096,131996.290418837,981.0953776041872,132977.38579644117,4222,0,1060.0232558139535,39,4,17,33.77523652644029,0.6348824786324785,43.09895833333334,1027.6041666666683,26.34882478632483,0
4371,4,0,0,42,0.0,0.0,1.0,42,1100,600,500,0.5454545454545454,16,6,10,370.7172391549301,0.3905826558265582,0.22495246018540493,0.22059510963575574,131931.1125721384,1381.8275622763013,133312.9401344147,4223,9,1086.2619047619048,38,4,17,33.64098031059347,0.6359649122807016,43.16239316239317,1027.3504273504288,27.035537561853392,0
4372,4,0,0,42,0.0,0.0,1.0,42,1150,700,450,0.6086956521739131,16,7,9,369.26064738529436,0.39049796747967475,0.22368479665018492,0.22052493410887153,132068.34781804745,1353.528722879698,133421.87654092716,4224,10,1087.2619047619048,38,4,17,33.539912690988466,0.6373355263157894,43.02884615384616,1027.8846153846164,27.049595141700433,0
4373,4,0,0,42,0.0,0.0,1.0,42,1400,1000,400,0.7142857142857143,18,10,8,367.34034249210447,0.3907883275261324,0.2181876177618205,0.220656279342263,132288.07259706705,1318.949179085405,133607.02177615245,4225,11,1088.2619047619048,38,4,17,33.36773462110985,0.6395285087719298,42.815170940170944,1028.7393162393168,27.072087269455707,0
4374,4,0,0,42,0.0,0.0,1.0,42,1100,900,200,0.8181818181818182,13,9,4,370.17904046302243,0.3909456058846303,0.21563493848180193,0.22336311980177215,132457.56842635456,1406.7400877174273,133864.30851407198,4226,12,1089.2619047619048,35,7,17,33.12392249456563,0.6470238095238094,42.65046296296296,1029.3981481481478,29.41137566137565,0
4375,4,0,0,42,0.0,0.0,1.0,42,750,300,450,0.4,12,3,9,372.4236090002292,0.3908367208672087,0.21284060437707764,0.22525172326818732,132546.94097490123,1472.7220239626004,134019.66299886382,4227,13,1090.2619047619048,35,7,17,32.97612022779214,0.6479166666666667,42.5636574074074,1029.7453703703688,29.42129629629625,0
4376,4,0,0,42,0.0,0.0,1.0,42,1400,1000,400,0.7142857142857143,18,10,8,376.26224158360776,0.3905705574912892,0.22054504309307177,0.2282965379915264,132666.1512586805,1583.4526909722176,134249.60394965272,4228,14,1091.2619047619048,35,7,17,32.75720424671385,0.6491071428571429,42.447916666666664,1030.208333333333,29.4345238095238,0
4377,4,0,0,42,0.0,0.0,1.0,42,800,500,300,0.625,11,5,6,372.75263980524926,0.3904374758033295,0.21755798659010028,0.2270680581467542,132815.23946544906,1501.4462234224818,134316.68568887154,4229,15,1092.2619047619048,35,7,17,32.69752601242608,0.6505952380952382,42.30324074074073,1030.7870370370358,29.451058201058167,0
4378,4,0,0,42,0.0,0.0,1.0,42,1450,1100,350,0.7586206896551724,18,11,7,368.7378838893992,0.3908125241966705,0.2129389129389132,0.22533981793241048,132934.57031249988,1403.6024305555409,134338.17274305542,4230,16,1093.2619047619048,35,7,17,32.680976430976436,0.6517857142857144,42.18749999999999,1031.249999999999,29.464285714285687,0
4379,4,1,0,43,0.023255813953488372,0.0,1.0,43,950,400,550,0.42105263157894735,15,4,11,368.0735407787302,0.392672572905131,0.23094537127903147,0.22731329579001597,133326.80389426596,1214.8137580147777,134541.61765228075,4231,0,1068.8139534883721,36,7,18,32.30404717769781,0.6536458333333334,41.807432432432435,1032.7702702702709,28.68806306306308,0
4380,4,0,0,43,0.0,0.0,1.0,43,1050,600,450,0.5714285714285714,15,6,9,367.40451268214275,0.39271871539313397,0.22377193382714533,0.22743380562388518,133414.04537983937,1203.3844655466332,134617.429845386,4232,1,1069.8139534883721,36,7,18,32.233758447787224,0.6545138888888888,41.722972972972975,1033.1081081081086,28.69744744744746,0
4381,4,0,0,43,0.0,0.0,1.0,43,800,400,400,0.5,12,4,8,370.3824141519249,0.3921419342930971,0.2289947486871713,0.22963709677419347,133472.2222222222,1287.152777777774,134759.37499999997,4233,2,1070.8139534883721,36,7,18,32.09845430107525,0.6550925925925927,41.666666666666664,1033.3333333333333,28.703703703703702,0
4382,4,0,0,43,0.0,0.0,1.0,43,1300,1200,100,0.9230769230769231,14,12,2,366.80004366791496,0.3920035068290882,0.22424887267568505,0.22813173447638618,133588.61395178965,1200.0618862105398,134788.6758380002,4234,3,1071.8139534883721,36,7,18,32.0742556281772,0.65625,41.554054054054056,1033.783783783784,28.71621621621622,0
4383,4,1,1,43,0.022727272727272728,0.022727272727272728,0.9772727272727273,44,1500,1000,500,0.6666666666666666,20,10,10,359.7691037058321,0.3924638830162086,0.22410439137134097,0.2258125225387665,133925.8233302552,836.4746845182833,134762.2980147735,4235,0,1048.4318181818182,37,7,17,31.91825564971751,0.6576576576576578,41.22807017543858,1035.0877192982434,27.97534376481739,0
4384,4,0,0,43,0.0,0.0,1.0,43,1400,900,500,0.6428571428571429,19,9,10,370.17430451539036,0.3905730897009967,0.2265840760832425,0.23150383496139473,133792.42153893743,1305.3033185212078,135097.72485745864,4236,5,1073.8139534883721,36,7,17,31.782682050723864,0.658275462962963,41.356981981981974,1034.5720720720708,28.738113113113076,0
4385,4,0,0,43,0.0,0.0,1.0,43,750,500,250,0.6666666666666666,10,5,5,386.14423456055465,0.3905730897009967,0.25768460894566414,0.22472328404753542,131081.8463387571,1555.0038451512914,132636.8501839084,4237,6,1074.8139534883721,38,5,17,34.10472091810119,0.627467105263158,43.9903846153846,1024.0384615384592,26.948380566801557,6
4386,4,1,1,43,0.022727272727272728,0.022727272727272728,0.9772727272727273,44,1050,900,150,0.8571428571428571,12,9,3,376.2929720696569,0.3957672656800564,0.24651463553473896,0.2205663183998764,131356.98356718177,1086.4353668797198,132443.41893406148,4238,0,1051.3636363636363,36,8,17,34.07828005419458,0.6339699074074077,43.72184684684683,1025.1126126126103,28.475350350350286,0
4387,4,0,0,43,0.0,0.0,1.0,43,1250,700,550,0.56,18,7,11,381.1026401419566,0.39082687338501293,0.2537499489107775,0.22355402292863222,131385.84530476414,1414.2985045856567,132800.1438093498,4239,8,1076.8139534883721,36,7,17,33.92579269185705,0.6342592592592593,43.69369369369369,1025.2252252252247,28.478478478478465,0
4388,4,0,0,43,0.0,0.0,1.0,43,700,400,300,0.5714285714285714,10,4,6,380.58479230287946,0.3905038759689923,0.24275331536304812,0.21181900362735148,129344.54038075249,1253.0804875821875,130597.62086833468,4240,9,1077.8139534883721,36,7,17,36.01401343222995,0.6137152777777778,45.69256756756757,1017.2297297297307,28.25638138138141,6
4389,4,2,2,43,0.044444444444444446,0.044444444444444446,0.9555555555555556,45,1150,800,350,0.6956521739130435,15,8,7,368.1214979451489,0.3984848484848485,0.23363314254565215,0.20747124054696653,129837.58680555565,559.2013888888955,130396.78819444454,4241,0,1030.8666666666666,39,6,16,35.82890433360588,0.6132478632478633,45.208333333333336,1019.1666666666674,26.13247863247865,0
4390,4,0,0,43,0.0,0.0,1.0,43,1100,800,300,0.7272727272727273,14,8,6,386.67817129511974,0.3911037283130306,0.25147316101924444,0.21666253090028148,129609.02829142023,1423.3964086127692,131032.42470003299,4242,11,1079.8139534883721,38,5,16,35.58913020669395,0.6126644736842104,45.432692307692314,1018.2692307692316,26.796558704453464,0
4391,4,0,0,43,0.0,0.0,1.0,43,1450,1100,350,0.7586206896551724,18,11,7,386.7506597419765,0.39121908453303805,0.2506603578005142,0.21730509962520617,129717.84056770045,1433.6920839725422,131151.53265167298,4243,12,1080.8139534883721,38,5,16,35.47631532948784,0.6137609649122806,45.325854700854705,1018.6965811965821,26.807804768331106,0
4392,4,1,0,44,0.022727272727272728,0.0,1.0,44,1050,700,350,0.6666666666666666,14,7,7,343.50868954688303,0.39515063424947144,0.19197609027596774,0.19100335106695698,129307.31336805549,84.77858020125325,129392.09194825674,4244,0,1057.2272727272727,39,5,20,36.994742591833955,0.607905982905983,45.729166666666664,1017.0833333333328,26.079059829059815,4
4393,4,0,0,44,0.0,0.0,1.0,44,1100,700,400,0.6363636363636364,15,7,8,340.53070812417434,0.39515063424947144,0.19377390446588882,0.18998540763364158,129439.78000217036,15.643988715297837,129455.42399088565,4245,1,1058.2272727272727,39,5,14,36.93582164670554,0.6092414529914529,45.59895833333334,1017.6041666666684,26.092414529914574,0
4394,4,0,0,44,0.0,0.0,1.0,44,1050,800,250,0.7619047619047619,13,8,5,338.0713063571127,0.39542591613812544,0.1947338803369152,0.18895771230317213,129511.53413973172,-43.17329301341218,129468.36084671831,4246,2,1059.2272727272727,40,4,15,36.925502529286476,0.6083333333333333,45.52845528455285,1017.8861788617893,25.44715447154473,0
4395,4,0,1,43,0.0,0.022727272727272728,0.9772727272727273,44,1050,600,450,0.5714285714285714,15,6,9,337.453400311564,0.3958333333333333,0.19431353094381731,0.18881934536517286,129554.63927469132,-56.26929012346358,129498.36998456785,4247,3,1060.2272727272727,41,3,15,36.897453387903575,0.6072154471544715,45.48611111111111,1018.0555555555553,24.830623306233058,0
4396,4,4,3,44,0.0851063829787234,0.06382978723404255,0.9361702127659575,47,1150,800,350,0.6956521739130435,15,8,7,324.43038513592916,0.4073388837496146,0.19335972560275305,0.18462551034348765,130215.33028978082,-950.8380486968169,129264.492241084,4248,0,993.4042553191489,44,3,17,36.55973116816354,0.6096117424242424,44.837962962962976,1020.6481481481505,23.196548821548877,0
4397,4,2,1,45,0.043478260869565216,0.021739130434782608,0.9782608695652174,46,1000,800,200,0.8,12,8,4,330.35231291821214,0.40141908212560384,0.20072430142237452,0.18764081031595878,130141.77755000294,-601.4725558138124,129540.30499418912,4249,0,1015.9565217391304,43,3,18,36.48308197989174,0.6102228682170543,44.91003787878788,1020.359848484849,23.729298801973233,0
4398,4,1,1,45,0.021739130434782608,0.021739130434782608,0.9782608695652174,46,1100,700,400,0.6363636363636364,15,7,8,328.6963765097874,0.40245571658615137,0.18819875776397477,0.18728049359278598,130262.58680555565,-636.5198504935627,129626.06695506208,4250,0,1016.9347826086956,41,5,19,36.40306122448979,0.6143292682926829,44.79166666666667,1020.8333333333342,24.89837398373986,0
4399,4,0,0,45,0.0,0.0,1.0,45,750,600,150,0.8,9,6,3,334.24169536863474,0.3985690235690236,0.19336920966550664,0.18983630270937002,130138.96869929682,-300.4260936842758,129838.54260561254,4251,2,1040.5333333333333,42,3,19,36.38671256726815,0.6116071428571428,44.91279069767442,1020.3488372093016,24.2940199335548,0
4400,4,1,0,46,0.021739130434782608,0.0,1.0,46,1000,800,200,0.8,12,8,4,334.2620830273578,0.4034118357487923,0.19843052640912773,0.19132277203628104,130439.87509645034,-479.6617598393457,129960.21333661099,4252,0,1018.8913043478261,41,5,20,36.08160548379786,0.6161077235772359,44.61805555555554,1021.5277777777756,24.915311653116476,0
4401,4,1,1,46,0.02127659574468085,0.02127659574468085,0.9787234042553191,47,1150,700,450,0.6086956521739131,16,7,9,324.05752159129656,0.406413814369411,0.19778821128039814,0.18683914445618857,130722.17312507167,-927.6993120121797,129794.47381305949,4253,0,998.1914893617021,43,4,13,36.05706161064295,0.6160368217054264,44.341856060606055,1022.6325757575752,23.782152924594772,0
4402,4,0,0,46,0.0,0.0,1.0,46,950,800,150,0.8421052631578947,11,8,3,329.78529808408916,0.4030193236714976,0.20003338457797426,0.18958610950894014,130609.02970261677,-585.4124414097932,130023.61726120698,4254,2,1020.8913043478261,42,4,13,36.02493917274939,0.6163194444444444,44.45251937984495,1022.1899224806181,24.337855297157574,0
4403,4,0,0,46,0.0,0.0,1.0,46,1050,700,350,0.6666666666666666,14,7,7,332.78737997256536,0.40321054750402574,0.20694041867954915,0.19199271921494146,130746.38429752066,-497.85066574838925,130248.53363177227,4255,3,1021.8913043478261,43,3,14,35.80941358024692,0.6162790697674418,44.31818181818182,1022.7272727272727,23.78435517970402,0
4404,4,1,1,46,0.02127659574468085,0.02127659574468085,0.9787234042553191,47,1400,800,600,0.5714285714285714,20,8,12,327.7857849317562,0.4058163737280296,0.20480262955322215,0.1903361154519694,130996.1591220851,-812.2642318244132,130183.89489026068,4256,0,1001.1276595744681,44,3,15,35.68518602267245,0.6174242424242424,44.074074074074076,1023.7037037037042,23.265993265993277,0
4405,4,1,1,46,0.02127659574468085,0.02127659574468085,0.9787234042553191,47,1350,800,550,0.5925925925925926,19,8,11,331.28735250168694,0.4063559975331483,0.2142894240257609,0.19296310721543733,131114.67013888876,-712.6736111111214,130401.99652777764,4257,0,1002.1063829787234,44,3,17,35.475996745321396,0.6186079545454546,43.95833333333333,1024.1666666666656,23.276515151515127,0
4406,4,1,0,47,0.02127659574468085,0.0,1.0,47,1250,800,450,0.64,17,8,9,326.96606830281826,0.4051996608078939,0.20790965665607364,0.191153379709841,131256.95408950615,-816.6859567901267,130440.26813271602,4258,0,1002.8936170212766,44,3,18,35.44320954188127,0.6200284090909091,43.81944444444444,1024.7222222222222,23.28914141414141,0
4407,4,0,0,47,0.0,0.0,1.0,47,900,600,300,0.6666666666666666,12,6,6,329.83289148898723,0.4050262102991058,0.20704299601459208,0.19371442812129733,131432.31232236128,-729.7829178325369,130702.52940452874,4259,1,1003.8936170212766,40,7,19,35.19305417905517,0.6276041666666665,43.64837398373985,1025.4065040650428,25.63516260162607,0
4408,4,1,0,48,0.020833333333333332,0.0,1.0,48,800,500,300,0.625,11,5,6,323.700810696791,0.40843860815602834,0.21642360455603793,0.1915802451688159,131725.71228441808,-1072.0560287843227,130653.65625563376,4260,0,983.9583333333334,42,6,15,35.055023283619676,0.6274801587301586,43.3624031007752,1026.5503875968998,24.44167589516428,0
4409,4,0,0,48,0.0,0.0,1.0,48,1000,700,300,0.7,13,7,6,324.83885684522824,0.40877105496453897,0.21450418049920073,0.19269981201475167,131813.89534550067,-1036.344983930188,130777.55036157048,4261,1,984.9583333333334,43,5,15,34.937138817164666,0.6269379844961239,43.27651515151516,1026.893939393941,23.88125440451026,0
4410,4,0,1,47,0.0,0.020833333333333332,0.9791666666666666,48,1000,500,500,0.5,15,5,10,325.72151916076933,0.40865100472813237,0.21359400448664734,0.19359459278558183,131886.83824215177,-1008.3237380911291,130878.51450406064,4262,2,985.9583333333334,43,5,16,34.84114271227068,0.6276647286821705,43.20549242424243,1027.1780303030314,23.88786116983794,0
4411,4,0,1,46,0.0,0.02127659574468085,0.9787234042553191,47,1400,1000,400,0.7142857142857143,18,10,8,331.04534854378176,0.4052960222016651,0.2223372873909495,0.1968848651865653,131911.15702479365,-666.2850091827117,131244.87201561095,4263,3,1007.8510638297872,43,4,16,34.67997173058013,0.6279069767441859,43.181818181818194,1027.2727272727293,23.890063424947193,0
4412,4,0,0,46,0.0,0.0,1.0,46,1500,1100,400,0.7333333333333333,19,11,8,340.38065840507085,0.40072463768115946,0.22722909162516336,0.20197951947239312,131825.2030001202,-225.8501216873894,131599.3528784328,4264,4,1030.5217391304348,42,4,18,34.52675819336983,0.6284722222222221,43.265503875968996,1026.9379844961243,24.450904392764862,0
4413,4,0,0,46,0.0,0.0,1.0,46,1250,800,450,0.64,17,8,9,343.0921281719206,0.4005132850241546,0.23286008382339674,0.20412248837703165,131924.7312736615,-147.532637762143,131777.19863589937,4265,5,1031.5217391304348,42,4,19,34.356921650003144,0.6294642857142857,43.168604651162795,1027.3255813953494,24.460132890365465,0
4414,4,0,0,46,0.0,0.0,1.0,46,1300,1000,300,0.7692307692307693,16,10,6,339.42184148647954,0.39997987117552336,0.23039632045385328,0.20238493537424632,132008.45457415085,-238.6894513314689,131769.76512281937,4266,6,1032.5217391304348,43,3,19,34.36693697014375,0.628875968992248,43.087121212121225,1027.6515151515173,23.89887244538412,0
4415,4,0,0,46,0.0,0.0,1.0,46,1000,600,400,0.6,14,6,8,333.8647988622001,0.3998993558776167,0.22099580276184594,0.19958349429779998,132105.78799357227,-378.90553259869677,131726.88246097357,4267,7,1033.5217391304348,43,3,19,34.41184598378775,0.6298449612403101,42.99242424242425,1028.0303030303046,23.90768146582104,0
4416,4,0,1,45,0.0,0.021739130434782608,0.9782608695652174,46,850,600,250,0.7058823529411765,11,6,5,335.77901556762157,0.39974838969404186,0.22368342028451593,0.20111551737720942,132178.8115978681,-323.42575255393075,131855.38584531416,4268,8,1034.5217391304348,43,3,19,34.289241642876874,0.6305717054263565,42.92140151515152,1028.3143939393956,23.914288231148735,0
4417,4,1,0,46,0.021739130434782608,0.0,1.0,46,1250,700,550,0.56,18,7,11,337.86859841896364,0.40073470209339773,0.23522128788164465,0.2039594209304003,132474.58944515287,-247.8360432068996,132226.75340194599,4269,0,1025.9565217391305,41,5,20,33.93833718801195,0.6364329268292683,42.63392857142856,1029.4642857142842,25.108885017421567,0
4418,4,0,0,46,0.0,0.0,1.0,46,850,700,150,0.8235294117647058,10,7,3,336.76999461984394,0.4003321256038647,0.2380119555792004,0.20357226407451134,132525.65906281487,-273.86690208491757,132251.79216072996,4270,1,1026.9565217391305,41,5,20,33.91533786170793,0.6369410569105691,42.58432539682539,1029.6626984126979,25.113724351529218,0
4419,4,0,0,46,0.0,0.0,1.0,46,800,600,200,0.75,10,6,4,338.66425823839484,0.3998792270531401,0.2407888234653619,0.20513490834486653,132602.28194286962,-218.469309019923,132383.8126338497,4271,2,1027.9565217391305,41,5,20,33.78965196172861,0.6377032520325203,42.509920634920626,1029.9603174603164,25.120983352690644,0
4420,4,0,1,45,0.0,0.021739130434782608,0.9782608695652174,46,1550,1200,350,0.7741935483870968,19,12,7,337.65375142581104,0.399104267310789,0.24756826438532809,0.20535990455569783,132755.59413580224,-234.91512345681252,132520.67901234544,4272,3,1028.9565217391305,41,5,16,33.66183737646002,0.6392276422764228,42.3611111111111,1030.5555555555536,25.135501355013503,0
4421,4,0,0,45,0.0,0.0,1.0,45,950,600,350,0.631578947368421,13,6,7,341.89554617778055,0.3974326599326599,0.2544936493846641,0.20769795941860503,132711.9596986747,74.7255891003939,132786.6852877751,4273,4,1051.5111111111112,40,5,17,33.59634414965314,0.6403645833333333,42.40345528455284,1030.3861788617883,25.759654471544707,0
4422,4,0,0,45,0.0,0.0,1.0,45,1600,1100,500,0.6875,21,11,10,350.044549128987,0.3965277777777778,0.26088061058002987,0.21384118242094075,132921.47040658645,305.68723560708776,133227.15764219355,4274,5,1052.5111111111112,40,5,18,33.17606189021385,0.6424479166666668,42.20020325203251,1031.199186991868,25.7799796747967,0
4423,4,0,0,45,0.0,0.0,1.0,45,1000,700,300,0.7,13,7,6,348.69325805691193,0.39640151515151517,0.2653268971858276,0.2136140774010688,133026.28772762563,277.0739349923896,133303.36166261803,4275,6,1053.5111111111112,40,5,18,33.1057284996552,0.6434895833333334,42.09857723577235,1031.6056910569098,25.790142276422745,0
4424,4,0,0,45,0.0,0.0,1.0,45,1050,700,350,0.6666666666666666,14,7,7,351.151197150877,0.3962752525252525,0.2666972968833763,0.21602923739924013,133183.59116803802,353.5154959018945,133537.10666393992,4276,7,1054.5111111111112,40,5,19,32.88454596173411,0.6450520833333334,41.946138211382106,1032.2154471544702,25.805386178861756,0
4425,4,0,0,45,0.0,0.0,1.0,45,1200,900,300,0.75,15,9,6,350.9092477499233,0.3960016835016835,0.263145924905422,0.21664275672142874,133314.74837233115,356.2756130609963,133671.02398539215,4277,8,1055.5111111111112,40,5,19,32.75929935052156,0.6463541666666668,41.819105691056905,1032.7235772357712,25.818089430894283,0
4426,4,0,0,45,0.0,0.0,1.0,45,850,500,350,0.5882352941176471,12,5,7,356.23000122034813,0.3950126262626263,0.27421688853913895,0.22055019442180632,133419.72061107805,505.6214472205718,133925.34205829861,4278,9,1056.5111111111112,40,5,19,32.51668142173257,0.6473958333333333,41.71747967479675,1033.1300813008131,25.82825203252033,0
4427,4,0,1,44,0.0,0.022222222222222223,0.9777777777777777,45,1350,900,450,0.6666666666666666,18,9,9,359.03901338299414,0.3956018518518518,0.2752527797373103,0.22308980149026034,133552.9635959205,590.1551846180535,134143.11878053856,4279,10,1057.5111111111112,39,6,19,32.3105621619806,0.6503739316239315,41.588541666666686,1033.6458333333362,26.50373931623939,0
4428,4,0,0,44,0.0,0.0,1.0,44,950,600,350,0.631578947368421,13,6,7,365.4281531621151,0.39650502114164904,0.2772896423402935,0.22690320627023783,133527.4273595589,958.9362352984293,134486.36359485734,4280,11,1058.7272727272727,38,6,19,32.17106849975882,0.6518640350877192,41.61324786324787,1033.5470085470097,27.198605488079203,0
4429,4,0,0,44,0.0,0.0,1.0,44,1250,1000,250,0.8,15,10,5,361.6001266830373,0.3964169309372798,0.26992335005354184,0.22519729897287252,133637.8718770548,864.6942800789229,134502.56615713373,4281,12,1059.7272727272727,38,6,19,32.15927877660674,0.6529605263157894,41.50641025641027,1033.974358974361,27.209851551956866,0
4430,4,0,0,44,0.0,0.0,1.0,44,1150,1000,150,0.8695652173913043,13,10,3,361.74182069378924,0.39611962649753346,0.2635617248598763,0.22612950611865476,133775.9917292169,878.4741626488477,134654.46589186575,4282,13,1060.7272727272727,38,6,17,32.0172381149093,0.6543311403508771,41.37286324786325,1034.5085470085473,27.22390913180388,0
4431,4,0,0,44,0.0,0.0,1.0,44,550,300,250,0.5454545454545454,8,3,5,361.9836732581248,0.3964169309372798,0.26948454188801074,0.22679002970104753,133858.89788333693,890.9471108188991,134749.84499415584,4283,14,1061.7272727272727,38,6,17,31.927954435955677,0.6551535087719298,41.29273504273504,1034.8290598290594,27.232343679712088,0
4432,4,0,1,43,0.0,0.022727272727272728,0.9772727272727273,44,1200,900,300,0.75,15,9,6,364.17937433751985,0.39599850246652574,0.2782097700071289,0.22919652571943128,134024.7872379282,961.812632405578,134986.59987033377,4284,15,1062.7272727272727,38,6,17,31.705057435685784,0.6567982456140351,41.13247863247863,1035.470085470085,27.24921277552855,0
4433,4,0,0,43,0.0,0.0,1.0,43,1100,900,200,0.8181818181818182,13,9,4,371.4360097673084,0.39463362864525653,0.2859184075679939,0.23313536783267208,133925.82333025534,1348.9746845182976,135274.79801477364,4285,16,1087.2093023255813,37,6,17,31.616348870056495,0.6576576576576577,41.22807017543859,1035.0877192982446,27.97534376481742,0
4434,4,0,0,43,0.0,0.0,1.0,43,900,800,100,0.8888888888888888,10,8,2,370.3162634729854,0.39447212993724623,0.28927651315497793,0.23279135550678587,133982.577571945,1323.1854993844013,135305.7630713294,4286,17,1088.2093023255813,37,6,18,31.588469956930027,0.6582207207207208,41.173245614035075,1035.307017543858,27.981270744428592,0
4435,4,0,0,43,0.0,0.0,1.0,43,1000,900,100,0.9,11,9,2,370.78148172665345,0.394702842377261,0.28402430976231985,0.23344402089510077,134039.34383656495,1339.8613034779723,135379.20514004293,4287,18,1089.2093023255813,37,6,18,31.51957150924748,0.6587837837837839,41.11842105263157,1035.5263157894724,27.987197724039795,0
4436,4,0,0,43,0.0,0.0,1.0,43,1300,900,400,0.6923076923076923,17,9,8,375.83307151780355,0.3943567737172388,0.28923449509853416,0.23754158480078397,134181.31209843387,1485.9549332486667,135667.26703168254,4288,19,1090.2093023255813,37,6,18,31.246582530779264,0.6601914414414416,40.981359649122794,1036.0745614035068,28.00201517306775,0
4437,4,0,0,43,0.0,0.0,1.0,43,1350,1000,350,0.7407407407407407,17,10,7,380.5718462813751,0.39384920634920634,0.2821897128068729,0.24187621271517618,134384.56658859286,1628.5965236686218,136013.16311226148,4289,20,1091.2093023255813,38,5,18,30.920273055126223,0.6603618421052633,40.7852564102564,1036.858974358973,27.285762483130867,0
4438,4,0,0,43,0.0,0.0,1.0,43,900,700,200,0.7777777777777778,11,7,4,381.4454605570875,0.3928110003691399,0.28261884748295474,0.24353825558644843,134550.78125000015,1664.859672912572,136215.64092291272,4290,21,1092.2093023255813,37,6,18,30.731258366800542,0.6638513513513513,40.62500000000001,1037.5000000000011,28.040540540540572,0
4439,4,0,0,43,0.0,0.0,1.0,43,800,700,100,0.875,9,7,2,382.86891984350893,0.39258028792912514,0.28337976421188626,0.24503610869984568,134638.42220598977,1709.7734558883212,136348.1956618781,4291,22,1093.2093023255813,36,7,18,30.60664424189815,0.6666666666666666,40.54054054054054,1037.8378378378377,28.828828828828826,0
4440,4,0,0,43,0.0,0.0,1.0,43,1550,1300,250,0.8387096774193549,18,13,5,385.7907041617969,0.3918420081210779,0.28601978080727064,0.24810054907810952,134813.78971877284,1801.9813732651567,136615.771092038,4292,23,1094.2093023255813,36,7,16,30.355400130123616,0.6684027777777778,40.37162162162162,1038.5135135135135,28.8475975975976,0
4441,4,0,0,43,0.0,0.0,1.0,43,1500,1200,300,0.8,18,12,6,364.87258163200863,0.39174972314507195,0.24324971456367916,0.2355968726884915,134960.0164987623,1256.0987085058068,136216.1152072681,4293,24,1095.2093023255813,36,7,16,30.752592030634727,0.6698495370370371,40.23085585585586,1039.0765765765768,28.863238238238246,3
4442,4,0,0,43,0.0,0.0,1.0,43,1000,700,300,0.7,13,7,6,375.0588466828352,0.39174972314507195,0.2189198407620323,0.21855425370332884,131131.51552641182,1247.8204358891498,132379.33596230097,4294,25,1096.2093023255813,37,6,18,34.338199871534094,0.6297860360360361,43.941885964912274,1024.2324561403498,27.681958274063508,8
4443,4,1,1,43,0.022727272727272728,0.022727272727272728,0.9772727272727273,44,1350,1000,350,0.7407407407407407,17,10,7,361.6453789279663,0.3964609760394644,0.21114447878399112,0.21275665877309397,131496.76462950127,711.186735341627,132207.95136484288,4295,0,1072.2727272727273,37,7,18,34.31241536597533,0.633445945945946,43.585526315789465,1025.6578947368412,27.720483641536248,0
4444,4,0,0,43,0.0,0.0,1.0,43,1250,1000,250,0.8,15,10,5,366.8250081774616,0.39292635658914726,0.21841367099687625,0.21548665053238805,131440.5393967373,1043.135387811614,132483.6747845489,4296,27,1098.2093023255813,37,6,19,34.23643783860848,0.632882882882883,43.64035087719297,1025.438596491227,27.71455666192505,0
4445,4,0,0,43,0.0,0.0,1.0,43,1100,700,400,0.6363636363636364,15,7,8,363.69287730530255,0.3923034330011074,0.2203386460125083,0.21427648363151158,131553.00188519515,968.9779547552828,132521.97983995042,4297,28,1099.2093023255813,37,6,19,34.20309605244407,0.6340090090090091,43.53070175438595,1025.8771929824538,27.7264106211474,0
4446,4,0,0,43,0.0,0.0,1.0,43,1100,800,300,0.7272727272727273,14,8,6,363.7242537480293,0.3925110741971207,0.21893964621738937,0.21461106977137787,131609.2511638194,973.8953331794177,132583.14649699882,4298,29,1100.2093023255813,37,6,15,34.14547267934743,0.6345720720720722,43.475877192982445,1026.0964912280683,27.732337600758605,0
4447,4,0,0,43,0.0,0.0,1.0,43,1100,700,400,0.6363636363636364,15,7,8,362.36202101693283,0.3924418604651163,0.21689859550980506,0.21443952217196705,131721.78578985814,946.1945021544789,132667.98029201262,4299,30,1101.2093023255813,37,6,16,34.06679484440646,0.6356981981981983,43.366228070175424,1026.5350877192961,27.744191559980976,0
4448,4,0,0,43,0.0,0.0,1.0,43,1250,900,350,0.72,16,9,7,359.10800315495857,0.3919804355850867,0.22103080495163852,0.2129858422765155,131806.2183195788,866.533572830064,132672.75189240885,4300,31,1102.2093023255813,37,6,17,34.06511389927033,0.6365427927927929,43.28399122807016,1026.8640350877167,27.75308202939775,0
4449,4,0,0,43,0.0,0.0,1.0,43,950,500,450,0.5263157894736842,14,5,9,358.74231225099294,0.3914267257290513,0.22025178681565927,0.21331523390805746,131903.67408366175,863.8858070348127,132767.55989069658,4301,32,1103.2093023255813,38,5,17,33.97620904836193,0.6356907894736844,43.18910256410255,1027.2435897435873,27.032726045883877,0
4450,4,0,0,43,0.0,0.0,1.0,43,1100,900,200,0.8181818181818182,13,9,4,358.88778404827656,0.3904808047249908,0.2267411639270145,0.21401993767888203,132013.44515897773,875.6025595368196,132889.04771851454,4302,33,1104.2093023255813,38,5,17,33.861801296046,0.6367872807017545,43.08226495726494,1027.670940170938,27.043972109761523,0
4451,4,0,1,42,0.0,0.023255813953488372,0.9767441860465116,43,1300,1000,300,0.7692307692307693,16,10,6,357.9533112944915,0.3907115171650055,0.24035525010284808,0.21207961291862276,131766.52444480962,833.8120479947306,132600.33649280434,4303,34,1105.2093023255813,38,5,17,34.13479882067289,0.6343201754385965,43.32264957264957,1026.709401709401,27.018668466036868,1
4452,4,1,1,42,0.023255813953488372,0.023255813953488372,0.9767441860465116,43,900,300,600,0.3333333333333333,15,3,12,356.68371073776507,0.3929724990771502,0.23934632306725323,0.21285963382737577,132040.89506172828,819.3672839506062,132860.2623456789,4304,0,1090.2558139534883,38,5,18,33.89076576576576,0.637061403508772,43.05555555555555,1027.777777777777,27.04678362573097,0
4453,4,0,0,42,0.0,0.0,1.0,42,1150,700,450,0.6086956521739131,16,7,9,367.82934830481975,0.3889251838946961,0.2495566362282826,0.21913088512170764,131975.1645337987,1308.867752577691,133284.0322863764,4305,36,1117.2142857142858,37,5,19,33.670699498452656,0.638231981981982,43.11951754385964,1027.52192982456,27.77086296823135,0
4454,4,2,1,43,0.045454545454545456,0.022727272727272728,0.9772727272727273,44,1350,900,450,0.6666666666666666,18,9,9,353.4149074211512,0.39566816420014095,0.24441018500099454,0.21307468692805553,132426.97934420907,562.3625984591035,132989.34194266816,4306,0,1067.3863636363637,36,8,21,33.58611415025529,0.6446759259259259,42.68018018018018,1029.2792792792793,28.59109109109109,0
4455,4,0,0,43,0.0,0.0,1.0,43,1100,700,400,0.6363636363636364,15,7,8,365.6837515776362,0.39237264673311184,0.25571980039544306,0.22030216253579524,132398.00347222204,1083.1597222221978,133481.16319444423,4307,1,1093.2093023255813,35,8,21,33.299595141700394,0.6464285714285715,42.70833333333332,1029.1666666666652,29.404761904761862,0
4456,4,1,0,44,0.022727272727272728,0.0,1.0,44,1250,800,450,0.64,17,8,9,358.8446627761827,0.3974079457364341,0.2530508407202765,0.21768640418279303,132658.9004545085,720.7876795714521,133379.68813407994,4308,0,1069.340909090909,36,8,16,33.21308847106834,0.6469907407407408,42.45495495495495,1030.1801801801796,28.6161161161161,0
4457,4,0,0,44,0.0,0.0,1.0,44,1250,800,450,0.64,17,8,9,360.7885921231328,0.3971546863988724,0.255386847195358,0.21965108587807292,132793.26331178815,782.0589027392946,133575.32221452743,4309,1,1070.340909090909,37,7,16,33.0279255319149,0.6463963963963963,42.32456140350877,1030.7017543859643,27.856804172593627,0
4458,4,1,1,44,0.022222222222222223,0.022222222222222223,0.9777777777777777,45,1450,1100,350,0.7586206896551724,18,11,7,355.46468114656096,0.39844276094276093,0.2581504485852313,0.21843440329998579,133141.23109796178,465.4010519395048,133606.63214990127,4310,0,1047.5333333333333,38,7,19,32.81573498964804,0.6480263157894738,41.98717948717948,1032.0512820512813,27.159244264507404,0
4459,4,0,0,44,0.0,0.0,1.0,44,1150,800,350,0.6956521739130435,15,8,7,359.28417853071693,0.3954369274136716,0.25806771079913826,0.22022832806485446,133047.67001625494,760.3845654432085,133808.05458169815,4311,3,1072.340909090909,37,7,19,32.81111612994651,0.6489301801801801,42.07785087719298,1031.6885964912276,27.88347558084399,0
4460,4,0,0,44,0.0,0.0,1.0,44,1100,800,300,0.7272727272727273,14,8,6,360.37805379128645,0.39534883720930236,0.26095533453224173,0.22150283852134423,133149.50086805568,796.8315972222335,133946.33246527793,4312,4,1073.340909090909,39,5,19,32.6806620912394,0.6463675213675213,41.97916666666667,1032.0833333333344,26.46367521367524,0
4461,4,0,0,44,0.0,0.0,1.0,44,1200,700,500,0.5833333333333334,17,7,10,358.53199845484465,0.3949524312896406,0.25803433854281277,0.22100554531619554,133257.03125000015,755.3819444444603,134012.4131944446,4313,5,1074.340909090909,39,5,19,32.620392789884306,0.6474358974358974,41.87500000000001,1032.5000000000011,26.474358974359003,0
4462,4,0,0,44,0.0,0.0,1.0,44,1000,600,400,0.6,14,6,8,358.94558458040177,0.39509557787174066,0.26166053758608965,0.22142050901963456,133283.9206271703,768.3349609375198,134052.25558810783,4314,6,1075.340909090909,39,5,19,32.582740677225196,0.6477029914529915,41.84895833333334,1032.604166666668,26.47702991452995,0
4463,4,0,0,44,0.0,0.0,1.0,44,1450,1100,350,0.7586206896551724,18,11,7,360.8858621742854,0.39479827343199436,0.2658481365377916,0.22342484276183316,133418.40820312515,829.7634548611272,134248.17165798627,4315,7,1076.340909090909,39,5,19,32.39774484102979,0.6490384615384615,41.71875000000001,1033.1250000000011,26.490384615384645,0
4464,4,0,0,44,0.0,0.0,1.0,44,500,300,200,0.6,7,3,4,348.122179448293,0.3948643410852713,0.21288051356388427,0.21360635381903545,133086.10586054513,466.05589598629854,133552.16175653142,4316,8,1077.340909090909,38,6,19,33.06045937737281,0.6474780701754386,42.0405982905983,1031.837606837608,27.153621232568632,4
4465,4,0,1,43,0.0,0.022727272727272728,0.9772727272727273,44,900,700,200,0.7777777777777778,11,7,4,347.3875549752698,0.3947211945031712,0.20788126582040234,0.21362897317734483,133168.79799702333,452.2366270363221,133621.03462405966,4317,9,1078.340909090909,38,6,19,32.99649794707241,0.6483004385964912,41.96047008547009,1032.158119658121,27.16205578047687,0
4466,4,0,0,43,0.0,0.0,1.0,43,850,400,450,0.47058823529411764,13,4,9,355.90448268887377,0.39218807678110007,0.2029888270776843,0.22002174877449396,133364.60503472268,893.0121527778263,134257.61718750052,4318,10,1104.1627906976744,39,4,17,32.58034153556543,0.6485042735042733,41.77083333333336,1032.9166666666704,26.485042735042832,4
4467,4,0,1,42,0.0,0.023255813953488372,0.9767441860465116,43,950,800,150,0.8421052631578947,11,8,3,356.61026349293,0.3920727205610926,0.2059278054362832,0.2206178404902929,133391.5052625872,913.7559678819839,134305.2612304692,4319,11,1105.1627906976744,39,4,17,32.5351458774495,0.6487713675213673,41.744791666666686,1033.0208333333364,26.487713675213755,0
4468,4,0,0,42,0.0,0.0,1.0,42,850,500,350,0.5882352941176471,12,5,7,362.9421866709044,0.38660230352303526,0.21872398488722067,0.22418927275064787,133334.25931633092,1278.5255268829296,134612.78484321386,4320,51,1132.2142857142858,38,4,17,32.429054170545854,0.6499451754385963,41.80021367521369,1032.7991452991475,27.178924876293355,0
4469,4,0,0,42,0.0,0.0,1.0,42,900,700,200,0.7777777777777778,11,7,4,362.9522872612477,0.3863845334881921,0.21475850656737938,0.22452883336717927,133389.43591798196,1282.8001725838644,134672.23609056583,4321,52,1133.2142857142858,38,4,17,32.37343572241183,0.6504934210526314,41.74679487179489,1033.0128205128235,27.184547908232197,0
4470,4,0,0,42,0.0,0.0,1.0,42,1350,1100,250,0.8148148148148148,16,11,5,360.5415151862613,0.3855860433604336,0.21438673050892,0.2242206731646486,133585.55036164974,1232.6530289929924,134818.20339064274,4322,53,1134.2142857142858,37,5,19,32.239075095460336,0.6542792792792793,41.55701754385965,1033.7719298245615,27.93978188715031,0
4471,4,1,1,42,0.023255813953488372,0.023255813953488372,0.9767441860465116,43,1550,1100,450,0.7096774193548387,20,11,9,353.22297731215684,0.3889811738648948,0.1988336093311256,0.2219669682331258,133969.4793721236,864.2196745562172,134833.69904667983,4323,0,1108.8139534883721,38,5,15,32.04398864809082,0.65625,41.18589743589744,1035.2564102564104,27.243589743589748,0
4472,4,0,0,42,0.0,0.0,1.0,42,1250,1000,250,0.8,15,10,5,359.6654172136641,0.3848601432442896,0.2034492152619074,0.2255735463840382,133897.45071800938,1231.6564952677716,135129.10721327714,4324,55,1136.2142857142858,37,5,15,31.94933697072429,0.6573761261261262,41.25548245614035,1034.9780701754385,27.97238027501185,0
4473,4,0,0,42,0.0,0.0,1.0,42,1500,1200,300,0.8,18,12,6,358.0064125547201,0.3846302748741773,0.2064988249059423,0.22505303244618274,133982.5775719451,1193.3243882733032,135175.90196021838,4325,56,1137.2142857142858,37,5,15,31.90708183294501,0.6582207207207207,41.17324561403508,1035.3070175438586,27.98127074442861,0
4474,4,0,0,42,0.0,0.0,1.0,42,1100,900,200,0.8181818181818182,13,9,4,359.6350916035078,0.3848359465737514,0.20569735091327002,0.22712783057954156,134152.91243459526,1249.2189904586028,135402.13142505387,4326,57,1138.2142857142858,37,5,15,31.694538526672314,0.6599099099099099,41.00877192982456,1035.9649122807016,27.999051683262206,0
4475,4,0,0,42,0.0,0.0,1.0,42,1300,900,400,0.6923076923076923,17,9,8,359.34042772831856,0.38450929152148666,0.2064056677418875,0.2273478674844724,134218.45465565415,1246.0233809993365,135464.47803665348,4327,58,1139.2142857142858,38,4,16,31.636637797711106,0.6587171052631579,40.94551282051282,1036.2179487179485,27.268893387314435,0
4476,4,0,1,41,0.0,0.023809523809523808,0.9761904761904762,42,1300,1000,300,0.7692307692307693,16,10,6,358.6160796162244,0.38384388308168793,0.20744472191126784,0.22794792187100263,134388.72070312515,1238.7912326389041,135627.51193576405,4328,59,1140.2142857142858,39,3,18,31.485248811198193,0.658653846153846,40.78125000000001,1036.8750000000011,26.586538461538492,0
4477,4,0,1,40,0.0,0.024390243902439025,0.975609756097561,41,1150,800,350,0.6956521739130435,15,8,7,362.4876046821831,0.3830030487804878,0.20151346136452686,0.23090745841565855,134467.66107823813,1548.5720742932417,136016.23315253138,4329,60,1143.780487804878,38,3,18,31.30601050679853,0.6611842105263157,40.70512820512821,1037.1794871794882,27.294197031039165,0
4478,4,0,0,40,0.0,0.0,1.0,40,850,500,350,0.5882352941176471,12,5,7,365.0838989083751,0.384909188034188,0.19656220272698466,0.23291023382145237,134522.34251163833,1822.3882588873628,136344.7307705257,4330,61,1160.475,37,3,19,31.184049430997444,0.6635698198198197,40.65241228070176,1037.390350877194,28.03757705073497,0
4479,4,0,0,40,0.0,0.0,1.0,40,1350,1000,350,0.7407407407407407,17,10,7,364.3801212916018,0.3848157051282051,0.19638715432649434,0.23341149483879195,134670.88906035668,1814.284989517193,136485.17404987387,4331,62,1161.475,35,5,19,31.053932500743382,0.669047619047619,40.50925925925926,1037.962962962963,29.65608465608466,0
4480,4,0,0,40,0.0,0.0,1.0,40,800,300,500,0.375,13,3,10,364.16133801385223,0.3844150641025641,0.192178563863588,0.22892219397648433,133982.5775719453,1758.254943828873,135740.83251577418,4332,63,1162.475,37,3,22,31.747775894937508,0.6582207207207207,41.17324561403509,1035.3070175438602,27.981270744428652,2
4481,4,0,1,39,0.0,0.025,0.975,40,1200,700,500,0.5833333333333334,17,7,10,364.511843557923,0.38385416666666666,0.1952666948883488,0.2303861143664758,134181.3120984341,1782.1354888042497,135963.44758723836,4333,64,1163.475,37,3,22,31.539823438106325,0.6601914414414414,40.98135964912281,1036.0745614035086,28.0020151730678,0
4482,4,1,1,39,0.025,0.025,0.975,40,850,600,250,0.7058823529411765,11,6,5,355.7093330440455,0.3852831196581197,0.18507416563658818,0.2265896460099471,134467.66107823804,1566.2804076265595,136033.9414858646,4334,0,1154.275,38,2,23,31.481767614338693,0.6611842105263158,40.705128205128204,1037.1794871794873,27.29419703103914,0
4483,4,1,0,40,0.025,0.0,1.0,40,1000,800,200,0.8,12,8,4,353.8015002945879,0.3851228632478632,0.19286123853211024,0.22684919724770627,134705.215419501,1531.8841910531291,136237.09961055414,4335,0,1155.25,34,6,24,31.294199159021385,0.6715686274509804,40.47619047619047,1038.0952380952372,30.532212885154035,0
4484,4,0,1,39,0.0,0.025,0.975,40,700,500,200,0.7142857142857143,9,5,4,352.80795817885314,0.38509615384615387,0.1887640449438206,0.22659727623239714,134767.01388888876,1509.3749999999814,136276.38888888873,4336,1,1156.25,34,6,24,31.258360085607283,0.6721813725490197,40.41666666666666,1038.3333333333321,30.539215686274474,0
4485,4,0,0,39,0.0,0.0,1.0,39,750,300,450,0.4,12,3,9,350.7655930575284,0.38197255960413856,0.19772243038718718,0.22586197781748577,134859.7381660996,1660.8312074829723,136520.56937358255,4337,2,1183.7435897435898,34,5,19,31.218958930276987,0.6731004901960785,40.32738095238094,1038.6904761904748,30.549719887955142,0
4486,4,0,1,38,0.0,0.02564102564102564,0.9743589743589743,39,900,600,300,0.6666666666666666,12,6,6,348.6837744347034,0.38169140800719753,0.1946439007485854,0.2256751693542914,135045.28238378666,1617.619756235802,136662.90214002246,4338,3,1184.7435897435898,34,5,20,31.088220135150614,0.6749387254901962,40.14880952380951,1039.4047619047603,30.57072829131648,0
4487,4,0,0,38,0.0,0.0,1.0,38,1250,900,350,0.72,16,9,7,350.68590714395754,0.37756341868183974,0.21068761011439485,0.2274632443585117,135123.54022491336,1877.1842560553437,137000.7244809687,4339,4,1214.8684210526317,33,5,21,30.958274398868447,0.6780303030303031,40.073529411764696,1039.70588235294,31.50623885918,0
4488,4,0,0,38,0.0,0.0,1.0,38,500,200,300,0.4,8,2,6,351.86984160294185,0.3768521811284969,0.21364600518501065,0.2286345693600737,135187.255202326,1913.6636149557792,137100.91881728178,4340,5,1215.8684210526317,33,5,22,30.86407023332547,0.6786616161616161,40.01225490196078,1039.9509803921565,31.51366607248959,0
4489,4,0,1,37,0.0,0.02631578947368421,0.9736842105263158,38,950,700,250,0.7368421052631579,12,7,5,351.4092301733732,0.37671882408724516,0.2117540552606776,0.228739382339846,135250.98519800074,1905.6889177239434,137156.6741157247,4341,6,1216.8684210526317,33,5,22,30.812617813383596,0.6792929292929293,39.95098039215686,1040.1960784313721,31.521093285799157,0
4490,4,0,0,37,0.0,0.0,1.0,37,1000,600,400,0.6,14,6,8,349.585534825024,0.3751564064064064,0.20669181767579925,0.22801325181870954,135323.83786848062,2061.451247165517,137385.28911564613,4342,7,1217.7567567567567,34,3,22,30.78756674294431,0.6776960784313726,39.88095238095237,1040.4761904761895,30.602240896358513,0
4491,4,1,0,38,0.02631578947368421,0.0,1.0,38,950,800,150,0.8421052631578947,11,8,3,342.40000000000003,0.37707444286391656,0.20378947368421052,0.22526315789473667,135633.6805555554,1688.5487528344436,137322.22930838983,4343,0,1186.6842105263158,34,4,23,30.666666666666654,0.6807598039215688,39.58333333333332,1041.6666666666654,30.637254901960745,0
4492,4,0,0,38,0.0,0.0,1.0,38,800,500,300,0.625,11,5,6,337.0926155825055,0.3763632053105737,0.19585188821487454,0.22289692334332173,135814.58574459862,1556.4187885802319,137371.00453317884,4344,1,1187.6842105263158,35,3,23,30.625416389073962,0.6803571428571429,39.409722222222214,1042.36111111111,29.781746031746,0
4493,4,0,0,38,0.0,0.0,1.0,38,850,600,250,0.7058823529411765,11,6,5,336.53133271707975,0.3763780227596017,0.1993082172571754,0.2229025180231948,135874.91426611776,1545.2331961590994,137420.14746227686,4345,2,1188.6842105263158,35,3,17,30.58022498519836,0.680952380952381,39.35185185185184,1042.592592592591,29.78835978835974,0
4494,4,0,0,38,0.0,0.0,1.0,38,450,100,350,0.2222222222222222,8,1,7,336.2371893840426,0.3760372214319583,0.19767075030232917,0.22289630898902413,135905.08355034707,1539.2686631944255,137444.3522135415,4346,3,1189.6842105263158,35,3,17,30.557983682983682,0.6812500000000001,39.32291666666666,1042.7083333333321,29.791666666666632,0
4495,4,0,0,38,0.0,0.0,1.0,38,500,200,300,0.4,8,2,6,336.2371893840426,0.3760372214319583,0.19767075030232917,0.22289630898902413,135905.08355034707,1539.2686631944255,137444.3522135415,4347,4,1190.6842105263158,35,3,17,30.557983682983682,0.6812500000000001,39.32291666666666,1042.7083333333321,29.791666666666632,0
4496,4,0,0,38,0.0,0.0,1.0,38,1100,800,300,0.7272727272727273,14,8,6,337.71141949314244,0.37532598387861543,0.20328471508037071,0.22456718440523898,136015.18906998215,1586.7765146903655,137601.96558467252,4348,5,1191.6842105263158,36,2,17,30.410414192666163,0.6802662037037037,39.21734234234234,1043.1306306306308,28.975850850850854,0
4497,4,0,1,37,0.0,0.02631578947368421,0.9736842105263158,38,1150,900,250,0.782608695652174,14,9,5,341.98927464524814,0.3744369369369369,0.20360170574240133,0.22854351742514817,136191.45063560182,1715.2030831507166,137906.65371875255,4349,6,1192.6842105263158,36,2,18,30.124159384327687,0.6820023148148149,39.04842342342342,1043.8063063063062,28.994619619619616,0
4498,4,0,0,37,0.0,0.0,1.0,37,1150,800,350,0.6956521739130435,15,8,7,348.5945128408215,0.372997997997998,0.2115398450802175,0.2324650982080509,136116.36231138554,2089.8834019204464,138206.24571330598,4350,15,1225.7567567567567,35,2,20,30.02624963028689,0.6833333333333333,39.120370370370374,1043.5185185185192,29.814814814814834,0
4499,4,0,0,37,0.0,0.0,1.0,37,600,200,400,0.3333333333333333,10,2,8,348.54413291449106,0.37256006006006004,0.21047930485659228,0.23262934466987134,136146.55838745268,2090.6168284893506,138237.17521594203,4351,16,1226.7567567567567,35,2,21,29.997620235850803,0.6836309523809524,39.091435185185176,1043.634259259258,29.818121693121658,0
4500,4,0,1,36,0.0,0.02702702702702703,0.972972972972973,37,550,300,250,0.5454545454545454,8,3,5,355.60522967893064,0.37256006006006004,0.18614593145424219,0.22481483164447688,134190.7793209879,2144.9975619427582,136335.77688293066,4352,17,1227.7567567567567,35,2,21,31.761058981233234,0.6642857142857141,40.972222222222236,1036.1111111111131,29.60317460317466,4
4501,4,0,0,36,0.0,0.0,1.0,36,1000,600,400,0.6,14,6,8,362.4250082595928,0.37190806878306876,0.17014726337684882,0.22983499977540242,134303.87081916103,2535.016298185947,136838.88711734698,4353,18,1181.1666666666667,34,2,21,31.471325753225383,0.6675857843137254,40.86309523809524,1036.5476190476193,30.486694677871157,0
4502,4,0,0,36,0.0,0.0,1.0,36,650,500,150,0.7692307692307693,8,5,3,362.41120635452086,0.3717427248677249,0.16921801250159474,0.23040887644874997,134396.4356575963,2541.3548752834354,136937.79053287974,4354,19,1182.1666666666667,34,2,21,31.379161882893218,0.6685049019607843,40.77380952380952,1036.9047619047612,30.497198879551803,0
4503,4,0,0,36,0.0,0.0,1.0,36,950,700,250,0.7368421052631579,12,7,5,359.4636569993156,0.3712632275132275,0.16820314691556382,0.22930939290571278,134519.90504535145,2471.0034013605446,136990.90844671198,4355,20,1183.1666666666667,34,2,23,31.33224313365466,0.6697303921568627,40.654761904761905,1037.3809523809523,30.511204481792713,0
4504,4,0,0,36,0.0,0.0,1.0,36,800,500,300,0.625,11,5,6,361.5274470694281,0.3710648148148148,0.17008870536055687,0.23140941876294216,134643.43112244885,2535.4591836734526,137178.8903061223,4356,21,1184.1666666666667,34,2,23,31.15536820371645,0.6709558823529412,40.53571428571428,1037.8571428571418,30.52521008403358,0
4505,4,0,0,36,0.0,0.0,1.0,36,1300,900,400,0.6923076923076923,17,9,8,360.50791417703476,0.3701719576719577,0.16965684588635455,0.23173990680665232,134797.91843820843,2519.143282312905,137317.06172052133,4357,22,1185.1666666666667,34,2,16,31.027647216171815,0.6724877450980393,40.38690476190475,1038.4523809523796,30.542717086834696,0
4506,4,0,0,36,0.0,0.0,1.0,36,750,600,150,0.8,9,6,3,360.4690250361542,0.3701884920634921,0.16957053339446837,0.23191237274449883,134828.82653061204,2520.32312925168,137349.14965986373,4358,23,1186.1666666666667,34,2,17,30.997822099954153,0.6727941176470589,40.35714285714285,1038.5714285714268,30.546218487394906,0
4507,4,0,0,36,0.0,0.0,1.0,36,950,600,350,0.631578947368421,13,6,7,362.2258190984994,0.3698247354497355,0.17555033548502097,0.2336396691258389,134921.57206632636,2574.415391156441,137495.9874574828,4359,24,1187.1666666666667,34,2,18,30.859688323593453,0.6737132352941178,40.26785714285713,1038.92857142857,30.55672268907559,0
4508,4,0,0,36,0.0,0.0,1.0,36,1100,800,300,0.7272727272727273,14,8,6,361.1838822093273,0.3697751322751323,0.17791399327833823,0.23316663638483764,134952.49433106554,2548.5331632652833,137501.02749433083,4360,25,1188.1666666666667,34,2,18,30.855913916895805,0.6740196078431373,40.23809523809523,1039.0476190476174,30.560224089635806,0
4509,4,0,0,36,0.0,0.0,1.0,36,750,500,250,0.6666666666666666,10,5,5,359.7160060829597,0.37003968253968256,0.17239404352806442,0.2326163506003138,135014.3494897957,2513.3645124716304,137527.71400226734,4361,26,1189.1666666666667,34,2,18,30.8323787705231,0.6746323529411766,40.178571428571416,1039.2857142857129,30.56722689075626,0
4510,4,0,1,35,0.0,0.027777777777777776,0.9722222222222222,36,350,100,250,0.2857142857142857,6,1,5,368.37685820931097,0.37003968253968256,0.14403956539565432,0.2268866558516436,133226.30385487515,2615.497448979578,135841.80130385474,4362,27,1190.1666666666667,34,2,16,32.39713061193113,0.6568627450980392,41.9047619047619,1032.3809523809514,30.364145658263276,7
4511,4,0,0,35,0.0,0.0,1.0,35,850,700,150,0.8235294117647058,10,7,3,371.76463207389355,0.37065826330532214,0.13717676981771976,0.21234691696424077,130359.27456382,2692.8203064972517,133052.09487031726,4363,28,1220.8,32,3,22,35.205705984174074,0.6328125,44.696969696969695,1021.212121212121,31.912878787878782,5
4512,4,0,0,35,0.0,0.0,1.0,35,1000,700,300,0.7,13,7,6,369.2665666026964,0.3703781512605042,0.13656697231982196,0.21124480663235917,130419.0113928536,2631.8761113513933,133050.887504205,4364,29,1221.8,33,2,23,35.20883323335333,0.6309974747474747,44.63848039215686,1021.4460784313717,30.952911467617323,0
4513,4,0,0,35,0.0,0.0,1.0,35,550,300,250,0.5454545454545454,8,3,5,371.4926785219183,0.3701680672268908,0.14244246817114758,0.21286147497163102,130481.60750973185,2694.592374327185,133176.19988405902,4365,30,1222.8,33,2,23,35.08843608812123,0.6316287878787878,44.57720588235294,1021.6911764705883,30.960338680926917,0
4514,4,1,0,36,0.027777777777777776,0.0,1.0,36,650,400,250,0.6153846153846154,9,4,5,363.3584334954,0.37432208994709,0.14839053713399308,0.21030745696248904,130870.93431122444,2310.611536281176,133181.54584750562,4366,0,1189.8055555555557,34,2,18,34.901590071747144,0.6332720588235294,44.19642857142857,1023.2142857142852,30.094537815126035,0
4515,4,0,0,36,0.0,0.0,1.0,36,700,600,100,0.8571428571428571,8,6,2,361.31676381027603,0.37374338624338627,0.1460804838334493,0.20962223584620474,130962.30867346935,2263.7755102040765,133226.08418367343,4367,1,1190.8055555555557,34,2,20,34.86130495464061,0.6341911764705883,44.107142857142854,1023.5714285714283,30.105042016806717,0
4516,4,2,1,37,0.05263157894736842,0.02631578947368421,0.9736842105263158,38,650,400,250,0.6153846153846154,9,4,5,344.22248201105106,0.3831495969653864,0.14536251021819768,0.20261196725966926,131516.61169982693,1455.7255132445064,132972.33721307144,4368,0,1129.078947368421,33,5,21,34.73914774990043,0.6420454545454546,43.56617647058823,1025.7352941176466,31.082887700534744,0
4517,4,0,0,37,0.0,0.0,1.0,37,950,700,250,0.7368421052631579,12,7,5,353.6678892236798,0.3770332832832833,0.14824943111501443,0.20820274869950547,131522.32552800738,1903.044651056018,133425.3701790634,4369,1,1160.5945945945946,32,5,22,34.49116814377153,0.64453125,43.56060606060606,1025.757575757576,32.05492424242425,0
4518,4,0,0,37,0.0,0.0,1.0,37,850,600,250,0.7058823529411765,11,6,5,353.37963137682146,0.3764702202202202,0.14207981055138275,0.20838627609347274,131587.09092184482,1900.039536781975,133487.1304586268,4370,2,1161.5945945945946,32,5,17,34.43319796537861,0.6451822916666666,43.497474747474755,1026.010101010102,32.06281565656569,0
4519,4,0,0,37,0.0,0.0,1.0,37,600,300,300,0.5,9,3,6,352.2113231316869,0.37559434434434436,0.14424167062867976,0.20822733423545314,131684.2689043209,1876.1381172839374,133560.40702160483,4371,3,1162.5945945945946,32,5,17,34.36513306269734,0.6461588541666667,43.40277777777777,1026.3888888888882,32.07465277777776,0
4520,4,0,0,37,0.0,0.0,1.0,37,1050,800,250,0.7619047619047619,13,8,5,350.832869721658,0.3761886886886887,0.14246444205858788,0.20776562736393303,131749.0741537853,1844.3811537088031,133593.4553074941,4372,4,1163.5945945945946,32,5,17,34.33515762718813,0.6468098958333334,43.339646464646464,1026.641414141414,32.08254419191919,0
4521,4,0,0,37,0.0,0.0,1.0,37,1000,800,200,0.8,12,8,4,353.50780676731415,0.3773460960960961,0.15690291490721409,0.20435941818288378,130824.41332572464,1849.4902852795149,132673.90361100415,4373,5,1164.5945945945946,35,2,19,35.2006495832862,0.6306547619047618,44.24189814814816,1023.0324074074089,29.229497354497397,6
4522,4,1,0,38,0.02631578947368421,0.0,1.0,38,700,500,200,0.7142857142857143,9,5,4,350.1822632833634,0.38135668563300146,0.16744827149149177,0.1955792667497197,129481.87183114664,1471.3545518572766,130953.22638300392,4374,0,1134.921052631579,33,5,20,36.64747641982742,0.6215277777777778,45.557598039215684,1017.769607843137,30.84150326797385,3
4523,4,2,2,38,0.05,0.05,0.95,40,1050,900,150,0.8571428571428571,12,9,3,334.0718744223873,0.3910122863247863,0.15692189805880385,0.18876453763866638,129937.87140185609,681.7176515346353,130619.58905339072,4375,0,1079.125,35,5,20,36.59479414992245,0.6217261904761905,45.1099537037037,1019.5601851851848,29.130291005290992,0
4524,4,1,0,39,0.02564102564102564,0.0,1.0,39,650,500,150,0.7692307692307693,8,5,3,342.6665153564529,0.38284412955465585,0.1754307183378987,0.19372532699854925,129958.94451530617,1106.5157312925196,131065.46024659868,4376,0,1107.7692307692307,34,5,21,36.3543490951547,0.6240808823529411,45.089285714285715,1019.6428571428576,29.98949579831934,0
4525,4,1,0,40,0.025,0.0,1.0,40,1250,1000,250,0.8,15,10,5,336.10659103792193,0.3860576923076923,0.1602071656225963,0.19641836042736344,131241.5683208545,822.2312261585771,132063.7995470131,4377,0,1081.05,36,4,20,35.2245668022127,0.6328125,43.83445945945945,1024.6621621621612,28.46283783783781,2
4526,4,0,0,40,0.0,0.0,1.0,40,650,500,150,0.7692307692307693,8,5,3,335.6758845550054,0.3859909188034188,0.16222527472527482,0.19631430266391703,131270.4173768363,812.8626937748522,132083.28007061116,4378,1,1082.05,36,4,20,35.20650183150183,0.6331018518518519,43.806306306306304,1024.7747747747746,28.465965965965964,0
4527,4,1,1,40,0.024390243902439025,0.024390243902439025,0.975609756097561,41,850,500,350,0.5882352941176471,12,5,7,328.2605869395245,0.39021849593495933,0.16640813228159357,0.19406765899864672,131684.26890432087,445.3764434479395,132129.64534776882,4379,0,1056.6341463414635,35,6,17,34.97970230040596,0.6392857142857145,43.40277777777777,1026.388888888888,29.3253968253968,0
4528,4,1,1,40,0.024390243902439025,0.024390243902439025,0.975609756097561,41,1350,1300,50,0.9629629629629629,14,13,1,328.50328832217633,0.3885416666666666,0.17093777561634993,0.19558173644775018,131951.69331114952,469.3130304783721,132421.0063416279,4380,0,1057.4878048780488,35,6,18,34.704503210544104,0.6419642857142858,43.1423611111111,1027.430555555554,29.35515873015869,0
4529,4,0,0,40,0.0,0.0,1.0,40,850,700,150,0.8235294117647058,10,7,3,332.76089633161433,0.3880074786324786,0.16205098493626924,0.19805010588564342,131938.95266439897,780.8248299319588,132719.77749433092,4381,1,1049.95,34,6,19,34.607956740054085,0.6439950980392157,43.1547619047619,1027.3809523809514,30.217086834733863,0
4530,4,0,0,40,0.0,0.0,1.0,40,1050,700,350,0.6666666666666666,14,7,7,330.90782282006035,0.38758012820512816,0.1626708362288627,0.19758355063820182,132061.28826530598,740.0226757369447,132801.31094104293,4382,2,1050.95,34,6,20,34.53256505289166,0.6452205882352942,43.03571428571428,1027.8571428571418,30.23109243697476,0
4531,4,0,1,39,0.0,0.025,0.975,40,1250,900,350,0.72,16,9,7,327.51841126034947,0.38826121794871793,0.08714531384350788,0.18580678648574955,130094.74068944292,521.6845567867001,130616.42524622961,4383,3,1051.95,37,3,21,36.60298437947834,0.6193693693693694,44.95614035087719,1020.1754385964914,27.572309151256526,8
4532,4,0,1,38,0.0,0.02564102564102564,0.9743589743589743,39,1650,1400,250,0.8484848484848485,19,14,5,334.3480085436199,0.385768106162843,0.0955932318564825,0.18924097283568922,130004.05811216646,893.3195864783952,130897.37769864485,4384,5,1079.8461538461538,36,3,21,36.52067689929328,0.6203703703703702,45.04504504504506,1019.8198198198218,28.328328328328382,0
4533,4,0,0,38,0.0,0.0,1.0,38,1100,800,300,0.7272727272727273,14,8,6,343.34474419611377,0.38080844001896635,0.10702550928968235,0.1941506544523598,129967.37423911194,1324.7229723937055,131292.09721150566,4385,8,1109.1315789473683,35,3,21,36.328509269769185,0.6220238095238094,45.081018518518526,1019.6759259259271,29.13359788359792,0
4534,4,1,1,38,0.02564102564102564,0.02564102564102564,0.9743589743589743,39,850,600,250,0.7058823529411765,11,6,5,334.0274885464388,0.38396873594242015,0.10695970695970702,0.19031798766018063,130262.58680555588,902.2569444444841,131164.84375000038,4386,0,1081.6666666666667,36,3,22,36.26700680272109,0.6229745370370369,44.791666666666686,1020.833333333336,28.356481481481556,0
4535,4,1,1,38,0.02564102564102564,0.02564102564102564,0.9743589743589743,39,1400,1100,300,0.7857142857142857,17,11,6,331.18015169128194,0.38554318488529016,0.11564043203333241,0.18953534107202688,130435.0819358213,839.5020442740421,131274.58398009534,4387,0,1082.4102564102564,36,3,22,36.16516003380737,0.624710648148148,44.622747747747766,1021.5090090090118,28.37525025025033,0
4536,4,0,0,38,0.0,0.0,1.0,38,900,500,400,0.5555555555555556,13,5,8,340.1117361839397,0.38128259838786155,0.12454589380625958,0.1942269157508674,130351.2158805942,1266.7956693672913,131618.0115499615,4388,2,1111.8947368421052,35,3,22,36.02197381842912,0.625892857142857,44.704861111111114,1021.1805555555561,29.17658730158732,0
4537,4,1,1,38,0.02564102564102564,0.02564102564102564,0.9743589743589743,39,1050,800,250,0.7619047619047619,13,8,5,329.8681334228639,0.38529014844804316,0.10713367845210575,0.1899094979927829,130665.25298524901,820.4606210940951,131485.7136063431,4389,0,1084.3589743589744,36,3,20,35.966011308147,0.6270254629629628,44.397522522522536,1022.4099099099119,28.40027527527533,0
4538,4,0,0,38,0.0,0.0,1.0,38,1000,900,100,0.9,11,9,2,336.8225199723835,0.38106033665244193,0.11883079343699521,0.19352502757814702,130587.7074358068,1196.9761391889663,131784.68357499578,4390,4,1113.8947368421052,35,3,20,35.86666761031216,0.6282738095238094,44.47337962962963,1022.1064814814819,29.20304232804234,0
4539,4,0,1,37,0.0,0.02631578947368421,0.9736842105263158,38,1200,1000,200,0.8333333333333334,14,10,4,335.93374108894193,0.3811344238975818,0.11781633163733396,0.19345754033766072,130676.4470271777,1179.7255444101563,131856.17257158784,4391,5,1114.8947368421052,35,3,20,35.799656629688336,0.6291666666666667,44.386574074074076,1022.4537037037042,29.212962962962976,0
4540,4,2,1,38,0.05128205128205128,0.02564102564102564,0.9743589743589743,39,900,700,200,0.7777777777777778,11,7,4,328.55403910102154,0.38765182186234814,0.12215950448408974,0.1906185180241166,130963.11034404817,805.6917753539582,131768.80211940213,4392,0,1087.128205128205,37,2,21,35.69887073736834,0.6280968468468469,44.10635964912281,1023.5745614035087,27.664177335229965,0
4541,4,0,1,37,0.0,0.02631578947368421,0.9736842105263158,38,1050,900,150,0.8571428571428571,12,9,3,334.27124846692766,0.38208274063537223,0.13171216254568407,0.19359610164556867,130895.6269402849,1150.9289272380513,132046.55586752295,4393,1,1116.7368421052631,36,2,21,35.62071273981146,0.6293402777777778,44.1722972972973,1023.310810810811,28.425300300300304,0
4542,4,0,0,37,0.0,0.0,1.0,37,1000,700,300,0.7,13,7,6,341.8960809158099,0.3811936936936937,0.14067263326229273,0.1976467926235999,130824.41332572441,1545.670840835042,132370.08416655945,4394,2,1147.4594594594594,35,2,21,35.49762887958668,0.6306547619047619,44.241898148148145,1023.032407407407,29.229497354497344,0
4543,4,0,0,37,0.0,0.0,1.0,37,600,500,100,0.8333333333333334,7,5,2,341.82329168091104,0.3809434434434435,0.13908784930162632,0.19790829873941926,130883.62328800143,1547.81418788579,132431.4374758872,4395,3,1148.4594594594594,35,2,21,35.439642008822524,0.6312500000000001,44.18402777777777,1023.263888888888,29.236111111111086,0
4544,4,2,1,38,0.05128205128205128,0.02564102564102564,0.9743589743589743,39,800,600,200,0.75,10,6,4,328.2801592624418,0.3877923976608187,0.14500442086649,0.1928592987254061,131443.5782911289,830.8172835349378,132274.39557466385,4396,0,1090.5128205128206,36,3,22,35.221511457646976,0.634837962962963,43.637387387387385,1025.45045045045,28.484734734734722,0
4545,4,0,0,38,0.0,0.0,1.0,38,550,300,250,0.5454545454545454,8,3,5,334.9056198866375,0.3843646277856804,0.14978978596915304,0.1960113213240055,131299.269603218,1194.5726554256871,132493.8422586437,4397,1,1120.2105263157894,36,2,22,35.19713950847891,0.6333912037037037,43.77815315315315,1024.8873873873868,28.469094094094075,0
4546,4,0,0,38,0.0,0.0,1.0,38,750,500,250,0.6666666666666666,10,5,5,336.2491270956063,0.383979374110953,0.15220491671767178,0.1970985121565707,131357.78523930465,1233.7912951857852,132591.57653449042,4398,2,1121.2105263157894,35,3,22,35.103707989913815,0.6360119047619048,43.72106481481481,1025.1157407407402,29.289021164021147,0
4547,4,0,0,38,0.0,0.0,1.0,38,1350,1000,350,0.7407407407407407,17,10,7,331.5768770171014,0.3837274774774775,0.15025541455747415,0.19509058112866665,131501.32395909424,1120.5596643941242,132621.88362348836,4399,3,1122.2105263157894,36,2,22,35.078822646757416,0.6354166666666667,43.58108108108108,1025.6756756756758,28.490990990990994,0
4548,4,0,0,38,0.0,0.0,1.0,38,850,600,250,0.7058823529411765,11,6,5,331.00546617570615,0.38442389758179235,0.1480425627783648,0.19519681568458627,131587.96623904307,1111.2672216135052,132699.23346065657,4400,4,1123.2105263157894,36,2,19,35.00621958804375,0.6362847222222223,43.49662162162162,1026.0135135135133,28.50037537537537,0
4549,4,0,0,38,0.0,0.0,1.0,38,950,700,250,0.7368421052631579,12,7,5,329.35486818265997,0.3835793029871977,0.14722757760820127,0.19525732692389433,131790.2425229284,1081.1515907799776,132871.39411370837,4401,5,1124.2105263157894,36,2,20,34.844995247495795,0.6383101851851851,43.29954954954955,1026.8018018018024,28.52227227227229,0
4550,4,0,0,38,0.0,0.0,1.0,38,750,600,150,0.8,9,6,3,330.4865631083882,0.38300142247510666,0.14928822439829426,0.1963757617010821,131876.9799148812,1116.7139690366116,132993.69388391782,4402,6,1125.2105263157894,36,2,20,34.72869385666777,0.6391782407407407,43.215090090090094,1027.1396396396403,28.531656656656676,0
4551,4,0,0,38,0.0,0.0,1.0,38,950,700,250,0.7368421052631579,12,7,5,327.9129323904185,0.3817419393077288,0.14190802449911732,0.19559041967287313,132021.60564280496,1058.3183690447183,133079.92401184968,4403,7,1126.2105263157894,36,2,21,34.649399152604275,0.640625,43.07432432432432,1027.7027027027027,28.5472972972973,0
4552,4,0,0,38,0.0,0.0,1.0,38,950,700,250,0.7368421052631579,12,7,5,329.1871530500866,0.3813270507349455,0.14121961345080458,0.19665054535609908,132079.4781267756,1095.7734761788984,133175.2516029545,4404,8,1127.2105263157894,36,2,21,34.558501314636274,0.6412037037037037,43.018018018018026,1027.9279279279292,28.553553553553588,0
4553,4,0,1,37,0.0,0.02631578947368421,0.9736842105263158,38,550,400,150,0.7272727272727273,7,4,3,329.43835483325336,0.3808528923660503,0.1441574912088548,0.1971017155719268,132137.36329234642,1106.2231150069053,133243.58640735332,4405,9,1128.2105263157894,36,2,21,34.49388462942681,0.6417824074074074,42.961711711711715,1028.1531531531532,28.55980980980981,0
4554,4,0,0,37,0.0,0.0,1.0,37,1000,700,300,0.7,13,7,6,333.71207202582656,0.3756569069069069,0.14991753744286918,0.19946370280843823,132100.3796403464,1416.6982810356621,133517.07792138206,4406,10,1159.3513513513512,35,2,21,34.421207685956595,0.6434523809523809,42.99768518518518,1028.0092592592594,29.371693121693124,0
4555,4,0,0,37,0.0,0.0,1.0,37,1250,900,350,0.72,16,9,7,337.37618273021695,0.37493743743743746,0.15512035829281934,0.20276787615205533,132308.6811583719,1527.5595582561814,133836.2407166281,4407,11,1160.3513513513512,35,2,23,34.117659466756685,0.6455357142857142,42.79513888888889,1028.8194444444446,29.394841269841272,0
4556,4,0,0,37,0.0,0.0,1.0,37,650,400,250,0.6153846153846154,9,4,5,337.81901030995414,0.3754066566566567,0.15931721194879045,0.2035153549916066,132398.0034722223,1545.3426408179062,133943.3461130402,4408,12,1161.3513513513512,34,3,23,34.01653171390013,0.6485906862745099,42.708333333333336,1029.1666666666672,30.26960784313727,0
4557,4,0,0,37,0.0,0.0,1.0,37,750,300,450,0.4,12,3,9,358.9634767006538,0.3754066566566567,0.20154254974398866,0.20618150108012764,130575.52984429065,1991.7303440984233,132567.26018838907,4409,13,1162.3513513513512,33,4,15,35.31324940047962,0.6325757575757576,44.48529411764706,1022.0588235294117,30.971479500891263,4
4558,4,0,0,37,0.0,0.0,1.0,37,1100,700,400,0.6363636363636364,15,7,8,358.75603535741556,0.37690815815815815,0.19958032762130085,0.2069894627102457,130749.1514314059,1981.409438775509,132730.56087018142,4410,14,1163.3513513513512,34,3,16,35.14263958406083,0.632046568627451,44.31547619047619,1022.7380952380953,30.080532212885156,0
4559,4,1,1,37,0.02631578947368421,0.02631578947368421,0.9736842105263158,38,650,400,250,0.6153846153846154,9,4,5,350.1784549625306,0.3807195353247985,0.19217815596084575,0.2033702189194735,131002.08340031287,1574.8214323988213,132576.90483271168,4411,0,1133.7105263157894,35,3,16,35.106109854908595,0.6324404761904763,44.06828703703703,1023.7268518518514,29.249338624338613,0
4560,4,0,0,37,0.0,0.0,1.0,37,950,800,150,0.8421052631578947,11,8,3,360.3225210036837,0.37747122122122123,0.20205830394246327,0.20904541400740026,130962.30867346934,2037.7338435374093,133000.04251700675,4412,16,1165.3513513513512,34,3,17,34.88674691788787,0.6341911764705883,44.107142857142854,1023.5714285714282,30.105042016806713,0
4561,4,1,1,37,0.02631578947368421,0.02631578947368421,0.9736842105263158,38,1050,700,350,0.6666666666666666,14,7,7,356.45535815913644,0.38137150308202944,0.19971767363071713,0.2086194445802481,131298.46810967507,1760.4084951560326,133058.8766048311,4413,0,1135.657894736842,35,3,17,34.64579804253717,0.6354166666666666,43.77893518518518,1024.8842592592591,29.282407407407405,0
4562,4,2,1,38,0.05128205128205128,0.02564102564102564,0.9743589743589743,39,950,600,350,0.631578947368421,13,6,7,349.1949112391839,0.38824224021592446,0.2074478525417982,0.206499212942678,131694.4515306123,1397.4131605445746,133091.8646911569,4414,0,1107.4871794871794,34,5,15,34.43226629552308,0.6415441176470588,43.392857142857146,1026.428571428572,30.18907563025212,0
4563,4,0,0,38,0.0,0.0,1.0,38,650,300,350,0.46153846153846156,10,3,7,357.42318030058414,0.38229018492176386,0.2126076840847635,0.21038199853135647,131516.61169982696,1801.4171232218312,133318.02882304878,4415,1,1137.6315789473683,33,5,18,34.400637196336106,0.6420454545454546,43.56617647058823,1025.7352941176468,31.08288770053475,0
4564,4,1,0,39,0.02564102564102564,0.0,1.0,39,800,500,300,0.625,11,5,6,351.9866364395658,0.3853744939271255,0.21688250897175876,0.20907158043940463,131862.52170138885,1482.7690972222185,133345.29079861107,4416,0,1109.4358974358975,35,4,16,34.19117647058823,0.6410714285714285,43.229166666666664,1027.083333333333,29.345238095238088,0
4565,4,0,0,39,0.0,0.0,1.0,39,1000,800,200,0.8,12,8,4,351.06658083009916,0.3853744939271255,0.22020844343177992,0.20934319484153463,132011.15779588904,1468.9411597650897,133480.09895565413,4417,1,1110.4358974358975,35,4,16,34.06504580095356,0.6425595238095239,43.08449074074074,1027.662037037037,29.361772486772484,0
4566,4,0,0,39,0.0,0.0,1.0,39,750,400,350,0.5333333333333333,11,4,7,351.20409430662215,0.3846434997750787,0.22235892941414392,0.20980307413814472,132079.4781267756,1477.3706984011212,133556.8488251767,4418,2,1111.4358974358975,36,3,16,33.99270559450774,0.6412037037037037,43.018018018018026,1027.9279279279292,28.553553553553588,0
4567,4,1,1,39,0.025,0.025,0.975,40,750,700,50,0.9333333333333333,8,7,1,341.2249105876827,0.387767094017094,0.21228687127024726,0.20525990775351383,132341.58587257622,1031.6491612803968,133373.23503385662,4419,0,1084.625,37,3,17,33.98559605001421,0.6418918918918919,42.76315789473684,1028.947368421053,27.809388335704135,0
4568,4,1,0,40,0.025,0.0,1.0,40,1150,800,350,0.6956521739130435,15,8,7,346.70522669271463,0.388394764957265,0.23036015282616096,0.2100292588385611,132606.5394188312,1195.100107888703,133801.6395267199,4420,0,1085.6,35,5,20,33.57832808929842,0.6485119047619048,42.505787037037024,1029.97685185185,29.427910052909997,0
4569,4,0,0,40,0.0,0.0,1.0,40,700,300,400,0.42857142857142855,11,3,8,347.47234749075005,0.3881543803418803,0.2333923154701718,0.21082831390696413,132666.15125868045,1219.5638020833144,133885.71506076376,4421,1,1086.6,35,5,14,33.498693966969995,0.6491071428571429,42.44791666666666,1030.2083333333323,29.434523809523782,0
4570,4,0,0,40,0.0,0.0,1.0,40,600,400,200,0.6666666666666666,8,4,4,359.15793582285573,0.3881543803418803,0.19949863013698588,0.2140637599205462,131992.67415642014,1483.6846850017414,133476.35884142187,4422,2,1087.6,36,4,15,33.87579908675797,0.6403356481481481,43.102477477477485,1027.5900900900915,28.54416916916921,3
4571,4,0,1,39,0.0,0.025,0.975,40,1050,800,250,0.7619047619047619,13,8,5,363.2704671119003,0.3882211538461538,0.1981653888280388,0.2173433397596105,132137.36329234674,1600.320337229156,133737.68362957588,4423,3,1088.6,36,4,15,33.62426980649873,0.6417824074074072,42.96171171171173,1028.1531531531557,28.55980980980988,0
4572,4,0,0,39,0.0,0.0,1.0,39,1100,700,400,0.6363636363636364,15,7,8,371.16780591650695,0.38346266306792626,0.20553236450556867,0.22185144361712109,132100.37964034657,2006.281614369024,134106.66125471558,4424,8,1117.4358974358975,35,4,16,33.45858665465736,0.6434523809523809,42.9976851851852,1028.009259259261,29.37169312169317,0
4573,4,0,0,39,0.0,0.0,1.0,39,650,400,250,0.6153846153846154,9,4,5,373.3198435406606,0.3830409356725146,0.20269663173736752,0.22369795349168756,132195.26113951812,2070.2228410843536,134265.48398060247,4425,9,1118.4358974358975,36,3,16,33.30755402248504,0.6423611111111109,42.90540540540542,1028.3783783783801,28.566066066066114,0
4574,4,0,0,39,0.0,0.0,1.0,39,1100,700,400,0.6363636363636364,15,7,8,369.7574511475516,0.38284412955465585,0.19896386648304776,0.22242332830568123,132341.5858725763,1986.857494613743,134328.44336719005,4426,10,1119.4358974358975,37,2,16,33.251633986928105,0.6418918918918918,42.76315789473685,1028.9473684210539,27.80938833570416,0
4575,4,1,1,39,0.025,0.025,0.975,40,1100,700,400,0.6363636363636364,15,7,8,362.89160100350915,0.3882879273504274,0.19294271110637817,0.21944076143103408,132539.10007165698,1619.4772670437353,134158.5773387007,4427,0,1092.425,37,3,16,33.22939960245625,0.6438626126126125,42.571271929824576,1029.714912280704,27.830132764343354,0
4576,4,0,0,39,0.0,0.0,1.0,39,1000,700,300,0.7,13,7,6,370.34772215266565,0.3830409356725146,0.20007376746854622,0.2229450527519417,132369.79316953314,2004.5702764312275,134374.36344596435,4428,12,1121.4358974358975,37,2,16,33.20802255372047,0.6421734234234233,42.735745614035096,1029.057017543861,27.812351825509758,0
4577,4,0,1,38,0.0,0.02564102564102564,0.9743589743589743,39,800,700,100,0.875,9,7,2,365.9565781012358,0.38315339631129103,0.19814860326042405,0.22112820259785113,132510.87474030486,1898.6452562327001,134409.51999653757,4429,13,1122.4358974358975,37,2,17,33.178913738019176,0.6435810810810809,42.59868421052632,1029.605263157896,27.827169274537727,0
4578,4,0,0,38,0.0,0.0,1.0,38,1250,900,350,0.72,16,9,7,374.51711251894875,0.38116405879563775,0.20107335040718288,0.22666836492295073,132571.90626014528,2330.0895067364713,134901.99576688174,4430,14,1150.5,36,2,19,32.89707490431931,0.6461226851851851,42.539414414414416,1029.8423423423424,28.60673173173173,0
4579,4,0,0,38,0.0,0.0,1.0,38,1150,1000,150,0.8695652173913043,13,10,3,372.1267281794022,0.38114924134660977,0.19623813632441767,0.22609293245959702,132716.9124360848,2277.5020797824945,134994.41451586728,4431,15,1151.5,36,2,14,32.81261384335155,0.6475694444444444,42.39864864864865,1030.4054054054059,28.622372372372386,0
4580,4,0,0,38,0.0,0.0,1.0,38,800,400,400,0.5,12,4,8,371.186602744793,0.3805269084874348,0.19499436665057113,0.22657230231542153,132891.0244704163,2265.473581689792,135156.4980521061,4432,16,1152.5,36,2,15,32.66164263870687,0.6493055555555556,42.229729729729726,1031.0810810810806,28.641141141141127,0
4581,4,0,0,38,0.0,0.0,1.0,38,1050,900,150,0.8571428571428571,12,9,3,371.57639061040015,0.3802898293029872,0.19338657779820667,0.22751602526679582,133007.16256797343,2284.4642784676594,135291.6268464411,4433,17,1153.5,36,2,16,32.534798034934475,0.650462962962963,42.11711711711712,1031.531531531532,28.653653653653667,0
4582,4,1,1,38,0.02564102564102564,0.02564102564102564,0.9743589743589743,39,650,400,250,0.6153846153846154,9,4,5,367.5536122880488,0.3835470085470085,0.19041627517463966,0.22632552385166657,133217.40974386354,1992.908034202838,135210.31777806638,4434,0,1124.8974358974358,37,2,16,32.427310143388226,0.6506193693693694,41.91337719298246,1032.3464912280706,27.901256519677585,0
4583,4,0,0,38,0.0,0.0,1.0,38,1250,800,450,0.64,17,8,9,379.600516564684,0.379208155523945,0.1989749332414501,0.23333593120827167,133152.40652392263,2508.9444596623716,135661.350983585,4435,19,1155.5,36,2,16,32.1817603200582,0.6519097222222222,41.976351351351354,1032.094594594595,28.669294294294307,0
4584,4,0,0,38,0.0,0.0,1.0,38,1100,700,400,0.6363636363636364,15,7,8,379.8919952574,0.37904516358463725,0.19967284623773174,0.23442864041119527,133297.7297398751,2527.7481028325724,135825.47784270768,4436,20,1156.5,36,2,18,32.02812613595057,0.6533564814814814,41.83558558558559,1032.6576576576583,28.684934934934954,0
4585,4,1,1,38,0.02564102564102564,0.02564102564102564,0.9743589743589743,39,650,500,150,0.7692307692307693,8,5,3,376.08328803683617,0.3834907782276203,0.19539372399784272,0.23335472172508748,133501.31539901384,2241.6368649054366,135742.9522639193,4437,0,1127.820512820513,36,3,18,31.92196977952125,0.6553819444444444,41.63851351351351,1033.4459459459456,28.70683183183182,0
4586,4,0,0,38,0.0,0.0,1.0,38,1350,900,450,0.6666666666666666,18,9,9,381.7187643547094,0.3784821005215742,0.20422131194565885,0.2362947330762552,133414.04537983923,2585.3289099910626,135999.3742898303,4438,22,1158.5,36,2,18,31.864054211176512,0.654513888888889,41.72297297297297,1033.1081081081074,28.69744744744743,0
4587,4,0,0,38,0.0,0.0,1.0,38,1400,1100,300,0.7857142857142857,17,11,6,380.0212928977276,0.37783013276434324,0.20370719632227252,0.23599375143092535,133532.02830289773,2549.015489385144,136081.04379228287,4439,23,1159.5,35,3,19,31.78938036580813,0.6577380952380952,41.60879629629629,1033.5648148148143,29.530423280423268,0
4588,4,0,0,38,0.0,0.0,1.0,38,800,500,300,0.625,11,5,6,384.48685413078476,0.37754860123281175,0.20992240480300772,0.23934641588503808,133621.76254125926,2675.162224579889,136296.92476583915,4440,24,1160.5,35,3,19,31.583851076532707,0.6586309523809524,41.52199074074073,1033.9120370370358,29.54034391534388,0
4589,4,0,0,38,0.0,0.0,1.0,38,1300,1000,300,0.7692307692307693,16,10,6,385.97473350715865,0.3771337126600285,0.2107118248794193,0.2410521448884329,133741.45507812497,2724.1644965277774,136465.61957465275,4441,25,1161.5,35,3,15,31.42518462571333,0.6598214285714286,41.40625,1034.3749999999998,29.553571428571423,0
4590,4,0,0,38,0.0,0.0,1.0,38,750,500,250,0.6666666666666666,10,5,5,386.33766911382986,0.3767484589853011,0.21153019588909627,0.2416705685240395,133801.32144043632,2738.4981299296915,136539.819570366,4442,26,1162.5,35,3,16,31.355693216989224,0.6604166666666667,41.348379629629626,1034.606481481481,29.560185185185173,0
4591,4,0,0,38,0.0,0.0,1.0,38,1300,1100,200,0.8461538461538461,15,11,4,386.01473995709455,0.37654101469890944,0.2072622278209788,0.2418610924986951,133861.2011986667,2734.47935420952,136595.68055287623,4443,27,1163.5,35,3,16,31.303941579987328,0.6610119047619047,41.29050925925925,1034.837962962962,29.56679894179891,0
4592,4,0,0,38,0.0,0.0,1.0,38,650,300,350,0.46153846153846156,10,3,7,386.9195247071021,0.3769707207207207,0.2092317107616981,0.24302024079917994,133951.04595336076,2765.655006858708,136716.70096021946,4444,28,1164.5,35,3,16,31.19036970781155,0.6619047619047619,41.2037037037037,1035.1851851851852,29.57671957671958,0
4593,4,0,0,38,0.0,0.0,1.0,38,800,400,400,0.5,12,4,8,383.4622691599746,0.37631875296348977,0.19900948168364607,0.24163523834108805,134070.88584533596,2682.225222908077,136753.11106824403,4445,29,1165.5,35,3,17,31.159663239457593,0.6630952380952382,41.087962962962955,1035.6481481481471,29.58994708994706,0
4594,4,0,0,38,0.0,0.0,1.0,38,1650,1400,250,0.8484848484848485,19,14,5,378.70819395741705,0.37544452347083923,0.1931900989633526,0.24020613208800454,134310.7263803154,2572.9145233196004,136883.640903635,4446,30,1166.5,35,3,18,31.04250409408961,0.6654761904761906,40.856481481481474,1036.5740740740732,29.616402116402092,0
4595,4,0,0,38,0.0,0.0,1.0,38,1050,800,250,0.7619047619047619,13,8,5,376.1904818617044,0.37599276908487433,0.19257191191683187,0.23941521406112212,134433.9710276155,2514.556067892223,136948.52709550774,4447,31,1167.5,36,2,18,30.984408368624898,0.6646412037037037,40.737612612612615,1037.04954954955,28.806931931931942,0
4596,4,0,0,38,0.0,0.0,1.0,38,950,700,250,0.7368421052631579,12,7,5,381.76803599941906,0.3751926268373637,0.1958359754808705,0.24374420759962934,134550.78125000015,2673.4375000000146,137224.21875000017,4448,32,1168.5,36,2,18,30.722891566265055,0.665798611111111,40.62500000000001,1037.5000000000011,28.819444444444475,0
4597,4,0,1,37,0.0,0.02631578947368421,0.9736842105263158,38,800,300,500,0.375,13,3,10,381.95549658463887,0.37449620673304884,0.1955985770806674,0.24426626122524048,134610.82845721874,2683.0691658093206,137293.89762302805,4449,33,1169.5,35,3,18,30.65794854636033,0.668452380952381,40.567129629629626,1037.731481481481,29.649470899470888,0
4598,4,0,0,37,0.0,0.0,1.0,37,1150,900,250,0.782608695652174,14,9,5,389.23848284914345,0.3736861861861862,0.2055567096292117,0.24893557263360122,134612.54428854873,3079.276502267572,137691.8207908163,4450,34,1196.7027027027027,34,3,18,30.46728614584528,0.6706495098039216,40.56547619047619,1037.7380952380952,30.52170868347339,0
4599,4,1,1,37,0.02631578947368421,0.02631578947368421,0.9736842105263158,38,650,400,250,0.6153846153846154,9,4,5,379.1107018127551,0.37775604551920344,0.19553804276494113,0.244001256302794,134843.0287339704,2624.0870515786,137467.115785549,4451,0,1166.1842105263158,36,2,14,30.499611478550012,0.6686921296296295,40.343468468468465,1038.6261261261257,28.850725725725713,0
4600,4,0,0,37,0.0,0.0,1.0,37,1050,900,150,0.8571428571428571,12,9,3,385.55964028832796,0.37271646646646645,0.20471881352104204,0.24841333607952212,134881.20666420183,3000.9499046210535,137882.1565688229,4452,36,1198.7027027027027,35,2,14,30.293987929433616,0.6711309523809523,40.30671296296296,1038.773148148148,29.6792328042328,0
4601,4,0,0,37,0.0,0.0,1.0,37,600,500,100,0.8333333333333334,7,5,2,385.22108329048416,0.3722472472472473,0.20639532258113147,0.2486074525304582,134941.3275489754,2996.4488758144616,137937.77642478986,4453,37,1199.7027027027027,35,2,14,30.242680368348733,0.6717261904761905,40.24884259259259,1039.0046296296289,29.68584656084654,0
4602,4,0,0,37,0.0,0.0,1.0,37,1250,1000,250,0.8,15,10,5,386.09133883264496,0.37124624624624625,0.20468307951604192,0.24979108232832492,135031.5339934841,3026.9011488340066,138058.4351423181,4454,38,1200.7027027027027,35,2,16,30.129918337045297,0.6726190476190477,40.16203703703703,1039.3518518518508,29.695767195767168,0
4603,4,0,0,37,0.0,0.0,1.0,37,1250,900,350,0.72,16,9,7,383.4121148107839,0.3708083083083083,0.20029247684558316,0.24847096790984552,135091.68836805542,2959.1579861110904,138050.8463541665,4455,39,1201.7027027027027,35,2,16,30.139445557782214,0.6732142857142858,40.10416666666666,1039.5833333333321,29.702380952380917,0
4604,4,0,0,37,0.0,0.0,1.0,37,750,400,350,0.5333333333333333,11,4,7,382.30426863548485,0.37033908908908914,0.19871964573656498,0.24816629692349657,135151.85613854582,2933.826303154994,138085.6824417008,4456,40,1202.7027027027027,35,2,17,30.10815523894331,0.6738095238095239,40.04629629629629,1039.8148148148139,29.70899470899468,0
4605,4,0,0,37,0.0,0.0,1.0,37,800,600,200,0.75,10,6,4,380.9440624883022,0.36986986986986986,0.19882365676758185,0.24811052417716373,135272.23186728387,2906.230709876532,138178.46257716042,4457,41,1203.7027027027027,35,2,17,30.023364485981297,0.675,39.93055555555555,1040.2777777777771,29.722222222222204,0
4606,4,0,0,37,0.0,0.0,1.0,37,1000,800,200,0.8,12,8,4,381.18032963158794,0.36968218218218213,0.1913795952706463,0.24972447669600373,135483.01832829634,2928.6923171724825,138411.71064546882,4458,42,1204.7027027027027,35,2,17,29.806952936816753,0.6770833333333334,39.72800925925925,1041.087962962962,29.745370370370342,0
4607,4,0,0,37,0.0,0.0,1.0,37,1050,800,250,0.7619047619047619,13,8,5,375.8694476182127,0.3693380880880881,0.18144605009343096,0.2378204356555376,134220.76106234986,2689.8966638803035,136910.65772623016,4459,43,1205.7027027027027,35,2,15,31.20613667671917,0.6645833333333333,40.94328703703703,1036.226851851851,29.60648148148146,2
4608,4,0,0,37,0.0,0.0,1.0,37,1050,800,250,0.7619047619047619,13,8,5,377.91203899782977,0.36836836836836834,0.1887275239960291,0.23989781242406527,134340.7215175969,2753.795197830935,137094.51671542783,4460,44,1206.7027027027027,35,2,17,31.03310725317256,0.6657738095238095,40.8275462962963,1036.689814814815,29.619708994709,0
4609,4,1,0,38,0.02631578947368421,0.0,1.0,38,1100,700,400,0.6363636363636364,15,7,8,370.5595092385109,0.37265884305357994,0.18239356275767937,0.23739223813744154,134674.32149943322,2381.2982963890413,137055.61979582228,4461,0,1175.921052631579,34,4,18,30.89015368734946,0.6712622549019608,40.50595238095239,1037.9761904761915,30.528711484593867,0
4610,4,0,0,38,0.0,0.0,1.0,38,950,600,350,0.631578947368421,13,6,7,373.12045500884005,0.3721995021337126,0.18328113024218595,0.23943955026726224,134736.11288265305,2454.559948979588,137190.67283163263,4462,1,1176.921052631579,34,4,18,30.761953904368763,0.671875,40.44642857142857,1038.2142857142856,30.53571428571428,0
4611,4,0,0,38,0.0,0.0,1.0,38,1050,800,250,0.7619047619047619,13,8,5,373.96745639000005,0.3710141062114746,0.18892590290077793,0.2407449034177806,134851.15124528468,2485.988404492465,137337.13964977715,4463,2,1177.921052631579,35,3,15,30.62504643042865,0.6708333333333333,40.33564814814815,1038.6574074074078,29.675925925925938,0
4612,4,0,0,38,0.0,0.0,1.0,38,550,400,150,0.7272727272727273,7,4,3,373.6419768122783,0.37031768610715976,0.1900851884640864,0.24113472507863576,134941.32754897553,2483.948875814478,137425.27642479,4464,3,1178.921052631579,35,3,15,30.543448999294483,0.6717261904761904,40.248842592592595,1039.00462962963,29.68584656084657,0
4613,4,0,0,38,0.0,0.0,1.0,38,1250,900,350,0.72,16,9,7,370.29502744296997,0.3711919155998103,0.18382374486488984,0.23977070234068604,135061.6095062801,2402.528479723944,137464.13798600406,4465,4,1179.921052631579,35,3,16,30.510359833723037,0.6729166666666666,40.133101851851855,1039.4675925925933,29.699074074074094,0
4614,4,0,0,38,0.0,0.0,1.0,38,750,500,250,0.6666666666666666,10,5,5,368.9543415488291,0.37129563774300617,0.18399957810357526,0.23910157978294247,135091.68836805553,2368.5329861111068,137460.22135416663,4466,5,1180.921052631579,35,3,16,30.515197060788232,0.6732142857142858,40.104166666666664,1039.5833333333333,29.70238095238095,0
4615,4,0,0,38,0.0,0.0,1.0,38,950,800,150,0.8421052631578947,11,8,3,370.88878121809654,0.371384542437174,0.18638935420010005,0.24115821910461782,135212.03730495553,2429.7255444101615,137641.7628493657,4467,6,1181.921052631579,35,3,16,30.34488834483269,0.6744047619047618,39.98842592592593,1040.0462962962972,29.715608465608494,0
4616,4,0,0,38,0.0,0.0,1.0,38,1050,700,350,0.6666666666666666,14,7,7,369.3282872462049,0.37068812233285914,0.1828407354723136,0.2411496463784046,135362.54882812515,2398.643663194459,137761.1924913196,4468,7,1182.921052631579,35,3,16,30.235443777110433,0.6758928571428571,39.84375000000001,1040.6250000000011,29.73214285714289,0
4617,4,0,0,38,0.0,0.0,1.0,38,1100,800,300,0.7272727272727273,14,8,6,364.25022998818395,0.37068812233285914,0.20228723343302746,0.2276192253517997,133763.29665814454,2144.662314341359,135907.95897248588,4469,8,1183.921052631579,36,2,15,31.965082734596123,0.6579861111111112,41.38513513513513,1034.4594594594587,28.734984984984962,7
4618,4,0,0,38,0.0,0.0,1.0,38,800,600,200,0.75,10,6,4,372.9738659165827,0.3705547652916074,0.21387528340746598,0.22195959417853808,131934.82069485038,2243.9592464085827,134178.77994125895,4470,9,1184.921052631579,36,2,16,33.579277649895864,0.6397569444444444,43.15878378378379,1027.364864864866,28.537912912912944,5
4619,4,0,0,38,0.0,0.0,1.0,38,900,700,200,0.7777777777777778,11,7,4,373.9386481003835,0.3697842579421527,0.21420002998950327,0.2230434053963467,132021.6056428052,2273.5961468225237,134295.20178962772,4471,10,1185.921052631579,36,2,16,33.466880341880355,0.6406249999999998,43.07432432432434,1027.7027027027045,28.547297297297348,0
4620,4,0,0,38,0.0,0.0,1.0,38,1350,1100,250,0.8148148148148148,16,11,5,368.14898273240124,0.3697842579421527,0.17815255823937304,0.2108793686293903,130469.43486636225,2014.3639450691544,132483.7988114314,4472,11,1186.921052631579,35,3,19,35.186194818926765,0.6270833333333334,44.58912037037037,1021.6435185185181,29.189814814814802,7
4621,4,1,0,39,0.02564102564102564,0.0,1.0,39,650,400,250,0.6153846153846154,9,4,5,359.0693039435647,0.37176675663517766,0.1762580586887068,0.20749271991242604,130809.21292914521,1593.9146071747298,132403.12753631995,4473,0,1157.4615384615386,36,3,15,35.07380192279467,0.6284722222222223,44.25675675675675,1022.9729729729718,28.415915915915882,0
4622,4,1,0,40,0.025,0.0,1.0,40,700,500,200,0.7142857142857143,9,5,4,349.5648434720289,0.37682959401709404,0.18022372083065719,0.20384736377750887,131159.5935768697,1169.756559710668,132329.35013658035,4474,0,1129.5,37,3,16,34.96262399200743,0.6300675675675677,43.91447368421052,1024.342105263157,27.68492176386911,0
4623,4,1,1,40,0.024390243902439025,0.024390243902439025,0.975609756097561,41,850,700,150,0.8235294117647058,10,7,3,342.94843585224606,0.38104674796747967,0.17808588171316164,0.20144547657955045,131437.6563755569,815.2677332164336,132252.92410877332,4475,0,1102.9268292682927,38,3,16,34.851444745433064,0.631030701754386,43.643162393162385,1025.4273504273492,26.984930274403926,0
4624,4,1,1,40,0.024390243902439025,0.024390243902439025,0.975609756097561,41,800,600,200,0.75,10,6,4,342.18554687500006,0.38074186991869924,0.17175304878048747,0.20128561580882331,131492.43918474668,798.9624424720312,132291.4016272187,4476,0,1103.9024390243903,38,3,17,34.815755208333314,0.6315789473684212,43.58974358974358,1025.641025641024,26.990553306342736,0
4625,4,0,0,40,0.0,0.0,1.0,40,750,500,250,0.6666666666666666,10,5,5,349.882965563648,0.37566773504273504,0.17604188372577645,0.2055187701028084,131437.6563755569,1197.5593998831007,132635.21577543998,4477,3,1132.5,38,2,17,34.673673334722494,0.631030701754386,43.643162393162385,1025.4273504273492,26.984930274403926,0
4626,4,3,3,40,0.06976744186046512,0.06976744186046512,0.9302325581395349,43,1100,600,500,0.5454545454545454,16,6,10,332.6646651212895,0.3879660391288298,0.16470604085316953,0.1981258157942033,131964.434573019,179.98088703073552,132144.41546004976,4478,0,1054.4186046511627,41,2,15,34.58480174439187,0.6313516260162602,43.129960317460316,1027.4801587301586,25.060491676345332,0
4627,4,0,0,40,0.0,0.0,1.0,40,1250,1100,150,0.88,14,11,3,357.0454166750594,0.3738915598290598,0.1848782138024363,0.21108525033829498,131684.26890432084,1403.4529320987526,133087.7218364196,4479,5,1134.5,38,2,16,34.241091565178166,0.6334978070175439,43.40277777777777,1026.3888888888878,27.010233918128627,0
4628,4,0,0,40,0.0,0.0,1.0,40,1200,600,600,0.5,18,6,12,355.49022960981563,0.37375801282051285,0.18440393217518003,0.21107644084244304,131848.8056674152,1374.1924400978635,133222.99810751306,4480,6,1135.5,38,2,16,34.11504386421166,0.6351425438596492,43.242521367521356,1027.0299145299127,27.027103013945073,0
4629,4,0,0,40,0.0,0.0,1.0,40,1050,800,250,0.7619047619047619,13,8,5,354.84576632277015,0.3736378205128205,0.1843794362198341,0.2110668846486825,131916.02105034713,1361.9683159722115,133277.98936631935,4481,7,1136.5,39,1,16,34.06383086595012,0.6340811965811967,43.17708333333333,1027.2916666666658,26.340811965811945,0
4630,4,0,1,39,0.0,0.025,0.975,40,850,700,150,0.8235294117647058,10,7,3,357.45615944821094,0.3736912393162393,0.18908593433319876,0.21352163325877357,132076.58420138864,1442.317708333309,133518.90190972196,4482,8,1137.5,39,1,17,33.83495473584651,0.6356837606837609,43.02083333333332,1027.9166666666647,26.356837606837555,0
4631,4,0,0,39,0.0,0.0,1.0,39,800,500,300,0.625,11,5,6,364.14819099855475,0.37159806567701303,0.19198647975028083,0.21715694043490968,132013.44515897782,1814.491448425722,133827.93660740354,4483,9,1167.4358974358975,38,1,17,33.726652112139156,0.6367872807017545,43.08226495726495,1027.6709401709386,27.04397210976154,0
4632,4,0,0,39,0.0,0.0,1.0,39,800,500,300,0.625,11,5,6,363.93590824759707,0.37148560503823663,0.19619846819846853,0.21797654741027472,132178.18737900836,1820.8777348600734,133999.06511386845,4484,10,1168.4358974358975,38,1,17,33.566017316017316,0.6384320175438598,42.92200854700853,1028.3119658119633,27.060841205577983,0
4633,4,0,0,39,0.0,0.0,1.0,39,850,500,350,0.5882352941176471,12,5,7,370.27657353767927,0.3717948717948718,0.20526136375741744,0.2222582824202475,132260.59701219932,1994.600135144976,134255.1971473443,4485,11,1169.4358974358975,38,1,18,33.31991760144023,0.6392543859649125,42.84188034188033,1028.6324786324765,27.069275753486224,0
4634,4,0,0,39,0.0,0.0,1.0,39,850,800,50,0.9411764705882353,9,8,1,370.2931786195903,0.37128879892037786,0.20751948574152412,0.22243000729432472,132288.07259706655,1997.0741790853465,134285.1467761519,4486,12,1170.4358974358975,38,1,19,33.29179215564092,0.63952850877193,42.815170940170916,1028.7393162393128,27.072087269455597,0
4635,4,0,0,39,0.0,0.0,1.0,39,900,500,400,0.5555555555555556,13,5,8,368.6341359471555,0.37075461088618983,0.20346724800166127,0.22207958921694465,132398.00347222204,1961.3303793191362,134359.3338515412,4487,13,1171.4358974358975,37,2,19,33.22368421052631,0.642454954954955,42.70833333333332,1029.1666666666652,27.815315315315274,0
4636,4,0,0,39,0.0,0.0,1.0,39,1100,1000,100,0.9090909090909091,12,10,2,370.86969687690384,0.37052968960863697,0.20264875344747613,0.22409694039087003,132510.8747403044,2028.85358956599,134539.72832987038,4488,14,1172.4358974358975,37,2,20,33.052449414270505,0.6435810810810811,42.5986842105263,1029.6052631578923,27.82716927453763,0
4637,4,0,0,39,0.0,0.0,1.0,39,1400,1000,400,0.7142857142857143,18,10,8,364.8164978282247,0.37024853801169594,0.1999106473281962,0.22123023094715336,132645.51487508198,1878.2544378698033,134523.76931295177,4489,15,1173.4358974358975,38,1,17,33.07275461522505,0.643092105263158,42.46794871794871,1030.1282051282035,27.108636977057987,0
4638,4,0,0,39,0.0,0.0,1.0,39,1100,700,400,0.6363636363636364,15,7,8,369.9115815781639,0.37047345928924874,0.2010505218052394,0.2249790110909813,132755.59413580227,2021.5663580246683,134777.16049382693,4490,16,1174.4358974358975,38,1,18,32.83075022461814,0.6441885964912282,42.3611111111111,1030.5555555555538,27.119883040935626,0
4639,4,0,0,39,0.0,0.0,1.0,39,1150,900,250,0.782608695652174,14,9,5,375.9467293173184,0.37047345928924874,0.21164139220701972,0.22982987828372842,132948.3427044524,2196.2989215793596,135144.64162603175,4491,17,1175.4358974358975,38,1,18,32.48126661832247,0.6461074561403508,42.174145299145295,1031.303418803418,27.139563652721527,0
4640,4,0,0,39,0.0,0.0,1.0,39,550,500,50,0.9090909090909091,6,5,1,377.4972973596323,0.37052968960863697,0.21282980785829064,0.2311183516808656,133003.43940618387,2241.687783074012,135245.12718925788,4492,18,1176.4358974358975,38,1,18,32.385853616433636,0.6466557017543859,42.1207264957265,1031.5170940170947,27.145186684660388,0
4641,4,0,0,39,0.0,0.0,1.0,39,1050,900,150,0.8571428571428571,12,9,3,371.68802044746013,0.3701923076923077,0.2083721572281465,0.2282348753656719,133113.6670524692,2095.3510802469214,135209.0181327161,4493,19,1177.4358974358975,38,1,18,32.42485419470615,0.6477521929824561,42.01388888888889,1031.944444444445,27.156432748538027,0
4642,4,0,0,39,0.0,0.0,1.0,39,900,500,400,0.5555555555555556,13,5,8,370.6021699269791,0.36999550157444894,0.20804707453208837,0.22795139055285157,133176.3793945314,2071.091037326404,135247.4704318578,4494,20,1178.4358974358975,39,0,18,32.3898518182124,0.6466346153846153,41.95312500000001,1032.1875000000011,26.46634615384618,0
4643,4,0,0,39,0.0,0.0,1.0,39,950,500,450,0.5263157894736842,14,5,9,368.64928182934136,0.368955240665767,0.21056822912222706,0.22806580960084744,133391.50526258704,2034.9365234375257,135426.44178602457,4495,21,1179.4358974358975,39,0,18,32.22423195858963,0.6487713675213674,41.74479166666668,1033.0208333333353,26.487713675213726,0
4644,4,0,0,39,0.0,0.0,1.0,39,1250,1000,250,0.8,15,10,5,369.0816857440163,0.36878654970760233,0.20802315963606244,0.2288306451612904,133472.22222222248,2052.4305555555807,135524.65277777807,4496,22,1180.4358974358975,39,0,18,32.13205645161291,0.6495726495726495,41.66666666666668,1033.3333333333353,26.495726495726547,0
4645,4,1,0,40,0.025,0.0,1.0,40,1400,1100,300,0.7857142857142857,17,11,6,367.4312579906662,0.37375801282051285,0.22006672058228882,0.22325737125575376,132719.81336805562,1753.0815972222272,134472.89496527784,4497,0,1151.9,39,1,17,32.93065103113627,0.642094017094017,42.395833333333336,1030.4166666666672,26.420940170940185,1
4646,4,2,1,41,0.047619047619047616,0.023809523809523808,0.9761904761904762,42,1050,600,450,0.5714285714285714,15,6,9,355.074797863722,0.38211382113821135,0.21570471887688147,0.2181832913276015,133139.26214293562,1054.8793186255741,134194.1414615612,4498,0,1098.0,41,1,18,32.82777003428498,0.6430386178861789,41.98908730158729,1032.0436507936488,25.171796360820704,0
4647,4,0,0,41,0.0,0.0,1.0,41,950,500,450,0.5263157894736842,14,5,9,362.3506644513179,0.37782012195121956,0.2193776812694257,0.22244913221515614,133104.92782900398,1446.1318081168647,134551.05963712084,4499,1,1125.780487804878,40,1,18,32.67452071433261,0.6442708333333333,42.02235772357724,1031.9105691056916,25.79776422764229,0
4648,4,0,0,41,0.0,0.0,1.0,41,1500,1100,400,0.7333333333333333,19,11,8,362.69026288052595,0.3776930894308943,0.22002592663721954,0.22360030769818826,133262.2777447286,1466.5861094586517,134728.86385418725,4500,2,1126.780487804878,40,1,19,32.50779199475065,0.6458333333333334,41.86991869918699,1032.5203252032516,25.81300813008129,0
4649,4,0,0,41,0.0,0.0,1.0,41,1150,700,450,0.6086956521739131,16,7,9,361.88561894261113,0.3778455284552846,0.21829316286078937,0.22373512353605246,133367.22932778124,1452.7364663890644,134819.9657941703,4501,3,1127.780487804878,40,1,20,32.423258559622184,0.646875,41.768292682926834,1032.926829268294,25.823170731707346,0
4650,4,0,0,41,0.0,0.0,1.0,41,750,400,350,0.5333333333333333,11,4,7,385.97559941281037,0.37815040650406506,0.23317677965621186,0.2248765286872378,131124.83071932473,1922.1970269589283,133047.02774628365,4502,4,1128.780487804878,41,0,15,34.06544620947953,0.6229674796747968,43.948412698412696,1024.206349206349,24.980642663569487,4
4651,4,1,0,42,0.023809523809523808,0.0,1.0,42,1150,900,250,0.782608695652174,14,9,5,382.23161504545675,0.38321476964769646,0.23653475075478747,0.22470221844878402,131468.65051025298,1651.0822744539569,133119.73278470692,4503,0,1102.8809523809523,37,5,17,33.813014540789055,0.6331644144144144,43.61293859649122,1025.5482456140337,27.71752015173064,0
4652,4,1,1,42,0.023255813953488372,0.023255813953488372,0.9767441860465116,43,1300,1000,300,0.7692307692307693,16,10,6,374.2450333718716,0.386812476928756,0.23241652288643033,0.22120193844109495,131675.35942925356,1255.7698567708378,132931.1292860244,4504,0,1078.2093023255813,39,4,15,33.808759599445175,0.6316773504273505,43.411458333333336,1026.3541666666672,26.316773504273517,0
4653,4,0,0,42,0.0,0.0,1.0,42,850,500,350,0.5882352941176471,12,5,7,379.6450371112253,0.3833599496709253,0.24117203474629112,0.22407928463646992,131621.9089084202,1593.9208984375098,133215.8298068577,4505,2,1104.8809523809523,39,3,15,33.7242623422326,0.6311431623931624,43.46354166666667,1026.145833333334,26.31143162393164,0
4654,4,0,0,42,0.0,0.0,1.0,42,1000,700,300,0.7,13,7,6,379.9254722550177,0.3825009678668215,0.24497526283240578,0.2250327797202798,131755.5555555556,1611.4583333333378,133367.01388888893,4506,3,1105.8809523809523,39,3,15,33.581912878787875,0.6324786324786325,43.333333333333336,1026.666666666667,26.324786324786334,0
4655,4,1,1,42,0.023255813953488372,0.023255813953488372,0.9767441860465116,43,550,200,350,0.36363636363636365,9,2,7,374.25099376688274,0.3866509782207457,0.24436316794332114,0.22283142208381537,131953.86860499703,1276.7732913609618,133230.641896358,4507,0,1081.139534883721,40,3,15,33.527242004615886,0.6328125,43.140243902439025,1027.439024390244,25.6859756097561,0
4656,4,0,0,42,0.0,0.0,1.0,42,850,600,250,0.7058823529411765,11,6,5,384.4574084030682,0.3821622144792876,0.25061563867079983,0.22868027513094452,131916.0210503473,1743.2183159722267,133659.23936631953,4508,5,1107.8809523809523,39,3,16,33.30333603731494,0.6340811965811965,43.177083333333336,1027.2916666666672,26.34081196581198,0
4657,4,0,1,41,0.0,0.023809523809523808,0.9761904761904762,42,1200,1100,100,0.9166666666666666,13,11,2,389.38602737867257,0.38208962446767325,0.2535354705433768,0.23226617570241728,132023.05230034713,1881.5863715277733,133904.6386718749,4509,6,1108.8809523809523,39,3,16,33.0685350361511,0.6351495726495726,43.072916666666664,1027.7083333333328,26.351495726495713,0
4658,4,0,0,41,0.0,0.0,1.0,41,900,600,300,0.6666666666666666,12,6,6,392.5458938204616,0.3782774390243902,0.2573897341344218,0.23375318023971348,131958.55391418267,2159.9576986996594,134118.51161288234,4510,7,1136.6341463414635,38,3,16,33.052580499809366,0.6362390350877194,43.13568376068375,1027.4572649572629,27.038349077822705,0
4659,4,0,0,41,0.0,0.0,1.0,41,600,500,100,0.8333333333333334,7,5,2,393.1701972242515,0.3774644308943089,0.26018457481872126,0.23463382737576283,132040.89506172828,2182.9089506172722,134223.80401234556,4511,8,1137.6341463414635,38,3,16,32.95326576576576,0.637061403508772,43.05555555555555,1027.777777777777,27.04678362573097,0
4660,4,0,0,41,0.0,0.0,1.0,41,950,500,450,0.5263157894736842,14,5,9,390.43087227508613,0.37822662601626017,0.2542790012748932,0.23350629483549704,132123.26189139063,2117.00007761704,134240.26196900767,4512,9,1138.6341463414635,38,3,17,32.94039454085697,0.6378837719298247,42.97542735042734,1028.0982905982887,27.055218173639176,0
4661,4,1,1,41,0.023809523809523808,0.023809523809523808,0.9761904761904762,42,1050,500,550,0.47619047619047616,16,5,11,378.8423353897237,0.38061362756484707,0.24818556669658998,0.22874280945171185,132482.65241468544,1638.578201592636,134121.23061627807,4513,0,1112.5,37,5,17,32.87568342386481,0.6432995495495495,42.626096491228076,1029.4956140350887,27.824205784732126,0
4662,4,1,0,42,0.023809523809523808,0.0,1.0,42,1000,600,400,0.6,14,6,8,376.0382010408498,0.38154519938056525,0.24977403055403324,0.22786827757604206,132618.00219382337,1573.8869941193502,134191.88918794272,4514,0,1113.4761904761904,38,4,18,32.81147356774885,0.6428179824561404,42.49465811965811,1030.0213675213663,27.105825461088585,0
4663,4,0,1,41,0.0,0.023809523809523808,0.9761904761904762,42,1100,800,300,0.7272727272727273,14,8,6,374.74145958632505,0.38170247773906313,0.24060852047164816,0.2275822818797556,132700.54879830522,1545.6794689166493,134246.22826722186,4515,1,1114.4761904761904,38,4,16,32.76173441172405,0.643640350877193,42.414529914529915,1030.3418803418804,27.11426000899685,0
4664,4,0,0,41,0.0,0.0,1.0,41,950,600,350,0.631578947368421,13,6,7,381.42759505353024,0.3778709349593496,0.2440894170440846,0.2308226786561057,132567.32840874133,1912.967451523563,134480.2958602649,4516,13,1142.6341463414635,37,4,17,32.72377200454287,0.6441441441441441,42.543859649122815,1029.8245614035102,27.833096254148924,0
4665,4,0,0,41,0.0,0.0,1.0,41,1000,500,500,0.5,15,5,10,378.45354806969715,0.3779979674796748,0.2447927600711246,0.2296681915692945,132673.03040990944,1842.1158183578104,134515.14622826726,4517,14,1143.6341463414635,38,3,16,32.693836634518995,0.6433662280701754,42.44123931623932,1030.235042735043,27.111448493027446,0
4666,4,0,0,41,0.0,0.0,1.0,41,850,500,350,0.5882352941176471,12,5,7,379.64755585014836,0.37815040650406506,0.24855084925797422,0.23056177762083316,132700.54879830522,1875.8878022499825,134576.4366005552,4518,15,1144.6341463414635,38,3,16,32.6353605004839,0.643640350877193,42.414529914529915,1030.3418803418804,27.11426000899685,0
4667,4,0,0,41,0.0,0.0,1.0,41,850,600,250,0.7058823529411765,11,6,5,380.1784500627643,0.3780233739837398,0.24974395933694904,0.23105363269409993,132728.0700402697,1892.070389546362,134620.14042981606,4519,16,1145.6341463414635,38,3,16,32.59396060134785,0.6439144736842104,42.38782051282052,1030.448717948719,27.11707152496629,0
4668,4,0,0,41,0.0,0.0,1.0,41,750,600,150,0.8,9,6,3,377.61819855709007,0.37756605691056916,0.24483284326986476,0.22983487454134086,132783.12108490412,1828.264596573908,134611.38568147804,4520,17,1146.6341463414635,38,3,16,32.60447980373862,0.6444627192982455,42.33440170940172,1030.6623931623947,27.122694556905124,0
4669,4,0,0,41,0.0,0.0,1.0,41,1000,600,400,0.6,14,6,8,378.45397191870927,0.3768292682926829,0.24782004296726878,0.23085213837013555,132865.71905361972,1856.7118215355435,134722.43087515526,4521,18,1147.6341463414635,38,3,16,32.49978411053541,0.6452850877192982,42.254273504273506,1030.9829059829062,27.131129104813322,0
4670,4,0,0,41,0.0,0.0,1.0,41,1150,900,250,0.782608695652174,14,9,5,378.0336559846155,0.37621951219512195,0.24769092052523511,0.23178863592656707,133058.54752218933,1860.1218359631844,134918.66935815252,4522,19,1148.6341463414635,38,3,16,32.316583825204525,0.647203947368421,42.06730769230769,1031.730769230769,27.150809716599184,0
4671,4,1,1,41,0.023809523809523808,0.023809523809523808,0.9761904761904762,42,1000,700,300,0.7,13,7,6,370.9705733414481,0.3787625822686798,0.23347161005963168,0.22966829877655967,133418.40820312512,1498.8606770833478,134917.26888020846,4523,0,1122.2619047619048,39,3,17,32.137275660415426,0.6490384615384615,41.71875000000001,1033.125000000001,26.490384615384638,0
4672,4,0,0,41,0.0,0.0,1.0,41,700,400,300,0.5714285714285714,10,4,6,377.90123071481315,0.37538109756097565,0.24246415648513997,0.2332562768894882,133306.67529585806,1875.3513313609535,135182.02662721902,4524,21,1150.6341463414635,38,3,17,32.07053072625698,0.649671052631579,41.82692307692308,1032.6923076923083,27.176113360323903,0
4673,4,1,1,41,0.023809523809523808,0.023809523809523808,0.9761904761904762,42,550,300,250,0.5454545454545454,8,3,5,370.30386805860286,0.37970625241966705,0.2391683156620099,0.22993065594344828,133527.4273595588,1489.2472970998626,135016.67465665864,4525,0,1124.2142857142858,38,4,17,32.04508648611398,0.6518640350877192,41.613247863247864,1033.5470085470088,27.198605488079178,0
4674,4,0,0,41,0.0,0.0,1.0,41,1150,800,350,0.6956521739130435,15,8,7,376.91385642546186,0.3754827235772358,0.24330220346976472,0.23351274218389761,133444.62393390678,1859.4255652348595,135304.04949914163,4526,23,1152.6341463414635,38,3,18,31.95744149174508,0.6510416666666666,41.69337606837607,1033.2264957264958,27.190170940170944,0
4675,4,0,0,41,0.0,0.0,1.0,41,1250,1000,250,0.8,15,10,5,373.5377644543225,0.375,0.24238128253153546,0.23230303715536607,133585.55036164966,1779.8524226667328,135365.4027843164,4527,24,1153.6341463414635,37,4,18,31.903196153302225,0.6542792792792793,41.557017543859644,1033.7719298245606,27.939781887150286,0
4676,4,0,0,41,0.0,0.0,1.0,41,650,500,150,0.7692307692307693,8,5,3,377.02621997286593,0.3751016260162601,0.2467937859317093,0.2350121798125642,133670.57802641182,1879.462550977204,135550.04057738904,4528,25,1154.6341463414635,37,4,18,31.727702081786997,0.6551238738738739,41.474780701754376,1034.1008771929812,27.94867235656706,0
4677,4,0,0,41,0.0,0.0,1.0,41,1050,600,450,0.5714285714285714,15,6,9,374.73489574864345,0.37405995934959346,0.2476301265397396,0.23430243481699442,133783.99032635018,1826.7059335564545,135610.69625990663,4529,26,1155.6341463414635,37,4,15,31.67318053347465,0.6562500000000002,41.365131578947356,1034.5394736842086,27.960526315789423,0
4678,4,0,0,41,0.0,0.0,1.0,41,600,300,300,0.5,9,3,6,378.11410522525136,0.37383130081300814,0.2497544432841532,0.23659712844200714,133812.35091566615,1919.2674669128735,135731.618382579,4530,27,1156.6341463414635,37,4,15,31.557333615938944,0.6565315315315317,41.3377192982456,1034.6491228070158,27.96348980559502,0
4679,4,0,0,41,0.0,0.0,1.0,41,550,500,50,0.9090909090909091,6,5,1,378.11410522525136,0.37383130081300814,0.2497544432841532,0.23659712844200714,133812.35091566615,1919.2674669128735,135731.618382579,4531,28,1157.6341463414635,37,4,15,31.557333615938944,0.6565315315315317,41.3377192982456,1034.6491228070158,27.96348980559502,0
4680,4,0,0,41,0.0,0.0,1.0,41,850,600,250,0.7058823529411765,11,6,5,379.7626797664027,0.3724085365853658,0.2549463952103237,0.23817806872525418,133897.45071800938,1969.8509397122161,135867.3016577216,4532,29,1158.6341463414635,37,4,15,31.429331320408224,0.6573761261261262,41.25548245614035,1034.9780701754385,27.97238027501185,0
4681,4,0,0,41,0.0,0.0,1.0,41,800,500,300,0.625,11,5,6,382.86884441150016,0.3726626016260162,0.2533009886819553,0.24049665735788248,133954.1989482341,2057.377871075717,136011.5768193098,4533,30,1159.6341463414635,37,4,15,31.292037390106984,0.6579391891891891,41.20065789473684,1035.1973684210527,27.978307254623047,0
4682,4,0,0,41,0.0,0.0,1.0,41,1000,800,200,0.8,12,8,4,382.8172409376845,0.37309451219512196,0.2533486552440962,0.24120806141804088,134067.73147747395,2064.6878125961925,136132.41929007013,4534,31,1160.6341463414635,37,4,16,31.179526204340913,0.6590653153153152,41.09100877192983,1035.6359649122815,27.990161213845443,0
4683,4,0,0,41,0.0,0.0,1.0,41,1450,1100,350,0.7586206896551724,18,11,7,381.635276581436,0.372484756097561,0.24931331447099403,0.24102206504955914,134152.9124345951,2039.4967682363667,136192.40920283148,4535,32,1161.6341463414635,37,4,16,31.124753034151844,0.6599099099099099,41.008771929824555,1035.9649122807007,27.99905168326218,0
4684,4,0,0,41,0.0,0.0,1.0,41,1350,1000,350,0.7407407407407407,17,10,7,380.3597470372281,0.3720274390243902,0.245516887584589,0.24064639181435574,134218.45465565412,2010.259492110448,136228.71414776458,4536,33,1162.6341463414635,38,3,16,31.092122899267974,0.6587171052631579,40.94551282051282,1036.2179487179483,27.268893387314428,0
4685,4,0,0,41,0.0,0.0,1.0,41,700,500,200,0.7142857142857143,9,5,4,380.3597470372281,0.3720274390243902,0.245516887584589,0.24064639181435574,134218.45465565412,2010.259492110448,136228.71414776458,4537,34,1163.6341463414635,38,3,16,31.092122899267974,0.6587171052631579,40.94551282051282,1036.2179487179483,27.268893387314428,0
4686,4,0,0,41,0.0,0.0,1.0,41,1150,800,350,0.6956521739130435,15,8,7,398.0335522619441,0.3720274390243902,0.2725131008252262,0.24814270946513453,133675.94103816655,2442.32376042083,136118.2647985874,4538,35,1164.6341463414635,36,5,16,31.179217031471207,0.6571180555555556,41.4695945945946,1034.1216216216217,28.7256006006006,1
4687,4,0,0,41,0.0,0.0,1.0,41,850,600,250,0.7058823529411765,11,6,5,360.6416286243818,0.37134146341463414,0.21934596669386752,0.2256106932557179,133803.62426035505,1451.0313938198592,135254.65565417492,4539,36,1165.6341463414635,38,3,17,32.0180194134655,0.6546052631578947,41.34615384615385,1034.6153846153848,27.226720647773284,3
4688,4,0,0,41,0.0,0.0,1.0,41,1150,1000,150,0.8695652173913043,13,10,3,362.7554226123808,0.3719766260162602,0.2222429158560495,0.22812866972982349,133997.13187824152,1521.6372406676765,135518.7691189092,4540,37,1166.6341463414635,38,3,17,31.76959722078905,0.6565241228070176,41.15918803418803,1035.363247863247,27.24640125955913,0
4689,4,0,0,41,0.0,0.0,1.0,41,950,700,250,0.7368421052631579,12,7,5,362.3564699027079,0.37106199186991873,0.2219202693419693,0.22822100472819656,134052.44545118336,1514.954183103214,135567.3996342866,4541,38,1167.6341463414635,38,3,17,31.72456927679768,0.6570723684210527,41.105769230769226,1035.5769230769224,27.252024291497957,0
4690,4,0,0,41,0.0,0.0,1.0,41,650,500,150,0.7692307692307693,8,5,3,365.2540957994317,0.37065548780487806,0.22153465346534662,0.230566647973391,134135.43721236012,1598.703566732391,135734.1407790925,4542,39,1168.6341463414635,38,3,17,31.56649649339933,0.6578947368421054,41.025641025641015,1035.8974358974344,27.26045883940617,0
4691,4,0,0,41,0.0,0.0,1.0,41,600,400,200,0.6666666666666666,8,4,4,363.22091744688674,0.37065548780487806,0.2164417251967139,0.22980297966845079,134218.454655654,1550.1900476659891,135768.64470332,4543,40,1169.6341463414635,38,3,17,31.536111970306216,0.658717105263158,40.94551282051281,1036.2179487179474,27.268893387314403,0
4692,4,1,1,41,0.023809523809523808,0.023809523809523808,0.9761904761904762,42,1150,900,250,0.782608695652174,14,9,5,358.542604151546,0.37342721641502125,0.21294702620003814,0.22891566265060243,134550.78125,1249.2593277449046,135800.0405777449,4544,0,1142.7619047619048,37,5,18,31.325301204819272,0.6638513513513513,40.625,1037.5,28.04054054054054,0
4693,4,0,0,41,0.0,0.0,1.0,41,1000,700,300,0.7,13,7,6,363.73725792577983,0.3698678861788618,0.21967295471100945,0.23205576704726155,134523.07167251068,1586.210643582428,136109.2823160931,4545,42,1171.6341463414635,38,3,18,31.21824579471334,0.6617324561403508,40.6517094017094,1037.3931623931617,27.29982006297794,0
4694,4,0,0,41,0.0,0.0,1.0,41,1400,900,500,0.6428571428571429,19,9,10,363.52699185595105,0.3697916666666667,0.22202108739837412,0.23265727478780862,134638.42220598977,1588.9458296921036,136227.36803568187,4546,43,1172.6341463414635,36,5,18,31.108488859953706,0.6666666666666666,40.54054054054054,1037.8378378378377,28.828828828828826,0
4695,4,0,0,41,0.0,0.0,1.0,41,1200,800,400,0.6666666666666666,16,8,8,362.5082233980774,0.3690548780487805,0.2169755685520114,0.23308318966756197,134806.8651532201,1573.7194377115925,136380.58459093168,4547,44,1173.6341463414635,37,4,15,30.966788969837747,0.6663851351351351,40.378289473684205,1038.4868421052622,28.06721194879087,0
4696,4,0,0,41,0.0,0.0,1.0,41,1100,700,400,0.6363636363636364,15,7,8,365.82428466873847,0.36859756097560975,0.22734888317544133,0.2363269765375347,134977.72301333104,1675.62579351339,136653.3488068444,4548,45,1174.6341463414635,37,4,15,30.710206288909987,0.6680743243243243,40.213815789473685,1039.1447368421054,28.08499288762447,0
4697,4,0,0,41,0.0,0.0,1.0,41,950,700,250,0.7368421052631579,12,7,5,364.7154640513779,0.3683689024390244,0.2264363586773328,0.23598210810532494,135034.69967922827,1649.8486313096387,136684.5483105379,4549,46,1175.6341463414635,37,4,15,30.68218781868692,0.6686373873873873,40.15899122807018,1039.3640350877197,28.090919867235666,0
4698,4,0,0,41,0.0,0.0,1.0,41,1300,1000,300,0.7692307692307693,16,10,6,365.8218240087389,0.3678607723577236,0.2298255046678721,0.2370715456887803,135091.68836805562,1683.897569444453,136775.5859375001,4550,47,1176.6341463414635,37,4,15,30.596609886439545,0.6692004504504503,40.10416666666667,1039.583333333334,28.096846846846862,0
4699,4,0,0,41,0.0,0.0,1.0,41,950,500,450,0.5263157894736842,14,5,9,363.4722017399184,0.3670985772357724,0.22239932950610153,0.23666855030244408,135262.72657211855,1632.848208102515,136895.57478022107,4551,48,1177.6341463414635,37,4,16,30.487223744773548,0.6708896396396395,39.93969298245615,1040.2412280701772,28.114627785680465,0
4700,4,0,0,41,0.0,0.0,1.0,41,1200,900,300,0.75,15,9,6,358.9571478865328,0.367505081300813,0.21745376235766334,0.23447090781769367,135376.81215614447,1518.8948763081244,136895.7070324526,4552,49,1178.6341463414635,37,4,16,30.49105731745865,0.6720157657657657,39.83004385964914,1040.6798245614057,28.126481744902854,0
4701,4,0,0,41,0.0,0.0,1.0,41,900,700,200,0.7777777777777778,11,7,4,353.6057198865933,0.3671239837398374,0.1921395062514597,0.22201801756813952,133938.09349890417,1300.8547394358852,135238.94823834006,4553,50,1179.6341463414635,36,5,15,32.06547360023209,0.6597222222222223,41.21621621621621,1035.135135135134,28.753753753753724,5
4702,4,0,0,41,0.0,0.0,1.0,41,950,700,250,0.7368421052631579,12,7,5,353.6808487801409,0.3669207317073171,0.1906080130150165,0.22284960752024197,134067.73147747366,1283.437812596163,135351.1692900698,4554,51,1180.6341463414635,37,4,16,31.933893594494453,0.6590653153153154,41.091008771929815,1035.6359649122792,27.990161213845383,0
4703,4,0,0,41,0.0,0.0,1.0,41,900,800,100,0.8888888888888888,10,8,2,353.7767246863103,0.3672764227642276,0.1906089686492296,0.22325509139021826,134124.51577648864,1290.0263783086796,135414.54215479732,4555,52,1181.6341463414635,37,4,16,31.87464715429942,0.6596283783783785,41.0361842105263,1035.8552631578925,27.996088193456554,0
4704,4,0,0,41,0.0,0.0,1.0,41,800,500,300,0.625,11,5,6,355.1566550103711,0.36641260162601624,0.18276553519952743,0.22482153693925075,134238.12044330928,1335.1123663049937,135573.23280961427,4556,53,1182.6341463414635,37,4,17,31.725368567700066,0.6607545045045047,40.92653508771929,1036.2938596491213,28.007942152678954,0
4705,4,0,0,41,0.0,0.0,1.0,41,1250,1100,150,0.88,14,11,3,357.5279688734554,0.36595528455284554,0.152682607376172,0.21925510380311916,133065.2506391527,1322.1265215426524,134387.37716069535,4557,54,1183.6341463414635,36,5,16,32.838763370443154,0.6510416666666666,42.060810810810814,1031.756756756757,28.65990990990992,4
4706,4,0,0,41,0.0,0.0,1.0,41,1000,500,500,0.5,15,5,10,356.1001064946132,0.3658282520325203,0.15246818072261048,0.21860783445667348,133104.2379025277,1279.6866583948888,134383.9245609226,4558,55,1184.6341463414635,37,4,16,32.83646353557894,0.6494932432432432,42.02302631578947,1031.907894736842,27.889402560455192,0
4707,4,0,0,41,0.0,0.0,1.0,41,750,400,350,0.5333333333333333,11,4,7,354.5447192730021,0.3658282520325203,0.15507017672731482,0.21297012488332756,132288.07259706716,1180.4075124187552,133468.4801094859,4559,56,1185.6341463414635,38,3,16,33.69681863814173,0.6395285087719296,42.81517094017095,1028.7393162393178,27.072087269455732,1
4708,4,0,0,41,0.0,0.0,1.0,41,950,600,350,0.631578947368421,13,6,7,351.60151895398445,0.36577743902439025,0.1451158739162135,0.2116641144102991,132370.51647308088,1108.3349313317522,133478.85140441262,4560,57,1186.6341463414635,38,3,17,33.68956776024363,0.6403508771929823,42.73504273504275,1029.0598290598314,27.080521817363984,0
4709,4,0,0,41,0.0,0.0,1.0,41,850,500,350,0.5882352941176471,12,5,7,351.3230091467566,0.36567581300813007,0.14497504864280675,0.21212679954205155,132482.65241468546,1108.843674782791,133591.49608946824,4561,58,1187.6341463414635,37,4,17,33.58395906557318,0.6432995495495495,42.626096491228076,1029.495614035089,27.824205784732133,0
4710,4,1,1,41,0.023809523809523808,0.023809523809523808,0.9761904761904762,42,1050,600,450,0.5714285714285714,15,6,9,344.4104590928573,0.37054781262098335,0.1436272622256447,0.20946931200565613,132755.59413580265,744.4830246913797,133500.07716049402,4562,0,1160.3333333333333,38,4,13,33.48775831087154,0.644188596491228,42.36111111111112,1030.555555555557,27.11988304093571,0
4711,4,1,0,42,0.023809523809523808,0.0,1.0,42,1350,1200,150,0.8888888888888888,15,12,3,345.619793201121,0.3692290940766551,0.1519975724203264,0.2109789136106276,132893.2574169956,786.1080292570829,133679.36544625266,4563,0,1161.3095238095239,38,4,14,33.318438503781984,0.6455592105263157,42.22756410256411,1031.089743589745,27.133940620782763,0
4712,4,0,0,42,0.0,0.0,1.0,42,1000,800,200,0.8,12,8,4,348.12775610987103,0.36930168408826947,0.15334023821853937,0.21313718993283498,133003.43940618393,860.4377830740125,133863.87718925794,4564,1,1162.3095238095239,38,4,14,33.14323321249785,0.6466557017543859,42.1207264957265,1031.5170940170951,27.1451866846604,0
4713,4,0,0,42,0.0,0.0,1.0,42,600,400,200,0.6666666666666666,8,4,4,351.28582321435067,0.36891453735965934,0.15756889894820914,0.21538839331942788,133058.54752218953,948.3162804076442,134006.8638025972,4565,2,1163.3095238095239,38,4,14,33.00649787718752,0.647203947368421,42.0673076923077,1031.7307692307706,27.150809716599227,0
4714,4,0,0,42,0.0,0.0,1.0,42,1000,800,200,0.8,12,8,4,359.0505767524402,0.3685636856368564,0.1653504880212957,0.22063794983642315,133141.2310979619,1160.8871630506292,134302.1182610125,4566,3,1164.3095238095239,38,4,14,32.723214285714306,0.6480263157894737,41.98717948717949,1032.0512820512822,27.159244264507425,0
4715,4,1,1,42,0.023255813953488372,0.023255813953488372,0.9767441860465116,43,1300,1000,300,0.7692307692307693,16,10,6,348.20062719452585,0.37209302325581395,0.1480208278242805,0.2162062174248935,133527.42735955867,699.2777047264087,134226.70506428508,4567,0,1138.2093023255813,38,5,16,32.616204947970495,0.6518640350877194,41.61324786324786,1033.5470085470079,27.198605488079153,0
4716,4,0,0,42,0.0,0.0,1.0,42,1400,900,500,0.6428571428571429,19,9,10,354.26736278732426,0.36914440572977153,0.12428147879227924,0.2230467316108993,134039.34383656507,1138.7979496902726,135178.14178625535,4568,5,1166.3095238095239,37,5,14,31.9470916278413,0.6587837837837838,41.118421052631575,1035.5263157894733,27.98719772403982,3
4717,4,0,0,42,0.0,0.0,1.0,42,1250,1000,250,0.8,15,10,5,353.44895744237385,0.3684427022841657,0.1175794714668712,0.2234516290271277,134190.7793209875,1085.9182098765277,135276.697530864,4569,6,1167.3095238095239,38,4,14,31.81691242180518,0.6584429824561404,40.972222222222214,1036.11111111111,27.266081871344998,0
4718,4,0,0,42,0.0,0.0,1.0,42,950,700,250,0.7368421052631579,12,7,5,351.3728665640962,0.3691081107239644,0.11855184296169763,0.22264325137415367,134273.81388569265,1036.0349779019364,135309.84886359458,4570,7,1168.3095238095239,38,4,14,31.787745249630625,0.6592653508771931,40.892094017094,1036.431623931622,27.27451641925321,0
4719,4,0,0,42,0.0,0.0,1.0,42,650,400,250,0.6153846153846154,9,4,5,354.4109180643514,0.3687693573364305,0.11978361669242688,0.22524937523343325,134384.56658859277,1125.4715236686075,135510.0381122614,4571,8,1169.3095238095239,38,4,15,31.59840288511075,0.6603618421052633,40.785256410256395,1036.8589743589723,27.28576248313085,0
4720,4,0,0,42,0.0,0.0,1.0,42,1100,900,200,0.8181818181818182,13,9,4,353.9364088317538,0.36827332559039877,0.11846894025261023,0.2254731172576949,134469.73876953113,1118.7472873263748,135588.4860568575,4572,9,1170.3095238095239,39,3,17,31.525664524120373,0.6594551282051283,40.70312499999999,1037.187499999999,26.59455128205126,0
4721,4,0,0,42,0.0,0.0,1.0,42,1100,800,300,0.7272727272727273,14,8,6,355.1936781125056,0.36814024390243905,0.1211720467798989,0.22715167745768375,134610.82845721886,1162.680710948225,135773.50916816707,4573,10,1171.3095238095239,35,7,18,31.352238084615955,0.6684523809523808,40.56712962962963,1037.731481481482,29.649470899470913,0
4722,4,0,0,42,0.0,0.0,1.0,42,700,600,100,0.8571428571428571,8,6,2,369.6268059282975,0.36814024390243905,0.05639608185433076,0.21351383730681703,130794.81336805585,1269.0538194444784,132063.86718750032,4574,11,1172.3095238095239,39,3,18,34.81839782756281,0.6228632478632476,44.27083333333335,1022.916666666669,26.228632478632537,7
4723,4,1,0,43,0.023255813953488372,0.0,1.0,43,1450,1100,350,0.7586206896551724,18,11,7,362.50078735197746,0.3728082318198597,0.05658914728682163,0.21145879262198722,131171.92147531253,909.9849626545251,132081.90643796706,4575,0,1146.0232558139535,40,3,19,34.61888227513228,0.625,43.902439024390254,1024.3902439024407,25.609756097561018,0
4724,4,0,2,41,0.0,0.046511627906976744,0.9534883720930233,43,1050,500,550,0.47619047619047616,16,5,11,372.9308100043852,0.37292358803986714,0.07531542996907836,0.219719185037848,131553.00188519532,1223.533568146796,132776.5354533421,4576,1,1147.0232558139535,37,6,18,33.96617144078666,0.6340090090090091,43.53070175438596,1025.8771929824552,27.726410621147437,1
4725,4,0,0,41,0.0,0.0,1.0,41,1100,700,400,0.6363636363636364,15,7,8,378.4788095671415,0.36471036585365857,0.10259860135483967,0.22265979777931072,131496.76462950138,1753.7477877808533,133250.51241728224,4577,14,1201.4634146341464,37,4,18,33.880781840210965,0.6334459459459459,43.58552631578947,1025.657894736842,27.720483641536273,0
4726,4,1,1,41,0.023809523809523808,0.023809523809523808,0.9761904761904762,42,850,500,350,0.5882352941176471,12,5,7,349.7299473125787,0.36794667053813396,0.08142501620762488,0.20577134109321496,131501.32395909424,815.796179475687,132317.12013856994,4578,0,1173.8333333333333,36,6,20,34.613343580734856,0.6354166666666666,43.58108108108108,1025.6756756756758,28.490990990990994,4
4727,4,0,0,41,0.0,0.0,1.0,41,800,500,300,0.625,11,5,6,358.18185738906243,0.36554878048780487,0.08705373122821314,0.21011754256637838,131387.4488275891,1212.1200917352467,132599.56891932435,4579,16,1203.4634146341464,35,6,21,34.51164672236021,0.6363095238095239,43.692129629629626,1025.231481481481,29.29232804232803,0
4728,4,0,0,41,0.0,0.0,1.0,41,1050,700,350,0.6666666666666666,14,7,7,383.9184406171147,0.36580284552845527,0.11743450767841024,0.20731595793324192,128144.53124999999,1643.2811428326477,129787.81239283264,4580,17,1204.4634146341464,37,4,15,37.15706447187928,0.5996621621621622,46.875,1012.4999999999999,27.364864864864863,8
4729,4,1,0,42,0.023809523809523808,0.0,1.0,42,850,800,50,0.9411764705882353,9,8,1,382.96115593920075,0.37106804103755325,0.13652968036529667,0.20862809241463917,128496.3348765432,1441.820987654322,129938.15586419753,4581,0,1176.7619047619048,38,4,13,36.82077625570777,0.6014254385964912,46.52777777777778,1013.8888888888888,26.6812865497076,0
4730,4,2,2,42,0.045454545454545456,0.045454545454545456,0.9545454545454546,44,800,500,300,0.625,11,5,6,369.8700776100908,0.380252378435518,0.13633407612897352,0.20390796611764236,128969.02394614645,740.3565792517684,129709.38052539821,4582,0,1124.2272727272727,40,4,13,36.66958479239621,0.6028645833333334,46.0619918699187,1015.7520325203251,25.393800813008127,0
4731,4,1,1,42,0.023255813953488372,0.023255813953488372,0.9767441860465116,43,1000,800,200,0.8,12,8,4,341.34310768554843,0.37622277593207826,0.18556490250822866,0.18796822987503853,128924.17332963306,201.4755960254722,129125.64892565853,4583,0,1151.3488372093022,41,2,18,37.43965924261665,0.6008638211382112,46.106150793650805,1015.5753968253991,24.770131629887786,8
4732,4,0,0,42,0.0,0.0,1.0,42,1050,700,350,0.6666666666666666,14,7,7,349.7419633064335,0.37167295780100656,0.18371840329406397,0.19243511549327572,128891.61544054485,615.761327582807,129507.37676812765,4584,3,1179.7619047619048,40,2,18,37.25959934614358,0.6020833333333333,46.13821138211383,1015.4471544715464,25.386178861788657,0
4733,4,1,1,42,0.023255813953488372,0.023255813953488372,0.9767441860465116,43,1450,1200,250,0.8275862068965517,17,12,5,348.7551854132958,0.3763381321520856,0.18576537382988323,0.19353037889819094,129227.86593967008,414.52127426785427,129642.38721393794,4585,0,1153.3023255813953,39,4,19,36.942189154116726,0.6071047008547009,45.807291666666664,1016.7708333333328,26.071047008546994,0
4734,4,3,2,43,0.06666666666666667,0.044444444444444446,0.9555555555555556,45,950,500,450,0.5263157894736842,14,5,9,338.94973674415917,0.38604797979797983,0.19150193137923233,0.1905131278941305,129731.44531249972,-205.5121527778075,129525.93315972191,4586,0,1102.9777777777779,41,4,13,36.679873892297195,0.6089939024390245,45.312499999999986,1018.7499999999978,24.847560975609703,0
4735,4,0,0,43,0.0,0.0,1.0,43,1150,700,450,0.6086956521739131,16,7,9,344.30097899666157,0.37949889258028796,0.19002403274433122,0.19327163211365345,129680.91699932278,329.85333601032147,130010.7703353331,4587,1,1116.3720930232557,41,2,13,36.59489545793967,0.6084857723577236,45.36210317460317,1018.5515873015866,24.84272164150211,0
4736,4,2,1,44,0.044444444444444446,0.022222222222222223,0.9777777777777777,45,1400,1100,300,0.7857142857142857,17,11,6,334.68786236077545,0.3885311447811448,0.18808146429492134,0.19010341154124163,130141.77755000282,-288.6253335916043,129853.15221641122,4588,0,1067.7111111111112,43,2,16,36.372486465583904,0.6102228682170543,44.910037878787875,1020.359848484848,23.72929880197321,0
4737,4,0,0,44,0.0,0.0,1.0,44,1000,500,500,0.5,15,5,10,342.4126341912956,0.3837869978858351,0.18806990881458985,0.19423061491195887,130089.53788834793,108.86026981550555,130198.39815816343,4589,1,1092.9772727272727,42,2,17,36.22839095744681,0.6111111111111112,44.961240310077514,1020.155038759689,24.2894056847545,0
4738,4,1,0,45,0.022222222222222223,0.0,1.0,45,1100,800,300,0.7272727272727273,14,8,6,336.1272795123858,0.387310606060606,0.18928074095663794,0.1918889677216298,130338.55273880383,-237.7013287005338,130100.85141010329,4590,0,1069.6666666666667,41,4,18,36.136512678519395,0.615091463414634,44.717261904761905,1021.1309523809522,24.905632984901274,0
4739,4,0,0,45,0.0,0.0,1.0,45,850,500,350,0.5882352941176471,12,5,7,335.9225934521381,0.3875631313131313,0.18718994883751083,0.19189717963353548,130363.87963750312,-241.5654919375168,130122.3141455656,4591,1,1070.6666666666667,41,4,18,36.116103231655984,0.6153455284552847,44.692460317460316,1021.2301587301585,24.908052651955085,0
4740,4,0,0,45,0.0,0.0,1.0,45,1250,1100,150,0.88,14,11,3,336.1090914428753,0.3867003367003367,0.17819205748130895,0.19263147093879626,130490.55103812345,-228.18788973924586,130262.3631483842,4592,2,1071.6666666666667,41,4,13,35.9831658413438,0.6166158536585367,44.56845238095237,1021.7261904761895,24.920150987224133,0
4741,4,0,0,45,0.0,0.0,1.0,45,1150,700,450,0.6086956521739131,16,7,9,338.418596408318,0.3862373737373737,0.1789855072463773,0.19459069293478265,130617.28395061709,-159.33641975310388,130457.94753086398,4593,3,1072.6666666666667,41,4,13,35.79596920289856,0.6178861788617886,44.444444444444436,1022.2222222222206,24.932249322493185,0
4742,4,0,1,44,0.0,0.022222222222222223,0.9777777777777777,45,1000,600,400,0.6,14,6,8,342.8308327906391,0.3870580808080808,0.17415704910613306,0.19803522223553374,130794.81336805546,-31.901041666675724,130762.91232638879,4594,4,1073.6666666666667,41,4,13,35.50364901561439,0.6196646341463414,44.27083333333333,1022.9166666666658,24.949186991869897,0
4743,4,0,0,44,0.0,0.0,1.0,44,900,600,300,0.6666666666666666,12,6,6,345.5796799748188,0.38312632135306557,0.1764994173073271,0.1992875827843325,130729.8495955616,235.51591727807966,130965.36551283968,4595,7,1098.9772727272727,40,4,13,35.499064228692546,0.6205729166666667,44.334349593495936,1022.662601626017,25.566565040650424,0
4744,4,1,1,44,0.022222222222222223,0.022222222222222223,0.9777777777777777,45,1100,800,300,0.7272727272727273,14,8,6,341.6133228866417,0.3861531986531987,0.18804379420598738,0.1986361186204524,131048.635961908,-46.40800185814524,131002.22796004986,4596,0,1075.5333333333333,41,4,14,35.2782958692633,0.6222052845528455,44.02281746031746,1023.9087301587309,24.97338366240807,0
4745,4,0,0,44,0.0,0.0,1.0,44,750,300,450,0.4,12,3,9,348.49520308425906,0.381705866807611,0.19480197126146348,0.20219145653598242,130963.79469892249,328.05084605723476,131291.84554497973,4597,1,1100.7954545454545,40,4,15,35.18789714058778,0.6229166666666668,44.105691056910565,1023.5772357723569,25.589430894308922,0
4746,4,0,1,43,0.0,0.022727272727272728,0.9772727272727273,44,600,200,400,0.3333333333333333,10,2,8,348.49520308425906,0.381705866807611,0.19480197126146348,0.20219145653598242,130963.79469892249,328.05084605723476,131291.84554497973,4598,2,1101.7954545454545,40,4,15,35.18789714058778,0.6229166666666668,44.105691056910565,1023.5772357723569,25.589430894308922,0
4747,4,1,1,43,0.022727272727272728,0.022727272727272728,0.9772727272727273,44,1200,1000,200,0.8333333333333334,14,10,4,349.9864791779344,0.38089103241719524,0.19870507399577209,0.2033705216844751,131023.24263038527,371.27267573693973,131394.51530612222,4599,0,1102.5,41,3,16,35.08963178294573,0.6219512195121952,44.04761904761904,1023.809523809522,24.970963995354197,0
4748,4,0,0,43,0.0,0.0,1.0,43,1550,1100,450,0.7096774193548387,20,11,9,357.6921497382074,0.37532299741602065,0.20467099525147758,0.20771104632237244,130997.85175933783,771.3806413769029,131769.23240071474,4600,4,1129.139534883721,41,2,16,34.91809203088152,0.6216971544715447,44.072420634920626,1023.7103174603162,24.968544328300396,0
4749,4,0,0,43,0.0,0.0,1.0,43,1250,900,350,0.72,16,9,7,358.2903431034605,0.37548449612403095,0.20337516811635314,0.20860864139069463,131099.43000637728,794.3319515305803,131893.76195790787,4601,5,1130.139534883721,41,2,16,34.80002179598954,0.6227134146341464,43.97321428571427,1024.1071428571406,24.978222996515626,0
4750,4,2,1,44,0.044444444444444446,0.022222222222222223,0.9777777777777777,45,1250,800,450,0.64,17,8,9,346.0101858159629,0.3808501683501684,0.20295288690375535,0.2042268628204343,131621.90890842007,109.30142564837928,131731.21033406846,4602,0,1080.8666666666666,39,6,14,34.5871189050181,0.6311431623931625,43.463541666666664,1026.1458333333328,26.31143162393161,0
4751,4,0,1,43,0.0,0.022727272727272728,0.9772727272727273,44,950,600,350,0.631578947368421,13,6,7,353.51241865314483,0.37733439041578576,0.21160290818210226,0.20839654734967145,131574.63480029578,502.6534763313503,132077.28827662714,4603,1,1106.4318181818182,38,6,14,34.44236176194939,0.6324013157894737,43.50961538461538,1025.9615384615377,26.99898785425099,0
4752,4,0,0,43,0.0,0.0,1.0,43,1650,1400,250,0.8484848484848485,19,14,5,352.9401538700924,0.37647655961609455,0.1950130275279487,0.20901825810788593,131749.9269606995,699.9678987765483,132449.89485947604,4604,2,1092.2325581395348,37,6,14,34.280212004699344,0.6359797297297298,43.338815789473685,1026.6447368421057,27.747155049786638,0
4753,4,1,0,44,0.022727272727272728,0.0,1.0,44,1200,600,600,0.5,18,6,12,345.5076698319941,0.3802193446088795,0.19066339066339033,0.20619006102877074,132040.89506172843,324.228395061731,132365.12345679017,4605,0,1068.3863636363637,38,6,15,34.177927927927925,0.6370614035087719,43.05555555555556,1027.777777777778,27.046783625731003,0
4754,4,0,0,44,0.0,0.0,1.0,44,1150,900,250,0.782608695652174,14,9,5,354.6733094243931,0.3805386715997181,0.15377085461355167,0.21043949692513989,131821.37573964504,566.1368160566973,132387.51255570175,4606,1,1069.3863636363637,38,6,13,34.16367561381606,0.6348684210526315,43.269230769230774,1026.9230769230774,27.02429149797572,4
4755,4,0,0,44,0.0,0.0,1.0,44,1400,1000,400,0.7142857142857143,18,10,8,351.87649171527653,0.3802964235377026,0.15347643622752805,0.2096869948771704,131985.99810979626,488.5539940828528,132474.5521038791,4607,2,1070.3863636363637,38,6,14,34.06958307340404,0.6365131578947367,43.108974358974365,1027.5641025641032,27.04116059379219,0
4756,4,1,1,44,0.022222222222222223,0.022222222222222223,0.9777777777777777,45,1300,900,400,0.6923076923076923,17,9,8,345.0770851679747,0.3839015151515151,0.15585985213757625,0.20732615140161645,132295.92328829685,130.45831758629652,132426.38160588316,4608,0,1047.5777777777778,41,4,17,33.932417229186754,0.6346544715447153,42.807539682539684,1028.7698412698417,25.09194734804492,0
4757,4,0,0,44,0.0,0.0,1.0,44,350,200,150,0.5714285714285714,5,2,3,351.46039727851,0.38189305849189575,0.15518697550719662,0.21041871595644754,132162.78029777252,489.9966537775154,132652.77695155004,4609,1,1072.25,40,4,18,33.90224517361796,0.6348958333333334,42.9369918699187,1028.2520325203254,25.706300813008134,0
4758,4,0,0,44,0.0,0.0,1.0,44,1250,1000,250,0.8,15,10,5,348.7550676451893,0.38092406624383374,0.15223814912611622,0.20937715271083052,132267.29811124317,425.7781000065964,132693.07621124978,4610,2,1073.25,40,4,18,33.866618915892765,0.6359375,42.83536585365853,1028.6585365853648,25.71646341463412,0
4759,4,0,0,44,0.0,0.0,1.0,44,1250,900,350,0.72,16,9,7,353.5543936140566,0.38034046863988724,0.1543062200956935,0.21299496395773676,132398.00347222234,562.0437157115531,132960.0471879339,4611,3,1074.25,39,5,18,33.61167341430498,0.638888888888889,42.708333333333336,1029.1666666666674,26.388888888888907,0
4760,4,0,1,43,0.0,0.022727272727272728,0.9772727272727273,44,1450,1000,450,0.6896551724137931,19,10,9,357.84878891768244,0.3802633897110641,0.15773927195490822,0.21665958212058356,132585.67843967024,689.1248914930668,133274.8033311633,4612,4,1075.25,39,5,20,33.31236724992413,0.6407585470085471,42.52604166666667,1029.8958333333342,26.40758547008549,0
4761,4,1,1,43,0.022727272727272728,0.022727272727272728,0.9772727272727273,44,600,500,100,0.8333333333333334,7,5,2,351.54539613788586,0.38274092670894994,0.16736270433037026,0.214307481876365,132842.8845264062,540.060892986975,133382.9454193932,4613,0,1070.6818181818182,40,4,13,33.21626905888539,0.6416666666666667,42.27642276422764,1030.894308943089,25.772357723577226,0
4762,4,0,0,43,0.0,0.0,1.0,43,800,500,300,0.625,11,5,6,358.2036473170027,0.3787144702842377,0.16985935556971254,0.21780631118052285,132746.64849175338,910.066731770829,133656.71522352422,4614,6,1096.5813953488373,39,4,14,33.14138363826275,0.6423611111111112,42.369791666666664,1030.5208333333328,26.423611111111097,0
4763,4,0,0,43,0.0,0.0,1.0,43,1200,1000,200,0.8333333333333334,14,10,4,359.106213651668,0.3791989664082687,0.17242189335212577,0.21945379723157493,132934.57031250003,947.5260416666665,133882.0963541667,4615,7,1097.5813953488373,39,4,15,32.92929292929292,0.6442307692307692,42.1875,1031.2500000000002,26.442307692307697,0
4764,4,0,0,43,0.0,0.0,1.0,43,1150,800,350,0.6956521739130435,15,8,7,362.0672724580161,0.37763012181616834,0.1756886829217903,0.2222204709398457,133095.75195312515,1037.9231770833485,134133.6751302085,4616,8,1098.5813953488373,39,4,16,32.69104583080962,0.6458333333333333,42.03125000000001,1031.8750000000011,26.458333333333364,0
4765,4,0,0,43,0.0,0.0,1.0,43,900,700,200,0.7777777777777778,11,7,4,363.53489653224153,0.377422480620155,0.18010720067040564,0.22364772526214277,133183.5911680382,1083.3766070130212,134266.96777505122,4617,9,1099.5813953488373,40,3,16,32.56497981687508,0.6450520833333333,41.94613821138211,1032.2154471544713,25.805386178861784,0
4766,4,0,0,43,0.0,0.0,1.0,43,1350,800,550,0.5925925925925926,19,8,11,357.94237333598846,0.376984126984127,0.17636517189527612,0.22082892868651968,133288.51176754912,941.9212480996766,134230.4330156488,4618,10,1100.5813953488373,40,3,16,32.60403339566315,0.64609375,41.84451219512195,1032.6219512195125,25.815548780487813,0
4767,4,0,0,43,0.0,0.0,1.0,43,1200,800,400,0.6666666666666666,16,8,8,363.4692875819929,0.3768687707641196,0.1870763624480738,0.22028583790614467,132623.7941001078,1041.3147399813201,133665.10884008912,4619,11,1101.5813953488373,37,6,18,33.12930239159747,0.6447072072072071,42.4890350877193,1030.0438596491233,27.839023233760088,1
4768,4,0,0,43,0.0,0.0,1.0,43,800,400,400,0.5,12,4,8,365.2748779497789,0.37673034330011074,0.1884025332181718,0.22188028623749653,132708.5151801516,1095.0173370652499,133803.53251721684,4620,12,1102.5813953488373,37,6,14,32.99756571246144,0.6455518018018017,42.406798245614034,1030.372807017544,27.84791370317686,0
4769,4,0,0,43,0.0,0.0,1.0,43,1000,700,300,0.7,13,7,6,363.74409049280956,0.3766611295681063,0.18546800879324254,0.22155321875471123,132810.65088757395,1061.8178829717267,133872.46877054567,4621,13,1103.5813953488373,38,5,15,32.93428689883914,0.6447368421052632,42.30769230769231,1030.7692307692307,27.125506072874494,0
4770,4,1,1,43,0.022727272727272728,0.022727272727272728,0.9772727272727273,44,1050,600,450,0.5714285714285714,15,6,9,358.5691466606428,0.3808359760394644,0.18981626568054266,0.21997296350728116,133078.7118799159,743.5840314957868,133822.2959114117,4622,0,1079.4772727272727,40,4,15,32.79839292163235,0.6440104166666667,42.04776422764227,1031.8089430894297,25.795223577235742,0
4771,4,1,0,44,0.022727272727272728,0.0,1.0,44,650,400,250,0.6153846153846154,9,4,5,365.1399999473415,0.3813755285412262,0.2133957640155988,0.22574713865357524,133367.22932778104,939.542021944605,134306.77134972563,4623,0,1080.4545454545455,40,4,16,32.33922012331104,0.6468750000000001,41.76829268292683,1032.9268292682923,25.823170731707307,0
4772,4,0,0,44,0.0,0.0,1.0,44,1650,1500,150,0.9090909090909091,18,15,3,365.2917458707642,0.38118833685694153,0.21222726763660793,0.22666365523836357,133502.12358807004,953.6513175317366,134455.77490560178,4624,1,1081.4545454545455,35,9,17,32.19997106805539,0.6574404761904762,41.637731481481474,1033.4490740740732,29.527116402116377,0
4773,4,0,0,44,0.0,0.0,1.0,44,1150,800,350,0.6956521739130435,15,8,7,359.3262226847032,0.3813975510923185,0.2003299120234603,0.22278225806451618,133472.2222222223,792.0138888888999,134264.2361111112,4625,2,1082.4545454545455,39,5,17,32.38407258064516,0.6495726495726495,41.66666666666667,1033.3333333333342,26.49572649572652,2
4774,4,0,0,44,0.0,0.0,1.0,44,1250,1000,250,0.8,15,10,5,358.8531735824996,0.3812103594080338,0.20330745080173185,0.22301376305441825,133559.51126379726,785.6508958282268,134345.1621596255,4626,3,1083.4545454545455,36,8,17,32.308802701819374,0.6559606481481484,41.58220720720719,1033.6711711711687,28.713088088088018,0
4775,4,0,0,44,0.0,0.0,1.0,44,800,500,300,0.625,11,5,6,359.14268231603705,0.3811663143058492,0.20736748819201756,0.22354501466735824,133617.7198101817,797.5652595162587,134415.28506969797,4627,4,1084.4545454545455,36,8,17,32.24299277493374,0.6565393518518519,41.52590090090089,1033.8963963963954,28.719344344344318,0
4776,4,0,0,44,0.0,0.0,1.0,44,950,700,250,0.7368421052631579,12,7,5,357.7724222287709,0.3807809196617336,0.20776286220585494,0.2230430518212354,133675.94103816632,765.1130437870058,134441.05408195333,4628,5,1085.4545454545455,36,8,17,32.2200896584268,0.6571180555555557,41.46959459459458,1034.1216216216199,28.72560060060055,0
4777,4,0,0,44,0.0,0.0,1.0,44,1000,500,500,0.5,15,5,10,358.3145580961601,0.38090204369274133,0.20962290295442187,0.22373346132652785,133734.1749477515,783.7803597516101,134517.9553075031,4629,6,1086.4545454545455,36,8,15,32.147749954636176,0.6576967592592595,41.41328828828827,1034.3468468468445,28.731856856856794,0
4778,4,0,0,44,0.0,0.0,1.0,44,1300,800,500,0.6153846153846154,18,8,10,357.4858919799979,0.38042855884425647,0.20134239502153073,0.2238616033586753,133840.71451071464,769.233442020601,134609.94795273524,4630,7,1087.4545454545455,37,7,15,32.062515453357356,0.6568130630630632,41.31030701754385,1034.7587719298228,27.96645329540062,0
4779,4,0,1,43,0.0,0.022727272727272728,0.9772727272727273,44,700,500,200,0.7142857142857143,9,5,4,357.4858919799979,0.38042855884425647,0.20134239502153073,0.2238616033586753,133840.71451071464,769.233442020601,134609.94795273524,4631,8,1088.4545454545455,37,7,15,32.062515453357356,0.6568130630630632,41.31030701754385,1034.7587719298228,27.96645329540062,0
4780,4,0,0,43,0.0,0.0,1.0,43,600,300,300,0.5,9,3,6,366.93026593095175,0.3773301956441491,0.21406891942861628,0.22947504105566036,133792.42153893746,1218.4977629656541,135010.9193019031,4632,9,1113.953488372093,36,7,15,31.86658684372846,0.658275462962963,41.356981981981974,1034.572072072071,28.738113113113084,0
4781,4,1,0,44,0.022727272727272728,0.0,1.0,44,1400,1000,400,0.7142857142857143,18,10,8,356.47964255622503,0.3798559725158563,0.21567390432029954,0.22531369844145796,134182.00481071128,766.6306224800131,134948.6354331913,4633,0,1089.6136363636363,40,4,17,31.747179990191256,0.6549479166666666,40.98069105691057,1036.0772357723583,25.901930894308958,0
4782,4,0,0,44,0.0,0.0,1.0,44,1300,900,400,0.6923076923076923,17,9,8,360.6514066767812,0.37948158914728686,0.22209720972097102,0.22893621652208168,134339.9898890379,889.9812652852431,135229.97115432317,4634,1,1090.6136363636363,40,4,18,31.48118648498513,0.6565104166666667,40.82825203252034,1036.6869918699213,25.917174796748032,0
4783,4,0,0,44,0.0,0.0,1.0,44,1300,900,400,0.6923076923076923,17,9,8,361.7393895251688,0.3795917019027484,0.22663567657827666,0.2301437515950452,134422.15377180977,925.1575688145776,135347.31134062435,4635,2,1091.6136363636363,41,3,19,31.370878376223736,0.6557418699186991,40.749007936507944,1037.0039682539693,25.292779713511447,0
4784,4,0,0,44,0.0,0.0,1.0,44,1150,800,350,0.6956521739130435,15,8,7,361.9718941897596,0.3793824876673714,0.22648812887409053,0.23094204377927505,134525.0508334121,938.8574932287764,135463.90832664087,4636,3,1092.6136363636363,41,3,19,31.262053329508152,0.6567581300813007,40.64980158730159,1037.4007936507937,25.302458381726677,0
4785,4,0,0,44,0.0,0.0,1.0,44,1200,1000,200,0.8333333333333334,14,10,4,361.9718941897596,0.3793824876673714,0.22648812887409053,0.23094204377927505,134525.0508334121,938.8574932287764,135463.90832664087,4637,4,1093.6136363636363,41,3,19,31.262053329508152,0.6567581300813007,40.64980158730159,1037.4007936507937,25.302458381726677,0
4786,4,0,0,44,0.0,0.0,1.0,44,1050,800,250,0.7619047619047619,13,8,5,361.84980054345897,0.3789200140944327,0.22971281987111314,0.23161575338750934,134643.43112244908,944.1569625535524,135587.58808500264,4638,5,1094.6136363636363,34,10,19,31.147004282327757,0.6709558823529411,40.53571428571429,1037.8571428571436,30.525210084033635,0
4787,4,0,0,44,0.0,0.0,1.0,44,1300,900,400,0.6923076923076923,17,9,8,365.0156906763239,0.3784355179704017,0.23824424457807436,0.2346375733065273,134797.9184382087,1040.671060090712,135838.5894982994,4639,6,1095.6136363636363,34,10,16,30.910619435209593,0.6724877450980391,40.386904761904766,1038.4523809523816,30.542717086834756,0
4788,4,0,0,44,0.0,0.0,1.0,44,1250,800,450,0.64,17,8,9,343.71684353534,0.3786777660324172,0.14151594359194664,0.21735228497431808,134199.7734917533,458.68138596582656,134658.4548777191,4640,7,1096.6136363636363,39,5,17,32.06002228477597,0.6567841880341883,40.96354166666666,1036.145833333332,26.56784188034184,6
4789,4,0,0,44,0.0,0.0,1.0,44,1350,1000,350,0.7407407407407407,17,10,7,342.69008913497674,0.37832540521494007,0.13908591898201816,0.21769142524003904,134366.32977229138,409.2019052812236,134775.5316775726,4641,8,1097.6136363636363,40,4,17,31.9204159315167,0.6567708333333335,40.80284552845527,1036.788617886177,25.919715447154424,0
4790,4,0,0,44,0.0,0.0,1.0,44,1450,1000,450,0.6896551724137931,19,10,9,341.37126453159914,0.3786447322057787,0.14337685237959574,0.21779486677115975,134524.4232930131,384.55449798397217,134908.97779099707,4642,9,1098.6136363636363,40,4,18,31.796956635318708,0.6583333333333334,40.650406504065025,1037.3983739837372,25.93495934959343,0
4791,4,0,0,44,0.0,0.0,1.0,44,1200,800,400,0.6666666666666666,16,8,8,339.212718428402,0.37817124735729385,0.1450557573324085,0.21689583446622185,134604.8231336804,331.9361757117763,134936.75930939216,4643,10,1099.6136363636363,39,5,18,31.77282004952152,0.6607905982905984,40.57291666666666,1037.708333333332,26.607905982905947,0
4792,4,0,0,44,0.0,0.0,1.0,44,1200,700,500,0.5833333333333334,17,7,10,342.06247055763237,0.377973044397463,0.14856420922044022,0.21936902069352393,134712.93945312488,416.0481770833194,135128.9876302082,4644,11,1100.6136363636363,39,5,18,31.591159943808936,0.6618589743589745,40.46874999999999,1038.124999999999,26.61858974358972,0
4793,4,0,0,44,0.0,0.0,1.0,44,1050,600,450,0.5714285714285714,15,6,9,368.59409611273463,0.37792899929527835,0.23877967081717544,0.218686373614315,131819.15181651223,953.5331256086899,132772.68494212092,4645,12,1101.6136363636363,36,8,18,33.80853163724092,0.6385995370370372,43.27139639639638,1026.9144144144125,28.525400400400347,5
4794,4,0,0,44,0.0,0.0,1.0,44,950,700,250,0.7368421052631579,12,7,5,371.00003773919116,0.37733439041578576,0.2387048718025373,0.22078495396573,131934.8206948502,989.5646913805678,132924.38538623077,4646,13,1102.6136363636363,36,8,18,33.62997369286419,0.6397569444444444,43.15878378378378,1027.3648648648646,28.537912912912905,0
4795,4,0,0,44,0.0,0.0,1.0,44,850,400,450,0.47058823529411764,13,4,9,373.626331394258,0.37759866102889356,0.23590286425902884,0.2226871504880864,131992.67415641993,1063.1877231961707,133055.8618796161,4647,14,1103.6136363636363,36,8,18,33.5041095890411,0.6403356481481481,43.10247747747748,1027.5900900900901,28.54416916916917,0
4796,4,0,0,44,0.0,0.0,1.0,44,1200,800,400,0.6666666666666666,16,8,8,373.626331394258,0.3778298978153629,0.23590286425902884,0.2226871504880864,131992.67415641993,1063.1877231961707,133055.8618796161,4648,15,1104.6136363636363,36,8,18,33.5041095890411,0.6403356481481481,43.10247747747748,1027.5900900900901,28.54416916916917,0
4797,4,0,0,44,0.0,0.0,1.0,44,1550,1200,350,0.7741935483870968,19,12,7,370.94837301541105,0.3774665257223397,0.23281880235805152,0.22181198631329657,132116.0357032932,1001.6456986765002,133117.6814019697,4649,16,1105.6136363636363,37,7,18,33.44843216723549,0.6396396396396395,42.98245614035087,1028.0701754385955,27.785680417259336,0
4798,4,0,0,44,0.0,0.0,1.0,44,850,500,350,0.5882352941176471,12,5,7,369.60279322243525,0.3775105708245243,0.22953091684435,0.22166714836486187,132228.7867420744,974.425784856871,133203.21252693125,4650,17,1106.6136363636363,37,7,18,33.369314143567884,0.6407657657657657,42.872807017543856,1028.5087719298238,27.797534376481725,0
4799,4,0,0,44,0.0,0.0,1.0,44,1250,700,550,0.56,18,7,11,365.05274599431317,0.3775215821000704,0.22465307278391422,0.21944181922130035,132315.55103550272,860.4310486521764,133175.9820841549,4651,18,1107.6136363636363,38,6,18,33.398883696780885,0.6398026315789475,42.788461538461526,1028.846153846152,27.074898785425052,0
4800,4,0,0,44,0.0,0.0,1.0,44,1100,700,400,0.6363636363636364,15,7,8,368.6671996864062,0.3765966349541931,0.22696193971218537,0.22244137771177858,132455.9583865963,966.4848162671948,133422.44320286348,4652,19,1108.6136363636363,36,8,18,33.16445137293515,0.6449652777777777,42.65202702702704,1029.3918918918937,28.59421921921927,0
4801,4,0,0,44,0.0,0.0,1.0,44,350,100,250,0.2857142857142857,6,1,5,369.4890806426579,0.3768609055673009,0.22952009705455367,0.2231089283510687,132484.9405993833,990.3477802126644,133475.28837959596,4653,20,1109.6136363636363,36,8,18,33.114107051702774,0.6452546296296295,42.62387387387388,1029.5045045045056,28.597347347347377,0
4802,4,0,0,44,0.0,0.0,1.0,44,850,600,250,0.7058823529411765,11,6,5,365.7123101613901,0.3769930408738548,0.22979905528883404,0.221312501097666,132567.32840874116,896.3007848568811,133463.62919359803,4654,21,1110.6136363636363,37,7,18,33.12837166382738,0.6441441441441441,42.54385964912281,1029.8245614035088,27.833096254148888,0
4803,4,0,0,44,0.0,0.0,1.0,44,1050,800,250,0.7619047619047619,13,8,5,363.3125572478017,0.37693798449612403,0.22817968984298642,0.22068830642906215,132708.5151801516,842.9340037319157,133551.4491838835,4655,22,1111.6136363636363,37,7,16,33.04811375971056,0.6455518018018017,42.406798245614034,1030.372807017544,27.84791370317686,0
4804,4,0,0,44,0.0,0.0,1.0,44,900,500,400,0.5555555555555556,13,5,8,367.1193728912433,0.37693798449612403,0.2291269787546779,0.22367396140962928,132821.51870046562,952.2705303555014,133773.78923082113,4656,23,1112.6136363636363,37,7,16,32.83637822217494,0.6466779279279279,42.29714912280702,1030.8114035087726,27.85976766239926,0
4805,4,0,0,44,0.0,0.0,1.0,44,1400,1100,300,0.7857142857142857,17,11,6,368.16651362105904,0.3765636011275546,0.23062442607897138,0.22499064721286943,132934.57031250003,988.4114583333345,133922.98177083337,4657,24,1113.6136363636363,37,7,16,32.695707070707066,0.6478040540540541,42.1875,1031.2500000000002,27.871621621621628,0
4806,4,0,0,44,0.0,0.0,1.0,44,800,400,400,0.5,12,4,8,373.96406732366853,0.3762112403100775,0.2332220601165227,0.22922657390543327,133047.6700162551,1151.009565443224,134198.67958169835,4658,25,1114.6136363636363,37,7,16,32.4324892833103,0.6489301801801801,42.077850877192986,1031.688596491229,27.883475580844028,0
4807,4,0,0,44,0.0,0.0,1.0,44,1650,1400,250,0.8484848484848485,19,14,5,375.01140760336324,0.3767177589852009,0.23896097000588878,0.23126931404065948,133274.01369892654,1195.855094836871,134469.86879376342,4659,26,1115.6136363636363,37,7,18,32.17795387773884,0.6511824324324325,41.858552631578945,1032.565789473684,27.907183499288756,0
4808,4,0,0,44,0.0,0.0,1.0,44,1150,700,450,0.6086956521739131,16,7,9,377.69626550018825,0.376244274136716,0.24210744678798202,0.2338143372892755,133415.57618690367,1278.1129770698744,134693.68916397353,4660,27,1116.6136363636363,37,7,18,31.966408405858648,0.6525900900900901,41.72149122807018,1033.1140350877195,27.922000948316743,0
4809,4,0,0,44,0.0,0.0,1.0,44,1050,600,450,0.5714285714285714,15,6,9,376.401530699281,0.3762993305144468,0.24206191999524584,0.23391940760248492,133559.51126379767,1254.412918758403,134813.92418255607,4661,28,1117.6136363636363,36,8,18,31.855321930493524,0.6559606481481481,41.58220720720721,1033.6711711711719,28.713088088088107,0
4810,4,1,1,44,0.022222222222222223,0.022222222222222223,0.9777777777777777,45,1400,1000,400,0.7142857142857143,18,10,8,367.41037229726913,0.37935606060606064,0.2399604352126603,0.2298994875992727,133812.35091566644,832.8091335795677,134645.160049246,4662,0,1093.7555555555555,37,8,18,31.834198813056375,0.6565315315315314,41.33771929824562,1034.649122807018,27.963489805595085,0
4811,4,0,0,44,0.0,0.0,1.0,44,1200,900,300,0.75,15,9,6,374.9149048347621,0.37574876673713886,0.2460201977373906,0.2342349147159704,133755.63274276728,1229.3960641736207,134985.0288069409,4663,30,1119.6136363636363,37,7,18,31.696964878807165,0.6559684684684683,41.39254385964914,1034.4298245614057,27.95756282598394,0
4812,4,0,0,44,0.0,0.0,1.0,44,1200,800,400,0.6666666666666666,16,8,8,379.4649618035253,0.3748458421423538,0.24928229665071755,0.23845755381816874,133969.47937212363,1367.3446745562178,135336.82404667986,4664,31,1120.6136363636363,38,6,18,31.364809081527348,0.65625,41.18589743589744,1035.2564102564106,27.24358974358975,0
4813,4,0,0,44,0.0,0.0,1.0,44,800,500,300,0.625,11,5,6,363.32779372224036,0.37435033474277657,0.20609296305675162,0.22883276832681446,134052.44545118336,940.9958497698804,134993.44130095324,4665,32,1121.6136363636363,38,6,16,31.699422263489108,0.6570723684210527,41.105769230769226,1035.5769230769224,27.252024291497957,3
4814,4,0,0,44,0.0,0.0,1.0,44,1350,1100,250,0.8148148148148148,16,11,5,361.0532467522494,0.3738328047921071,0.19985649781547687,0.22814711513328262,134172.79188368042,888.7044270833246,135061.49631076373,4666,33,1122.6136363636363,39,5,17,31.637928145318064,0.6565170940170941,40.98958333333333,1036.0416666666656,26.565170940170912,0
4815,4,0,0,44,0.0,0.0,1.0,44,1400,1100,300,0.7857142857142857,17,11,6,363.226801579978,0.3738438160676533,0.20376435442760465,0.23036774394661305,134307.72705078113,956.8332248263755,135264.5602756075,4667,34,1123.6136363636363,39,5,17,31.446692962181334,0.6578525641025642,40.85937499999999,1036.562499999999,26.578525641025617,0
4816,4,0,0,44,0.0,0.0,1.0,44,1800,1500,300,0.8333333333333334,21,15,6,362.49977871101305,0.3728528012684989,0.20611315981686373,0.23094087025746518,134471.7151249254,949.1933951351466,135420.90852006053,4668,35,1124.6136363636363,40,4,17,31.30164445750865,0.6578125000000001,40.70121951219511,1037.1951219512175,25.929878048780438,0
4817,4,0,0,44,0.0,0.0,1.0,44,1050,500,550,0.47619047619047616,16,5,11,365.54066104766264,0.3722141472868217,0.20589520909186998,0.23356592001985332,134579.22299409422,1038.905340276862,135618.12833437108,4669,36,1125.6136363636363,37,7,17,31.11537479305364,0.664132882882883,40.59758771929824,1037.609649122806,28.04350403034611,0
4818,4,0,0,44,0.0,0.0,1.0,44,1300,900,400,0.6923076923076923,17,9,8,364.595464784856,0.3710469520789288,0.20899105119637462,0.2338746518010172,134721.47680055388,1023.7678901200208,135745.2446906739,4670,37,1126.6136363636363,37,7,17,30.997834811998306,0.6655405405405406,40.460526315789465,1038.1578947368412,28.058321479374086,0
4819,4,0,0,44,0.0,0.0,1.0,44,700,500,200,0.7142857142857143,9,5,4,363.15656758834456,0.37123414376321356,0.20705603932449423,0.2331342059995954,134749.93657904342,987.0648901584963,135737.00146920193,4671,38,1127.6136363636363,37,7,17,31.00677209842644,0.6658220720720722,40.43311403508771,1038.2675438596482,28.06128496917968,0
4820,4,0,0,44,0.0,0.0,1.0,44,1300,900,400,0.6923076923076923,17,9,8,358.1521593437531,0.3710799859055673,0.20073830279309823,0.23049843000586578,134840.88918633058,858.711125983179,135699.60031231376,4672,39,1128.6136363636363,40,4,16,31.045947488584467,0.6614583333333335,40.34552845528454,1038.6178861788592,25.96544715447148,0
4821,4,0,0,44,0.0,0.0,1.0,44,1050,800,250,0.7619047619047619,13,8,5,354.08712286511957,0.3701770613107822,0.1951166925983554,0.22871388700542264,134972.8597085892,758.4303118183345,135731.29002040756,4673,40,1129.6136363636363,40,4,16,31.019967400162983,0.6627604166666667,40.218495934959336,1039.1260162601604,25.97815040650401,0
4822,4,0,0,44,0.0,0.0,1.0,44,1000,400,600,0.4,16,4,12,336.72927968325797,0.3701770613107822,0.13308303758787732,0.20515826042140697,132821.5187004656,235.27523159153583,133056.79393205713,4674,41,1130.6136363636363,37,7,14,33.6195395879871,0.6466779279279279,42.29714912280702,1030.8114035087724,27.859767662399253,7
4823,4,0,0,44,0.0,0.0,1.0,44,1150,1000,150,0.8695652173913043,13,10,3,323.7227294333619,0.36994582452431285,0.11216415163783555,0.19502320529278167,132398.00347222234,-227.9513888888838,132170.05208333346,4675,42,1131.6136363636363,38,6,18,34.37921727395412,0.640625,42.708333333333336,1029.1666666666674,27.083333333333353,5
4824,4,0,0,44,0.0,0.0,1.0,44,1200,800,400,0.6666666666666666,16,8,8,325.5170649174745,0.3690428999295278,0.11552283574487321,0.19682142231333896,132535.48127145896,-171.48782781794296,132363.99344364103,4676,43,1132.6136363636363,38,6,18,34.19515632565539,0.6419956140350876,42.57478632478633,1029.7008547008556,27.097390913180412,0
4825,4,0,0,44,0.0,0.0,1.0,44,1100,800,300,0.7272727272727273,14,8,6,324.7331313166096,0.36877862931641997,0.11682855526216529,0.19663488604849994,132590.49236613355,-188.69484622687798,132401.79751990666,4677,44,1133.6136363636363,38,6,18,34.16018326417706,0.6425438596491228,42.52136752136753,1029.9145299145312,27.10301394511924,0
4826,4,0,0,44,0.0,0.0,1.0,44,1650,1000,650,0.6060606060606061,23,10,13,324.0451315268175,0.3688006518675124,0.11833547000490174,0.19679415922195398,132700.54879830524,-199.80664219446015,132500.7421561108,4678,45,1134.6136363636363,38,6,14,34.067598161205595,0.643640350877193,42.414529914529915,1030.3418803418806,27.114260008996858,0
4827,4,1,1,44,0.022222222222222223,0.022222222222222223,0.9777777777777777,45,1350,900,450,0.6666666666666666,18,9,9,317.880063904535,0.3731902356902357,0.11375228606370658,0.19467942318160883,133015.1489257814,-543.4271918402619,132471.72173394114,4679,0,1110.3777777777777,39,6,16,33.911546164461946,0.6450320512820513,42.10937500000001,1031.5625000000011,26.450320512820543,0
4828,4,0,0,44,0.0,0.0,1.0,44,1200,900,300,0.75,15,9,6,325.67135437235515,0.3684703136011276,0.11621210551594907,0.19909471714733046,132948.34270445263,-140.50663397616404,132807.83607047648,4680,47,1136.6136363636363,38,6,17,33.77749576988157,0.6461074561403508,42.17414529914531,1031.30341880342,27.13956365272158,0
4829,4,0,0,44,0.0,0.0,1.0,44,1450,1200,250,0.8275862068965517,17,12,5,324.64169491855114,0.3691970577871741,0.1074876272557912,0.19978904817216844,133196.3677496531,-151.781083351586,133044.5866663015,4681,48,1137.6136363636363,38,6,18,33.555854550472645,0.6485745614035088,41.93376068376069,1032.264957264958,27.16486729644626,0
4830,4,1,1,44,0.022222222222222223,0.022222222222222223,0.9777777777777777,45,1500,1100,400,0.7333333333333333,19,11,8,320.62955254942744,0.37325336700336703,0.1102150537634412,0.19879032258064536,133472.22222222245,-440.9722222221975,133031.25000000026,4682,0,1113.3111111111111,39,6,18,33.38373655913979,0.6495726495726495,41.66666666666668,1033.333333333335,26.49572649572654,0
4831,4,0,0,44,0.0,0.0,1.0,44,850,700,150,0.8235294117647058,10,7,3,327.4354116504277,0.36899885482734324,0.11119575644715307,0.20210668512216076,133306.67529585818,-70.13477975014192,133236.54051610804,4683,50,1139.6136363636363,38,6,18,33.373422304986555,0.6496710526315788,41.82692307692309,1032.6923076923092,27.176113360323928,0
4832,4,0,0,44,0.0,0.0,1.0,44,1400,600,800,0.42857142857142855,22,6,16,328.77695197966995,0.36866851656095845,0.1161932111937285,0.20369006422776356,133444.62393390675,-25.296656987361416,133419.3272769194,4684,51,1140.6136363636363,38,6,18,33.20084961913625,0.6510416666666666,41.69337606837607,1033.2264957264956,27.190170940170937,0
4833,4,0,0,44,0.0,0.0,1.0,44,1550,900,650,0.5806451612903226,22,9,13,331.2981488867022,0.36882267441860467,0.11420489785178622,0.20571105855776362,133527.42735955876,47.477901965083305,133574.90526152385,4685,52,1141.6136363636363,38,6,19,33.052942595272555,0.6518640350877192,41.613247863247864,1033.5470085470085,27.19860548807917,0
4834,4,0,0,44,0.0,0.0,1.0,44,1150,700,450,0.6086956521739131,16,7,9,328.3806750959838,0.3685804263565891,0.054682159945317776,0.19525128611001188,131901.66650142102,-137.20834159561758,131764.4581598254,4686,53,1142.6136363636363,40,4,16,34.75794750032978,0.6322916666666667,43.1910569105691,1027.235772357723,25.680894308943074,5
4835,4,0,0,44,0.0,0.0,1.0,44,1050,700,350,0.6666666666666666,14,7,7,328.9762648839329,0.3691640239605356,0.06121439873417689,0.19614433906287312,132006.08103642007,-114.62650373455529,131891.45453268552,4687,54,1143.6136363636363,40,4,16,34.63768295094936,0.6333333333333333,43.08943089430894,1027.6422764227639,25.691056910569095,0
4836,4,0,0,44,0.0,0.0,1.0,44,950,600,350,0.631578947368421,13,6,7,329.38872960569057,0.3692190803382664,0.06245168713035043,0.19666101601133162,132058.30379569056,-100.29661577101945,131958.00717991954,4688,55,1144.6136363636363,40,4,16,34.57459956495946,0.6338541666666666,43.03861788617887,1027.8455284552858,25.696138211382145,0
4837,4,1,1,44,0.022222222222222223,0.022222222222222223,0.9777777777777777,45,1250,900,350,0.72,16,9,7,321.783871396702,0.3741161616161616,0.05842494374799134,0.1933313294544497,132295.92328829697,-485.86112685813214,131810.06216143884,4689,0,1120.1555555555556,41,4,17,34.53150112504018,0.6346544715447153,42.80753968253969,1028.7698412698426,25.09194734804494,0
4838,4,0,0,44,0.0,0.0,1.0,44,950,500,450,0.5263157894736842,14,5,9,328.7382571239842,0.36923009161381254,0.05616478956727877,0.1973599429779934,132267.29811124338,-103.73578888227672,132163.5623223611,4690,57,1146.6136363636363,40,4,17,34.38138049133899,0.6359375,42.83536585365854,1028.6585365853664,25.71646341463416,0
4839,4,1,0,45,0.022222222222222223,0.0,1.0,45,1250,1000,250,0.8,15,10,5,340.3551111300311,0.3730639730639731,0.0957052997707537,0.19921201299276478,131301.43364800353,-62.04809375050502,131239.38555425304,4691,0,1122.111111111111,39,6,17,35.055328285394864,0.6279380341880341,43.77604166666667,1024.895833333334,26.27938034188036,2
4840,4,1,1,45,0.021739130434782608,0.021739130434782608,0.9782608695652174,46,1100,600,500,0.5454545454545454,16,6,10,336.85202554099425,0.37695249597423514,0.10243149823199871,0.1985431238511822,131568.46923828128,-336.1762152777761,131232.2930230035,4692,0,1098.695652173913,39,7,17,34.875896876163395,0.6306089743589745,43.515625,1025.9375000000002,26.306089743589748,0
4841,4,0,0,45,0.0,0.0,1.0,45,1150,900,250,0.782608695652174,14,9,5,339.4089121108866,0.3775042087542087,0.09925709921544157,0.19993891865575045,131547.23340821092,-70.33932354445551,131476.89408466645,4693,1,1085.1777777777777,38,7,18,34.831719086301476,0.6321271929824561,43.53632478632478,1025.8547008547002,26.996176338281586,0
4842,4,0,0,45,0.0,0.0,1.0,45,1100,800,300,0.7272727272727273,14,8,6,338.9084896425741,0.3775042087542087,0.10292933499930612,0.1999310279193662,131602.0390459493,-79.79034261085349,131522.24870333844,4694,2,1086.1777777777777,38,7,17,34.78932389282244,0.6326754385964912,43.48290598290598,1026.068376068376,27.00179937022042,0
4843,4,0,0,45,0.0,0.0,1.0,45,1550,1300,250,0.8387096774193549,18,13,5,338.4638703106836,0.3776304713804714,0.11026922009436602,0.2002438956862712,131711.6845642485,-84.07069544891681,131627.61386879958,4695,3,1087.1777777777777,38,7,17,34.69027546489038,0.6337719298245614,43.37606837606837,1026.4957264957252,27.013045434098032,0
4844,4,0,0,45,0.0,0.0,1.0,45,1550,1200,350,0.7741935483870968,19,12,7,342.70457787960044,0.3773779461279461,0.12075335676308896,0.2041327268239359,131969.53125000003,45.31250000000102,132014.84375000003,4696,4,1088.1777777777777,39,6,18,34.321776155717764,0.6346153846153847,43.125,1027.5000000000002,26.34615384615385,0
4845,4,0,0,45,0.0,0.0,1.0,45,1200,900,300,0.75,15,9,6,341.35386452613534,0.3776515151515152,0.11665090303112224,0.2039031437738438,132076.58420138876,16.970486111102957,132093.55468749985,4697,5,1089.1777777777777,39,6,18,34.24875016889611,0.6356837606837608,43.02083333333333,1027.9166666666656,26.35683760683758,0
4846,4,0,0,45,0.0,0.0,1.0,45,1350,900,450,0.6666666666666666,18,9,9,337.4382727737117,0.3769360269360269,0.11689510048837581,0.20242196265902984,132237.24500868065,-75.61848958332718,132161.62651909734,4698,6,1090.1777777777777,39,6,18,34.18785024643846,0.6372863247863249,42.864583333333336,1028.5416666666674,26.37286324786327,0
4847,4,0,0,45,0.0,0.0,1.0,45,1550,1300,250,0.8387096774193549,18,13,5,339.59184270690463,0.37617845117845117,0.11711824417009664,0.20429990537180084,132345.71358194522,-11.295050069405022,132334.41853187582,4699,7,1091.1777777777777,40,5,18,34.02345679012347,0.63671875,42.75914634146341,1028.963414634146,25.724085365853647,0
4848,4,0,0,45,0.0,0.0,1.0,45,1100,800,300,0.7272727272727273,14,8,6,336.7877179748955,0.37647306397306396,0.11950873551288743,0.20319033579762782,132452.98603121113,-78.27156342318142,132374.71446778794,4700,8,1092.1777777777777,38,7,18,33.98784812316208,0.6411732456140351,42.65491452991453,1029.3803418803413,27.08895636527214,0
4849,4,0,0,45,0.0,0.0,1.0,45,1000,800,200,0.8,12,8,4,337.4995695666396,0.3760942760942761,0.12282157676348548,0.20436531725015117,132590.49236613343,-50.15317956022716,132540.3391865732,4701,9,1093.1777777777777,38,7,18,33.83147475795298,0.6425438596491228,42.52136752136752,1029.9145299145302,27.103013945119216,0
4850,4,0,0,45,0.0,0.0,1.0,45,1150,800,350,0.6956521739130435,15,8,7,334.36210707230947,0.37592592592592594,0.12298517933877084,0.202697028545749,132633.43578557714,-130.48098849893034,132502.95479707822,4702,10,1094.1777777777777,40,5,15,33.8691709418574,0.6395833333333334,42.47967479674796,1030.0813008130065,25.752032520325162,0
4851,4,0,0,45,0.0,0.0,1.0,45,900,600,300,0.6666666666666666,12,6,6,335.354646943631,0.3755681818181818,0.12427261071111562,0.20372443171728424,132711.95969867468,-98.88552201071718,132613.07417666397,4703,11,1095.1777777777777,40,5,16,33.76483545385804,0.6403645833333333,42.40345528455284,1030.386178861788,25.7596544715447,0
4852,4,0,0,45,0.0,0.0,1.0,45,1650,1200,450,0.7272727272727273,21,12,9,340.0555911680827,0.3759048821548821,0.12558786484858464,0.2074482244377747,132869.07723783766,36.574521614087644,132905.65175945175,4704,12,1096.1777777777777,40,5,16,33.4861179563003,0.6419270833333335,42.25101626016259,1030.9959349593476,25.77489837398369,0
4853,4,0,0,45,0.0,0.0,1.0,45,1200,700,500,0.5833333333333334,17,7,10,338.45053466381734,0.37598905723905723,0.11862361918525077,0.20704849163972772,132973.87390318266,1.01574377024059,132974.88964695288,4705,13,1097.1777777777777,40,5,16,33.422422570368184,0.6429687500000001,42.14939024390244,1031.4024390243903,25.78506097560976,0
4854,4,0,0,45,0.0,0.0,1.0,45,950,500,450,0.5263157894736842,14,5,9,336.2949149645109,0.37527356902356906,0.11523331034709261,0.20601868930626124,133026.28772762563,-52.78717611872088,132973.5005515069,4706,14,1098.1777777777777,40,5,16,33.42548353200012,0.6434895833333334,42.09857723577235,1031.6056910569098,25.790142276422745,0
4855,4,0,0,45,0.0,0.0,1.0,45,1400,900,500,0.6428571428571429,19,9,10,338.26753220845814,0.3750841750841751,0.11887444750776832,0.20795672258529652,133157.3674730649,8.56281809768825,133165.93029116257,4707,15,1099.1777777777777,40,5,16,33.243279834580555,0.6447916666666667,41.97154471544715,1032.1138211382108,25.802845528455272,0
4856,4,0,0,45,0.0,0.0,1.0,45,900,600,300,0.6666666666666666,12,6,6,336.3267151985438,0.3755260942760943,0.12104745028548924,0.2070549559385945,133209.81744497325,-39.595933306890856,133170.22151166634,4708,16,1100.1777777777777,40,5,16,33.24083645074489,0.6453125,41.920731707317074,1032.3170731707319,25.807926829268297,0
4857,4,0,0,45,0.0,0.0,1.0,45,950,600,350,0.631578947368421,13,6,7,359.2273482297584,0.3755260942760943,0.17522992427935424,0.20035861396371013,129428.42306193302,351.23384524466513,129779.65690717769,4709,17,1101.1777777777777,41,4,15,36.47173881251829,0.6059451219512195,45.610119047619044,1017.5595238095231,24.818524970963978,7
4858,4,0,0,45,0.0,0.0,1.0,45,1050,800,250,0.7619047619047619,13,8,5,358.22434481256806,0.375736531986532,0.17971805366075477,0.20044156087604012,129554.63927469145,281.92515432099515,129836.56442901245,4710,18,1102.1777777777777,41,4,15,36.368804001818994,0.6072154471544715,45.486111111111114,1018.0555555555563,24.830623306233083,0
4859,4,0,0,45,0.0,0.0,1.0,45,1000,700,300,0.7,13,7,6,356.01509436052913,0.3756523569023569,0.17383851173663212,0.19984729217056058,129680.91699932292,233.67278045478128,129914.5897797777,4711,19,1103.1777777777777,41,4,16,36.29660968799715,0.6084857723577235,45.36210317460318,1018.5515873015877,24.842721641502138,0
4860,4,1,0,46,0.021739130434782608,0.0,1.0,46,700,400,300,0.5714285714285714,10,4,6,354.43923798950266,0.379639694041868,0.18373398131273633,0.20016399478730848,129916.60399202272,9.508424223302228,129926.11241624602,4712,0,1080.1739130434783,42,4,17,36.097249944555344,0.609375,45.13081395348837,1019.4767441860465,24.27325581395349,0
4861,4,1,1,46,0.02127659574468085,0.02127659574468085,0.9787234042553191,47,1150,800,350,0.6956521739130435,15,8,7,357.01790920449787,0.3817067530064755,0.2061658706035605,0.20341718082581872,130262.58680555566,-97.40447163630893,130165.18233391935,4713,0,1058.1702127659576,40,7,18,35.68027210884354,0.6158854166666666,44.79166666666667,1020.8333333333343,25.520833333333357,0
4862,4,1,1,46,0.02127659574468085,0.02127659574468085,0.9787234042553191,47,1350,900,450,0.6666666666666666,18,9,9,346.7950467908622,0.384404872032069,0.22701971596525028,0.19977348470065173,130688.28125000013,-335.5902777777618,130352.69097222236,4714,0,1053.787234042553,39,8,15,35.5100516164086,0.6217948717948718,44.37500000000001,1022.500000000001,26.217948717948744,0
4863,4,2,1,47,0.041666666666666664,0.020833333333333332,0.9791666666666666,48,850,600,250,0.7058823529411765,11,6,5,340.17351335823037,0.39128989361702127,0.2359463276836158,0.1983225028471896,131150.23389274688,-677.2328317901312,130473.00106095675,4715,0,1023.5208333333334,41,7,18,35.21257062146891,0.6232215447154472,43.92361111111111,1024.3055555555552,24.983062330623298,0
4864,4,0,0,47,0.0,0.0,1.0,47,700,400,300,0.5714285714285714,10,4,6,344.9252824090893,0.38762334258402714,0.23709149080474257,0.2005619064644626,131048.63596190794,-359.6024463025898,130689.03351560535,4716,1,1046.2340425531916,41,6,18,35.19351726253915,0.6222052845528455,44.02281746031746,1023.9087301587305,24.97338366240806,0
4865,4,2,1,48,0.04081632653061224,0.02040816326530612,0.9795918367346939,49,1100,600,500,0.5454545454545454,16,6,10,332.8810584938787,0.3937606292517007,0.22793969165626837,0.19595285362352724,131519.83486969466,-1042.4190437941013,130477.41582590056,4717,0,1004.4897959183673,38,11,19,35.02673332638961,0.6318530701754386,43.56303418803419,1025.7478632478633,26.99336482231219,0
4866,4,0,0,48,0.0,0.0,1.0,48,800,600,200,0.75,10,6,4,339.5128344588955,0.3899693410165485,0.23240607065198016,0.1992959519789786,131412.43128895422,-676.7585939904657,130735.67269496375,4718,1,1026.4166666666667,37,11,19,34.96495472854952,0.6326013513513513,43.66776315789473,1025.3289473684206,27.711593172119475,0
4867,4,0,0,48,0.0,0.0,1.0,48,1000,700,300,0.7,13,7,6,336.5111615580179,0.3897569444444444,0.22698373433322905,0.19808974016667869,131519.83486969466,-748.4215200160706,130771.4133496786,4719,2,1027.4166666666667,38,10,20,34.933644064854356,0.6318530701754386,43.56303418803419,1025.7478632478633,26.99336482231219,0
4868,4,0,0,48,0.0,0.0,1.0,48,450,300,150,0.6666666666666666,6,3,3,335.69933482009907,0.3896830673758865,0.22423331250650813,0.19789568522267734,131574.63480029596,-766.0965236686343,130808.53827662733,4720,3,1028.4166666666667,38,10,16,34.89925023430177,0.6324013157894737,43.50961538461539,1025.961538461539,26.998987854251027,0
4869,4,0,1,47,0.0,0.020833333333333332,0.9791666666666666,48,1600,1500,100,0.9375,17,15,2,334.0424555422879,0.38982158687943264,0.2721713711052023,0.18750098336925924,129678.39084201408,-900.5301431007368,128777.86069891334,4721,4,1029.4166666666667,39,9,14,36.85867934819664,0.6116452991452991,45.36458333333334,1018.5416666666682,26.11645299145303,5
4870,4,0,0,47,0.0,0.0,1.0,47,1200,1000,200,0.8333333333333334,14,10,4,341.2459107271555,0.3859466543324082,0.27873567706880586,0.19173716905029056,129717.84056770043,-546.8634715830128,129170.97709611742,4722,7,1052.2340425531916,38,9,14,36.63520363572802,0.6137609649122806,45.325854700854705,1018.696581196582,26.807804768331106,0
4871,4,0,0,47,0.0,0.0,1.0,47,1100,800,300,0.7272727272727273,14,8,6,340.2450079116045,0.3859466543324082,0.2774858948016572,0.1914405097612373,129772.26382725182,-569.1270134779755,129203.13681377385,4723,8,1053.2340425531916,38,9,14,36.60545769109783,0.6143092105263158,45.2724358974359,1018.9102564102566,26.81342780026991,0
4872,4,0,0,47,0.0,0.0,1.0,47,1050,600,450,0.5714285714285714,15,6,9,338.22482296299387,0.3853492136910268,0.2751062742582544,0.19075100246068583,129864.12896050357,-615.3455946180441,129248.78336588552,4724,9,1054.2340425531916,39,8,15,36.56372423777891,0.6135149572649572,45.18229166666667,1019.2708333333342,26.135149572649595,0
4873,4,1,0,48,0.020833333333333332,0.0,1.0,48,1250,900,350,0.72,16,9,7,333.5275673493286,0.3894152630023641,0.28364746207217095,0.18952746484179997,130158.8642363176,-917.6861284619006,129241.17810785571,4725,0,1033.25,40,8,16,36.38478073233079,0.6148437500000001,44.89329268292683,1020.4268292682921,25.5106707317073,0
4874,4,0,0,48,0.0,0.0,1.0,48,1400,1000,400,0.7142857142857143,18,10,8,334.24834352901405,0.3893321513002364,0.2789683724943586,0.19031691396856107,130236.65229030343,-893.7229410403804,129342.92934926305,4726,1,1034.25,40,8,16,36.287626111774856,0.615625,44.81707317073171,1020.7317073170735,25.518292682926838,0
4875,4,1,0,49,0.02040816326530612,0.0,1.0,49,1550,1200,350,0.7741935483870968,19,12,7,328.77696448113,0.3921130952380953,0.2863286424635707,0.18891346661807612,130589.98243343184,-1212.9966508930627,129376.98578253877,4727,0,1014.1224489795918,38,11,15,36.06995400857113,0.6225328947368423,44.47115384615384,1022.1153846153837,26.897773279352204,0
4876,4,0,0,49,0.0,0.0,1.0,49,900,700,200,0.7777777777777778,11,7,4,327.00998345935733,0.3920068027210884,0.2851597160603372,0.18803074048913043,130617.28395061726,-1257.368827160497,129359.91512345677,4728,1,1015.1224489795918,38,11,15,36.08752264492755,0.6228070175438596,44.44444444444444,1022.2222222222221,26.900584795321635,0
4877,4,0,0,49,0.0,0.0,1.0,49,1350,1000,350,0.7407407407407407,17,10,7,327.8151326732511,0.39239654195011336,0.27823267799991735,0.1893614472265484,130794.81336805546,-1224.6961805555638,129570.1171874999,4729,2,1016.1224489795918,39,10,16,35.887644263408006,0.6228632478632479,44.27083333333333,1022.9166666666658,26.228632478632456,0
4878,4,0,0,49,0.0,0.0,1.0,49,1250,900,350,0.72,16,9,7,313.462249618382,0.3923611111111111,0.22281025648622554,0.17816748081713193,130168.08234739369,-1638.3589463305902,128529.72340106311,4730,3,1017.1224489795918,44,5,14,36.88734385869402,0.6091382575757576,44.88425925925926,1020.462962962963,23.19234006734007,6
4879,4,0,0,49,0.0,0.0,1.0,49,850,600,250,0.7058823529411765,11,6,5,314.36901291128675,0.39184736394557823,0.22457309454393948,0.1791172282866635,130262.58680555566,-1609.8958333333244,128652.69097222234,4731,4,1018.1224489795918,44,5,15,36.7687074829932,0.6100852272727273,44.79166666666667,1020.8333333333343,23.200757575757596,0
4880,4,0,0,49,0.0,0.0,1.0,49,1400,1100,300,0.7857142857142857,17,11,6,315.4708327126049,0.391687925170068,0.22290027860114758,0.18043288375602617,130411.00599610877,-1571.8262687038298,128839.17972740493,4732,5,1019.1224489795918,42,7,16,36.59065395440026,0.6143353174603177,44.64631782945735,1021.4147286821686,24.319398301956397,0
4881,4,0,1,48,0.0,0.02040816326530612,0.9795918367346939,49,1650,1200,450,0.7272727272727273,21,12,9,314.3827813738725,0.3915639172335601,0.21446279792144485,0.18027006142400653,130509.99907044324,-1593.9806990265238,128916.01837141672,4733,6,1020.1224489795918,42,7,13,36.51849217638691,0.6153273809523812,44.54941860465115,1021.8023255813935,24.328626799556986,0
4882,4,0,0,48,0.0,0.0,1.0,48,800,500,300,0.625,11,5,6,320.96557440099696,0.3898400561465721,0.21645754457496036,0.18419311319803167,130541.23682169619,-1220.1513881015453,129321.08543359465,4734,7,1040.0833333333333,41,7,13,36.318783775038014,0.6171239837398375,44.5188492063492,1021.9246031746026,24.92499032133177,0
4883,4,1,1,48,0.02040816326530612,0.02040816326530612,0.9795918367346939,49,1150,800,350,0.6956521739130435,15,8,7,316.24303708777944,0.39239654195011336,0.23046019888751412,0.18302121134083865,130867.47378795058,-1522.8145266586253,129344.65926129196,4735,0,1019.8367346938776,43,6,14,36.110307727903745,0.6174903100775193,44.19981060606061,1023.2007575757581,23.79536645525019,0
4884,4,1,0,49,0.02040816326530612,0.0,1.0,49,1150,900,250,0.782608695652174,14,9,5,312.4622934918775,0.3946286848072562,0.23018672101295468,0.18197521293024532,131109.82090973653,-1606.6249318468815,129503.19597788966,4736,0,989.9591836734694,43,6,16,35.96287948836492,0.6199127906976745,43.96306818181818,1024.147727272727,23.817389006342488,0
4885,4,2,2,49,0.0392156862745098,0.0392156862745098,0.9607843137254902,51,1200,1000,200,0.8333333333333334,14,10,4,305.9459821486232,0.40173202614379083,0.23603227698846485,0.18017612274260228,131536.54095611078,-2150.4767967479497,129386.06415936282,4737,0,952.0980392156863,40,11,16,35.70066376064988,0.6286458333333333,43.546747967479675,1025.8130081300815,25.645325203252035,0
4886,4,0,0,49,0.0,0.0,1.0,49,1350,900,450,0.6666666666666666,18,9,9,318.01741014600054,0.3945578231292517,0.24357801884497632,0.18614940129854854,131303.86002245452,-1448.6172986972142,129855.24272375731,4738,2,991.9591836734694,43,6,17,35.625230989559256,0.6218507751937985,43.773674242424235,1024.905303030302,23.835007047216326,0
4887,4,1,0,50,0.02,0.0,1.0,50,1300,1000,300,0.7692307692307693,16,10,6,311.48151979681313,0.39596938775510204,0.24304051995531628,0.18333284670885971,131515.04041883696,-1807.0878574451704,129707.9525613918,4739,0,973.1,39,11,19,35.58031634000202,0.6300747863247863,43.56770833333334,1025.729166666668,26.3007478632479,0
4888,4,0,0,50,0.0,0.0,1.0,50,650,300,350,0.46153846153846156,10,3,7,311.45069718141434,0.39561224489795915,0.24397806883947615,0.18357138937999704,131568.46923828125,-1804.5817057291683,129763.88753255208,4740,1,974.1,39,11,13,35.52740125901106,0.6306089743589745,43.515625,1025.9375,26.306089743589745,0
4889,4,0,1,49,0.0,0.02,0.98,50,1300,1100,200,0.8461538461538461,15,11,4,308.0052935986666,0.39573979591836733,0.24272871287128672,0.18213427783059333,131692.96136558938,-1887.57415394275,129805.38721164662,4741,2,975.1,40,10,13,35.49071782178217,0.6302083333333333,43.394308943089435,1026.422764227643,25.660569105691074,0
4890,4,0,0,49,0.0,0.0,1.0,49,1400,1100,300,0.7857142857142857,17,11,6,313.731350975289,0.3946109693877551,0.240215477053765,0.18504513815009574,131595.187717014,-1542.8927951388846,130052.2949218751,4742,6,995.9591836734694,39,10,13,35.44204737732654,0.6308760683760684,43.489583333333336,1026.0416666666674,26.308760683760703,0
4891,4,0,0,49,0.0,0.0,1.0,49,1700,1300,400,0.7647058823529411,21,13,8,313.2952792344544,0.39415036848072565,0.2404382672212635,0.18569762882826346,131782.29302300359,-1542.6459418402687,130239.64708116332,4743,7,996.9591836734694,39,10,15,35.26523029319265,0.6327457264957265,43.30729166666667,1026.7708333333344,26.327457264957292,0
4892,4,1,2,48,0.02,0.04,0.96,50,1500,1100,400,0.7333333333333333,19,11,8,306.82980277574876,0.3968792517006803,0.23843243243243273,0.18310810810810818,132040.8950617284,-1897.1836419753045,130143.71141975309,4744,0,978.0,41,9,15,35.17173423423424,0.6321138211382114,43.05555555555556,1027.7777777777778,25.067750677506776,0
4893,4,0,0,48,0.0,0.0,1.0,48,1200,900,300,0.75,15,9,6,324.70804686100195,0.3918809101654846,0.24216822161376483,0.19300458409260637,131889.27001953122,-1034.8985460069437,130854.37147352428,4745,9,1019.1458333333334,39,9,15,34.86472382787412,0.6338141025641026,43.203125,1027.1874999999998,26.33814102564102,0
4894,4,0,1,47,0.0,0.020833333333333332,0.9791666666666666,48,1150,700,450,0.6086956521739131,16,7,9,322.5092581043914,0.3918809101654846,0.24517233705864871,0.19215622325830878,131979.9735297276,-1087.0473304580705,130892.92619926954,4746,10,1020.1458333333334,40,8,15,34.83005307750632,0.6330729166666667,43.11483739837398,1027.5406504065036,25.68851626016259,0
4895,4,0,0,47,0.0,0.0,1.0,47,950,600,350,0.631578947368421,13,6,7,326.28121476118,0.3881051495528831,0.22191904159974518,0.19098656502759603,131303.86002245464,-831.6034098083101,130472.25661264634,4747,11,1042.6170212765958,43,4,19,35.41349056022666,0.6218507751937985,43.77367424242424,1024.905303030303,23.835007047216347,1
4896,4,0,0,47,0.0,0.0,1.0,47,1300,700,600,0.5384615384615384,19,7,12,324.85887298720013,0.388336416897934,0.22385605107865003,0.19090768448372297,131455.26389085723,-859.1137410781957,130596.15014977903,4748,12,1043.6170212765958,41,6,19,35.297454935345534,0.626270325203252,43.62599206349206,1025.4960317460313,25.01209833526906,0
4897,4,1,1,47,0.020833333333333332,0.020833333333333332,0.9791666666666666,48,1050,700,350,0.6666666666666666,14,7,7,308.08364499884874,0.3927766696217494,0.14181993426873984,0.17699707447973084,130584.26852352633,-1535.1003005299813,129049.16822299635,4749,0,1022.8541666666666,42,6,15,36.6044905827329,0.6160714285714286,44.47674418604652,1022.0930232558148,24.335548172757495,5
4898,4,1,0,48,0.020833333333333332,0.0,1.0,48,1350,1100,250,0.8148148148148148,16,11,5,302.97685977985515,0.3942265070921986,0.16002429430819065,0.17534359774618807,130867.47378795042,-1670.036748880862,129197.43703906957,4750,0,1018.7083333333334,43,5,17,36.449656794693816,0.6174903100775193,44.1998106060606,1023.2007575757567,23.795366455250157,0
4899,4,0,0,48,0.0,0.0,1.0,48,1600,1300,300,0.8125,19,13,6,301.1001150509374,0.3936631944444444,0.15222706995810364,0.17516392279580822,131067.25930212611,-1707.1266289437667,129360.13267318235,4751,1,1019.7083333333334,44,4,17,36.29660608252705,0.6181344696969697,44.004629629629626,1023.9814814814807,23.27230639730638,0
4900,4,1,0,49,0.02040816326530612,0.0,1.0,49,1400,1100,300,0.7857142857142857,17,11,6,302.08765394982885,0.3963647959183674,0.1748928916939234,0.17748651286442232,131446.78605109768,-1858.050411522604,129588.73563957507,4752,0,999.8775510204082,44,5,18,35.889766741911224,0.6219223484848484,43.634259259259274,1025.4629629629653,23.305976430976486,0
4901,4,0,0,49,0.0,0.0,1.0,49,1100,700,400,0.6363636363636364,15,7,8,300.26945483454745,0.39572704081632654,0.17656376630074377,0.17696731699823345,131565.50068587123,-1898.979766803823,129666.5209190674,4753,1,1000.8775510204082,44,5,14,35.81716305655836,0.6231060606060606,43.518518518518526,1025.9259259259272,23.316498316498347,0
4902,4,0,0,49,0.0,0.0,1.0,49,1150,900,250,0.782608695652174,14,9,5,301.23360940157977,0.395390447845805,0.16448040650631057,0.1780893098782139,131684.26890432095,-1866.4544753086404,129817.81442901232,4754,2,1001.8775510204082,44,5,14,35.673207036535864,0.6242897727272727,43.40277777777778,1026.3888888888887,23.327020202020197,0
4903,4,0,0,49,0.0,0.0,1.0,49,1400,1100,300,0.7857142857142857,17,11,6,316.4519517264982,0.3951778628117914,0.19423778573162287,0.1872900545581298,131725.71228441808,-1364.6486213769151,130361.06366304118,4755,3,1002.8775510204082,42,7,14,35.241056258259405,0.6274801587301586,43.3624031007752,1026.5503875968998,24.44167589516428,5
4904,4,1,1,49,0.02,0.02,0.98,50,1300,1200,100,0.9230769230769231,14,12,2,312.52739225712224,0.3963180272108844,0.20513513513513537,0.18650828247602444,132040.89506172825,-1746.7206790123576,130294.1743827159,4756,0,983.8,44,6,14,35.02533783783783,0.6278409090909092,43.05555555555555,1027.7777777777767,23.358585858585833,0
4905,4,0,0,49,0.0,0.0,1.0,49,2050,1600,450,0.7804878048780488,25,16,9,315.7185634985114,0.3947172619047619,0.20299078990180508,0.1881308145262135,131984.12682399276,-1466.0322149047313,130518.09460908803,4757,5,1004.8775510204082,43,6,14,35.00032639080884,0.6286337209302326,43.11079545454545,1027.556818181818,23.896670190274836,0
4906,4,0,0,49,0.0,0.0,1.0,49,950,500,450,0.5263157894736842,14,5,9,313.48658369258317,0.3943806689342404,0.2046532266859198,0.18716080194715623,132057.11680010345,-1520.3731204086162,130536.74367969483,4758,6,1005.8775510204082,43,6,15,34.98441434801304,0.629360465116279,43.039772727272734,1027.8409090909104,23.903276955602568,0
4907,4,0,0,49,0.0,0.0,1.0,49,1450,1100,350,0.7586206896551724,18,11,7,311.1517073479293,0.3938137755102041,0.20505139158527363,0.1863649415383989,132178.81159786822,-1574.4674192205846,130604.34417864763,4759,7,1006.8775510204082,43,6,16,34.922357031034174,0.6305717054263564,42.92140151515153,1028.3143939393965,23.914288231148756,0
4908,4,0,0,49,0.0,0.0,1.0,49,1200,1000,200,0.8333333333333334,14,10,4,312.0716204012007,0.39392006802721086,0.2108041488578154,0.18752989585060825,132302.7274091223,-1542.4146947873542,130760.31271433496,4760,8,1007.8775510204082,44,5,18,34.77447274472747,0.6304450757575757,42.80092592592594,1028.7962962962981,23.38173400673405,0
4909,4,1,1,49,0.02,0.02,0.98,50,1200,800,400,0.6666666666666666,16,8,8,303.8201925800201,0.3963520408163265,0.20579232962383864,0.1836262898233776,132519.85520151825,-1947.4898272940336,130572.36537422422,4761,0,988.7,43,7,19,34.76932539317575,0.6339631782945736,42.58996212121213,1029.6401515151533,23.945119802677983,0
4910,4,0,1,48,0.0,0.02040816326530612,0.9795918367346939,49,750,300,450,0.4,12,3,9,309.3469226883497,0.3936189058956916,0.2073318080156299,0.18624494576155606,132374.1812414269,-1610.0908779149217,130764.09036351199,4762,10,1009.8775510204082,44,5,19,34.772959030652025,0.631155303030303,42.731481481481495,1029.0740740740766,23.388047138047195,0
4911,4,0,0,48,0.0,0.0,1.0,48,1550,1300,250,0.8387096774193549,18,13,5,314.6067997968356,0.39241651891252954,0.22030090584947537,0.18991708909201635,132474.589445153,-1264.514385358054,131210.07505979494,4763,11,1030.8958333333333,41,7,19,34.53701696058592,0.6364329268292683,42.63392857142857,1029.464285714285,25.10888501742159,0
4912,4,0,0,48,0.0,0.0,1.0,48,1500,1000,500,0.6666666666666666,20,10,10,314.1155982482461,0.3915761672576832,0.21435738136518312,0.19026535245118387,132602.28194286974,-1269.510975686574,131332.77096718317,4764,12,1031.8958333333333,41,7,20,34.421755602645604,0.6377032520325203,42.50992063492063,1029.9603174603174,25.12098335269067,0
4913,4,0,0,48,0.0,0.0,1.0,48,1000,800,200,0.8,12,8,4,313.86262127018847,0.39165927895981084,0.21151762496388304,0.19024142420597587,132627.8278238378,-1274.6164611678073,131353.21136267,4765,13,1032.8958333333333,41,7,11,34.40268949243955,0.6379573170731707,42.485119047619044,1030.0595238095234,25.123403019744472,0
4914,4,0,0,48,0.0,0.0,1.0,48,1450,1000,450,0.6896551724137931,19,10,9,312.1980952663266,0.39133606678487,0.20395011228745563,0.19013705801976133,132806.71788391258,-1307.5991276140344,131499.11875629856,4766,14,1033.8958333333333,41,7,11,34.26652229708051,0.6397357723577237,42.31150793650792,1030.7539682539664,25.140340689121132,0
4915,4,0,0,48,0.0,0.0,1.0,48,1200,1000,200,0.8333333333333334,14,10,4,314.16620937445174,0.39114213947990545,0.20133543410628985,0.19172809242681554,132883.42195964,-1250.5038068468482,131632.91815279314,4767,15,1034.8958333333333,41,7,12,34.13906395330191,0.6404979674796749,42.237103174603156,1031.0515873015845,25.147599690282547,0
4916,4,0,0,48,0.0,0.0,1.0,48,1750,1400,350,0.8,21,14,7,318.79733727810685,0.39008939125295505,0.1989983974358982,0.1954889332365749,133062.4842529604,-1116.006865709246,131946.47738725116,4768,16,1035.8958333333333,41,7,15,33.84054487179489,0.6422764227642277,42.06349206349206,1031.7460317460313,25.164537359659302,0
4917,4,0,0,48,0.0,0.0,1.0,48,1400,1200,200,0.8571428571428571,16,12,4,320.51929282039947,0.3896553634751773,0.19672410202185286,0.19694992340287135,133139.26214293577,-1065.2595702633005,132074.00257267247,4769,17,1036.8958333333333,41,7,16,33.71933977378321,0.6430386178861789,41.9890873015873,1032.04365079365,25.17179636082073,0
4918,4,0,1,47,0.0,0.020833333333333332,0.9791666666666666,48,1550,1100,450,0.7096774193548387,20,11,9,319.36141440481833,0.38890735815602834,0.20437392460503645,0.19680716428475067,133247.02659282796,-1089.208224415603,132157.81836841235,4770,18,1037.8958333333333,42,6,18,33.64148287189112,0.642609126984127,41.88468992248062,1032.4612403100775,24.582410483573273,0
4919,4,0,0,47,0.0,0.0,1.0,47,950,700,250,0.7368421052631579,12,7,5,326.0774204801862,0.3857732038236201,0.2009724340703607,0.2007787951193383,133216.06217718567,-712.2500157470436,132503.81216143863,4771,19,1060.5531914893618,41,6,19,33.4991030815555,0.6438008130081301,41.91468253968254,1032.3412698412696,25.179055361982186,0
4920,4,0,0,47,0.0,0.0,1.0,47,1100,400,700,0.36363636363636365,18,4,14,327.0305643138562,0.38519503546099293,0.19923280817956446,0.20206024955914295,133344.11144376747,-678.4799973229932,132665.6314464445,4772,20,1061.5531914893618,41,6,20,33.346440463612204,0.6450711382113821,41.79067460317461,1032.8373015873026,25.191153697251284,0
4921,4,0,0,47,0.0,0.0,1.0,47,1150,800,350,0.6956521739130435,15,8,7,327.8689029416871,0.38511794634597596,0.19658848018328934,0.2028676943854515,133397.1358861398,-652.6454802896262,132744.49040585017,4773,21,1062.5531914893618,42,5,21,33.271777194134394,0.6440972222222221,41.73934108527133,1033.042635658916,24.596253229974188,0
4922,4,0,0,47,0.0,0.0,1.0,47,1450,1200,250,0.8275862068965517,17,12,5,325.887481044864,0.3848095898859081,0.19212176429604955,0.2027857836595786,133606.80474175367,-691.7796115979338,132915.02513015573,4774,22,1063.5531914893618,39,8,22,33.11345507976489,0.6509081196581196,41.53645833333334,1033.8541666666683,26.50908119658124,0
4923,4,0,0,47,0.0,0.0,1.0,47,750,400,350,0.5333333333333333,11,4,7,327.79950432759733,0.3847903176071539,0.19683262282749192,0.20427279845951415,133660.65673828137,-637.220594618039,133023.43614366333,4775,23,1064.5531914893618,39,8,22,33.0102456264061,0.6514423076923077,41.48437500000001,1034.062500000001,26.5144230769231,0
4924,4,0,0,47,0.0,0.0,1.0,47,800,400,400,0.5,12,4,8,326.2461757152889,0.38444341658957754,0.19844497082490986,0.2035688124006436,133708.6072794799,-675.61564297044,133032.99163650948,4776,24,1065.5531914893618,40,7,11,33.002522026792455,0.6502604166666666,41.43800813008131,1034.2479674796757,25.856199186991894,0
4925,4,0,0,47,0.0,0.0,1.0,47,1050,600,450,0.5714285714285714,15,6,9,325.56504589600553,0.3845975948196115,0.198068805683008,0.20367833615173606,133805.5981217718,-687.5148612685821,133118.08326050322,4777,25,1066.5531914893618,41,6,12,32.923318790551996,0.6496443089430894,41.34424603174603,1034.6230158730154,25.23470770421989,0
4926,4,0,0,47,0.0,0.0,1.0,47,1000,500,500,0.5,15,5,10,326.90160215150104,0.3838459759481961,0.1995277305372367,0.20522811774059946,133933.93034297056,-643.3567176870745,133290.5736252835,4778,26,1067.5531914893618,41,6,13,32.76068621813302,0.6509146341463414,41.220238095238095,1035.119047619048,25.246806039488973,0
4927,4,0,1,46,0.0,0.02127659574468085,0.9787234042553191,47,950,700,250,0.7368421052631579,12,7,5,329.12945003739634,0.38425069380203514,0.20487184296583894,0.20691535786688345,133985.28045477436,-580.2996661627689,133404.9807886116,4779,27,1068.5531914893618,41,6,13,32.65179826242494,0.6514227642276422,41.17063492063492,1035.3174603174593,25.25164537359657,0
4928,4,0,0,46,0.0,0.0,1.0,46,700,500,200,0.7142857142857143,9,5,4,332.54357469774294,0.3852153784219002,0.20124437045100385,0.20868492349331577,133918.90290377766,-293.22586175555466,133625.67704202211,4780,28,1074.3478260869565,40,6,13,32.629684176075926,0.65234375,41.23475609756098,1035.0609756097574,25.876524390243937,0
4929,4,0,0,46,0.0,0.0,1.0,46,500,300,200,0.6,7,3,4,332.9848783968576,0.38452093397745574,0.2041745617179631,0.20941049019180147,133997.80636525876,-276.1513484037321,133721.65501685502,4781,29,1075.3478260869565,40,6,13,32.53950726344719,0.653125,41.15853658536585,1035.3658536585363,25.884146341463406,0
4930,4,0,0,46,0.0,0.0,1.0,46,1200,800,400,0.6666666666666666,16,8,8,336.6919597326941,0.38457125603864734,0.2070017493706533,0.2120451835399354,134050.42158272193,-173.2601708639006,133877.16141185802,4782,30,1076.3478260869565,40,6,13,32.39102878639189,0.6536458333333333,41.107723577235774,1035.569105691057,25.889227642276428,0
4931,4,1,0,47,0.02127659574468085,0.0,1.0,47,1050,700,350,0.6666666666666666,14,7,7,329.54067387652657,0.3887025901942646,0.17819355264678238,0.1904833760658486,130820.18455530347,-777.8856449987534,130042.29891030471,4783,0,1054.4255319148936,41,6,16,35.8178982415309,0.6199186991869918,44.24603174603174,1023.015873015872,24.95160665892371,8
4932,4,0,0,47,0.0,0.0,1.0,47,500,400,100,0.8,6,4,2,328.1566152649733,0.3886062288004934,0.17942148453455142,0.18993307125942369,130870.93431122431,-810.7674319728076,130060.1668792515,4784,1,1055.4255319148936,41,6,16,35.8020651541594,0.6204268292682927,44.19642857142856,1023.2142857142842,24.956445993031323,0
4933,4,0,0,47,0.0,0.0,1.0,47,1550,1300,250,0.8387096774193549,18,13,5,333.64531047954887,0.38839423373419674,0.18221526544703126,0.19349177449227128,130947.07739866781,-662.0243409863931,130285.05305768142,4785,2,1056.4255319148936,41,6,16,35.5847751284288,0.6211890243902438,44.12202380952381,1023.5119047619048,24.9637049941928,0
4934,4,0,1,46,0.0,0.02127659574468085,0.9787234042553191,47,1450,1100,350,0.7586206896551724,18,11,7,333.6646200327682,0.38891458526056116,0.17618282905952976,0.19401422779482824,131048.63596190796,-654.7413351914792,130393.89462671649,4786,3,1057.4255319148936,41,6,16,35.48176452540128,0.6222052845528455,44.02281746031746,1023.9087301587306,24.973383662408065,0
4935,4,0,0,46,0.0,0.0,1.0,46,850,600,250,0.7058823529411765,11,6,5,342.83117346831324,0.387157809983897,0.1848138895720346,0.19957884084576494,131093.85456945264,-211.38800069403567,130882.46656875861,4787,4,1080.3260869565217,40,6,16,35.20144884390196,0.62421875,43.978658536585364,1024.085365853658,25.60213414634145,0
4936,4,0,0,46,0.0,0.0,1.0,46,950,500,450,0.5263157894736842,14,5,9,345.13760413674237,0.38639291465378417,0.19019896831245364,0.20121658739197426,131150.23389274685,-147.0244984567986,131003.20939429005,4788,5,1081.3260869565217,41,5,16,35.08545197740113,0.6232215447154472,43.92361111111111,1024.305555555555,24.98306233062329,0
4937,4,0,0,46,0.0,0.0,1.0,46,1400,1000,400,0.7142857142857143,18,10,8,347.52742963123416,0.3869162640901771,0.19406556038600598,0.20341676348556814,131302.70460325325,-73.74171312044587,131228.9628901328,4789,6,1082.3260869565217,41,5,18,34.87027312618979,0.6247459349593496,43.77480158730158,1024.9007936507928,24.997580332946168,0
4938,4,0,0,46,0.0,0.0,1.0,46,1000,700,300,0.7,13,7,6,352.2347607650526,0.38630233494363925,0.19790831373934825,0.20675211003438562,131410.2692513147,57.46033178636708,131467.72958310106,4790,7,1083.3260869565217,38,8,18,34.641033656350935,0.6307565789473686,43.66987179487178,1025.3205128205109,26.982118758434495,0
4939,4,2,1,47,0.041666666666666664,0.020833333333333332,0.9791666666666666,48,1100,800,300,0.7272727272727273,14,8,6,338.58135069621676,0.39406028368794327,0.19133771929824572,0.20131648781396208,131901.6665014209,-668.1111193734085,131233.5553820475,4791,0,1039.1458333333333,40,8,17,34.495985028360366,0.6322916666666668,43.191056910569095,1027.235772357722,25.68089430894305,0
4940,4,0,1,46,0.0,0.02127659574468085,0.9787234042553191,47,1450,900,550,0.6206896551724138,20,9,11,343.7888085839184,0.39028291705211227,0.19067232694867053,0.20385223720257659,131797.2932778105,-337.9131138872708,131459.38016392323,4792,1,1062.2553191489362,40,7,17,34.46737265769331,0.6312500000000001,43.29268292682925,1026.8292682926804,25.67073170731701,0
4941,4,0,0,46,0.0,0.0,1.0,46,900,700,200,0.7777777777777778,11,7,4,346.80061524860747,0.38880837359098225,0.18968752286234425,0.2054971622203328,131771.20642681248,-60.33290782605505,131710.87351898642,4793,2,1084.6521739130435,40,6,17,34.41634498003893,0.6309895833333334,43.3180894308943,1026.7276422764207,25.66819105691052,0
4942,4,0,0,46,0.0,0.0,1.0,46,750,500,250,0.6666666666666666,10,5,5,362.34573204952653,0.38880837359098225,0.2215122565093317,0.20815786433664846,130581.7925347223,275.54704024556514,130857.33957496787,4794,3,1085.6521739130435,39,7,14,35.2204783258595,0.6207264957264957,44.47916666666667,1022.083333333334,26.207264957264975,4
4943,4,0,0,46,0.0,0.0,1.0,46,1350,1000,350,0.7407407407407407,17,10,7,358.75097723125856,0.38952294685990335,0.2194287941603763,0.20666077420786605,130688.28125000017,176.90972222223763,130865.19097222241,4795,4,1086.6521739130435,39,7,14,35.20442814452594,0.6217948717948718,44.37500000000001,1022.5000000000014,26.217948717948754,0
4944,4,0,0,46,0.0,0.0,1.0,46,1300,1100,200,0.8461538461538461,15,11,4,358.55322128434807,0.3894524959742351,0.21629560436155026,0.20726022285071108,130821.45317925343,181.29069010416288,131002.74386935758,4796,5,1087.6521739130435,39,7,14,35.074606285850045,0.623130341880342,44.244791666666664,1023.0208333333329,26.231303418803407,0
4945,4,0,0,46,0.0,0.0,1.0,46,900,400,500,0.4444444444444444,14,4,10,355.9605858470451,0.38984500805152983,0.2164950050679635,0.20604601265618896,130874.74093967021,117.24989149306049,130991.99083116328,4797,6,1088.6521739130435,39,7,14,35.08697699277206,0.62366452991453,44.192708333333336,1023.2291666666673,26.236645299145316,0
4946,4,0,0,46,0.0,0.0,1.0,46,1050,900,150,0.8571428571428571,12,9,3,361.4576927775949,0.38960346215781,0.21759042115416904,0.20966253183191552,130954.69292534728,266.9162326388937,131221.60915798618,4798,7,1089.6521739130435,39,7,14,34.86540810095665,0.624465811965812,44.114583333333336,1023.5416666666671,26.24465811965813,0
4947,4,0,0,46,0.0,0.0,1.0,46,1650,1200,450,0.7272727272727273,21,12,9,361.1640943107264,0.38986513687600644,0.21764560197777194,0.21021931386434292,131088.00048828125,268.85579427083326,131356.8562825521,4799,8,1090.6521739130435,39,7,15,34.73800986674803,0.625801282051282,43.984375,1024.0625,26.25801282051282,0
4948,4,1,0,47,0.02127659574468085,0.0,1.0,47,1050,700,350,0.6666666666666666,14,7,7,356.76757357470774,0.3923835954363244,0.22335659964579624,0.20971291725313032,131465.0463533676,-19.067427399516703,131445.97892596808,4800,0,1068.4255319148936,38,9,16,34.46951939438136,0.6313048245614036,43.61645299145299,1025.5341880341875,26.987741790373356,0
4949,4,0,0,47,0.0,0.0,1.0,47,1250,700,550,0.56,18,7,11,356.15139403581804,0.3922294172062905,0.22701682320019678,0.20995223062774462,131574.6348002958,-27.902079224204897,131546.7327210716,4801,1,1069.4255319148936,38,9,14,34.374674580860145,0.6324013157894738,43.50961538461538,1025.9615384615379,26.998987854251,0
4950,4,1,0,48,0.020833333333333332,0.0,1.0,48,1150,900,250,0.782608695652174,14,9,5,349.7185053359227,0.39512226654846333,0.23778225670148423,0.20787065588411902,131889.27001953125,-375.1763237847217,131514.09369574653,4802,0,1048.125,39,9,15,34.22246307000641,0.6338141025641026,43.203125,1027.1875,26.338141025641026,0
4951,4,0,1,47,0.0,0.020833333333333332,0.9791666666666666,48,1300,1000,300,0.7692307692307693,16,10,6,343.97764775077707,0.39540854018912525,0.15950948212983218,0.20190541195499737,131410.26925131492,-505.19082133978304,130905.07842997514,4803,1,1049.125,38,10,19,34.85268834010628,0.6307565789473684,43.669871794871796,1025.320512820513,26.982118758434552,6
4952,4,0,0,47,0.0,0.0,1.0,47,1500,1100,400,0.7333333333333333,19,11,8,345.5469380749602,0.39199814986123954,0.17346019848453165,0.20358546301192249,131553.00188519547,-308.4526008002437,131244.5492843952,4804,4,1072.4255319148936,37,10,19,34.668483682485395,0.634009009009009,43.530701754385966,1025.8771929824563,27.72641062114747,0
4953,4,0,0,47,0.0,0.0,1.0,47,1000,600,400,0.6,14,6,8,345.2562848623906,0.3924028677150786,0.1706856802462795,0.20371426946672475,131609.2511638198,-312.2157779316506,131297.03538588816,4805,5,1073.4255319148936,37,10,13,34.61922063118902,0.634572072072072,43.475877192982466,1026.0964912280715,27.73233760075869,0
4954,4,0,0,47,0.0,0.0,1.0,47,1700,1400,300,0.8235294117647058,20,14,6,346.82720730949256,0.3922101449275362,0.13829084373399736,0.20540157973415754,131750.58144229633,-261.06275539328857,131489.51868690303,4806,6,1074.4255319148936,42,5,15,34.43644801006764,0.6277281746031744,43.33817829457365,1026.647286821707,24.443983019564453,1
4955,4,0,1,46,0.0,0.02127659574468085,0.9787234042553191,47,1350,800,550,0.5925925925925926,19,8,11,351.6262014951935,0.39165124884366326,0.15089522280208745,0.20892588205431947,131874.96244216122,-125.86157682828488,131749.10086533293,4807,7,1075.4255319148936,42,5,15,34.18789308176102,0.6289682539682538,43.217054263565906,1027.1317829457387,24.455518641565206,0
4956,4,0,0,46,0.0,0.0,1.0,46,800,500,300,0.625,11,5,6,356.5479623854055,0.3880032206119162,0.15535361002717618,0.21149730422070717,131811.5800284237,199.43005558708066,132011.01008401078,4808,8,1099.4565217391305,41,5,16,34.12542668985285,0.6298272357723576,43.278769841269856,1026.884920634923,25.045973674022513,0
4957,4,0,0,46,0.0,0.0,1.0,46,1100,600,500,0.5454545454545454,16,6,10,353.81270545093855,0.3878623188405797,0.1548149392228073,0.21043828632650616,131913.47321625426,134.53256881458032,132048.00578506885,4809,9,1100.4565217391305,41,5,16,34.09293014646709,0.6308434959349591,43.1795634920635,1027.2817460317474,25.055652342237742,0
4958,4,0,0,46,0.0,0.0,1.0,46,850,600,250,0.7058823529411765,11,6,5,349.2330168005839,0.3874396135265701,0.14982373678025773,0.2084132519616391,132040.8950617286,22.608024691376187,132063.50308641998,4810,10,1101.4565217391305,41,5,17,34.08220720720722,0.6321138211382114,43.055555555555564,1027.7777777777794,25.067750677506815,0
4959,4,0,0,46,0.0,0.0,1.0,46,1150,700,450,0.6086956521739131,16,7,9,348.6271838952573,0.38696658615136875,0.1468665696101097,0.2084722161977238,132117.37769471222,11.941865866726346,132129.31956057894,4811,11,1102.4565217391305,41,5,17,34.02077503296988,0.6328760162601625,42.9811507936508,1028.0753968253973,25.075009678668227,0
4960,4,0,1,45,0.0,0.021739130434782608,0.9782608695652174,46,1050,800,250,0.7619047619047619,13,8,5,350.21086418826667,0.3861714975845411,0.14785599285535778,0.209869446732359,132198.62768350774,59.4791291088445,132258.10681261658,4812,12,1103.4565217391305,42,4,18,33.89828512202018,0.6321924603174602,42.902131782945744,1028.3914728682182,24.4855112587671,0
4961,4,0,0,45,0.0,0.0,1.0,45,1150,900,250,0.782608695652174,14,9,5,359.44139646194157,0.3856481481481482,0.1495658884815747,0.21537396044650187,132193.88247197014,503.1907438901342,132697.07321586026,4813,13,1126.8222222222223,41,4,18,33.66575020901666,0.6336382113821138,42.906746031746025,1028.3730158730148,25.082268679829628,0
4962,4,1,1,45,0.021739130434782608,0.021739130434782608,0.9782608695652174,46,1250,1000,250,0.8,15,10,5,351.892553744827,0.39038848631239936,0.14828821835708617,0.21214848953552315,132425.49332493235,120.5388869880486,132546.0322119204,4814,0,1103.304347826087,38,8,18,33.62678188360664,0.6408991228070176,42.681623931623925,1029.2735042735035,27.086144849302723,0
4963,4,0,0,45,0.0,0.0,1.0,45,850,600,250,0.7058823529411765,11,6,5,355.05501164419303,0.3845117845117845,0.15522349689900117,0.213754244677029,132372.47973552824,399.9024667737252,132772.38220230196,4815,15,1128.8222222222223,41,4,18,33.59874594299303,0.6354166666666667,42.73313492063491,1029.0674603174587,25.09920634920631,0
4964,4,0,0,45,0.0,0.0,1.0,45,1050,800,250,0.7619047619047619,13,8,5,335.13218398727673,0.3845117845117845,0.12838197488080239,0.1923921507957387,130555.17713758688,-244.79733191018977,130310.3798056767,4816,16,1129.8222222222223,39,6,14,35.942755580470894,0.6204594017094017,44.505208333333336,1021.9791666666673,26.204594017094035,4
4965,4,0,0,45,0.0,0.0,1.0,45,850,700,150,0.8235294117647058,10,7,3,335.6463230142187,0.3845117845117845,0.13187509906482786,0.19308517081251733,130635.03146701396,-230.56640624999523,130404.46506076396,4817,17,1130.8222222222223,39,6,15,35.848872359214724,0.6212606837606838,44.427083333333336,1022.2916666666673,26.212606837606852,0
4966,4,0,0,45,0.0,0.0,1.0,45,1050,900,150,0.8571428571428571,12,9,3,333.06349790761675,0.3836910774410774,0.1301458009116696,0.19258760674531758,130833.79937743742,-284.8074269614613,130548.99195047596,4818,18,1131.8222222222223,40,5,16,35.71404920366876,0.6216145833333333,44.232723577235774,1023.0691056910573,25.57672764227643,0
4967,4,1,1,45,0.021739130434782608,0.021739130434782608,0.9782608695652174,46,1600,1200,400,0.75,20,12,8,325.6786571470914,0.38886876006441223,0.13243723324643697,0.19026111163941173,131228.82207349347,-652.3146896219888,130576.50738387149,4819,0,1108.195652173913,42,4,16,35.50453943635332,0.6225198412698412,43.846899224806215,1024.6124031007776,24.39553340716137,0
4968,4,2,2,45,0.0425531914893617,0.0425531914893617,0.9574468085106383,47,1100,900,200,0.8181818181818182,13,9,4,319.02204613489437,0.3888567684242985,0.13667403465010275,0.1876023841264245,131480.6990504537,-1010.8765566574432,130469.82249379625,4820,0,1085.5744680851064,41,6,16,35.42150319210677,0.6265243902439024,43.60119047619048,1025.5952380952394,25.014518002322912,0
4969,4,0,0,45,0.0,0.0,1.0,45,1100,700,400,0.6363636363636364,15,7,8,330.839133380627,0.3832070707070707,0.13678390878778135,0.1935202858336286,131277.2866669818,-313.66724930710757,130963.61941767468,4821,21,1134.8222222222223,41,4,16,35.323491448854476,0.624491869918699,43.799603174603185,1024.8015873015888,24.99516066589241,0
4970,4,0,0,45,0.0,0.0,1.0,45,1250,900,350,0.72,16,9,7,317.86523083763507,0.38449074074074074,0.12406761919715281,0.1907371071419729,132248.4575464967,-592.56270281232,131655.8948436844,4822,22,1135.8222222222223,42,3,14,34.6798948029518,0.6326884920634919,42.85368217054264,1028.5852713178303,24.490125507567388,2
4971,4,0,0,45,0.0,0.0,1.0,45,1400,1000,400,0.7142857142857143,18,10,8,321.7558065203492,0.38486952861952867,0.12703553756185348,0.1938382541720156,132398.0034722224,-479.95021708429,131918.0532551381,4823,23,1136.8222222222223,41,4,14,34.429824561403514,0.6356707317073169,42.70833333333334,1029.166666666668,25.101626016260198,0
4972,4,0,0,45,0.0,0.0,1.0,45,1150,900,250,0.782608695652174,14,9,5,326.617348553972,0.38499579124579125,0.1353887657770496,0.197435146222579,132525.65906281516,-342.9641243071119,132182.69493850804,4824,24,1137.8222222222223,41,4,14,34.17668288531329,0.6369410569105689,42.584325396825406,1029.6626984127001,25.11372435152927,0
4973,4,0,0,45,0.0,0.0,1.0,45,1400,1100,300,0.7857142857142857,17,11,6,326.5059358872109,0.38440656565656567,0.137595070761529,0.19844453809598966,132730.03595245988,-332.57107819977466,132397.4648742601,4825,25,1138.8222222222223,41,4,12,33.974659831199276,0.6389735772357723,42.38591269841271,1030.4563492063508,25.133081687959773,0
4974,4,1,1,45,0.021739130434782608,0.021739130434782608,0.9782608695652174,46,900,700,200,0.7777777777777778,11,7,4,319.4209292110271,0.3872987117552335,0.1398554128290479,0.19552822262515174,132997.0322265041,-703.5928767802127,132293.43934972386,4826,0,1115.0434782608695,42,4,13,33.88993267574764,0.6401289682539681,42.12693798449614,1031.4922480620176,24.559339239571848,0
4975,4,0,0,45,0.0,0.0,1.0,45,900,400,500,0.4444444444444444,14,4,10,327.48559135939,0.3835227272727273,0.14990380915736834,0.20026707104542482,132960.14817964233,-291.4934492315334,132668.6547304108,4827,27,1140.8222222222223,41,4,13,33.71889829421573,0.6412601626016259,42.16269841269842,1031.3492063492072,25.154858691444076,0
4976,4,0,0,45,0.0,0.0,1.0,45,800,600,200,0.75,10,6,4,327.071420699107,0.3832070707070707,0.15610694364300848,0.2002879053256369,133011.3112953515,-299.16028911564024,132712.15100623586,4828,28,1141.8222222222223,41,4,14,33.67835160607811,0.6417682926829268,42.11309523809524,1031.5476190476193,25.15969802555169,0
4977,4,0,0,45,0.0,0.0,1.0,45,650,400,250,0.6153846153846154,9,4,5,332.5811200525025,0.3834806397306398,0.16586241148386716,0.20436157069735272,133139.26214293588,-144.07901470772947,132995.18312822815,4829,29,1142.8222222222223,41,4,15,33.40813146848667,0.6430386178861788,41.989087301587304,1032.0436507936508,25.171796360820753,0
4978,4,0,0,45,0.0,0.0,1.0,45,850,600,250,0.7058823529411765,11,6,5,333.64774096198664,0.383733164983165,0.16610299769408132,0.20572308577798354,133267.27450239373,-107.13498362306018,133160.13951877068,4830,30,1143.8222222222223,41,4,15,33.25246605175506,0.6443089430894309,41.865079365079374,1032.539682539684,25.183894696089855,0
4979,4,0,0,45,0.0,0.0,1.0,45,1300,900,400,0.6923076923076923,17,9,8,331.5855513033416,0.38360690235690237,0.16526777425653894,0.20515747746415305,133395.34837372447,-153.6059736394509,133241.74240008503,4831,31,1144.8222222222223,41,4,16,33.1775785076347,0.6455792682926829,41.74107142857143,1033.0357142857142,25.195993031358885,0
4980,4,0,0,45,0.0,0.0,1.0,45,850,600,250,0.7058823529411765,11,6,5,330.05983350676394,0.3831228956228956,0.1682795698924735,0.20463709677419364,133472.22222222225,-189.236111111102,133282.98611111115,4832,32,1145.8222222222223,41,4,16,33.140120967741936,0.646341463414634,41.66666666666667,1033.3333333333337,25.203252032520336,0
4981,4,0,0,45,0.0,0.0,1.0,45,950,600,350,0.631578947368421,13,6,7,332.7943543708393,0.38259680134680135,0.164543361473523,0.20747896829914034,133677.3274124463,-102.58802595113383,133574.73938649514,4833,33,1146.8222222222223,41,4,16,32.8644634177539,0.6483739837398375,41.46825396825396,1034.126984126983,25.222609368950803,0
4982,4,0,1,44,0.0,0.022222222222222223,0.9777777777777777,45,1050,800,250,0.7619047619047619,13,8,5,333.04806089815816,0.3829545454545455,0.15588366890380345,0.2085048784614517,133831.2596450615,-85.55169753088097,133745.70794753064,4834,34,1147.8222222222223,41,4,13,32.70413870246087,0.64989837398374,41.319444444444436,1034.7222222222206,25.237127371273672,0
4983,4,0,0,44,0.0,0.0,1.0,44,1250,900,350,0.72,16,9,7,335.88309483925275,0.3841173361522199,0.15251577941846017,0.21047984952296053,133866.31350593225,192.68633501883014,134058.9998409511,4835,35,1167.2727272727273,40,4,14,32.595788732855404,0.6518229166666667,41.28556910569105,1034.8577235772352,25.87144308943088,0
4984,4,0,0,44,0.0,0.0,1.0,44,1250,1000,250,0.8,15,10,5,340.18926086116176,0.38376497533474274,0.16133976458409527,0.21378827886444524,133971.50262946996,315.13329119572364,134286.6359206657,4836,36,1168.2727272727273,40,4,14,32.37929877949019,0.6528645833333333,41.1839430894309,1035.264227642277,25.881605691056926,0
4985,4,0,0,44,0.0,0.0,1.0,44,1300,700,600,0.5384615384615384,19,7,12,335.58865792520544,0.38317036645525016,0.15743217935684095,0.21195729732896804,134155.68300118978,204.2251222817136,134359.90812347148,4837,37,1169.2727272727273,40,4,14,32.31455594794325,0.6546875,41.00609756097561,1035.9756097560976,25.899390243902438,0
4986,4,0,0,44,0.0,0.0,1.0,44,650,400,250,0.6153846153846154,9,4,5,339.20682700609905,0.3826198026779422,0.16332079373852304,0.21485908209988813,134260.98573104636,308.4485921078748,134569.43432315424,4838,38,1170.2727272727273,40,4,14,32.1157743348369,0.6557291666666667,40.90447154471545,1036.3821138211383,25.90955284552846,0
4987,4,0,0,44,0.0,0.0,1.0,44,1250,1000,250,0.8,15,10,5,330.24190512471284,0.38290609584214236,0.09567042938948744,0.2074553763040079,133957.03667534763,70.28920424974245,134027.32587959737,4839,39,1171.2727272727273,39,5,16,32.651187361642194,0.6543803418803418,41.197916666666686,1035.2083333333364,26.5438034188035,5
4988,4,0,0,44,0.0,0.0,1.0,44,1150,1000,150,0.8695652173913043,13,10,3,332.2551000165983,0.38332452431289643,0.10192976038046475,0.20902630975727812,134010.95920138917,105.16493055559005,134116.12413194476,4840,40,1172.2727272727273,39,5,16,32.54527162977868,0.6549145299145298,41.14583333333335,1035.416666666669,26.54914529914536,0
4989,4,0,1,43,0.0,0.022727272727272728,0.9772727272727273,44,1100,600,500,0.5454545454545454,16,6,10,331.3014917354453,0.3826198026779422,0.10369987155701454,0.20894955468859303,134103.0471280325,85.70791195719235,134188.7550399897,4841,41,1173.2727272727273,40,4,16,32.47808738880168,0.6541666666666666,41.0569105691057,1035.772357723579,25.894308943089477,0
4990,4,0,0,43,0.0,0.0,1.0,43,750,400,350,0.5333333333333333,11,4,7,334.1983490480102,0.38145994832041347,0.08413270319591981,0.21024883478083706,134010.95920138905,357.9944508477298,134368.95365223679,4842,42,1186.5581395348838,39,4,14,32.49496981891348,0.6549145299145298,41.14583333333334,1035.416666666668,26.549145299145337,2
4991,4,0,0,43,0.0,0.0,1.0,43,850,600,250,0.7058823529411765,11,6,5,333.73434801390954,0.38104466592838687,0.08721690532279958,0.21011102936075232,134037.9245334204,346.6118706597468,134384.53640408014,4843,43,1187.5581395348838,39,4,14,32.48006991248366,0.6551816239316238,41.11979166666668,1035.5208333333353,26.551816239316288,0
4992,4,0,0,43,0.0,0.0,1.0,43,1200,1100,100,0.9166666666666666,13,11,2,333.5881256840394,0.3805370985603544,0.08898202024359625,0.21048225392145278,134118.8368055559,348.09027777781694,134466.92708333372,4844,44,1188.5581395348838,39,4,15,32.40312416197373,0.6559829059829059,41.041666666666686,1035.8333333333362,26.559829059829134,0
4993,4,0,0,43,0.0,0.0,1.0,43,850,500,350,0.5882352941176471,12,5,7,332.199492042982,0.3797065337763012,0.08709475318166082,0.21022395336155153,134226.75781250026,318.0121527778075,134544.76996527807,4845,45,1189.5581395348838,39,4,16,32.331456909261505,0.6570512820512819,40.937500000000014,1036.250000000002,26.570512820512874,0
4994,4,0,0,43,0.0,0.0,1.0,43,1400,1200,200,0.8571428571428571,16,12,4,329.1705113417913,0.3791989664082687,0.08875968992248029,0.20880219003024095,134313.6525877455,242.41874049839146,134556.0713282439,4846,46,1190.5581395348838,40,3,16,32.32332516339868,0.65625,40.85365853658537,1036.5853658536596,25.91463414634149,0
4995,4,0,0,43,0.0,0.0,1.0,43,1250,900,350,0.72,16,9,7,331.1868356879503,0.37908361018826137,0.08825037779586031,0.21053578096723735,134392.67223750753,301.81677159760113,134694.48900910513,4847,47,1191.5581395348838,40,3,17,32.19232905354635,0.65703125,40.77743902439025,1036.8902439024396,25.92225609756099,0
4996,4,0,0,43,0.0,0.0,1.0,43,1000,800,200,0.8,12,8,4,332.48262358226674,0.37889904023624954,0.09334682289031937,0.21181758154061295,134471.71512492586,341.9017284685227,134813.61685339437,4848,48,1192.5581395348838,40,3,18,32.07998562936834,0.6578124999999999,40.70121951219513,1037.1951219512212,25.92987804878053,0
4997,4,0,0,43,0.0,0.0,1.0,43,1350,1200,150,0.8888888888888888,15,12,3,331.68967804910653,0.3787836840162422,0.10022530341738123,0.21209360387695658,134606.20896568405,329.5444983600079,134935.75346404407,4849,49,1193.5581395348838,38,5,19,31.966608325611713,0.6625548245614036,40.57158119658119,1037.7136752136746,27.308254610886173,0
4998,4,0,0,43,0.0,0.0,1.0,43,1400,1100,300,0.7857142857142857,17,11,6,333.92057333961156,0.3782991878922111,0.09469840191062406,0.21433554370636348,134744.8281923442,398.8140569070044,135143.6422492512,4850,50,1194.5581395348838,38,5,20,31.770726143925373,0.6639254385964912,40.43803418803419,1038.247863247863,27.32231219073324,0
4999,4,0,0,43,0.0,0.0,1.0,43,1000,600,400,0.6,14,6,8,330.27123377772875,0.37843761535622006,0.10479707974720465,0.21264218111172706,134855.77493790633,307.7966341588095,135163.57157206515,4851,51,1195.5581395348838,38,5,14,31.75508297332509,0.6650219298245614,40.33119658119658,1038.6752136752136,27.333558254610885,0
5000,4,0,0,43,0.0,0.0,1.0,43,1300,1200,100,0.9230769230769231,14,12,2,332.60251305258254,0.37781469176818017,0.10462964291350474,0.21480026838973523,134966.7673405652,378.0571992110238,135344.82453977622,4852,52,1196.5581395348838,38,5,16,31.584155870861615,0.6661184210526316,40.224358974358964,1039.1025641025622,27.344804318488478,0
