period,mktsize,entries,exits,surviv,entryrate,exitrate,survivrate,firms,totresinv,totinninv,totimiinv,costshareinn,firmsres,firmsinn,firmsimi,hindex,div,gini,pcm,cs,totprofits,ts,maxage,minage,avgage,actfirms,inactfirms,profitablefirms,wmc,avgproxopt,price,totoutput,avgoutput,magtechshock
1,4,40,26,14,1.0,0.65,0.35,40,0,0,0,0,0,0,0,400.8109104654985,0.5009214743589744,0.004985763435757518,0.17423595483825038,118969.2258900244,2536.83274927121,121506.05863929562,0,0,0.0,35,5,14,46.32975936251829,0.5086309523809525,56.10532407407405,975.5787037036998,27.873677248677136,0
2,4,32,26,20,0.6956521739130435,0.5652173913043478,0.4347826086956522,46,450,200,250,0.4444444444444444,7,2,5,308.19291837794316,0.49543075684380034,-0.16294566918418774,0.14587798136555946,122685.23526230374,-837.8558605252291,121847.37940177851,1,0,0.30434782608695654,42,4,15,44.69243120761607,0.5357142857142857,52.32558139534883,990.6976744186029,23.588039867109593,0
3,4,17,20,17,0.4594594594594595,0.5405405405405406,0.45945945945945943,37,300,200,100,0.6666666666666666,4,2,2,310.73549847686115,0.49402527527527523,-0.028716960024753657,0.15175920796579595,124015.10560941824,307.1791320406273,124322.28474145888,2,0,0.8648648648648649,37,0,17,43.24911933069133,0.5574324324324325,50.98684210526316,996.0526315789471,26.920341394025595,0
4,4,12,6,23,0.41379310344827586,0.20689655172413793,0.7931034482758621,29,650,500,150,0.7692307692307693,8,5,3,380.0703769191713,0.48198891625615764,-0.06059731640455934,0.18538126547690206,123960.50347222232,3622.7430555555643,127583.24652777788,3,0,1.2413793103448276,29,0,23,41.579497907949786,0.5754310344827587,51.04166666666667,995.8333333333342,34.339080459770145,0
5,4,8,9,22,0.25806451612903225,0.2903225806451613,0.7096774193548387,31,700,500,200,0.7142857142857143,9,5,4,357.38924767172574,0.4813620071684588,-0.0010740102114874528,0.17995847579226595,125293.14041137705,2755.684238009997,128048.82464938705,4,0,1.903225806451613,31,0,14,40.76182967009148,0.5836693548387097,49.70703125000001,1001.1718750000008,32.29586693548389,0
6,4,2,0,24,0.08333333333333333,0.0,1.0,24,700,500,200,0.7142857142857143,9,5,4,441.69394793508525,0.48011020531400966,0.055264993026499454,0.21543847664588853,123960.50347222219,6150.5208333333285,130111.02430555552,5,0,3.125,24,0,24,40.04532775453278,0.5933159722222222,51.041666666666664,995.833333333333,41.49305555555554,0
7,4,3,2,25,0.1111111111111111,0.07407407407407407,0.9259259259259259,27,800,600,200,0.75,10,6,4,394.82854639134257,0.4812440645773979,0.03394051593992087,0.1977673240568261,125074.41583404203,4476.589958900233,129551.00579294226,6,0,3.6666666666666665,27,0,25,40.051943865912904,0.5933641975308642,49.92559523809524,1000.2976190476196,37.048059964726654,0
8,4,7,6,26,0.21875,0.1875,0.8125,32,750,600,150,0.8,9,6,3,334.5721223774105,0.4835349462365592,-0.006466328066215388,0.17437111789787407,126710.35640495883,2078.7505739210455,128789.10697887988,7,0,3.5625,32,0,18,39.87412214697766,0.595703125,48.295454545454554,1006.8181818181831,31.463068181818223,0
9,4,1,0,27,0.037037037037037035,0.0,1.0,27,750,600,150,0.8,9,6,3,390.44105345648904,0.48100664767331436,0.010154962083745334,0.19875926739401323,125745.15483276642,4419.214143990927,130164.36897675735,8,0,4.925925925925926,27,0,25,39.4658753709199,0.6003086419753086,49.25595238095238,1002.9761904761904,37.147266313932974,0
10,4,4,3,28,0.12903225806451613,0.0967741935483871,0.9032258064516129,31,450,100,350,0.2222222222222222,8,1,7,389.8374803764923,0.4827060931899641,0.031732825742582405,0.19446278991879995,124902.36282348634,3538.3244832356772,128440.68730672201,9,0,5.161290322580645,31,0,21,40.35552624723198,0.5796370967741935,50.09765625,999.6093750000001,32.24546370967742,8
11,4,8,10,26,0.2222222222222222,0.2777777777777778,0.7222222222222222,36,1100,800,300,0.7272727272727273,14,8,6,339.105815832746,0.4837466931216931,0.02542125225393277,0.1760552274529681,126553.21865361976,1382.9864915591138,127936.20514517887,10,0,4.916666666666667,36,0,12,39.92142324193247,0.5853587962962963,48.45157657657657,1006.193693693693,27.949824824824805,0
12,4,3,3,26,0.10344827586206896,0.10344827586206896,0.896551724137931,29,550,300,250,0.5454545454545454,8,3,5,407.4903317728477,0.4773193760262726,0.06214055601956803,0.20806485138224873,125869.5625964504,4458.12596450614,130327.68856095654,11,0,6.172413793103448,29,0,19,38.909313725490186,0.5951867816091954,49.13194444444443,1003.4722222222205,34.602490421455876,0
13,4,6,5,27,0.1875,0.15625,0.84375,32,850,600,250,0.7058823529411765,11,6,5,370.8763062632331,0.47484038978494625,0.044421487603305776,0.1951131872080489,127092.01388888898,3027.083333333344,130119.09722222232,12,0,6.15625,32,0,16,38.56749311294765,0.599609375,47.91666666666667,1008.3333333333342,31.510416666666693,0
14,4,2,3,26,0.06896551724137931,0.10344827586206896,0.896551724137931,29,1100,900,200,0.8181818181818182,13,9,4,398.58204469571706,0.47270114942528735,0.10280750884021161,0.21059625852468233,127267.13204089498,4345.278742283939,131612.41078317893,13,0,7.310344827586207,29,0,20,37.68854668501949,0.6095545977011494,47.74305555555555,1009.0277777777771,34.79406130268197,0
15,4,2,1,27,0.07142857142857142,0.03571428571428571,0.9642857142857143,28,800,700,100,0.875,9,7,2,406.3581709444162,0.4686673280423281,0.09713045599625914,0.21550783903595555,127418.19273104102,4755.484748645782,132173.6774796868,14,0,8.071428571428571,28,0,17,37.336641999905126,0.6142113095238095,47.593390804597696,1009.6264367816087,36.058087027914596,0
16,4,2,2,27,0.06896551724137931,0.06896551724137931,0.9310344827586207,29,1000,700,300,0.7,13,7,6,394.0436804008155,0.4674671592775041,0.09259785263875497,0.21166771150734057,127933.68055555546,4282.291666666656,132215.9722222221,15,0,8.448275862068966,29,0,19,37.11731191652939,0.6163793103448276,47.08333333333333,1011.6666666666658,34.88505747126434,0
17,4,1,0,28,0.03571428571428571,0.0,1.0,28,750,500,250,0.6666666666666666,10,5,5,404.45887179459066,0.4641754850088184,0.0953057167200877,0.2174197996318706,127962.75308825461,4751.134149161037,132713.88723741565,16,0,9.5,28,0,21,36.82399649720723,0.6197916666666667,47.05459770114942,1011.7816091954014,36.13505747126434,0
18,4,2,3,27,0.06666666666666667,0.1,0.9,30,650,200,450,0.3076923076923077,11,2,9,380.70419788772955,0.4650862068965517,0.0008257858284490549,0.20129064209444186,127295.38819516706,3692.377731529651,130987.76592669671,17,0,9.8,30,0,20,38.11045995382701,0.6069444444444445,47.71505376344086,1009.1397849462365,33.63799283154122,6
19,4,2,3,26,0.06896551724137931,0.10344827586206896,0.896551724137931,29,700,600,100,0.8571428571428571,8,6,2,384.18535444786914,0.46592775041050905,0.03526484180590139,0.20475812846946864,127617.73003472216,4005.7725694444357,131623.5026041666,18,0,10.724137931034482,29,0,19,37.69115120274915,0.6131465517241379,47.39583333333333,1010.4166666666661,34.84195402298848,0
20,4,1,0,27,0.037037037037037035,0.0,1.0,27,1050,900,150,0.8571428571428571,12,9,3,404.2574640554756,0.46456552706552706,0.06439517799141115,0.21666669761206722,127843.36911848068,4936.327239229017,132779.6963577097,19,0,11.62962962962963,27,0,21,36.951883460859335,0.6219135802469136,47.172619047619044,1011.3095238095234,37.455908289241606,0
21,4,3,0,30,0.1,0.0,1.0,30,650,400,250,0.6153846153846154,9,4,5,395.5288649622153,0.4664032567049809,0.10479140850888058,0.20862208759771733,127197.0703124999,4183.28461592969,131380.3549284296,20,0,11.366666666666667,29,1,21,37.83775643673413,0.6088362068965517,47.81249999999999,1008.7499999999992,34.78448275862066,8
22,4,1,1,30,0.03225806451612903,0.03225806451612903,0.967741935483871,31,850,400,450,0.47058823529411764,13,4,9,376.60518846681526,0.4661290322580645,0.05451926088318171,0.1951224064994062,126469.13528442376,3325.786505805107,129794.92179022887,21,0,11.96774193548387,31,0,18,39.06485976267528,0.595766129032258,48.53515624999999,1005.8593749999994,32.44707661290321,8
23,4,0,0,30,0.0,0.0,1.0,30,600,600,0,1.0,6,6,0,380.18650272041464,0.4663553639846743,0.05352257948786976,0.1890251688776481,124764.89559847944,3486.7858639726987,128251.68146245215,22,1,13.233333333333333,30,0,20,40.73949504462085,0.5809027777777778,50.23521505376343,999.0591397849449,33.30197132616483,8
24,4,4,5,29,0.11764705882352941,0.14705882352941177,0.8529411764705882,34,950,700,250,0.7368421052631579,12,7,5,343.2112927645676,0.4695669934640523,0.04017991109126062,0.1752227732715044,125864.58510487515,1839.6293934240155,127704.21449829916,23,0,12.558823529411764,34,0,19,40.527000039545996,0.5824142156862745,49.13690476190475,1003.4523809523798,29.51330532212882,0
25,4,4,4,29,0.12121212121212122,0.12121212121212122,0.8787878787878788,33,450,200,250,0.4444444444444444,7,2,5,373.03400253870575,0.4729719065656566,0.059367798300828944,0.1877959749923428,125284.25232438021,2753.0131439628244,128037.26546834304,24,0,13.393939393939394,32,1,17,40.379461470551135,0.5810546875,49.71590909090909,1001.1363636363641,31.285511363636378,8
26,4,4,2,31,0.12121212121212122,0.06060606060606061,0.9393939393939394,33,650,300,350,0.46153846153846156,10,3,7,362.5555784845634,0.47072285353535354,0.06898058162566412,0.1846619421217269,125767.10467428391,2519.5130779027304,128286.61775218663,25,0,13.575757575757576,33,0,20,40.14240989615152,0.5836489898989898,49.23406862745098,1003.063725490196,30.39587046939988,0
27,4,1,1,31,0.03125,0.03125,0.96875,32,900,600,300,0.6666666666666666,12,6,6,364.1694553221785,0.4692120295698925,0.05474056603773558,0.1863029066802652,125948.7632001837,2773.338498622592,128722.10169880629,26,0,14.1875,32,0,21,39.914308176100626,0.587890625,49.053030303030305,1003.7878787878792,31.368371212121225,0
28,4,4,4,31,0.11428571428571428,0.11428571428571428,0.8857142857142857,35,1300,900,400,0.6923076923076923,17,9,8,337.7242801883207,0.4717086834733894,0.055052182563099405,0.17806707069294614,127182.05959467139,1590.5297759599932,128772.58937063138,27,0,13.114285714285714,34,1,20,39.31089932727488,0.5958946078431373,47.82738095238096,1008.6904761904777,29.667366946778756,0
29,4,1,0,32,0.03125,0.0,1.0,32,1100,800,300,0.7272727272727273,14,8,6,361.2875513978045,0.46830897177419356,0.05441236370472513,0.18903038508872683,126869.31060924917,2767.260515508636,129636.5711247578,28,0,14.40625,32,0,21,39.038152232944825,0.5973307291666667,48.13762626262627,1007.4494949494958,31.482796717171745,0
30,4,2,1,33,0.058823529411764705,0.029411764705882353,0.9705882352941176,34,1000,700,300,0.7,13,7,6,365.3574592606513,0.4696969696969697,0.08262724779030783,0.18854007924413305,126305.47417534729,2568.6726701197686,128874.14684546705,29,0,14.5,31,3,17,39.51640759930916,0.5940860215053764,48.69791666666667,1005.2083333333339,32.42607526881722,7
31,4,1,1,33,0.029411764705882353,0.029411764705882353,0.9705882352941176,34,1600,1300,300,0.8125,19,13,6,365.61171089604,0.46923276886512183,0.09298379118788525,0.19018698016328334,126632.90235731342,2459.694417317712,129092.59677463114,30,0,15.323529411764707,31,3,18,39.172595946528666,0.5974462365591398,48.372395833333336,1006.5104166666671,32.46807795698926,0
32,4,2,0,35,0.05714285714285714,0.0,1.0,35,1150,600,550,0.5217391304347826,17,6,11,343.6010209740294,0.47097338935574234,0.07960868660237241,0.18187005197571385,127339.27455786239,1750.7809496347563,129090.05550749715,31,0,15.057142857142857,33,2,16,39.00153796341264,0.5997474747474747,47.67156862745098,1009.3137254901964,30.58526440879383,0
33,4,1,1,35,0.027777777777777776,0.027777777777777776,0.9722222222222222,36,1000,700,300,0.7,13,7,6,336.2653365368505,0.46959325396825397,0.07921180719108145,0.17982148853091573,127753.08956916133,1391.7871315193122,129144.87670068064,32,0,15.61111111111111,34,2,18,38.763198696812694,0.6017156862745099,47.26190476190478,1010.9523809523837,29.73389355742305,0
34,4,2,0,37,0.05405405405405406,0.0,1.0,37,750,500,250,0.6666666666666666,10,5,5,328.129309493392,0.46896896896896895,0.07928710156517815,0.17783999046412763,128291.0574872472,1019.2112214935028,129310.26870874071,33,0,15.945945945945946,35,2,21,38.419803686355145,0.6050595238095238,46.73032407407408,1013.0787037037047,28.945105820105848,0
35,4,0,3,34,0.0,0.08108108108108109,0.9189189189189189,37,1250,700,550,0.56,18,7,11,329.33605713623876,0.46843718718718713,0.08404979539941881,0.1791506328198249,128437.66744898849,1059.8309970850698,129497.49844607356,34,1,16.945945945945947,35,2,13,38.23979980208572,0.6065476190476191,46.58564814814816,1013.6574074074086,28.961640211640248,0
36,4,1,1,34,0.02857142857142857,0.02857142857142857,0.9714285714285714,35,1250,800,450,0.64,17,8,9,348.4024598230854,0.46523109243697475,0.09677720368418385,0.18886840231852114,128299.67928501058,1939.9847714821296,130239.66405649271,35,0,18.457142857142856,33,2,22,37.89753941373332,0.6095328282828283,46.7218137254902,1013.1127450980393,30.700386215092102,0
37,4,0,0,34,0.0,0.0,1.0,34,1600,1200,400,0.75,20,12,8,355.46153165627754,0.4631053178847297,0.09867456454166934,0.19271779256824134,128304.38220589743,2321.4544434241525,130625.83664932159,36,1,19.647058823529413,32,2,22,37.713941508806926,0.6119791666666667,46.71717171717172,1013.1313131313137,31.660353535353554,0
38,4,0,0,34,0.0,0.0,1.0,34,700,400,300,0.5714285714285714,10,4,6,354.57371317948775,0.4626596850861557,0.09965406546371369,0.1925445617035567,128368.35048719516,2303.2085373941372,130671.5590245893,37,2,20.647058823529413,32,2,16,37.671058642744406,0.6126302083333333,46.6540404040404,1013.3838383838382,31.668244949494945,0
39,4,1,1,34,0.02857142857142857,0.02857142857142857,0.9714285714285714,35,1200,1000,200,0.8333333333333334,14,10,4,345.44986908069797,0.46249999999999997,0.1026694045174541,0.18902706319359536,128672.41753472213,1889.9739583333283,130562.39149305546,38,0,21.02857142857143,33,2,17,37.591974674880234,0.6133207070707071,46.354166666666664,1014.5833333333326,30.744949494949473,0
40,4,1,2,33,0.02857142857142857,0.05714285714285714,0.9428571428571428,35,850,400,450,0.47058823529411764,13,4,9,345.9190563006132,0.46120448179271706,0.10303092996793262,0.19032438914388297,128890.09785899642,1917.1082035755348,130807.20606257196,39,0,21.428571428571427,33,2,19,37.358194545015685,0.615530303030303,46.139705882352935,1015.4411764705873,30.770944741532947,0
41,4,0,1,32,0.0,0.030303030303030304,0.9696969696969697,33,950,600,350,0.631578947368421,13,6,7,364.62506888385525,0.45975378787878785,0.10454603781948846,0.19968539436485475,128705.44645521366,2785.846455891919,131491.2929111056,40,1,22.939393939393938,31,2,19,37.071864707643606,0.6186155913978495,46.32161458333333,1014.7135416666658,32.73269489247309,0
42,4,2,0,34,0.058823529411764705,0.0,1.0,34,1200,1000,200,0.8333333333333334,14,10,4,352.81077118938333,0.46004159239453357,0.10003653635367238,0.19533196066537376,129137.2133583307,2312.1999668401136,131449.4133251708,41,0,22.941176470588236,32,2,22,36.93141821946172,0.6204427083333333,45.89646464646464,1016.4141414141408,31.7629419191919,0
43,4,2,2,34,0.05555555555555555,0.05555555555555555,0.9444444444444444,36,650,200,450,0.3076923076923077,11,2,9,347.168412345375,0.4596230158730159,0.15516083991192708,0.18952280874474417,128579.18228565925,1799.2908787553824,130378.47316441464,42,0,22.61111111111111,33,3,19,37.643487191880126,0.6123737373737373,46.44607843137254,1014.2156862745089,30.73380867498512,8
44,4,1,2,33,0.02857142857142857,0.05714285714285714,0.9428571428571428,35,1250,900,350,0.72,16,9,7,380.14236522559804,0.4594187675070028,0.13965010945202794,0.20659463545469728,128400.34060618827,2773.030147910563,131173.37075409884,43,0,22.057142857142857,32,3,18,36.99052157302438,0.6129557291666667,46.622474747474755,1013.5101010101021,31.67219065656569,8
45,4,0,0,33,0.0,0.0,1.0,33,1000,500,500,0.5,15,5,10,385.58083792364033,0.45805713383838387,0.163527923368878,0.210354838910619,128553.12256113398,3313.524142964471,131866.64670409844,44,1,24.09090909090909,30,3,18,36.69621161917384,0.6197916666666667,46.47177419354837,1014.1129032258043,33.803763440860145,0
46,4,0,0,33,0.0,0.0,1.0,33,1200,800,400,0.6666666666666666,16,8,8,387.2308070821964,0.4573469065656566,0.15904275808936852,0.21252667551487964,128791.76783443158,3374.42804081395,132166.19587524552,45,2,25.09090909090909,30,3,20,36.41005693855933,0.6222222222222222,46.23655913978494,1015.053763440859,33.835125448028634,0
47,4,1,1,33,0.029411764705882353,0.029411764705882353,0.9705882352941176,34,650,400,250,0.6153846153846154,9,4,5,376.6095502932018,0.45779486036838973,0.14974186984210758,0.2083230007114412,129102.12410820836,2924.218580457876,132026.34268866622,46,0,25.323529411764707,31,3,21,36.362508007687396,0.6226478494623655,45.93098958333332,1016.276041666665,32.78309811827952,0
48,4,2,1,34,0.05714285714285714,0.02857142857142857,0.9714285714285714,35,950,500,450,0.5263157894736842,14,5,9,358.499278846822,0.4573879551820728,0.1294101471194833,0.20134094633613384,129700.2354863512,2299.4881776239636,131999.72366397516,47,0,24.6,33,2,16,36.21370709015078,0.6237373737373737,45.34313725490195,1018.6274509803904,30.867498514557287,0
49,4,1,1,34,0.02857142857142857,0.02857142857142857,0.9714285714285714,35,1150,600,550,0.5217391304347826,17,6,11,353.7590164415186,0.4567577030812325,0.13628063431042747,0.2005919654536239,130075.00120146081,2203.040897731615,132278.04209919242,48,0,25.571428571428573,33,2,18,35.953768220406836,0.6275252525252526,44.97549019607842,1020.0980392156849,30.912061794414694,0
50,4,0,1,33,0.0,0.029411764705882353,0.9705882352941176,34,750,400,350,0.5333333333333333,11,4,7,362.8410854681419,0.45601232917409384,0.1441526090376719,0.2052034037983692,129972.73875114776,2631.8899219467303,132604.6286730945,49,1,27.264705882352942,32,2,18,35.82605869242199,0.62890625,45.07575757575757,1019.696969696969,31.86553030303028,0
51,4,0,2,31,0.0,0.06060606060606061,0.9393939393939394,33,1050,500,550,0.47619047619047616,16,5,11,368.2255466940888,0.4551767676767677,0.14206165859849906,0.20820030730407293,129963.68620130759,2971.1898803711047,132934.8760816787,50,2,28.757575757575758,31,2,18,35.69800046822458,0.6313844086021505,45.08463541666667,1019.661458333334,32.8923051075269,0
52,4,0,0,31,0.0,0.0,1.0,31,1100,800,300,0.7272727272727273,14,8,6,418.21754549834753,0.4544802867383513,0.1828999276110359,0.22545428311725518,128076.4959279974,4512.76755260723,132589.26348060463,51,3,29.967741935483872,30,1,17,36.35888328243262,0.6149305555555555,46.942204301075265,1012.2311827956985,33.74103942652328,8
53,4,3,1,33,0.08823529411764706,0.029411764705882353,0.9705882352941176,34,1200,900,300,0.75,15,9,6,383.68898246757647,0.4567179144385027,0.16482650961470213,0.2117697513086692,129014.56921616699,3100.293757208778,132114.86297337577,52,0,28.235294117647058,33,1,19,36.27211499798954,0.6167929292929293,46.017156862745104,1015.9313725490207,30.785799168152142,0
54,4,1,0,34,0.029411764705882353,0.0,1.0,34,500,400,100,0.8,6,4,2,381.9001815891961,0.4563465537730244,0.1757258968212312,0.2114472701001866,129139.10064638611,3063.6491974240757,132202.7498438102,53,0,29.058823529411764,33,1,20,36.19031830238726,0.6180555555555556,45.89460784313726,1016.4215686274518,30.80065359477127,0
55,4,1,1,34,0.02857142857142857,0.02857142857142857,0.9714285714285714,35,1150,1100,50,0.9565217391304348,12,11,1,372.4753971194695,0.4571078431372549,0.16853944177887836,0.2083604797219821,129544.24267409174,2650.4236651768624,132194.66633926862,54,0,29.2,33,2,17,36.016687733237035,0.6221590909090908,45.49632352941177,1018.0147058823534,30.848930481283436,0
56,4,0,2,32,0.0,0.058823529411764705,0.9411764705882353,34,1150,700,450,0.6086956521739131,16,7,9,377.8610024737084,0.45623514557338085,0.17432757489612993,0.2126456269151204,129779.68606519741,3007.7364554637297,132787.42252066114,55,1,30.352941176470587,32,2,18,35.63971499380423,0.626953125,45.265151515151516,1018.9393939393938,31.841856060606055,0
57,4,0,2,30,0.0,0.0625,0.9375,32,1150,900,250,0.782608695652174,14,9,5,385.3697500428656,0.456086189516129,0.13771728016359952,0.21660437674823113,129731.44531249987,3598.9149305555425,133330.36024305542,56,2,29.90625,31,1,18,35.49761417859577,0.6290322580645161,45.31249999999999,1018.749999999999,32.86290322580642,0
58,4,1,0,31,0.03225806451612903,0.0,1.0,31,600,300,300,0.5,9,3,6,397.7948418004614,0.45546594982078853,0.15745068491984449,0.22329550453065877,129680.10210717989,4117.215140478648,133797.31724765853,57,0,31.580645161290324,30,1,19,35.233570863024525,0.63125,45.36290322580644,1018.5483870967731,33.95161290322577,0
59,4,0,2,29,0.0,0.06451612903225806,0.935483870967742,31,1150,900,250,0.782608695652174,14,9,5,398.22631960710476,0.45259856630824374,0.16240853412245948,0.2253052264622745,129988.3137682101,4152.953556769559,134141.26732497965,58,1,32.58064516129032,30,1,21,34.90812134791968,0.634375,45.06048387096774,1019.7580645161282,33.99193548387094,0
60,4,0,0,29,0.0,0.0,1.0,29,1150,900,250,0.782608695652174,14,9,5,415.07654284936507,0.4500205254515599,0.14691005913134725,0.23472495813561303,129969.4090409895,4989.450596181782,134958.8596371713,59,2,32.310344827586206,28,1,21,34.49785120473439,0.6402529761904762,45.07902298850574,1019.6839080459765,36.41728243021345,0
61,4,3,3,29,0.09375,0.09375,0.90625,32,950,700,250,0.7368421052631579,12,7,5,383.48647788398097,0.45226394489247307,0.1264827948098206,0.22247876034287623,130961.35669284384,3644.381883409271,134605.73857625312,60,0,30.1875,31,1,20,34.294963533053476,0.6414650537634409,44.10807291666666,1023.5677083333322,33.01831317204297,0
62,4,0,0,29,0.0,0.0,1.0,29,1350,900,450,0.6666666666666666,18,9,9,411.8552085239042,0.4489429392446634,0.13137950417708555,0.23711663947055817,130666.2455410224,4963.114760866675,135629.36030188907,61,1,32.827586206896555,28,1,21,33.86939057522955,0.6473214285714286,44.39655172413792,1022.4137931034468,36.514778325123096,0
63,4,1,0,30,0.03333333333333333,0.0,1.0,30,850,500,350,0.5882352941176471,12,5,7,396.62178812117486,0.44918582375478927,0.11891843009585812,0.2305911531568846,131043.55709876523,4394.945987654295,135438.5030864195,62,0,32.7,29,1,23,33.87536172906492,0.6479885057471264,44.027777777777764,1023.8888888888873,35.30651340996163,0
64,4,0,1,29,0.0,0.03333333333333333,0.9666666666666667,30,700,400,300,0.5714285714285714,10,4,6,422.28006909186826,0.44909003831417627,0.21235750113999008,0.2320952860948542,128848.62075617297,4882.040895061745,133730.66165123472,63,1,33.7,29,1,18,35.46226630186958,0.6257183908045977,46.180555555555564,1015.2777777777789,35.00957854406134,8
65,4,1,1,29,0.03333333333333333,0.03333333333333333,0.9666666666666667,30,700,500,200,0.7142857142857143,9,5,4,408.5993239629011,0.44904214559386973,0.17354315436833279,0.22619532121577296,129133.07354896526,4552.737310671762,133685.81085963701,64,0,32.63333333333333,30,0,19,35.518050780216875,0.6256944444444444,45.90053763440861,1016.397849462366,33.8799283154122,0
66,4,0,0,29,0.0,0.0,1.0,29,1500,1400,100,0.9333333333333333,16,14,2,415.8787476252379,0.4475574712643678,0.14947866137949872,0.2310367367308036,129272.00038580241,4952.2955246913525,134224.29591049376,63,1,32.55172413793103,29,0,19,35.19074933988891,0.6300287356321839,45.763888888888886,1016.944444444444,35.067049808429104,0
67,4,0,0,29,0.0,0.0,1.0,29,850,500,350,0.5882352941176471,12,5,7,418.51289208458877,0.4474035303776683,0.15141528089041256,0.23291705331516147,129342.63117283938,5026.311728395045,134368.94290123443,64,2,33.55172413793103,29,0,19,35.05142909157108,0.6307471264367817,45.694444444444436,1017.2222222222211,35.07662835249038,0
68,4,0,0,29,0.0,0.0,1.0,29,1050,700,350,0.6666666666666666,14,7,7,418.75022219002585,0.44709564860426926,0.15250360077946312,0.23346758963197323,129413.28124999988,5038.368055555542,134451.64930555542,65,3,34.55172413793103,29,0,20,34.973041223041236,0.6314655172413793,45.62499999999999,1017.4999999999991,35.086206896551694,0
69,4,0,1,28,0.0,0.034482758620689655,0.9655172413793104,29,850,700,150,0.8235294117647058,10,7,3,418.9410480349345,0.44689039408866993,0.1504856196355968,0.2339939024390243,129483.95061728389,5049.2283950617175,134533.17901234562,66,4,35.55172413793103,29,0,15,34.895833333333336,0.632183908045977,45.55555555555555,1017.7777777777773,35.09578544061301,0
70,4,0,0,28,0.0,0.0,1.0,28,850,600,250,0.7058823529411765,11,6,5,430.5328130486132,0.44582231040564374,0.15418684422921736,0.2396361883949828,129347.50297265162,5537.668863125909,134885.17183577752,67,5,36.892857142857146,28,0,20,34.74076035781545,0.6339285714285714,45.689655172413794,1017.2413793103449,36.330049261083744,0
71,4,1,0,29,0.034482758620689655,0.0,1.0,29,1050,800,250,0.7619047619047619,13,8,5,416.22341048550345,0.4479679802955665,0.13879615959677638,0.23373525976268616,129696.07445987653,4996.5084876543215,134692.58294753084,68,0,36.58620689655172,29,0,16,34.74797745659485,0.6343390804597702,45.34722222222222,1018.6111111111111,35.12452107279693,0
72,4,1,1,29,0.03333333333333333,0.03333333333333333,0.9666666666666667,30,1250,900,350,0.72,16,9,7,409.2328133690785,0.44559386973180076,0.12981301027126646,0.23296206782044843,130228.28686842405,4658.737643080116,134887.02451150416,69,0,36.333333333333336,30,0,19,34.382681502940905,0.6368055555555556,44.8252688172043,1020.6989247311824,34.023297491039415,0
73,4,0,0,29,0.0,0.0,1.0,29,900,400,500,0.4444444444444444,14,4,10,488.18860551839833,0.4439655172413793,0.21615067404098554,0.2513483435243747,126211.25347222238,6669.311112556387,132880.56458477877,70,1,38.3448275862069,24,5,19,36.527962072206556,0.6167534722222222,48.79166666666668,1004.8333333333346,41.86805555555561,8
74,4,1,1,29,0.03333333333333333,0.03333333333333333,0.9666666666666667,30,1050,800,250,0.7619047619047619,13,8,5,474.31423810204893,0.4468630268199234,0.20533578656853702,0.24668879273537192,126625.62157064478,6012.067043895755,132637.68861454053,71,0,38.03333333333333,26,4,15,36.444917203311874,0.6129807692307692,48.37962962962963,1006.481481481482,38.71082621082623,0
75,4,2,1,30,0.06451612903225806,0.03225806451612903,0.967741935483871,31,550,400,150,0.7272727272727273,7,4,3,463.1821768955261,0.4505376344086021,0.23109957055827435,0.2452587592414015,127354.736328125,5597.688802083334,132952.42513020834,72,0,37.67741935483871,27,4,14,35.96813725490197,0.6168981481481481,47.65625,1009.375,37.38425925925926,0
76,4,3,2,31,0.09090909090909091,0.06060606060606061,0.9393939393939394,33,1050,700,350,0.6666666666666666,14,7,7,437.09461633558556,0.452020202020202,0.21673525377229041,0.23603109282121634,128144.5312500001,4602.25694444446,132746.78819444455,73,0,36.18181818181818,29,4,17,35.811042524005494,0.6185344827586207,46.87500000000001,1012.5000000000008,34.913793103448306,0
77,4,2,1,32,0.06060606060606061,0.030303030303030304,0.9696969696969697,33,750,500,250,0.6666666666666666,10,5,5,432.41398376613296,0.4518229166666667,0.20474509904943505,0.23585609717321215,128544.89736094586,4516.922232131047,133061.8195930769,74,0,35.54545454545455,28,5,14,35.517320770756584,0.6257440476190477,46.47988505747126,1014.0804597701141,36.217159277504074,0
78,4,0,3,29,0.0,0.09375,0.90625,32,950,800,150,0.8421052631578947,11,8,3,441.0014465461526,0.45127688172043007,0.19493872908717336,0.24039870854123857,128521.48216057246,4935.6319090135885,133457.11406958604,75,1,35.71875,27,5,14,35.323720770961735,0.628858024691358,46.50297619047618,1013.9880952380944,37.55511463844794,0
79,4,2,0,31,0.06451612903225806,0.0,1.0,31,850,700,150,0.8235294117647058,10,7,3,450.4034528054045,0.4492831541218638,0.21166593018117608,0.24536904518503377,128496.33487654322,5375.038580246917,133871.37345679014,76,0,37.61290322580645,26,5,16,35.11130136986302,0.6322115384615384,46.52777777777778,1013.8888888888889,38.995726495726494,0
80,4,1,0,32,0.03125,0.0,1.0,32,1400,1000,400,0.7142857142857143,18,10,8,437.06199272180186,0.44976478494623656,0.216230551626591,0.24103184778027598,128982.3725888492,4874.658557933667,133857.03114678286,77,0,37.40625,28,4,17,34.94961103253182,0.6302083333333333,46.04885057471264,1015.8045977011491,36.278735632183896,0
81,4,1,1,32,0.030303030303030304,0.030303030303030304,0.9696969696969697,33,1000,500,500,0.5,15,5,10,428.67267806134146,0.45130997474747475,0.2391984917669847,0.22352218213198516,126730.08323424494,4286.469480776851,131016.5527150218,78,0,37.24242424242424,28,5,19,37.48513603500761,0.6071428571428572,48.275862068965516,1006.8965517241379,35.960591133004925,8
82,4,0,0,32,0.0,0.0,1.0,32,1000,700,300,0.7,13,7,6,440.03607542626526,0.4495337701612903,0.23826219512195146,0.22916428408457917,126679.71241230863,4748.728697208044,131428.44110951666,79,1,39.21875,27,5,20,37.25132421778763,0.6099537037037037,48.325892857142854,1006.6964285714282,37.2850529100529,0
83,4,0,1,31,0.0,0.03125,0.96875,32,1050,600,450,0.5714285714285714,15,6,9,437.12170749291613,0.4495547715053763,0.23009013002364065,0.22827466946852304,126792.09183673479,4684.715136054438,131476.80697278923,80,2,40.21875,27,5,20,37.20818557919622,0.6111111111111112,48.21428571428572,1007.1428571428579,37.30158730158733,0
84,4,1,0,32,0.03125,0.0,1.0,32,1200,700,500,0.5833333333333334,17,7,10,418.09237678544747,0.45220094086021506,0.19062010397379336,0.22054294345684644,127200.69372192495,4236.328073391467,131437.02179531642,81,0,39.5,28,4,22,37.264990742059545,0.6119791666666667,47.80890804597701,1008.7643678160919,36.02729885057471,0
85,4,1,2,31,0.030303030303030304,0.06060606060606061,0.9393939393939394,33,650,500,150,0.7692307692307693,8,5,3,407.2291775515173,0.453125,0.18927623547450279,0.21666260485239122,127547.57185571,3788.2185570987817,131335.7904128088,82,0,39.27272727272727,29,4,17,37.18132705440213,0.6124281609195402,47.465277777777786,1010.1388888888898,34.83237547892723,0
86,4,1,0,32,0.03125,0.0,1.0,32,900,600,300,0.6666666666666666,12,6,6,409.0126474651928,0.4514868951612903,0.1776417525773195,0.21799025716551498,127617.73003472228,4039.453125000004,131657.18315972228,83,0,39.625,29,3,18,37.06400343642611,0.6131465517241379,47.395833333333336,1010.4166666666671,34.84195402298852,0
87,4,0,0,32,0.0,0.0,1.0,32,650,500,150,0.7692307692307693,8,5,3,409.8860570467315,0.45138188844086025,0.1785665200659703,0.21864596415484008,127652.81635802473,4064.6219135802535,131717.438271605,84,1,40.625,29,3,18,37.00579530877773,0.6135057471264368,47.361111111111114,1010.5555555555559,34.84674329501917,0
88,4,1,0,33,0.030303030303030304,0.0,1.0,33,650,300,350,0.46153846153846156,10,3,7,403.68299378322735,0.45300662878787884,0.17326941885316227,0.21725012581800682,128008.4786716671,3734.9691799629836,131743.44785163007,85,0,40.36363636363637,30,3,19,36.796608668703236,0.6142361111111111,47.00940860215053,1011.9623655913966,33.73207885304655,0
89,4,1,2,32,0.029411764705882353,0.058823529411764705,0.9411764705882353,34,650,500,150,0.7692307692307693,8,5,3,396.4674491166742,0.453561348781937,0.16746791237697867,0.21515409267963434,128342.36145019531,3376.7137315538203,131719.07518174913,86,0,40.14705882352941,31,3,20,36.636361689368634,0.6149193548387097,46.6796875,1013.28125,32.68649193548387,0
90,4,1,0,33,0.030303030303030304,0.0,1.0,33,700,500,200,0.7142857142857143,9,5,4,407.441722198303,0.45213857323232326,0.17967176741549973,0.22114493474823643,128348.74561004149,3858.926790669425,132207.6724007109,87,0,41.666666666666664,30,3,21,36.351803952778894,0.6177083333333333,46.673387096774185,1013.306451612902,33.77688172043007,0
91,4,0,2,31,0.0,0.06060606060606061,0.9393939393939394,33,1350,1100,250,0.8148148148148148,16,11,5,410.2457413766447,0.4518229166666667,0.1752537974200441,0.22342842073675298,128484.9788450976,3942.083080413908,132427.06192551152,88,1,42.666666666666664,30,3,15,36.14084802686818,0.6190972222222222,46.53897849462365,1013.8440860215046,33.79480286738349,0
92,4,1,3,29,0.03125,0.09375,0.90625,32,900,400,500,0.4444444444444444,14,4,10,414.94606467772394,0.451171875,0.1820507117437724,0.2272560681061056,128707.6485339505,4281.346450617267,132988.99498456778,89,0,42.75,29,3,17,35.7930696231408,0.6242816091954023,46.319444444444436,1014.7222222222213,34.990421455938666,0
93,4,0,0,29,0.0,0.0,1.0,29,1450,1200,250,0.8275862068965517,17,12,5,432.7637581609945,0.44735221674876846,0.16819647730091813,0.2352397411679595,128408.33875868049,5314.095052083324,133722.43381076382,90,1,45.310344827586206,27,2,17,35.648980815347734,0.6277006172839505,46.61458333333333,1013.5416666666661,37.53858024691356,0
94,4,0,1,28,0.0,0.034482758620689655,0.9655172413793104,29,1350,1100,250,0.8148148148148148,16,11,5,434.2660470704379,0.4466338259441707,0.17372428972601028,0.23695140999079528,128559.207700007,5365.779788477879,133924.98748848488,91,2,46.310344827586206,27,2,17,35.45564318904378,0.6292438271604939,46.4657738095238,1014.136904761904,37.560626102292744,0
95,4,0,0,28,0.0,0.0,1.0,28,900,700,200,0.7777777777777778,11,7,4,439.74298088239505,0.4455742945326278,0.15801886792452802,0.24003246431553965,128574.57895137924,5707.953722755657,134282.53267413488,92,3,45.785714285714285,26,2,17,35.30096114830594,0.6330128205128205,46.450617283950606,1014.1975308641966,39.00759734093064,0
96,4,2,0,30,0.06666666666666667,0.0,1.0,30,950,700,250,0.7368421052631579,12,7,5,412.8781628424881,0.4475095785440613,0.13536281018976326,0.22959658403471875,129310.96671043058,4677.934874157733,133988.9015845883,93,0,43.666666666666664,28,2,19,35.22713895559638,0.6335565476190477,45.72557471264367,1017.0977011494243,36.324917898193725,0
97,4,0,1,29,0.0,0.03333333333333333,0.9666666666666667,30,650,500,150,0.7692307692307693,8,5,3,417.652661194072,0.44600095785440613,0.141432538001788,0.23311535060974078,129457.14272443517,4813.6240338882235,134270.76675832339,94,1,44.666666666666664,28,2,18,34.95605675561204,0.6350446428571428,45.581896551724135,1017.6724137931031,36.34544334975369,0
98,4,0,0,29,0.0,0.0,1.0,29,950,800,150,0.8421052631578947,11,8,3,430.8613905499911,0.4434010673234811,0.1522244581965273,0.2400814447587847,129390.57019292083,5349.880199475612,134740.45039239645,95,2,46.793103448275865,27,2,19,34.688246550631376,0.6377314814814814,45.64732142857142,1017.4107142857135,37.68187830687828,0
99,4,0,0,29,0.0,0.0,1.0,29,750,500,250,0.6666666666666666,10,5,5,430.9874294023545,0.44334975369458124,0.1476017364910176,0.24061412487205716,129466.28146701377,5359.667968749983,134825.94943576376,96,3,47.793103448275865,27,2,18,34.607429205049456,0.6385030864197531,45.57291666666666,1017.7083333333323,37.69290123456786,0
100,4,0,1,28,0.0,0.034482758620689655,0.9655172413793104,29,550,300,250,0.5454545454545454,8,3,5,428.0686008260449,0.44319581280788173,0.14504732433549372,0.23967638026610447,129579.88989866774,5293.8164328231205,134873.70633149086,97,4,48.793103448275865,27,2,18,34.56530741498586,0.6396604938271605,45.46130952380952,1018.1547619047614,37.70943562610227,0
101,4,1,0,29,0.034482758620689655,0.0,1.0,29,950,700,250,0.7368421052631579,12,7,5,430.12456710533337,0.4430931855500821,0.14830103196576894,0.24269796414098313,129883.08930342976,5373.181512188221,135256.270815618,98,0,49.62068965517241,27,2,19,34.202554744525564,0.6427469135802469,45.16369047619048,1019.3452380952385,37.753527336860685,0
102,4,0,1,28,0.0,0.034482758620689655,0.9655172413793104,29,400,200,200,0.5,6,2,4,429.03067506464754,0.4430418719211822,0.14754453163142522,0.24231567641120377,129921.01414133365,5348.020080428005,135269.03422176166,99,1,50.62068965517241,27,2,19,34.19163260837833,0.6431327160493827,45.126488095238095,1019.4940476190479,37.759038800705476,0
103,4,1,0,29,0.034482758620689655,0.0,1.0,29,1050,800,250,0.7619047619047619,13,8,5,420.44601017208885,0.44027093596059114,0.13014087621689785,0.23979052999091446,130300.5670041454,5156.870704010768,135457.43770815615,100,0,49.10344827586207,27,2,22,34.02276757518341,0.6469907407407407,44.754464285714285,1020.9821428571428,37.814153439153436,0
104,4,0,0,29,0.0,0.0,1.0,29,450,200,250,0.4444444444444444,7,2,5,417.07418455670216,0.4397064860426929,0.12422634836427959,0.2385664335664336,130414.54081632647,5078.507653061215,135493.0484693877,101,1,50.10344827586207,27,2,22,33.99256993006993,0.6481481481481481,44.64285714285714,1021.4285714285709,37.83068783068781,0
105,4,0,0,29,0.0,0.0,1.0,29,1150,900,250,0.782608695652174,14,9,5,415.66285871865205,0.43832101806239737,0.11391204412347733,0.23939811418741475,130680.67347381657,5063.820463081062,135744.49393689763,102,2,51.10344827586207,27,2,20,33.757367923155286,0.6508487654320987,44.382440476190474,1022.4702380952378,37.869268077601404,0
106,4,1,2,28,0.03333333333333333,0.06666666666666667,0.9333333333333333,30,1300,900,400,0.6923076923076923,17,9,8,401.64513006357373,0.43994252873563217,0.10733258511036259,0.23389922280172823,131107.31272294887,4531.722734178887,135639.03545712776,103,0,50.36666666666667,28,2,22,33.6820169285447,0.6517857142857143,43.96551724137931,1024.1379310344828,36.576354679802954,0
107,4,1,1,28,0.034482758620689655,0.034482758620689655,0.9655172413793104,29,900,600,300,0.6666666666666666,12,6,6,388.6224086193535,0.4392959770114942,0.04820672838871798,0.22804535933450454,131399.31520061722,4412.943672839494,135812.2588734567,104,0,47.58620689655172,29,0,23,33.719407567958086,0.6515804597701149,43.68055555555555,1025.2777777777771,35.354406130268174,0
108,4,0,0,28,0.0,0.0,1.0,28,1000,900,100,0.9,11,9,2,401.1528861651753,0.4373622134038801,0.05766071678987128,0.23428511312398562,131217.6956376337,4927.671464196054,136145.36710182976,105,1,50.07142857142857,28,0,23,33.58253868087692,0.6529017857142857,43.85775862068965,1024.568965517241,36.59174876847289,0
109,4,0,0,28,0.0,0.0,1.0,28,1150,800,350,0.6956521739130435,15,8,7,400.2247339546567,0.43639770723104054,0.05894308943089421,0.23441734417344182,131328.125,4912.152777777779,136240.27777777778,106,2,51.07142857142857,28,0,24,33.49424119241191,0.6540178571428572,43.75,1025.0,36.607142857142854,0
110,4,0,0,28,0.0,0.0,1.0,28,500,400,100,0.8,6,4,2,401.91308444684637,0.4363701499118166,0.030682393439303457,0.2186196461659602,128435.6446731736,4723.993220702888,133159.6378938765,107,3,52.07142857142857,28,0,19,36.40266950153556,0.6246279761904762,46.58764367816093,1013.6494252873574,36.201765188834194,8
111,4,0,0,28,0.0,0.0,1.0,28,850,500,350,0.5882352941176471,12,5,7,401.54996915840405,0.4359292328042328,0.03390250814793827,0.2188214774016108,128508.47463750181,4720.514805456493,133228.98944295832,108,4,53.07142857142857,28,0,19,36.33714751310757,0.6253720238095238,46.51580459770116,1013.9367816091967,36.21202791461417,0
112,4,2,0,30,0.06666666666666667,0.0,1.0,30,600,400,200,0.6666666666666666,8,4,4,380.37925552897127,0.4417385057471264,0.0337387089667327,0.21112025444436314,129235.55333347792,3831.7047129726066,133067.25804645053,109,0,50.46666666666667,30,0,22,36.13048028200045,0.6267361111111112,45.7997311827957,1016.8010752688177,33.89336917562726,0
113,4,0,0,30,0.0,0.0,1.0,30,1000,700,300,0.7,13,7,6,379.88445897587405,0.44125957854406134,0.03891899035284818,0.21121129324543986,129303.89577190994,3824.108097756955,133128.0038696669,110,1,51.46666666666667,30,0,22,36.0733007356504,0.6274305555555555,45.732526881720425,1017.0698924731174,33.90232974910391,0
114,4,0,1,29,0.0,0.03333333333333333,0.9666666666666667,30,1600,1300,300,0.8125,19,13,6,381.47117483742625,0.4403735632183908,0.03875682338439845,0.21301620471010244,129474.83090530684,3878.183171464892,133353.01407677174,111,2,52.46666666666667,30,0,18,35.858535833773544,0.6291666666666667,45.56451612903225,1017.74193548387,33.92473118279567,0
115,4,1,1,29,0.03333333333333333,0.03333333333333333,0.9666666666666667,30,500,200,300,0.4,8,2,6,379.4557982803474,0.44305555555555554,0.05019359380499844,0.21262996507188694,129611.66030754999,3836.3792056885195,133448.0395132385,112,0,53.06666666666667,30,0,19,35.770305350228796,0.6305555555555555,45.43010752688172,1018.279569892473,33.9426523297491,0
116,4,0,1,28,0.0,0.034482758620689655,0.9655172413793104,29,700,500,200,0.7142857142857143,9,5,4,390.8547592565506,0.4419129720853859,0.04263870521406421,0.21811064897736057,129448.61352237644,4319.121334876531,133767.73485725297,113,1,52.275862068965516,29,0,19,35.64655270460854,0.6318247126436782,45.59027777777777,1017.6388888888881,35.09099616858235,0
117,4,0,2,26,0.0,0.07142857142857142,0.9285714285714286,28,700,300,400,0.42857142857142855,11,3,8,419.39198726461666,0.44232253086419754,0.024827520729159946,0.21962127964181896,126904.52108577805,5106.126754810715,132010.64784058876,114,2,52.214285714285715,27,1,21,37.53830674937234,0.6122685185185186,48.10267857142857,1007.5892857142856,37.31812169312169,8
118,4,1,0,27,0.037037037037037035,0.0,1.0,27,500,400,100,0.8,6,4,2,427.69134618001823,0.444681861348528,0.048282549890267035,0.22435760497202406,126975.33543381344,5461.250428669404,132436.58586248284,115,0,53.74074074074074,26,1,22,37.255971520440966,0.6165865384615384,48.032407407407405,1007.8703703703702,38.764245014245006,0
119,4,3,1,29,0.1,0.03333333333333333,0.9666666666666667,30,800,600,200,0.75,10,6,4,389.93470462851303,0.44892241379310344,0.0393523600439083,0.2101955715482693,128074.22839506157,3988.1172839506,132062.34567901216,116,0,49.266666666666666,29,1,21,37.07693011342848,0.617816091954023,46.944444444444436,1012.2222222222209,34.90421455938693,0
120,4,1,0,30,0.03333333333333333,0.0,1.0,30,700,300,400,0.42857142857142855,11,3,8,390.652051592798,0.4468630268199234,0.04791666666666683,0.21206825657894737,128355.55555555549,4028.472222222218,132384.0277777777,117,0,50.233333333333334,29,1,23,36.77014802631581,0.6206896551724138,46.666666666666664,1013.3333333333328,34.942528735632166,0
121,4,1,1,30,0.03225806451612903,0.03225806451612903,0.967741935483871,31,550,300,250,0.5454545454545454,8,3,5,379.9763168282094,0.4478046594982079,0.04888698995941043,0.20818731437249507,128723.56088854214,3582.3809110880034,132305.94179963015,118,0,49.58064516129032,30,1,21,36.6639072847682,0.6215277777777778,46.30376344086022,1014.78494623656,33.826164874552,0
122,4,2,1,31,0.0625,0.03125,0.96875,32,900,500,400,0.5555555555555556,13,5,8,367.86862344929926,0.44947076612903225,0.054952754644459034,0.20348792388531414,129102.12410820868,3098.5241360134755,132200.64824422216,119,0,48.90625,31,1,23,36.584587871022855,0.6226478494623655,45.93098958333334,1016.2760416666678,32.783098118279604,0
123,4,2,0,33,0.06060606060606061,0.0,1.0,33,950,700,250,0.7368421052631579,12,7,5,359.1412253356198,0.4501657196969697,0.061980909879756796,0.20161393631053914,129683.21352731877,2714.917642332429,132398.1311696512,120,0,47.878787878787875,32,1,20,36.214670881368534,0.6259765625,45.35984848484849,1018.5606060606071,31.830018939393973,0
124,4,1,1,33,0.029411764705882353,0.029411764705882353,0.9705882352941176,34,1200,800,400,0.6666666666666666,16,8,8,347.7528661990904,0.44951351752822344,0.06957910506826459,0.1971862982453155,130075.00120146111,2246.790897731657,132321.79209919277,121,0,47.44117647058823,33,1,22,36.10693977254523,0.6275252525252526,44.97549019607844,1020.0980392156874,30.91206179441477,0
125,4,0,1,32,0.0,0.030303030303030304,0.9696969696969697,33,1300,900,400,0.6923076923076923,17,9,8,359.5017099810345,0.4473642676767677,0.07429420505200612,0.20331483261952635,129972.73875114789,2745.084366391188,132717.82311753908,122,1,49.81818181818182,32,1,23,35.911187469044066,0.62890625,45.07575757575758,1019.69696969697,31.86553030303031,0
126,4,0,1,31,0.0,0.03125,0.96875,32,950,600,350,0.631578947368421,13,6,7,369.3278768954075,0.44650957661290325,0.07043625447112922,0.20829240780527755,129864.12896050354,3192.488606770844,133056.6175672744,123,2,48.59375,31,1,23,35.77116334525634,0.6303763440860215,45.18229166666667,1019.2708333333339,32.879704301075286,0
127,4,1,1,31,0.03125,0.03125,0.96875,32,650,300,350,0.46153846153846156,10,3,7,361.2831957368923,0.44781165994623656,0.051695266649655514,0.20549620378706535,130196.1347791883,3007.5351291232555,133203.66990831157,124,0,46.0,31,1,24,35.638874712936975,0.633736559139785,44.85677083333333,1020.5729166666661,32.92170698924729,0
128,4,0,0,31,0.0,0.0,1.0,31,850,700,150,0.8235294117647058,10,7,3,371.7875689013194,0.44672939068100354,0.048219285165028714,0.21145940154814377,130193.99144771077,3480.9015131807155,133674.89296089148,125,1,46.935483870967744,30,1,25,35.373040958777814,0.6364583333333333,44.858870967741936,1020.5645161290327,34.01881720430109,0
129,4,0,0,31,0.0,0.0,1.0,31,1200,700,500,0.5833333333333334,17,7,10,373.32117499730765,0.4461021505376344,0.048801674102736614,0.21328909089007003,130368.94531249999,3533.9156351167753,133902.86094761675,126,2,47.935483870967744,29,2,26,35.15614375084999,0.6411637931034483,44.6875,1021.2499999999999,35.21551724137931,0
130,4,1,0,32,0.03125,0.0,1.0,32,900,700,200,0.7777777777777778,11,7,4,361.42533842841857,0.44730762768817206,0.048099040483701616,0.20831242233056096,130708.89698230993,3048.301465487317,133757.19844779724,127,0,47.40625,30,2,21,35.11517481598317,0.6416666666666666,44.35483870967741,1022.580645161289,34.0860215053763,0
131,4,0,0,32,0.0,0.0,1.0,32,500,300,200,0.6,7,3,4,361.58568424042954,0.4469506048387097,0.0462611680462488,0.20896193187197462,130812.00003251804,3059.949307723415,133871.94934024147,128,1,48.40625,30,2,22,35.00662418429468,0.6427083333333333,44.254032258064505,1022.9838709677406,34.09946236559135,0
132,4,0,0,32,0.0,0.0,1.0,32,850,600,250,0.7058823529411765,11,6,5,360.9812947963406,0.44585853494623656,0.05306933842239214,0.20924136999256895,130928.03955078112,3052.514648437486,133980.5541992186,129,2,49.40625,31,1,23,34.904580152671755,0.6411290322580645,44.14062499999999,1023.437499999999,33.01411290322577,0
133,4,0,1,31,0.0,0.03125,0.96875,32,1250,800,450,0.64,17,8,9,359.6244770700358,0.4454805107526882,0.049361563414324294,0.20863527780424726,130961.35669284381,3019.3818834092685,133980.7385762531,130,3,50.40625,31,1,23,34.90557287028793,0.6414650537634409,44.10807291666666,1023.567708333332,33.018313172042966,0
134,4,0,0,31,0.0,0.0,1.0,31,750,600,150,0.8,9,6,3,369.95101196468465,0.4449820788530466,0.052960874909923294,0.21360600918446493,130777.62783269733,3476.263151809443,134253.89098450678,131,4,52.70967741935484,30,1,23,34.827529566360056,0.6423611111111112,44.287634408602145,1022.8494623655906,34.09498207885302,0
135,4,0,0,31,0.0,0.0,1.0,31,750,400,350,0.5333333333333333,11,4,7,370.3698463617536,0.44484767025089605,0.05343999864408522,0.21442020078722643,130880.75798141392,3494.857245057217,134375.61522647113,132,5,53.70967741935484,30,1,24,34.712279434300974,0.6434027777777778,44.18682795698924,1023.2526881720421,34.10842293906807,0
136,4,0,0,31,0.0,0.0,1.0,31,950,500,450,0.5263157894736842,14,5,9,372.8707141245472,0.4444444444444444,0.05495347842474607,0.21664044465954793,131018.32807622259,3570.5795106370574,134588.90758685966,133,6,54.70967741935484,30,1,24,34.508883637477574,0.6447916666666667,44.052419354838705,1023.7903225806444,34.12634408602148,0
137,4,1,0,32,0.03125,0.0,1.0,32,700,400,300,0.5714285714285714,10,4,6,363.29551038969873,0.44424143145161293,0.05790694244132677,0.2129788514790338,131362.56946250994,3145.0521736616706,134507.62163617162,134,0,53.96875,30,2,25,34.40572964468336,0.6482638888888889,43.71639784946235,1025.134408602149,34.17114695340497,0
138,4,0,0,32,0.0,0.0,1.0,32,550,200,350,0.36363636363636365,9,2,7,364.8071264529719,0.4438424059139785,0.059370904325033225,0.21444363442497458,131465.92994854873,3191.9416261995348,134657.87157474825,135,1,54.96875,30,2,26,34.26250546089996,0.6493055555555556,43.61559139784945,1025.5376344086003,34.18458781362001,0
139,4,0,0,32,0.0,0.0,1.0,32,1050,600,450,0.5714285714285714,15,6,9,366.86729151786045,0.44228830645161293,0.0628028418019908,0.21682651997139196,131672.772863915,3261.286709446194,134934.05957336118,136,2,55.96875,30,2,19,34.000676619521556,0.6513888888888889,43.41397849462366,1026.3440860215062,34.21146953405021,0
140,4,0,0,32,0.0,0.0,1.0,32,1050,700,350,0.6666666666666666,14,7,7,364.39550725034974,0.44161626344086025,0.05942408376963404,0.21614764560502117,131810.75846918728,3206.2496386865714,135017.00810787384,137,3,56.96875,30,2,22,33.92479275741711,0.6527777777777778,43.27956989247313,1026.8817204301083,34.22939068100361,0
141,4,0,1,31,0.0,0.03125,0.96875,32,1250,800,450,0.64,17,8,9,400.5574594756483,0.44117523521505375,0.006822909787346676,0.22347977344805703,129440.63484579147,3969.682369349065,133410.31721514053,138,4,57.96875,30,2,19,35.407861136793905,0.6288194444444444,45.598118279569896,1017.6075268817208,33.92025089605736,8
142,4,0,2,29,0.0,0.06451612903225806,0.935483870967742,31,600,200,400,0.3333333333333333,10,2,8,406.76813934183434,0.4392025089605735,0.0205775092052638,0.22638068788294793,129342.63117283952,4322.492283950614,133665.12345679014,139,5,60.483870967741936,29,2,22,35.350104678681944,0.6307471264367817,45.69444444444444,1017.2222222222224,35.07662835249043,0
143,4,0,1,28,0.0,0.034482758620689655,0.9655172413793104,29,850,500,350,0.5882352941176471,12,5,7,415.68293297934395,0.43698686371100165,0.05072745348385377,0.23073610731501662,129239.21407755796,4944.507112740908,134183.72119029888,140,16,64.44827586206897,27,2,22,35.22930996633982,0.6361882716049383,45.79613095238094,1016.815476190475,37.65983245149908,0
144,4,0,1,27,0.0,0.03571428571428571,0.9642857142857143,28,750,500,250,0.6666666666666666,10,5,5,424.6387209437955,0.4348544973544974,0.06556017946550519,0.23618513162367546,129319.08543381336,5382.778206447178,134701.86364026053,141,17,66.92857142857143,26,2,23,34.91977696859355,0.640625,45.71759259259259,1017.129629629629,39.120370370370345,0
145,4,1,0,28,0.03571428571428571,0.0,1.0,28,950,700,250,0.7368421052631579,12,7,5,408.5373176696658,0.43276014109347444,0.06141522029372526,0.23007101574028532,129807.25623582766,5006.221655328803,134813.47789115648,142,0,65.5,27,1,22,34.83012071651092,0.6419753086419753,45.23809523809524,1019.047619047619,37.742504409171076,0
146,4,0,0,28,0.0,0.0,1.0,28,750,500,250,0.6666666666666666,10,5,5,424.9461891308223,0.43259479717813054,0.0820776999511319,0.22316036399265315,127019.58647113209,5195.29784317609,132214.88431430818,143,1,66.5,28,0,19,37.279373337134174,0.6101190476190477,47.988505747126425,1008.0459770114929,36.00164203612475,8
147,4,3,0,31,0.0967741935483871,0.0,1.0,31,1000,800,200,0.8,12,8,4,399.76841020584004,0.44269713261648747,0.018251329930202953,0.21013755045227797,127058.13397863918,3999.644765297664,131057.77874393684,144,0,60.96774193548387,30,1,20,37.87411678442874,0.6045138888888889,47.950268817204304,1008.198924731183,33.606630824372765,8
148,4,0,0,31,0.0,0.0,1.0,31,700,300,400,0.42857142857142855,11,3,8,402.29098877452776,0.44175627240143367,0.01829318089015941,0.21217103800090173,127193.68071814667,4033.7743163949663,131227.45503454164,145,1,61.96774193548387,30,1,20,37.670719520319786,0.6059027777777778,47.81586021505377,1008.7365591397854,33.62455197132618,0
149,4,2,2,31,0.06060606060606061,0.06060606060606061,0.9393939393939394,33,650,400,250,0.6153846153846154,9,4,5,384.614737196482,0.4476010101010101,0.010759278175008768,0.20620910608727056,127857.05061983476,3235.14118457301,131092.19180440778,146,0,59.15151515151515,32,1,18,37.43445692883896,0.607421875,47.159090909090914,1011.3636363636367,31.605113636363647,0
150,4,2,0,33,0.06060606060606061,0.0,1.0,33,700,500,200,0.7142857142857143,9,5,4,383.28515143745227,0.44543087121212116,0.03079434907821077,0.2068089060717021,128112.5730155087,3220.7293898581866,131333.30240536688,147,0,59.96969696969697,32,1,21,37.205870125550845,0.6100260416666667,46.90656565656566,1012.3737373737379,31.63667929292931,0
151,4,3,2,34,0.08333333333333333,0.05555555555555555,0.9444444444444444,36,950,700,250,0.7368421052631579,12,7,5,359.03735517141456,0.4484953703703704,0.034552845528454945,0.19762821545006212,128907.38195516115,2056.5130958504747,130963.89505101163,148,0,55.888888888888886,35,1,15,37.00754122027201,0.6113095238095239,46.12268518518518,1015.509259259259,29.01455026455026,0
152,4,1,2,33,0.02857142857142857,0.05714285714285714,0.9428571428571428,35,1200,1000,200,0.8333333333333334,14,10,4,366.6190922826211,0.44775910364145655,0.040584758109081465,0.20191268407120985,128929.21095521537,2453.5820578231237,131382.7930130385,149,0,58.457142857142856,34,1,16,36.792775368264785,0.6136642156862745,46.101190476190474,1015.5952380952377,29.870448179271698,0
153,4,3,4,32,0.08333333333333333,0.1111111111111111,0.8888888888888888,36,1000,600,400,0.6,14,6,8,360.2960620617237,0.4466435185185185,0.06173014970627255,0.20144970539306162,129525.18332315245,2133.4826978309347,131658.6660209834,150,0,57.583333333333336,35,1,17,36.34605362895584,0.6175595238095238,45.5150462962963,1017.939814814815,29.083994708994716,0
154,4,3,1,34,0.08571428571428572,0.02857142857142857,0.9714285714285714,35,950,500,450,0.5263157894736842,14,5,9,368.4669210359696,0.44439775910364143,0.08302705589771842,0.2073444034942052,129776.9292091835,2563.701105442153,132340.63031462565,151,0,58.74285714285714,34,1,19,35.88182030611052,0.6222426470588236,45.26785714285713,1018.92857142857,29.96848739495794,0
155,4,0,0,34,0.0,0.0,1.0,34,950,700,250,0.7368421052631579,12,7,5,378.09309930955476,0.44230912061794414,0.09593407915313401,0.21251439719812903,129731.44531249996,3010.1128472222226,132741.5581597222,152,1,61.470588235294116,33,1,19,35.68294137695978,0.6240530303030303,45.3125,1018.7499999999997,30.87121212121211,0
156,4,1,0,35,0.02857142857142857,0.0,1.0,35,800,500,300,0.625,11,5,6,372.0226468569565,0.44527310924369745,0.10076855108947558,0.21097697292635748,130080.35891439917,2678.5678854875423,132758.9267998867,153,0,60.68571428571428,34,1,20,35.48255339012722,0.6253063725490196,44.9702380952381,1020.1190476190483,30.003501400560243,0
157,4,0,0,35,0.0,0.0,1.0,35,900,100,800,0.1111111111111111,17,1,16,372.26018260924025,0.4446078431372549,0.09831050684794596,0.2119361756767349,130232.20663265324,2696.053004535171,132928.2596371884,154,1,61.68571428571428,34,1,21,35.32214641163207,0.6268382352941176,44.821428571428584,1020.7142857142871,30.021008403361385,0
158,4,1,1,35,0.027777777777777776,0.027777777777777776,0.9722222222222222,36,850,500,350,0.5882352941176471,12,5,7,364.65220089432114,0.44512235449735454,0.1006224603359478,0.20956518051396522,130597.00255102038,2324.5004251700707,132921.50297619044,155,0,60.94444444444444,34,2,19,35.146119652146915,0.6305147058823529,44.464285714285715,1022.142857142857,30.063025210084028,0
159,4,0,2,33,0.0,0.05714285714285714,0.9428571428571428,35,650,500,150,0.7692307692307693,8,5,3,370.3515905862273,0.4457282913165266,0.10187586726740117,0.21255071671703712,130544.21864487216,2669.4518033929257,133213.6704482651,156,1,61.48571428571429,33,2,19,35.0540382539873,0.632260101010101,44.51593137254902,1021.9362745098039,30.967765894236482,0
160,4,1,0,34,0.029411764705882353,0.0,1.0,34,1600,1200,400,0.75,20,12,8,361.37623128445637,0.44420306001188353,0.08184173837119246,0.20993998860572655,131014.28086553243,2669.0894127258716,133683.3702782583,157,0,58.794117647058826,33,1,22,34.80717819806879,0.6369949494949495,44.056372549019606,1023.7745098039212,31.023469994058217,0
161,4,0,0,34,0.0,0.0,1.0,34,900,600,300,0.6666666666666666,12,6,6,364.4047538271681,0.4435160427807487,0.07798216786415502,0.21256520148229555,131171.1560006968,2759.878562331786,133931.03456302857,158,1,59.794117647058826,33,1,22,34.57089663835386,0.6385732323232323,43.9031862745098,1024.3872549019602,31.042038027332126,0
162,4,1,0,35,0.02857142857142857,0.0,1.0,35,1200,900,300,0.75,15,9,6,354.8821738227083,0.44390756302521006,0.08010346199761265,0.20885688590549537,131511.22448979577,2334.197845804971,133845.42233560074,159,0,59.05714285714286,34,1,23,34.47123568554626,0.6397058823529411,43.57142857142856,1025.7142857142844,30.168067226890717,0
163,4,0,1,34,0.0,0.02857142857142857,0.9714285714285714,35,950,700,250,0.7368421052631579,12,7,5,355.82489358651287,0.4425770308123249,0.08413342833943704,0.21025129592935746,131663.90483276636,2369.8589852607643,134033.76381802713,160,1,60.05714285714286,34,1,20,34.29295712021034,0.6412377450980392,43.422619047619044,1026.3095238095232,30.18557422969186,0
164,4,0,1,33,0.0,0.029411764705882353,0.9705882352941176,34,1000,800,200,0.8,12,8,4,367.9182304798461,0.44067513368983957,0.08316878298326857,0.21673775561905648,131548.03929077752,2879.7843677912283,134427.82365856876,161,4,62.794117647058826,33,1,23,34.099744156413024,0.6423611111111112,43.53553921568627,1025.8578431372546,31.086601307189532,0
165,4,0,0,33,0.0,0.0,1.0,33,1050,800,250,0.7619047619047619,13,8,5,368.17261551884206,0.43903882575757575,0.05685618729096964,0.21706627726223557,131579.47063629367,3088.7915705497808,134668.26220684344,131,5,60.81818181818182,33,0,20,34.06145484949832,0.6426767676767677,43.50490196078431,1025.9803921568623,31.090314913844313,0
166,4,0,0,33,0.0,0.0,1.0,33,850,500,350,0.5882352941176471,12,5,7,368.321340366297,0.43868371212121215,0.057334751865442124,0.21751219352802334,131642.34459102261,3097.336961745472,134739.68155276807,132,6,61.81818181818182,33,0,20,33.9941087493034,0.6433080808080809,43.44362745098039,1026.2254901960778,31.09774212715387,0
167,4,0,0,33,0.0,0.0,1.0,33,950,700,250,0.7368421052631579,12,7,5,368.9634680039993,0.43828914141414144,0.05706823517495674,0.2184315880897174,131736.6836823577,3121.2047349577074,134857.8884173154,133,7,62.81818181818182,33,0,20,33.882331582507675,0.6442550505050505,43.35171568627451,1026.5931372549016,31.108882947118232,0
168,4,0,0,33,0.0,0.0,1.0,33,650,500,150,0.7692307692307693,8,5,3,366.85162705743966,0.43828914141414144,0.05460187938106342,0.2173608862437927,131768.1375552672,3067.871131295654,134836.00868656285,134,8,63.81818181818182,33,0,20,33.904770430492555,0.6445707070707071,43.32107843137255,1026.7156862745096,31.112596553773017,0
169,4,0,1,32,0.0,0.030303030303030304,0.9696969696969697,33,750,500,250,0.6666666666666666,10,5,5,367.21025740340974,0.4382102272727273,0.050162725103059636,0.21793356636264677,131831.05656478272,3081.943242983463,134912.99980776617,135,9,64.81818181818181,33,0,20,33.832040572792366,0.6452020202020202,43.259803921568626,1026.960784313725,31.12002376708258,0
170,4,0,0,32,0.0,0.0,1.0,32,900,700,200,0.7777777777777778,11,7,4,373.01882441921805,0.4377940188172043,0.05427631578947434,0.22109249855518068,131781.4827568615,3431.3947556371813,135212.87751249867,136,10,66.4375,32,0,20,33.73298901459257,0.6471354166666667,43.30808080808081,1026.7676767676764,32.08648989898989,0
171,4,0,0,32,0.0,0.0,1.0,32,1100,900,200,0.8181818181818182,13,9,4,361.9717512653709,0.43678595430107525,0.045481293359762365,0.2040388251546141,129844.02101826339,2999.9735358636854,132843.99455412707,137,11,67.4375,32,0,20,35.979053105384885,0.6276041666666667,45.2020202020202,1019.1919191919188,31.849747474747463,8
172,4,0,0,32,0.0,0.0,1.0,32,1200,1100,100,0.9166666666666666,13,11,2,363.5328460534056,0.43626092069892475,0.04072907638974854,0.20576417642420156,130004.92814827566,3052.2123061422267,133057.14045441788,138,12,68.4375,32,0,21,35.77571086624572,0.6292317708333333,45.04419191919192,1019.8232323232321,31.869476010101003,0
173,4,0,0,32,0.0,0.0,1.0,32,950,800,150,0.8421052631578947,11,8,3,364.12382976574736,0.4349168346774193,0.036871365829518554,0.2071226541869483,130198.1482278594,3081.649672227323,133279.79790008673,139,13,69.4375,32,0,21,35.564353169202846,0.6311848958333333,44.85479797979798,1020.5808080808081,31.893150252525253,0
174,4,0,0,32,0.0,0.0,1.0,32,800,600,200,0.75,10,6,4,366.5288681030911,0.4342447916666667,0.04679964758253985,0.20918270687012677,130327.04132550243,3153.724588052232,133480.76591355467,140,14,70.4375,32,0,21,35.37209925394666,0.6324869791666667,44.72853535353535,1021.085858585858,31.908933080808062,0
175,4,0,0,32,0.0,0.0,1.0,32,1150,600,550,0.5217391304347826,17,6,11,365.43863202106206,0.43401377688172044,0.04411628338278928,0.2087335915103354,130359.27456382001,3127.662993572082,133486.93755739208,141,15,71.4375,32,0,21,35.36721068249257,0.6328125,44.696969696969695,1021.2121212121211,31.912878787878785,0
176,4,0,1,31,0.0,0.03125,0.96875,32,650,400,250,0.6153846153846154,9,4,5,367.7646746017114,0.43336273521505375,0.04677651093807933,0.21058626908722183,130455.99819214863,3195.4215449953927,133651.41973714402,142,16,72.4375,32,0,21,35.20964652082561,0.6337890625,44.60227272727272,1021.5909090909081,31.924715909090878,0
177,4,0,0,31,0.0,0.0,1.0,31,1000,700,300,0.7,13,7,6,376.70866303137336,0.4298387096774194,0.06051213325824145,0.21592643380622267,130495.30241224504,3631.742180718322,134127.04459296336,143,17,75.06451612903226,31,0,19,34.94129922263286,0.636760752688172,44.563802083333336,1021.744791666667,32.95950940860216,0
178,4,1,0,32,0.03125,0.0,1.0,32,800,500,300,0.625,11,5,6,362.69703994245015,0.4313256048387097,0.05826702442635079,0.21030201758036482,130940.1543847566,3098.3212809917277,134038.47566574832,144,0,73.6875,32,0,21,34.84841475450284,0.638671875,44.128787878787875,1023.484848484848,31.9839015151515,0
179,4,1,1,32,0.030303030303030304,0.030303030303030304,0.9696969696969697,33,950,800,150,0.8421052631578947,11,8,3,377.44994239776344,0.43162089646464646,-0.03985554730388963,0.21402543055306403,130075.00120146088,3219.360342176074,133294.36154363694,145,0,72.42424242424242,33,0,19,35.34959154252762,0.6275252525252526,44.975490196078425,1020.0980392156855,30.91206179441471,8
180,4,1,0,33,0.030303030303030304,0.0,1.0,33,1250,800,450,0.64,17,8,9,373.09642155869983,0.4327256944444444,-0.025537271828073305,0.21310761705979972,130359.27456382003,3127.4509357097218,133486.72549952974,146,0,72.81818181818181,32,1,21,35.17170499505439,0.6328125,44.696969696969695,1021.2121212121212,31.91287878787879,0
181,4,0,0,33,0.0,0.0,1.0,33,950,600,350,0.631578947368421,13,6,7,372.879273806268,0.4326467803030303,-0.019972281529759828,0.21333757603201609,130423.7529971432,3126.462860932567,133550.21585807577,147,1,73.81818181818181,32,1,21,35.111763494025546,0.6334635416666667,44.63383838383839,1021.4646464646469,31.920770202020215,0
182,4,0,1,32,0.0,0.030303030303030304,0.9696969696969697,33,1200,700,500,0.5833333333333334,17,7,10,369.35416354820956,0.4317392676767677,-0.02495757430401868,0.2119782773453898,130544.21864487193,3043.41013672623,133587.62878159815,148,2,74.81818181818181,33,0,17,35.079520925770474,0.632260101010101,44.515931372549005,1021.936274509802,30.967765894236425,0
183,4,0,0,32,0.0,0.0,1.0,32,750,600,150,0.8,9,6,3,370.8260576134012,0.4293724798387097,-0.0042039839407042034,0.21304733402274525,130585.01882779812,3284.8655430568238,133869.88437085494,149,3,77.21875,32,0,17,35.0005147210212,0.6350911458333333,44.4760101010101,1022.0959595959591,31.940498737373723,0
184,4,0,0,32,0.0,0.0,1.0,32,850,600,250,0.7058823529411765,11,6,5,370.61523643582547,0.4284064180107527,0.0026732810764102943,0.21399529795913197,130778.66934815321,3293.7134922456853,134072.3828403989,150,4,78.21875,32,0,17,34.80948854050939,0.6370442708333333,44.28661616161616,1022.8535353535351,31.964172979797972,0
185,4,0,0,32,0.0,0.0,1.0,32,550,400,150,0.7272727272727273,7,4,3,369.38257166815515,0.42863743279569894,0.002291100962725112,0.21346202536771708,130810.95838434855,3263.8576420773406,134074.8160264259,151,5,79.21875,32,0,17,34.80827779149181,0.6373697916666667,44.255050505050505,1022.9797979797981,31.968118686868692,0
186,4,0,1,31,0.0,0.03125,0.96875,32,1050,500,550,0.47619047619047616,16,5,11,369.36938595538413,0.42815440188172044,0.00318012211668961,0.21435058066859694,130972.4633487654,3275.443672839506,134247.90702160491,152,6,80.21875,32,0,18,34.64495703301674,0.6389973958333333,44.09722222222222,1023.611111111111,31.987847222222218,0
187,4,0,0,31,0.0,0.0,1.0,31,600,300,300,0.5,9,3,6,380.2083535665496,0.4245519713261649,0.016547648362472467,0.22038625804078757,130928.03955078124,3755.986870659723,134684.02642144097,153,7,82.74193548387096,31,0,18,34.41263782866837,0.6411290322580645,44.140625,1023.4374999999999,33.0141129032258,0
188,4,0,0,31,0.0,0.0,1.0,31,1000,700,300,0.7,13,7,6,381.11959409713234,0.42473118279569894,0.0170686273705285,0.22129706416481956,130994.67807345925,3784.9277072482696,134779.60578070753,154,8,83.74193548387096,31,0,18,34.32173747138132,0.6418010752688172,44.075520833333336,1023.6979166666671,33.02251344086023,0
189,4,0,0,31,0.0,0.0,1.0,31,950,600,350,0.631578947368421,13,6,7,384.8599273645844,0.4235663082437276,0.03574575829413296,0.21146954571259088,128837.60452270509,3716.886223687066,132554.49074639217,155,9,84.74193548387096,31,0,17,36.42333055448677,0.6199596774193548,46.19140625,1015.2343750000001,32.749495967741936,8
190,4,2,0,33,0.06060606060606061,0.0,1.0,33,800,500,300,0.625,11,5,6,365.1733417375456,0.42905618686868685,0.029547188963986226,0.2029855032203543,129294.84941188473,2843.0064458381266,132137.85585772287,156,0,80.54545454545455,33,0,19,36.456576093505255,0.6196338383838385,45.741421568627445,1017.0343137254893,30.819221628045128,0
191,4,1,2,32,0.029411764705882353,0.058823529411764705,0.9411764705882353,34,950,700,250,0.7368421052631579,12,7,5,359.4370032598207,0.4315396613190731,0.05231850889672396,0.20226307106514171,129776.92920918363,2529.326105442169,132306.2553146258,157,0,79.1470588235294,34,0,17,36.111841336604726,0.6222426470588236,45.26785714285714,1018.928571428571,29.96848739495797,0
192,4,0,0,32,0.0,0.0,1.0,32,950,700,250,0.7368421052631579,12,7,5,377.6456657916397,0.426726310483871,0.058976088574618446,0.21096338960127575,129490.37606175398,3380.2958562901854,132870.67191804416,158,1,85.03125,32,0,17,35.940019848654025,0.6240234375,45.54924242424243,1017.8030303030309,31.806344696969717,0
193,4,0,0,32,0.0,0.0,1.0,32,800,600,200,0.75,10,6,4,374.9441245552546,0.42571824596774194,0.06636314321140735,0.21014067856415083,129618.91842987972,3319.970379298048,132938.88880917776,159,2,86.03125,32,0,17,35.87776400082663,0.6253255208333333,45.42297979797981,1018.3080808080817,31.822127525252554,0
194,4,0,0,32,0.0,0.0,1.0,32,550,300,250,0.5454545454545454,8,3,5,375.54069642570903,0.42588625672043007,0.06762504648568246,0.21082023646946393,129683.21352731875,3340.2648645546515,133023.4783918734,160,3,87.03125,32,0,18,35.797074501053686,0.6259765625,45.35984848484849,1018.5606060606069,31.830018939393966,0
195,4,0,0,32,0.0,0.0,1.0,32,1000,800,200,0.8,12,8,4,377.2753646967355,0.4254242271505377,0.06580271961343098,0.21249054211216697,129811.85154894913,3394.9627270176575,133206.81427596678,161,4,88.03125,32,0,19,35.62187667781771,0.6272786458333333,45.23358585858586,1019.0656565656568,31.845801767676775,0
196,4,1,1,32,0.030303030303030304,0.030303030303030304,0.9696969696969697,33,950,800,150,0.8421052631578947,11,8,3,394.34836554736137,0.4261363636363636,0.14967516241879086,0.2104242878560718,127665.57621671243,3477.7463715436984,131143.32258825612,162,0,86.33333333333333,32,1,18,37.38521364317841,0.60546875,47.34848484848484,1010.6060606060594,31.581439393939355,8
197,4,0,0,32,0.0,0.0,1.0,32,1100,1000,100,0.9090909090909091,12,10,2,402.2503806803624,0.4252772177419355,0.15815907333419288,0.2142114415716493,127584.8409864637,3864.2101711697014,131449.0511576334,163,1,88.84375,31,1,18,37.26868260514671,0.6071908602150538,47.428385416666664,1010.2864583333329,32.58988575268816,0
198,4,0,0,32,0.0,0.0,1.0,32,650,300,350,0.46153846153846156,10,3,7,406.8057938228549,0.42536122311827956,0.10996359223300978,0.21076960142733417,126469.13528442373,3889.675394693996,130358.81067911773,164,2,89.84375,31,1,15,38.30542071197411,0.595766129032258,48.53515624999999,1005.8593749999992,32.4470766129032,8
199,4,4,2,34,0.1111111111111111,0.05555555555555555,0.9444444444444444,36,800,700,100,0.875,9,7,2,373.4147338691803,0.4378472222222222,0.10360713148678813,0.19829845118737643,127471.58893014818,2319.953891246556,129791.54282139473,165,0,80.75,35,1,13,38.11329990448903,0.5967261904761905,47.54050925925925,1009.8379629629618,28.852513227513196,0
200,4,2,0,36,0.05555555555555555,0.0,1.0,36,700,600,100,0.8571428571428571,8,6,2,375.59783186311006,0.4360119047619047,0.12250859106529255,0.20018126203693207,127617.73003472212,2386.588541666656,130004.31857638877,166,0,81.69444444444444,35,1,15,37.90807560137457,0.5982142857142857,47.39583333333333,1010.4166666666657,28.869047619047592,0
201,4,0,0,36,0.0,0.0,1.0,36,750,400,350,0.5333333333333333,11,4,7,397.84952750279206,0.43604497354497357,0.12565280028813297,0.19864879876122027,124942.13632758886,2741.6339806241067,127683.77030821296,167,1,82.69444444444444,35,1,16,40.1139345527514,0.5708333333333333,50.05787037037035,999.768518518516,28.564814814814742,8
202,4,2,2,36,0.05263157894736842,0.05263157894736842,0.9473684210526316,38,1000,800,200,0.8,12,8,4,378.59942676632636,0.44061166429587484,0.12615069041424842,0.19148394084527617,125476.64399092938,1901.1172852628308,127377.76127619222,168,0,79.28947368421052,34,4,16,40.04079531051963,0.5784313725490196,49.523809523809504,1001.9047619047593,29.467787114845862,0
203,4,2,0,38,0.05263157894736842,0.0,1.0,38,1250,1000,250,0.8,15,10,5,378.23527743178806,0.44013750592697964,0.13341624067292468,0.19212892077988633,125655.61933106561,1905.4776077097363,127561.09693877534,169,0,80.15789473684211,34,4,18,39.86459075437347,0.5802696078431373,49.34523809523809,1002.6190476190463,29.488795518207244,0
204,4,2,0,40,0.05,0.0,1.0,40,850,600,250,0.7058823529411765,11,6,5,365.8299551665818,0.44298878205128206,0.15251295336787596,0.18878390734532163,126305.47417534718,1241.8639721513575,127547.33814749854,170,0,77.1,35,5,15,39.50453367875649,0.5848214285714286,48.697916666666664,1005.2083333333329,28.720238095238084,0
205,4,1,1,40,0.024390243902439025,0.024390243902439025,0.975609756097561,41,1200,800,400,0.6666666666666666,16,8,8,359.65371930193345,0.4450457317073171,0.16043542314617798,0.18737204257338486,126694.89590942286,913.2581060790446,127608.1540155019,171,0,76.1951219512195,36,5,16,39.25871551081281,0.5868055555555556,48.31081081081081,1006.7567567567562,27.96546546546545,0
206,4,2,1,41,0.047619047619047616,0.023809523809523808,0.9761904761904762,42,1200,600,600,0.5,18,6,12,348.7840284823222,0.4504573170731707,0.1585290662754668,0.18413412558474496,127233.99233270418,476.0582795633323,127710.05061226751,172,0,74.04761904761905,36,6,19,38.97872716449009,0.5923032407407407,47.77590090090089,1008.8963963963952,28.024899899899864,0
207,4,2,3,40,0.046511627906976744,0.06976744186046512,0.9302325581395349,43,1000,400,600,0.4,16,4,12,338.47050634859824,0.4523809523809524,0.1593328655584776,0.18026978297664642,127590.03371229602,37.092663127104345,127627.12637542312,173,0,73.20930232558139,37,6,16,38.874267419144786,0.5940315315315315,47.42324561403508,1010.307017543859,27.305595068752947,0
208,4,3,2,41,0.06976744186046512,0.046511627906976744,0.9534883720930233,43,1000,600,400,0.6,14,6,8,340.36220044841036,0.4492201919527501,0.16435924205514607,0.18227759654676204,127811.68845221614,100.45350492459647,127912.14195714073,174,0,74.0,37,6,18,38.5997252945854,0.5962837837837838,47.203947368421055,1011.1842105263163,27.32930298719774,0
209,4,2,1,42,0.046511627906976744,0.023255813953488372,0.9767441860465116,43,1200,900,300,0.75,15,9,6,337.855001778184,0.4494278331487634,0.17092544741123517,0.18244170096021953,128144.53125000015,58.85416666668121,128203.38541666683,175,0,74.25581395348837,37,6,20,38.32304526748972,0.5996621621621622,46.87500000000001,1012.5000000000011,27.364864864864895,0
210,4,1,1,42,0.023255813953488372,0.023255813953488372,0.9767441860465116,43,800,500,300,0.625,11,5,6,335.339627587828,0.45104282022886677,0.16507324537010226,0.18196556068932007,128338.88942992085,7.423077293026495,128346.31250721388,176,0,75.09302325581395,37,6,22,38.188395014969515,0.6016328828828829,46.683114035087726,1013.26754385965,27.385609293504054,0
211,4,1,1,42,0.023255813953488372,0.023255813953488372,0.9767441860465116,43,1050,800,250,0.7619047619047619,13,8,5,334.443524308725,0.45191952750092285,0.16422232789615787,0.181732010298974,128394.44739006246,-11.861702639255753,128382.5856874232,177,0,75.93023255813954,37,6,13,38.1544366908291,0.6021959459459459,46.62828947368422,1013.4868421052643,27.39153627311525,0
212,4,0,1,41,0.0,0.023809523809523808,0.9761904761904762,42,1250,1000,250,0.8,15,10,5,342.53949513689776,0.4497677119628339,0.17104720676149232,0.18574324736296585,128311.11495844883,390.3249076639079,128701.43986611273,178,2,78.73809523809524,37,5,22,38.03436147186149,0.6013513513513513,46.71052631578948,1013.1578947368428,27.382645803698452,0
213,4,0,1,40,0.0,0.024390243902439025,0.975609756097561,41,1150,900,250,0.782608695652174,14,9,5,346.5458250444861,0.44951727642276423,0.169384973485331,0.18847486230969307,128429.74044568223,701.3580725996342,129131.09851828185,179,3,79.29268292682927,36,5,14,37.811770914342866,0.6044560185185186,46.59346846846847,1013.6261261261266,28.156281281281295,0
214,4,1,1,40,0.024390243902439025,0.024390243902439025,0.975609756097561,41,1050,600,450,0.5714285714285714,15,6,9,378.24043547061706,0.44679878048780486,0.18434029564282373,0.19437227737521728,126133.51048752846,1357.055967474662,127490.56645500312,180,0,80.1951219512195,34,7,18,39.37025954017541,0.585171568627451,48.86904761904763,1004.5238095238104,29.544817927170897,7
215,4,3,2,41,0.06976744186046512,0.046511627906976744,0.9534883720930233,43,1500,1300,200,0.8666666666666667,17,13,4,356.1102479759444,0.44709763750461423,0.2010019213195593,0.18620289403272636,126843.3691736881,434.0447301092702,127277.41390379737,181,0,77.27906976744185,37,6,19,39.19521697325932,0.5864301801801801,48.16337719298246,1007.3464912280706,27.225580844001907,0
216,4,2,2,41,0.046511627906976744,0.046511627906976744,0.9534883720930233,43,1050,700,350,0.6666666666666666,14,7,7,361.5683260188407,0.4452057954964932,0.2372433164908352,0.19134683320772367,127332.20663265321,608.5889530962603,127940.79558574947,182,0,77.86046511627907,34,9,17,38.55542777384603,0.5974264705882353,47.67857142857144,1009.2857142857155,29.684873949579867,0
217,4,1,0,42,0.023809523809523808,0.0,1.0,42,1000,600,400,0.6,14,6,8,358.15916958381604,0.4469125048393341,0.23423688862698877,0.1905316961704503,127542.56129535167,736.1075680272377,128278.6688633789,183,0,78.30952380952381,34,8,18,38.42565311333728,0.5995710784313726,47.47023809523811,1010.1190476190492,29.709383753501445,0
218,4,0,1,41,0.0,0.023809523809523808,0.9761904761904762,42,1550,1200,350,0.7741935483870968,19,12,7,358.34894925119085,0.44725125822686795,0.23601947847942162,0.19105941465101195,127632.7664399095,747.4135487528596,128380.17998866235,184,1,79.30952380952381,34,8,20,38.328375353440165,0.6004901960784313,47.380952380952394,1010.4761904761922,29.719887955182124,0
219,4,0,0,41,0.0,0.0,1.0,41,850,500,350,0.5882352941176471,12,5,7,368.0306089913911,0.4450457317073171,0.23635906462157386,0.1961481817151922,127617.73003472235,1193.4461805555734,128811.17621527793,185,2,82.17073170731707,33,8,21,38.09922680412372,0.6025883838383839,47.39583333333334,1010.4166666666678,30.6186868686869,0
220,4,1,1,41,0.023809523809523808,0.023809523809523808,0.9761904761904762,42,1050,600,450,0.5714285714285714,15,6,9,360.7302038173689,0.4454365079365079,0.24379484766498072,0.1942094656524037,128024.0238803856,836.4264455782472,128860.45032596386,186,0,81.19047619047619,34,8,22,37.86735874210877,0.6044730392156863,46.99404761904763,1012.0238095238104,29.765406162465013,0
221,4,1,0,42,0.023809523809523808,0.0,1.0,42,1300,900,400,0.6923076923076923,17,9,8,369.4207938417263,0.44668263646922185,0.23418586602726665,0.19346355203609372,126906.72607891177,1055.255116752557,127961.98119566432,187,0,79.80952380952381,33,9,20,38.79479850806777,0.5953282828282829,48.10049019607842,1007.5980392156848,30.53327391562681,7
222,4,3,2,43,0.06666666666666667,0.044444444444444446,0.9555555555555556,45,850,500,350,0.5882352941176471,12,5,7,345.7823935998864,0.449810606060606,0.24128582691182832,0.18536481934207394,127851.72994898826,-158.0893941106541,127693.64055487761,188,0,75.42222222222222,35,10,18,38.421740291447314,0.6005952380952381,47.16435185185185,1011.3425925925919,28.895502645502628,0
223,4,2,1,44,0.044444444444444446,0.022222222222222223,0.9777777777777777,45,1400,700,700,0.5,21,7,14,336.3459790512466,0.45134680134680133,0.2585526315789475,0.1825878171992481,128355.5555555555,-365.2901020233243,127990.26545353218,189,0,76.08888888888889,34,11,20,38.1459018640351,0.607843137254902,46.666666666666664,1013.3333333333329,29.803921568627437,0
224,4,1,3,42,0.022222222222222223,0.06666666666666667,0.9333333333333333,45,1550,1100,450,0.7096774193548387,20,11,9,362.91527745476674,0.45143097643097646,0.2965511967576666,0.19175123568791852,127267.13204089504,237.43730709877002,127504.5693479938,190,0,76.71111111111111,35,10,17,38.58826565726085,0.5946428571428571,47.74305555555556,1009.0277777777776,28.829365079365076,8
225,4,0,0,42,0.0,0.0,1.0,42,1250,800,450,0.64,17,8,9,385.34701940390454,0.4475295199380565,0.31273998227823174,0.20185506323287578,126917.01630015444,1381.418788580264,128298.43508873471,191,1,83.02380952380952,35,7,18,38.38301171605791,0.5910714285714286,48.090277777777786,1007.6388888888898,28.789682539682566,0
226,4,2,1,43,0.045454545454545456,0.022727272727272728,0.9772727272727273,44,1000,600,400,0.6,14,6,8,370.4659876228732,0.45077959830866804,0.31299765306013105,0.19678540845365258,127482.44224773234,645.9434641912198,128128.38571192356,192,0,80.20454545454545,34,10,16,38.17659829462846,0.5989583333333333,47.5297619047619,1009.8809523809516,29.70238095238093,0
227,4,0,0,43,0.0,0.0,1.0,43,1150,700,450,0.6086956521739131,16,7,9,378.9974999916931,0.4480204872646733,0.31368613288801517,0.20101799858846453,127422.33737244889,1058.5494614512352,128480.88683390012,193,1,83.06976744186046,34,9,16,38.02298274574538,0.5983455882352942,47.58928571428571,1009.6428571428564,29.695378151260485,0
228,4,2,0,45,0.044444444444444446,0.0,1.0,45,1500,800,700,0.5333333333333333,22,8,14,366.06685713083766,0.4537878787878788,0.30939068100358447,0.19753547692714457,128116.0277676324,379.80632659685665,128495.83409422926,194,0,80.33333333333333,36,9,18,37.638116425658126,0.6012731481481481,46.90315315315315,1012.3873873873866,28.12187187187185,0
229,4,3,3,45,0.0625,0.0625,0.9375,48,1250,800,450,0.64,17,8,9,346.4886097600688,0.45641252955082745,0.3040070679434568,0.19043847649218798,128848.62075617272,-671.0809345381538,128177.53982163456,195,0,76.25,38,10,17,37.38600091199271,0.6049890350877193,46.18055555555555,1015.2777777777768,26.717836257309916,0
230,4,0,1,44,0.0,0.022222222222222223,0.9777777777777777,45,1100,900,200,0.8181818181818182,13,9,4,356.7726161706664,0.45462962962962966,0.302920860469706,0.19501260476124785,128629.57552146744,178.3020351432553,128807.87755661069,196,1,80.64444444444445,36,9,17,37.34851428359975,0.6064814814814814,46.3963963963964,1014.4144144144146,28.178178178178186,0
231,4,2,2,44,0.043478260869565216,0.043478260869565216,0.9565217391304348,46,1200,900,300,0.75,15,9,6,352.02252644377575,0.45667270531400966,0.3209366517077805,0.1949442559130433,129147.08547921688,-107.46333735115786,129039.62214186572,197,0,79.5,38,8,19,36.94139338518674,0.6080043859649122,45.886752136752136,1016.4529914529915,26.74876293297346,0
232,4,1,1,44,0.022222222222222223,0.022222222222222223,0.9777777777777777,45,1200,800,400,0.6666666666666666,16,8,8,349.37776708595754,0.458270202020202,0.3073618952728885,0.19445036168129762,129344.54038075257,38.04416914584775,129382.58454989843,198,0,77.95555555555555,36,9,20,36.80763127790693,0.6137152777777778,45.69256756756758,1017.2297297297314,28.256381381381427,0
233,4,1,1,44,0.022222222222222223,0.022222222222222223,0.9777777777777777,45,1300,800,500,0.6153846153846154,18,8,10,345.8412134402001,0.45816498316498316,0.29663534180947115,0.19417341871921873,129688.42734203818,-29.67938377564576,129658.74795826254,199,0,76.6,36,9,18,36.54804680302194,0.6171875,45.35472972972974,1018.5810810810826,28.293918918918962,0
234,4,1,1,44,0.022222222222222223,0.022222222222222223,0.9777777777777777,45,1450,1100,350,0.7586206896551724,18,11,7,328.07917686275493,0.45728114478114473,0.26641326153521305,0.17644735287150212,127982.3229988494,-592.0323334889382,127390.29066536046,200,0,77.55555555555556,38,7,18,38.736009925034324,0.596217105263158,47.03525641025641,1011.858974358974,26.62786774628879,8
235,4,0,1,43,0.0,0.022727272727272728,0.9772727272727273,44,850,600,250,0.7058823529411765,11,6,5,334.8404673572335,0.4568247885835095,0.27921268608924454,0.17994018592342395,127950.32035097323,-231.41098703448665,127718.90936393874,201,1,80.29545454545455,37,7,18,38.59766175354938,0.5976914414414414,47.066885964912274,1011.7324561403497,27.344120436225666,0
236,4,3,1,45,0.06521739130434782,0.021739130434782608,0.9782608695652174,46,1700,1400,300,0.8235294117647058,20,14,6,307.9522422126321,0.4594605475040258,0.20872699592531263,0.16520531888865503,127880.99500868045,-1303.0456787184576,126577.949329962,202,0,74.71739130434783,43,3,18,39.34839512530038,0.5874515503875969,47.135416666666664,1011.4583333333325,23.522286821705407,8
237,4,1,0,46,0.021739130434782608,0.0,1.0,46,850,500,350,0.5882352941176471,12,5,7,311.159525904162,0.45952093397745575,0.2322209253618439,0.167925617942524,128120.5622004851,-1226.81332142446,126893.74887906064,203,0,75.54347826086956,43,3,19,39.02318538958003,0.5898740310077519,46.89867424242425,1012.4053030303041,23.54430937279777,0
238,4,0,3,43,0.0,0.06521739130434782,0.9347826086956522,46,900,500,400,0.5555555555555556,13,5,8,320.61261914803595,0.4590780998389694,0.13953541829489002,0.16836613210484722,127018.7444132716,-1050.6954876638447,125968.04892560776,204,1,76.54347826086956,42,4,16,39.90956134448396,0.580109126984127,47.98934108527133,1008.0426356589161,24.001015134736097,8
239,4,3,2,44,0.06521739130434782,0.043478260869565216,0.9565217391304348,46,1600,1200,400,0.75,20,12,8,317.69605444276954,0.45880636070853464,0.18771403454293378,0.16915996128631888,127579.22620670572,-1093.6743884846437,126485.55181822108,205,0,77.26086956521739,40,6,17,39.410019112765326,0.5888020833333334,47.4339430894309,1010.2642276422769,25.256605691056922,0
240,4,1,3,42,0.022222222222222223,0.06666666666666667,0.9333333333333333,45,1250,800,450,0.64,17,8,9,309.87886217124515,0.4572390572390572,0.14023208071226967,0.15879918805241386,126018.93310854444,-1072.6272302131115,124946.30587833133,206,0,78.97777777777777,41,4,18,41.20465286697624,0.5713922764227642,48.983134920634924,1004.0674603174612,24.489450251645394,7
241,4,1,2,41,0.023255813953488372,0.046511627906976744,0.9534883720930233,43,1250,900,350,0.72,16,9,7,314.30319394046643,0.45415743816906606,0.1551962736692878,0.16178060879134157,126200.78667534728,-666.935473552842,125533.85120179443,207,0,81.46511627906976,39,4,19,40.906852581380896,0.5763888888888888,48.802083333333336,1004.7916666666672,25.763888888888903,0
242,4,4,1,44,0.08888888888888889,0.022222222222222223,0.9777777777777777,45,1350,1000,350,0.7407407407407407,17,10,7,314.7542244580232,0.457807239057239,0.2078235624863738,0.16590991591872828,127170.80213758672,-988.218858506948,126182.58327907977,208,0,78.6,39,6,18,39.90165324107544,0.5862713675213675,47.838541666666664,1008.6458333333327,25.86271367521366,0
243,4,4,3,45,0.08333333333333333,0.0625,0.9375,48,1050,800,250,0.7619047619047619,13,8,5,299.55446925324026,0.46176861702127664,0.22828065134099562,0.16087184459896248,127923.87777176859,-1935.96613785229,125987.9116339163,209,0,74.60416666666667,42,6,13,39.51708173690931,0.5892857142857143,47.093023255813954,1011.6279069767447,24.08637873754154,0
244,4,1,0,46,0.021739130434782608,0.0,1.0,46,1050,600,450,0.5714285714285714,15,6,9,311.2093000411225,0.4585547504025765,0.23185134616205128,0.16638104760855396,127743.06047650533,-1249.0343127992028,126494.02616370612,210,0,78.78260869565217,41,5,14,39.40668956493293,0.5889227642276422,47.27182539682539,1010.9126984126978,24.656407278358483,0
245,4,1,3,44,0.02127659574468085,0.06382978723404255,0.9361702127659575,47,1300,1000,300,0.7692307692307693,16,10,6,309.4040542600214,0.4582562442183164,0.2446370720602402,0.16707818930041166,128144.53125000012,-1468.4228552531983,126676.10839474692,211,0,78.08510638297872,39,8,17,39.04320987654322,0.5961538461538461,46.87500000000001,1012.5000000000009,25.961538461538485,0
246,4,1,0,45,0.022222222222222223,0.0,1.0,45,1600,1100,500,0.6875,21,11,10,315.6353026818031,0.4563131313131313,0.2524355921195065,0.17091670141702808,128255.57503270255,-903.6025507848334,127351.9724819177,212,0,80.93333333333334,37,8,20,38.77237136465327,0.6007882882882882,46.76535087719299,1012.9385964912294,27.37671882408728,0
247,4,0,1,44,0.0,0.022222222222222223,0.9777777777777777,45,1250,900,350,0.72,16,9,7,336.82055289723905,0.45589225589225585,0.22963277836816665,0.17395616919665294,126339.03704616835,-458.11970301792365,125880.91734315043,213,1,81.93333333333334,38,7,14,40.199034714842334,0.5794956140350878,48.66452991452991,1005.3418803418795,26.456365272154724,8
248,4,1,3,42,0.022222222222222223,0.06666666666666667,0.9333333333333333,45,1800,1400,400,0.7777777777777778,22,14,8,332.0575874875082,0.4586069023569024,0.21783299706205161,0.1722857466319484,126527.07151955945,-597.1451758711374,125929.92634368832,214,0,78.6,38,7,15,40.12557077625571,0.5814144736842105,48.4775641025641,1006.0897435897432,26.47604588394061,0
249,4,2,0,44,0.045454545454545456,0.0,1.0,44,1450,1100,350,0.7586206896551724,18,11,7,331.1691530561655,0.46072278012684986,0.23963765531467796,0.17341789464034946,126903.55994091959,-394.6911069106751,126508.86883400891,215,0,79.6590909090909,38,6,18,39.761601809634875,0.5852521929824561,48.10363247863247,1007.5854700854691,26.515407107512345,0
250,4,2,3,43,0.043478260869565216,0.06521739130434782,0.9347826086956522,46,1100,800,300,0.7272727272727273,14,8,6,322.2570479816976,0.46282206119162644,0.23873007399771762,0.17066617653201055,127361.4763678862,-991.093670100129,126370.38269778606,216,0,77.15217391304348,38,8,12,39.5174022720858,0.5899122807017544,47.649572649572626,1009.401709401706,26.56320287899226,0
251,4,2,1,44,0.044444444444444446,0.022222222222222223,0.9777777777777777,45,1200,900,300,0.75,15,9,6,328.27887357484497,0.46069023569023565,0.24603209072264476,0.17436265430359374,127479.27847991661,-630.2492112958191,126849.0292686208,217,0,79.66666666666667,37,8,17,39.244933043792955,0.5929054054054055,47.53289473684209,1009.8684210526292,27.29374110953052,0
252,4,1,0,45,0.022222222222222223,0.0,1.0,45,1450,1000,450,0.6896551724137931,19,10,9,329.7080666586162,0.46188973063973066,0.25293040293040314,0.17649078862314158,127793.20987654317,-573.1095679012367,127220.10030864194,218,0,80.04444444444445,38,7,18,38.887934981684985,0.5942982456140351,47.22222222222222,1011.1111111111109,26.608187134502916,0
253,4,1,2,44,0.021739130434782608,0.043478260869565216,0.9565217391304348,46,1050,700,350,0.6666666666666666,14,7,7,322.8702674381519,0.46224838969404186,0.25069004236435033,0.17423520984072202,128118.16541883693,-926.8907335069355,127191.27468532999,219,0,79.28260869565217,39,7,20,38.72922883012655,0.5958867521367521,46.90104166666667,1012.3958333333344,25.958867521367548,0
254,4,1,1,44,0.022222222222222223,0.022222222222222223,0.9777777777777777,45,1250,900,350,0.72,16,9,7,333.66557481597613,0.4604377104377104,0.26845531468099537,0.1806936692034742,128258.5768834714,-440.9002184722647,127817.67666499913,220,0,81.6,36,9,21,38.312720029646115,0.6027199074074074,46.76238738738739,1012.9504504504511,28.13751251251253,0
255,4,2,1,45,0.043478260869565216,0.021739130434782608,0.9782608695652174,46,1200,800,400,0.6666666666666666,16,8,8,327.94489089562967,0.46312399355877615,0.2758416511588564,0.1793230573620781,128644.60699445965,-762.3316789781684,127882.27531548149,221,0,80.56521739130434,37,9,18,38.064292405245695,0.6047297297297297,46.38157894736841,1014.4736842105249,27.418207681365537,0
256,4,0,2,43,0.0,0.044444444444444446,0.9555555555555556,45,1050,700,350,0.6666666666666666,14,7,7,327.17212771980746,0.46262626262626266,0.2751647401966082,0.17952770517500038,128783.68975309702,-573.1132415743419,128210.57651152267,222,1,82.64444444444445,37,8,18,37.942345432285485,0.6061373873873874,46.244517543859644,1015.0219298245606,27.43302513039353,0
257,4,0,2,41,0.0,0.046511627906976744,0.9534883720930233,43,1150,800,350,0.6956521739130435,15,8,7,373.51045690519766,0.46232465854558874,0.2959956128385097,0.19208133734448307,126163.40880102056,924.4698304933868,127087.87863151394,223,2,85.65116279069767,34,9,18,39.45817039933641,0.5854779411764706,48.83928571428572,1004.6428571428584,29.54831932773113,8
258,4,3,1,43,0.06818181818181818,0.022727272727272728,0.9772727272727273,44,1300,900,400,0.6923076923076923,17,9,8,397.97477053234707,0.46059064482029594,0.3576920647952264,0.19857354668329733,124913.20951485317,1207.9940584451124,126121.20357329828,224,0,84.4090909090909,35,9,17,40.14089093435219,0.5705357142857144,50.08680555555554,999.6527777777759,28.561507936507883,8
259,4,3,1,45,0.06521739130434782,0.021739130434782608,0.9782608695652174,46,1450,1200,250,0.8275862068965517,17,12,5,375.2125672406578,0.46604267310789055,0.3409779135991109,0.19127285593864155,125802.56615713346,240.54076265614827,126043.10691978961,225,0,78.71739130434783,38,8,19,39.78833865814696,0.5740131578947368,49.19871794871795,1003.2051282051282,26.400134952766532,0
260,4,0,4,41,0.0,0.08888888888888889,0.9111111111111111,45,1200,800,400,0.6666666666666666,16,8,8,372.01679506597986,0.4644991582491582,0.2623316302833254,0.1824492391291697,124191.12761488341,292.57720868742774,124483.70482357085,226,1,81.28888888888889,35,10,13,41.53990555813593,0.5630952380952381,50.81018518518518,996.7592592592594,28.47883597883598,8
261,4,4,2,43,0.08888888888888889,0.044444444444444446,0.9555555555555556,45,1700,1400,300,0.8235294117647058,20,14,6,358.726114949884,0.46757154882154883,0.28898660289542,0.17961246149460597,125057.87706832998,-27.694723079553114,125030.18234525043,227,0,80.31111111111112,35,10,19,40.97190079456916,0.5720238095238095,49.94212962962963,1000.2314814814821,28.578042328042347,0
262,4,8,6,45,0.1568627450980392,0.11764705882352941,0.8823529411764706,51,1000,500,500,0.5,15,5,10,320.75719869418174,0.4734313725490196,0.3066838076045535,0.16812443882020112,126942.00857426303,-2052.6159660108897,124889.39260825215,228,0,68.80392156862744,41,10,18,39.98449497932663,0.5807926829268293,48.06547619047619,1007.7380952380953,24.57897793263647,0
263,4,2,0,47,0.0425531914893617,0.0,1.0,47,1200,1000,200,0.8333333333333334,14,10,4,346.021052075745,0.471804656182547,0.3304479258912385,0.17982906092588838,126594.96792282244,-639.0952023699567,125955.87272045249,229,0,75.48936170212765,37,10,20,39.70454710539696,0.5838963963963963,48.41008771929825,1006.3596491228072,27.198909435751546,0
264,4,4,2,49,0.0784313725490196,0.0392156862745098,0.9607843137254902,51,1400,1200,200,0.8571428571428571,16,12,4,334.039706375825,0.4725490196078432,0.3642012900659948,0.17904982222840096,127847.22792935937,-1655.8683322805568,126191.35959707882,230,0,70.49019607843137,38,13,15,38.72323755194027,0.5948464912280702,47.16880341880342,1011.3247863247866,26.613810166441752,0
265,4,0,4,45,0.0,0.08163265306122448,0.9183673469387755,49,1400,800,600,0.5714285714285714,20,8,12,342.50577558975783,0.47084041950113376,0.3608095950083172,0.18272770058113483,127658.21468195273,-1055.2648339907898,126602.94984796194,231,1,74.26530612244898,38,11,16,38.702558409979915,0.5929276315789473,47.35576923076923,1010.5769230769235,26.594129554655883,0
266,4,3,2,46,0.0625,0.041666666666666664,0.9583333333333334,48,1050,700,350,0.6666666666666666,14,7,7,341.8635069374342,0.46946106678487,0.3508509234828494,0.18435724121981753,128090.45041867575,-842.1098829351818,127248.34053574057,232,0,71.95833333333333,38,10,20,38.276824978012314,0.5973135964912281,46.928418803418815,1012.2863247863263,26.63911381016648,0
267,4,1,1,46,0.02127659574468085,0.02127659574468085,0.9787234042553191,47,1250,900,350,0.72,16,9,7,350.76140941667444,0.4668902251002158,0.35317351498210603,0.18927995868756037,128116.77781865586,-412.3156884810584,127704.4621301748,233,0,74.29787234042553,37,10,21,38.02472562186361,0.5993806306306306,46.90241228070176,1012.3903508771939,27.361901375059293,0
268,4,1,0,47,0.02127659574468085,0.0,1.0,47,1250,1000,250,0.8,15,10,5,348.97429555929125,0.466177150786309,0.35417558053599896,0.1889989501692399,128261.74554183817,-447.98352900132534,127813.76201283684,234,0,75.14893617021276,35,12,22,37.92180834856794,0.6047619047619048,46.75925925925926,1012.9629629629633,28.94179894179895,0
269,4,0,2,45,0.0,0.0425531914893617,0.9574468085106383,47,1200,900,300,0.75,15,9,6,349.24942174270603,0.46546407647240207,0.3524005606942011,0.18994525952302727,128429.74044568239,-429.197482955906,128000.54296272648,235,1,76.14893617021276,36,11,15,37.74326000814725,0.6044560185185186,46.59346846846848,1013.6261261261278,28.156281281281327,0
270,4,3,4,44,0.0625,0.08333333333333333,0.9166666666666666,48,1150,700,450,0.6086956521739131,16,7,9,329.22016660042846,0.46624741430260047,0.3320944526160958,0.18281899333155677,129255.70371283534,-1086.971916226265,128168.73179660908,236,0,72.1875,38,10,19,37.41047664075087,0.6091008771929824,45.77991452991454,1016.8803418803436,26.76000899685115,0
271,4,0,1,43,0.0,0.022727272727272728,0.9772727272727273,44,1300,1000,300,0.7692307692307693,16,10,6,358.0147489764684,0.46399312896405914,0.3519227179391451,0.19590245252982036,128672.41753472228,413.3246527777904,129085.74218750007,237,1,79.36363636363636,35,9,20,37.273271731690635,0.6089285714285715,46.35416666666667,1014.5833333333338,28.98809523809525,0
272,4,2,0,45,0.044444444444444446,0.0,1.0,45,1400,1000,400,0.7142857142857143,18,10,8,350.4855612649479,0.46279461279461276,0.3509730283373165,0.19479548556831738,129289.65627411267,63.91661844136033,129353.57289255403,238,0,78.0,35,10,22,36.83531068624104,0.6151785714285714,45.74652777777778,1017.013888888889,29.057539682539687,0
273,4,0,1,44,0.0,0.022222222222222223,0.9777777777777777,45,900,700,200,0.7777777777777778,11,7,4,352.62108234938626,0.4623106060606061,0.3492966291282751,0.19656892421898883,129407.39300679434,126.35499721363578,129533.74800400798,239,1,79.0,35,10,22,36.66119231790087,0.6163690476190475,45.63078703703703,1017.4768518518513,29.07076719576718,0
274,4,2,2,44,0.043478260869565216,0.043478260869565216,0.9565217391304348,46,1300,1100,200,0.8461538461538461,15,11,4,334.3149180197695,0.4647846215780998,0.3248982045746458,0.1892864891706238,130017.30974687697,-506.6547501643754,129510.65499671259,240,0,73.67391304347827,38,8,19,36.508092394720315,0.6167763157894737,45.03205128205128,1019.8717948717941,26.838731443994583,0
275,4,1,2,43,0.022222222222222223,0.044444444444444446,0.9555555555555556,45,1250,800,450,0.64,17,8,9,344.5263087077408,0.46494107744107743,0.3236300674667152,0.19559593059948274,130122.70752779684,-33.860779278255905,130088.84674851858,241,0,75.08888888888889,37,8,21,36.14085169263837,0.6196509009009009,44.92872807017543,1020.2850877192968,27.575272641062078,0
276,4,1,1,43,0.022727272727272728,0.022727272727272728,0.9772727272727273,44,1750,1300,450,0.7428571428571429,22,13,9,351.8336405965906,0.46256166314305847,0.3268929517370738,0.2006156783259554,130292.12648158887,368.3057835311181,130660.43226511999,242,0,77.54545454545455,35,9,22,35.7826257416015,0.625297619047619,44.762731481481495,1020.9490740740758,29.169973544973594,0
277,4,1,0,44,0.022727272727272728,0.0,1.0,44,950,500,450,0.5263157894736842,14,5,9,351.09326424631,0.4632223396758281,0.31841357147271454,0.20095649482736305,130439.87509645088,359.3123070987981,130799.18740354967,243,0,77.81818181818181,35,9,23,35.651767505098576,0.6267857142857143,44.61805555555557,1021.5277777777799,29.186507936507997,0
278,4,0,1,43,0.0,0.022727272727272728,0.9772727272727273,44,1150,700,450,0.6086956521739131,16,7,9,352.5935622311426,0.4632443622269204,0.3232174486139143,0.20212311476470987,130498.99798525398,402.6213134430984,130901.61929869709,244,1,78.81818181818181,35,9,19,35.553541761063286,0.6273809523809524,44.5601851851852,1021.759259259261,29.193121693121743,0
279,4,0,0,43,0.0,0.0,1.0,43,1250,800,450,0.64,17,8,9,359.7445468497912,0.46239387227759315,0.32118634689263703,0.2059082600840637,130439.8750964508,785.006751543227,131224.88184799402,245,2,81.18604651162791,35,8,23,35.43082936777701,0.6267857142857143,44.618055555555564,1021.5277777777793,29.18650793650798,0
280,4,0,0,43,0.0,0.0,1.0,43,1050,1000,50,0.9523809523809523,11,10,1,358.75860714001715,0.4619093761535622,0.314779068450727,0.20612864408936202,130587.70743580685,769.8928058556312,131357.60024166247,246,3,82.18604651162791,35,8,19,35.30614218850262,0.6282738095238095,44.47337962962963,1022.1064814814822,29.203042328042347,0
281,4,1,1,43,0.022727272727272728,0.022727272727272728,0.9772727272727273,44,1400,1000,400,0.7142857142857143,18,10,8,350.1922002806417,0.46116323114869623,0.31474359615519254,0.20312041533827419,130953.25213304537,371.76149967537384,131325.01363272074,247,0,81.29545454545455,36,8,20,35.15513257784135,0.6299189814814814,44.115990990991,1023.5360360360374,28.431556556556597,0
282,4,0,2,41,0.0,0.046511627906976744,0.9534883720930233,43,1350,800,550,0.5925925925925926,19,8,11,349.3243543429095,0.4597176079734219,0.29969443982765864,0.2035301090806383,131126.2038009294,561.1152960392884,131687.31909696868,248,1,80.4186046511628,36,7,20,35.00251969946857,0.6316550925925926,43.947072072072075,1024.2117117117123,28.45032532532534,0
283,4,1,0,42,0.023809523809523808,0.0,1.0,42,1050,600,450,0.5714285714285714,15,6,9,356.9135305946566,0.45663956639566394,0.3095238095238093,0.20808199906210229,131150.233892747,961.8586033950696,132112.09249614205,249,0,82.95238095238095,35,7,21,34.78389830508473,0.6339285714285714,43.923611111111114,1024.305555555556,29.26587301587303,0
284,4,0,0,42,0.0,0.0,1.0,42,1300,900,400,0.6923076923076923,17,9,8,351.9730319254412,0.45561120789779325,0.30642663569492856,0.20615563298490136,131328.12500000012,844.7916666666822,132172.9166666668,250,1,83.95238095238095,35,7,21,34.730691056910565,0.6357142857142857,43.75000000000001,1025.000000000001,29.285714285714313,0
285,4,0,1,41,0.0,0.023809523809523808,0.9761904761904762,42,1550,900,650,0.5806451612903226,22,9,13,350.4499279351614,0.45515147115756877,0.3015338508835952,0.20559092502572304,131389.14399092997,809.0632086168068,132198.20719954677,251,2,84.95238095238095,34,8,22,34.70811077566185,0.6384803921568627,43.690476190476204,1025.2380952380972,30.15406162464992,0
286,4,0,0,41,0.0,0.0,1.0,41,1150,900,250,0.782608695652174,14,9,5,358.9099973597042,0.45431910569105693,0.30306882626507026,0.21039117925115136,131359.5300635575,1229.2497176566976,132588.7797812142,252,3,87.26829268292683,33,8,22,34.52119446104801,0.6404671717171717,43.71936274509805,1025.1225490196096,31.064319667260897,0
287,4,0,0,41,0.0,0.0,1.0,41,1750,1400,350,0.8,21,14,7,356.75498966520865,0.4539380081300813,0.2345991651733501,0.20739235076957005,131039.71370018658,1166.6685861300161,132206.3822863166,253,4,88.26829268292683,36,5,19,34.899728699222756,0.630787037037037,44.03153153153153,1023.8738738738731,28.44094094094092,8
288,4,0,0,41,0.0,0.0,1.0,41,1500,1100,400,0.7333333333333333,19,11,8,368.0901581552063,0.45218495934959346,0.13815130989777558,0.20611643038137184,129584.09857521011,1346.7296816766507,130930.82825688676,254,5,89.26829268292683,35,6,16,36.08770508885606,0.6181547619047619,45.45717592592593,1018.1712962962968,29.09060846560848,8
289,4,0,1,40,0.0,0.024390243902439025,0.975609756097561,41,1150,600,550,0.5217391304347826,17,6,11,371.485565885054,0.45157520325203254,0.1502319317671701,0.2088005077215994,129731.44531250012,1438.6718750000139,131170.11718750012,255,6,90.26829268292683,35,6,16,35.85122699386504,0.6196428571428572,45.31250000000001,1018.7500000000009,29.107142857142883,0
290,4,1,0,41,0.024390243902439025,0.0,1.0,41,1150,700,450,0.6086956521739131,16,7,9,379.2068299551904,0.45299796747967475,0.1638342393410317,0.21475389367385214,130026.38996056248,1661.379029492464,131687.76899005493,256,0,89.26829268292683,35,6,17,35.35425177787865,0.6226190476190476,45.02314814814815,1019.907407407408,29.140211640211657,0
291,4,1,2,40,0.023809523809523808,0.047619047619047616,0.9523809523809523,42,1300,1000,300,0.7692307692307693,16,10,6,372.98618036108667,0.45322783584978704,0.177014298832481,0.21409548303458956,130550.14209733381,1338.6797692963269,131888.82186663014,257,0,88.11904761904762,36,6,17,34.98071625344354,0.6258680555555556,44.51013513513514,1021.9594594594594,28.387762762762762,0
292,4,0,0,40,0.0,0.0,1.0,40,1700,1300,400,0.7647058823529411,21,13,8,379.2407265382794,0.4525373931623931,0.21751193664842128,0.21812057058166168,130627.42524092988,1907.8479308390183,132535.2731717689,258,1,92.8,34,6,17,34.742440122666046,0.6308210784313726,44.43452380952382,1022.2619047619062,30.0665266106443,0
293,4,0,0,40,0.0,0.0,1.0,40,1350,1100,250,0.8148148148148148,16,11,5,376.81771656341374,0.4522836538461539,0.21742053789731042,0.21706823390765684,130688.28125000013,1849.13194444446,132537.41319444458,259,2,93.8,34,6,17,34.74259712034773,0.6314338235294117,44.37500000000001,1022.500000000001,30.073529411764735,0
294,4,0,0,40,0.0,0.0,1.0,40,1850,1500,350,0.8108108108108109,22,15,7,371.19757238803595,0.4516559829059829,0.21730456026058675,0.2150144428738249,130901.38888888905,1718.0555555555798,132619.44444444464,260,3,94.8,34,6,19,34.67019543973942,0.633578431372549,44.16666666666668,1023.3333333333346,30.098039215686313,0
295,4,0,0,40,0.0,0.0,1.0,40,950,600,350,0.631578947368421,13,6,7,371.77236496626597,0.45146901709401704,0.22164495871612977,0.21585891737642982,130992.77388038568,1739.8986678004756,132732.67254818615,261,4,95.8,34,6,19,34.56288521921154,0.6344975490196079,44.07738095238096,1023.6904761904777,30.10854341736699,0
296,4,0,0,40,0.0,0.0,1.0,40,1950,1700,250,0.8717948717948718,22,17,5,372.3053941349624,0.4505208333333333,0.22631273234200777,0.21771771961370617,131267.1201814059,1774.291383219956,133041.41156462586,262,5,96.8,34,6,19,34.271414188351926,0.6372549019607843,43.80952380952381,1024.7619047619046,30.14005602240896,0
297,4,1,0,41,0.024390243902439025,0.0,1.0,41,1250,800,450,0.64,17,8,9,355.8707783184968,0.4500762195121952,0.14683295447564015,0.19898689998935676,129527.44904667995,1019.0068211702937,130546.45586785024,263,0,95.41463414634147,38,3,14,36.456365449202345,0.611842105263158,45.51282051282052,1017.948717948719,26.788124156545237,8
298,4,0,0,41,0.0,0.0,1.0,41,1200,900,300,0.75,15,9,6,353.92810691694893,0.44979674796747965,0.15062952056143875,0.19858720678277075,129663.42872242315,978.3063728175941,130641.73509524074,264,1,96.41463414634147,38,3,14,36.36753033322845,0.6132127192982456,45.379273504273506,1018.4829059829062,26.80218173639227,0
299,4,1,1,41,0.023809523809523808,0.023809523809523808,0.9761904761904762,42,1000,700,300,0.7,13,7,6,368.798303237728,0.45059039876113044,0.10613721281500932,0.19830357597791654,127973.55791179692,1185.657149082956,129159.21506087987,265,0,95.0952380952381,36,6,15,37.714941569282146,0.5998263888888888,47.04391891891892,1011.8243243243242,28.106231231231227,8
300,4,1,0,42,0.023809523809523808,0.0,1.0,42,1450,1200,250,0.8275862068965517,17,12,5,361.4524095931645,0.45322783584978704,0.12348825269798946,0.1960209360524234,128315.61872260788,875.9979151448883,129191.61663775277,266,0,95.19047619047619,36,6,16,37.550711348227196,0.6032986111111112,46.70608108108109,1013.1756756756768,28.143768768768798,0
301,4,0,2,40,0.0,0.047619047619047616,0.9523809523809523,42,1750,1300,450,0.7428571428571429,22,13,9,360.32751939512326,0.4525624274099884,0.12185620666127184,0.19625097744188125,128486.82032962026,859.4674488677992,129346.28777848805,267,1,96.19047619047619,36,6,13,37.40419860046653,0.6050347222222222,46.53716216216217,1013.8513513513522,28.16253753753756,0
302,4,0,0,40,0.0,0.0,1.0,40,1400,1200,200,0.8571428571428571,16,12,4,381.91745109437846,0.4505475427350427,0.1298178613396006,0.20701385406453246,128295.24518140589,1799.6386054421737,130094.88378684806,268,3,101.525,34,6,18,37.05322169996081,0.6072303921568627,46.726190476190474,1013.0952380952381,29.796918767507,0
303,4,1,0,41,0.024390243902439025,0.0,1.0,41,1800,1500,300,0.8333333333333334,21,15,6,372.1520525867121,0.4515243902439024,0.12431012996261348,0.20393932481751822,128731.13854595338,1381.511488340195,130112.65003429358,269,0,100.02439024390245,35,6,16,36.854660888077866,0.6095238095238096,46.2962962962963,1014.814814814815,28.994708994709,0
304,4,0,1,40,0.0,0.024390243902439025,0.975609756097561,41,950,600,350,0.631578947368421,13,6,7,372.9875496153352,0.4509400406504065,0.12472056321110414,0.20500293140512024,128848.62075617285,1411.7862654321032,130260.40702160496,270,1,101.02439024390245,35,6,17,36.71340629274967,0.6107142857142858,46.18055555555556,1015.2777777777778,29.00793650793651,0
305,4,1,0,41,0.024390243902439025,0.0,1.0,41,1100,1000,100,0.9090909090909091,12,10,2,369.52486183811465,0.4502540650406504,0.14604175396629437,0.20568423120298845,129348.51794249393,1359.498644332986,130708.01658682691,271,0,101.17073170731707,35,6,19,36.291221033868105,0.6157738095238094,45.688657407407405,1017.2453703703698,29.064153439153422,0
306,4,0,0,41,0.0,0.0,1.0,41,1350,900,450,0.6666666666666666,18,9,9,371.23020882550446,0.45022865853658534,0.152832214094915,0.20725252229858168,129466.28146701396,1412.3589409722322,130878.6404079862,272,1,102.17073170731707,35,6,14,36.12781473899694,0.6169642857142856,45.57291666666667,1017.7083333333339,29.07738095238097,0
307,4,0,1,40,0.0,0.024390243902439025,0.975609756097561,41,1400,1100,300,0.7857142857142857,17,11,6,367.7844077998054,0.4496697154471545,0.15193031675713464,0.20609982291864254,129613.56122470848,1333.969371570645,130947.53059627912,273,2,103.17073170731707,35,6,14,36.06548836856862,0.618452380952381,45.42824074074074,1018.2870370370368,29.093915343915338,0
308,4,0,0,40,0.0,0.0,1.0,40,1250,1000,250,0.8,15,10,5,371.90328414102567,0.44934561965811964,0.14401729376022465,0.20911618302752277,129746.60572562354,1650.6377551020357,131397.24348072556,274,3,105.05,34,6,14,35.825153852146144,0.6219362745098039,45.297619047619044,1018.8095238095234,29.964985994397747,0
309,4,0,0,40,0.0,0.0,1.0,40,1400,800,600,0.5714285714285714,20,8,12,372.3480605903842,0.4487313034188034,0.14380182179142897,0.2101790667656857,129898.2585742627,1673.4729308389642,131571.73150510166,275,4,106.05,34,6,14,35.65947487251352,0.623468137254902,45.148809523809504,1019.4047619047592,29.9824929971988,0
310,4,0,1,39,0.0,0.025,0.975,40,1600,1000,600,0.625,22,10,12,370.389940175756,0.44776976495726495,0.1446101319014823,0.20972442944386632,130019.64462868462,1631.5936791382958,131651.2383078229,276,5,107.05,34,6,15,35.58592078129254,0.6246936274509804,45.02976190476189,1019.8809523809509,29.996498599439732,0
311,4,0,1,38,0.0,0.02564102564102564,0.9743589743589743,39,1100,900,200,0.8181818181818182,13,9,4,380.0668499871389,0.44601889338731443,0.14896890212508818,0.21430616890461224,129856.32216274976,2070.8166630622663,131927.13882581203,277,6,110.61538461538461,33,6,15,35.505465712797076,0.6253156565656566,45.18995098039215,1019.2401960784302,30.88606654783122,0
312,4,0,1,37,0.0,0.02631578947368421,0.9736842105263158,38,1100,700,400,0.6363636363636364,15,7,8,390.050312794365,0.44535324798482695,0.15167440404778043,0.21986634950252198,129844.02101826343,2529.1402025303523,132373.1612207938,278,7,107.39473684210526,32,6,15,35.263617030062754,0.6276041666666667,45.2020202020202,1019.1919191919192,31.849747474747474,0
313,4,0,0,37,0.0,0.0,1.0,37,900,600,300,0.6666666666666666,12,6,6,390.5750901442626,0.44338088088088085,0.1365237962984649,0.22107042768712043,130004.92814827566,2755.337306142226,132760.26545441788,279,8,108.02702702702703,32,5,16,35.08625314679542,0.6292317708333333,45.04419191919192,1019.8232323232321,31.869476010101003,0
314,4,0,0,37,0.0,0.0,1.0,37,900,500,400,0.5555555555555556,13,5,8,388.5383606930824,0.44322447447447444,0.13400803352542012,0.220645010032382,130133.72559241395,2712.388882511977,132846.1144749259,280,9,109.02702702702703,32,5,18,35.007012333457084,0.6305338541666667,44.91792929292929,1020.328282828282,31.885258838383812,0
315,4,2,3,36,0.05128205128205128,0.07692307692307693,0.9230769230769231,39,850,500,350,0.5882352941176471,12,5,7,370.44591201020194,0.44348852901484476,0.1360257902749169,0.21356579759514333,130718.71456916103,1884.8426870748299,132603.55725623586,281,0,104.38461538461539,34,5,14,34.87461195188202,0.6317401960784313,44.345238095238095,1022.6190476190479,30.07703081232494,0
316,4,0,0,36,0.0,0.0,1.0,36,1150,600,550,0.5217391304347826,17,6,11,398.84123429373574,0.4430224867724868,0.13778358769431343,0.22744102677070405,130295.81917656786,3193.4690687391403,133489.288245307,282,11,111.5,31,5,19,34.57905560515241,0.634744623655914,44.75911458333333,1020.9635416666661,32.934307795698906,0
317,4,0,1,35,0.0,0.027777777777777776,0.9722222222222222,36,800,400,400,0.5,12,4,8,402.1532221771171,0.4429232804232804,0.1444139855780815,0.22972233951457588,130362.29663425016,3285.1235283745614,133647.4201626247,283,12,112.5,31,5,19,34.426797781461175,0.6354166666666667,44.694010416666664,1021.2239583333328,32.942708333333314,0
318,4,0,0,35,0.0,0.0,1.0,35,1250,800,450,0.64,17,8,9,407.8877797256327,0.44254201680672267,0.13453164366562653,0.2330173947635606,130365.5137154584,3634.899988437964,134000.41370389637,284,13,113.48571428571428,30,5,20,34.27711239799947,0.6381944444444445,44.69086021505376,1021.2365591397846,34.04121863799282,0
319,4,0,0,35,0.0,0.0,1.0,35,950,700,250,0.7368421052631579,12,7,5,398.426918453528,0.441281512605042,0.11405178372055946,0.2225723762753909,129490.37606175395,3318.49030073463,132808.8663624886,285,14,114.48571428571428,32,3,15,35.41123930033496,0.6240234375,45.54924242424243,1017.8030303030307,31.80634469696971,8
320,4,1,0,36,0.027777777777777776,0.0,1.0,36,900,600,300,0.6666666666666666,12,6,6,384.21009637295003,0.44353505291005296,0.11429697309716547,0.21681543973067863,129887.55076172644,2780.821679161885,132668.3724408883,286,0,112.27777777777777,33,3,17,35.368077262162394,0.6256313131313131,45.15931372549021,1019.3627450980407,30.889780154486083,0
321,4,1,0,37,0.02702702702702703,0.0,1.0,37,1050,800,250,0.7619047619047619,13,8,5,377.3427738442314,0.44456956956956956,0.11759514616657452,0.21499762695776006,130262.58680555574,2430.729166666691,132693.31597222242,287,0,110.21621621621621,34,3,19,35.161564625850346,0.6271446078431373,44.79166666666668,1020.8333333333348,30.024509803921614,0
322,4,0,0,37,0.0,0.0,1.0,37,1200,800,400,0.6666666666666666,16,8,8,375.98772641653255,0.44494494494494496,0.113771037327979,0.21474336697936738,130356.430294238,2402.4835700211675,132758.91386425917,288,1,111.21621621621621,33,4,19,35.100779031161224,0.6303661616161615,44.699754901960794,1021.2009803921586,30.945484254307836,0
323,4,0,0,37,0.0,0.0,1.0,37,900,700,200,0.7777777777777778,11,7,4,376.1495715544745,0.4444444444444444,0.11977216511221478,0.21552982667007958,130481.60750973203,2416.1201521049766,132897.727661837,289,2,112.21621621621621,33,4,19,34.96948842509295,0.6316287878787878,44.57720588235295,1021.6911764705898,30.960338680926963,0
324,4,0,2,35,0.0,0.05405405405405406,0.9459459459459459,37,1000,600,400,0.6,14,6,8,375.8176334623839,0.44375625625625625,0.1220217940035706,0.21603686290211904,130606.84479827482,2416.871065215313,133023.71586349013,290,3,113.21621621621621,33,4,17,34.85081225272748,0.6328914141414141,44.454656862745104,1022.1813725490206,30.97519310754608,0
325,4,0,0,35,0.0,0.0,1.0,35,1100,800,300,0.7272727272727273,14,8,6,391.8320929407544,0.4429271708683473,0.11656618276534148,0.22382659176506456,130362.29663425017,3216.026306152339,133578.32294040252,291,4,116.94285714285714,31,4,19,34.69030239279187,0.6354166666666667,44.694010416666664,1021.2239583333329,32.94270833333332,0
326,4,1,1,35,0.027777777777777776,0.027777777777777776,0.9722222222222222,36,1000,900,100,0.9,11,9,2,390.60558630174927,0.442526455026455,0.14831716274735518,0.22686461989502751,131004.77629833695,3034.239490868283,134039.01578920524,292,0,114.66666666666667,32,4,18,34.06871813846407,0.6393229166666667,44.06565656565657,1023.7373737373741,31.99179292929294,0
327,4,0,0,35,0.0,0.0,1.0,35,1200,800,400,0.6666666666666666,16,8,8,399.1623594910353,0.440406162464986,0.1536391570755835,0.23077399989117456,130828.1135559081,3444.3316989474692,134272.44525485556,293,1,118.8,31,4,18,34.02923613762675,0.6401209677419355,44.23828124999999,1023.0468749999992,33.00151209677417,0
328,4,0,0,35,0.0,0.0,1.0,35,1300,800,500,0.6153846153846154,18,8,10,399.4354123367586,0.4397408963585434,0.15124681933842266,0.23153114608900588,130928.03955078115,3459.4590928819316,134387.49864366307,294,2,119.8,31,4,18,33.92069550466497,0.6411290322580645,44.14062499999999,1023.4374999999992,33.01411290322578,0
329,4,1,0,36,0.027777777777777776,0.0,1.0,36,1600,1200,400,0.75,20,12,8,391.6083858185248,0.4410218253968254,0.11207158022444652,0.21846579493124804,129436.8355624142,2937.7100480109657,132374.54561042518,295,0,117.44444444444444,35,1,15,35.639407036700035,0.6166666666666667,45.60185185185185,1017.592592592592,29.07407407407406,7
330,4,1,0,37,0.02702702702702703,0.0,1.0,37,1350,1000,350,0.7407407407407407,17,10,7,382.45991904068376,0.4414727227227227,0.11713503954883309,0.21520505892289232,129774.47041636235,2526.7066897979134,132301.17710616026,296,0,115.24324324324324,36,1,16,35.52787908930151,0.6180555555555556,45.270270270270274,1018.9189189189192,28.30330330330331,0
331,4,0,1,36,0.0,0.02702702702702703,0.972972972972973,37,1000,800,200,0.8,12,8,4,370.7368267975244,0.4408158158158158,0.0399991362210288,0.20211732044636632,128525.67361379009,2156.0941629935196,130681.76777678361,297,1,116.24324324324324,35,2,16,37.100621123920405,0.6074404761904761,46.49884259259258,1014.004629629628,28.9715608465608,8
332,4,0,0,36,0.0,0.0,1.0,36,1050,700,350,0.6666666666666666,14,7,7,390.6224364172714,0.4389715608465608,0.035678395282108255,0.19573049094897593,125089.30165816302,2584.1953552575555,127673.49701342058,298,2,118.27777777777777,34,2,20,40.14166567495735,0.5744485294117647,49.91071428571427,1000.3571428571408,29.422268907562966,8
333,4,3,0,39,0.07692307692307693,0.0,1.0,39,1650,1200,450,0.7272727272727273,21,12,9,366.8883563988463,0.4464968511021143,0.038158956428187674,0.18737512487512478,125878.73191751288,1436.6882117574419,127315.42012927032,299,0,110.1025641025641,37,2,22,39.91841491841492,0.5765765765765766,49.12280701754385,1003.5087719298228,27.121858700806023,0
334,4,1,1,39,0.025,0.025,0.975,40,1400,1300,100,0.9285714285714286,15,13,2,362.5822274038265,0.45064102564102565,0.03694562838382698,0.18657832341983466,126189.15741008632,1151.1137727057885,127340.27118279212,300,0,108.325,35,5,23,39.70608704834312,0.5836309523809524,48.81365740740739,1004.7453703703682,28.70701058201052,0
335,4,1,1,39,0.025,0.025,0.975,40,1800,1500,300,0.8333333333333334,21,15,6,357.9752294056201,0.4505208333333333,0.05519796443350877,0.18662720268895883,126723.24087178372,1072.756244420069,127795.9971162038,301,0,107.6,36,4,15,39.27180032062036,0.5870949074074074,48.282657657657644,1006.8693693693675,27.968593593593543,0
336,4,0,4,35,0.0,0.10256410256410256,0.8974358974358975,39,900,700,200,0.7777777777777778,11,7,4,367.75253920845955,0.4462438146648673,0.05111692968178683,0.19126651201894485,126625.62157064443,1513.3787722907732,128139.00034293521,302,1,111.33333333333333,35,4,16,39.12622661760196,0.5880952380952381,48.37962962962961,1006.4814814814791,28.75661375661369,0
337,4,5,5,35,0.125,0.125,0.875,40,1350,1000,350,0.7407407407407407,17,10,7,350.0299290233029,0.44895833333333335,0.07850781928757633,0.1856610360856316,127423.91889812215,920.4370575561323,128344.35595567829,303,0,107.4,37,3,13,38.75253402838112,0.5923423423423424,47.587719298245595,1009.6491228070147,27.287814129919315,0
338,4,3,1,37,0.07894736842105263,0.02631578947368421,0.9736842105263158,38,950,300,650,0.3157894736842105,16,3,13,370.12688600422945,0.44690908013276437,0.0965314293984274,0.1969797232344458,127559.2635459532,1842.6225994512854,129401.88614540448,304,0,106.63157894736842,35,3,15,38.10628628169875,0.5976190476190476,47.453703703703695,1010.1851851851839,28.862433862433825,0
339,4,0,0,37,0.0,0.0,1.0,37,950,700,250,0.7368421052631579,12,7,5,378.9974999916936,0.4444444444444444,0.103570142480649,0.20101799858846456,127422.33737244872,2258.5494614512195,129680.88683389993,305,1,110.51351351351352,34,3,16,38.02298274574539,0.5983455882352942,47.5892857142857,1009.642857142855,29.69537815126044,0
340,4,1,1,37,0.02631578947368421,0.02631578947368421,0.9736842105263158,38,1400,900,500,0.6428571428571429,19,9,10,374.02773025890605,0.44544215267899473,0.11668162623567024,0.20036053214420968,127822.4682382758,1961.829534250674,129784.29777252648,306,0,108.57894736842105,35,3,17,37.73761493266186,0.600297619047619,47.19328703703703,1011.2268518518512,28.892195767195748,0
341,4,0,0,37,0.0,0.0,1.0,37,900,500,400,0.5555555555555556,13,5,8,383.03352554875534,0.4420357857857858,0.12188097670259457,0.20498448219820892,127783.1792091835,2389.048327664378,130172.22753684787,307,1,111.97297297297297,34,3,17,37.55028651045959,0.6020220588235294,47.23214285714285,1011.0714285714271,29.73739495798315,0
342,4,0,0,37,0.0,0.0,1.0,37,1300,1100,200,0.8461538461538461,15,11,4,381.4515473336076,0.4423173173173173,0.11254106206453596,0.20505734982848373,127963.79145408151,2362.3972505668826,130326.18870464839,308,2,112.97297297297297,34,3,20,37.40489077146332,0.6038602941176471,47.05357142857142,1011.7857142857133,29.75840336134451,0
343,4,0,0,37,0.0,0.0,1.0,37,1600,1100,500,0.6875,21,11,10,381.9124677893387,0.4420983483483483,0.09934541364495408,0.20687342455744895,128268.64216887722,2397.606285161105,130666.24845403833,309,3,113.97297297297297,33,4,20,37.080611339624156,0.6092171717171717,46.75245098039215,1012.9901960784304,30.696672608437282,0
344,4,0,0,37,0.0,0.0,1.0,37,1150,900,250,0.782608695652174,14,9,5,367.4923626220318,0.4419419419419419,0.020641836077285536,0.19390599507217304,127212.08191609984,1953.2728164795396,129165.35473257938,310,4,114.97297297297297,34,3,19,38.529374164109825,0.5962009803921569,47.79761904761905,1008.8095238095243,29.67086834733895,8
345,4,1,1,37,0.02631578947368421,0.02631578947368421,0.9736842105263158,38,1000,700,300,0.7,13,7,6,356.143928569614,0.44364924134660977,0.022263031246042342,0.18940085707660098,127530.03532503861,1483.8095582561805,129013.84488329479,311,0,112.92105263157895,35,3,15,38.4893863870746,0.5973214285714286,47.48263888888889,1010.0694444444447,28.85912698412699,0
346,4,3,2,38,0.075,0.05,0.95,40,1100,600,500,0.5454545454545454,16,6,10,340.9883950617284,0.44706196581196583,0.06389444444444448,0.18531977992485246,128401.20525931346,758.1410811501378,129159.3463404636,312,0,108.075,36,4,13,37.98171296296297,0.6041666666666667,46.62162162162163,1013.5135135135142,28.153153153153173,0
347,4,1,0,39,0.02564102564102564,0.0,1.0,39,1450,1300,150,0.896551724137931,16,13,3,339.30192105350295,0.44793072424651376,0.07701700009392343,0.18559629670740785,128658.13607103721,930.7905456131784,129588.9266166504,313,0,109.82051282051282,36,3,15,37.762469012469026,0.6067708333333333,46.36824324324324,1014.5270270270266,28.181306306306297,0
348,4,0,0,39,0.0,0.0,1.0,39,700,400,300,0.5714285714285714,10,4,6,338.35607494940257,0.4478182636077373,0.07482853809157941,0.185211921949825,128686.6997910073,908.3853278954699,129595.08511890276,314,1,110.82051282051282,36,3,15,37.75735294117647,0.6070601851851851,46.340090090090094,1014.6396396396402,28.18443443443445,0
349,4,0,1,38,0.0,0.02564102564102564,0.9743589743589743,39,1200,800,400,0.6666666666666666,16,8,8,335.3467607563521,0.447733918128655,0.07395959696672594,0.18414236720535632,128811.51532202207,839.3048822714586,129650.82020429353,315,2,111.82051282051282,37,2,15,37.70657809462087,0.6064189189189189,46.21710526315789,1015.1315789473676,27.435988620199126,0
350,4,0,1,37,0.0,0.02631578947368421,0.9736842105263158,38,1350,1000,350,0.7407407407407407,17,10,7,344.95585684603685,0.44644973921289716,0.08056437678046025,0.1896415856904799,128858.14868922981,1290.0746185374628,130148.22330776727,316,3,115.65789473684211,36,2,15,37.415197057083695,0.6087962962962963,46.171171171171174,1015.3153153153157,28.203203203203216,0
351,4,0,0,37,0.0,0.0,1.0,37,1200,800,400,0.6666666666666666,16,8,8,349.4364758781099,0.4451951951951952,0.0679001699967976,0.1926290522805459,128966.15655006858,1613.0958504801129,130579.25240054869,317,4,115.62162162162163,35,2,15,37.191393193558206,0.611904761904762,46.06481481481482,1015.7407407407406,29.02116402116402,0
352,4,1,0,38,0.02631578947368421,0.0,1.0,38,1100,700,400,0.6363636363636364,15,7,8,340.44426842479237,0.44523470839260315,0.07970181426261891,0.18963910769669987,129377.95380015431,1209.4109010630984,130587.3647012174,318,0,113.55263157894737,35,3,19,37.000853242320815,0.6160714285714286,45.65972222222222,1017.3611111111111,29.067460317460316,0
353,4,0,0,38,0.0,0.0,1.0,38,1250,800,450,0.64,17,8,9,344.60039196782367,0.4449976292081555,0.08476340920514103,0.19281838726138525,129554.6392746913,1328.9158950617207,130883.55516975303,319,1,114.55263157894737,35,3,15,36.715552523874464,0.6178571428571429,45.48611111111111,1018.0555555555552,29.087301587301578,0
354,4,0,0,38,0.0,0.0,1.0,38,1400,1000,400,0.7142857142857143,18,10,8,348.7355773855076,0.44449383594120434,0.07496501991174243,0.19601344522013026,129731.44531250015,1448.3940972222367,131179.8394097224,320,2,115.55263157894737,35,3,15,36.43064076346283,0.6196428571428572,45.31250000000001,1018.7500000000011,29.10714285714289,0
355,4,0,0,38,0.0,0.0,1.0,38,1100,800,300,0.7272727272727273,14,8,6,348.6973931348788,0.44441974869606443,0.07220402209521981,0.19628720263167992,129790.4074502744,1451.5153463648908,131241.9227966393,321,3,116.55263157894737,35,3,15,36.371724973496896,0.6202380952380953,45.25462962962963,1018.9814814814819,29.113756613756625,0
356,4,0,0,38,0.0,0.0,1.0,38,1450,900,550,0.6206896551724138,20,9,11,344.590851184371,0.44367887624466573,0.07147465190043523,0.19500256838699404,129996.88042534742,1359.1471354166858,131356.0275607641,322,4,117.55263157894737,35,3,16,36.26681137214843,0.6223214285714286,45.05208333333334,1019.7916666666682,29.136904761904805,0
357,4,0,0,38,0.0,0.0,1.0,38,1150,800,350,0.6956521739130435,15,8,7,345.0822912713363,0.4434417970602181,0.06892756114986698,0.1960370307968391,130147.65346004812,1382.3300919162702,131529.9835519644,323,5,118.55263157894737,36,2,17,36.10137769929735,0.6218171296296297,44.904279279279294,1020.3828828828848,28.343968968969023,0
358,4,0,1,37,0.0,0.02631578947368421,0.9736842105263158,38,900,600,300,0.6666666666666666,12,6,6,344.8016809367377,0.4429528212422949,0.07606726436568012,0.1963117108046856,130233.84871357869,1380.9699902605594,131614.81870383924,324,6,119.55263157894737,36,2,18,36.021164313033246,0.6226851851851851,44.819819819819834,1020.7207207207226,28.353353353353405,0
359,4,2,0,39,0.05128205128205128,0.0,1.0,39,750,400,350,0.5333333333333333,11,4,7,337.9981614162717,0.4447537112010796,0.09392391552946555,0.19488008278229632,130722.82745160718,1036.818237156092,131759.64568876327,325,0,116.84615384615384,36,3,17,35.699996329332315,0.6276041666666667,44.341216216216225,1022.6351351351365,28.40653153153157,0
360,4,0,0,39,0.0,0.0,1.0,39,1400,1000,400,0.7142857142857143,18,10,8,335.6008428125541,0.4441351776878093,0.09244309046289256,0.19480278806935622,130982.0694850257,991.5385825014371,131973.60806752712,326,1,117.84615384615384,36,3,18,35.49940410707736,0.6302083333333333,44.087837837837846,1023.6486486486497,28.43468468468471,0
361,4,0,0,39,0.0,0.0,1.0,39,1250,800,450,0.64,17,8,9,335.61757878569625,0.44298245614035087,0.09908028287713955,0.1958379162420449,131183.87972009176,1005.5232174742423,132189.40293756602,327,2,118.84615384615384,36,3,18,35.29528965593054,0.6322337962962963,43.89076576576577,1024.4369369369374,28.456581581581595,0
362,4,0,0,39,0.0,0.0,1.0,39,1050,900,150,0.8571428571428571,12,9,3,333.36142977901216,0.44233580746738643,0.09879402648633429,0.19496073335404954,131270.4173768364,952.0988048859776,132222.5161817224,328,3,119.84615384615384,36,3,18,35.2657967032967,0.6331018518518519,43.80630630630631,1024.7747747747756,28.46596596596599,0
363,4,0,0,39,0.0,0.0,1.0,39,900,700,200,0.7777777777777778,11,7,4,337.16663294837866,0.4415485829959514,0.10028840520931936,0.197781251698585,131385.84530476423,1059.7846156967826,132445.629920461,329,4,120.84615384615384,36,3,19,35.05190026362038,0.6342592592592593,43.693693693693696,1025.2252252252254,28.478478478478483,0
364,4,0,2,37,0.0,0.05128205128205128,0.9487179487179487,39,1800,1500,300,0.8333333333333334,21,15,6,335.61983123763764,0.44152046783625726,0.014187296153420625,0.18679321845776825,129344.54038075231,898.5539170927636,130243.09429784508,330,5,121.84615384615384,36,3,20,37.15750581202259,0.6137152777777778,45.692567567567565,1017.2297297297291,28.256381381381363,8
365,4,1,0,38,0.02631578947368421,0.0,1.0,38,900,500,400,0.5555555555555556,13,5,8,333.7682465386672,0.441708155523945,0.02451114513415531,0.1868482177681789,129573.74762854066,1049.5205086843582,130623.26813722502,331,0,123.78947368421052,36,2,15,36.97185045902003,0.6160300925925926,45.46734234234234,1018.1306306306302,28.281406406406393,0
366,4,0,0,38,0.0,0.0,1.0,38,750,300,450,0.4,12,3,9,332.62742402099667,0.4417674253200569,0.018237427029921482,0.18648169841425116,129631.081144489,1023.770518829629,130654.85166331862,332,1,124.78947368421052,36,2,15,36.942708909285244,0.6166087962962963,45.41103603603603,1018.3558558558551,28.28766266266264,0
367,4,0,0,38,0.0,0.0,1.0,38,950,700,250,0.7368421052631579,12,7,5,359.6460219272563,0.4414858937885254,0.017302931519836973,0.19448566898327205,128201.5477259353,1650.6537365067663,129852.20146244207,333,2,125.78947368421052,36,2,15,37.71312872975276,0.6021412037037037,46.81869369369369,1012.7252252252246,28.131256256256236,8
368,4,1,1,38,0.02564102564102564,0.02564102564102564,0.9743589743589743,39,1050,600,450,0.5714285714285714,15,6,9,353.9779693206724,0.4435166441745389,0.028429660429660775,0.193287852196943,128588.99493113243,1303.5342605416795,129892.52919167411,334,0,123.53846153846153,37,2,16,37.46081081081081,0.6041666666666667,46.43640350877192,1014.2543859649104,27.412280701754334,0
369,4,0,0,38,0.0,0.0,1.0,38,850,400,450,0.47058823529411764,13,4,9,358.41886551828225,0.442345305832148,0.039608127381982605,0.1953512993418045,128515.36502718927,1612.4662669426118,130127.83129413189,335,1,127.71052631578948,36,2,16,37.423413667999405,0.6053240740740741,46.509009009009006,1013.9639639639632,28.165665665665646,0
370,4,2,1,39,0.05,0.025,0.975,40,1050,800,250,0.7619047619047619,13,8,5,348.9672699043216,0.4458066239316239,0.057907600126143155,0.19311958339731303,129119.93805473378,1011.7264546351118,130131.66450936889,336,0,122.275,38,2,18,37.046672973825295,0.6077302631578947,45.91346153846154,1016.3461538461543,26.74595141700406,0
371,4,1,1,39,0.025,0.025,0.975,40,700,300,400,0.42857142857142855,11,3,8,342.6519768133168,0.44644764957264954,0.05353448275862016,0.19109437168435017,129424.43828870448,869.5592897496215,130293.9975784541,337,0,116.3,37,3,19,36.89744971264366,0.6126126126126126,45.61403508771931,1017.5438596491249,27.501185395922295,0
372,4,0,0,39,0.0,0.0,1.0,39,1650,1400,250,0.8484848484848485,19,14,5,349.01638621418067,0.4472278452541611,0.043048095720443325,0.19481538494240602,129459.11864144563,1236.6707501420533,130695.78939158769,338,1,116.97435897435898,36,3,17,36.7002784847479,0.6148726851851851,45.579954954954964,1017.6801801801812,28.26889389389392,0
373,4,0,0,39,0.0,0.0,1.0,39,1200,800,400,0.6666666666666666,16,8,8,347.83681135237094,0.4471434997750787,0.030765827469731777,0.19472400070816046,129573.74762854094,1214.1038420177215,130787.85147055866,339,2,117.97435897435898,36,3,17,36.61375953987391,0.6160300925925926,45.467342342342356,1018.1306306306326,28.28140640640646,0
374,4,0,1,38,0.0,0.02564102564102564,0.9743589743589743,39,1250,900,350,0.72,16,9,7,340.5395231530065,0.4469748088169141,0.009166249513321567,0.18212148512011103,127756.25673284059,995.0040669646671,128751.26079980526,340,3,118.97435897435898,37,2,17,38.651934201012295,0.5957207207207207,47.25877192982455,1010.9649122806994,27.32337600758647,8
375,4,0,2,36,0.0,0.05263157894736842,0.9473684210526316,38,950,600,350,0.631578947368421,13,6,7,347.7058968391364,0.44480500237079185,0.006289864837856207,0.18557065727656763,127673.13169677221,1278.5401517774785,128951.67184854968,341,4,123.0,37,1,17,38.555906657987045,0.5948761261261262,47.34100877192983,1010.6359649122818,27.314485538169777,0
376,4,0,0,36,0.0,0.0,1.0,36,1350,1000,350,0.7407407407407407,17,10,7,360.2979832440351,0.4444113756613757,0.016499442586399127,0.19168878467965578,127546.62390430976,1990.958272461653,129537.58217677141,342,5,126.44444444444444,36,0,17,38.36747491638795,0.5954861111111112,47.46621621621622,1010.1351351351356,28.05930930930932,0
377,4,2,0,38,0.05263157894736842,0.0,1.0,38,700,600,100,0.8571428571428571,8,6,2,346.2684888019434,0.44625711237553345,0.03845299263991042,0.1867327223334329,128090.45041867568,1270.7373392870272,129361.1877579627,343,0,120.73684210526316,38,0,19,38.165347405452934,0.5973135964912281,46.92841880341881,1012.2863247863256,26.639113810166464,0
378,4,0,1,37,0.0,0.02631578947368421,0.9736842105263158,38,1200,900,300,0.75,15,9,6,348.20977127943166,0.44604966808914176,0.04154164063031662,0.18831662582798006,128204.80619331067,1328.4789053962568,129533.28509870693,344,1,121.73684210526316,34,4,19,37.99934367775555,0.6063112745098039,46.81547619047619,1012.7380952380954,29.786414565826334,0
379,4,0,1,36,0.0,0.02702702702702703,0.972972972972973,37,1550,1200,350,0.7741935483870968,19,12,7,346.48774887005686,0.4452577577577577,0.042609927502013756,0.18834222326847208,128408.33875868034,1498.3832465277524,129906.7220052081,345,2,122.94594594594595,35,2,13,37.83508907159987,0.60625,46.61458333333332,1013.5416666666649,28.958333333333282,0
380,4,0,1,35,0.0,0.027777777777777776,0.9722222222222222,36,1300,700,600,0.5384615384615384,19,7,12,351.61506885364895,0.44413029100529106,0.038480292313199715,0.19123185708469448,128429.74044568211,1831.5664059329529,130261.30685161507,346,3,126.47222222222223,36,0,13,37.68331296522608,0.6044560185185186,46.593468468468465,1013.6261261261257,28.156281281281267,0
381,4,2,0,37,0.05405405405405406,0.0,1.0,37,1150,500,650,0.43478260869565216,18,5,13,339.92781368764486,0.44441316316316315,0.0583323848629973,0.18705118731796053,128895.01006319237,1362.9997932055826,130258.00985639796,347,0,123.08108108108108,37,0,15,37.50528650613684,0.6072635135135135,46.13486842105262,1015.4605263157882,27.4448790896159,0
382,4,0,0,37,0.0,0.0,1.0,37,1400,1000,400,0.7142857142857143,18,10,8,342.08635869721945,0.4438188188188188,0.055868496667201395,0.18876891681535038,129006.37846500824,1426.264451561994,130432.64291657023,348,1,124.08108108108108,37,0,16,37.33708850512683,0.6083896396396397,46.0252192982456,1015.8991228070157,27.456733048838263,0
383,4,2,1,38,0.05128205128205128,0.02564102564102564,0.9743589743589743,39,1300,900,400,0.6923076923076923,17,9,8,324.85031687961555,0.44537224471435,0.05847158835206656,0.18206909431870746,129619.76431450031,621.6988640735225,130241.46317857383,349,0,118.66666666666667,37,2,13,37.15217957000824,0.6145833333333333,45.422149122807,1018.3114035087696,27.52192982456134,0
384,4,0,1,37,0.0,0.02631578947368421,0.9736842105263158,38,1000,500,500,0.5,15,5,10,332.5270400525334,0.44356033665244193,0.058713411474254906,0.185881998456082,129516.42679419267,1013.542808010692,130529.96960220336,350,1,122.78947368421052,36,2,13,37.061621860825305,0.6154513888888888,45.52364864864864,1017.905405405404,28.27515015015011,0
385,4,0,0,37,0.0,0.0,1.0,37,1100,700,400,0.6363636363636364,15,7,8,339.85548536059713,0.44385010010010006,0.056407971359649034,0.19002091505063223,129525.18332315215,1403.9688089420176,130929.15213209417,351,2,124.56756756756756,35,2,13,36.86623555050221,0.6175595238095238,45.51504629629628,1017.9398148148125,29.08399470899464,0
386,4,0,3,34,0.0,0.08108108108108109,0.9189189189189189,37,1550,1000,550,0.6451612903225806,21,10,11,338.12280231433743,0.44385010010010006,0.05591943010370182,0.18928596010674442,129573.74762854059,1362.3677309065658,130936.11535944715,352,3,125.56756756756756,36,1,13,36.86101279357002,0.6160300925925926,45.467342342342334,1018.1306306306296,28.28140640640638,0
387,4,0,0,34,0.0,0.0,1.0,34,1100,600,500,0.5454545454545454,16,6,10,365.1733417375456,0.4409350861556744,0.04496289418285704,0.2029855032203543,129294.84941188473,2643.006445838127,131937.85585772287,353,4,129.05882352941177,33,1,21,36.45657609350525,0.6196338383838385,45.741421568627445,1017.0343137254893,30.819221628045128,0
388,4,0,0,34,0.0,0.0,1.0,34,800,500,300,0.625,11,5,6,364.15154594280756,0.4406194295900178,0.04138908575478428,0.20257760263574398,129326.01042868115,2618.8533256439705,131944.86375432514,354,5,130.05882352941177,33,1,21,36.450803212851405,0.619949494949495,45.71078431372548,1017.156862745097,30.82293523469991,0
389,4,0,0,34,0.0,0.0,1.0,34,800,700,100,0.875,9,7,2,364.15154594280756,0.4406194295900178,0.04138908575478428,0.20257760263574398,129326.01042868115,2618.8533256439705,131944.86375432514,355,6,131.05882352941177,33,1,21,36.450803212851405,0.619949494949495,45.71078431372548,1017.156862745097,30.82293523469991,0
390,4,1,0,35,0.02857142857142857,0.0,1.0,35,600,300,300,0.5,9,3,6,354.7548236721881,0.44131652661064424,0.043703369886335164,0.19962830610192359,129776.92920918363,2207.7983276643918,131984.72753684802,356,0,128.28571428571428,34,1,17,36.231111500564694,0.6222426470588236,45.26785714285714,1018.928571428571,29.96848739495797,0
391,4,0,1,34,0.0,0.02857142857142857,0.9714285714285714,35,1000,800,200,0.8,12,8,4,353.7637800396916,0.4403361344537815,0.036460106116728896,0.19953395814886934,129867.92091836724,2188.513321995455,132056.4342403627,357,1,129.28571428571428,34,1,17,36.16391224791717,0.6231617647058824,45.17857142857142,1019.2857142857133,29.978991596638625,0
392,4,0,1,33,0.0,0.029411764705882353,0.9705882352941176,34,1150,1000,150,0.8695652173913043,13,10,3,363.8760541117445,0.439468211527035,0.04685510567863527,0.2050130939019828,129825.09731833906,2648.0488273740825,132473.14614571314,358,2,133.6764705882353,33,1,18,35.94977553310886,0.625,45.220588235294116,1019.1176470588232,30.88235294117646,0
393,4,1,0,34,0.029411764705882353,0.0,1.0,34,1300,1000,300,0.7692307692307693,16,10,6,362.1854494041185,0.438614081996435,0.045436437068989255,0.20460133170823688,129928.59977324265,2611.6496598639474,132540.2494331066,359,0,134.3235294117647,34,0,20,35.88763039078313,0.6237745098039216,45.11904761904762,1019.5238095238096,29.985994397759107,0
394,4,0,0,34,0.0,0.0,1.0,34,800,500,300,0.625,11,5,6,361.3768790852826,0.43840983363042185,0.04289716353449324,0.20462099954551322,130019.64462868476,2597.2186791383215,132616.86330782308,360,1,135.3235294117647,34,0,21,35.81572701451306,0.6246936274509804,45.029761904761905,1019.8809523809521,29.996498599439768,0
395,4,2,1,35,0.05555555555555555,0.027777777777777776,0.9722222222222222,36,1200,900,300,0.75,15,9,6,343.73114244515693,0.4414517195767196,0.040687892318644,0.19738674634726908,130566.583404195,1776.4136904761917,132342.99709467118,361,0,128.75,34,2,16,35.71151232770336,0.6302083333333333,44.49404761904762,1022.0238095238094,30.059523809523807,0
396,4,0,0,35,0.0,0.0,1.0,35,1350,1000,350,0.7407407407407407,17,10,7,353.13532169646294,0.43876050420168067,0.037953603125107094,0.2025063488517958,130512.91120001934,2217.7437764321558,132730.6549764515,362,1,133.42857142857142,33,2,16,35.52560566082994,0.6319444444444444,44.54656862745099,1021.813725490197,30.96405228758173,0
397,4,0,1,34,0.0,0.02857142857142857,0.9714285714285714,35,750,400,350,0.5333333333333333,11,4,7,379.6061872294513,0.43795518207282913,0.019460844572952496,0.2032531246482935,127803.53597474538,2705.5406874759833,130509.07666222136,363,2,134.42857142857142,33,2,17,37.616021290348655,0.6044823232323233,47.212009803921575,1011.1519607843144,30.640968508615586,8
398,4,0,0,34,0.0,0.0,1.0,34,1150,800,350,0.6956521739130435,15,8,7,390.8845590007579,0.4367015745692216,0.030756176580786,0.20907232223908295,127761.29548324169,3187.9835284665037,130949.27901170819,364,5,139.3235294117647,32,2,18,37.37432871237667,0.6064453125,47.25378787878789,1010.9848484848499,31.593276515151558,0
399,4,2,0,36,0.05555555555555555,0.0,1.0,36,650,300,350,0.46153846153846156,10,3,7,356.64546234980503,0.4455522486772487,0.06277547529767724,0.1842122892687529,126342.873086735,1811.922477324291,128154.79556405928,365,0,132.52777777777777,34,2,20,39.696812709690136,0.5873161764705883,48.6607142857143,1005.3571428571454,29.56932773109251,7
400,4,0,2,34,0.0,0.05555555555555555,0.9444444444444444,36,1300,900,400,0.6923076923076923,17,9,8,359.0718929000502,0.44470899470899466,0.06549879185364138,0.18608788438845206,126480.04979263146,1883.086178626576,128363.13597125803,366,1,133.52777777777777,35,1,20,39.49452019330341,0.5866071428571429,48.52430555555557,1005.9027777777801,28.74007936507943,0
401,4,0,0,34,0.0,0.0,1.0,34,1000,500,500,0.5,15,5,10,367.6404230741461,0.44531714200831846,0.08823529411764719,0.19050458286569402,126474.91349480973,2499.4581410995816,128974.37163590931,367,2,138.85294117647058,33,1,20,39.28433641975309,0.5909090909090908,48.529411764705884,1005.8823529411768,30.481283422459903,0
402,4,2,1,35,0.05555555555555555,0.027777777777777776,0.9722222222222222,36,1300,700,600,0.5384615384615384,19,7,12,349.47386446590565,0.446031746031746,0.08524836369836986,0.18398962746368466,127122.02558106571,1686.666933930429,128808.69251499615,368,0,132.08333333333334,34,2,23,39.07621099437296,0.595281862745098,47.88690476190476,1008.4523809523805,29.66036414565825,0
403,4,0,0,35,0.0,0.0,1.0,35,1100,900,200,0.8181818181818182,13,9,4,351.3424501955326,0.4447128851540616,0.07619721632460474,0.18593516184505152,127332.2066326531,1947.441893424041,129279.64852607714,369,1,132.82857142857142,34,1,20,38.813448533459145,0.5974264705882353,47.67857142857143,1009.2857142857147,29.684873949579842,0
404,4,1,1,35,0.027777777777777776,0.027777777777777776,0.9722222222222222,36,1250,700,550,0.56,18,7,11,340.55899270243367,0.4476190476190476,0.0795163937554868,0.1819022436250981,127705.45488522378,1498.248215663582,129203.70310088736,370,0,130.11111111111111,35,1,21,38.70340948127792,0.5991071428571428,47.30902777777778,1010.7638888888889,28.878968253968253,0
405,4,2,0,37,0.05405405405405406,0.0,1.0,37,1500,1100,400,0.7333333333333333,19,11,8,336.1648605308935,0.44932432432432434,0.09893682875670895,0.18191737398404653,128230.06071950313,1221.2880955279447,129451.34881503107,371,0,127.48648648648648,36,1,23,38.278528278111345,0.6024305555555556,46.79054054054053,1012.8378378378366,28.134384384384347,0
406,4,1,0,38,0.02631578947368421,0.0,1.0,38,1150,700,450,0.6086956521739131,16,7,9,329.00782437949755,0.45005037932669517,0.09536059005645603,0.17940237970882003,128533.39489073536,857.6985226223155,129391.09341335768,372,0,125.10526315789474,37,1,19,38.15059111880045,0.6036036036036037,46.491228070175424,1014.0350877192963,27.40635372214314,0
407,4,0,1,37,0.0,0.02631578947368421,0.9736842105263158,38,800,500,300,0.625,11,5,6,329.00782437949755,0.45005037932669517,0.09536059005645603,0.17940237970882003,128533.39489073536,857.6985226223155,129391.09341335768,373,1,126.10526315789474,37,1,19,38.15059111880045,0.6036036036036037,46.491228070175424,1014.0350877192963,27.40635372214314,0
408,4,1,1,37,0.02631578947368421,0.02631578947368421,0.9736842105263158,38,1000,800,200,0.8,12,8,4,327.07509586157397,0.450731981981982,0.09141154528499262,0.17934876109565903,128755.86718990437,822.5675207755964,129578.43471067997,374,0,124.02631578947368,37,1,21,37.97311653702102,0.6058558558558558,46.27192982456139,1014.9122807017527,27.430061640587912,0
409,4,0,2,35,0.0,0.05405405405405406,0.9459459459459459,37,1050,800,250,0.7619047619047619,13,8,5,334.70368113567537,0.45045045045045046,0.10030383285293976,0.1833443690403387,128715.26668137722,1216.2947153234197,129931.56139670064,375,1,127.64864864864865,36,1,21,37.82090408019826,0.607349537037037,46.31193693693693,1014.7522522522515,28.187562562562544,0
410,4,1,0,36,0.027777777777777776,0.0,1.0,36,1250,900,350,0.72,16,9,7,340.31300937007,0.44694113756613757,0.10978112175102606,0.18704421793197065,128848.62075617265,1569.7723765431851,130418.39313271584,376,0,131.5,35,1,23,37.54274965800273,0.6107142857142858,46.18055555555554,1015.2777777777762,29.007936507936463,0
411,4,0,1,35,0.0,0.027777777777777776,0.9722222222222222,36,900,600,300,0.6666666666666666,12,6,6,354.1321241356685,0.4469246031746032,0.16994676179280344,0.18559773465695362,126937.59799416091,1798.7345445394938,128736.3325387004,377,1,132.5,33,3,21,39.148197130001215,0.5956439393939394,48.06985294117647,1007.7205882352941,30.536987522281642,8
412,4,1,1,35,0.027777777777777776,0.027777777777777776,0.9722222222222222,36,1300,1100,200,0.8461538461538461,15,11,4,344.3337514924315,0.44933862433862437,0.15590505492132856,0.18197972463341983,127277.43686322571,1565.1834630911217,128842.62032631683,378,0,129.13888888888889,33,3,23,39.046433487167036,0.5991161616161615,47.7328431372549,1009.0686274509807,30.577837195484264,0
413,4,2,1,36,0.05405405405405406,0.02702702702702703,0.972972972972973,37,1100,1000,100,0.9090909090909091,12,10,2,338.19846429794757,0.4534534534534535,0.1675083773282291,0.18099052030765378,127783.1792091835,1243.2149943310444,129026.39420351454,379,0,126.48648648648648,34,3,19,38.68357274618314,0.6020220588235294,47.23214285714285,1011.0714285714271,29.73739495798315,0
414,4,2,0,38,0.05263157894736842,0.0,1.0,38,1000,600,400,0.6,14,6,8,335.0695924245962,0.45108760075865334,0.19762641898864763,0.1825839871196598,128506.3934948978,1012.2271825396602,129518.62067743746,380,0,124.07894736842105,34,4,17,38.02444131345151,0.609375,46.51785714285713,1013.9285714285702,29.821428571428534,0
415,4,1,2,37,0.02564102564102564,0.05128205128205128,0.9487179487179487,39,900,400,500,0.4444444444444444,14,4,10,326.04101192319246,0.45136077372919475,0.19827812943837642,0.17946573642497407,128907.38195516098,605.8186514060164,129513.200606567,381,0,121.87179487179488,35,4,18,37.84524352252869,0.6113095238095239,46.122685185185176,1015.5092592592575,29.014550264550216,0
416,4,0,0,37,0.0,0.0,1.0,37,1600,1300,300,0.8125,19,13,6,343.89583850539026,0.4468531031031031,0.2065389864375129,0.18802970615241865,128641.33536380227,1447.843978277568,130089.17934207983,382,1,129.35135135135135,33,4,21,37.663082870258506,0.6130050505050505,46.38480392156862,1014.4607843137245,30.741235888294682,0
417,4,0,0,37,0.0,0.0,1.0,37,1300,700,600,0.5384615384615384,19,7,12,347.3282255870253,0.44641516516516516,0.2091038406827883,0.1908002003158432,128827.88470780461,1549.1121203383223,130376.99682814293,383,2,130.35135135135135,33,4,21,37.385824078544985,0.6148989898989898,46.20098039215686,1015.1960784313718,30.76351752822339,0
418,4,1,0,38,0.02631578947368421,0.0,1.0,38,1150,800,350,0.6956521739130435,15,8,7,336.78068525397754,0.4464201043148412,0.20538145879801362,0.18704685392974468,129261.91184807237,1106.5830498865969,130368.49489795897,384,0,127.89473684210526,34,4,22,37.21196246000155,0.6170343137254901,45.77380952380951,1016.9047619047603,29.908963585434126,0
419,4,0,0,38,0.0,0.0,1.0,38,1200,900,300,0.75,15,9,6,339.0297761665249,0.4464201043148412,0.20630766009336532,0.18887538899081627,129383.00028344667,1172.9379251700698,130555.93820861675,385,1,128.89473684210526,34,4,22,37.03170099071693,0.6182598039215687,45.654761904761905,1017.3809523809521,29.92296918767506,0
420,4,0,0,38,0.0,0.0,1.0,38,1400,1100,300,0.7857142857142857,17,11,6,338.0549876767184,0.44606448553816974,0.20038829096592758,0.1893506424098868,129595.0414540816,1162.0500283446672,130757.09148242627,386,2,129.89473684210526,34,4,16,36.841118126193535,0.6204044117647058,45.44642857142857,1018.2142857142853,29.947478991596626,0
421,4,0,0,38,0.0,0.0,1.0,38,1350,1000,350,0.7407407407407407,17,10,7,337.6045396977903,0.44557550972024657,0.2058841613379241,0.1901246618298082,129807.2562358277,1164.7037981859462,130971.96003401365,387,3,130.89473684210526,34,4,18,36.63721767912773,0.6225490196078431,45.23809523809524,1019.0476190476194,29.971988795518218,0
422,4,0,2,36,0.0,0.05263157894736842,0.9473684210526316,38,1300,1100,200,0.8461538461538461,15,11,4,339.3928758837866,0.4452643432906591,0.20634627915268178,0.19142831378899758,129867.92091836738,1215.24943310658,131083.17035147396,388,4,131.89473684210526,34,4,18,36.53011368060422,0.6231617647058824,45.17857142857143,1019.2857142857146,29.978991596638664,0
423,4,0,0,36,0.0,0.0,1.0,36,900,600,300,0.6666666666666666,12,6,6,358.53340924869184,0.4404431216931217,0.2261446556009945,0.20168110720525204,129762.65889321416,2104.849697231833,131867.508590446,389,5,139.11111111111111,33,3,20,36.149366530350406,0.6243686868686869,45.28186274509804,1018.872549019608,30.87492572786691,0
424,4,0,1,35,0.0,0.027777777777777776,0.9722222222222222,36,800,600,200,0.75,10,6,4,359.2765925946543,0.4402281746031746,0.22332077840552444,0.20290712653054488,129918.78311526799,2135.3555423394637,132054.13865760746,390,6,140.11111111111111,33,3,22,35.97174640381456,0.6259469696969697,45.128676470588225,1019.4852941176456,30.893493761140775,0
425,4,0,0,35,0.0,0.0,1.0,35,1050,700,350,0.6666666666666666,14,7,7,366.98578010983425,0.4408613445378151,0.22263910519609253,0.20686516878816893,129844.0210182633,2530.181869197004,132374.2028874603,391,7,143.05714285714285,32,3,22,35.85129666336307,0.6276041666666667,45.20202020202019,1019.1919191919181,31.849747474747442,0
426,4,0,0,35,0.0,0.0,1.0,35,1000,600,400,0.6,14,6,8,368.38735059858635,0.4406862745098039,0.22031108987630765,0.20782607137542877,129876.1944731404,2568.949437557382,132445.14391069778,392,8,144.05714285714285,32,3,22,35.782856435030354,0.6279296875,45.17045454545454,1019.318181818181,31.853693181818155,0
427,4,0,0,35,0.0,0.0,1.0,35,1150,900,250,0.782608695652174,14,9,5,366.2036849759594,0.4411764705882353,0.21380639912272947,0.207275904943996,130004.92814827566,2521.656750586671,132526.58489886235,393,9,145.05714285714285,32,3,23,35.70761627667038,0.6292317708333333,45.04419191919192,1019.8232323232321,31.869476010101003,0
428,4,0,0,35,0.0,0.0,1.0,35,950,700,250,0.7368421052631579,12,7,5,366.87794088814803,0.4408263305322129,0.21663366336633705,0.2081723147736122,130101.5202530354,2546.275571370267,132647.79582440568,394,10,146.05714285714285,32,3,24,35.59225453795379,0.6302083333333333,44.94949494949495,1020.2020202020202,31.88131313131313,0
429,4,1,0,36,0.027777777777777776,0.0,1.0,36,1500,1100,400,0.7333333333333333,19,11,8,359.9606645618757,0.4416170634920635,0.2130828670397018,0.20675426600868077,130575.52984429074,2200.4108996539917,132775.94074394472,395,0,142.97222222222223,33,3,18,35.28776978417267,0.6325757575757576,44.485294117647065,1022.0588235294124,30.971479500891284,0
430,4,0,0,36,0.0,0.0,1.0,36,850,500,350,0.5882352941176471,12,5,7,371.12589678274185,0.44150132275132276,0.19742322066388085,0.2066455667158639,129361.8974626313,2416.703029340968,131778.60049197226,396,1,143.97222222222223,32,4,22,36.23686442431011,0.6227213541666667,45.675505050505045,1017.2979797979793,31.790561868686854,8
431,4,1,0,37,0.02702702702702703,0.0,1.0,37,1150,900,250,0.782608695652174,14,9,5,363.2161037470294,0.4426614114114114,0.2012496017788299,0.20431520206717213,129762.65889321423,2026.377475009625,131789.03636822387,397,0,141.05405405405406,33,4,20,36.030089808355385,0.6243686868686869,45.281862745098046,1018.8725490196085,30.874925727866923,0
432,4,0,0,37,0.0,0.0,1.0,37,1400,800,600,0.5714285714285714,20,8,12,365.7405695266275,0.4423485985985986,0.20761434511434573,0.20672293060200683,129950.01922337562,2105.5988081507185,132055.61803152633,398,1,142.05405405405406,33,4,21,35.7752403846154,0.6262626262626263,45.09803921568628,1019.6078431372549,30.897207367795602,0
433,4,0,0,37,0.0,0.0,1.0,37,900,600,300,0.6666666666666666,12,6,6,364.6045643422039,0.44178553553553557,0.19615772852232594,0.20723974111109425,130168.77710796325,2092.026053681275,132260.80316164452,399,2,143.05405405405406,33,4,21,35.581917257115414,0.6284722222222222,44.88357843137255,1020.4656862745095,30.923202614379075,0
434,4,0,0,37,0.0,0.0,1.0,37,600,400,200,0.6666666666666666,8,4,4,365.92801026032316,0.4414727227227227,0.19949690768445194,0.2083311261601599,130232.20663265289,2131.122448979573,132363.32908163246,400,3,144.05405405405406,34,3,21,35.48372988103569,0.6268382352941176,44.82142857142856,1020.7142857142843,30.021008403361304,0
435,4,0,0,37,0.0,0.0,1.0,37,750,500,250,0.6666666666666666,10,5,5,362.3365863471693,0.44078453453453453,0.18972434573058616,0.20694659177731053,130356.43029423773,2046.5843353272596,132403.01462956498,401,4,145.05405405405406,33,4,22,35.449292971718876,0.6303661616161615,44.69975490196078,1021.2009803921563,30.945484254307768,0
436,4,1,1,37,0.02631578947368421,0.02631578947368421,0.9736842105263158,38,1200,800,400,0.6666666666666666,16,8,8,349.8665986720579,0.4406264817449028,0.1898264394987932,0.2023387314258185,130840.48327664386,1555.342970521524,132395.8262471654,402,0,142.21052631578948,34,4,16,35.27751919944146,0.6329656862745099,44.22619047619047,1023.0952380952372,30.0910364145658,0
437,4,0,0,37,0.0,0.0,1.0,37,1050,700,350,0.6666666666666666,14,7,7,357.09989588561507,0.43903278278278274,0.1952991688225898,0.20627770456451425,130794.81336805562,1941.3628472222265,132736.17621527784,403,1,146.21621621621622,33,4,17,35.138747454175146,0.6347853535353536,44.270833333333336,1022.9166666666672,30.997474747474765,0
438,4,0,0,37,0.0,0.0,1.0,37,1200,800,400,0.6666666666666666,16,8,8,357.57352361145934,0.43828203203203203,0.20144359928791022,0.2070554037555955,130888.84833958097,1960.4773404459836,132849.32568002696,404,2,147.21621621621622,33,4,17,35.0314371257485,0.6357323232323233,44.17892156862745,1023.2843137254906,31.008615567439108,0
439,4,1,1,37,0.02631578947368421,0.02631578947368421,0.9736842105263158,38,750,500,250,0.6666666666666666,10,5,5,363.354313928822,0.4392780938833571,0.17942813461453389,0.20719403075571632,130293.86421388404,1869.3034229623163,132163.16763684637,405,0,144.31578947368422,33,5,20,35.48681130716601,0.6297348484848485,44.7610294117647,1020.9558823529408,30.938057040998206,7
440,4,0,2,35,0.0,0.05405405405405406,0.9459459459459459,37,1300,1200,100,0.9230769230769231,14,12,2,372.85643273887615,0.4390640640640641,0.175724135165213,0.2127939288326953,130327.04132550258,2318.655143607802,132645.69646911038,406,1,145.43243243243242,32,5,20,35.21057458472445,0.6324869791666667,44.72853535353536,1021.0858585858592,31.9089330808081,0
441,4,0,0,35,0.0,0.0,1.0,35,1250,900,350,0.72,16,9,7,387.4589884127606,0.4395658263305322,0.20165073081069607,0.2203962704673006,130198.14822785932,3089.2885611161973,133287.43678897552,407,2,153.02857142857144,32,3,21,34.968967792486275,0.6311848958333333,44.85479797979797,1020.5808080808074,31.89315025252523,0
442,4,1,1,35,0.027777777777777776,0.027777777777777776,0.9722222222222222,36,950,600,350,0.631578947368421,13,6,7,377.14537476061486,0.4398148148148148,0.18651602673009404,0.21636234657319484,130528.564453125,2645.680756029359,133174.24520915435,408,0,149.75,31,5,18,34.896364254162435,0.6370967741935484,44.53125,1021.875,32.96370967741935,0
443,4,0,1,34,0.0,0.02857142857142857,0.9714285714285714,35,1200,800,400,0.6666666666666666,16,8,8,406.15492456937176,0.43806022408963585,0.2568491943851683,0.22067851709476585,128390.74315200615,3462.12987075617,131852.87302276233,409,4,155.02857142857144,29,6,17,36.34127609519893,0.6210488505747127,46.63194444444444,1013.4722222222221,34.94731800766283,6
444,4,0,0,34,0.0,0.0,1.0,34,900,600,300,0.6666666666666666,12,6,6,407.07209357439,0.4364787581699346,0.23763835854802084,0.22215548783857975,128566.75347222228,3667.1875000000055,132233.94097222228,410,5,148.85294117647058,29,5,19,36.137359627499315,0.6228448275862069,46.458333333333336,1014.1666666666671,34.971264367816104,0
445,4,2,0,36,0.05555555555555555,0.0,1.0,36,850,500,350,0.5882352941176471,12,5,7,386.6889850334693,0.4395667989417989,0.23093612178119272,0.2147966552710809,129267.58660210509,2797.270372178831,132064.85697428393,411,0,141.52777777777777,31,5,21,35.93736662398636,0.6243279569892473,45.76822916666667,1016.9270833333338,32.804099462365606,0
446,4,0,0,36,0.0,0.0,1.0,36,1550,1200,350,0.7741935483870968,19,12,7,387.49474980484666,0.4389219576719577,0.23228024517542023,0.2157873471293847,129366.91496107317,2825.8000691731877,132192.71503024636,412,1,142.52777777777777,31,5,21,35.81544114510006,0.6253360215053764,45.67057291666667,1017.3177083333337,32.816700268817215,0
447,4,1,1,36,0.02702702702702703,0.02702702702702703,0.972972972972973,37,1050,700,350,0.6666666666666666,14,7,7,379.77454370541597,0.4415978478478479,0.23391491627952155,0.21354709359993063,129747.52456700859,2454.961387868596,132202.4859548772,413,0,139.64864864864865,32,5,17,35.6237348700789,0.6266276041666667,45.29671717171718,1018.8131313131322,31.83791035353538,0
448,4,0,0,36,0.0,0.0,1.0,36,1150,900,250,0.782608695652174,14,9,5,389.35835391267113,0.4404100529100529,0.2444039655147925,0.21866119186351946,129698.2849968805,2899.8221503363775,132598.10714721688,414,1,144.47222222222223,31,5,17,35.42984894967829,0.6286962365591398,45.345052083333336,1018.6197916666672,32.85870295698926,0
449,4,0,0,36,0.0,0.0,1.0,36,650,500,150,0.7692307692307693,8,5,3,393.07895354652965,0.440244708994709,0.24832445864394703,0.22112457307703792,129764.60986667221,3001.547410753049,132766.15727742526,415,2,145.47222222222223,31,5,17,35.26743876464323,0.6293682795698925,45.27994791666667,1018.8802083333343,32.867103494623684,0
450,4,0,0,36,0.0,0.0,1.0,36,1000,800,200,0.8,12,8,4,393.36262215274246,0.440162037037037,0.24525978910319135,0.22203575838744224,129897.3104688858,3019.3493313259737,132916.65980021178,416,3,146.47222222222223,31,5,18,35.124882913952405,0.6307123655913979,45.14973958333334,1019.401041666668,32.883904569892515,0
451,4,0,0,36,0.0,0.0,1.0,36,1150,900,250,0.782608695652174,14,9,5,397.72887622402766,0.4399470899470899,0.2509644569256515,0.2254564411243875,130063.2815890843,3145.9845648871633,133209.26615397146,417,4,147.47222222222223,31,5,18,34.84437494681303,0.6323924731182795,44.98697916666667,1020.0520833333342,32.904905913978524,0
452,4,1,0,37,0.02702702702702703,0.0,1.0,37,1350,800,550,0.5925925925925926,19,8,11,386.3959034393119,0.4411286286286286,0.23952539859102662,0.22125472432607746,130455.99819214888,2681.5326561065326,133137.5308482554,418,0,144.45945945945945,32,5,20,34.733809170683465,0.6337890625,44.602272727272734,1021.5909090909101,31.924715909090942,0
453,4,0,0,37,0.0,0.0,1.0,37,1050,900,150,0.8571428571428571,12,9,3,385.74659065060655,0.44069069069069067,0.24054955288745594,0.22198934928912328,130649.5530589992,2679.523932506903,133329.0769915061,419,1,145.45945945945945,32,5,15,34.55369272570088,0.6357421875,44.412878787878796,1022.3484848484859,31.948390151515184,0
454,4,0,0,37,0.0,0.0,1.0,37,850,500,350,0.5882352941176471,12,5,7,386.63605312200326,0.44003378378378377,0.23692515027987748,0.22343261785980528,130810.95838434852,2715.246530966228,133526.20491531474,420,2,146.45945945945945,32,5,16,34.36702871718917,0.6373697916666667,44.255050505050505,1022.9797979797979,31.968118686868685,0
455,4,1,0,38,0.02631578947368421,0.0,1.0,38,1100,700,400,0.6363636363636364,15,7,8,379.2426964641232,0.43970779990516834,0.2328749008198887,0.22103978082616038,131139.7734645328,2346.760260476732,133486.53372500953,421,0,143.57894736842104,33,5,17,34.222700805615375,0.6382575757575757,43.93382352941176,1024.2647058823525,31.03832442067735,0
456,4,0,0,38,0.0,0.0,1.0,38,950,500,450,0.5263157894736842,14,5,9,376.72258564429376,0.43915955429113324,0.23068570241534903,0.22011024029154025,131233.9323367215,2287.7572628316075,133521.68959955312,422,1,144.57894736842104,33,5,17,34.19185803133596,0.6392045454545454,43.841911764705884,1024.6323529411768,31.049465240641723,0
457,4,0,0,38,0.0,0.0,1.0,38,1100,1000,100,0.9090909090909091,12,10,2,376.72258564429376,0.43915955429113324,0.23068570241534903,0.22011024029154025,131233.9323367215,2287.7572628316075,133521.68959955312,423,2,145.57894736842104,33,5,17,34.19185803133596,0.6392045454545454,43.841911764705884,1024.6323529411768,31.049465240641723,0
458,4,0,1,37,0.0,0.02631578947368421,0.9736842105263158,38,1200,1000,200,0.8333333333333334,14,10,4,374.7526287914798,0.43904101469890944,0.2289656126929802,0.21985837955606732,131390.9388816801,2247.8199490580514,133638.75883073817,424,3,146.57894736842104,33,5,18,34.08339309905172,0.6407828282828283,43.68872549019608,1025.2450980392155,31.06803327391562,0
459,4,0,0,37,0.0,0.0,1.0,37,1500,1000,500,0.6666666666666666,20,10,10,383.6155259246385,0.43543543543543545,0.2470015279474571,0.22487902202037105,131360.48179076108,2678.384061575341,134038.86585233643,425,4,151.24324324324326,32,5,18,33.88707558402103,0.6429036458333333,43.71843434343434,1025.1262626262621,32.03519570707069,0
460,4,0,0,37,0.0,0.0,1.0,37,1250,900,350,0.72,16,9,7,386.85099171597625,0.43421546546546547,0.25043160083160076,0.2279306967144532,131554.70623214485,2778.4137141618435,134333.1199463067,426,5,152.24324324324326,32,5,14,33.6074358974359,0.6448567708333333,43.529040404040416,1025.8838383838397,32.05886994949499,0
461,4,0,0,37,0.0,0.0,1.0,37,1100,1000,100,0.9090909090909091,12,10,2,383.1175157394152,0.43346471471471476,0.24354572257659224,0.22688481576672886,131749.0741537854,2695.075598153262,134444.14975193865,427,6,153.24324324324326,32,5,15,33.50653876112,0.6468098958333333,43.33964646464647,1026.6414141414148,32.08254419191921,0
462,4,0,0,37,0.0,0.0,1.0,37,950,600,350,0.631578947368421,13,6,7,383.1175157394152,0.43346471471471476,0.24354572257659224,0.22688481576672886,131749.0741537854,2695.075598153262,134444.14975193865,428,7,154.24324324324326,32,5,15,33.50653876112,0.6468098958333333,43.33964646464647,1026.6414141414148,32.08254419191921,0
463,4,0,1,36,0.0,0.02702702702702703,0.972972972972973,37,1350,1000,350,0.7407407407407407,17,10,7,386.67467426463963,0.432494994994995,0.24579928765975256,0.23043831867157102,131988.4197934689,2807.3158460688255,134795.7356395377,429,8,155.24324324324326,33,4,16,33.173201152852315,0.646780303030303,43.106617647058826,1027.573529411765,31.13859180035652,0
464,4,0,0,36,0.0,0.0,1.0,36,1250,800,450,0.64,17,8,9,397.71886774392823,0.43275462962962963,0.24473533267781056,0.23653806344770484,131911.15702479347,3292.7112029384857,135203.86822773196,430,9,156.75,32,4,16,32.96767453294002,0.6484375,43.18181818181819,1027.272727272728,32.10227272727275,0
465,4,1,1,36,0.02702702702702703,0.02702702702702703,0.972972972972973,37,850,700,150,0.8235294117647058,10,7,3,387.8881425952901,0.4337775275275275,0.2366861618529874,0.2325112351899769,132208.88600538264,2856.451845444072,135065.3378508267,431,0,153.48648648648648,33,4,18,32.919248490626,0.648989898989899,42.892156862745104,1028.4313725490204,31.16458704694001,0
466,4,0,1,35,0.0,0.027777777777777776,0.9722222222222222,36,1150,800,350,0.6956521739130435,15,8,7,397.7708971648655,0.4317791005291005,0.24159199705413026,0.23880910089920127,132268.09007052862,3322.4793707274875,135590.5694412561,432,1,158.47222222222223,32,4,19,32.605304611104295,0.6520182291666667,42.834595959595966,1028.6616161616168,32.14567550505053,0
467,4,0,0,35,0.0,0.0,1.0,35,1200,900,300,0.75,15,9,6,418.6058499075153,0.43151260504201683,0.23802245789145382,0.23380668202151458,129483.95061728395,3888.350678502197,133372.30129578614,433,2,163.14285714285714,29,6,18,34.90436226346435,0.632183908045977,45.55555555555556,1017.7777777777777,35.09578544061303,8
468,4,0,1,34,0.0,0.02857142857142857,0.9714285714285714,35,750,400,350,0.5333333333333333,11,4,7,413.97405483122566,0.4312324929971989,0.2330749646393211,0.2317703965518503,129577.44618236211,3728.3401621574694,133305.78634451958,434,3,164.14285714285714,30,5,18,34.92656765676567,0.6302083333333333,45.46370967741935,1018.1451612903224,33.938172043010745,0
469,4,0,0,34,0.0,0.0,1.0,34,950,500,450,0.5263157894736842,14,5,9,422.39519621123554,0.4299799465240642,0.22832722342994183,0.23698729715508737,129660.70842978403,4153.612075617295,133814.32050540132,435,4,163.52941176470588,29,5,19,34.62700009091321,0.6339798850574713,45.38194444444445,1018.472222222223,35.11973180076631,0
470,4,0,0,34,0.0,0.0,1.0,34,1000,600,400,0.6,14,6,8,419.3934975218721,0.43014705882352944,0.22385732267556024,0.2361542664096683,129802.20148533964,4087.6398533950783,133889.84133873472,436,5,164.52941176470588,29,5,19,34.55871496070147,0.6354166666666667,45.243055555555564,1019.0277777777789,35.13888888888893,0
471,4,1,0,35,0.02857142857142857,0.0,1.0,35,1000,800,200,0.8,12,8,4,385.4734693596372,0.4322478991596639,0.14348920670630516,0.20520114626390284,127569.89282024806,2834.9618342516264,130404.8546544997,437,0,160.8,32,3,20,37.70778652668417,0.6044921875,47.44318181818183,1010.2272727272737,31.569602272727302,8
472,4,1,1,35,0.027777777777777776,0.027777777777777776,0.9722222222222222,36,1000,600,400,0.6,14,6,8,376.6944101935539,0.4350198412698412,0.14055791103035187,0.20231700430369468,127927.48169273837,2437.913452758548,130365.3951454969,438,0,157.30555555555554,33,3,21,37.56246214415505,0.6057449494949495,47.08946078431372,1011.6421568627451,30.6558229352347,0
473,4,1,0,36,0.027777777777777776,0.0,1.0,36,1350,1000,350,0.7407407407407407,17,10,7,372.7793557988134,0.43870701058201056,0.11006238571582228,0.20161312803150486,128206.57920030758,2358.55320069204,130565.13240099962,431,0,146.11111111111111,33,3,22,37.37546385930945,0.6085858585858586,46.81372549019608,1012.7450980392157,30.68924539512775,0
474,4,0,0,36,0.0,0.0,1.0,36,1100,900,200,0.8181818181818182,13,9,4,377.32116536371035,0.4380952380952381,0.1128474321256332,0.2051823378516274,128423.8652951991,2491.4085027393503,130915.27379793844,432,1,147.11111111111111,33,3,20,37.037918631362594,0.6107954545454546,46.59926470588236,1013.6029411764717,30.715240641711265,0
475,4,1,2,35,0.02702702702702703,0.05405405405405406,0.9459459459459459,37,950,500,450,0.5263157894736842,14,5,9,367.83674437845843,0.43997122122122123,0.123582008183861,0.20196676879041328,128808.33510487541,2076.087726757384,130884.4228316328,433,0,144.1081081081081,34,3,21,36.885285954419295,0.6124387254901961,46.2202380952381,1015.1190476190486,29.85644257703084,0
476,4,1,0,36,0.027777777777777776,0.0,1.0,36,1000,600,400,0.6,14,6,8,368.12753002687987,0.4385251322751323,0.13226029141700502,0.203021230631591,128983.44574502617,2296.4714592945293,131279.9172043207,434,0,147.36111111111111,33,3,22,36.699114288012225,0.6164772727272727,46.04779411764707,1015.8088235294135,30.78208556149738,0
477,4,0,0,36,0.0,0.0,1.0,36,1500,1100,400,0.7333333333333333,19,11,8,371.8705182174476,0.4371527777777778,0.13815261044176652,0.20687166898155612,129326.01042868134,2418.5061034217606,131744.5165321031,435,1,148.36111111111111,33,3,23,36.25451807228914,0.619949494949495,45.71078431372549,1017.1568627450986,30.82293523469996,0
478,4,1,0,37,0.02702702702702703,0.0,1.0,37,1200,700,500,0.5833333333333334,17,7,10,361.83365380195,0.4384071571571571,0.13426614969933048,0.20266949842620036,129595.04145408177,1978.369472789127,131573.41092687089,436,0,145.32432432432432,34,3,21,36.23582368759499,0.6204044117647058,45.44642857142858,1018.2142857142869,29.947478991596675,0
479,4,0,0,37,0.0,0.0,1.0,37,950,700,250,0.7368421052631579,12,7,5,359.73439643985466,0.43809434434434436,0.13268674870077546,0.20180509911757089,129655.65653344669,1928.3198696145075,131583.97640306118,437,1,146.32432432432432,34,3,21,36.2275959477888,0.6210171568627452,45.38690476190476,1018.4523809523807,29.95448179271708,0
480,4,0,0,37,0.0,0.0,1.0,37,700,600,100,0.8571428571428571,8,6,2,358.0013839466126,0.4377815315315315,0.13068117205564622,0.20098817854640535,129685.96938775519,1885.5513038548843,131571.5206916101,438,2,147.32432432432432,34,3,21,36.24089333021662,0.6213235294117647,45.35714285714286,1018.5714285714292,29.95798319327733,0
481,4,0,1,36,0.0,0.02702702702702703,0.972972972972973,37,950,500,450,0.5263157894736842,14,5,9,395.9067348645161,0.43837587587587584,0.13164542924768585,0.2179023729857699,128903.70898776577,2846.444760969156,131750.1537487349,439,3,148.32432432432432,31,6,18,36.07527140231654,0.6206317204301075,46.12630208333333,1015.4947916666661,32.75789650537632,8
482,4,0,0,36,0.0,0.0,1.0,36,950,500,450,0.5263157894736842,14,5,9,400.4253396037409,0.43617724867724866,0.1512615235322663,0.2207158491163728,128962.36423647245,3127.959699098163,132090.3239355706,440,4,153.27777777777777,30,6,18,35.90048961228002,0.6239583333333334,46.068548387096776,1015.725806451613,33.85752688172043,0
483,4,0,1,35,0.0,0.027777777777777776,0.9722222222222222,36,950,500,450,0.5263157894736842,14,5,9,400.4253396037409,0.43634259259259256,0.1512615235322663,0.2207158491163728,128962.36423647245,3127.959699098163,132090.3239355706,441,5,154.27777777777777,30,6,18,35.90048961228002,0.6239583333333334,46.068548387096776,1015.725806451613,33.85752688172043,0
484,4,1,0,36,0.027777777777777776,0.0,1.0,36,1150,1000,150,0.8695652173913043,13,10,3,395.917808910279,0.43821097883597887,0.1403868182218695,0.21993495904663535,129269.72229448504,3036.0370418545626,132305.7593363396,442,0,146.16666666666666,30,6,20,35.700557317825336,0.6270833333333333,45.76612903225807,1016.9354838709688,33.89784946236563,0
485,4,2,1,37,0.05263157894736842,0.02631578947368421,0.9736842105263158,38,850,500,350,0.5882352941176471,12,5,7,374.86283722172783,0.44053757705073493,0.1476695080941579,0.2120022600422041,129972.73875114789,2144.389921946744,132117.12867309464,443,0,139.42105263157896,32,6,18,35.51959509658245,0.62890625,45.07575757575758,1019.69696969697,31.86553030303031,0
486,4,0,0,37,0.0,0.0,1.0,37,950,500,450,0.5263157894736842,14,5,9,386.05493470504297,0.4385635635635636,0.15558755382442602,0.21754153880031507,129830.95169067406,2624.3759155273715,132455.32760620143,444,1,144.16216216216216,31,6,18,35.3787370640092,0.6300403225806452,45.214843750000014,1019.1406250000018,32.87550403225812,0
487,4,0,0,37,0.0,0.0,1.0,37,1050,500,550,0.47619047619047616,16,5,11,386.8678405869531,0.43818818818818817,0.15796593324683217,0.21892694562695234,129996.88042534735,2658.3224826389073,132655.20290798627,445,2,145.16216216216216,31,6,18,35.18896833503575,0.6317204301075269,45.05208333333334,1019.7916666666677,32.896505376344116,0
488,4,0,0,37,0.0,0.0,1.0,37,1000,500,500,0.5,15,5,10,385.04808318694046,0.4383133133133133,0.1545446390991445,0.21826821155473916,130063.2815890843,2616.1234537760506,132679.40504286037,446,3,146.16216216216216,31,6,19,35.16775168070802,0.6323924731182795,44.98697916666667,1020.0520833333342,32.904905913978524,0
489,4,0,0,37,0.0,0.0,1.0,37,1100,800,300,0.7272727272727273,14,8,6,384.18774254556325,0.4378753753753754,0.15664362678145238,0.21815182250630696,130129.69970703135,2598.847113715292,132728.54682074665,447,4,147.16216216216216,31,6,19,35.1220860983495,0.6330645161290323,44.92187500000001,1020.3125000000008,32.91330645161293,0
490,4,0,0,37,0.0,0.0,1.0,37,950,800,150,0.8421052631578947,11,8,3,382.0074968763015,0.43662412412412416,0.15444015444015458,0.21765543426673004,130262.58680555562,2552.2569444444534,132814.8437500001,448,5,148.16216216216216,31,6,20,35.04251700680272,0.6344086021505376,44.79166666666667,1020.8333333333339,32.93010752688174,0
491,4,0,1,36,0.0,0.02702702702702703,0.972972972972973,37,1000,700,300,0.7,13,7,6,382.18575829608994,0.4368430930930931,0.15703319695157458,0.21794316587633766,130295.81917656798,2559.4412909613766,132855.26046752936,449,6,149.16216216216216,31,6,20,35.00417144921991,0.634744623655914,44.759114583333336,1020.9635416666671,32.934307795698935,0
492,4,1,1,36,0.02702702702702703,0.02702702702702703,0.972972972972973,37,1350,900,450,0.6666666666666666,18,9,9,374.3595374721498,0.43615490490490494,0.1644705678277636,0.21633815781735802,130810.95838434863,2394.0659754106873,133205.02435975932,450,0,145.97297297297297,32,5,20,34.68099440467374,0.6373697916666667,44.25505050505051,1022.9797979797988,31.968118686868713,0
493,4,1,1,36,0.02702702702702703,0.02702702702702703,0.972972972972973,37,1050,700,350,0.6666666666666666,14,7,7,383.2562931610603,0.43818818818818817,0.17620008067769266,0.21047681673599208,128816.57483930209,2483.5219301601846,131300.09676946228,451,0,143.59459459459458,32,5,17,36.48554104477612,0.6171875,46.21212121212121,1015.151515151515,31.723484848484844,8
494,4,0,0,36,0.0,0.0,1.0,36,1100,900,200,0.8181818181818182,13,9,4,389.50683432595395,0.4365079365079365,0.18323380608774986,0.21356452485075159,128752.49496224875,2829.99534486277,131582.49030711153,452,1,147.97222222222223,32,4,18,36.39250020734844,0.6165364583333333,46.275252525252526,1014.89898989899,31.715593434343436,0
495,4,0,0,36,0.0,0.0,1.0,36,900,500,400,0.5555555555555556,13,5,8,390.1423544828494,0.4361111111111111,0.18362758506361665,0.21477857338162626,128912.72454660248,2858.8627754821077,131771.58732208458,453,2,148.97222222222223,32,4,19,36.21238965560114,0.6181640625,46.11742424242425,1015.5303030303038,31.735321969696994,0
496,4,1,0,37,0.02702702702702703,0.0,1.0,37,950,700,250,0.7368421052631579,12,7,5,388.02016355160407,0.4377815315315315,0.181702439766956,0.21589839869409777,129333.80126953135,2637.4702054278728,131971.2714749592,454,0,145.9189189189189,31,6,20,35.835893497183825,0.625,45.70312500000001,1017.1875000000008,32.81250000000003,0
497,4,0,0,37,0.0,0.0,1.0,37,650,500,150,0.7692307692307693,8,5,3,387.49474980484626,0.43793793793793795,0.18293142752377367,0.21578734712938474,129366.91496107331,2625.8000691732004,131992.7150302465,455,1,146.9189189189189,31,6,21,35.81544114510006,0.6253360215053764,45.67057291666668,1017.3177083333348,32.81670026881725,0
498,4,0,1,36,0.0,0.02702702702702703,0.972972972972973,37,750,400,350,0.5333333333333333,11,4,7,386.41227129775285,0.4385635635635636,0.18671646694679356,0.21554688795088792,129433.15505981455,2602.9118855794422,132036.066945394,456,2,147.9189189189189,31,6,16,35.775351887396035,0.626008064516129,45.60546875000001,1017.5781250000008,32.82510080645164,0
499,4,0,2,34,0.0,0.05555555555555555,0.9444444444444444,36,1100,800,300,0.7272727272727273,14,8,6,448.3560836929233,0.4390376984126984,0.20876060124998208,0.24072414749207482,127913.92220391173,4332.253689236116,132246.17589314785,457,3,151.75,31,5,17,35.76406766207577,0.6105510752688172,47.102864583333336,1011.5885416666671,32.63188844086023,8
500,4,1,0,35,0.02857142857142857,0.0,1.0,35,1200,800,400,0.6666666666666666,16,8,8,448.5837085478358,0.43953081232492996,0.2107759438436725,0.24161912198606633,128042.48504162343,4487.554558330457,132530.0395999539,458,0,152.37142857142857,30,5,19,35.62555334218682,0.6145833333333333,46.97580645161291,1012.0967741935494,33.73655913978498,0
501,4,1,0,36,0.027777777777777776,0.0,1.0,36,1000,900,100,0.9,11,9,2,402.40315843968824,0.4431878306878307,0.21120316902390734,0.20842285826596577,126456.23692735424,2977.277828792969,129433.51475614721,459,0,149.11111111111111,32,4,16,38.429471085446494,0.5930989583333333,48.54797979797979,1005.8080808080799,31.431502525252498,8
502,4,3,2,37,0.07692307692307693,0.05128205128205128,0.9487179487179487,39,1600,1200,400,0.75,20,12,8,373.63014356190524,0.4464968511021143,0.207662031117265,0.19812618494167147,127413.15593117694,1721.0791484481952,129134.23507962513,460,0,138.56410256410257,35,4,15,38.16789426420574,0.5961309523809524,47.59837962962962,1009.6064814814799,28.845899470899425,0
503,4,2,0,39,0.05128205128205128,0.0,1.0,39,1300,900,400,0.6923076923076923,17,9,8,370.4381105475531,0.4473403058929375,0.20870984598944342,0.19800529115803717,127734.70320001704,1663.560420953352,129398.26362097039,461,0,139.51282051282053,35,4,17,37.91838409281735,0.5994047619047619,47.28009259259259,1010.8796296296288,28.882275132275108,0
504,4,2,1,40,0.04878048780487805,0.024390243902439025,0.975609756097561,41,750,400,350,0.5333333333333333,11,4,7,356.547762071006,0.45083841463414637,0.2022721129758991,0.19324226386424262,128291.05748724725,949.6906882287569,129240.74817547601,462,0,133.65853658536585,35,6,19,37.70005045889029,0.6050595238095238,46.73032407407408,1013.0787037037051,28.94510582010586,0
505,4,0,2,38,0.0,0.05,0.95,40,1050,700,350,0.6666666666666666,14,7,7,363.1152099727985,0.45090811965811967,0.1932031708749269,0.19756715737497635,128446.04768990935,1328.1427154195078,129774.19040532886,463,1,134.675,34,6,14,37.375220199647686,0.6087622549019608,46.577380952380956,1013.6904761904766,29.814425770308134,0
506,4,2,1,39,0.05,0.025,0.975,40,1000,800,200,0.8,12,8,4,366.72204589036556,0.45146901709401704,0.18893779342723027,0.20028665583243058,128596.93877551035,1431.8664965986582,130028.805272109,464,0,135.575,34,6,16,37.12954812206573,0.6102941176470589,46.42857142857144,1014.2857142857155,29.83193277310928,0
507,4,0,0,39,0.0,0.0,1.0,39,1250,900,350,0.72,16,9,7,375.9482412360378,0.44815564552406656,0.19648001189436348,0.20555479134424848,128641.33536380247,1872.4967560553737,130513.83211985785,465,1,140.05128205128204,33,6,16,36.85018522992671,0.6130050505050505,46.38480392156863,1014.4607843137261,30.74123588829473,0
508,4,0,1,38,0.0,0.02564102564102564,0.9743589743589743,39,850,600,250,0.7058823529411765,11,6,5,334.1662523740335,0.448015069725596,0.14395714763977274,0.1766645302373872,127290.8059030313,707.2583140572895,127998.06421708858,466,2,141.05128205128204,36,3,19,39.28923483242197,0.5928819444444444,47.71959459459459,1009.1216216216208,28.031156156156133,8
509,4,0,0,38,0.0,0.0,1.0,38,1450,1100,350,0.7586206896551724,18,11,7,340.7478842691559,0.4457533191085823,0.15628282681928507,0.18003879121566663,127267.13204089493,1073.2011959876415,128340.33323688256,467,3,145.6315789473684,35,3,19,39.147453544390906,0.5946428571428571,47.74305555555555,1009.0277777777767,28.829365079365047,0
510,4,2,0,40,0.05,0.0,1.0,40,1050,900,150,0.8571428571428571,12,9,3,325.721773741961,0.4508279914529914,0.16034510781233058,0.17528199707665035,128005.79415060382,338.85486399658737,128344.6490146004,468,0,139.3,37,3,18,38.77169339401163,0.5982545045045045,47.01206140350876,1011.9517543859632,27.350047415836844,0
511,4,1,0,41,0.024390243902439025,0.0,1.0,41,1000,700,300,0.7,13,7,6,322.8513017113001,0.4523882113821138,0.1589673039587538,0.17528589563432626,128360.96871804,88.30116790853262,128449.26988594854,469,0,136.8780487804878,38,3,20,38.48225267966966,0.6000548245614035,46.66132478632478,1013.3547008547006,26.667228969860542,0
512,4,1,3,39,0.023809523809523808,0.07142857142857142,0.9285714285714286,42,1550,1100,450,0.7096774193548387,20,11,9,320.16670118326124,0.45447396438250093,0.09241478150337068,0.16459964413483893,126151.14239763665,-162.38962396816237,125988.75277366849,470,0,134.5952380952381,38,4,18,40.81055691445992,0.5775767543859649,48.85149572649572,1004.594017094016,26.43668466036884,8
513,4,4,0,43,0.09302325581395349,0.0,1.0,43,1200,600,600,0.5,18,6,12,314.9804858745663,0.45704134366925064,0.11336399559499877,0.1549013622314648,124306.52006172837,-753.5482412886288,123552.97182043974,471,0,132.1627906976744,38,5,18,42.841805942432686,0.5586622807017544,50.69444444444444,997.2222222222221,26.24269005847953,8
514,4,8,2,49,0.1568627450980392,0.0392156862745098,0.9607843137254902,51,1600,1100,500,0.6875,21,11,10,287.2793525216277,0.4646895424836601,0.19719465543050307,0.14781929826646362,126186.51446998438,-2913.6749837388707,123272.8394862455,472,0,112.27450980392157,43,8,19,41.600298460571764,0.5702519379844961,48.8162878787879,1004.7348484848521,23.36592670895005,0
515,4,2,5,46,0.0392156862745098,0.09803921568627451,0.9019607843137255,51,1800,1300,500,0.7222222222222222,23,13,10,301.53429268881007,0.4637091503267974,0.24046679543018556,0.15687753289228454,126638.85952027423,-2562.8082135272725,124076.05130674696,473,0,113.19607843137256,43,8,10,40.7788636434911,0.5748546511627908,48.366477272727295,1006.5340909090947,23.40776955602546,0
516,4,2,2,46,0.041666666666666664,0.041666666666666664,0.9583333333333334,48,1350,900,450,0.6666666666666666,18,9,9,329.9349573211939,0.46136229314420807,0.246730911724091,0.17087212310873168,126452.3651286439,-1255.7888616233536,125196.57626702054,474,0,121.125,40,8,12,40.25567512040685,0.57734375,48.55182926829269,1005.7926829268312,25.144817073170778,0
517,4,0,0,46,0.0,0.0,1.0,46,1400,1000,400,0.7142857142857143,18,10,8,336.7551865103221,0.4604367954911433,0.2400451830189454,0.17403641187526878,126365.89055309021,-689.1261916502187,125676.76436144,475,1,121.8695652173913,38,8,12,40.17306874933588,0.5797697368421053,48.63782051282052,1005.4487179487191,26.45917678812419,0
518,4,1,1,46,0.02127659574468085,0.02127659574468085,0.9787234042553191,47,1050,800,250,0.7619047619047619,13,8,5,330.0113490287596,0.4614554424915202,0.24114649625424445,0.17161300615263067,126619.79709201399,-1042.8059895833228,125576.99110243066,476,0,120.25531914893617,39,8,13,40.081849858552395,0.5806623931623931,48.38541666666667,1006.4583333333343,25.806623931623957,0
519,4,2,2,46,0.041666666666666664,0.041666666666666664,0.9583333333333334,48,1700,1100,600,0.6470588235294118,23,11,12,320.41646650407057,0.4606235224586288,0.23258380604429107,0.16806110277906383,126969.90983301778,-1463.350027792803,125506.55980522498,477,0,118.54166666666667,42,6,16,39.96450661795343,0.5796130952380952,48.03779069767442,1007.8488372093018,23.996400885935756,0
520,4,0,0,46,0.0,0.0,1.0,46,800,500,300,0.625,11,5,6,330.6300222227205,0.45883655394524964,0.22621905459907565,0.17230676644715895,126708.03098560711,-821.3041798863105,125886.7268057208,478,1,124.43478260869566,40,6,16,39.97573264694996,0.5799479166666667,48.297764227642276,1006.808943089431,25.170223577235774,0
521,4,3,1,48,0.061224489795918366,0.02040816326530612,0.9795918367346939,49,1100,900,200,0.8181818181818182,13,9,4,313.9240482536019,0.4630810657596372,0.24610682013444296,0.16692001980818605,127523.2908265759,-1790.5697524003565,125732.72107417554,479,0,117.75510204081633,38,11,9,39.562398631972385,0.5915570175438596,47.48931623931623,1010.0427350427335,26.580071974808778,0
522,4,2,0,50,0.04,0.0,1.0,50,850,400,450,0.47058823529411764,13,4,9,314.6129623128397,0.4640731292517007,0.26449021627188474,0.1687785560252857,127880.99500868037,-1953.3962673611302,125927.59874131925,480,0,116.36,39,11,11,39.179969104016465,0.593482905982906,47.13541666666666,1011.4583333333319,25.934829059829024,0
523,4,0,2,48,0.0,0.04,0.96,50,1200,600,600,0.5,18,6,12,317.1486435433248,0.4638520408163265,0.26238781391519206,0.170810211788633,128039.0842013887,-1878.5156250000216,126160.56857638869,481,1,117.36,39,11,13,38.95464525867984,0.5950854700854701,46.97916666666666,1012.0833333333318,25.95085470085466,0
524,4,0,2,46,0.0,0.041666666666666664,0.9583333333333334,48,900,600,300,0.6666666666666666,12,6,6,329.5708066038532,0.4631168735224586,0.2625036157211562,0.1761341023815024,127728.5453817518,-1180.8800544398598,126547.66532731194,482,2,123.08333333333333,37,11,13,38.957474599558886,0.5954391891891893,47.2861842105263,1010.8552631578925,27.32041251778088,0
525,4,1,5,42,0.02127659574468085,0.10638297872340426,0.8936170212765957,47,1300,900,400,0.6923076923076923,17,9,8,349.8309717315258,0.46336339808818994,0.22771276070189028,0.1792728741718874,126018.93310854441,-582.9348348135466,125435.99827373086,483,0,126.04255319148936,41,6,16,40.20178753746335,0.5713922764227642,48.983134920634924,1004.0674603174609,24.489450251645387,8
526,4,1,1,42,0.023255813953488372,0.023255813953488372,0.9767441860465116,43,1300,1000,300,0.7692307692307693,16,10,6,370.4826566073799,0.4588178294573643,0.2408368922226296,0.18861665836388739,125748.9818467383,717.5633720505612,126466.54521878886,484,0,134.69767441860466,38,5,17,39.96236330066752,0.5734649122807017,49.25213675213676,1002.9914529914533,26.39451192082772,0
527,4,5,2,45,0.10638297872340426,0.0425531914893617,0.9574468085106383,47,1150,900,250,0.782608695652174,14,9,5,342.07817969500496,0.4655411655874191,0.24681907520430313,0.17846032180850593,126750.8802625869,-727.2220756201319,126023.65818696677,485,0,122.1063829787234,39,8,15,39.64356832523015,0.5819978632478633,48.255208333333336,1006.9791666666674,25.81997863247865,0
528,4,3,1,47,0.0625,0.020833333333333332,0.9791666666666666,48,1250,800,450,0.64,17,8,9,338.4771544269363,0.4668938386524823,0.26075425404222274,0.17854197162564975,127199.76463766523,-988.2402406528574,126211.52439701237,486,0,120.5,38,10,18,39.27376791640189,0.5882675438596492,47.809829059829056,1008.7606837606833,26.546333783175875,0
529,4,2,3,46,0.04081632653061224,0.061224489795918366,0.9387755102040817,49,1250,1000,250,0.8,15,10,5,330.31586246887775,0.46671272675736963,0.2609386646297518,0.17565593135784782,127527.89680621652,-1375.1025555225053,126152.79425069402,487,0,118.95918367346938,40,9,14,39.14377703994367,0.58828125,47.484756097560975,1010.060975609756,25.2515243902439,0
530,4,1,1,46,0.02127659574468085,0.02127659574468085,0.9787234042553191,47,1700,1400,300,0.8235294117647058,20,14,6,345.61991807429433,0.4660037002775208,0.2654174094010415,0.1832466217711195,127407.31336805565,-593.0989583333236,126814.21440972232,488,0,124.44680851063829,39,8,15,38.880863942770674,0.5886752136752137,47.60416666666667,1009.5833333333342,25.886752136752158,0
531,4,2,3,45,0.041666666666666664,0.0625,0.9375,48,1200,700,500,0.5833333333333334,17,7,10,341.04073346274333,0.46535165484633567,0.2800735195605575,0.18286839328778132,127861.72251966424,-878.7888740167859,126982.93364564746,489,0,122.8125,40,8,18,38.53140909699892,0.5916666666666667,47.15447154471545,1011.3821138211383,25.28455284552846,0
532,4,1,2,44,0.021739130434782608,0.043478260869565216,0.9565217391304348,46,1250,700,550,0.56,18,7,11,374.08780507357574,0.4626308373590982,0.26066275759713853,0.19421699815993038,126553.21865361997,399.1201380328039,126952.33879165277,490,0,119.15217391304348,36,10,17,39.04145681775789,0.5853587962962963,48.451576576576585,1006.1936936936949,27.94982482482486,8
533,4,4,1,47,0.08333333333333333,0.020833333333333332,0.9791666666666666,48,1300,1000,300,0.7692307692307693,16,10,6,360.08207262501713,0.4646775265957446,0.27799333779961266,0.1896997083782153,127148.79575521492,-440.91058964366886,126707.88516557125,491,0,115.0,36,12,21,38.78126395712372,0.5914351851851851,47.860360360360374,1008.5585585585605,28.01551551551557,0
534,4,0,0,47,0.0,0.0,1.0,47,1200,900,300,0.75,15,9,6,360.0822306238181,0.4649244526672834,0.2711748381128578,0.18995163542082172,127202.60080024641,-239.32075253922568,126963.28004770719,492,1,116.57446808510639,37,10,21,38.72599637681158,0.5900900900900901,47.80701754385966,1008.7719298245629,27.264106211474672,0
535,4,2,4,45,0.04081632653061224,0.08163265306122448,0.9183673469387755,49,900,500,400,0.5555555555555556,13,5,8,350.36407615592515,0.46596867913832196,0.2828544091516054,0.1873434357627136,127749.32861328122,-848.2449001736109,126901.08371310761,493,0,112.77551020408163,39,10,19,38.410720419027996,0.5921474358974359,47.265625,1010.9374999999998,25.921474358974354,0
536,4,0,2,43,0.0,0.044444444444444446,0.9555555555555556,45,800,400,400,0.5,12,4,8,376.2157133661329,0.46355218855218855,0.27905482908924095,0.19877870237126952,127267.13204089507,575.9789737654344,127843.1110146605,494,1,121.31111111111112,35,10,20,38.2527529249828,0.5946428571428571,47.74305555555556,1009.0277777777778,28.82936507936508,0
537,4,3,2,44,0.06521739130434782,0.043478260869565216,0.9565217391304348,46,1200,700,500,0.5833333333333334,17,7,10,362.9189317346608,0.46532809983896944,0.304258364644838,0.19597622313671703,128144.53125000013,104.22935956791594,128248.76060956805,495,0,118.1086956521739,35,11,22,37.688614540466396,0.6035714285714286,46.87500000000001,1012.500000000001,28.92857142857146,0
538,4,0,1,43,0.0,0.022727272727272728,0.9772727272727273,44,950,600,350,0.631578947368421,13,6,7,368.8410231398611,0.46289200140944325,0.28850151220678244,0.19902852741544513,128115.23604948989,650.830948859737,128766.06699834962,496,1,122.45454545454545,35,9,22,37.56871403528829,0.6032738095238095,46.90393518518518,1012.3842592592594,28.925264550264554,0
539,4,1,2,42,0.022727272727272728,0.045454545454545456,0.9545454545454546,44,1750,1400,350,0.8,21,14,7,359.5928146605358,0.4620000880902044,0.2788468522688363,0.1960418574512108,128525.67361379042,443.3850951646318,128969.05870895505,497,0,122.61363636363636,35,9,19,37.38312312140928,0.6074404761904761,46.4988425925926,1014.0046296296307,28.971560846560877,0
540,4,1,0,43,0.023255813953488372,0.0,1.0,43,1350,1000,350,0.7407407407407407,17,10,7,359.3400354307636,0.46105574012550754,0.2759930402308606,0.19691833941605844,128731.13854595338,651.6503772290843,129382.78892318247,498,0,125.18604651162791,35,8,20,37.179706508515814,0.6095238095238096,46.2962962962963,1014.814814814815,28.994708994709,0
541,4,0,0,43,0.0,0.0,1.0,43,1650,1000,650,0.6060606060606061,23,10,13,359.62656147271514,0.4602943890734588,0.283792486583184,0.19809937708242803,128936.76757812512,673.8172743055702,129610.5848524307,499,1,126.18604651162791,35,8,20,36.96260683760684,0.6116071428571428,46.09375000000001,1015.6250000000009,29.017857142857167,0
542,4,0,0,43,0.0,0.0,1.0,43,1300,700,600,0.5384615384615384,19,7,12,360.40701324712893,0.4605020302694722,0.2859776447528737,0.19926785745023912,129083.74592764076,704.5374657064642,129788.28339334723,500,2,127.18604651162791,35,8,20,36.79290053151103,0.6130952380952381,45.94907407407408,1016.203703703705,29.03439153439157,0
543,4,0,0,43,0.0,0.0,1.0,43,1250,1000,250,0.8,15,10,5,360.41110795650724,0.46034053156146176,0.28807833537331673,0.19943042607648573,129115.5360385725,706.9346796120644,129822.47071818457,501,3,128.1860465116279,36,7,20,36.76038781163436,0.611400462962963,45.9177927927928,1016.3288288288301,28.23135635635639,0
544,4,0,0,43,0.0,0.0,1.0,43,1250,900,350,0.72,16,9,7,357.87312066483815,0.4600867478774455,0.28213550562781875,0.19831311603692447,129172.76810171682,645.492325095388,129818.26042681221,502,4,129.1860465116279,36,7,20,36.766552195266044,0.6119791666666667,45.8614864864865,1016.554054054056,28.237612612612665,0
545,4,1,0,44,0.022727272727272728,0.0,1.0,44,1000,600,400,0.6,14,6,8,348.15498785951195,0.4610531183932347,0.28024986709197175,0.19455719909796285,129504.14540816352,217.51234566753595,129721.65775383105,503,0,127.22727272727273,34,10,20,36.67641325536062,0.6194852941176471,45.5357142857143,1017.8571428571449,29.93697478991603,0
546,4,0,0,44,0.0,0.0,1.0,44,1950,1400,550,0.717948717948718,25,14,11,345.95304897732854,0.46075581395348836,0.2768339070933743,0.19422403458333512,129685.96938775526,173.05130385489775,129859.02069161016,504,1,128.22727272727272,34,10,21,36.5476955742559,0.6213235294117647,45.35714285714287,1018.5714285714298,29.957983193277347,0
547,4,0,2,42,0.0,0.045454545454545456,0.9545454545454546,44,1250,600,650,0.48,19,6,13,343.78902023073204,0.4608328928823115,0.2145840294019381,0.18407165251352062,127802.69870799844,-2.2354530136997255,127800.46325498474,505,2,129.22727272727272,36,8,18,38.52229275717413,0.5980902777777778,47.21283783783783,1011.1486486486478,28.08746246246244,8
548,4,1,1,42,0.023255813953488372,0.023255813953488372,0.9767441860465116,43,1400,1000,400,0.7142857142857143,18,10,8,347.746862938714,0.45891011443337026,0.22685795032692258,0.18655370381960826,127880.99500868029,294.04296874996646,128175.03797743026,506,0,132.72093023255815,35,8,19,38.34213010641948,0.6008928571428571,47.13541666666665,1011.4583333333312,28.89880952380946,0
549,4,1,0,43,0.023255813953488372,0.0,1.0,43,1400,1200,200,0.8571428571428571,16,12,4,349.31268778679805,0.4576181247692876,0.24867140002550925,0.1891822180389884,128261.7455418379,360.69101508913474,128622.43655692703,507,0,133.4418604651163,35,8,21,37.91323887873247,0.6047619047619048,46.759259259259245,1012.962962962961,28.941798941798886,0
550,4,0,0,43,0.0,0.0,1.0,43,1550,1100,450,0.7096774193548387,20,11,9,348.7619583861417,0.457687338501292,0.24583806984180945,0.18943918781817934,128379.0134173523,354.7432270232915,128733.7566443756,508,1,134.4418604651163,35,8,18,37.80740825338817,0.605952380952381,46.643518518518505,1013.4259259259239,28.9550264550264,0
551,4,0,1,42,0.0,0.023255813953488372,0.9767441860465116,43,1200,1000,200,0.8333333333333334,14,10,4,350.9127522846147,0.4574335548172757,0.24438241007079653,0.1917331272457832,128613.70991941007,426.43818587104414,129040.14810528111,509,2,135.4418604651163,35,8,18,37.5133120340788,0.6083333333333334,46.41203703703703,1014.3518518518513,28.981481481481467,0
552,4,0,0,42,0.0,0.0,1.0,42,800,600,200,0.75,10,6,4,356.9328679106062,0.45726867982965547,0.24658971098140237,0.19473510514525097,128555.01570001712,777.1020876200213,129332.11778763714,510,3,139.28571428571428,35,7,19,37.420585102335835,0.6077380952380953,46.469907407407405,1014.1203703703701,28.974867724867718,0
553,4,0,0,42,0.0,0.0,1.0,42,1400,1100,300,0.7857142857142857,17,11,6,355.61007624794655,0.45661536972512584,0.25162103460849417,0.19479649830214268,128715.26668137734,754.4891597678795,129469.75584114522,511,4,140.28571428571428,36,6,20,37.29053379203195,0.607349537037037,46.31193693693694,1014.7522522522524,28.18756256256257,0
554,4,1,1,42,0.023255813953488372,0.023255813953488372,0.9767441860465116,43,1150,800,350,0.6956521739130435,15,8,7,350.49733385484524,0.4566952750092285,0.25881850926843986,0.19341023217183656,129006.37846500824,443.27834045088423,129449.65680545912,512,0,138.0,37,6,21,37.12347094801225,0.6083896396396397,46.0252192982456,1015.8991228070157,27.456733048838263,0
555,4,0,0,42,0.0,0.0,1.0,42,750,600,150,0.8,9,6,3,354.5063805503313,0.45639759969028265,0.2571497179166464,0.19587942876335843,129058.31665702879,750.3993436003735,129808.71600062917,513,1,140.8095238095238,36,6,21,36.96871882965755,0.6108217592592593,45.97409909909911,1016.1036036036047,28.225100100100132,0
556,4,0,0,42,0.0,0.0,1.0,42,1100,700,400,0.6363636363636364,15,7,8,356.5055991360701,0.4560588463027488,0.260980120203421,0.19741976726352264,129145.65659626042,808.2299361341964,129953.88653239462,514,2,141.8095238095238,37,5,21,36.828928443006106,0.6097972972972974,45.88815789473684,1016.4473684210529,27.471550497866296,0
557,4,1,0,43,0.023255813953488372,0.0,1.0,43,1350,1100,250,0.8148148148148148,16,11,5,376.31495402103167,0.4559339239571798,0.33882893607309494,0.19978781484349267,127461.3227036158,997.9415535172851,128459.2642571331,515,0,139.48837209302326,36,7,17,38.0506300881008,0.5946180555555556,47.55067567567568,1009.7972972972975,28.04992492492493,8
558,4,1,1,43,0.022727272727272728,0.022727272727272728,0.9772727272727273,44,1150,800,350,0.6956521739130435,15,8,7,369.6793086251109,0.45674770965468636,0.34371796893479445,0.19825127574174545,127867.13219452134,653.966605109258,128521.0987996306,516,0,137.29545454545453,37,7,19,37.801749060422104,0.5968468468468469,47.14912280701754,1011.4035087719294,27.335229966808903,0
559,4,3,1,45,0.06521739130434782,0.021739130434782608,0.9782608695652174,46,1700,1000,700,0.5882352941176471,24,10,14,363.7446761816224,0.4601046698872786,0.3568430498465818,0.19939580424262646,128743.8367421475,166.87876099034364,128910.71550313784,517,0,130.84782608695653,36,10,19,37.054991492824385,0.6076388888888888,46.28378378378378,1014.8648648648644,28.19069069069068,0
560,4,0,0,45,0.0,0.0,1.0,45,1500,1000,500,0.6666666666666666,20,10,10,375.5236360488037,0.45831228956228953,0.3745133819951336,0.20578695255474452,128731.13854595339,668.3170438957494,129399.45558984914,518,1,134.75555555555556,35,10,20,36.76912256690998,0.6095238095238096,46.2962962962963,1014.8148148148151,28.994708994709004,0
561,4,1,1,45,0.021739130434782608,0.021739130434782608,0.9782608695652174,46,1700,1000,700,0.5882352941176471,24,10,14,364.28499713792877,0.4586252012882448,0.36385130697491164,0.20144351751040096,129089.93632656186,205.1054170513832,129295.04174361324,519,0,132.80434782608697,37,9,21,36.688066465256796,0.6092342342342343,45.94298245614034,1016.2280701754372,27.46562351825506,0
562,4,0,0,45,0.0,0.0,1.0,45,1000,600,400,0.6,14,6,8,364.149422198334,0.45770202020202017,0.3551912568306015,0.2019374068554396,129201.3888888888,409.91458910432965,129611.30347799313,520,1,134.86666666666667,33,12,22,36.57786885245902,0.6186868686868687,45.83333333333333,1016.666666666666,30.808080808080785,0
563,4,1,2,44,0.021739130434782608,0.043478260869565216,0.9565217391304348,46,800,600,200,0.75,10,6,4,356.18889659969557,0.4579911433172303,0.35939605334743474,0.19920021287272724,129534.44054705225,27.74589002268931,129562.18643707494,521,0,132.91304347826087,34,12,19,36.441156979690476,0.6197916666666667,45.50595238095239,1017.9761904761912,29.94047619047621,0
564,4,0,0,44,0.0,0.0,1.0,44,1250,900,350,0.72,16,9,7,358.53934069985274,0.45691287878787884,0.3400611604065691,0.20088357261463752,129606.62853529885,493.8150290753467,130100.44356437419,515,1,126.97727272727273,33,11,19,36.30789405062783,0.622790404040404,45.43504901960784,1018.259803921568,30.856357694592973,0
565,4,0,0,44,0.0,0.0,1.0,44,1550,1100,450,0.7096774193548387,20,11,9,359.35781466286943,0.4564724277660324,0.342861126603458,0.20198387513809557,129731.4453125,524.0017361111125,130255.44704861111,516,2,127.97727272727273,33,11,21,36.16010565780504,0.6240530303030303,45.3125,1018.75,30.87121212121212,0
566,4,0,0,44,0.0,0.0,1.0,44,900,600,300,0.6666666666666666,12,6,6,364.7385817307693,0.45521714235377025,0.34673295454545405,0.20615658967391284,129950.01922337548,679.5571414840235,130629.5763648595,517,3,128.97727272727272,33,11,21,35.80078125,0.6262626262626263,45.09803921568626,1019.6078431372538,30.89720736779557,0
567,4,0,0,44,0.0,0.0,1.0,44,850,400,450,0.47058823529411764,13,4,9,365.04886693695687,0.45518410852713176,0.3515896091768629,0.20670017468928675,130019.64462868468,692.7047902494188,130712.3494189341,518,4,129.97727272727272,34,10,21,35.722102252830624,0.6246936274509804,45.0297619047619,1019.8809523809514,29.996498599439747,0
568,4,0,0,44,0.0,0.0,1.0,44,900,500,400,0.5555555555555556,13,5,8,366.39301819138365,0.45508500704721633,0.35221970050481555,0.20827062015494271,130171.45691609952,738.7825963718501,130910.23951247137,519,5,130.97727272727272,34,10,22,35.533568595426985,0.6262254901960784,44.880952380952365,1020.4761904761883,30.014005602240832,0
569,4,1,0,45,0.022222222222222223,0.0,1.0,45,1150,800,350,0.6956521739130435,15,8,7,357.0278548789284,0.457723063973064,0.34431756389342083,0.20454025704746062,130475.34722222204,316.69855442174446,130792.04577664379,520,0,129.04444444444445,34,11,24,35.464246873300695,0.6292892156862745,44.58333333333332,1021.6666666666652,30.049019607843093,0
570,4,0,1,44,0.0,0.022222222222222223,0.9777777777777777,45,1200,800,400,0.6666666666666666,16,8,8,359.59747345165306,0.4572390572390572,0.3385809656885581,0.2069854626007234,130657.85147392278,396.84665532878347,131054.69812925157,521,1,130.04444444444445,34,11,18,35.21362172022978,0.6311274509803921,44.4047619047619,1022.3809523809514,30.070028011204453,0
571,4,0,0,44,0.0,0.0,1.0,44,1450,900,550,0.6206896551724138,20,9,11,370.34536310639027,0.45387376673713886,0.35183016504166864,0.21358203559936612,130732.14215986646,883.2085315743993,131615.35069144086,522,8,133.97727272727272,33,11,21,34.86356600758937,0.6341540404040404,44.33210784313726,1022.6715686274515,30.990047534165196,0
572,4,0,0,44,0.0,0.0,1.0,44,1350,800,550,0.5925925925925926,19,8,11,371.50073505683235,0.4530038759689923,0.3542896026129556,0.21512005115981622,130888.84833958093,925.0606737793172,131813.90901336024,523,9,134.97727272727272,33,11,21,34.6751497005988,0.6357323232323233,44.17892156862745,1023.2843137254903,31.0086155674391,0
573,4,0,0,44,0.0,0.0,1.0,44,1200,900,300,0.75,15,9,6,374.5241918644606,0.4528056730091614,0.36035229585451023,0.21740101283139984,130982.91710219646,1011.2542351499694,131994.17133734643,524,10,135.97727272727272,33,11,21,34.502449219841175,0.6366792929292929,44.08700980392158,1023.6519607843152,31.01975638740349,0
574,4,1,1,44,0.022222222222222223,0.022222222222222223,0.9777777777777777,45,950,600,350,0.631578947368421,13,6,7,367.3640282090433,0.45294612794612793,0.3544362883493315,0.21500386449379238,131298.46810967516,646.8668284893791,131945.33493816454,525,0,133.93333333333334,35,10,22,34.36629493694712,0.6354166666666667,43.77893518518519,1024.88425925926,29.28240740740743,0
575,4,0,0,44,0.0,0.0,1.0,44,1100,900,200,0.8181818181818182,13,9,4,375.30373845186153,0.4528387068357999,0.35575246949448003,0.21894838436462855,131175.6395266441,1046.1415816326707,132221.78110827677,526,1,137.52272727272728,34,10,22,34.28723610304088,0.6363357843137255,43.89880952380953,1024.4047619047628,30.12955182072832,0
576,4,0,0,44,0.0,0.0,1.0,44,1450,900,550,0.6206896551724138,20,9,11,371.7960691393027,0.45247533474277657,0.3445171982828885,0.21794492770499443,131359.5300635575,967.8799614208705,132327.41002497837,527,2,138.52272727272728,33,11,23,34.19094939230922,0.6404671717171717,43.71936274509805,1025.1225490196096,31.064319667260897,0
577,4,0,0,44,0.0,0.0,1.0,44,1200,700,500,0.5833333333333334,17,7,10,367.7364959886871,0.4524533121916843,0.3397483248034612,0.21624914081519064,131480.69905045364,870.0503117913945,132350.74936224503,528,3,139.52272727272728,34,10,23,34.1724704971948,0.6393995098039216,43.60119047619048,1025.595238095239,30.16456582633056,0
578,4,0,2,42,0.0,0.045454545454545456,0.9545454545454546,44,1550,1100,450,0.7096774193548387,20,11,9,373.58322462844603,0.4516605003523608,0.3431074840260644,0.22092143777410572,131694.45153061222,1039.7675736961376,132734.21910430834,529,4,140.52272727272728,34,10,18,33.80644475373076,0.6415441176470589,43.39285714285714,1026.428571428571,30.18907563025209,0
579,4,0,1,41,0.0,0.023809523809523808,0.9761904761904762,42,1500,1200,300,0.8,18,12,6,378.70957715819657,0.44985240030971735,0.32322181677636497,0.22438676360900753,131768.13755526696,1580.3711312956266,133348.5086865626,530,5,139.33333333333334,33,9,19,33.60040184610488,0.6445707070707071,43.321078431372534,1026.7156862745078,31.112596553772963,0
580,4,0,0,41,0.0,0.0,1.0,41,1650,1300,350,0.7878787878787878,20,13,7,376.02976953557487,0.4491107723577236,0.3010845280208525,0.22390863549618303,131956.93963860036,1723.9475201845223,133680.8871587849,531,6,140.9512195121951,33,8,19,33.47845101781169,0.6464646464646464,43.13725490196077,1027.4509803921555,31.134878193701685,0
581,4,1,2,40,0.023809523809523808,0.047619047619047616,0.9523809523809523,42,1050,600,450,0.5714285714285714,15,6,9,367.8390495477536,0.4487877468060395,0.2972705685305479,0.22124098157559022,132336.750637755,1335.7249149659635,133672.47555272098,532,0,138.57142857142858,34,8,22,33.305854448686766,0.6479779411764706,42.76785714285713,1028.9285714285704,30.262605042016776,0
582,4,0,0,40,0.0,0.0,1.0,40,850,500,350,0.5882352941176471,12,5,7,384.0650638123241,0.44776976495726495,0.30107734806629827,0.23018469056301552,132203.1572830579,2154.9228076216727,134358.08009067958,533,1,144.7,32,8,22,33.0233271945979,0.6513671875,42.89772727272727,1028.4090909090912,32.1377840909091,0
583,4,0,0,40,0.0,0.0,1.0,40,1250,800,450,0.64,17,8,9,383.6607709549139,0.44763621794871794,0.2983889775377442,0.2303378261584144,132268.0900705286,2149.215481838601,134417.30555236718,534,2,145.7,32,8,22,32.968168241888634,0.6520182291666667,42.834595959595966,1028.6616161616166,32.14567550505052,0
584,4,0,1,39,0.0,0.025,0.975,40,1350,900,450,0.6666666666666666,18,9,9,386.7437133653099,0.4469818376068376,0.18611823694029828,0.2205262025146871,130292.97052154191,2120.2802836393157,132413.25080518122,535,3,146.7,34,6,16,34.890731887437816,0.6274509803921569,44.76190476190476,1020.9523809523806,30.028011204481782,8
585,4,0,0,39,0.0,0.0,1.0,39,850,500,350,0.5882352941176471,12,5,7,399.61520028669634,0.44601889338731443,0.19696199881140442,0.2271396431936735,130168.77710796316,2603.4843870145955,132772.26149497775,536,4,150.87179487179486,33,6,16,34.68873844121532,0.6284722222222222,44.88357843137254,1020.4656862745088,30.923202614379054,0
586,4,0,0,39,0.0,0.0,1.0,39,1250,900,350,0.72,16,9,7,402.29114264774626,0.44534412955465585,0.1923646176616296,0.22976642163698874,130356.4302942376,2688.2474589100116,133044.6777531476,537,5,151.87179487179486,33,6,16,34.429252170086805,0.6303661616161615,44.69975490196077,1021.2009803921553,30.945484254307736,0
587,4,1,0,40,0.025,0.0,1.0,40,1450,1100,350,0.7586206896551724,18,11,7,393.0605299813656,0.4467147435897436,0.18231100045269333,0.22670253543833846,130735.62349965706,2277.4026920438937,133013.02619170095,538,0,149.05,35,5,16,34.27927418137921,0.6297619047619047,44.3287037037037,1022.6851851851851,29.219576719576718,0
588,4,1,1,40,0.024390243902439025,0.024390243902439025,0.975609756097561,41,1050,700,350,0.6666666666666666,14,7,7,386.6023929134817,0.44763719512195127,0.18321524101832165,0.2245752302860357,131010.89000740601,1929.824714917617,132940.71472232364,539,0,146.390243902439,36,5,17,34.1649708502915,0.6304976851851851,44.05968468468468,1023.7612612612609,28.4378128128128,0
589,4,0,0,40,0.0,0.0,1.0,40,1000,600,400,0.6,14,6,8,391.43221003728627,0.44676816239316236,0.19322345357910198,0.22697934644981754,130942.84664619755,2251.0495702588973,133193.89621645646,540,1,150.875,35,5,17,34.11043103773228,0.6318452380952381,44.1261574074074,1023.4953703703691,29.24272486772483,0
590,4,0,0,40,0.0,0.0,1.0,40,1150,1000,150,0.8695652173913043,13,10,3,388.4034693554417,0.44616720085470085,0.19346388606307263,0.22591752093278028,131061.33355034704,2180.9353298610918,133242.26888020814,541,2,151.875,35,5,17,34.067692438114605,0.6330357142857144,44.01041666666666,1023.9583333333319,29.25595238095234,0
591,4,0,0,40,0.0,0.0,1.0,40,1600,1400,200,0.875,18,14,4,391.1375753320669,0.44606036324786325,0.19887275398350113,0.2278588811134601,131120.59709630048,2257.238484867957,133377.83558116845,542,3,152.875,35,5,17,33.937568275134666,0.6336309523809525,43.95254629629629,1024.189814814814,29.262566137566118,0
592,4,0,0,40,0.0,0.0,1.0,40,1000,700,300,0.7,13,7,6,391.1375753320669,0.44606036324786325,0.19887275398350113,0.2278588811134601,131120.59709630048,2257.238484867957,133377.83558116845,543,4,153.875,35,5,17,33.937568275134666,0.6336309523809525,43.95254629629629,1024.189814814814,29.262566137566118,0
593,4,2,2,40,0.047619047619047616,0.047619047619047616,0.9523809523809523,42,500,200,300,0.4,8,2,6,375.5587848140857,0.44824332171893144,0.19324823792332801,0.2213399646670251,131565.50068587108,1482.4441122256521,133047.94479809672,544,0,147.5,35,7,14,33.88613116726835,0.638095238095238,43.51851851851852,1025.925925925926,29.312169312169317,0
594,4,0,0,40,0.0,0.0,1.0,40,1050,600,450,0.5714285714285714,15,6,9,389.3743763232869,0.445446047008547,0.20159286037053725,0.227357650343914,131209.51753257887,2217.9248113854596,133427.44234396433,545,6,155.875,35,5,17,33.89252899533063,0.6345238095238095,43.86574074074074,1024.5370370370372,29.272486772486776,0
595,4,0,1,39,0.0,0.025,0.975,40,800,400,400,0.5,12,4,8,392.2070717531639,0.4448584401709402,0.200931361481147,0.23007749944301478,131387.44882758896,2306.2173139574543,133693.66614154642,546,7,156.875,35,5,17,33.63955369910438,0.6363095238095238,43.69212962962962,1025.23148148148,29.292328042328,0
596,4,0,0,39,0.0,0.0,1.0,39,1250,1000,250,0.8,15,10,5,391.18234815984124,0.44466936572199733,0.18995945934214764,0.23001106748801273,131476.45968632106,2486.254045567548,133962.71373188862,547,8,155.07692307692307,35,4,19,33.57561693563556,0.637202380952381,43.60532407407407,1025.578703703703,29.302248677248656,0
597,4,0,1,38,0.0,0.02564102564102564,0.9743589743589743,39,1150,900,250,0.782608695652174,14,9,5,391.1903701186039,0.4441351776878093,0.1868119474976362,0.23109160638518708,131654.57182623874,2500.4001361025203,134154.97196234125,548,9,156.07692307692307,35,4,15,33.39500864629149,0.6389880952380953,43.431712962962955,1026.2731481481471,29.322089947089918,0
598,4,0,0,38,0.0,0.0,1.0,38,1550,1400,150,0.9032258064516129,17,14,3,395.4688045792482,0.4430417259364628,0.1754969244366409,0.23471536475128216,131832.8045294282,2827.152322316534,134659.95685174473,549,10,157.02631578947367,35,3,15,33.104760697246334,0.6407738095238096,43.258101851851855,1026.9675925925928,29.341931216931226,0
599,4,0,0,38,0.0,0.0,1.0,38,1150,800,350,0.6956521739130435,15,8,7,394.7944712662228,0.44197486960644855,0.16863859728158093,0.23541840902436467,132011.1577958889,2823.455048653963,134834.61284454286,550,11,158.02631578947367,35,3,15,32.94160847693059,0.6425595238095239,43.08449074074073,1027.6620370370358,29.361772486772452,0
600,4,0,1,37,0.0,0.02631578947368421,0.9736842105263158,38,1100,700,400,0.6363636363636364,15,7,8,398.64746260659086,0.44153034613560926,0.1744520876659732,0.23846366399557878,132130.1269531249,2934.667968749985,135064.79492187488,551,12,159.02631578947367,35,3,16,32.722264437689965,0.64375,42.96874999999999,1028.1249999999993,29.374999999999982,0
601,4,1,2,36,0.02631578947368421,0.05263157894736842,0.9473684210526316,38,1250,900,350,0.72,16,9,7,398.13797964234766,0.44107100521574205,0.17760494353292122,0.2398538560284389,132398.0034722223,2942.805989583338,135340.80946180565,552,0,159.6578947368421,34,4,17,32.464574898785415,0.6485906862745099,42.708333333333336,1029.1666666666672,30.26960784313727,0
602,4,0,0,36,0.0,0.0,1.0,36,900,600,300,0.6666666666666666,12,6,6,415.46445341289206,0.4387731481481481,0.2032358860290222,0.24904126378864222,132208.88600538255,3785.6185121107246,135994.50451749327,553,1,168.11111111111111,33,3,18,32.21023991102636,0.648989898989899,42.8921568627451,1028.4313725490197,31.16458704693999,0
603,4,0,0,36,0.0,0.0,1.0,36,750,600,150,0.8,9,6,3,419.78598802859585,0.4387731481481481,0.20630476795594732,0.2520517584772555,132271.9101427335,3905.178897539402,136177.08904027293,554,2,169.11111111111111,33,3,18,32.0352831387499,0.6496212121212122,42.830882352941174,1028.676470588235,31.172014260249544,0
604,4,0,1,35,0.0,0.027777777777777776,0.9722222222222222,36,950,800,150,0.8421052631578947,11,8,3,425.03838022984894,0.43842592592592594,0.2116926680163549,0.2558456830673866,132366.47450800182,4052.166384323343,136418.64089232517,555,3,170.11111111111111,33,3,18,31.804389464491287,0.6505681818181819,42.7389705882353,1029.0441176470595,31.183155080213922,0
605,4,0,0,35,0.0,0.0,1.0,35,1300,900,400,0.6923076923076923,17,9,8,431.903489649068,0.4369747899159664,0.22764603817235396,0.26019551693492643,132398.0034722223,4436.635699010001,136834.6391712323,556,4,174.68571428571428,31,4,18,31.595816464237505,0.6559139784946236,42.708333333333336,1029.1666666666672,33.198924731182814,0
606,4,0,0,35,0.0,0.0,1.0,35,1000,700,300,0.7,13,7,6,432.2960562997355,0.43623949579831933,0.22740067571229838,0.26112795394667754,132498.52710300026,4455.718146430127,136954.2452494304,557,5,175.68571428571428,31,4,18,31.483838160279912,0.6569220430107527,42.610677083333336,1029.557291666667,33.211525537634415,0
607,4,0,0,35,0.0,0.0,1.0,35,1150,800,350,0.6956521739130435,15,8,7,432.01623624700653,0.43504901960784315,0.2281524820773968,0.26189122183525443,132632.61795043957,4459.88888210722,137092.5068325468,558,6,176.68571428571428,31,4,16,31.35520688492816,0.658266129032258,42.48046875000001,1030.078125000001,33.22832661290325,0
608,4,0,0,35,0.0,0.0,1.0,35,1050,800,250,0.7619047619047619,13,8,5,430.77492457477126,0.4350140056022409,0.22683807597862216,0.26137202478800553,132666.15125868062,4429.850260416676,137096.0015190973,559,7,177.68571428571428,31,4,16,31.35321873946748,0.6586021505376345,42.44791666666667,1030.208333333334,33.23252688172045,0
609,4,0,0,35,0.0,0.0,1.0,35,1050,600,450,0.5714285714285714,15,6,9,426.3638292610552,0.4343137254901961,0.21859610437339239,0.25953825042938056,132788.1262913223,4323.2108011937535,137111.33709251604,560,8,178.68571428571428,32,3,16,31.343409285801787,0.6572265625,42.32954545454545,1030.681818181818,32.20880681818181,0
610,4,0,0,35,0.0,0.0,1.0,35,900,700,200,0.7777777777777778,11,7,4,424.59289403451214,0.43392857142857144,0.21597410550258056,0.2589097072286627,132853.20255905017,4281.705151260084,137134.90771031025,561,9,179.68571428571428,32,3,16,31.323229230455194,0.6578776041666667,42.266414141414145,1030.934343434344,32.21669823232325,0
611,4,0,0,35,0.0,0.0,1.0,35,900,400,500,0.4444444444444444,14,4,10,421.8032506770739,0.43333333333333335,0.2105826584337671,0.257656480798778,132918.29476902867,4213.073761605963,137131.36853063462,562,10,180.68571428571428,32,3,16,31.32933349659198,0.6585286458333333,42.20328282828283,1031.1868686868688,32.22458964646465,0
612,4,1,0,36,0.027777777777777776,0.0,1.0,36,850,500,350,0.5882352941176471,12,5,7,414.54276615720084,0.43373015873015874,0.20686926242481807,0.25527107179153974,133219.07439446382,3845.000720876605,137064.07511534044,563,0,176.63888888888889,33,3,17,31.212903608736944,0.6590909090909092,41.91176470588236,1032.3529411764719,31.283422459893085,0
613,4,0,1,35,0.0,0.027777777777777776,0.9722222222222222,36,1150,700,450,0.6086956521739131,16,7,9,414.6409663323016,0.43341600529100527,0.20596165763485108,0.25598384053350237,133313.97667063161,3855.487222462529,137169.46389309416,564,1,177.63888888888889,33,3,18,31.11464637474784,0.6600378787878788,41.81985294117648,1032.720588235295,31.294563279857424,0
614,4,0,0,35,0.0,0.0,1.0,35,900,700,200,0.7777777777777778,11,7,4,422.5947230357017,0.4302871148459384,0.21433637904226166,0.2604036963272745,133243.9949526834,4261.641828639934,137505.63678132332,565,2,183.37142857142857,32,3,19,30.97993355346296,0.6617838541666667,41.88762626262626,1032.449494949495,32.264046717171716,0
615,4,0,0,35,0.0,0.0,1.0,35,550,300,250,0.5454545454545454,8,3,5,422.5001895104673,0.42990196078431375,0.213103243498157,0.2608021924532914,133309.18281616675,4264.631000663194,137573.81381682993,566,3,184.37142857142857,32,3,19,30.91657496841504,0.6624348958333333,41.82449494949495,1032.7020202020203,32.271938131313135,0
616,4,0,0,35,0.0,0.0,1.0,35,850,500,350,0.5882352941176471,12,5,7,422.6076271066433,0.4287464985994398,0.2125222614100637,0.2615563997720541,133406.99450311193,4275.762677277827,137682.75718038974,567,4,185.37142857142857,32,3,19,30.815102256986886,0.6634114583333333,41.72979797979798,1033.080808080808,32.28377525252525,0
617,4,0,0,35,0.0,0.0,1.0,35,1250,1000,250,0.8,15,10,5,423.0164428291543,0.4273809523809524,0.21324399309009068,0.2629639800639549,133570.0936926079,4300.469180440767,137870.56287304865,568,5,186.37142857142857,32,3,19,30.640039086356424,0.6650390625,41.571969696969695,1033.712121212121,32.30350378787878,0
618,4,0,0,35,0.0,0.0,1.0,35,1150,800,350,0.6956521739130435,15,8,7,423.0164428291543,0.4273809523809524,0.21324399309009068,0.2629639800639549,133570.0936926079,4300.469180440767,137870.56287304865,569,6,187.37142857142857,32,3,19,30.640039086356424,0.6650390625,41.571969696969695,1033.712121212121,32.30350378787878,0
619,4,0,1,34,0.0,0.02857142857142857,0.9714285714285714,35,950,800,150,0.8421052631578947,11,8,3,424.49702389546667,0.4266456582633053,0.21527671156396133,0.2641171452626202,133602.72548719522,4342.7918707274775,137945.51735792268,570,7,188.37142857142857,32,3,19,30.568871112196703,0.6653645833333333,41.54040404040404,1033.838383838384,32.3074494949495,0
620,4,0,1,33,0.0,0.029411764705882353,0.9705882352941176,34,1250,1000,250,0.8,15,10,5,433.82418983545335,0.42543077837195487,0.23244518868134234,0.26970479585776547,133573.15275404195,4789.4529554579085,138362.60570949985,571,8,193.11764705882354,31,3,19,30.357648948230256,0.6676747311827957,41.56901041666667,1033.723958333334,33.345934139784966,0
621,4,0,1,32,0.0,0.030303030303030304,0.9696969696969697,33,1000,600,400,0.6,14,6,8,444.5654510877835,0.4250315656565657,0.23578744920922046,0.275888922793702,133506.94670265348,5270.515196843565,138777.46189949705,572,9,197.3030303030303,30,3,19,30.14696319417349,0.6697916666666667,41.63306451612903,1033.467741935484,34.4489247311828,0
622,4,0,0,32,0.0,0.0,1.0,32,600,500,100,0.8333333333333334,7,5,2,447.12539021852257,0.42439516129032256,0.23059475806451601,0.2772177419354839,133472.22222222216,5535.763888888885,139007.98611111104,573,10,201.125,29,3,19,30.115927419354826,0.6724137931034483,41.666666666666664,1033.333333333333,35.63218390804597,0
623,4,0,0,32,0.0,0.0,1.0,32,1000,600,400,0.6,14,6,8,442.6358399928859,0.42389112903225806,0.2286908919935522,0.2755000997413911,133615.77932098744,5428.626543209848,139044.4058641973,574,11,202.125,29,3,19,30.086870857961667,0.6738505747126438,41.527777777777764,1033.888888888887,35.65134099616852,0
624,4,0,0,32,0.0,0.0,1.0,32,1350,1200,150,0.8888888888888888,15,12,3,450.49145303650863,0.42324008736559143,0.2344316351188085,0.28175573750369004,133795.33420138864,5654.730902777744,139450.0651041664,575,12,203.125,29,3,18,29.70239293864948,0.6756465517241379,41.35416666666665,1034.5833333333312,35.67528735632177,0
625,4,0,1,31,0.0,0.03125,0.96875,32,1150,900,250,0.782608695652174,14,9,5,452.08770075198606,0.42261004704301075,0.22950909029920896,0.28385927832388774,133939.06491126522,5710.440779320958,139649.50569058617,576,13,204.125,29,3,18,29.515938771859208,0.6770833333333333,41.215277777777764,1035.138888888887,35.694444444444386,0
626,4,0,0,31,0.0,0.0,1.0,31,1100,900,200,0.8181818181818182,13,9,4,462.7071158994813,0.4220878136200717,0.2217266103281339,0.2900678290534344,133880.81989447074,6189.521609525677,140070.34150399643,577,14,199.29032258064515,28,3,18,29.3000023138507,0.6796875,41.27155172413792,1034.9137931034472,36.96120689655169,0
627,4,0,1,30,0.0,0.03225806451612903,0.967741935483871,31,900,600,300,0.6666666666666666,12,6,6,461.1673306907217,0.42110215053763445,0.21931006693380506,0.2896870634373712,133955.17747142943,6155.150325340188,140110.32779676962,578,15,200.29032258064515,28,3,18,29.264688873467495,0.6804315476190477,41.199712643678154,1035.2011494252865,36.97146962233166,0
628,4,0,0,30,0.0,0.0,1.0,30,900,600,300,0.6666666666666666,12,6,6,461.1905196035408,0.4189655172413793,0.20157276343787567,0.2899946670386662,133992.36400118907,6359.20159532303,140351.5655965121,579,16,199.03333333333333,28,2,18,29.22651262836526,0.6808035714285714,41.16379310344828,1035.344827586207,36.97660098522168,0
629,4,0,0,30,0.0,0.0,1.0,30,650,300,350,0.46153846153846156,10,3,7,461.8497860903275,0.41834291187739464,0.20312196475648658,0.2907031797688199,134029.55569180197,6380.304325208062,140409.86001701004,580,17,200.03333333333333,28,2,18,29.1718699412608,0.6811755952380952,41.12787356321838,1035.4885057471254,36.98173234811162,0
630,4,0,0,30,0.0,0.0,1.0,30,1100,900,200,0.8181818181818182,13,9,4,452.6888855465112,0.4174568965517242,0.19842061512884435,0.2634863727256584,131087.1402221355,5868.338283327551,136955.47850546305,581,18,201.03333333333333,30,0,19,32.395710285689276,0.6454861111111111,43.98521505376344,1024.0591397849462,34.1353046594982,8
631,4,0,0,30,0.0,0.0,1.0,30,1050,800,250,0.7619047619047619,13,8,5,447.4849626545046,0.4165229885057471,0.19457994579945792,0.26209833526906695,131328.125,5753.472222222224,137081.59722222222,582,19,202.03333333333333,30,0,20,32.28319783197831,0.6479166666666667,43.75,1025.0,34.166666666666664,0
632,4,0,0,30,0.0,0.0,1.0,30,900,700,200,0.7777777777777778,11,7,4,447.5486456520382,0.4169300766283525,0.19794152353481054,0.2623715234733356,131362.56946251012,5758.228010463642,137120.79747297376,583,20,203.03333333333333,30,0,20,32.24645994493248,0.6482638888888889,43.71639784946237,1025.1344086021506,34.17114695340502,0
633,4,0,0,30,0.0,0.0,1.0,30,1100,900,200,0.8181818181818182,13,9,4,434.4841278886333,0.4169300766283525,0.13116100766703198,0.23753533458821674,128637.19135802462,5182.228356521622,133819.41971454624,584,21,204.03333333333333,29,1,16,35.36988864549106,0.6235632183908046,46.388888888888886,1014.4444444444439,34.980842911877374,8
634,4,0,0,30,0.0,0.0,1.0,30,950,600,350,0.631578947368421,13,6,7,441.2196904128283,0.4159243295019157,0.13683634373289588,0.24207458690217312,128778.12499999985,5363.888888888873,134142.01388888873,585,22,205.03333333333333,29,1,16,35.0540503557745,0.625,46.24999999999999,1014.9999999999989,34.99999999999996,0
635,4,1,0,31,0.03225806451612903,0.0,1.0,31,750,500,250,0.6666666666666666,10,5,5,427.82991797542076,0.4226254480286738,0.12487625874722652,0.23643232309167975,129064.77627471375,4843.554529425356,133908.3308041391,586,0,199.38709677419354,30,1,17,35.099481922398596,0.625,45.967741935483865,1016.1290322580638,33.87096774193546,0
636,4,0,1,30,0.0,0.03225806451612903,0.967741935483871,31,400,300,100,0.75,5,3,2,424.0603342440571,0.4218189964157706,0.11862367866497214,0.23475433730260298,129133.07354896505,4752.042866227291,133885.11641519234,587,1,200.38709677419354,30,1,17,35.12518734020982,0.6256944444444444,45.90053763440859,1016.3978494623643,33.879928315412144,0
637,4,0,1,29,0.0,0.03333333333333333,0.9666666666666667,30,750,600,150,0.8,9,6,3,433.5756377492685,0.42109674329501917,0.11235647895024603,0.23958001252066813,129060.22376543198,5191.4737654320825,134251.69753086407,588,2,200.4,29,1,18,34.95819664661928,0.6278735632183908,45.972222222222214,1016.1111111111102,35.03831417624518,0
638,4,0,0,29,0.0,0.0,1.0,29,700,400,300,0.5714285714285714,10,4,6,443.47469346191383,0.4197454844006568,0.12740127742835794,0.24389382557940437,128872.93411035149,5630.376990025113,134503.3111003766,589,3,207.44827586206895,28,1,18,34.89929720296214,0.6290922619047619,46.156609195402304,1015.3735632183913,36.263341543513974,0
639,4,1,1,29,0.03333333333333333,0.03333333333333333,0.9666666666666667,30,800,700,100,0.875,9,7,2,432.27103101181456,0.42157567049808425,0.13681048607318358,0.24057393853575465,129342.63117283958,5182.214506172853,134524.84567901245,590,0,201.5,29,1,20,34.70155197524121,0.6307471264367817,45.69444444444445,1017.2222222222229,35.076628352490445,0
640,4,1,0,30,0.03333333333333333,0.0,1.0,30,450,300,150,0.6666666666666666,6,3,3,427.41631382312374,0.4226053639846743,0.15498431746897556,0.23980442458033413,129660.70842978402,5083.82040895063,134744.52883873464,591,0,199.16666666666666,29,1,17,34.49915337060776,0.6339798850574713,45.38194444444445,1018.4722222222229,35.1197318007663,0
641,4,1,0,31,0.03225806451612903,0.0,1.0,31,1450,1300,150,0.896551724137931,16,13,3,411.8777964066296,0.42477598566308244,0.1483420519205687,0.23384924102638183,130125.41415553824,4519.15376777663,134644.56792331487,592,0,193.70967741935485,30,1,19,34.42014666491021,0.6357638888888889,44.92607526881721,1020.2956989247314,34.00985663082438,0
642,4,0,0,31,0.0,0.0,1.0,31,400,300,100,0.75,5,3,2,413.0075360786854,0.4242383512544803,0.14957170536048126,0.23469709684950443,130159.7005434154,4551.3874436351,134711.0879870505,593,1,194.70967741935485,30,1,19,34.35634000702493,0.6361111111111111,44.89247311827957,1020.4301075268814,34.014336917562716,0
643,4,0,1,30,0.0,0.03225806451612903,0.967741935483871,31,850,700,150,0.8235294117647058,10,7,3,413.6609745939191,0.4237903225806452,0.15378538512179052,0.2356905552918843,130262.58680555562,4576.909722222233,134839.49652777784,594,2,195.70967741935485,30,1,19,34.23469387755102,0.6371527777777778,44.79166666666667,1020.8333333333339,34.0277777777778,0
644,4,0,0,30,0.0,0.0,1.0,30,1200,1100,100,0.9166666666666666,13,11,2,420.9912536443149,0.41738505747126436,0.16095238095238118,0.23986710963455146,130262.58680555552,4967.881944444439,135230.46874999997,595,3,202.96666666666667,29,1,21,34.047619047619044,0.6400862068965517,44.791666666666664,1020.833333333333,35.20114942528735,0
645,4,0,0,30,0.0,0.0,1.0,30,850,600,250,0.7058823529411765,11,6,5,446.2261671834109,0.41767241379310344,0.19296585767174035,0.24159817648616286,128250.0217013888,5463.064236111103,133713.0859374999,596,4,203.96666666666667,29,1,19,35.47108528726176,0.6196120689655172,46.77083333333333,1012.916666666666,34.928160919540204,8
646,4,0,0,30,0.0,0.0,1.0,30,800,600,200,0.75,10,6,4,443.6050195562205,0.4172174329501916,0.19646478487256824,0.24123915295985784,128425.93557098744,5394.077932098738,133820.01350308617,597,5,204.96666666666667,29,1,17,35.356147803051066,0.6214080459770115,46.59722222222221,1013.6111111111093,34.95210727969342,0
647,4,2,0,32,0.0625,0.0,1.0,32,1000,700,300,0.7,13,7,6,417.9608580547386,0.4246471774193548,0.18241111467008353,0.23119663338888963,129102.12410820847,4391.926913791224,133494.0510219997,598,0,193.09375,31,1,19,35.31189942344652,0.6226478494623655,45.93098958333333,1016.276041666666,32.78309811827955,0
648,4,0,1,31,0.0,0.03125,0.96875,32,600,200,400,0.3333333333333333,10,2,8,415.6899455807898,0.42439516129032256,0.1777771551172025,0.23032586267915015,129168.29639010956,4338.79241943359,133507.08880954314,599,1,194.09375,31,1,20,35.30178579052986,0.6233198924731183,45.865885416666664,1016.536458333333,32.79149865591397,0
649,4,1,0,32,0.03125,0.0,1.0,32,750,400,350,0.5333333333333333,11,4,7,418.5586054670837,0.42605426747311825,0.18693996415770586,0.23289030099065944,129333.80126953128,4426.7550998263905,133760.55636935768,600,0,194.84375,31,1,21,35.05931046253625,0.625,45.703125,1017.1875000000002,32.81250000000001,0
650,4,0,0,32,0.0,0.0,1.0,32,600,300,300,0.5,9,3,6,417.481594237771,0.425760248655914,0.18512445610442763,0.23268196700242116,129400.0328911676,4404.426405164935,133804.45929633253,601,1,195.84375,31,1,21,35.01887637573585,0.6256720430107527,45.638020833333336,1017.4479166666672,32.82090053763442,0
651,4,1,0,33,0.030303030303030304,0.0,1.0,33,950,600,350,0.631578947368421,13,6,7,404.19429882869355,0.4294902146464647,0.1762976148897577,0.22727831339712407,129747.52456700857,3888.641943424152,133636.16651043273,602,0,190.87878787878788,32,1,19,35.001755690502755,0.6266276041666667,45.29671717171718,1018.8131313131321,31.837910353535378,0
652,4,1,1,33,0.029411764705882353,0.029411764705882353,0.9705882352941176,34,750,600,150,0.8,9,6,3,393.6133769819262,0.42996137849079025,0.17806356360245612,0.22372823140808865,130168.77710796325,3447.23438701461,133616.01149497787,603,0,186.23529411764707,33,1,20,34.84185480965534,0.6284722222222222,44.88357843137255,1020.4656862745095,30.923202614379075,0
653,4,0,0,33,0.0,0.0,1.0,33,800,500,300,0.625,11,5,6,402.59386529575454,0.42775410353535354,0.19007957499971884,0.2278732060261955,130004.92814827577,3867.837306142242,133872.765454418,604,1,192.72727272727272,32,1,21,34.779827493706414,0.6292317708333333,45.044191919191924,1019.8232323232329,31.869476010101028,0
654,4,0,0,33,0.0,0.0,1.0,33,1000,700,300,0.7,13,7,6,398.90421282227237,0.4272411616161616,0.18620612061206132,0.2263445252530872,130101.52025303547,3779.6089047036144,133881.12915773908,605,2,193.72727272727272,32,1,21,34.77542285478549,0.6302083333333333,44.949494949494955,1020.2020202020208,31.88131313131315,0
655,4,0,0,33,0.0,0.0,1.0,33,1150,600,550,0.5217391304347826,17,6,11,398.1737303992645,0.4266887626262626,0.18692492857303522,0.2263038037332532,130165.93491735557,3765.7311753902895,133931.66609274584,606,3,194.72727272727272,32,1,21,34.72840880970057,0.630859375,44.88636363636365,1020.4545454545471,31.889204545454596,0
656,4,1,1,33,0.029411764705882353,0.029411764705882353,0.9705882352941176,34,850,500,350,0.5882352941176471,12,5,7,387.9728015912128,0.4297014260249554,0.1788936464380697,0.22266381228280252,130544.21864487203,3329.5212478373546,133873.7398927094,607,0,189.97058823529412,33,1,17,34.60384438581765,0.632260101010101,44.51593137254901,1021.9362745098028,30.96776589423645,0
657,4,0,0,33,0.0,0.0,1.0,33,750,600,150,0.8,9,6,3,395.6278465368606,0.4261363636363636,0.18028973128490966,0.2261649223064783,130391.51178770038,3717.3026030507262,134108.8143907511,608,5,196.72727272727272,32,1,22,34.56365640581861,0.6331380208333333,44.66540404040405,1021.338383838385,31.91682449494953,0
658,4,0,1,32,0.0,0.030303030303030304,0.9696969696969697,33,950,600,350,0.631578947368421,13,6,7,394.4233849276777,0.425189393939394,0.18321108028262367,0.2262273886760947,130520.50053884815,3696.067524997459,134216.5680638456,609,6,197.72727272727272,32,1,20,34.4631677581449,0.6344401041666667,44.53914141414142,1021.843434343435,31.932607323232343,0
659,4,0,0,32,0.0,0.0,1.0,32,950,500,450,0.5263157894736842,14,5,9,397.92673130755793,0.423828125,0.1617754777070064,0.22867678190075635,130595.10125054259,3993.4563530816013,134588.55760362418,610,7,192.4375,31,1,20,34.29777070063694,0.637768817204301,44.466145833333336,1022.1354166666671,32.972110215053775,0
660,4,1,0,33,0.030303030303030304,0.0,1.0,33,1150,900,250,0.782608695652174,14,9,5,390.6055863017493,0.42621527777777773,0.154303269498139,0.2268646198950275,131004.77629833692,3634.2394908682827,134639.0157892052,611,0,187.57575757575756,32,1,21,34.06871813846408,0.6393229166666667,44.06565656565657,1023.7373737373739,31.991792929292934,0
661,4,0,0,33,0.0,0.0,1.0,33,1000,800,200,0.8,12,8,4,389.96010105924984,0.426333648989899,0.1507191784661266,0.2266800329383123,131037.09323347113,3619.847623966951,134656.94085743808,612,1,188.57575757575756,32,1,21,34.05244173140956,0.6396484375,44.034090909090914,1023.8636363636367,31.995738636363647,0
662,4,0,1,32,0.0,0.030303030303030304,0.9696969696969697,33,1100,900,200,0.8181818181818182,13,9,4,390.6113231329433,0.4259390782828283,0.1513134301595842,0.22763211589471544,131134.06795224987,3644.4903581267313,134778.5583103766,613,2,189.57575757575756,32,1,22,33.93737672583827,0.640625,43.939393939393945,1024.242424242425,32.00757575757578,0
663,4,0,1,31,0.0,0.03125,0.96875,32,1150,900,250,0.782608695652174,14,9,5,409.6322604718009,0.42019489247311825,0.12472118959107781,0.23052526792241532,129779.68606519754,4232.38923324152,134012.07529843907,614,3,196.15625,32,0,19,34.830390334572485,0.626953125,45.26515151515152,1018.9393939393949,31.84185606060609,8
664,4,1,0,32,0.03125,0.0,1.0,32,750,500,250,0.6666666666666666,10,5,5,407.84354574960787,0.4204469086021505,0.1541388270230144,0.2317996861285746,130165.93491735541,4217.4672865013845,134383.4022038568,615,0,197.03125,32,0,20,34.48171863400149,0.630859375,44.88636363636364,1020.4545454545457,31.889204545454554,0
665,4,0,0,32,0.0,0.0,1.0,32,900,600,300,0.6666666666666666,12,6,6,431.21529540930317,0.42053091397849457,0.17069296197464978,0.2255379371313836,126854.94936192041,4545.560051967018,131400.50941388743,616,1,198.03125,30,2,17,37.29180564820991,0.6024305555555556,48.151881720430104,1007.3924731182793,33.579749103942646,8
666,4,3,1,34,0.08571428571428572,0.02857142857142857,0.9714285714285714,35,900,600,300,0.6666666666666666,12,6,6,397.80615143585885,0.4294117647058824,0.15732301161193663,0.2131123389197187,127825.12825540762,3170.1457701018235,130995.27402550944,617,0,181.97142857142856,32,3,17,37.133745369792315,0.6070963541666667,47.19065656565657,1011.2373737373739,31.601167929292934,0
667,4,0,0,34,0.0,0.0,1.0,34,1300,800,500,0.6153846153846154,18,8,10,409.84148294311217,0.42704619726678555,0.1643937327635847,0.21914664418528415,127749.32861328135,3671.394856770847,131420.7234700522,618,1,188.3235294117647,31,3,18,36.90752189592994,0.6088709677419355,47.26562500000001,1010.9375000000008,32.61088709677422,0
668,4,1,0,35,0.02857142857142857,0.0,1.0,35,1000,800,200,0.8,12,8,4,398.2755350982256,0.42724089635854345,0.1609146276311575,0.21558477345195465,128240.42986685042,3215.0051652892716,131455.43503213968,619,0,183.9142857142857,32,3,20,36.69518199950138,0.611328125,46.78030303030304,1012.8787878787887,31.652462121212146,0
669,4,1,1,35,0.027777777777777776,0.027777777777777776,0.9722222222222222,36,850,500,350,0.5882352941176471,12,5,7,372.9904645479123,0.42910052910052915,0.15090976321040372,0.19273997853309732,126361.00788503746,2242.108904703631,128603.11678974109,620,0,179.77777777777777,32,4,17,39.26728829168236,0.5921223958333333,48.64267676767678,1005.4292929292948,31.41966540404046,8
670,4,2,0,37,0.05405405405405406,0.0,1.0,37,900,700,200,0.7777777777777778,11,7,4,390.2982238771915,0.43005505505505504,0.1313957748198804,0.19938566159265877,125890.05918697132,2429.0416635609586,128319.10085053228,621,0,175.78378378378378,33,4,19,39.319386779012504,0.5849116161616161,49.111519607843135,1003.5539215686273,30.41072489601901,7
671,4,2,5,34,0.05128205128205128,0.1282051282051282,0.8717948717948718,39,1150,700,450,0.6086956521739131,16,7,9,369.06315194489395,0.4390182186234817,0.11207476370845026,0.1914019640038793,126509.15745027427,1537.9736796982108,128047.13112997249,622,0,167.71794871794873,35,4,16,39.21326123638596,0.5869047619047619,48.49537037037037,1006.0185185185179,28.743386243386226,0
672,4,1,0,35,0.02857142857142857,0.0,1.0,35,1000,800,200,0.8,12,8,4,396.6232758585458,0.42626050420168066,0.15894177149526678,0.2032134272521759,126011.15120781798,2995.7911173502716,129006.94232516825,623,0,187.0,31,4,21,39.035279687027206,0.5910618279569892,48.99088541666667,1004.0364583333338,32.38827284946238,0
673,4,3,1,37,0.07894736842105263,0.02631578947368421,0.9736842105263158,38,1450,1300,150,0.896551724137931,16,13,3,368.97831037327245,0.43788525367472736,0.1608539420841255,0.19354215462330424,126972.00255102066,1769.9829931973068,128741.98554421797,624,0,173.1578947368421,34,4,20,38.738778643987715,0.59375,48.0357142857143,1007.8571428571449,29.642857142857203,0
674,4,1,0,38,0.02631578947368421,0.0,1.0,38,1050,900,150,0.8571428571428571,12,9,3,369.5419428306846,0.43508475580844,0.17719937366184157,0.19545137438732746,127308.35383326125,1809.2119721663207,129117.56580542757,625,0,174.1315789473684,33,5,21,38.378744181339826,0.5994318181818181,47.70220588235294,1009.1911764705882,30.581550802139034,0
675,4,2,1,39,0.05,0.025,0.975,40,1050,700,350,0.6666666666666666,14,7,7,351.5417252946394,0.4371794871794872,0.17997597803706245,0.18900232241855702,127968.81028163576,997.275270061721,128966.08555169748,626,0,166.375,35,5,16,38.15631434454358,0.6017857142857144,47.04861111111111,1011.8055555555552,28.908730158730148,0
676,4,0,1,38,0.0,0.02564102564102564,0.9743589743589743,39,900,700,200,0.7777777777777778,11,7,4,359.5457904639294,0.43406995051731895,0.18161789560094688,0.19284728761247116,127873.46938775506,1395.2735260770905,129268.74291383215,627,1,171.5897435897436,34,5,16,38.05148501255491,0.6029411764705883,47.14285714285714,1011.4285714285711,29.747899159663856,0
677,4,3,5,36,0.07317073170731707,0.12195121951219512,0.8780487804878049,41,600,500,100,0.8333333333333334,7,5,2,333.40425588826577,0.43871951219512195,0.16067719686855986,0.18210867997487026,128601.0181422978,375.51234183715655,128976.53048413496,628,0,160.5121951219512,36,5,14,37.97023611265312,0.6061921296296297,46.42454954954955,1014.3018018018026,28.175050050050075,0
678,4,2,1,37,0.05263157894736842,0.02631578947368421,0.9736842105263158,38,1250,1200,50,0.96,13,12,1,362.9635219327549,0.43440315315315314,0.1929081717116401,0.19660920526187123,128268.64216887756,1711.3676230296303,129980.00979190718,629,0,173.81578947368422,33,5,18,37.56048874909267,0.6092171717171717,46.75245098039217,1012.990196078433,30.696672608437364,0
679,4,1,0,38,0.02631578947368421,0.0,1.0,38,1100,900,200,0.8181818181818182,13,9,4,364.2771227731657,0.4337808202939782,0.19173477961958585,0.19762750991394595,128330.72015570941,1749.5891003460292,130080.30925605544,630,0,174.55263157894737,33,5,19,37.46371552975327,0.6098484848484849,46.69117647058824,1013.2352941176475,30.704099821746894,0
680,4,1,2,37,0.02564102564102564,0.05128205128205128,0.9487179487179487,39,1100,600,500,0.5454545454545454,16,6,10,356.4890086038378,0.43752811515969414,0.20095995958064927,0.19558721282859226,128778.12500000012,1381.5972222222376,130159.72222222235,631,0,171.05128205128204,34,5,17,37.204091406677605,0.6121323529411764,46.25000000000001,1015.0000000000009,29.852941176470615,0
681,4,0,1,36,0.0,0.02702702702702703,0.972972972972973,37,1050,700,350,0.6666666666666666,14,7,7,373.60354983751415,0.4351539039039039,0.20773983994876244,0.20316074692347685,128423.86529519911,2195.922391628239,130619.78768682735,632,1,181.0,33,4,17,37.13212328215049,0.6107954545454546,46.59926470588236,1013.6029411764719,30.71524064171127,0
682,4,0,0,36,0.0,0.0,1.0,36,1200,1200,0,1.0,12,12,0,383.9893880895062,0.43263888888888885,0.20954121327906483,0.20851818868784716,128368.3504871954,2658.4168707275026,131026.76735792292,633,2,186.08333333333334,32,4,17,36.925824404020254,0.6126302083333333,46.654040404040416,1013.3838383838402,31.668244949495005,0
683,4,2,1,37,0.05263157894736842,0.02631578947368421,0.9736842105263158,38,1350,1100,250,0.8148148148148148,16,11,5,364.08962366665344,0.43403271692745377,0.20335993487350934,0.20097935629826807,129019.90504535165,1794.961734693902,130814.86678004556,634,0,177.23684210526315,34,4,19,36.76446176079994,0.6145833333333333,46.01190476190477,1015.9523809523823,29.880952380952422,0
684,4,0,0,37,0.0,0.0,1.0,37,750,500,250,0.6666666666666666,10,5,5,375.7723871140854,0.43227602602602605,0.21917718877178283,0.20707457077137928,128952.32602845077,2291.3446751249676,131243.67070357574,635,1,182.8108108108108,33,4,19,36.536759974259965,0.6161616161616161,46.078431372549026,1015.6862745098053,30.778371954842587,0
685,4,2,0,39,0.05128205128205128,0.0,1.0,39,1200,800,400,0.6666666666666666,16,8,8,362.0174956030407,0.4359817813765183,0.22072379856391078,0.20324289320076222,129685.96938775519,1589.9582627168606,131275.92765047206,636,0,174.3846153846154,34,5,19,36.138625915536856,0.6213235294117647,45.35714285714286,1018.5714285714292,29.95798319327733,0
686,4,1,1,39,0.025,0.025,0.975,40,1250,1000,250,0.8,15,10,5,340.2366863905322,0.4376736111111111,0.1897664835164834,0.18212669683257934,127793.20987654346,695.987654321015,128489.19753086448,637,0,171.0,38,2,19,38.621794871794876,0.5942982456140351,47.222222222222236,1011.1111111111131,26.608187134502977,8
687,4,0,1,38,0.0,0.02564102564102564,0.9743589743589743,39,1250,800,450,0.64,17,8,9,344.3614940369242,0.4362067026540711,0.19144705924881644,0.1842923584744329,127783.97108966221,1000.7758396814422,128784.74692934366,638,1,176.35897435897436,37,2,19,38.52698098543182,0.5960022522522522,47.23135964912281,1011.0745614035088,27.32633949739213,0
688,4,1,0,39,0.02564102564102564,0.0,1.0,39,1400,1000,400,0.7142857142857143,18,10,8,345.0374080581348,0.4389057579847053,0.19240216509397268,0.18554808866902486,127978.05574792235,1031.4433287165161,129009.49907663887,639,0,177.23076923076923,37,2,20,38.311389250108355,0.597972972972973,47.03947368421052,1011.8421052631571,27.347083926031274,0
689,4,0,0,39,0.0,0.0,1.0,39,1100,700,400,0.6363636363636364,15,7,8,347.06067209525156,0.43882141250562307,0.19849575612140602,0.18715327831678502,128089.02739304387,1090.9327870113698,129179.96018005523,640,1,178.23076923076923,37,2,20,38.14675404390523,0.5990990990990991,46.9298245614035,1012.2807017543848,27.358937885253646,0
690,4,1,0,40,0.025,0.0,1.0,40,1200,1100,100,0.9166666666666666,13,11,2,367.83822907936514,0.44177350427350426,0.26965025744066273,0.19007760014010305,126361.00788503744,1342.2980164519379,127703.30590148938,641,0,174.75,32,8,21,39.396793503286034,0.5921223958333333,48.64267676767678,1005.4292929292947,31.419665404040458,8
691,4,4,2,42,0.09090909090909091,0.045454545454545456,0.9545454545454546,44,1300,500,800,0.38461538461538464,21,5,16,333.9567341644931,0.4480047568710359,0.26521404092227185,0.17717491588868964,127432.89531085183,-288.5852913724019,127144.31001947942,642,0,159.77272727272728,36,8,20,39.14905383299874,0.5943287037037037,47.578828828828854,1009.6846846846882,28.046796796796897,0
692,4,1,1,42,0.023255813953488372,0.023255813953488372,0.9767441860465116,43,1450,800,650,0.5517241379310345,21,8,13,343.20085637806295,0.44772056109265407,0.2709131098035551,0.18182343242156998,127376.0500365234,143.1138909179923,127519.16392744139,643,0,164.46511627906978,36,7,20,38.973951360999564,0.59375,47.63513513513516,1009.4594594594627,28.04054054054063,0
693,4,0,1,41,0.0,0.023809523809523808,0.9761904761904762,42,1600,1200,400,0.75,20,12,8,354.6208231630329,0.4453760162601626,0.280209698558322,0.18763917342121686,127325.53155006893,630.4569615912596,127955.9885116602,644,2,169.38095238095238,35,7,20,38.737576452599406,0.5952380952380952,47.685185185185205,1009.2592592592621,28.835978835978917,0
694,4,2,1,42,0.046511627906976744,0.023255813953488372,0.9767441860465116,43,1000,800,200,0.8,12,8,4,344.30871876475686,0.44645164267257287,0.28085441043764026,0.18490059600254088,127922.58795975712,208.97247229919577,128131.56043205631,645,0,159.8139534883721,37,6,22,38.38653443167858,0.5974099099099099,47.09429824561405,1011.622807017546,27.341156946420163,0
695,4,1,1,42,0.023255813953488372,0.023255813953488372,0.9767441860465116,43,1200,800,400,0.6666666666666666,16,8,8,345.02112505600337,0.44541343669250644,0.24378526368387043,0.17925051008723536,126581.54776398028,141.4064679759979,126722.95423195629,646,0,160.65116279069767,36,7,18,39.74350007460461,0.5856481481481481,48.42342342342343,1006.3063063063071,27.952952952952973,8
696,4,1,0,43,0.023255813953488372,0.0,1.0,43,950,500,450,0.5263157894736842,14,5,9,345.8933241783966,0.44292174234034704,0.25844354943484493,0.1814622069986312,126978.48820103885,184.20227660092402,127162.69047763977,647,0,161.53488372093022,36,7,19,39.313780260707645,0.5896990740740741,48.02927927927928,1007.8828828828827,27.99674674674674,0
697,4,4,1,46,0.0851063829787234,0.02127659574468085,0.9787234042553191,47,1650,1200,450,0.7272727272727273,21,12,9,323.0802898557922,0.4497186247301881,0.28535236050908996,0.1749481663357449,128255.57503270225,-1107.1994331402072,127148.37559956204,648,0,148.70212765957447,37,10,20,38.58383849318032,0.6007882882882882,46.76535087719297,1012.9385964912271,27.37671882408722,0
698,4,1,1,46,0.02127659574468085,0.02127659574468085,0.9787234042553191,47,900,300,600,0.3333333333333333,15,3,12,323.37477378765277,0.45149167437557813,0.29140996283212384,0.17596231804984372,128450.0173731338,-1092.500937788573,127357.51643534523,649,0,149.61702127659575,37,10,16,38.37829006670274,0.602759009009009,46.57346491228069,1013.7061403508752,27.397463252726357,0
699,4,1,2,45,0.02127659574468085,0.0425531914893617,0.9574468085106383,47,1100,700,400,0.6363636363636364,15,7,8,323.01860698489264,0.4514531298180697,0.2928044038621176,0.17675287820409277,128672.41753472204,-1087.2829861111318,127585.1345486109,650,0,150.4468085106383,37,10,18,38.16093429158109,0.6050112612612613,46.35416666666666,1014.5833333333319,27.42117117117113,0
700,4,1,0,46,0.021739130434782608,0.0,1.0,46,1050,700,350,0.6666666666666666,14,7,7,322.0186919797499,0.45142914653784216,0.2810679794070119,0.1765761263604597,128755.86718990435,-907.640812557739,127848.22637734661,651,0,148.45652173913044,37,9,19,38.1014116969173,0.6058558558558558,46.27192982456139,1014.9122807017526,27.43006164058791,0
701,4,1,0,47,0.02127659574468085,0.0,1.0,47,1600,1400,200,0.875,18,14,4,316.3150649951441,0.45156876349059516,0.28287225095288426,0.17492958710661669,129092.79348381891,-1233.2009277522313,127859.59255606668,652,0,146.27659574468086,38,9,20,37.90387580599946,0.6074561403508771,45.94017094017093,1016.2393162393145,26.743139901034592,0
702,4,1,1,47,0.020833333333333332,0.020833333333333332,0.9791666666666666,48,1450,1100,350,0.7586206896551724,18,11,7,317.96276656821203,0.4519429669030733,0.2993003683618136,0.1778735041597672,129545.80213758661,-1361.8516710069653,128183.95046657964,653,0,144.20833333333334,39,9,17,37.40247365189808,0.610309829059829,45.49479166666666,1018.0208333333318,26.10309829059825,0
703,4,0,1,46,0.0,0.02127659574468085,0.9787234042553191,47,1500,1300,200,0.8666666666666667,17,13,4,329.5991486224267,0.4513760407030527,0.3045981928384809,0.17555091392031386,127591.41845703124,-977.0182291666679,126614.40022786456,654,1,148.12765957446808,39,8,15,39.0969215039351,0.5905448717948718,47.421875,1010.3124999999999,25.905448717948715,8
704,4,3,2,47,0.061224489795918366,0.04081632653061224,0.9591836734693877,49,1650,1300,350,0.7878787878787878,20,13,7,323.8121466948084,0.4534438775510204,0.33158286427051564,0.1766000699201098,128540.34423828124,-1473.0224609375,127067.32177734374,655,0,142.6122448979592,39,10,16,38.2752311248074,0.6001602564102564,46.484375,1014.0624999999999,26.001602564102562,0
705,4,1,0,48,0.020833333333333332,0.0,1.0,48,1350,800,550,0.5925925925925926,19,8,11,325.4962050265124,0.4542516252955083,0.32920001404099963,0.17804792413201376,128658.86843450936,-1224.4053163123804,127434.46311819699,656,0,145.39583333333334,38,10,17,38.11188044088739,0.6030701754385965,46.36752136752136,1014.5299145299138,26.698155645524047,0
706,4,0,0,48,0.0,0.0,1.0,48,1500,1200,300,0.8,18,12,6,326.81838885263215,0.4541500443262411,0.32507191468462837,0.17950452779639942,128821.50472094376,-1179.7526755058889,127641.75204543787,657,1,146.39583333333334,38,10,17,37.912851680348,0.6047149122807017,46.207264957264954,1015.1709401709396,26.715024741340518,0
707,4,0,0,48,0.0,0.0,1.0,48,1550,1200,350,0.7741935483870968,19,12,7,326.95916966036117,0.45335586583924353,0.3162723449001059,0.1805680431747986,129038.51290269544,-1161.934993425391,127876.57790927005,658,2,147.39583333333334,38,10,19,37.688617245005254,0.606907894736842,45.99358974358974,1016.0256410256397,26.73751686909578,0
708,4,0,1,47,0.0,0.020833333333333332,0.9791666666666666,48,1150,700,450,0.6086956521739131,16,7,9,325.1011089639723,0.45366060874704495,0.31242116051718716,0.17991197496069028,129119.93805473362,-1204.5929898093457,127915.34506492427,659,3,148.39583333333334,38,10,19,37.65307999579524,0.6077302631578947,45.91346153846153,1016.346153846153,26.745951417004026,0
709,4,0,0,47,0.0,0.0,1.0,47,1650,1100,550,0.6666666666666666,22,11,11,337.37281710097307,0.45251310514955284,0.3175673659395417,0.18669305323635357,129117.7949585451,-687.8331553939516,128429.96180315115,660,4,152.25531914893617,37,10,20,37.343452188297896,0.6095157657657657,45.9155701754386,1016.337719298247,27.46858700806073,0
710,4,1,0,48,0.020833333333333332,0.0,1.0,48,1700,1300,400,0.7647058823529411,21,13,8,346.7295879803256,0.4528664302600473,0.3040017483147688,0.18893391279045807,128505.599379136,-571.64812730839,127933.9512518276,661,0,150.0625,37,11,14,37.72969161169388,0.603322072072072,46.5186403508772,1013.9254385964921,27.403390232337625,6
711,4,1,0,49,0.02040816326530612,0.0,1.0,49,1100,800,300,0.7272727272727273,14,8,6,341.01961218836544,0.4538513321995465,0.3086659505907623,0.18704886349823766,128767.28121119163,-1017.5663397618341,127749.7148714298,662,0,147.9795918367347,38,11,16,37.6076754385965,0.6041666666666667,46.26068376068377,1014.9572649572663,26.709401709401742,0
712,4,1,1,49,0.02,0.02,0.98,50,1650,1200,450,0.7272727272727273,21,12,9,330.317480377351,0.4563180272108844,0.3054114994363024,0.18280814838580944,129121.97401258712,-1469.7509765624643,127652.22303602465,663,0,146.0,39,11,17,37.51846964572445,0.6060363247863247,45.91145833333335,1016.3541666666691,26.06036324786331,0
713,4,0,1,48,0.0,0.02040816326530612,0.9795918367346939,49,1200,800,400,0.6666666666666666,16,8,8,336.35204572762706,0.45528628117913833,0.30837097886545095,0.18627869110563275,129149.73416121368,-1112.0445419393109,128037.68961927437,664,1,149.6734693877551,40,9,17,37.336907618476296,0.6046875,45.88414634146342,1016.4634146341473,25.411585365853682,0
714,4,1,2,47,0.02040816326530612,0.04081632653061224,0.9591836734693877,49,1400,700,700,0.5,21,7,14,342.6704534163757,0.4558708900226757,0.2252414176238946,0.18854422745244662,128891.61544054485,-961.7562917244827,127929.85914882037,665,0,144.12244897959184,40,9,15,37.43911796103549,0.6020833333333333,46.13821138211383,1015.4471544715464,25.386178861788657,8
715,4,0,1,46,0.0,0.02127659574468085,0.9787234042553191,47,1150,1000,150,0.8695652173913043,13,10,3,351.82524046356394,0.45164585260561213,0.24935148721119327,0.1927125798110111,128713.06911571344,-343.0987015121524,128369.97041420129,666,1,151.0212765957447,38,9,15,37.388792377342604,0.6036184210526316,46.31410256410257,1014.7435897435905,26.703778677462907,0
716,4,0,1,45,0.0,0.021739130434782608,0.9782608695652174,46,950,800,150,0.8421052631578947,11,8,3,348.93941722547106,0.45097624798711755,0.2501606339687297,0.19144513972100188,128778.12500000015,-212.84722222220825,128565.27777777794,667,2,154.67391304347825,39,7,15,37.39566228790366,0.6025641025641026,46.25000000000001,1015.0000000000011,26.025641025641054,0
717,4,0,0,45,0.0,0.0,1.0,45,1300,800,500,0.6153846153846154,18,8,10,352.8430598528243,0.4509890572390572,0.24591528419132325,0.19371580947976225,128804.55864800377,89.5589192708673,128894.11756727465,668,3,157.4,39,6,15,37.26964682743288,0.6028311965811965,46.22395833333335,1015.1041666666691,26.02831196581203,0
718,4,2,0,47,0.0425531914893617,0.0,1.0,47,1150,800,350,0.6956521739130435,15,8,7,340.63702792302814,0.45312981806968855,0.2485548099234154,0.18915888166694167,129255.70371283508,-592.3131943445723,128663.3905184905,669,0,151.6595744680851,38,9,17,37.120237094627726,0.6091008771929824,45.77991452991453,1016.8803418803415,26.76000899685109,0
719,4,0,0,47,0.0,0.0,1.0,47,1200,700,500,0.5833333333333334,17,7,10,340.53070812417457,0.45251310514955284,0.2513900897977315,0.1899854076336415,129439.7800021702,-584.3560112847174,128855.42399088548,670,1,152.6595744680851,39,8,14,36.93582164670556,0.6092414529914529,45.598958333333336,1017.6041666666672,26.092414529914542,0
720,4,0,1,46,0.0,0.02127659574468085,0.9787234042553191,47,1500,1200,300,0.8,18,12,6,353.8584366833416,0.4521469318532223,0.2939154743175083,0.1880283193910978,127496.31461620648,-349.5215100571155,127146.79310614936,671,2,153.6595744680851,38,9,15,38.58166719559928,0.591282894736842,47.51602564102564,1009.9358974358977,26.57726045883941,8
721,4,2,1,47,0.041666666666666664,0.020833333333333332,0.9791666666666666,48,1450,1000,450,0.6896551724137931,19,10,9,347.3179254178058,0.4544270833333333,0.312036846438863,0.18705881171615357,128039.08420138927,-705.9461805555168,127333.13802083375,672,0,151.22916666666666,39,9,18,38.191299574584875,0.5950854700854701,46.979166666666686,1012.0833333333364,25.95085470085478,0
722,4,0,0,47,0.0,0.0,1.0,47,1350,1000,350,0.7407407407407407,17,10,7,354.6533922203444,0.45339962997224786,0.3087475939456146,0.190996679050786,128036.38100162544,-318.2926300314105,127718.08837159403,673,1,154.9787234042553,38,9,18,38.00846264822828,0.596765350877193,46.98183760683761,1012.07264957265,26.633490778227632,0
723,4,0,0,47,0.0,0.0,1.0,47,1500,1200,300,0.8,18,12,6,358.06986597814097,0.45278291705211227,0.3127082229120921,0.19349544680741845,128173.03790276761,-220.9281850350847,127952.10971773253,674,2,155.9787234042553,36,11,18,37.78219528469751,0.6018518518518519,46.846846846846844,1012.6126126126125,28.128128128128125,0
724,4,0,0,47,0.0,0.0,1.0,47,1600,1100,500,0.6875,21,11,10,358.2276543209879,0.45249383287079864,0.30846808510638346,0.19468894256575411,128401.20525931321,-200.6274855937188,128200.57777371949,675,3,156.9787234042553,36,11,16,37.5449074074074,0.6041666666666667,46.621621621621614,1013.5135135135123,28.15315315315312,0
725,4,0,0,47,0.0,0.0,1.0,47,1400,1100,300,0.7857142857142857,17,11,6,354.3292241435303,0.4527251002158495,0.2976408419928711,0.19353810320562606,128601.01814229762,-286.5802035143318,128314.43793878329,676,4,157.9787234042553,36,11,17,37.43963028755414,0.6061921296296297,46.424549549549546,1014.301801801801,28.17505005005003,0
726,4,0,0,47,0.0,0.0,1.0,47,1500,1000,500,0.6666666666666666,20,10,10,355.03877335204584,0.451800030835646,0.3002799427840377,0.1949037456148196,128800.9863748883,-254.13115818522482,128546.85521670309,677,5,158.9787234042553,36,11,18,37.21756896679239,0.6082175925925926,46.22747747747747,1015.0900900900893,28.196946946946927,0
727,4,0,1,46,0.0,0.02127659574468085,0.9787234042553191,47,1350,1000,350,0.7407407407407407,17,10,7,351.2903083072355,0.4512411347517731,0.2907439732037551,0.19368206484909925,128972.51136271408,-338.64134404674877,128633.87001866734,678,6,159.9787234042553,36,11,18,37.137841832963794,0.6099537037037037,46.05855855855856,1015.7657657657659,28.215715715715717,0
728,4,1,1,46,0.02127659574468085,0.02127659574468085,0.9787234042553191,47,1350,900,450,0.6666666666666666,18,9,9,348.8532661691318,0.45127967930928153,0.276962102335905,0.18457441589374782,127322.68248273182,-510.1932114337766,126812.48927129804,679,0,160.82978723404256,40,7,15,38.886021884335236,0.5861979166666667,47.6880081300813,1009.2479674796747,25.231199186991866,8
729,4,1,0,47,0.02127659574468085,0.0,1.0,47,1350,900,450,0.6666666666666666,18,9,9,351.0359041086602,0.4515494912118409,0.3015878791251363,0.1869120472814243,127579.22620670572,-443.02219660915466,127136.20401009657,680,0,161.4255319148936,40,7,17,38.56796767595481,0.5888020833333334,47.4339430894309,1010.2642276422769,25.256605691056922,0
730,4,2,2,47,0.04081632653061224,0.04081632653061224,0.9591836734693877,49,1450,1100,350,0.7586206896551724,18,11,7,340.2880116299078,0.45316043083900226,0.3027598401735032,0.18330625484653898,128046.43956380339,-1085.4663369088257,126960.97322689457,681,0,155.79591836734693,42,7,19,38.36165629487794,0.5905257936507937,46.97189922480621,1012.1124031007763,24.097914359542294,0
731,4,1,0,48,0.020833333333333332,0.0,1.0,48,1650,1100,550,0.6666666666666666,22,11,11,338.90660612589966,0.4528110224586288,0.30923485586463206,0.18364563835760622,128283.34349270923,-904.5976976852234,127378.745795024,682,0,158.20833333333334,37,11,20,38.154720027419984,0.6010698198198199,46.737938596491226,1013.0482456140346,27.37968231389283,0
732,4,0,0,48,0.0,0.0,1.0,48,1400,800,600,0.5714285714285714,20,8,12,337.1478641713937,0.45304188829787234,0.296415756067655,0.18320151137778898,128394.44739006221,-942.4172581948387,127452.03013186737,683,1,159.20833333333334,37,11,17,38.08591636914422,0.6021959459459459,46.628289473684205,1013.4868421052623,27.391536273115197,0
733,4,0,0,48,0.0,0.0,1.0,48,1450,900,550,0.6206896551724138,20,9,11,340.31854554008993,0.45279255319148937,0.29843541644141736,0.18569948246019427,128561.19340806788,-849.6483292936268,127711.54507877424,684,2,160.20833333333334,37,11,17,37.83550924424261,0.6038851351351351,46.463815789473685,1014.1447368421054,27.409317211948796,0
734,4,1,3,46,0.02040816326530612,0.061224489795918366,0.9387755102040817,49,1350,800,550,0.5925925925925926,19,8,11,343.69285544731895,0.4520797902494331,0.2085719746373389,0.18522814622194125,128065.44189453138,-901.7338943833531,127163.70800014802,685,0,157.91836734693877,39,10,20,38.25608469692292,0.5953525641025641,46.95312500000001,1012.187500000001,25.953525641025667,8
735,4,2,2,46,0.041666666666666664,0.041666666666666664,0.9583333333333334,48,1200,1000,200,0.8333333333333334,14,10,4,342.76968382715626,0.4514720005910165,0.24381209318259645,0.1863211745049292,128408.33875868062,-797.0296223958287,127611.30913628479,686,0,161.22916666666666,35,13,15,37.92929941760877,0.60625,46.614583333333336,1013.5416666666672,28.95833333333335,0
736,4,1,2,45,0.02127659574468085,0.0425531914893617,0.9574468085106383,47,1100,600,500,0.5454545454545454,16,6,10,350.2747560606836,0.4498920752389763,0.23590409914918564,0.1905808017799825,128446.04768990952,-401.71839569158647,128044.32929421794,687,0,164.4255319148936,34,13,18,37.7006263456645,0.6087622549019608,46.57738095238096,1013.690476190478,29.814425770308176,0
737,4,0,0,45,0.0,0.0,1.0,45,1650,900,750,0.5454545454545454,24,9,15,367.394289839993,0.44667508417508417,0.24311216364064436,0.1990279802421517,128272.40404359267,425.3097579328858,128697.71380152556,688,2,172.4,32,13,21,37.44443059537164,0.6116536458333333,46.748737373737384,1013.0050505050519,31.656407828282873,0
738,4,1,1,45,0.021739130434782608,0.021739130434782608,0.9782608695652174,46,1200,900,300,0.75,15,9,6,359.61698198331135,0.4461654589371981,0.24368359967859976,0.1967791800290705,128672.41753472232,54.55729166667555,128726.97482638899,689,0,169.6304347826087,33,13,19,37.23263175906913,0.6133207070707071,46.35416666666667,1014.5833333333342,30.74494949494952,0
739,4,0,0,45,0.0,0.0,1.0,45,1200,600,600,0.5,18,6,12,365.70951530780906,0.44610690235690237,0.23789775691184145,0.1997336583604189,128596.93877551025,405.8248299319756,129002.76360544223,690,1,173.22222222222223,34,11,19,37.15522300469483,0.6102941176470589,46.42857142857143,1014.2857142857147,29.831932773109255,0
740,4,0,1,44,0.0,0.022222222222222223,0.9777777777777777,45,1050,800,250,0.7619047619047619,13,8,5,364.7609932158077,0.44534932659932663,0.23892311202372718,0.1995939367371894,128672.41753472235,386.9357638888977,129059.35329861124,691,2,174.22222222222223,35,10,19,37.102156057494845,0.6089285714285715,46.35416666666667,1014.5833333333344,28.98809523809527,0
741,4,1,0,45,0.022222222222222223,0.0,1.0,45,800,400,400,0.5,12,4,8,360.97304404996726,0.4438973063973064,0.23886039886039923,0.19884108358684627,128936.76757812499,308.53949652777715,129245.30707465277,692,0,174.7111111111111,35,10,20,36.92841880341881,0.6116071428571428,46.09375,1015.6249999999999,29.01785714285714,0
742,4,0,1,44,0.0,0.022222222222222223,0.9777777777777777,45,1200,600,600,0.5,18,6,12,362.3440631031375,0.4434132996632996,0.23507252980937166,0.20004126955467572,129024.94454089519,350.28452932099896,129375.22907021618,693,1,175.7111111111111,35,10,21,36.80365686944634,0.6125,46.00694444444445,1015.9722222222233,29.02777777777781,0
743,4,2,1,45,0.043478260869565216,0.021739130434782608,0.9782608695652174,46,1350,900,450,0.6666666666666666,18,9,9,349.60251446911457,0.4479770531400966,0.23664271265572934,0.19488622097006883,129407.39300679434,-151.6494395147579,129255.74356727958,694,0,172.32608695652175,35,11,23,36.73797539149887,0.6163690476190475,45.63078703703703,1017.4768518518513,29.07076719576718,0
744,4,0,1,44,0.0,0.022222222222222223,0.9777777777777777,45,1200,900,300,0.75,15,9,6,354.4609207017719,0.44808501683501684,0.23973268845723816,0.19747216612238216,129383.00028344667,172.24348072562367,129555.2437641723,695,1,168.62222222222223,34,11,23,36.63921717762697,0.6182598039215687,45.654761904761905,1017.3809523809521,29.92296918767506,0
745,4,0,2,42,0.0,0.045454545454545456,0.9545454545454546,44,600,200,400,0.3333333333333333,10,2,8,352.8470298553402,0.44837914023960534,0.23628389154704954,0.19717922256621956,129504.14540816334,339.03061224491034,129843.17602040825,696,2,171.0909090909091,34,10,19,36.55701754385965,0.6194852941176471,45.53571428571429,1017.8571428571435,29.936974789915983,0
746,4,0,0,42,0.0,0.0,1.0,42,1350,1100,250,0.8148148148148148,16,11,5,353.62939937620365,0.44363385598141697,0.2167085493738803,0.1897430863319629,127888.11404309704,644.9993912831613,128533.1134343802,697,5,180.14285714285714,36,6,22,38.18609441104431,0.5989583333333333,47.12837837837837,1011.4864864864857,28.096846846846823,8
747,4,1,0,43,0.023255813953488372,0.0,1.0,43,1000,700,300,0.7,13,7,6,348.291626962892,0.44472129937246213,0.22226413443981663,0.18850287291350365,128234.94897959146,333.40220995259875,128568.35118954406,698,0,176.93023255813952,34,9,23,37.96647273154678,0.6066176470588236,46.78571428571426,1012.8571428571398,29.789915966386467,0
748,4,1,0,44,0.022727272727272728,0.0,1.0,44,1250,800,450,0.64,17,8,9,336.7792507681475,0.44624295278365045,0.21697518091989076,0.18395213533466934,128601.01814229741,-137.96909240325033,128463.04904989417,699,0,173.88636363636363,36,8,21,37.88465452795972,0.6061921296296297,46.42454954954953,1014.3018018017995,28.175050050049986,0
749,4,1,0,45,0.022222222222222223,0.0,1.0,45,1400,1000,400,0.7142857142857143,18,10,8,339.6223417231125,0.4477483164983165,0.26226323915938865,0.17737505902624837,126795.93474915992,-348.1754566950349,126447.75929246488,700,0,171.0,38,7,19,39.65913510837664,0.5841557017543859,48.210470085470085,1007.1581196581197,26.50416104363473,8
750,4,0,2,43,0.0,0.044444444444444446,0.9555555555555556,45,1350,1000,350,0.7407407407407407,17,10,7,341.3213313438881,0.44751683501683504,0.2621769957364619,0.17908929031692117,126984.30879720954,-331.5093323106019,126652.79946489894,701,1,172.0,38,7,19,39.42300897463079,0.5860745614035088,48.02350427350428,1007.9059829059837,26.523841655420625,0
751,4,2,1,44,0.044444444444444446,0.022222222222222223,0.9777777777777777,45,1250,800,450,0.64,17,8,9,333.6242005619084,0.45,0.2644249409608401,0.17775121491346296,127604.23657909637,-485.58205950032817,127118.65451959604,702,0,157.6,38,7,18,38.9821472630503,0.5923793859649122,47.409188034188034,1010.363247863248,26.588506522717054,0
752,4,2,0,46,0.043478260869565216,0.0,1.0,46,1100,500,600,0.45454545454545453,17,5,12,325.9621416190158,0.4507447665056361,0.26297277462544955,0.1755569937899312,128039.08420138896,-852.821180555545,127186.26302083342,703,0,155.06521739130434,39,7,22,38.731645395910526,0.5950854700854701,46.97916666666667,1012.083333333334,25.95085470085472,0
753,4,0,0,46,0.0,0.0,1.0,46,1450,900,550,0.6206896551724138,20,9,11,324.54611954696634,0.44989935587761676,0.2627027703754041,0.17571750926919275,128250.02170138895,-875.3906249999957,127374.63107638895,704,1,156.06521739130434,39,7,23,38.55237899355548,0.5972222222222222,46.770833333333336,1012.9166666666672,25.972222222222236,0
754,4,2,0,48,0.041666666666666664,0.0,1.0,48,1400,700,700,0.5,21,7,14,315.49224927124334,0.4529680112293144,0.28219030871434203,0.1736225087924969,128898.98667800438,-1466.6737528344845,127432.3129251699,705,0,150.52083333333334,41,7,20,38.1215806955842,0.600609756097561,46.13095238095237,1015.4761904761892,24.767711962833882,0
755,4,1,1,48,0.02040816326530612,0.02040816326530612,0.9795918367346939,49,1500,1200,300,0.8,18,12,6,312.5394426271715,0.4543827947845805,0.280538029594136,0.17355005909706758,129254.34570312503,-1719.5208421910413,127534.824860934,706,0,148.42857142857142,39,10,21,37.83591135696237,0.6073717948717949,45.78125,1016.8750000000002,26.073717948717956,0
756,4,0,0,48,0.0,0.0,1.0,48,1400,1000,400,0.7142857142857143,18,10,8,311.35522169466594,0.45392841312056736,0.2795190437186452,0.17347441245247,129386.78521050337,-1542.949761284726,127843.83544921865,707,1,150.8125,39,9,22,37.73175403569846,0.6087072649572649,45.651041666666664,1017.3958333333325,26.087072649572626,0
757,4,0,2,46,0.0,0.041666666666666664,0.9583333333333334,48,1700,1200,500,0.7058823529411765,22,12,10,315.6174999564714,0.453374335106383,0.2824469627204207,0.1765615241599653,129545.80213758672,-1422.6155598958392,128123.18657769088,708,2,151.8125,39,9,17,37.46216190865992,0.610309829059829,45.494791666666664,1018.0208333333327,26.103098290598275,0
758,4,1,1,46,0.02127659574468085,0.02127659574468085,0.9787234042553191,47,1150,900,250,0.782608695652174,14,9,5,309.87487982236865,0.4528407338883749,0.2734679850528763,0.17440713891958606,129784.51063368037,-1356.608072916686,128427.90256076369,709,0,153.25531914893617,39,8,18,37.36667688952496,0.6127136752136753,45.26041666666666,1018.9583333333319,26.127136752136714,0
759,4,1,0,47,0.02127659574468085,0.0,1.0,47,1400,1100,300,0.7857142857142857,17,11,6,310.484825903058,0.4512411347517731,0.27841137650985615,0.17510628365771858,129864.12896050328,-1335.8317057291854,128528.2972547741,710,0,154.17021276595744,39,8,21,37.27058848577755,0.6135149572649572,45.18229166666666,1019.2708333333318,26.13514957264953,0
760,4,2,1,48,0.04081632653061224,0.02040816326530612,0.9795918367346939,49,1000,600,400,0.6,14,6,8,302.2255381320474,0.4536741780045352,0.2848316805302291,0.17267011514257513,130368.94531249974,-1918.6143663194748,128450.33094618026,711,0,148.83673469387756,39,10,23,36.97130422956617,0.6185897435897436,44.687499999999986,1021.249999999998,26.185897435897385,0
761,4,0,0,48,0.0,0.0,1.0,48,1350,900,450,0.6666666666666666,18,9,9,306.87218498995503,0.45321734633569744,0.2865054103087439,0.17473203715338378,130237.26974875583,-1606.7608930146305,128630.50885574121,712,1,152.77083333333334,41,7,23,36.985595457932405,0.6140752032520325,44.816468253968246,1020.7341269841259,24.895954316685998,0
762,4,0,0,48,0.0,0.0,1.0,48,1750,1400,350,0.8,21,14,7,309.1849972875314,0.45248781028368795,0.2903724200074811,0.17652536566160004,130342.35161675354,-1540.01515283485,128802.33646391869,713,2,153.77083333333334,39,9,23,36.82046737393316,0.6183226495726496,44.71354166666667,1021.1458333333339,26.18322649572651,0
763,4,0,1,47,0.0,0.020833333333333332,0.9791666666666666,48,1350,900,450,0.6666666666666666,18,9,9,304.92478726175847,0.45195220153664306,0.2811597342576553,0.1748104756429332,130501.9544813367,-1641.3438585069503,128860.61062282974,714,3,154.77083333333334,39,9,12,36.76821031705577,0.6199252136752137,44.557291666666664,1021.7708333333325,26.199252136752115,0
764,4,1,1,47,0.020833333333333332,0.020833333333333332,0.9791666666666666,48,1600,1200,400,0.75,20,12,8,300.38812806306703,0.4509548611111111,0.2654718137254899,0.17334324087309103,130755.83316808775,-1744.5000082622848,129011.33315982546,715,0,145.60416666666666,40,8,13,36.62828729464757,0.6208333333333333,44.30894308943089,1022.7642276422762,25.569105691056905,0
765,4,0,0,47,0.0,0.0,1.0,47,1400,1000,400,0.7142857142857143,18,10,8,305.9456177861736,0.4501426148627814,0.2698503528758953,0.17624191221766905,130688.28124999999,-1403.2986111111106,129284.98263888888,716,1,149.5744680851064,39,8,14,36.55426514534094,0.6217948717948718,44.375,1022.4999999999999,26.217948717948715,0
766,4,0,1,46,0.0,0.02127659574468085,0.9787234042553191,47,1500,1100,400,0.7333333333333333,19,11,8,305.93140777861953,0.4505858772741289,0.2594986735964486,0.17733192220796085,130928.03955078124,-1389.000108506944,129539.0394422743,717,2,150.5744680851064,39,8,15,36.31308312128924,0.624198717948718,44.140625,1023.4374999999999,26.241987179487175,0
767,4,0,1,45,0.0,0.021739130434782608,0.9782608695652174,46,900,400,500,0.4444444444444444,14,4,10,313.42183803829846,0.44904388083735913,0.2627244863208076,0.18111129144337407,130808.47447083425,-1000.3535000730567,129808.12097076119,718,3,154.7173913043478,38,8,15,36.24194952132287,0.6247258771929824,44.25747863247863,1022.9700854700855,26.92026540710751,0
768,4,1,1,45,0.021739130434782608,0.021739130434782608,0.9782608695652174,46,1150,700,450,0.6086956521739131,16,7,9,309.38876309791135,0.44885265700483096,0.25976016161895266,0.1795025127835346,130963.79469892244,-1096.2547094983233,129867.53998942413,719,0,155.52173913043478,40,6,16,36.188608684140874,0.6229166666666667,44.105691056910565,1023.5772357723565,25.58943089430891,0
769,4,1,0,46,0.021739130434782608,0.0,1.0,46,1800,1500,300,0.8333333333333334,21,15,6,309.23531520620605,0.44679951690821257,0.2572542861333771,0.1801429772628986,131119.8742894441,-1090.6208688611302,130029.25342058296,720,0,156.15217391304347,40,6,19,36.035382350995576,0.6244791666666667,43.953252032520325,1024.1869918699185,25.604674796747965,0
770,4,0,0,46,0.0,0.0,1.0,46,1350,1100,250,0.8148148148148148,16,11,5,313.28951159310054,0.4462661030595813,0.256641613736422,0.183124530167724,131250.01161882837,-976.1495926696745,130273.86202615869,721,1,157.15217391304347,40,6,19,35.80056365499686,0.62578125,43.82621951219514,1024.695121951222,25.61737804878055,0
771,4,1,0,47,0.02127659574468085,0.0,1.0,47,1400,1000,400,0.7142857142857143,18,10,8,307.1349429256097,0.4456907184705519,0.26015768441516296,0.18115444238426703,131595.187717014,-1316.457430937682,130278.73028607632,722,0,154.7872340425532,39,8,15,35.6112521150592,0.6308760683760684,43.489583333333336,1026.0416666666674,26.308760683760703,0
772,4,0,0,47,0.0,0.0,1.0,47,1650,1300,350,0.7878787878787878,20,13,7,310.8261058818109,0.4453245451742214,0.2620551183652322,0.18397545185977462,131728.82080078137,-1211.048719618041,130517.77208116332,723,1,155.7872340425532,39,8,15,35.3823143920176,0.6322115384615384,43.35937500000001,1026.562500000001,26.322115384615408,0
773,4,0,2,45,0.0,0.0425531914893617,0.9574468085106383,47,1650,1300,350,0.7878787878787878,20,13,7,312.4364936208099,0.44553654024051803,0.26291562089288734,0.18544921075301427,131835.7760959202,-1161.9384765624957,130673.83761935771,724,2,156.7872340425532,39,8,15,35.23356408695945,0.6332799145299146,43.255208333333336,1026.9791666666672,26.33279914529916,0
774,4,0,1,44,0.0,0.022222222222222223,0.9777777777777777,45,1400,1200,200,0.8571428571428571,16,12,4,333.3865114088722,0.4436026936026936,0.20071609830708814,0.19457353973826394,131191.27498584636,-163.64980086371207,131027.62518498265,725,3,162.6888888888889,38,7,20,35.34496993082352,0.6285635964912281,43.88354700854701,1024.4658119658125,26.959626630679274,8
775,4,1,0,45,0.022222222222222223,0.0,1.0,45,1300,1000,300,0.7692307692307693,16,10,6,331.3954905881766,0.44328703703703703,0.21530842512289405,0.1951313202176926,131530.20154867726,-282.1541876949225,131248.04736098234,726,0,163.55555555555554,36,9,23,35.05438760200535,0.6357060185185186,43.55292792792794,1025.78828828829,28.494119119119166,0
776,4,0,1,44,0.0,0.022222222222222223,0.9777777777777777,45,1300,900,400,0.6923076923076923,17,9,8,328.44802396084424,0.44276094276094274,0.212583095916429,0.19408292324959003,131665.5124653742,-350.9445213911722,131314.567943983,727,1,164.55555555555554,37,8,14,34.993767806267826,0.6351351351351351,43.42105263157896,1026.315789473686,27.73826458036989,0
777,4,0,0,44,0.0,0.0,1.0,44,1450,900,550,0.6206896551724138,20,9,11,335.74333183537476,0.4418934989429175,0.21652266741160542,0.19814075386553973,131616.85333982622,37.89617320022205,131654.74951302644,728,6,169.27272727272728,36,8,17,34.85559335674568,0.6365740740740741,43.468468468468465,1026.1261261261254,28.503503503503484,0
778,4,0,1,43,0.0,0.022727272727272728,0.9772727272727273,44,1750,1500,250,0.8571428571428571,20,15,5,334.3980840258543,0.44108967582804787,0.2068331339712921,0.19854886239035094,131848.06428049668,17.948015583148845,131866.01229607983,729,7,170.27272727272728,36,8,18,34.657346491228076,0.6388888888888888,43.24324324324324,1027.0270270270266,28.52852852852852,0
779,4,0,1,42,0.0,0.023255813953488372,0.9767441860465116,43,1350,1200,150,0.8888888888888888,15,12,3,332.850130915838,0.43980712440014763,0.20847139667424508,0.19823267587964144,131963.7458404351,184.83001582664542,132148.57585626174,730,8,174.13953488372093,36,7,18,34.580730308344286,0.6400462962962963,43.130630630630634,1027.477477477478,28.541041041041055,0
780,4,0,1,41,0.0,0.023809523809523808,0.9761904761904762,42,1050,700,350,0.6666666666666666,14,7,7,340.6885402736502,0.4374879016647309,0.23151162305412942,0.20352126934671994,132079.47812677556,599.5929206233416,132679.0710473989,731,9,178.6904761904762,36,6,18,34.26293638621093,0.6412037037037037,43.018018018018026,1027.927927927929,28.553553553553584,0
781,4,0,0,41,0.0,0.0,1.0,41,1150,900,250,0.782608695652174,14,9,5,349.55476335878376,0.43559451219512196,0.23496731756773448,0.20811520015666848,131951.69331114984,1024.8685860339729,132976.5618971838,732,10,183.7560975609756,35,6,18,34.16377999324097,0.6419642857142858,43.14236111111112,1027.4305555555568,29.355158730158767,0
782,4,0,1,40,0.0,0.024390243902439025,0.975609756097561,41,1400,900,500,0.6428571428571429,19,9,10,342.4356710854804,0.4351371951219512,0.15927743508369985,0.19151643194925344,129536.03512619298,671.5518236380724,130207.58694983105,733,11,184.7560975609756,37,4,18,36.789548326870595,0.6137387387387387,45.504385964912295,1017.9824561403533,27.513039355144684,8
783,4,0,0,40,0.0,0.0,1.0,40,1150,900,250,0.782608695652174,14,9,5,349.1153671832097,0.43273237179487184,0.18113113666519176,0.19586844794075417,129659.75265806385,1053.2424316208512,130712.9950896847,734,12,189.925,36,4,18,36.4938080495356,0.6168981481481481,45.3828828828829,1018.4684684684715,28.290790790790876,0
784,4,1,0,41,0.024390243902439025,0.0,1.0,41,1350,1000,350,0.7407407407407407,17,10,7,342.5290068060946,0.43302845528455286,0.187744315366404,0.19418326327343713,130066.77685682157,710.328779047424,130777.105635869,735,0,186.26829268292684,37,4,19,36.24849958794654,0.6190878378378378,44.98355263157896,1020.0657894736861,27.569345661450974,0
785,4,0,0,41,0.0,0.0,1.0,41,1400,1100,300,0.7857142857142857,17,11,6,341.8425028367821,0.4326473577235772,0.18533020920151166,0.19421161974353482,130150.67737188392,698.2066597414897,130848.88403162542,736,1,187.26829268292684,37,4,19,36.180958521384056,0.6199324324324325,44.9013157894737,1020.3947368421075,27.57823613086777,0
786,4,1,0,42,0.023809523809523808,0.0,1.0,42,950,700,250,0.7368421052631579,12,7,5,334.96986425265584,0.43263646922183513,0.18809983748811843,0.19195874508648506,130486.54994806103,341.86047630041105,130828.41042436144,737,0,183.78571428571428,37,5,20,36.01631251341492,0.6233108108108107,44.57236842105264,1021.7105263157902,27.613798008534868,0
787,4,0,0,42,0.0,0.0,1.0,42,1100,600,500,0.5454545454545454,16,6,10,340.85012998322276,0.4319952574525745,0.007480760967225608,0.18800737938893622,128989.67013888911,393.2291666666905,129382.8993055558,738,1,184.78571428571428,39,3,14,37.38549357396773,0.6047008547008548,46.04166666666668,1015.8333333333352,26.047008547008595,8
788,4,0,0,42,0.0,0.0,1.0,42,1900,1400,500,0.7368421052631579,24,14,10,338.903460018487,0.4317411924119241,0.014232307826613999,0.18807012476070778,129229.25954380176,359.5958612265094,129588.85540502827,739,2,185.78571428571428,37,5,16,37.191195765484025,0.6106418918918919,45.80592105263157,1016.7763157894722,27.48044096728303,0
789,4,1,1,42,0.023255813953488372,0.023255813953488372,0.9767441860465116,43,1000,700,300,0.7,13,7,6,329.30478036277935,0.4333702473237357,0.02741016745899194,0.1843427791102984,129572.31445312515,-66.24348958331879,129506.07096354183,740,0,182.4418604651163,39,4,13,37.08691426232864,0.6105769230769231,45.46875000000001,1018.1250000000011,26.10576923076926,0
790,4,0,0,42,0.0,0.0,1.0,42,1150,1000,150,0.8695652173913043,13,10,3,332.1323919964714,0.4304950638792102,0.029122191353511795,0.185424769703173,129466.28146701399,199.98914930556498,129666.27061631955,741,4,187.78571428571428,39,3,13,37.12256908904813,0.6095085470085471,45.57291666666667,1017.7083333333342,26.09508547008549,0
791,4,0,0,42,0.0,0.0,1.0,42,1500,1000,500,0.6666666666666666,20,10,10,331.2723407366195,0.42920054200542007,0.03533568044254243,0.1860719253339116,129704.91672092007,193.53027343749534,129898.44699435757,742,5,188.78571428571428,39,3,13,36.902311926918244,0.6119123931623931,45.338541666666664,1018.6458333333327,26.119123931623914,0
792,4,0,0,42,0.0,0.0,1.0,42,650,500,150,0.7692307692307693,8,5,3,331.3961086721606,0.4293215253581107,0.040328430728185705,0.18639363651077628,129757.97661675337,200.25770399304577,129958.23432074641,743,6,189.78571428571428,39,3,13,36.84535067988959,0.6124465811965811,45.28645833333333,1018.8541666666657,26.124465811965788,0
793,4,0,0,42,0.0,0.0,1.0,42,1650,900,750,0.5454545454545454,24,9,15,336.0678338270311,0.42826897018970195,0.04289995524159829,0.1899210137124121,129943.7717013887,333.9843749999798,130277.75607638869,744,7,190.78571428571428,39,3,14,36.53793761067974,0.6143162393162394,45.10416666666666,1019.5833333333318,26.143162393162353,0
794,4,0,0,42,0.0,0.0,1.0,42,1150,900,250,0.782608695652174,14,9,5,336.2012199106372,0.4271075300038714,0.04190612328247667,0.19077373973376457,130103.13042534703,348.16623263886913,130451.2966579859,745,8,191.78571428571428,39,3,14,36.373034510925066,0.6159188034188035,44.94791666666666,1020.2083333333318,26.159188034187995,0
795,4,0,1,41,0.0,0.023809523809523808,0.9761904761904762,42,1100,800,300,0.7272727272727273,14,8,6,334.63294951246905,0.4271196283391405,0.04784987778150396,0.1905327293592493,130236.00396050335,316.2516276041571,130552.25558810751,746,9,192.78571428571428,39,3,14,36.278468040956575,0.6172542735042735,44.81770833333333,1020.7291666666656,26.172542735042708,0
796,4,0,0,41,0.0,0.0,1.0,41,1400,900,500,0.6428571428571429,19,9,10,338.35642852399616,0.4245934959349593,0.05750441556320118,0.19291969158563843,130289.85407991783,616.8819398786959,130906.73601979653,747,10,197.02439024390245,38,3,15,36.12891551555743,0.6195175438596492,44.764957264957246,1020.9401709401681,26.866846603688632,0
797,4,0,0,41,0.0,0.0,1.0,41,1050,700,350,0.6666666666666666,14,7,7,341.419564400679,0.4246189024390244,0.05844170749560673,0.19562584148374432,130480.80490037614,709.7399143472755,131190.54481472343,748,11,198.02439024390245,38,3,17,35.85738436334482,0.6214364035087719,44.57799145299145,1021.6880341880336,26.88652721547457,0
798,4,0,1,40,0.0,0.024390243902439025,0.975609756097561,41,950,500,450,0.5263157894736842,14,5,9,342.73604949437674,0.4238821138211382,0.05789719233034285,0.19693428141217406,130589.98243343181,751.5789365548841,131341.56136998668,749,12,199.02439024390245,38,3,13,35.713259119891305,0.622532894736842,44.47115384615384,1022.1153846153835,26.897773279352197,0
799,4,1,0,41,0.024390243902439025,0.0,1.0,41,1250,1000,250,0.8,15,10,5,338.7443757818185,0.4261432926829268,0.069809370050268,0.1961604371969924,130890.45606874114,667.6811673606372,131558.1372361018,750,0,197.70731707317074,38,3,15,35.51150205331663,0.6255482456140351,44.17735042735042,1023.2905982905968,26.928699955015706,0
800,4,0,0,41,0.0,0.0,1.0,41,950,500,450,0.5263157894736842,14,5,9,330.0465239445821,0.4263973577235773,0.03257680192842338,0.18115378532625484,128794.39153928321,360.7370653444194,129155.12860462764,751,1,198.70731707317074,38,3,16,37.85851489316912,0.6044407894736843,46.23397435897435,1015.0641025641014,26.71221322537109,8
801,4,0,0,41,0.0,0.0,1.0,41,1350,1100,250,0.8148148148148148,16,11,5,326.5769511939487,0.42578760162601625,0.03722444977500716,0.18001423691872218,128963.2175021702,223.28287760417078,129186.50037977437,752,2,199.70731707317074,39,2,16,37.77486497111406,0.6044337606837606,46.067708333333336,1015.7291666666672,26.04433760683762,0
802,4,0,0,41,0.0,0.0,1.0,41,1400,900,500,0.6428571428571429,19,9,10,329.8843566541448,0.4259400406504065,0.040580405804058195,0.18244624623116984,129095.50781249997,317.3177083333326,129412.8255208333,753,3,200.70731707317074,39,2,16,37.556375563755644,0.6057692307692308,45.9375,1016.2499999999998,26.057692307692303,0
803,4,0,1,40,0.0,0.024390243902439025,0.975609756097561,41,1500,1000,500,0.6666666666666666,20,10,10,330.38120908740814,0.4251524390243902,0.03377029781079455,0.18360010271334426,129285.00987082577,342.75438115575093,129627.76425198153,754,4,201.70731707317074,37,4,16,37.35119047619046,0.611204954954955,45.751096491228076,1016.9956140350888,27.48636794689429,0
804,4,0,0,40,0.0,0.0,1.0,40,1350,1100,250,0.8148148148148148,16,11,5,338.2827196990055,0.4232638888888889,0.03135245901639361,0.18759314456035775,129201.38888888905,741.3194444444637,129942.70833333352,755,18,207.65,36,4,17,37.23531420765028,0.6122685185185186,45.83333333333334,1016.666666666668,28.240740740740776,0
805,4,1,1,40,0.024390243902439025,0.024390243902439025,0.975609756097561,41,1150,800,350,0.6956521739130435,15,8,7,330.40427577105345,0.4255589430894309,0.034312219696504,0.18474717955085682,129527.44904667995,359.28459894807105,129886.73364562802,756,0,203.5609756097561,38,3,15,37.10445528967254,0.611842105263158,45.51282051282052,1017.948717948719,26.788124156545237,0
806,4,0,0,40,0.0,0.0,1.0,40,1250,1000,250,0.8,15,10,5,336.7395941482534,0.42528044871794873,0.032690650581646,0.18833074651038437,129536.03512619255,723.9823791935833,130260.01750538613,757,1,202.95,37,3,15,36.93451098664367,0.6137387387387387,45.504385964912274,1017.9824561403499,27.513039355144592,0
807,4,1,0,41,0.024390243902439025,0.0,1.0,41,1250,900,350,0.72,16,9,7,332.5809828568035,0.4277439024390244,0.05476174652754673,0.18778033955145665,129908.37191358021,441.01080246912943,130349.38271604934,758,0,198.97560975609755,38,3,16,36.662693006357856,0.6156798245614035,45.138888888888886,1019.4444444444441,26.82748538011695,0
808,4,0,0,41,0.0,0.0,1.0,41,750,500,250,0.6666666666666666,10,5,5,333.79985687676543,0.4275406504065041,0.05897716353525606,0.18873138827202915,129962.83512309169,476.31515267734596,130439.15027576903,759,1,199.97560975609755,38,3,16,36.57642672534226,0.6162280701754386,45.08547008547009,1019.6581196581209,26.83310841205581,0
809,4,1,2,40,0.023809523809523808,0.047619047619047616,0.9523809523809523,42,1450,1100,350,0.7586206896551724,18,11,7,329.9713024049064,0.43067653890824625,0.06503060895714752,0.18814224107116276,130290.57167830507,199.12048914524763,130489.69216745032,760,0,196.1904761904762,37,5,18,36.34220724590986,0.6213400900900901,44.764254385964925,1020.9429824561421,27.59305357989573,0
810,4,2,1,41,0.047619047619047616,0.023809523809523808,0.9761904761904762,42,1550,1300,250,0.8387096774193549,18,13,5,315.40609276072473,0.433701122725513,0.09576309665701799,0.18250049091465417,130859.79327781116,-145.2047805538666,130714.5884972573,761,0,193.16666666666666,40,2,18,36.139460005297316,0.621875,44.20731707317075,1023.1707317073196,25.57926829268299,0
811,4,1,0,42,0.023809523809523808,0.0,1.0,42,1050,800,250,0.7619047619047619,13,8,5,314.79947836550485,0.4332534843205575,0.09858339125541904,0.182518454036788,130937.79047070231,-156.1703722982033,130781.6200984041,762,0,194.14285714285714,40,2,19,36.076357859199675,0.62265625,44.131097560975626,1023.4756097561004,25.58689024390251,0
812,4,0,0,42,0.0,0.0,1.0,42,1550,1100,450,0.7096774193548387,20,11,9,317.1796994752694,0.4329510259388308,0.09282359500656767,0.18477092550935112,131119.8742894445,-82.28753552775046,131037.58675391675,763,1,195.14285714285714,40,2,20,35.83196897532579,0.6244791666666667,43.953252032520346,1024.186991869922,25.60467479674805,0
813,4,0,0,42,0.0,0.0,1.0,42,1500,1100,400,0.7333333333333333,19,11,8,320.58647592873234,0.4312330623306233,0.09170324224833659,0.1882839081560486,131432.31232236128,27.084366118081135,131459.39668847935,764,2,196.14285714285714,40,2,21,35.430087545424506,0.6276041666666667,43.64837398373985,1025.4065040650428,25.63516260162607,0
814,4,0,0,42,0.0,0.0,1.0,42,1350,900,450,0.6666666666666666,18,9,9,317.71694641594365,0.4305313588850174,0.0838789586613995,0.18733344696885348,131582.4642935879,-38.804248551258496,131543.66004503664,765,3,197.14285714285714,41,1,16,35.35260749049184,0.6275406504065041,43.501984126984134,1025.9920634920643,25.024196670538153,0
815,4,0,0,42,0.0,0.0,1.0,42,1000,700,300,0.7,13,7,6,317.1235329727616,0.43039827719705764,0.08489063226566884,0.18710831155375204,131607.91175555877,-52.80681138194939,131555.10494417683,766,4,198.14285714285714,41,1,16,35.34224032356829,0.6277947154471545,43.477182539682545,1026.0912698412703,25.02661633759196,0
816,4,0,0,42,0.0,0.0,1.0,42,850,600,250,0.7058823529411765,11,6,5,317.6036079916354,0.4302893921796361,0.08193182550422051,0.18776725304465494,131684.268904321,-35.32021604938035,131648.94868827163,767,5,199.14285714285714,41,1,16,35.25315741993686,0.6285569105691057,43.40277777777778,1026.3888888888891,25.033875338753393,0
817,4,0,0,42,0.0,0.0,1.0,42,1100,900,200,0.8181818181818182,13,9,4,315.3685059391317,0.4296239837398374,0.07625808944267387,0.18732129328673722,131862.52170138882,-82.94270833333837,131779.57899305547,768,6,200.14285714285714,41,1,16,35.131423258958755,0.6303353658536586,43.229166666666664,1027.0833333333328,25.050813008130067,0
818,4,0,1,41,0.0,0.023809523809523808,0.9761904761904762,42,1200,800,400,0.6666666666666666,16,8,8,315.77488912590576,0.42870451025938827,0.07286279701570741,0.18831963595021622,132015.4057716836,-62.56997590703671,131952.83579577657,769,7,201.14285714285714,41,1,17,34.96747996910897,0.631859756097561,43.08035714285714,1027.6785714285709,25.065331010452947,0
819,4,0,1,40,0.0,0.024390243902439025,0.975609756097561,41,800,400,400,0.5,12,4,8,319.44124539336633,0.42654979674796745,0.07442497684470473,0.19045930857415805,132006.0810364201,233.6373851543333,132239.71842157445,770,8,206.73170731707316,40,1,17,34.882647679324876,0.6333333333333333,43.08943089430894,1027.642276422764,25.691056910569102,0
820,4,0,0,40,0.0,0.0,1.0,40,1400,1200,200,0.8571428571428571,16,12,4,323.4488915047848,0.42373130341880344,0.06420206833620679,0.19252724302424196,131942.77479383672,535.348849826385,132478.1236436631,771,10,212.7,39,1,18,34.84329058095915,0.6343482905982907,43.151041666666664,1027.3958333333328,26.343482905982892,0
821,4,0,0,40,0.0,0.0,1.0,40,1500,1300,200,0.8666666666666667,17,13,4,325.4452082330934,0.42343749999999997,0.06450836289913897,0.19398894134256578,131996.29041883667,591.5120442708246,132587.80246310748,772,11,213.7,39,1,18,34.738237033282665,0.6348824786324787,43.09895833333333,1027.6041666666656,26.34882478632476,0
822,4,0,0,40,0.0,0.0,1.0,40,1350,1200,150,0.8888888888888888,15,12,3,328.3462235618963,0.42291666666666666,0.0712002229202553,0.19627188857252276,132103.35422092,675.1274956597036,132778.4817165797,773,12,214.7,39,1,19,34.556122707467814,0.6359508547008548,42.99479166666666,1028.0208333333321,26.359508547008517,0
823,4,0,0,40,0.0,0.0,1.0,40,1350,900,450,0.6666666666666666,18,9,9,328.1540430334527,0.42238247863247863,0.07505062265870266,0.19727191010598963,132317.61203342,684.1118706597131,133001.72390407973,774,13,215.7,39,1,19,34.34589197124635,0.6380876068376069,42.78645833333333,1028.8541666666656,26.38087606837604,0
824,4,1,1,40,0.024390243902439025,0.024390243902439025,0.975609756097561,41,1000,500,500,0.5,15,5,10,323.12711429499063,0.423729674796748,0.08130081300812986,0.1957770163081413,132612.49999999988,370.1633029513748,132982.66330295126,775,0,211.41463414634146,39,2,21,34.179476806903985,0.641025641025641,42.49999999999999,1029.999999999999,26.410256410256387,0
825,4,0,1,39,0.0,0.025,0.975,40,1200,800,400,0.6666666666666666,16,8,8,331.894885548935,0.42270299145299145,0.09795727913728736,0.2015613524076779,132700.54879830498,808.5266911388426,133509.0754894438,776,1,215.625,38,2,16,33.865399903221345,0.643640350877193,42.4145299145299,1030.3418803418786,27.114260008996805,0
826,4,0,2,37,0.0,0.05128205128205128,0.9487179487179487,39,1200,800,400,0.6666666666666666,16,8,8,346.45750810858823,0.4196749887539361,0.1085446439777149,0.2106085162486746,132736.76155163112,1397.529528316391,134134.29107994752,777,16,222.12820512820514,37,2,17,33.45392636731219,0.6458333333333333,42.379385964912274,1030.4824561403498,27.850877192982427,0
827,4,0,0,37,0.0,0.0,1.0,37,1000,500,500,0.5,15,5,10,350.8536202052927,0.4167292292292292,0.12954762735784642,0.21355785973534727,132785.41512613592,1917.64872149348,134703.0638476294,778,17,230.72972972972974,35,2,17,33.29180703724499,0.6502976190476191,42.332175925925924,1030.6712962962958,29.44775132275131,0
828,4,0,0,37,0.0,0.0,1.0,37,900,600,300,0.6666666666666666,12,6,6,353.54997145731454,0.41685435435435436,0.13625683350454,0.2158069025775449,132891.02447041642,1996.723581689806,134887.74805210624,779,18,231.72972972972974,36,1,17,33.116262560069906,0.6493055555555556,42.22972972972973,1031.0810810810815,28.64114114114115,0
829,4,0,0,37,0.0,0.0,1.0,37,750,600,150,0.8,9,6,3,353.934024986883,0.41694819819819817,0.13177667731063636,0.21637702275232812,132949.08717839463,2011.0411086762422,134960.12828707087,780,19,232.72972972972974,36,1,17,33.048063623789744,0.6498842592592593,42.17342342342342,1031.3063063063064,28.6473973973974,0
830,4,0,0,37,0.0,0.0,1.0,37,1100,900,200,0.8181818181818182,13,9,4,349.7109006620414,0.41701076076076077,0.13291951486471776,0.21429441879364278,133036.2050183629,1904.842215526335,134941.04723388923,781,20,233.72972972972974,36,1,17,33.069533893679726,0.6507523148148149,42.08896396396396,1031.6441441441439,28.656781781781774,0
831,4,0,1,36,0.0,0.02702702702702703,0.972972972972973,37,900,700,200,0.7777777777777778,11,7,4,349.32419211607635,0.41626001001001,0.13602581193153007,0.21455810298604058,133123.35139193258,1900.6414353542846,135023.99282728686,782,21,234.72972972972974,36,1,17,32.99209770114943,0.6516203703703703,42.00450450450451,1031.9819819819827,28.666166166166185,0
832,4,0,1,35,0.0,0.027777777777777776,0.9722222222222222,36,1350,1000,350,0.7407407407407407,17,10,7,362.2153390483879,0.41650132275132273,0.13703807565277004,0.22224017533491922,133083.8092233581,2440.9994159379194,135524.80863929604,783,22,239.38888888888889,35,1,17,32.69921948027669,0.6532738095238095,42.04282407407407,1031.828703703703,29.480820105820086,0
833,4,0,0,35,0.0,0.0,1.0,35,1250,1000,250,0.8,15,10,5,366.975610792702,0.41628151260504204,0.12508939900795935,0.22546502976342553,133134.14292800456,2771.396683673473,135905.53961167802,784,23,225.02857142857144,34,1,18,32.52585842273235,0.6559436274509804,41.99404761904762,1032.0238095238096,30.353641456582636,0
834,4,0,0,35,0.0,0.0,1.0,35,1250,900,350,0.72,16,9,7,363.17883214709843,0.4158263305322129,0.11412103746397673,0.22424031095203412,133318.49666950115,2683.691184807255,136002.1878543084,785,24,226.02857142857144,34,1,20,32.43876080691641,0.657781862745098,41.81547619047619,1032.7380952380954,30.374649859943982,0
835,4,0,0,35,0.0,0.0,1.0,35,750,600,150,0.8,9,6,3,363.27300251819463,0.41568627450980394,0.11360073766712797,0.22448408617149976,133349.23469387754,2688.435374149658,136037.6700680272,786,25,227.02857142857144,34,1,20,32.40548639926234,0.6580882352941176,41.785714285714285,1032.8571428571427,30.378151260504197,0
836,4,0,0,35,0.0,0.0,1.0,35,750,400,350,0.5333333333333333,11,4,7,365.7098258392861,0.41551120448179274,0.12085734040101404,0.2263644699453155,133410.72137188195,2757.9223356008897,136168.64370748284,787,26,228.02857142857144,34,1,20,32.28086348621034,0.6587009803921569,41.72619047619047,1033.0952380952372,30.385154061624622,0
837,4,0,0,35,0.0,0.0,1.0,35,1750,1500,250,0.8571428571428571,20,15,5,391.32125925281076,0.41502100840336137,0.13796953134085332,0.2272094198727157,130992.77388038546,3252.051445578225,134244.82532596367,788,27,229.02857142857144,34,1,16,34.06258479668178,0.6344975490196079,44.07738095238095,1023.690476190476,30.108543417366942,8
838,4,0,0,35,0.0,0.0,1.0,35,1150,900,250,0.782608695652174,14,9,5,391.6008635888463,0.41432072829131655,0.1374869231663376,0.22809358357852677,131114.67013888867,3268.9236111110877,134383.59374999977,789,28,230.02857142857144,34,1,16,33.93171955519392,0.6357230392156863,43.95833333333332,1024.166666666665,30.122549019607792,0
839,4,0,0,35,0.0,0.0,1.0,35,800,600,200,0.75,10,6,4,392.2869370709111,0.413655462184874,0.13915872646990501,0.22903808551100785,131206.12953514716,3294.090136054395,134500.21967120157,790,29,231.02857142857144,34,1,16,33.82136493918972,0.6366421568627452,43.869047619047606,1024.5238095238076,30.13305322128846,0
840,4,0,0,35,0.0,0.0,1.0,35,1100,1000,100,0.9090909090909091,12,10,2,389.64901844140405,0.41330532212885157,0.13449477351916395,0.22822299651567932,131328.12499999988,3234.3749999999845,134562.49999999985,791,30,232.02857142857144,34,1,17,33.76524390243902,0.6378676470588236,43.74999999999999,1024.999999999999,30.147058823529385,0
841,4,1,2,34,0.027777777777777776,0.05555555555555555,0.9444444444444444,36,1250,1000,250,0.8,15,10,5,379.0351895566241,0.41426917989417994,0.1296181456007819,0.2242603799985122,131713.96933138277,2784.8458665552025,134498.81519793798,792,0,226.55555555555554,35,1,14,33.64680817078214,0.6395833333333334,43.37384259259259,1026.5046296296289,29.32870370370368,0
842,4,0,0,34,0.0,0.0,1.0,34,1050,900,150,0.8571428571428571,12,9,3,390.7410936611662,0.410650623885918,0.1305932929656224,0.23075218041739107,131642.3445910227,3487.614739523263,135129.95933054597,793,32,227.88235294117646,33,1,14,33.418915691425845,0.6433080808080809,43.443627450980394,1026.2254901960785,31.097742127153893,0
843,4,0,0,34,0.0,0.0,1.0,34,900,700,200,0.7777777777777778,11,7,4,396.7931421763035,0.4104092394533571,0.16225107657332716,0.22385122549191472,129876.1944731406,3566.404142478592,133442.59861561918,794,33,228.88235294117646,32,2,18,35.05899293942773,0.6279296875,45.170454545454554,1019.3181818181827,31.85369318181821,8
844,4,1,0,35,0.02857142857142857,0.0,1.0,35,1100,900,200,0.8181818181818182,13,9,4,414.89455129411465,0.4133403361344538,0.11732398480864714,0.23319935124462302,129731.44531250001,3764.973958333334,133496.41927083334,795,0,223.31428571428572,33,2,15,34.74565439672801,0.6240530303030303,45.3125,1018.7500000000001,30.871212121212125,8
845,4,0,1,34,0.0,0.02857142857142857,0.9714285714285714,35,950,600,350,0.631578947368421,13,6,7,413.87808440143795,0.4130602240896359,0.11061592646679808,0.23299907053472937,129793.87622849374,3743.7681720972537,133537.644400591,796,1,224.31428571428572,33,2,15,34.707732010422916,0.6246843434343434,45.25122549019607,1018.9950980392148,30.87863933452166,0
846,4,0,0,34,0.0,0.0,1.0,34,950,900,50,0.9473684210526315,10,9,1,415.0570759223821,0.4130087641117053,0.104939981196295,0.23377010884644417,129811.85154894902,3975.8655047954203,133787.71705374445,797,2,226.88235294117646,32,2,16,34.65932556890926,0.6272786458333333,45.233585858585855,1019.065656565656,31.84580176767675,0
847,4,0,1,33,0.0,0.029411764705882353,0.9705882352941176,34,1100,800,300,0.7272727272727273,14,8,6,406.6661310940986,0.41308303624480097,0.11419914999733871,0.21273670427823135,126862.35427856447,3544.4133307444617,130406.76760930892,798,3,227.88235294117646,31,3,19,37.90242234285468,0.5997983870967742,48.14453125,1007.4218750000001,32.49747983870968,8
848,4,0,1,32,0.0,0.030303030303030304,0.9696969696969697,33,900,700,200,0.7777777777777778,11,7,4,417.9847838052661,0.4097616792929293,0.12823468970845808,0.2178931117247911,126719.58327913626,3993.371524164634,130712.95480330089,799,38,235.6969696969697,30,3,19,37.765040270546876,0.6010416666666667,48.28629032258064,1006.854838709677,33.561827956989234,0
849,4,2,0,34,0.058823529411764705,0.0,1.0,34,500,300,200,0.6,7,3,4,397.97756228242304,0.4155340166369578,0.1549848764727959,0.21052512609685028,127314.91246110095,3333.69570069381,130648.60816179475,800,0,227.8235294117647,32,2,15,37.65456232536802,0.6018880208333333,47.69570707070707,1009.217171717172,31.538036616161627,0
850,4,2,0,36,0.05555555555555555,0.0,1.0,36,900,700,200,0.7777777777777778,11,7,4,382.7665409832077,0.4205026455026455,0.17291756525376067,0.20607336066486664,128024.0238803853,2600.6625566893154,130624.68643707462,801,0,216.11111111111111,34,2,19,37.30982629494569,0.6044730392156863,46.994047619047606,1012.0238095238079,29.765406162464938,0
851,4,1,0,37,0.02702702702702703,0.0,1.0,37,650,300,350,0.46153846153846156,10,3,7,372.49119826283555,0.4241741741741742,0.15938673957708138,0.20205688900031799,128325.39859693863,2160.0729875283255,130485.47158446696,802,0,211.24324324324326,34,3,21,37.26109348686014,0.6075367647058824,46.69642857142856,1013.2142857142845,29.80042016806719,0
852,4,2,1,38,0.05128205128205128,0.02564102564102564,0.9743589743589743,39,1100,800,300,0.7272727272727273,14,8,6,360.7130741736766,0.4273504273504274,0.17163568139177898,0.19887725727668484,128972.51136271407,1504.4142115088057,130476.92557422287,803,0,201.35897435897436,36,3,17,36.89855875831487,0.6099537037037037,46.05855855855856,1015.7657657657658,28.215715715715717,0
853,4,1,0,39,0.02564102564102564,0.0,1.0,39,650,400,250,0.6153846153846154,9,4,5,369.12686190231517,0.425944669365722,0.16364212974382486,0.19701807812536734,127676.20991940988,1638.583861952513,129314.7937813624,804,0,202.30769230769232,35,4,15,38.01152847763018,0.5988095238095238,47.33796296296295,1010.6481481481459,28.87566137566131,8
854,4,0,1,38,0.0,0.02564102564102564,0.9743589743589743,39,850,700,150,0.8235294117647058,10,7,3,367.00219429234994,0.4254385964912281,0.1606270089384001,0.19631133907799594,127763.95486379013,1577.9303572959338,129341.88522108606,805,1,203.30769230769232,35,4,15,37.975219423774085,0.5997023809523809,47.2511574074074,1010.995370370369,28.88558201058197,0
855,4,1,0,39,0.02564102564102564,0.0,1.0,39,1000,700,300,0.7,13,7,6,366.46506652145354,0.42647885739991004,0.17190222269151634,0.19702568336596182,127968.81028163548,1579.2197145061357,129548.02999614162,806,0,204.15384615384616,35,4,16,37.77882635552504,0.6017857142857144,47.04861111111109,1011.8055555555529,28.908730158730084,0
856,4,0,0,39,0.0,0.0,1.0,39,900,700,200,0.7777777777777778,11,7,4,365.8857120375945,0.4260008996851102,0.17545217819691783,0.19700151884585737,128027.370541838,1568.6771262002594,129596.04766803826,807,1,205.15384615384616,35,4,16,37.73349344312292,0.6023809523809525,46.99074074074073,1012.0370370370359,28.915343915343882,0
857,4,1,0,40,0.025,0.0,1.0,40,1450,1100,350,0.7586206896551724,18,11,7,355.3565693058189,0.4278044871794872,0.17415505823247313,0.19330514496772427,128437.66744898829,1128.2873585390887,129565.95480752738,808,0,201.0,35,5,15,37.58040267945497,0.6065476190476191,46.585648148148145,1013.657407407407,28.9616402116402,0
858,4,3,2,41,0.06976744186046512,0.046511627906976744,0.9534883720930233,43,1250,900,350,0.72,16,9,7,336.16366596018725,0.4329318936877076,0.18687868776851446,0.1872104737562195,129368.6579043552,100.0723706178361,129468.73027497304,809,0,187.90697674418604,37,6,18,37.119170798304246,0.6120495495495495,45.66885964912281,1017.3245614035088,27.49525841631105,0
859,4,0,0,41,0.0,0.0,1.0,41,1250,700,550,0.56,18,7,11,352.1007867686589,0.4286077235772358,0.18695591550889046,0.19511813473593786,129173.52123970845,896.419691635891,130069.94093134435,810,1,197.8048780487805,37,4,19,36.912482472225214,0.6100788288288288,45.86074561403509,1016.5570175438603,27.4745139876719,0
860,4,0,0,41,0.0,0.0,1.0,41,1250,700,550,0.56,18,7,11,351.2859116654499,0.4279979674796748,0.1936787415211425,0.1953861133997456,129319.08543381374,885.6005759369798,130204.68600975072,811,2,198.8048780487805,35,6,19,36.78500986193294,0.6154761904761905,45.71759259259261,1017.1296296296321,29.06084656084663,0
861,4,2,0,43,0.046511627906976744,0.0,1.0,43,1200,900,300,0.75,15,9,6,339.37453318460314,0.4309939091915836,0.20529546239001095,0.19170743678921276,129927.00277970156,218.78318328717847,130145.78596298874,812,0,190.51162790697674,37,6,19,36.47065677206568,0.6176801801801801,45.120614035087726,1019.5175438596501,27.554528212422976,0
862,4,0,0,43,0.0,0.0,1.0,43,1050,800,250,0.7619047619047619,13,8,5,339.12822291594387,0.43044019933554817,0.206011502875719,0.19184260785391014,129982.90339335197,216.17420744846373,130199.07760080043,813,1,191.51162790697674,37,6,19,36.42025089605734,0.6182432432432432,45.06578947368422,1019.7368421052645,27.560455192034176,0
863,4,1,1,43,0.022727272727272728,0.022727272727272728,0.9772727272727273,44,1100,600,500,0.5454545454545454,16,6,10,331.6951270304038,0.43331571529245944,0.2041743970315395,0.18898908400569533,130262.58680555565,-158.5069444444348,130104.07986111121,814,0,188.13636363636363,38,6,21,36.32653061224489,0.6192434210526316,44.79166666666667,1020.8333333333342,26.86403508771932,0
864,4,0,0,43,0.0,0.0,1.0,43,1500,900,600,0.6,21,9,12,335.11796738239764,0.4317552602436323,0.2043153676257481,0.19066491689458198,130206.62607725471,126.9159741459101,130333.54205140063,815,1,193.37209302325581,37,6,21,36.29583870505659,0.6204954954954955,44.846491228070185,1020.6140350877207,27.584163110478936,0
865,4,1,0,44,0.022727272727272728,0.0,1.0,44,1750,1100,650,0.6285714285714286,24,11,13,328.2288249575239,0.4344168428470754,0.20494480417605554,0.18780345873242918,130426.23325525995,-238.0701429980009,130188.16311226196,816,0,189.95454545454547,38,6,22,36.24947704215039,0.6208881578947368,44.63141025641027,1021.474358974361,26.88090418353582,0
866,4,0,1,43,0.0,0.022727272727272728,0.9772727272727273,44,1450,800,650,0.5517241379310345,21,8,13,325.7857319782909,0.4338222339675828,0.19848769919324916,0.18719472059076958,130589.9824334321,-291.1293967784205,130298.85303665369,817,1,190.95454545454547,38,6,16,36.14638862757395,0.622532894736842,44.471153846153854,1022.1153846153859,26.89777327935226,0
867,4,0,0,43,0.0,0.0,1.0,43,1250,900,350,0.72,16,9,7,334.03451896332587,0.43074012550756735,0.20044914662141933,0.19169961309964284,130542.57079101274,121.14496768237831,130663.71575869512,818,4,196.37209302325581,37,6,18,35.983547925608036,0.6238738738738738,44.51754385964913,1021.9298245614044,27.619724988146064,0
868,4,0,0,43,0.0,0.0,1.0,43,1450,1200,250,0.8275862068965517,17,12,5,333.04159183013167,0.42988648947951275,0.20120305025339813,0.1923804959865819,130794.81336805563,112.02256944444883,130906.83593750009,819,5,197.37209302325581,37,6,18,35.753988458927346,0.6264076576576576,44.270833333333336,1022.9166666666673,27.646396396396415,0
869,4,0,1,42,0.0,0.023255813953488372,0.9767441860465116,43,750,500,250,0.6666666666666666,10,5,5,333.63243916640164,0.42958656330749356,0.20456471536700116,0.1930633154016089,130863.1260158704,132.0367859230047,130995.1628017934,820,6,198.37209302325581,38,5,18,35.66987748425046,0.6252741228070176,44.20405982905983,1023.1837606837605,26.92588843904633,0
870,4,0,0,42,0.0,0.0,1.0,42,1000,600,400,0.6,14,6,8,338.6828493327973,0.42690185830429733,0.20623605857821792,0.19563915179106267,130794.81336805543,459.59201388887897,131254.40538194432,821,9,203.95238095238096,37,5,19,35.609725050916495,0.6264076576576576,44.27083333333333,1022.9166666666656,27.64639639639637,0
871,4,0,0,42,0.0,0.0,1.0,42,1400,1000,400,0.7142857142857143,18,10,8,339.69953167611544,0.4266719899341851,0.2101682202935824,0.1967979968425315,130906.99932912034,493.8092730455361,131400.80860216587,822,10,204.95238095238096,37,5,19,35.4703516197007,0.6275337837837838,44.16118421052631,1023.3552631578934,27.65825035561874,0
872,4,0,1,41,0.0,0.023809523809523808,0.9761904761904762,42,1450,1000,450,0.6896551724137931,19,10,9,339.4906430263862,0.4262243515292296,0.2056392991047522,0.1969636515010136,130963.11034404793,492.1501086872619,131455.2604527352,823,11,205.95238095238096,37,5,19,35.41900999821459,0.6280968468468469,44.106359649122794,1023.5745614035069,27.664177335229915,0
873,4,1,0,42,0.023809523809523808,0.0,1.0,42,850,600,250,0.7058823529411765,11,6,5,341.2919492455881,0.4260670731707317,0.20617080058313242,0.1990230580432133,131159.59357686943,552.7426708217503,131712.3362476912,824,0,206.66666666666666,37,5,20,35.17448083922072,0.6300675675675675,43.914473684210506,1024.342105263155,27.684921763869053,0
874,4,0,0,42,0.0,0.0,1.0,42,1250,800,450,0.64,17,8,9,342.590284834386,0.42489353464963225,0.21029958726322606,0.2008112918768456,131356.98356718183,600.4334894244954,131957.41705660633,825,1,207.66666666666666,36,6,20,34.94200629828994,0.6339699074074074,43.72184684684684,1025.112612612611,28.475350350350304,0
875,4,0,0,42,0.0,0.0,1.0,42,700,300,400,0.42857142857142855,11,3,8,342.590284834386,0.42489353464963225,0.21029958726322606,0.2008112918768456,131356.98356718183,600.3252830533044,131957.30885023513,826,2,208.66666666666666,36,6,20,34.94200629828994,0.6339699074074074,43.72184684684684,1025.112612612611,28.475350350350304,0
876,4,0,0,42,0.0,0.0,1.0,42,900,700,200,0.7777777777777778,11,7,4,340.82779055031335,0.4249540263259775,0.2043445974919731,0.2002308297258808,131443.5782911289,559.924874198517,132003.50316532742,827,3,209.66666666666666,36,6,21,34.89983710374113,0.634837962962963,43.637387387387385,1025.45045045045,28.484734734734722,0
877,4,0,0,42,0.0,0.0,1.0,42,1100,700,400,0.6363636363636364,15,7,8,339.3150912152707,0.4252564847077042,0.2011014747319504,0.19979451621718802,131530.20154867697,526.0364672104483,132056.23801588741,828,4,210.66666666666666,36,6,22,34.85129176272551,0.6357060185185186,43.552927927927925,1025.7882882882877,28.494119119119105,0
878,4,0,0,42,0.0,0.0,1.0,42,1100,1000,100,0.9090909090909091,12,10,2,339.7005251591549,0.4248088463027488,0.20830197750742063,0.20047611303434065,131616.85333982628,542.062839866888,132158.91617969316,829,5,211.66666666666666,36,6,19,34.754078870354114,0.6365740740740741,43.468468468468465,1026.1261261261259,28.503503503503495,0
879,4,0,0,42,0.0,0.0,1.0,42,1150,800,350,0.6956521739130435,15,8,7,341.07392775404577,0.42486933797909404,0.21383647798742156,0.201898047104278,131732.43344696047,586.099697670647,132318.5331446311,830,6,212.66666666666666,36,6,19,34.60239322802399,0.6377314814814814,43.35585585585586,1026.5765765765766,28.516016016016017,0
880,4,1,0,43,0.023255813953488372,0.0,1.0,43,1250,1000,250,0.8,15,10,5,333.77277617243544,0.4241648209671465,0.2136240268729439,0.1992857327286885,132059.6782182979,215.58508387195656,132275.26330216986,831,0,208.69767441860466,37,6,20,34.46056468245501,0.6390765765765766,43.03728070175438,1027.8508771929821,27.779753437648164,0
881,4,0,1,42,0.0,0.023255813953488372,0.9767441860465116,43,1500,1100,400,0.7333333333333333,19,11,8,335.4809244263574,0.4235418973791067,0.21864482863810775,0.20075332663343667,132144.21895438983,266.3729464835358,132410.59190087338,832,1,209.69767441860466,37,6,20,34.331675909139385,0.6399211711711712,42.95504385964912,1028.1798245614036,27.788643907064962,0
882,4,1,1,42,0.023255813953488372,0.023255813953488372,0.9767441860465116,43,1100,700,400,0.6363636363636364,15,7,8,336.5655296083119,0.42513381321520854,0.2252682825086676,0.20338523709245185,132513.92598257045,320.16740009527774,132834.09338266574,833,0,207.65116279069767,36,7,21,33.9323799628131,0.6455439814814814,42.59572072072073,1029.6171171171175,28.600475475475484,0
883,4,0,0,42,0.0,0.0,1.0,42,1250,1000,250,0.8,15,10,5,337.65894750412554,0.4238288811459543,0.21618089615028202,0.2045184591968698,132600.901154533,554.7761443876436,133155.67729892064,834,1,205.28571428571428,36,6,21,33.81692360959254,0.646412037037037,42.51126126126127,1029.9549549549556,28.609859859859878,0
884,4,0,0,42,0.0,0.0,1.0,42,1250,900,350,0.72,16,9,7,335.1583368217962,0.4233207510646535,0.21305458027449697,0.20389341150731805,132765.01092884352,499.46005020775783,133264.4709790513,835,2,206.28571428571428,37,5,18,33.71668528566869,0.6461148648648649,42.35197368421053,1030.5921052631581,27.853840682788057,0
885,4,0,1,41,0.0,0.023809523809523808,0.9761904761904762,42,1150,800,350,0.6956521739130435,15,8,7,338.36384817559565,0.4225706542779713,0.22249903789674108,0.20662166417164282,132906.30290089257,594.1376192674651,133500.44052016002,836,3,207.28571428571428,37,5,18,33.492396852403246,0.6475225225225225,42.21491228070175,1031.1403508771928,27.86865813181602,0
886,4,0,0,41,0.0,0.0,1.0,41,1700,1500,200,0.8823529411764706,19,15,4,335.88307761088356,0.4226117886178862,0.2002586490640168,0.20619671515955812,133104.2379025277,741.4922139504438,133845.73011647814,837,4,203.58536585365854,37,4,19,33.35801632841002,0.6494932432432432,42.02302631578947,1031.907894736842,27.889402560455192,0
887,4,0,1,40,0.0,0.024390243902439025,0.975609756097561,41,1450,1100,350,0.7586206896551724,18,11,7,337.3341185918638,0.42309451219512195,0.12525750629161392,0.1944972146623948,130722.82745160715,651.0802733579932,131373.90772496516,838,5,204.58536585365854,36,5,17,35.71697316741917,0.6276041666666667,44.341216216216225,1022.6351351351362,28.406531531531563,8
888,4,1,0,41,0.024390243902439025,0.0,1.0,41,1250,1100,150,0.88,14,11,3,339.24584977749714,0.42578760162601625,0.13875875392417325,0.19691856797429433,130982.06948502555,687.0246936125322,131669.09417863807,839,0,205.390243902439,36,5,19,35.40612394572791,0.6302083333333333,44.08783783783784,1023.6486486486485,28.434684684684683,0
889,4,1,0,42,0.023809523809523808,0.0,1.0,42,1200,800,400,0.6666666666666666,16,8,8,331.12936559131475,0.42652680991095626,0.1417027868388523,0.19353209904852536,131246.0064308022,291.8813691650349,131537.88779996723,840,0,201.47619047619048,38,4,21,35.34759149202378,0.6291118421052632,43.83012820512821,1024.679487179488,26.965249662618106,0
890,4,1,1,42,0.023255813953488372,0.023255813953488372,0.9767441860465116,43,950,600,350,0.631578947368421,13,6,7,322.6459987886942,0.4276024363233666,0.14410303441522454,0.19023305675272906,131581.12502164117,-109.1239348964562,131472.0010867447,841,0,197.7674418604651,37,6,15,35.22752573830645,0.6342905405405406,43.503289473684205,1025.9868421052624,27.72937411095304,0
891,4,0,0,42,0.0,0.0,1.0,42,1150,800,350,0.6956521739130435,15,8,7,331.72547394763916,0.42563153310104535,0.1495564303227057,0.19532562005100476,131530.20154867697,326.3836894326704,131856.58523810963,842,2,203.47619047619048,36,6,22,35.04592527536869,0.6357060185185186,43.552927927927925,1025.7882882882877,28.494119119119105,0
892,4,1,2,41,0.023255813953488372,0.046511627906976744,0.9534883720930233,43,900,600,300,0.6666666666666666,12,6,6,327.89169506524524,0.42603359173126615,0.15760039913916968,0.19504871689309702,131918.83710612857,51.018221952877894,131969.85532808144,843,0,199.72093023255815,37,6,17,34.75324207492794,0.6376689189189189,43.17434210526314,1027.3026315789455,27.76493598862015,0
893,4,0,0,41,0.0,0.0,1.0,41,1300,1000,300,0.7692307692307693,16,10,6,345.0943241054912,0.42278963414634146,0.1652563464410155,0.20417888995941294,131713.96933138277,890.748644332981,132604.71797571576,844,1,209.9268292682927,35,6,19,34.517819558762746,0.6395833333333334,43.37384259259259,1026.5046296296289,29.32870370370368,0
894,4,0,0,41,0.0,0.0,1.0,41,1300,800,500,0.6153846153846154,18,8,10,341.6402162203756,0.4216717479674797,0.16490158322635873,0.20284887838084797,131848.0642804967,808.9202378053701,132656.98451830208,845,2,210.9268292682927,36,5,19,34.471399853801174,0.6388888888888888,43.24324324324324,1027.0270270270269,28.528528528528525,0
895,4,0,0,41,0.0,0.0,1.0,41,1300,1000,300,0.7692307692307693,16,10,6,340.08595984237184,0.42093495934959346,0.16254994988306026,0.20269656326333413,131992.6741564201,777.7710565295188,132770.44521294962,846,3,211.9268292682927,36,5,19,34.365753424657534,0.6403356481481481,43.102477477477485,1027.5900900900913,28.5441691691692,0
896,4,0,0,41,0.0,0.0,1.0,41,1500,1000,500,0.6666666666666666,20,10,10,341.3169725272297,0.4202743902439024,0.16448861664005276,0.20483503462967934,132253.17166829004,828.0504321889615,133081.222100479,847,4,212.9268292682927,36,5,19,34.07210240128458,0.6429398148148149,42.84909909909911,1028.6036036036048,28.572322322322357,0
897,4,1,0,42,0.023809523809523808,0.0,1.0,42,1300,1100,200,0.8461538461538461,15,11,4,336.0223531295819,0.4216632791327913,0.1795580685805922,0.20352718157107008,132600.90115453306,511.45262661311426,133112.35378114617,848,0,208.83333333333334,36,6,20,33.859064071725335,0.646412037037037,42.51126126126127,1029.954954954956,28.609859859859892,0
898,4,0,0,42,0.0,0.0,1.0,42,1400,1000,400,0.7142857142857143,18,10,8,334.9369681811381,0.4206591173054588,0.17791706344869995,0.20365502962296306,132745.923182473,492.3034098287524,133238.22659230174,849,1,209.83333333333334,36,6,17,33.741530980220745,0.6478587962962963,42.3704954954955,1030.518018018018,28.6255005005005,0
899,4,0,1,41,0.0,0.023809523809523808,0.9761904761904762,42,1550,1300,250,0.8387096774193549,18,13,5,334.970931471264,0.42048974061169186,0.1717941517548376,0.20462500463524788,132920.05423920555,504.8708759435302,133424.9251151491,850,2,210.83333333333334,36,6,18,33.56607877397984,0.6495949074074074,42.201576576576585,1031.1936936936947,28.644269269269298,0
900,4,0,0,41,0.0,0.0,1.0,41,750,400,350,0.5333333333333333,11,4,7,332.41809843443093,0.41989329268292686,0.15629460006390405,0.20353942390771312,133007.16256797343,642.7976118009938,133649.9601797744,851,3,211.8780487804878,36,5,18,33.54462336244539,0.650462962962963,42.11711711711712,1031.531531531532,28.653653653653667,0
901,4,0,0,41,0.0,0.0,1.0,41,1400,1000,400,0.7142857142857143,18,10,8,330.43928037219433,0.4198678861788618,0.15850065081464915,0.20280074521436173,133094.2994303427,595.9169050807741,133690.2163354235,852,4,212.8780487804878,36,5,19,33.508403361344534,0.6513310185185186,42.032657657657666,1031.8693693693708,28.663038038038078,0
902,4,0,0,41,0.0,0.0,1.0,41,1400,900,500,0.6428571428571429,19,9,10,325.0115071315659,0.4191310975609756,0.15416826288681662,0.20024902536170688,133239.59094229378,460.8800523496548,133700.47099464343,853,5,213.8780487804878,36,5,19,33.50308136998253,0.6527777777777778,41.891891891891895,1032.4324324324334,28.678678678678708,0
903,4,0,2,39,0.0,0.04878048780487805,0.9512195121951219,41,1650,1200,450,0.7272727272727273,21,12,9,325.422261890273,0.41854674796747965,0.15080524053648214,0.20114683116839702,133358.94217451522,479.5937211449712,133838.5358956602,854,6,214.8780487804878,37,4,19,33.37314225053078,0.652027027027027,41.776315789473685,1032.8947368421052,27.916073968705547,0
904,4,0,0,39,0.0,0.0,1.0,39,1000,500,500,0.5,15,5,10,333.892179390357,0.41745389113810166,0.14397110177286798,0.20620371563562062,133326.80389426596,1103.3554246814442,134430.1593189474,855,7,216.12820512820514,36,3,19,33.18658452367972,0.6536458333333333,41.807432432432435,1032.7702702702709,28.68806306306308,0
905,4,0,0,39,0.0,0.0,1.0,39,1000,600,400,0.6,14,6,8,337.474713730413,0.41734143049932526,0.14518175669254818,0.2089064118598385,133414.0453798391,1204.773354435494,134618.8187342746,856,8,217.12820512820514,36,3,19,33.00677639706416,0.6545138888888888,41.72297297297296,1033.1081081081065,28.697447447447402,0
906,4,0,1,38,0.0,0.02564102564102564,0.9743589743589743,39,1200,1000,200,0.8333333333333334,14,10,4,332.8434935285117,0.417538236617184,0.14163614163614224,0.20652499933138246,133501.31539901363,1087.008841611859,134588.3242406255,857,9,218.12820512820514,36,3,19,33.039119537975374,0.6553819444444444,41.6385135135135,1033.445945945944,28.706831831831778,0
907,4,0,0,38,0.0,0.0,1.0,38,850,800,50,0.9411764705882353,9,8,1,334.31016560582106,0.4168889284020863,0.12151702786377672,0.2079246151938643,133588.61395178956,1332.00633065497,134920.62028244452,858,10,211.92105263157896,36,2,19,32.91394335511982,0.65625,41.55405405405405,1033.7837837837833,28.716216216216203,0
908,4,0,0,38,0.0,0.0,1.0,38,950,600,350,0.631578947368421,13,6,7,359.75233201150456,0.41623696064485544,0.05425791911707867,0.2098990039969562,131179.87403817297,1874.7510307283906,133054.62506890137,859,11,212.92105263157896,35,3,20,34.6812271683049,0.6342261904761906,43.894675925925924,1024.421296296296,29.26917989417989,8
909,4,0,0,38,0.0,0.0,1.0,38,1050,800,250,0.7619047619047619,13,8,5,357.94933973731617,0.41601469890943577,0.05055057435726695,0.20900841394160435,131209.51753257884,1793.2720336076814,133002.78956618652,860,12,213.92105263157896,35,3,20,34.69743184214491,0.6345238095238095,43.86574074074074,1024.537037037037,29.27248677248677,0
910,4,0,0,38,0.0,0.0,1.0,38,1000,600,400,0.6,14,6,8,357.77762119548913,0.4156442626837364,0.05997503640524271,0.20939331366067754,131298.4681096749,1795.1307173782393,133093.59882705312,861,13,214.92105263157896,35,3,21,34.611918878223236,0.6354166666666667,43.778935185185176,1024.8842592592578,29.282407407407366,0
911,4,0,1,37,0.0,0.02631578947368421,0.9736842105263158,38,900,800,100,0.8888888888888888,10,8,2,359.1728830501529,0.4153330962541489,0.06361778231987714,0.2106989005336591,131387.44882758908,1838.1617584019139,133225.610585991,862,14,215.92105263157896,35,3,21,34.48624595469257,0.6363095238095238,43.692129629629626,1025.2314814814808,29.292328042328023,0
912,4,0,0,37,0.0,0.0,1.0,37,950,600,350,0.631578947368421,13,6,7,361.1062040191482,0.4124436936936937,0.08212275428435212,0.21218068495367973,131450.17715419506,2093.494897959196,133543.67205215426,863,15,221.40540540540542,34,3,21,34.37330701958054,0.639093137254902,43.63095238095239,1025.476190476191,30.161064425770324,0
913,4,1,0,38,0.02631578947368421,0.0,1.0,38,1150,800,350,0.6956521739130435,15,8,7,378.98751245607184,0.4134068278805121,0.11298650330825333,0.21729123710156734,130505.75573979582,2372.97689909296,132878.7326388888,864,0,216.55263157894737,34,4,18,34.8724707755641,0.6295955882352942,44.55357142857142,1021.7857142857134,30.052521008403335,7
914,4,0,0,38,0.0,0.0,1.0,38,1000,700,300,0.7,13,7,6,373.8814940703215,0.4127104077761972,0.10717525065574973,0.21520739082278256,130657.8514739227,2170.11054421766,132827.96201814036,865,1,217.55263157894737,34,4,18,34.848528955131194,0.6311274509803921,44.40476190476189,1022.3809523809507,30.070028011204432,0
915,4,0,0,38,0.0,0.0,1.0,38,1700,1300,400,0.7647058823529411,21,13,8,372.94826680399086,0.4119991702228544,0.1045464569244341,0.21534754760617533,130779.59183673467,2154.804421768707,132934.39625850337,866,2,218.55263157894737,34,4,19,34.74889432029796,0.6323529411764706,44.285714285714285,1022.8571428571427,30.08403361344537,0
916,4,0,0,38,0.0,0.0,1.0,38,1650,1300,350,0.7878787878787878,20,13,7,368.93929199415123,0.4113323850165955,0.1058569312324773,0.21404453661037195,130962.30867346936,2063.4282879818547,133025.7369614512,867,3,219.55263157894737,34,4,19,34.66624990307824,0.6341911764705883,44.107142857142854,1023.5714285714284,30.10504201680672,0
917,4,0,0,38,0.0,0.0,1.0,38,850,700,150,0.8235294117647058,10,7,3,367.63791238507315,0.4115398293029872,0.1065789473684211,0.21362743557510994,131023.24263038542,2033.822278911558,133057.06490929698,868,4,220.55263157894737,34,4,20,34.63783914728682,0.6348039215686274,44.047619047619044,1023.8095238095232,30.112044817927153,0
918,4,0,1,37,0.0,0.02631578947368421,0.9736842105263158,38,900,600,300,0.6666666666666666,12,6,6,362.746443035162,0.4124585111427217,0.09943441428536115,0.19871791005345252,128717.71541950118,1738.378684807258,130456.09410430845,869,5,221.55263157894737,34,4,16,37.10699202252462,0.6115196078431373,46.30952380952381,1014.761904761905,29.845938375350148,8
919,4,0,1,36,0.0,0.02702702702702703,0.972972972972973,37,1150,1100,50,0.9565217391304348,12,11,1,370.00379907792507,0.412474974974975,0.0906256020427827,0.20214663003089006,128610.25694744804,2117.2567341887707,130727.51368163682,688,6,205.05405405405406,33,4,16,37.03271616125006,0.6126893939393939,46.41544117647059,1014.3382352941172,30.737522281639915,0
920,4,0,0,36,0.0,0.0,1.0,36,1050,700,350,0.6666666666666666,14,7,7,369.428281556004,0.41121031746031744,0.11376444068751779,0.20246430175812516,128734.59314025861,2311.639904123422,131046.23304438204,689,7,211.0,33,3,17,36.92023406995934,0.6139520202020202,46.29289215686275,1014.8284313725495,30.752376708259078,0
921,4,2,0,38,0.05263157894736842,0.0,1.0,38,950,500,450,0.5263157894736842,14,5,9,366.34971283181665,0.41669630156472265,0.062188096341735166,0.19710741780237387,127998.08873724718,1778.4126103823824,129776.50134762956,690,0,200.8421052631579,35,3,19,37.75174901826223,0.6020833333333333,47.01967592592593,1011.921296296297,28.912037037037056,8
922,4,1,0,39,0.02564102564102564,0.0,1.0,39,1100,900,200,0.8181818181818182,13,9,4,357.3536159456135,0.418859649122807,0.06280982312110717,0.19352172037512314,128258.57688347141,1366.7332450694018,129625.31012854082,691,0,196.66666666666666,36,3,20,37.71284973133223,0.6027199074074074,46.76238738738739,1012.9504504504512,28.137512512512533,0
923,4,1,1,39,0.025,0.025,0.975,40,1150,900,250,0.782608695652174,14,9,5,346.6999643998085,0.42199519230769234,0.0724813533672033,0.18944603488851927,128616.79945993006,918.2879587950187,129535.08741872507,692,0,192.725,37,3,14,37.61699185673619,0.6044481981981982,46.40899122807018,1014.36403508772,27.41524419156,0
924,4,1,0,40,0.025,0.0,1.0,40,1350,900,450,0.6666666666666666,18,9,9,343.5087563810465,0.423303952991453,0.07536721028188831,0.1887565326606594,128839.3438966798,851.4885589796934,129690.83245565949,693,0,193.675,37,3,17,37.47108669042734,0.6067004504504505,46.189692982456144,1015.2412280701758,27.438952110004752,0
925,4,1,2,39,0.024390243902439025,0.04878048780487805,0.9512195121951219,41,1350,1000,350,0.7407407407407407,17,10,7,337.4996462647811,0.42634654471544714,0.06708465135376795,0.18729467155038151,129230.01284646122,524.0326620909341,129754.04550855215,694,0,189.9268292682927,36,5,19,37.22611400302727,0.6125578703703703,45.80518018018017,1016.7792792792784,28.243868868868844,0
926,4,0,0,39,0.0,0.0,1.0,39,700,500,200,0.7142857142857143,9,5,4,345.10490659159996,0.42628205128205127,0.07226752790062885,0.19123769133225094,129172.76810171631,1115.6312139842207,130288.39931570053,695,1,194.64102564102564,36,3,19,37.09104168974559,0.6119791666666667,45.86148648648647,1016.5540540540518,28.23761261261255,0
927,4,0,0,39,0.0,0.0,1.0,39,1000,700,300,0.7,13,7,6,345.45003340116915,0.42560728744939275,0.07362274689007364,0.19199680224516597,129289.65627411257,1132.6263860636973,130422.28266017626,696,2,195.64102564102564,35,4,19,36.963340730624786,0.6151785714285714,45.74652777777777,1017.0138888888882,29.057539682539662,0
928,4,0,0,39,0.0,0.0,1.0,39,900,600,300,0.6666666666666666,12,6,6,348.68740794220236,0.42560728744939275,0.07820629476680407,0.19452155397384782,129436.83556241421,1226.5989368998542,130663.43449931407,697,3,196.64102564102564,35,4,13,36.731308765544426,0.6166666666666667,45.60185185185185,1017.5925925925922,29.074074074074062,0
929,4,1,0,40,0.025,0.0,1.0,40,800,400,400,0.5,12,4,8,341.27649634948057,0.42636217948717947,0.08432905935669344,0.1918911412351614,129745.78622118726,855.837467535087,130601.62368872235,698,0,192.7,36,4,14,36.60605725654912,0.6177662037037037,45.298423423423415,1018.806306306305,28.30017517517514,0
930,4,0,1,39,0.0,0.025,0.975,40,1350,1000,350,0.7407407407407407,17,10,7,340.0786031470551,0.42586805555555557,0.0774193548387101,0.19191967055406112,129889.2389010631,834.5101858615246,130723.74908692462,699,1,193.7,36,4,16,36.49101487700691,0.619212962962963,45.15765765765765,1019.3693693693683,28.315815815815785,0
931,4,0,1,38,0.0,0.02564102564102564,0.9743589743589743,39,950,700,250,0.7368421052631579,12,7,5,347.9002020660582,0.4211369770580297,0.071592235779814,0.19628168351029968,129878.87577428429,1236.9774251972071,131115.8531994815,700,2,199.53846153846155,35,4,17,36.30220752431777,0.6211309523809524,45.16782407407408,1019.328703703705,29.123677248677286,0
932,4,0,0,38,0.0,0.0,1.0,38,1550,1400,150,0.9032258064516129,17,14,3,356.4270306677712,0.4178372451398767,0.07559601773448676,0.20056929358878722,129776.92920918363,1651.2011054421696,131428.1303146258,701,3,205.60526315789474,34,4,18,36.18851501343614,0.6222426470588236,45.26785714285714,1018.928571428571,29.96848739495797,0
933,4,1,0,39,0.02564102564102564,0.0,1.0,39,1050,600,450,0.5714285714285714,15,6,9,358.4249737065146,0.42006860098965365,0.11328782291039974,0.20468501896521546,130351.21588059413,1544.2262249228315,131895.44210551697,702,0,201.30769230769232,35,4,21,35.55444576674599,0.6258928571428571,44.70486111111111,1021.1805555555555,29.1765873015873,0
934,4,1,0,40,0.025,0.0,1.0,40,850,700,150,0.8235294117647058,10,7,3,356.98433043991133,0.4221554487179487,0.13185972252807798,0.2059804122652654,130751.61944038639,1335.2558639720924,132086.8753043585,703,0,197.25,36,4,15,35.18544006459665,0.6278935185185186,44.31306306306307,1022.7477477477482,28.409659659659674,0
935,4,0,0,40,0.0,0.0,1.0,40,750,400,350,0.5333333333333333,11,4,7,356.1407421508829,0.4217815170940171,0.13549416685009952,0.20610794797343432,130866.8190995048,1321.4012154045863,132188.22031490938,704,1,198.25,36,4,15,35.090386308606654,0.6290509259259259,44.20045045045045,1023.1981981981974,28.42217217217215,0
936,4,0,0,40,0.0,0.0,1.0,40,1150,800,350,0.6956521739130435,15,8,7,359.8038787617292,0.42126068376068376,0.14315381230058377,0.20869543420965886,130953.2521330451,1423.497610786454,132376.74974383155,705,2,199.25,36,4,16,34.909185095536735,0.6299189814814814,44.11599099099099,1023.5360360360352,28.431556556556533,0
937,4,0,1,39,0.0,0.025,0.975,40,1350,1200,150,0.8888888888888888,15,12,3,362.344099546206,0.42122061965811963,0.14657703728142524,0.2107994176054797,131068.5405633673,1498.3824618537328,132566.92302522104,706,3,200.25,36,4,17,34.727491843542644,0.6310763888888888,44.00337837837837,1023.9864864864857,28.444069069069045,0
938,4,0,0,39,0.0,0.0,1.0,39,1100,900,200,0.8181818181818182,13,9,4,372.2697667030659,0.419646873594242,0.145906679300283,0.2168673578377505,131120.5970963006,1962.4468182013054,133083.0439145019,707,4,206.17948717948718,35,4,19,34.420673710777116,0.6336309523809525,43.9525462962963,1024.189814814815,29.262566137566143,0
939,4,0,0,39,0.0,0.0,1.0,39,900,400,500,0.4444444444444444,14,4,10,372.32518716667596,0.4197593342330184,0.1453754320097107,0.21723468896586995,131179.87403817294,1968.314230752739,133148.18826892567,708,5,207.17948717948718,35,4,19,34.35922965389975,0.6342261904761906,43.894675925925924,1024.4212962962958,29.26917989417988,0
940,4,0,0,39,0.0,0.0,1.0,39,1300,900,400,0.6923076923076923,17,9,8,371.47200740300104,0.418859649122807,0.14404836356055895,0.2175764614789005,131328.12499999997,1957.1118934327842,133285.23689343277,709,6,208.17948717948718,33,6,20,34.231029810298104,0.6401515151515151,43.75,1024.9999999999998,31.060606060606055,0
941,4,0,0,39,0.0,0.0,1.0,39,1550,1300,250,0.8387096774193549,18,13,5,371.6703335390677,0.41832546108861896,0.14608858700148009,0.21858812518541518,131485.18786344197,1973.8287257304967,133459.01658917248,710,7,209.17948717948718,33,6,20,34.06706794917751,0.641729797979798,43.5968137254902,1025.6127450980396,31.07917409387999,0
942,4,1,1,39,0.025,0.025,0.975,40,1050,700,350,0.6666666666666666,14,7,7,359.8058554891072,0.41928418803418804,0.14615817936007192,0.21405072207247425,131921.96609224967,1493.259173525379,133415.22526577505,711,0,204.925,35,5,16,33.930449151269336,0.6416666666666666,43.1712962962963,1027.314814814815,29.35185185185186,0
943,4,0,1,38,0.0,0.02564102564102564,0.9743589743589743,39,1500,1100,400,0.7333333333333333,19,11,8,365.77519894300855,0.4171446243814665,0.13949977862366314,0.21752406558781673,131908.3776218821,1849.7626133786853,133758.1402352608,712,1,209.7948717948718,34,5,16,33.790850620002324,0.6436887254901961,43.18452380952381,1027.2619047619048,30.21358543417367,0
944,4,0,0,38,0.0,0.0,1.0,38,1250,800,450,0.64,17,8,9,368.3510329905919,0.4155109056424846,0.12972537924979255,0.2195860577883144,132000.11337868494,2124.47562358278,134124.58900226772,713,2,205.94736842105263,34,4,17,33.632124652455964,0.6446078431372548,43.0952380952381,1027.6190476190486,30.22408963585437,0
945,4,0,0,38,0.0,0.0,1.0,38,1050,600,450,0.5714285714285714,15,6,9,369.52197279557015,0.415259009009009,0.12536189924724916,0.22081814775707634,132091.88102324284,2162.170493197304,134254.05151644014,714,3,206.94736842105263,34,4,17,33.50945763366145,0.6455269607843137,43.005952380952394,1027.9761904761922,30.234593837535066,0
946,4,0,0,38,0.0,0.0,1.0,38,1200,900,300,0.75,15,9,6,371.2610556123239,0.4149478425794215,0.12547982598311025,0.22239618574058634,132183.68055555562,2214.930555555565,134398.61111111118,715,4,207.94736842105263,34,4,19,33.37216369529983,0.6464460784313726,42.91666666666667,1028.333333333334,30.245098039215705,0
947,4,0,0,38,0.0,0.0,1.0,38,1150,800,350,0.6956521739130435,15,8,7,371.64190246747853,0.41349573257468,0.12132496595820252,0.22353832969796228,132338.45191400885,2236.5028077846328,134574.95472179347,716,5,208.94736842105263,35,3,19,33.20631796025497,0.6458333333333333,42.7662037037037,1028.9351851851848,29.398148148148135,0
948,4,0,0,38,0.0,0.0,1.0,38,1100,700,400,0.6363636363636364,15,7,8,372.39910631347686,0.412843764817449,0.11945098611947835,0.22507895670896297,132520.55165816317,2270.1203970528413,134790.672055216,717,6,209.94736842105263,34,4,20,33.00333371873434,0.6498161764705883,42.58928571428571,1029.6428571428564,30.28361344537813,0
949,4,0,0,38,0.0,0.0,1.0,38,1250,700,550,0.56,18,7,11,372.90831675409873,0.41198435277382645,0.12948754582540434,0.22686347843571553,132765.81809807252,2301.895549886616,135067.71364795914,718,7,210.94736842105263,34,4,18,32.74325208886835,0.6522671568627452,42.351190476190474,1030.5952380952378,30.311624649859937,0
950,4,0,0,38,0.0,0.0,1.0,38,850,700,150,0.8235294117647058,10,7,3,373.34856978276065,0.4114657420578473,0.12258417406101829,0.22769004326188072,132857.85147392284,2320.457766439902,135178.30924036275,719,8,211.94736842105263,34,4,19,32.639289838337184,0.6531862745098039,42.26190476190476,1030.9523809523805,30.322128851540604,0
951,4,0,0,38,0.0,0.0,1.0,38,900,500,400,0.5555555555555556,13,5,8,372.989422201111,0.4108730440967283,0.12282118867443215,0.22859450726979003,133042.01388888896,2324.652777777782,135366.66666666674,720,9,212.94736842105263,34,4,20,32.46331448572966,0.6550245098039216,42.083333333333336,1031.6666666666672,30.343137254901976,0
952,4,0,2,36,0.0,0.05263157894736842,0.9473684210526316,38,1200,800,400,0.6666666666666666,16,8,8,375.12580743332796,0.4103247984826932,0.11720225121576555,0.23047240429762708,133134.14292800447,2388.410572562346,135522.5535005668,721,10,213.94736842105263,34,4,20,32.31557849809665,0.6559436274509804,41.99404761904761,1032.023809523809,30.353641456582615,0
953,4,0,0,36,0.0,0.0,1.0,36,1350,1100,250,0.8148148148148148,16,11,5,379.77406408081333,0.40945767195767196,0.09801012738349568,0.2342588773019717,133282.33882400996,2923.435097078048,136205.773921088,722,11,210.83333333333334,33,3,20,32.04664134820794,0.6597222222222222,41.85049019607843,1032.5980392156862,31.29084967320261,0
954,4,0,0,36,0.0,0.0,1.0,36,800,400,400,0.5,12,4,8,380.4773970823857,0.40925925925925927,0.09804619522227509,0.23509263215618376,133345.6182718185,2946.998750480584,136292.6170222991,723,12,211.83333333333334,33,3,20,31.964878974845757,0.6603535353535354,41.78921568627451,1032.8431372549019,31.298276886512177,0
955,4,0,0,36,0.0,0.0,1.0,36,950,700,250,0.7368421052631579,12,7,5,382.4329844613726,0.4083167989417989,0.10358926712265593,0.23690613460645346,133440.56560277296,3006.414750336405,136446.98035310936,724,13,212.83333333333334,33,3,20,31.81895682599928,0.661300505050505,41.697303921568626,1033.2107843137253,31.309417706476523,0
956,4,0,0,36,0.0,0.0,1.0,36,1250,800,450,0.64,17,8,9,381.9155683346742,0.40749007936507936,0.09729466308413692,0.23759880047723564,133598.8862456749,3004.698913879298,136603.58515955418,725,14,213.83333333333334,33,3,20,31.673285127232504,0.6628787878787878,41.54411764705883,1033.823529411766,31.327985739750485,0
957,4,0,1,35,0.0,0.027777777777777776,0.9722222222222222,36,1350,900,450,0.6666666666666666,18,9,9,408.5288950244033,0.4067294973544973,-0.009849358846852008,0.2422550326545985,131799.59518274228,3604.847444492516,135404.4426272348,726,15,214.83333333333334,33,3,15,32.80311393563275,0.6448863636363636,43.290441176470594,1026.8382352941182,31.116310160427826,8
958,4,0,0,35,0.0,0.0,1.0,35,1000,800,200,0.8,12,8,4,412.21196785261566,0.4067226890756303,-0.013407350151078523,0.2443227203044804,131781.48275686157,3864.380866748295,135645.86362360985,727,16,214.65714285714284,32,3,16,32.72693269388424,0.6471354166666667,43.30808080808081,1026.7676767676771,32.08648989898991,0
959,4,0,2,33,0.0,0.05714285714285714,0.9428571428571428,35,850,300,550,0.35294117647058826,14,3,11,410.9756129233248,0.4049019607843137,-0.01678896183688483,0.244840376132505,131976.01807213554,3847.784983675142,135823.80305581068,728,17,215.65714285714284,32,3,17,32.56149135741788,0.6490885416666667,43.11868686868687,1027.5252525252529,32.11016414141415,0
960,4,0,0,33,0.0,0.0,1.0,33,1050,700,350,0.6666666666666666,14,7,7,418.89573855901733,0.4012784090909091,0.015606579033267787,0.2494721715448456,131962.841881646,4455.734422471784,136418.57630411777,729,18,225.9090909090909,31,2,17,32.371398851011705,0.6515456989247312,43.131510416666664,1027.473958333333,33.14432123655913,0
961,4,0,0,33,0.0,0.0,1.0,33,1350,1200,150,0.8888888888888888,15,12,3,419.90504017531055,0.4014756944444444,0.013513513513513598,0.250588491717524,132040.8950617284,4488.927469135806,136529.8225308642,730,19,226.9090909090909,32,1,17,32.26632882882884,0.6497395833333333,43.05555555555556,1027.7777777777778,32.11805555555556,0
962,4,0,2,31,0.0,0.06060606060606061,0.9393939393939394,33,1050,900,150,0.8571428571428571,12,9,3,417.6036450498185,0.401238952020202,0.013620175722594885,0.24985646448498708,132138.24043783802,4436.2821714621,136574.52260930013,731,20,227.9090909090909,32,1,17,32.22681034835646,0.6507161458333333,42.96085858585859,1028.156565656566,32.12989267676769,0
963,4,0,0,31,0.0,0.0,1.0,31,1200,900,300,0.75,15,9,6,418.76109597820863,0.39896953405017926,0.018031849734585492,0.2513839405948212,132264.0313042534,4877.406141493051,137141.43744574647,732,30,233.80645161290323,31,0,18,32.06962025316455,0.6545698924731183,42.838541666666664,1028.645833333333,33.18212365591397,0
964,4,0,1,30,0.0,0.03225806451612903,0.967741935483871,31,650,300,350,0.46153846153846156,10,3,7,418.29226989013705,0.3987007168458781,0.01620048095177795,0.25132526421307794,132297.51798841695,4867.805820041238,137165.3238084582,733,31,234.80645161290323,31,0,19,32.04776294139981,0.6549059139784946,42.805989583333336,1028.7760416666672,33.1863239247312,0
965,4,0,0,30,0.0,0.0,1.0,30,900,500,400,0.5555555555555556,13,5,8,423.6386811581384,0.394683908045977,0.008638105189828993,0.2549825269612192,132363.42351716963,5214.853234477976,137578.27675164762,734,32,229.76666666666668,30,0,19,31.843488766980148,0.6583333333333333,42.74193548387097,1029.0322580645163,34.30107526881721,0
966,4,0,0,30,0.0,0.0,1.0,30,700,500,200,0.7142857142857143,9,5,4,420.9020444614113,0.3936781609195403,0.009442993907745612,0.2542673233891492,132501.77043588858,5154.053214244424,137655.823650133,735,33,230.76666666666668,30,0,19,31.773825065274142,0.6597222222222222,42.60752688172043,1029.5698924731187,34.31899641577062,0
967,4,0,0,30,0.0,0.0,1.0,30,800,700,100,0.875,9,7,2,417.9799148032268,0.3930316091954023,0.01038051750380542,0.2536671454447135,132674.805703694,5091.080796912932,137765.88650060692,736,34,231.76666666666668,30,0,17,31.674005218525767,0.6614583333333333,42.439516129032256,1030.2419354838705,34.34139784946235,0
968,4,0,0,30,0.0,0.0,1.0,30,1200,900,300,0.75,15,9,6,420.7198279593678,0.39188218390804597,0.014948520787176012,0.2572257561698989,132951.89698592332,5187.099845357862,138138.99683128117,737,35,232.76666666666668,30,0,18,31.323309005604074,0.6642361111111111,42.17069892473119,1031.3172043010761,34.37724014336921,0
969,4,0,0,30,0.0,0.0,1.0,30,1050,800,250,0.7619047619047619,13,8,5,420.66784501329363,0.391139846743295,0.018308146604133713,0.25791105258163277,133055.88073765757,5194.4661232512435,138250.34686090882,738,36,233.76666666666668,30,0,18,31.21960222338022,0.6652777777777779,42.06989247311828,1031.7204301075271,34.39068100358424,0
970,4,0,0,30,0.0,0.0,1.0,30,1300,700,600,0.5384615384615384,19,7,12,420.33793131510413,0.3905172413793103,0.014800347222222232,0.25866949619391033,133194.58896982312,5197.347597988213,138391.93656781132,739,37,234.76666666666668,30,0,18,31.088053385416664,0.6666666666666667,41.935483870967744,1032.2580645161293,34.40860215053764,0
971,4,0,0,30,0.0,0.0,1.0,30,700,500,200,0.7142857142857143,9,5,4,419.7327497236124,0.38991858237547894,0.018425962080784508,0.259020619769198,133298.66756633722,5189.963254422494,138488.63082075972,740,38,235.76666666666668,30,0,18,30.998633346349084,0.6677083333333333,41.83467741935485,1032.6612903225814,34.422043010752716,0
972,4,0,1,29,0.0,0.03333333333333333,0.9666666666666667,30,700,600,100,0.8571428571428571,8,6,2,417.88192153303817,0.3901819923371648,0.016137428422696498,0.25811934767362266,133333.36946467802,5143.520927274838,138476.89039195285,741,39,236.76666666666668,30,0,18,31.011408988374125,0.6680555555555556,41.80107526881721,1032.7956989247314,34.426523297491045,0
973,4,0,0,29,0.0,0.0,1.0,29,650,300,350,0.46153846153846156,10,3,7,428.6465665898894,0.3883415435139573,0.02810565127658049,0.26448026743533865,133292.88435571003,5627.107445987671,138919.9918016977,742,40,242.82758620689654,29,0,19,30.774349921542253,0.670617816091954,41.840277777777786,1032.63888888889,35.60823754789276,0
974,4,0,0,29,0.0,0.0,1.0,29,950,600,350,0.631578947368421,13,6,7,426.6941393298701,0.38818760262725777,0.025034538390928285,0.26403918538565513,133400.47260802475,5584.2399691358105,138984.71257716056,743,41,243.82758620689654,29,0,19,30.716142332168154,0.6716954022988506,41.736111111111114,1033.0555555555559,35.62260536398468,0
975,4,0,0,29,0.0,0.0,1.0,29,950,700,250,0.7368421052631579,12,7,5,425.8557285119532,0.3878284072249589,0.02294696987850764,0.2648255805223424,133583.59602077544,5577.487210258207,139161.08323103364,744,42,244.82758620689654,28,1,20,30.5530460968265,0.6767113095238095,41.558908045977006,1033.7643678160912,36.92015599343183,0
976,4,0,0,29,0.0,0.0,1.0,29,700,400,300,0.5714285714285714,10,4,6,429.83907496146986,0.3871100164203613,0.02586925486964775,0.2681093294257071,133695.01626701016,5693.468423834057,139388.48469084423,745,43,245.82758620689654,28,1,20,30.337709548948787,0.6778273809523809,41.451149425287355,1034.1954022988502,36.93555008210179,0
977,4,0,0,29,0.0,0.0,1.0,29,800,700,100,0.875,9,7,2,427.716320347239,0.3873152709359606,0.022781680195218534,0.266991067697057,133723.49778163584,5639.144483024699,139362.64226466054,746,44,246.82758620689654,29,0,18,30.363876952687885,0.6749281609195402,41.423611111111114,1034.3055555555559,35.66570881226055,0
978,4,0,0,29,0.0,0.0,1.0,29,650,500,150,0.7692307692307693,8,5,3,427.7836772939598,0.3865968801313629,0.026664074326106846,0.26755336793977386,133795.33420138888,5647.092013888885,139442.42621527775,747,45,247.82758620689654,29,0,18,30.28972009665726,0.6756465517241379,41.354166666666664,1034.5833333333333,35.67528735632184,0
979,4,0,0,29,0.0,0.0,1.0,29,450,300,150,0.6666666666666666,6,3,3,427.9627043826856,0.38664819376026277,0.024994214302245243,0.2679262308950428,133831.25964506177,5654.957561728406,139486.21720679017,748,46,248.82758620689654,29,0,18,30.24888143176735,0.6760057471264368,41.31944444444445,1034.7222222222226,35.6800766283525,0
980,4,0,0,29,0.0,0.0,1.0,29,750,400,350,0.5333333333333333,11,4,7,424.7214378139254,0.38592980295566504,0.022488755622188883,0.26641617462873496,133903.125,5574.305555555557,139477.43055555556,749,47,249.82758620689654,29,0,18,30.260332796564676,0.6767241379310345,41.25,1035.0,35.689655172413794,0
981,4,0,0,29,0.0,0.0,1.0,29,850,700,150,0.8235294117647058,10,7,3,429.33658287754713,0.3854679802955665,0.01720668840630002,0.27010162239258345,134010.9592013889,5707.1614583333385,139718.12065972225,750,48,250.82758620689654,29,0,18,30.03227699530517,0.677801724137931,41.145833333333336,1035.4166666666667,35.70402298850575,0
982,4,0,0,29,0.0,0.0,1.0,29,1150,900,250,0.782608695652174,14,9,5,429.5129203421929,0.38474958949096877,0.01941128350179544,0.2718062679112043,134226.75781249988,5730.425347222208,139957.1831597221,751,49,251.82758620689654,29,0,19,29.810430907385072,0.6799568965517242,40.93749999999999,1036.249999999999,35.73275862068962,0
983,4,0,0,29,0.0,0.0,1.0,29,800,500,300,0.625,11,5,6,429.9456853572984,0.3831588669950739,0.027715546111739986,0.273152726909977,134370.72000385783,5754.422260802447,140125.14226466027,752,50,252.82758620689654,29,0,19,29.654359231971426,0.6813936781609196,40.7986111111111,1036.805555555554,35.751915708812206,0
984,4,0,1,28,0.0,0.034482758620689655,0.9655172413793104,29,900,700,200,0.7777777777777778,11,7,4,428.90880736104924,0.38238916256157635,0.02825471719890471,0.2735712965140627,134514.75935570974,5738.913001543193,140253.67235725294,753,51,253.82758620689654,29,0,19,29.536389297987235,0.6828304597701149,40.659722222222214,1037.3611111111102,35.77107279693483,0
985,4,0,0,28,0.0,0.0,1.0,28,1100,600,500,0.5454545454545454,16,6,10,438.6147558660996,0.3812279541446208,0.022097533942920133,0.2791817731782633,134439.00490487512,6193.386263046629,140632.39116792174,754,52,255.10714285714286,28,0,19,29.360914842523307,0.6852678571428572,40.73275862068965,1037.0689655172412,37.03817733990147,0
986,4,0,0,28,0.0,0.0,1.0,28,750,500,250,0.6666666666666666,10,5,5,434.0252576571344,0.38109016754850084,0.019076305220883327,0.2771084337349397,134550.78125000003,6079.6875,140630.46875000003,755,53,256.10714285714283,28,0,19,29.36746987951807,0.6863839285714286,40.625,1037.5000000000002,37.05357142857144,0
987,4,0,0,28,0.0,0.0,1.0,28,750,400,350,0.5333333333333333,11,4,7,433.0615533175064,0.3812555114638448,0.019931370028282602,0.2770596633846191,134625.32461768403,6060.21043896156,140685.5350566456,756,54,257.10714285714283,28,0,19,29.317515805990123,0.6871279761904762,40.55316091954023,1037.7873563218395,37.06383415435141,0
988,4,0,0,28,0.0,0.0,1.0,28,550,400,150,0.7272727272727273,7,4,3,433.0615533175064,0.3812555114638448,0.019931370028282602,0.2770596633846191,134625.32461768403,6060.21043896156,140685.5350566456,757,55,258.10714285714283,28,0,19,29.317515805990123,0.6871279761904762,40.55316091954023,1037.7873563218395,37.06383415435141,0
989,4,0,0,28,0.0,0.0,1.0,28,250,0,250,0.0,5,0,5,433.0615533175064,0.3812555114638448,0.019931370028282602,0.2770596633846191,134625.32461768403,6060.21043896156,140685.5350566456,758,56,259.10714285714283,28,0,19,29.317515805990123,0.6871279761904762,40.55316091954023,1037.7873563218395,37.06383415435141,0
990,4,0,0,28,0.0,0.0,1.0,28,500,200,300,0.4,8,2,6,430.7639994731861,0.3804839065255732,0.02508650519031108,0.2761552702922601,134699.88862878198,6004.772550865383,140704.66117964737,759,57,260.10714285714283,28,0,19,29.302191464821217,0.6878720238095238,40.481321839080465,1038.074712643679,37.07409688013139,0
991,4,0,1,27,0.0,0.03571428571428571,0.9642857142857143,28,900,500,400,0.5555555555555556,13,5,8,427.7260301226831,0.3791335978835979,0.024925903971547037,0.2756202493571299,134886.3889714625,5938.883934469542,140825.27290593204,760,58,261.10714285714283,28,0,18,29.193752881512218,0.6897321428571428,40.30172413793103,1038.7931034482756,37.099753694581274,0
992,4,0,0,27,0.0,0.0,1.0,27,750,600,150,0.8,9,6,3,436.4871009146559,0.37701804368471037,0.018133656086931182,0.28016287976831206,134743.8378020478,6362.789425666083,141106.6272277139,761,59,254.96296296296296,27,0,23,29.109484735559693,0.6917438271604939,40.43898809523809,1038.2440476190468,38.45348324514988,0
993,4,0,0,27,0.0,0.0,1.0,27,950,700,250,0.7368421052631579,12,7,5,436.46603886667623,0.37624643874643876,0.01218295659556401,0.281045475211199,134859.73816609962,6372.339143990907,141232.07731009054,762,60,255.96296296296296,27,0,18,28.993553008595995,0.6929012345679013,40.32738095238094,1038.690476190475,38.47001763668426,0
994,4,0,0,27,0.0,0.0,1.0,27,550,300,250,0.5454545454545454,8,3,5,436.71409092956713,0.37606837606837606,0.01485300826463809,0.28180571006194444,134937.03275581074,6385.780718537428,141322.81347434816,763,61,256.962962962963,27,0,18,28.909457653012502,0.6936728395061729,40.2529761904762,1038.9880952380959,38.48104056437392,0
995,4,0,0,27,0.0,0.0,1.0,27,700,500,200,0.7142857142857143,9,5,4,435.5501537449356,0.3757716049382716,0.011877303215886315,0.2819571662565687,135053.01616089148,6364.472390518714,141417.4885514102,764,62,257.962962962963,27,0,20,28.823222381293256,0.6948302469135803,40.14136904761905,1039.434523809524,38.4975749559083,0
996,4,0,0,27,0.0,0.0,1.0,27,1050,900,150,0.8571428571428571,12,9,3,432.22981820808246,0.37589031339031337,0.01335431869127679,0.28100969297267786,135207.7382059594,6288.163221017563,141495.90142697698,765,63,258.962962962963,27,0,20,28.754262650832256,0.6963734567901234,39.99255952380952,1040.0297619047615,38.51962081128746,0
997,4,0,0,27,0.0,0.0,1.0,27,750,400,350,0.5333333333333333,11,4,7,431.1085223667757,0.37446581196581197,0.018682680392717588,0.2817918696666569,135401.2653238379,6274.5278840702995,141675.7932079082,766,64,259.962962962963,27,0,21,28.589386140501382,0.6983024691358024,39.80654761904762,1040.7738095238096,38.54717813051147,0
998,4,0,0,27,0.0,0.0,1.0,27,800,600,200,0.75,10,6,4,431.1085223667757,0.37446581196581197,0.018682680392717588,0.2817918696666569,135401.2653238379,6274.5278840702995,141675.7932079082,767,65,260.962962962963,27,0,21,28.589386140501382,0.6983024691358024,39.80654761904762,1040.7738095238096,38.54717813051147,0
999,4,0,0,27,0.0,0.0,1.0,27,600,500,100,0.8333333333333334,7,5,2,430.5926677944678,0.3743471035137702,0.022238106584067996,0.2817582517513846,135439.98735561926,6263.89309630101,141703.88045192027,768,66,261.962962962963,27,0,21,28.56400405051227,0.6986882716049383,39.769345238095234,1040.9226190476186,38.552689594356245,0
1000,4,0,0,27,0.0,0.0,1.0,27,950,800,150,0.8421052631578947,11,8,3,429.9362550080654,0.37375356125356124,0.02874895472780592,0.2822414552107356,135556.18666737518,6256.103847789102,141812.2905151643,769,67,262.962962962963,27,0,21,28.464680384871873,0.6998456790123457,39.65773809523809,1041.3690476190468,38.56922398589062,0
1001,4,0,0,27,0.0,0.0,1.0,27,1150,900,250,0.782608695652174,14,9,5,432.0000000000001,0.3735754985754986,0.0269629629629633,0.28421052631578975,135633.68055555562,6318.772144274395,141952.45269983003,770,68,263.962962962963,26,1,21,28.333333333333343,0.7043269230769231,39.58333333333334,1041.6666666666674,40.06410256410259,0
1002,4,0,0,27,0.0,0.0,1.0,27,850,600,250,0.7058823529411765,11,6,5,432.1933399407018,0.37250712250712253,0.027558364051255113,0.28497748352340063,135714.06797744264,6330.943263222094,142045.01124066472,771,69,264.962962962963,26,1,21,28.247803120063196,0.7051282051282051,39.506172839506185,1041.9753086419767,40.0759734093068,0
1003,4,0,0,27,0.0,0.0,1.0,27,750,600,150,0.8,9,6,3,432.1933399407018,0.37250712250712253,0.027558364051255113,0.28497748352340063,135714.06797744264,6330.943263222094,142045.01124066472,772,70,265.962962962963,26,1,21,28.247803120063196,0.7051282051282051,39.506172839506185,1041.9753086419767,40.0759734093068,0
1004,4,0,0,27,0.0,0.0,1.0,27,900,800,100,0.8888888888888888,10,8,2,431.9114442738089,0.37232905982905984,0.02504591934643785,0.285755318909851,135834.69376333634,6333.7117531626245,142168.40551649895,773,71,266.962962962963,26,1,21,28.1344066123859,0.7063301282051282,39.39043209876543,1042.4382716049379,40.093779677113,0
1005,4,0,0,27,0.0,0.0,1.0,27,900,600,300,0.6666666666666666,12,6,6,432.9397197790861,0.3712606837606838,0.021201607112514287,0.2870827955394783,135915.14072264137,6368.61258763908,142283.75331028044,774,72,267.962962962963,26,1,20,28.027107690789798,0.7071314102564102,39.31327160493827,1042.7469135802469,40.10565052231719,0
1006,4,0,0,27,0.0,0.0,1.0,27,950,600,350,0.631578947368421,13,6,7,434.2074656187058,0.37031101614434947,0.026239817690786538,0.2892292290687751,136076.1060861529,6417.052230986113,142493.15831713902,775,73,268.962962962963,26,1,20,27.83303751910467,0.7087339743589743,39.15895061728394,1043.3641975308633,40.12939221272551,0
1007,4,0,0,27,0.0,0.0,1.0,27,900,500,400,0.5555555555555556,13,5,8,438.56170269019765,0.3694207027540361,0.030713640469738124,0.25687185443283006,131328.125,6119.097222222223,137447.22222222222,776,74,269.962962962963,26,1,22,32.511856368563684,0.6610576923076923,43.75,1025.0,39.42307692307692,8
1008,4,0,0,27,0.0,0.0,1.0,27,650,600,50,0.9230769230769231,7,6,1,437.8335685786932,0.3690645773979107,0.023643508067886954,0.25724173856811816,131446.78605109744,6110.363082990398,137557.14913408784,777,75,270.962962962963,26,1,22,32.40970654627539,0.6622596153846154,43.63425925925926,1025.4629629629633,39.440883190883206,0
1009,4,0,0,27,0.0,0.0,1.0,27,550,200,350,0.36363636363636365,9,2,7,438.31211145720636,0.3678774928774929,0.019889022596603745,0.2583243720715876,131565.50068587108,6133.3504801097415,137698.85116598083,778,76,271.962962962963,26,1,21,32.27662454873646,0.6634615384615384,43.51851851851852,1025.925925925926,39.45868945868946,0
1010,4,0,0,27,0.0,0.0,1.0,27,1000,900,100,0.9,11,9,2,440.5347656023006,0.36775878442545107,0.01733482617826132,0.25990378495915695,131605.0841382793,6195.322978585593,137800.40711686487,779,77,272.962962962963,26,1,21,32.17933774502431,0.6638621794871795,43.479938271604944,1026.0802469135808,39.46462488129157,0
1011,4,0,0,27,0.0,0.0,1.0,27,650,600,50,0.9230769230769231,7,6,1,439.664469961785,0.3678774928774929,0.018844284067559114,0.25992963464140734,131684.26890432098,6179.378858024694,137863.64776234567,780,78,273.962962962963,26,1,21,32.12110960757781,0.6646634615384616,43.40277777777778,1026.388888888889,39.47649572649573,0
1012,4,0,0,27,0.0,0.0,1.0,27,850,700,150,0.8235294117647058,10,7,3,439.664469961785,0.3675807217473884,0.018844284067559114,0.25992963464140734,131684.26890432098,6179.378858024694,137863.64776234567,781,79,274.962962962963,26,1,21,32.12110960757781,0.6646634615384616,43.40277777777778,1026.388888888889,39.47649572649573,0
1013,4,0,0,27,0.0,0.0,1.0,27,750,600,150,0.8,9,6,3,441.8882802482516,0.367818138651472,0.028921617740373495,0.2620610175375995,131803.0907064472,6248.448216735257,138051.53892318247,782,80,275.962962962963,26,1,21,31.943192064923352,0.6658653846153846,43.28703703703704,1026.851851851852,39.494301994302,0
1014,4,0,0,27,0.0,0.0,1.0,27,700,400,300,0.5714285714285714,10,4,6,440.5627730330068,0.3682336182336183,0.031628383190883236,0.26182016225961524,131882.33500990688,6220.489445206502,138102.82445511338,783,81,276.962962962963,26,1,22,31.896659655448723,0.6666666666666667,43.209876543209866,1027.1604938271594,39.50617283950613,0
1015,4,0,0,27,0.0,0.0,1.0,27,800,600,200,0.75,10,6,4,442.9215087063293,0.3671058879392213,0.027876502422230276,0.2640478358527704,132001.24611816023,6293.238216354194,138294.48433451442,784,82,277.962962962963,26,1,23,31.715222505881755,0.6678685897435898,43.094135802469125,1027.6234567901224,39.5239791073124,0
1016,4,0,0,27,0.0,0.0,1.0,27,700,500,200,0.7142857142857143,9,5,4,440.891632248248,0.3666310541310542,0.025028631152918424,0.26366427774127693,132120.21081008977,6250.1390794086055,138370.34988949838,785,83,278.962962962963,26,1,23,31.646527569298513,0.6690705128205128,42.978395061728385,1028.0864197530852,39.541785375118664,0
1017,4,0,0,27,0.0,0.0,1.0,27,800,700,100,0.875,9,7,2,440.891632248248,0.3666310541310542,0.025028631152918424,0.26366427774127693,132120.21081008977,6250.1390794086055,138370.34988949838,786,84,279.962962962963,26,1,23,31.646527569298513,0.6690705128205128,42.978395061728385,1028.0864197530852,39.541785375118664,0
1018,4,0,0,27,0.0,0.0,1.0,27,950,600,350,0.631578947368421,13,6,7,437.48292561373137,0.3669278252611586,0.022187779499913907,0.26300258476706445,132318.6043714753,6177.426030711767,138496.03040218705,787,85,280.962962962963,26,1,23,31.532798360082,0.671073717948718,42.78549382716049,1028.8580246913573,39.57146248812913,0
1019,4,1,0,28,0.03571428571428571,0.0,1.0,28,600,500,100,0.8333333333333334,7,5,2,422.8095346321754,0.3725198412698412,0.02040521581249477,0.2568011594555424,132704.48022959183,5621.743905895689,138326.22413548752,788,0,271.89285714285717,27,1,21,31.519593683805123,0.6712962962962963,42.410714285714285,1030.357142857143,38.161375661375665,0
1020,4,0,0,28,0.0,0.0,1.0,28,900,800,100,0.8888888888888888,10,8,2,422.8095346321754,0.3725198412698412,0.02040521581249477,0.2568011594555424,132704.48022959183,5621.743905895689,138326.22413548752,789,1,272.89285714285717,27,1,21,31.519593683805123,0.6712962962962963,42.410714285714285,1030.357142857143,38.161375661375665,0
1021,4,0,0,28,0.0,0.0,1.0,28,750,500,250,0.6666666666666666,10,5,5,423.3781715193962,0.3721340388007055,0.013774331903662507,0.25820105389844833,132857.85147392272,5649.822845804969,138507.6743197277,790,2,273.89285714285717,27,1,21,31.34983641262511,0.6728395061728395,42.26190476190475,1030.9523809523796,38.1834215167548,0
1022,4,0,0,28,0.0,0.0,1.0,28,600,300,300,0.5,9,3,6,421.3039485766761,0.3713073192239859,0.018109668109667965,0.2574635241301906,132934.5703124997,5601.171874999955,138535.74218749965,791,3,274.89285714285717,27,1,21,31.325757575757564,0.6736111111111112,42.18749999999998,1031.2499999999977,38.19444444444436,0
1023,4,0,0,28,0.0,0.0,1.0,28,800,500,300,0.625,11,5,6,416.4106406246961,0.37039792768959434,0.04065365695661827,0.2269196826940911,128508.47463750163,5102.4592499009095,133610.93388740253,792,4,275.89285714285717,28,0,19,35.96045297813047,0.6253720238095238,46.51580459770115,1013.9367816091952,36.21202791461412,8
1024,4,0,0,28,0.0,0.0,1.0,28,350,100,250,0.2857142857142857,6,1,5,416.2069356755078,0.37053571428571425,0.039327207221794724,0.2270161168468108,128544.89736094588,5100.255565464381,133645.15292641026,793,5,276.89285714285717,28,0,19,35.92820204023803,0.6257440476190477,46.47988505747126,1014.0804597701142,36.21715927750408,0
1025,4,1,0,29,0.034482758620689655,0.0,1.0,29,750,400,350,0.5333333333333333,11,4,7,404.17615267157095,0.3764367816091954,0.034793923792820536,0.22293698194870795,128989.67013888877,4626.909722222204,133616.57986111098,794,0,268.3103448275862,29,0,21,35.77727645611156,0.6271551724137931,46.04166666666666,1015.8333333333323,35.028735632183874,0
1026,4,2,1,30,0.06451612903225806,0.03225806451612903,0.967741935483871,31,750,400,350,0.5333333333333333,11,4,7,400.15705606948467,0.389426523297491,0.0546442904993254,0.20722320073134637,126449.06790163612,3926.147350849824,130375.21525248594,795,0,251.93548387096774,30,1,18,38.49336273330661,0.5982638888888889,48.55510752688173,1005.7795698924739,33.525985663082466,8
1027,4,3,0,33,0.09090909090909091,0.0,1.0,33,600,400,200,0.6666666666666666,8,4,4,375.9563340760525,0.4032118055555556,0.06056053207674639,0.19794088597662712,127123.84458537403,2958.60291679422,130082.44750216824,796,0,237.54545454545453,32,1,21,38.40668169108135,0.5999348958333333,47.88510101010102,1008.4595959595966,31.514362373737395,0
1028,4,0,0,33,0.0,0.0,1.0,33,750,500,250,0.6666666666666666,10,5,5,375.9563340760525,0.4032118055555556,0.06056053207674639,0.19794088597662712,127123.84458537403,2958.60291679422,130082.44750216824,797,1,238.54545454545453,32,1,21,38.40668169108135,0.5999348958333333,47.88510101010102,1008.4595959595966,31.514362373737395,0
1029,4,0,0,33,0.0,0.0,1.0,33,650,300,350,0.46153846153846156,10,3,7,377.20425479890287,0.40388257575757575,0.06021916498822244,0.19890988723355985,127187.51793503201,2995.134584481158,130182.65251951317,798,2,239.54545454545453,32,1,21,38.30970709725874,0.6005859375,47.82196969696969,1008.7121212121201,31.522253787878753,0
1030,4,1,0,34,0.029411764705882353,0.0,1.0,34,900,600,300,0.6666666666666666,12,6,6,368.71080880008526,0.4075311942959002,0.06567616737416682,0.19651070578905627,127617.73003472213,2610.8072916666574,130228.53732638879,799,0,233.47058823529412,33,1,18,38.08204467353953,0.6025883838383839,47.39583333333333,1010.4166666666658,30.618686868686844,0
1031,4,0,1,33,0.0,0.029411764705882353,0.9705882352941176,34,650,300,350,0.46153846153846156,10,3,7,380.14305727592273,0.4070484254307784,0.051884241869317727,0.18993185574490232,124969.36462238086,2701.2472666762815,127670.61188905714,800,1,234.47058823529412,33,1,21,40.52822547697838,0.5754419191919191,50.03063725490196,999.8774509803925,30.29931669637553,8
1032,4,3,1,35,0.08333333333333333,0.027777777777777776,0.9722222222222222,36,700,400,300,0.5714285714285714,10,4,6,362.7973198716476,0.42200727513227515,0.0612329294095022,0.18459417361643135,125724.42618580679,1922.4969725222998,127646.9231583291,801,0,209.25,35,1,21,40.18044335449127,0.5788690476190477,49.276620370370374,1002.8935185185188,28.65410052910054,0
1033,4,2,0,37,0.05405405405405406,0.0,1.0,37,800,600,200,0.75,10,6,4,353.9354616194608,0.4259259259259259,0.073256860618091,0.18189397986800748,126136.14843149268,1530.0268640555837,127666.17529554827,802,0,204.40540540540542,33,4,23,39.97791366760198,0.5874368686868687,48.86642156862745,1004.53431372549,30.440433749257274,0
1034,4,1,0,38,0.02631578947368421,0.0,1.0,38,950,600,350,0.631578947368421,13,6,7,343.85257996622227,0.42634246088193456,0.08124307200271375,0.17794729406352036,126421.84452428421,1094.095480752756,127515.94000503697,803,0,200.0,35,3,16,39.93710918018954,0.5860119047619048,48.58217592592593,1005.671296296297,28.73346560846563,0
1035,4,3,1,40,0.07317073170731707,0.024390243902439025,0.975609756097561,41,900,600,300,0.6666666666666666,12,6,6,320.7767885906563,0.4338160569105691,0.09600759196375797,0.1693326007930366,127230.25504241695,-35.725864888025626,127194.52917752892,804,0,186.29268292682926,37,4,19,39.68896043908272,0.5903716216216216,47.7796052631579,1008.8815789473688,27.26706970128024,0
1036,4,0,1,39,0.0,0.025,0.975,40,1050,800,250,0.7619047619047619,13,8,5,330.4861050709219,0.4309695512820513,0.09983528754885551,0.17398607118813103,127120.40323685187,402.30538815844943,127522.70862501032,805,1,191.875,36,4,19,39.556579192257594,0.5911458333333333,47.88851351351352,1008.4459459459472,28.01238738738742,0
1037,4,1,0,40,0.025,0.0,1.0,40,750,500,250,0.6666666666666666,10,5,5,337.4081879603294,0.4277777777777778,0.12002454261490403,0.17875455064281318,127376.05003652327,595.5444464735347,127971.5944829968,806,0,192.625,36,4,15,39.12013795924439,0.59375,47.63513513513515,1009.4594594594616,28.0405405405406,0
1038,4,1,2,39,0.024390243902439025,0.04878048780487805,0.9512195121951219,41,1350,900,450,0.6666666666666666,18,9,9,328.0579364344485,0.4292682926829268,0.12579451464181624,0.17556716377609136,127783.97108966243,184.10917301479157,127968.08026267722,807,0,188.90243902439025,37,4,16,38.93908379423776,0.5960022522522522,47.231359649122815,1011.0745614035106,27.32633949739218,0
1039,4,0,0,39,0.0,0.0,1.0,39,1350,1000,350,0.7407407407407407,17,10,7,378.0963794698764,0.42414529914529914,0.20562608912123492,0.19063460811033633,125347.46334876544,1686.5023238988083,127033.96567266424,808,1,199.43589743589743,35,4,16,40.18723994452151,0.575,49.65277777777778,1001.3888888888889,28.61111111111111,8
1040,4,3,1,41,0.07142857142857142,0.023809523809523808,0.9761904761904762,42,1000,800,200,0.8,12,8,4,355.9089667397022,0.43429394115369724,0.2120798077239654,0.18275609546551097,126101.95500042866,581.9503386488319,126683.9053390775,809,0,186.11904761904762,35,7,19,39.96360528539603,0.5827380952380952,48.90046296296296,1004.398148148148,28.697089947089943,0
1041,4,3,1,43,0.06818181818181818,0.022727272727272728,0.9772727272727273,44,1150,700,450,0.6086956521739131,16,7,9,340.41960809361416,0.4379074171952079,0.22023785965884324,0.17811932569271785,126870.98434133576,-162.1258464142888,126708.85849492147,810,0,178.4318181818182,37,7,19,39.56201930053692,0.5867117117117118,48.1359649122807,1007.4561403508769,27.228544333807484,0
1042,4,1,0,44,0.022727272727272728,0.0,1.0,44,1300,1000,300,0.7692307692307693,16,10,6,339.84458092673594,0.4363658386187456,0.21460745824392125,0.1784232571364637,127009.10526556234,-167.32876942906788,126841.77649613327,811,0,179.38636363636363,37,7,20,39.43478280575802,0.5881193693693694,47.998903508771924,1008.0043859649111,27.243361782835436,0
1043,4,1,1,44,0.022222222222222223,0.022222222222222223,0.9777777777777777,45,1100,700,400,0.6363636363636364,15,7,8,332.008234194804,0.4371843434343434,0.2079980686824794,0.1757409888305445,127340.9020684248,-544.3273411049711,126796.57472731982,812,0,176.37777777777777,37,8,16,39.2923909107369,0.5914977477477478,47.66995614035087,1009.3201754385957,27.278923660502585,0
1044,4,0,0,44,0.0,0.0,1.0,44,1500,900,600,0.6,21,9,12,342.6437668613773,0.43546291402396053,0.21432739043521454,0.18089248717213224,127233.9923327045,-80.81311886209275,127153.1792138424,813,2,181.38636363636363,36,8,21,39.133599360047626,0.5923032407407407,47.77590090090091,1008.8963963963978,28.02489989989994,0
1045,4,3,2,45,0.06382978723404255,0.0425531914893617,0.9574468085106383,47,1100,600,500,0.5454545454545454,16,6,10,324.0615572950414,0.43994757940178847,0.22783198347266387,0.17454456728509005,128041.65556423076,-1101.3243398440238,126940.33122438674,814,0,170.74468085106383,40,7,20,38.77711115573854,0.5934895833333333,46.976626016260155,1012.0934959349579,25.302337398373947,0
1046,4,2,2,45,0.0425531914893617,0.0425531914893617,0.9574468085106383,47,1100,700,400,0.6363636363636364,15,7,8,322.13878955192746,0.44148936170212766,0.2234426761381103,0.17451518773117466,128273.18395135172,-1135.6463579879671,127137.53759336376,815,0,171.2340425531915,40,7,22,38.58973715890851,0.5958333333333333,46.7479674796748,1013.0081300813009,25.325203252032523,0
1047,4,0,0,45,0.0,0.0,1.0,45,1250,900,350,0.72,16,9,7,337.68869906629374,0.43632154882154883,0.2247193066703257,0.18211202982942515,128091.8023003471,-348.96918402778687,127742.83311631932,816,1,179.6,39,6,22,38.38109693352543,0.5956196581196581,46.92708333333333,1012.2916666666656,25.956196581196554,0
1048,4,1,1,45,0.021739130434782608,0.021739130434782608,0.9782608695652174,46,1250,900,350,0.72,16,9,7,328.703904085873,0.4386473429951691,0.2239702517162474,0.17843926221804512,128355.55555555546,-761.7947048611172,127593.76085069434,817,0,176.67391304347825,39,7,23,38.33950109649124,0.5982905982905983,46.666666666666664,1013.3333333333326,25.982905982905965,0
1049,4,0,4,41,0.0,0.08888888888888889,0.9111111111111111,45,1100,900,200,0.8181818181818182,13,9,4,308.65056999898354,0.43562710437710433,0.08878022276555275,0.1686772890560988,128622.09590143932,-1057.3655793335847,127564.73032210574,818,1,181.13333333333333,41,4,16,38.57650774246127,0.5978150406504066,46.40376984126984,1014.384920634921,24.741095625241975,8
1050,4,1,0,42,0.023809523809523808,0.0,1.0,42,750,300,450,0.4,12,3,9,316.0504684631104,0.43545538133952766,0.10192762867573313,0.17288106270309278,128658.86843450923,-267.46087186794796,128391.40756264128,819,0,187.0,38,4,18,38.35145499859589,0.6030701754385965,46.367521367521356,1014.5299145299127,26.698155645524018,0
1051,4,2,2,42,0.045454545454545456,0.045454545454545456,0.9545454545454546,44,600,300,300,0.5,9,3,6,304.48039702216585,0.4383698907681466,0.12957013279693075,0.1690749508379058,129254.34570312499,-927.7756732709663,128326.57002985402,820,0,179.45454545454547,39,5,20,38.040787406952134,0.6073717948717949,45.78125,1016.8749999999999,26.073717948717945,0
1052,4,4,0,46,0.08695652173913043,0.0,1.0,46,1200,1000,200,0.8333333333333334,14,10,4,328.3497164461245,0.4448772141706924,0.22058601134215472,0.17321200638213013,127202.60080024641,-742.8255268447803,126459.77527340162,821,0,172.32608695652175,37,9,21,39.52626811594201,0.5900900900900901,47.80701754385966,1008.7719298245629,27.264106211474672,8
1053,4,2,1,47,0.041666666666666664,0.020833333333333332,0.9791666666666666,48,750,200,550,0.26666666666666666,13,2,11,322.9576175989792,0.4485261524822695,0.2017230196435187,0.16684176036066317,126350.1710807885,-1416.3189818370033,124933.8520989515,822,0,166.10416666666666,40,8,16,40.53602715724922,0.5763020833333333,48.65345528455284,1005.3861788617882,25.134654471544703,8
1054,4,1,1,47,0.020833333333333332,0.020833333333333332,0.9791666666666666,48,1250,600,650,0.48,19,6,13,318.1822988247029,0.4477504432624113,0.22082323538321758,0.16540468794021151,126605.73365928004,-1543.2593239804505,125062.47433529959,823,0,166.97916666666666,40,8,17,40.393904204113234,0.57890625,48.39939024390243,1006.402439024389,25.160060975609724,0
1055,4,3,2,48,0.06,0.04,0.96,50,950,600,350,0.631578947368421,13,6,7,318.70765257082843,0.4502891156462585,0.2681056541477511,0.1689778210457585,127407.31336805536,-1876.06658259801,125531.24678545735,824,0,161.2,39,11,14,39.56011831063421,0.5886752136752137,47.60416666666666,1009.5833333333318,25.886752136752097,0
1056,4,2,3,47,0.04,0.06,0.94,50,1650,900,750,0.5454545454545454,24,9,15,324.2191412524481,0.4507142857142857,0.2669841269841269,0.17302387835155394,127670.361328125,-1721.3650173611127,125948.99631076389,825,0,161.96,39,11,15,39.152150759293626,0.5913461538461539,47.34375,1010.625,25.91346153846154,0
1057,4,0,2,45,0.0,0.0425531914893617,0.9574468085106383,47,750,200,550,0.26666666666666666,13,2,11,347.7606515454977,0.4468085106382979,0.2721333355498927,0.18359385251597626,127233.99233270445,-550.6047855287568,126683.38754717569,826,2,173.17021276595744,36,11,23,39.00453919708301,0.5923032407407407,47.77590090090091,1008.8963963963974,28.02489989989993,0
1058,4,0,0,45,0.0,0.0,1.0,45,1100,900,200,0.8181818181818182,13,9,4,348.48713481117727,0.445496632996633,0.28548401096107767,0.18423558790813954,127290.8059030316,-128.1583526093488,127162.64755042226,827,3,181.24444444444444,36,9,23,38.927947029721366,0.5928819444444444,47.719594594594604,1009.1216216216233,28.0311561561562,0
1059,4,1,3,43,0.021739130434782608,0.06521739130434782,0.9347826086956522,46,1050,700,350,0.6666666666666666,14,7,7,337.36569511063857,0.4478562801932367,0.28191907535710814,0.17974464105134141,127604.23657909648,-590.1416054861415,127014.09497361034,828,0,178.2826086956522,38,8,17,38.88764054844737,0.5923793859649122,47.40918803418804,1010.363247863249,26.58850652271708,0
1060,4,2,1,44,0.044444444444444446,0.022222222222222223,0.9777777777777777,45,700,400,300,0.5714285714285714,10,4,6,335.61719203046954,0.44915824915824915,0.2740599915504853,0.18013739082451763,127901.25739645002,-414.8278270874034,127486.42956936262,829,0,173.95555555555555,38,7,19,38.62814216307564,0.5953947368421053,47.115384615384635,1011.5384615384642,26.619433198380637,0
1061,4,0,1,43,0.0,0.022727272727272728,0.9772727272727273,44,750,500,250,0.6666666666666666,10,5,5,335.71349170023143,0.4500748766737139,0.2604359680872508,0.18031032631364138,127928.27641034804,-210.55032781792255,127717.72608253012,830,1,172.6818181818182,38,6,20,38.59810082022037,0.5956688596491229,47.08867521367523,1011.6452991453017,26.622244714350046,0
1062,4,1,0,44,0.022727272727272728,0.0,1.0,44,900,700,200,0.7777777777777778,11,7,4,335.7643012788826,0.4497445384073291,0.2641136963300552,0.181068113524042,128090.45041867575,-198.35988293518113,127892.09053574057,831,0,173.45454545454547,38,6,22,38.431178540017584,0.5973135964912281,46.928418803418815,1012.2863247863263,26.63911381016648,0
1063,4,1,0,45,0.022222222222222223,0.0,1.0,45,1350,1100,250,0.8148148148148148,16,11,5,332.206334102974,0.4503787878787879,0.26950242120567625,0.1810201515291809,128505.59937913588,-461.9023551619065,128043.69702397397,832,0,170.57777777777778,37,8,17,38.09782902562991,0.603322072072072,46.51864035087719,1013.9254385964912,27.4033902323376,0
1064,4,0,0,45,0.0,0.0,1.0,45,1100,900,200,0.8181818181818182,13,9,4,334.91688096281615,0.4503787878787879,0.2744609026801703,0.18275199008997542,128561.1934080677,-388.5372181825328,128172.65618988517,833,1,171.57777777777778,37,8,17,37.97246098677337,0.6038851351351351,46.46381578947368,1014.144736842104,27.409317211948757,0
1065,4,1,1,45,0.021739130434782608,0.021739130434782608,0.9782608695652174,46,1150,900,250,0.782608695652174,14,9,5,329.7694431690646,0.4519524959742351,0.28166172595520456,0.1813731937429852,128875.73964497015,-700.1438198553885,128175.59582511475,834,0,168.82608695652175,38,8,18,37.78277567340064,0.6052631578947368,46.15384615384614,1015.3846153846132,26.720647773279296,0
1066,4,0,2,43,0.0,0.044444444444444446,0.9555555555555556,45,700,300,400,0.42857142857142855,11,3,8,336.8972464080547,0.4511784511784512,0.282465296524254,0.18538356500207892,128895.01006319223,-315.125206794432,128579.8848563978,835,1,172.9777777777778,37,8,18,37.58222204225605,0.6072635135135135,46.134868421052616,1015.460526315787,27.444879089615863,0
1067,4,0,0,43,0.0,0.0,1.0,43,1050,600,450,0.5714285714285714,15,6,9,354.6248802984537,0.448297342192691,0.29620116119856155,0.19376137474661126,128613.7099194099,521.9242969821416,129135.63421639203,836,2,181.74418604651163,35,8,19,37.41917693595011,0.6083333333333334,46.412037037037024,1014.3518518518498,28.981481481481424,0
1068,4,1,0,44,0.022727272727272728,0.0,1.0,44,600,300,300,0.5,9,3,6,348.99776912423886,0.4497115045806906,0.2953990884891511,0.19186365161122765,128858.14868922955,194.2412852041008,129052.38997443365,837,0,178.5909090909091,36,8,20,37.31260167110324,0.6087962962962963,46.17117117117116,1015.3153153153135,28.203203203203152,0
1069,4,2,2,44,0.043478260869565216,0.043478260869565216,0.9565217391304348,46,1550,1100,450,0.7096774193548387,20,11,9,339.96854563623435,0.45133856682769724,0.19029550932952422,0.18602773227510783,128672.41753472213,-427.63679008400754,128244.78074463812,838,0,171.7826086956522,39,7,17,37.73100616016428,0.6014957264957265,46.354166666666664,1014.5833333333326,26.014957264957246,8
1070,4,0,0,44,0.0,0.0,1.0,44,1550,1000,550,0.6451612903225806,21,10,11,350.07454516686516,0.447938689217759,0.19952388439579072,0.19128999511746403,128616.79945992985,205.09351435056146,128821.89297428042,839,1,180.1590909090909,37,7,17,37.53141552264621,0.6044481981981982,46.40899122807017,1014.3640350877183,27.415244191559953,0
1071,4,1,0,45,0.022222222222222223,0.0,1.0,45,1250,700,550,0.56,18,7,11,342.9607536394302,0.4489057239057239,0.20288412097415054,0.18914564069627038,128984.24373584626,-152.69331214844448,128831.55042369782,840,0,177.13333333333333,38,7,18,37.337417613237974,0.606359649122807,46.047008547008545,1015.8119658119655,26.731893837156985,0
1072,4,1,0,46,0.021739130434782608,0.0,1.0,46,1700,1300,400,0.7647058823529411,21,13,8,337.7239601428147,0.4493156199677939,0.2029030045518112,0.18753477240694863,129254.34570312501,-469.5421006944437,128784.80360243058,841,0,174.2608695652174,39,7,19,37.19567370074439,0.6073717948717949,45.78125,1016.8750000000001,26.073717948717952,0
1073,4,0,0,46,0.0,0.0,1.0,46,1100,700,400,0.6363636363636364,15,7,8,340.1952608927248,0.4486714975845411,0.2056424685465985,0.1894154457171238,129360.29188368065,-398.44835069443934,128961.84353298621,842,1,175.2608695652174,39,7,20,37.025138234691795,0.608440170940171,45.677083333333336,1017.2916666666674,26.084401709401728,0
1074,4,0,1,45,0.0,0.021739130434782608,0.9782608695652174,46,1200,1000,200,0.8333333333333334,14,10,4,339.52477058834825,0.44806763285024154,0.20965387405590907,0.18942418525857063,129439.78000217004,-410.3976779513973,129029.38232421865,843,2,176.2608695652174,39,7,17,36.96141280240217,0.6092414529914529,45.59895833333333,1017.6041666666658,26.09241452991451,0
1075,4,1,0,46,0.021739130434782608,0.0,1.0,46,900,600,300,0.6666666666666666,12,6,6,341.90415219074225,0.4485104669887279,0.21550558599587277,0.1916545293472874,129625.34722222203,-336.1111111111306,129289.2361111109,844,0,176.80434782608697,39,7,18,36.71235679214402,0.6111111111111112,45.41666666666666,1018.3333333333318,26.11111111111107,0
1076,4,1,2,45,0.02127659574468085,0.0425531914893617,0.9574468085106383,47,1250,800,450,0.64,17,8,9,340.34352962733203,0.4492175454825778,0.21968286549137184,0.19250321174073504,129977.44914568008,-552.6032371604658,129424.84590851961,845,0,174.0212765957447,40,7,19,36.39479934888047,0.6130208333333333,45.07113821138209,1019.7154471544683,25.492886178861706,0
1077,4,0,1,44,0.0,0.022222222222222223,0.9777777777777777,45,1100,600,500,0.5454545454545454,16,6,10,356.22763534266534,0.4465488215488216,0.22553408974752154,0.20063183399869267,129811.0473632811,248.4564887152612,130059.50385199637,846,1,182.37777777777777,39,6,20,36.15891938396539,0.6129807692307692,45.23437499999999,1019.0624999999989,26.12980769230766,0
1078,4,0,0,44,0.0,0.0,1.0,44,1650,1000,650,0.6060606060606061,23,10,13,365.14479983851135,0.44535103946441157,0.2288596808936505,0.20559333535181346,129799.47973738032,679.1210095697236,130478.60074695003,847,2,186.61363636363637,38,6,20,35.94350667505418,0.6145833333333333,45.245726495726494,1019.0170940170935,26.816239316239304,0
1079,4,0,0,44,0.0,0.0,1.0,44,1350,900,450,0.6666666666666666,18,9,9,364.98897460074704,0.44494362226920364,0.2365618033192971,0.20607839027457558,129908.37191358017,683.024691358017,130591.39660493819,848,3,187.61363636363637,38,6,20,35.836739327883734,0.6156798245614035,45.138888888888886,1019.4444444444438,26.82748538011694,0
1080,4,0,1,43,0.0,0.022727272727272728,0.9772727272727273,44,1150,900,250,0.782608695652174,14,9,5,364.35899451700527,0.4448885658914729,0.2271727329866864,0.2062972100628312,130017.30974687712,674.5952498356405,130691.90499671275,849,4,188.61363636363637,38,6,20,35.742064739157755,0.6167763157894737,45.032051282051285,1019.8717948717953,26.83873144399461,0
1081,4,0,0,43,0.0,0.0,1.0,43,1550,1300,250,0.8387096774193549,18,13,5,374.211692546039,0.44352159468438535,0.22725238346464316,0.21184071529949577,130010.8582087761,1130.3166599338615,131141.17486870996,850,5,192.74418604651163,37,6,20,35.49741515249257,0.6185247747747749,45.03837719298247,1019.8464912280728,27.563418681839803,0
1082,4,0,0,43,0.0,0.0,1.0,43,1350,900,450,0.6666666666666666,18,9,9,375.2131552345273,0.4432447397563677,0.2218662134636289,0.2130175966721953,130122.70752779729,1164.7503318329009,131287.4578596302,851,6,193.74418604651163,37,6,20,35.35811839512808,0.6196509009009009,44.92872807017545,1020.2850877193005,27.575272641062174,0
1083,4,0,1,42,0.0,0.023255813953488372,0.9767441860465116,43,900,700,200,0.7777777777777778,11,7,4,375.4022113797648,0.4423218899963086,0.21838330997509225,0.2137381764975069,130234.60493853912,1178.0717384195514,131412.67667695868,852,7,194.74418604651163,37,6,21,35.239530740860104,0.620777027027027,44.81907894736844,1020.7236842105291,27.58712660028457,0
1084,4,1,0,43,0.023255813953488372,0.0,1.0,43,1100,700,400,0.6363636363636364,15,7,8,373.91500711963994,0.4433370247323736,0.23448365308830388,0.21520885965330416,130654.64854570659,1170.7497739689377,131825.39831967553,853,0,191.95348837209303,37,6,18,34.85092235092235,0.625,44.40789473684212,1022.3684210526333,27.631578947368467,0
1085,4,0,0,43,0.0,0.0,1.0,43,1400,1000,400,0.7142857142857143,18,10,8,372.52440020311263,0.4427833148763381,0.23178011959562927,0.21471956466589825,130710.70545744868,1138.5854301323764,131849.29088758107,854,1,192.95348837209303,37,6,19,34.8295982557724,0.6255630630630631,44.35307017543861,1022.5877192982475,27.637505926979664,0
1086,4,0,0,43,0.0,0.0,1.0,43,1000,600,400,0.6,14,6,8,375.5169424384332,0.4422526762643042,0.2359683607256191,0.21691625733796585,130794.81336805575,1223.133680555576,132017.94704861133,855,2,193.95348837209303,37,6,19,34.667769857433804,0.6264076576576576,44.27083333333334,1022.9166666666682,27.646396396396437,0
1087,4,0,2,41,0.0,0.046511627906976744,0.9534883720930233,43,800,400,400,0.5,12,4,8,363.2422318531872,0.441860465116279,0.15820940554360186,0.20188548332030104,129289.65627411277,883.838493441376,130173.49476755415,856,3,194.95348837209303,35,8,20,36.51096790713555,0.6151785714285714,45.746527777777786,1017.0138888888898,29.05753968253971,8
1088,4,0,1,40,0.0,0.024390243902439025,0.975609756097561,41,1600,1100,500,0.6875,21,11,10,372.88035276048186,0.4402439024390244,0.16732112479845895,0.20755195822747802,129348.51794249412,1446.3041998885556,130794.82214238268,857,4,203.34146341463415,35,6,20,36.20588709371562,0.6157738095238094,45.68865740740741,1017.2453703703713,29.06415343915347,0
1089,4,2,0,42,0.047619047619047616,0.0,1.0,42,1300,800,500,0.6153846153846154,18,8,10,348.11661196246666,0.43841947348044913,0.14626905843796,0.19234881749769378,129058.31665702877,606.9390973297961,129665.25575435857,858,0,198.66666666666666,36,6,18,37.131035501865604,0.6108217592592593,45.97409909909911,1016.1036036036046,28.22510010010013,8
1090,4,1,1,42,0.023255813953488372,0.023255813953488372,0.9767441860465116,43,1250,1000,250,0.8,15,10,5,338.2923974435199,0.4420450350682909,0.14081796311146788,0.1886630678050397,129424.43828870401,156.66070329329884,129581.0989919973,859,0,195.02325581395348,37,6,19,37.008351293103445,0.6126126126126126,45.61403508771929,1017.5438596491211,27.501185395922192,0
1091,4,0,2,40,0.0,0.047619047619047616,0.9523809523809523,42,1650,1100,550,0.6666666666666666,22,11,11,344.1264272249046,0.44093592721641506,0.14145038409256183,0.19222587449064812,129487.77113261906,512.0328098368645,129999.80394245592,860,1,199.28571428571428,36,6,16,36.79556686582578,0.615162037037037,45.5518018018018,1017.7927927927924,28.27202202202201,0
1092,4,1,0,41,0.024390243902439025,0.0,1.0,41,1600,1300,300,0.8125,19,13,6,347.40179985693055,0.43788109756097565,0.13248494489262552,0.19511699046208325,129701.9692670825,811.73951367455,130513.70878075705,861,0,204.3170731707317,35,6,20,36.49455080862023,0.6193452380952381,45.34143518518518,1018.6342592592595,29.103835978835985,0
1093,4,1,0,42,0.023809523809523808,0.0,1.0,42,1350,900,450,0.6666666666666666,18,9,9,342.51748155412474,0.43976238869531553,0.13884878827901836,0.19403761348455958,130038.81602993225,508.11355417050686,130546.92958410275,862,0,200.42857142857142,37,5,21,36.27714470006449,0.6188063063063063,45.0109649122807,1019.9561403508769,27.566382171645323,0
1094,4,0,0,42,0.0,0.0,1.0,42,800,500,300,0.625,11,5,6,342.86513294331,0.43983497870692995,0.1314641935880112,0.19451324371369244,130094.74068944289,520.990112342256,130615.73080178515,863,1,201.42857142857142,37,5,22,36.211575666380035,0.6193693693693694,44.95614035087719,1020.1754385964912,27.57230915125652,0
1095,4,0,1,41,0.0,0.023809523809523808,0.9761904761904762,42,1150,800,350,0.6956521739130435,15,8,7,345.2905488497641,0.43996806039488967,-0.005963995950644341,0.18856388525800039,128593.1654188366,480.4009331597025,129073.5663519963,864,2,202.42857142857142,39,3,16,37.67683834856732,0.6006944444444444,46.43229166666666,1014.2708333333317,26.0069444444444,8
1096,4,1,1,41,0.023809523809523808,0.023809523809523808,0.9761904761904762,42,1300,1000,300,0.7692307692307693,16,10,6,339.8916092808224,0.44092382888114595,-0.009522832321928965,0.18672962931515755,128830.99500868046,357.71484374999534,129188.70985243046,865,0,196.54761904761904,39,3,17,37.57139681236747,0.6030982905982907,46.197916666666664,1015.2083333333326,26.030982905982885,0
1097,4,1,1,41,0.023809523809523808,0.023809523809523808,0.9761904761904762,42,1350,1000,350,0.7407407407407407,17,10,7,343.5442916347954,0.43855255516840885,0.027937808722799273,0.19078022518689172,129257.13320444745,482.1734211488082,129739.30662559626,866,0,197.45238095238096,37,5,18,37.04487455970097,0.6109234234234234,45.77850877192982,1016.8859649122801,27.48340445708865,0
1098,4,1,3,39,0.023809523809523808,0.07142857142857142,0.9285714285714286,42,1000,600,400,0.6,14,6,8,342.9452487190621,0.4377419667053813,0.05334000051286014,0.19193771153444775,129563.941849896,486.6676525469242,130050.60950244292,867,0,197.92857142857142,37,5,17,36.748227427750855,0.6140202702702703,45.47697368421052,1018.0921052631569,27.516002844950187,0
1099,4,0,0,39,0.0,0.0,1.0,39,1000,700,300,0.7,13,7,6,361.0246840322716,0.433816914080072,0.05249461997676863,0.20066583446243952,129292.1786422902,1535.5335884353622,130827.71223072555,868,1,212.6153846153846,34,5,20,36.56478013188185,0.6173406862745099,45.74404761904761,1017.0238095238091,29.912464985994383,0
1100,4,2,0,41,0.04878048780487805,0.0,1.0,41,1150,700,450,0.6086956521739131,16,7,9,347.40502426665824,0.4352388211382114,0.06461123837757654,0.19576684119634236,129831.84831791252,820.8472830939004,130652.69560100642,869,0,203.1951219512195,36,5,19,36.362569060773474,0.6186342592592593,45.21396396396396,1019.1441441441443,28.309559559559563,0
1101,4,0,2,39,0.0,0.04878048780487805,0.9512195121951219,41,950,400,550,0.42105263157894735,15,4,11,350.103169803613,0.4350863821138211,0.06604658180916756,0.19757692600139068,129889.23890106326,894.9268525282043,130784.16575359147,870,1,204.1951219512195,36,5,19,36.23554647223449,0.619212962962963,45.15765765765766,1019.3693693693697,28.315815815815824,0
1102,4,0,0,39,0.0,0.0,1.0,39,750,500,250,0.6666666666666666,10,5,5,364.4357784304967,0.43218623481781376,0.06192549588776064,0.20422331074086028,129613.56122470832,1647.1638160150728,131260.7250407234,871,2,214.25641025641025,35,4,19,36.15073501553384,0.618452380952381,45.42824074074073,1018.2870370370356,29.093915343915302,0
1103,4,0,0,39,0.0,0.0,1.0,39,1000,600,400,0.6,14,6,8,360.23200745856104,0.43120220422852,0.05928760754631357,0.202253166198801,129688.42734203796,1543.584505113213,131232.01184715118,872,3,215.25641025641025,36,3,19,36.18159203980098,0.6171875,45.354729729729726,1018.5810810810809,28.293918918918916,0
1104,4,1,0,40,0.025,0.0,1.0,40,1400,1100,300,0.7857142857142857,17,11,6,356.86949967781214,0.4338942307692308,0.06770049451730764,0.20216809293562776,130038.81602993228,1281.3774430593953,131320.19347299167,873,0,210.85,37,3,20,35.91118397477241,0.6188063063063063,45.0109649122807,1019.9561403508771,27.56638217164533,0
1105,4,0,0,40,0.0,0.0,1.0,40,950,500,450,0.5263157894736842,14,5,9,359.92061621117824,0.43392094017094013,0.06437696335078513,0.20435445212941453,130126.29323727083,1367.0271294470022,131493.32036671785,874,1,211.85,38,2,20,35.74454624781849,0.6178728070175439,44.925213675213676,1020.2991452991456,26.849977507872254,0
1106,4,0,0,40,0.0,0.0,1.0,40,750,500,250,0.6666666666666666,10,5,5,362.33792687424966,0.43344017094017095,0.07328326180257516,0.2061592742959921,130208.06081753602,1435.8637637884462,131643.92458132448,875,2,212.85,38,2,20,35.599855193830905,0.6186951754385965,44.84508547008547,1020.6196581196585,26.858412055780487,0
1107,4,0,1,39,0.0,0.025,0.975,40,850,500,350,0.5882352941176471,12,5,7,361.0905416217632,0.43285256410256406,0.07341733759788283,0.20604203529795637,130320.07250071014,1411.4919412422425,131731.5644419524,876,3,213.85,36,4,20,35.51799566192421,0.6235532407407407,44.73536036036036,1021.0585585585583,28.36273773773773,0
1108,4,0,0,39,0.0,0.0,1.0,39,1500,1200,300,0.8,18,12,6,360.4624919003663,0.43151147098515524,0.08624837111222261,0.20629370750966697,130435.0819358209,1603.3909331628856,132038.47286898378,877,4,219.74358974358975,36,3,20,35.41735567559622,0.6247106481481481,44.622747747747745,1021.5090090090085,28.375250250250236,0
1109,4,0,1,38,0.0,0.02564102564102564,0.9743589743589743,39,1250,1000,250,0.8,15,10,5,371.8699018711038,0.43114597390913184,0.06025972305042071,0.20857051017988,129647.68005540161,1857.0739422041588,131504.75399760576,878,5,220.74358974358975,37,2,19,35.926733419465975,0.6148648648648649,45.39473684210526,1018.4210526315785,27.524893314366988,7
1110,4,1,0,39,0.02564102564102564,0.0,1.0,39,1250,800,450,0.64,17,8,9,374.45031858076,0.4323268106162843,0.08254325440817167,0.21152120669282545,129927.00277970142,1930.2415166204985,131857.2442963219,879,0,221.48717948717947,37,2,20,35.57664730766474,0.6176801801801801,45.12061403508772,1019.517543859649,27.554528212422944,0
1111,4,0,0,39,0.0,0.0,1.0,39,1000,700,300,0.7,13,7,6,378.56294207541333,0.4315958164642375,0.08742862182243072,0.21476522030912482,130094.7406894429,2049.8095567867013,132144.5502462296,880,1,222.48717948717947,37,2,21,35.3011249641731,0.6193693693693694,44.95614035087719,1020.1754385964913,27.572309151256523,0
1112,4,0,1,38,0.0,0.02564102564102564,0.9743589743589743,39,1050,900,150,0.8571428571428571,12,9,3,380.481871227905,0.4313427800269905,0.095738898142254,0.21695091054307353,130292.12648158854,2114.974830737908,132407.10131232644,881,2,223.48717948717947,35,4,21,35.051416128178964,0.625297619047619,44.762731481481474,1020.9490740740731,29.169973544973516,0
1113,4,0,2,36,0.0,0.05263157894736842,0.9473684210526316,38,1700,1400,300,0.8235294117647058,20,14,6,381.5730925812129,0.4313063063063063,0.08918043447586177,0.21808897809821617,130384.1429280045,2350.2161281179065,132734.3590561224,882,3,227.92105263157896,34,4,21,34.93001321055289,0.6283700980392157,44.672619047619044,1021.3095238095235,30.038515406162457,0
1114,4,0,0,36,0.0,0.0,1.0,36,950,800,150,0.8421052631578947,11,8,3,382.6458227953297,0.42895171957671957,0.0978387510194576,0.2193887172379634,130505.75573979582,2787.4964569160893,133293.2521967119,883,4,233.13888888888889,34,2,17,34.779020544487175,0.6295955882352942,44.55357142857142,1021.7857142857134,30.052521008403335,0
1115,4,0,0,36,0.0,0.0,1.0,36,950,500,450,0.5263157894736842,14,5,9,384.45622767811204,0.42868716931216927,0.1102281988590057,0.2214684466483769,130688.28124999977,2848.7847222221935,133537.06597222196,884,5,234.13888888888889,34,2,17,34.547337679978256,0.6314338235294117,44.374999999999986,1022.4999999999982,30.073529411764653,0
1116,4,0,1,35,0.0,0.027777777777777776,0.9722222222222222,36,850,500,350,0.5882352941176471,12,5,7,381.66090039004155,0.4281580687830688,0.11322249382428673,0.22020475455009006,130749.15143140565,2780.3677721088143,133529.51920351447,885,6,235.13888888888889,34,2,17,34.55699763318202,0.632046568627451,44.315476190476176,1022.7380952380933,30.080532212885096,0
1117,4,1,0,36,0.027777777777777776,0.0,1.0,36,1050,600,450,0.5714285714285714,15,6,9,380.38510071024444,0.4281746031746032,0.11160240995009474,0.2199885299800699,130840.48327664383,2753.9540816326353,133594.43735827648,886,0,234.69444444444446,34,2,18,34.496935846714756,0.6329656862745099,44.22619047619047,1023.0952380952369,30.091036414565792,0
1118,4,1,1,36,0.02702702702702703,0.02702702702702703,0.972972972972973,37,1200,900,300,0.75,15,9,6,375.4812022537,0.4290853353353354,0.11309094906022188,0.21924535635552458,131209.51753257884,2453.3414780521266,133662.85901063096,887,0,229.32432432432432,35,2,19,34.248380780237994,0.6345238095238095,43.86574074074074,1024.537037037037,29.27248677248677,0
1119,4,0,1,35,0.0,0.027777777777777776,0.9722222222222222,36,600,300,300,0.5,9,3,6,376.4703613251922,0.4270998677248677,0.11858419295735723,0.22016305014354398,131268.81456833013,2683.763610253795,133952.57817858394,888,1,234.86111111111111,35,1,20,34.16299600933664,0.6351190476190476,43.80787037037038,1024.7685185185203,29.279100529100578,0
1120,4,0,0,35,0.0,0.0,1.0,35,950,700,250,0.7368421052631579,12,7,5,381.38674069667513,0.42531512605042016,0.11893147502903578,0.2233836624080526,131328.12500000003,3017.374507030179,134345.4995070302,889,2,240.34285714285716,33,2,21,33.97696476964768,0.6401515151515151,43.75,1025.0000000000002,31.060606060606066,0
1121,4,0,0,35,0.0,0.0,1.0,35,550,300,250,0.5454545454545454,8,3,5,384.5935897107802,0.4242997198879552,0.11658016935263582,0.2260027499086944,131453.76778162245,3111.2552864282925,134565.02306805074,890,3,241.34285714285716,33,2,21,33.767527087316765,0.6414141414141414,43.627450980392155,1025.4901960784314,31.075460487225193,0
1122,4,0,1,34,0.0,0.02857142857142857,0.9714285714285714,35,1100,600,500,0.5454545454545454,16,6,10,384.5333534068527,0.4246848739495798,0.11568799298860677,0.2161342641562655,129731.44531249997,2977.213541666667,132708.65885416663,891,4,242.34285714285716,35,0,20,35.51891615541922,0.6196428571428572,45.3125,1018.7499999999998,29.10714285714285,8
1123,4,0,0,34,0.0,0.0,1.0,34,700,400,300,0.5714285714285714,10,4,6,393.47703691172705,0.4230540701128936,0.12705222341390976,0.22090482465989086,129685.96938775516,3405.6901927437725,133091.65958049893,892,6,250.35294117647058,34,0,20,35.337531167212084,0.6213235294117647,45.35714285714286,1018.571428571429,29.957983193277325,0
1124,4,1,0,35,0.02857142857142857,0.0,1.0,35,850,600,250,0.7058823529411765,11,6,5,388.6400171272791,0.4243347338935574,0.1314013420208111,0.2204294151196806,130085.4190779321,3111.279899691361,133196.69897762345,893,0,244.17142857142858,35,0,21,35.053607896528256,0.6232142857142857,44.96527777777778,1020.1388888888889,29.1468253968254,0
1125,4,1,1,35,0.027777777777777776,0.027777777777777776,0.9722222222222222,36,1200,1000,200,0.8333333333333334,14,10,4,381.52896959031165,0.4263062169312169,0.12894577858329548,0.2187102430872254,130498.99798525375,2757.950210048008,133256.94819530175,894,0,238.36111111111111,35,1,17,34.81441625132155,0.6273809523809524,44.56018518518518,1021.7592592592591,29.19312169312169,0
1126,4,0,0,35,0.0,0.0,1.0,35,1400,1100,300,0.7857142857142857,17,11,6,393.2868331341858,0.4239145658263305,0.13698438592402673,0.22531292402921144,130475.3472222224,3262.8472222222417,133738.19444444464,895,2,246.17142857142858,34,1,21,34.538132137031,0.6292892156862745,44.58333333333334,1021.666666666668,30.049019607843178,0
1127,4,0,0,35,0.0,0.0,1.0,35,1300,1000,300,0.7692307692307693,16,10,6,395.1893937457278,0.42377450980392156,0.13640552995391753,0.22729345774243562,130627.42524092968,3324.5145975056703,133951.93983843536,896,3,247.17142857142858,34,1,18,34.33484724971857,0.6308210784313726,44.43452380952381,1022.2619047619045,30.06652661064425,0
1128,4,0,0,35,0.0,0.0,1.0,35,1250,900,350,0.72,16,9,7,395.64435172933764,0.42265406162464986,0.13950596761860456,0.22881342925719567,130840.48327664395,3353.2596371882055,134193.74291383216,897,4,248.17142857142858,34,1,18,34.10664417035141,0.6329656862745099,44.226190476190474,1023.0952380952378,30.09103641456582,0
1129,4,0,0,35,0.0,0.0,1.0,35,650,300,350,0.46153846153846156,10,3,7,394.3356311915218,0.42223389355742297,0.1714561300768196,0.21833242490670798,129139.10064638617,3194.9523436825916,132334.05299006877,898,5,249.17142857142858,33,2,17,35.87432682260269,0.6180555555555556,45.894607843137265,1016.4215686274523,30.800653594771283,8
1130,4,0,0,35,0.0,0.0,1.0,35,600,500,100,0.8333333333333334,7,5,2,397.93105009031086,0.4219187675070028,0.17496895952321823,0.22103011568464595,129265.58036169791,3287.7726450350006,132553.3530067329,899,6,250.17142857142858,32,3,18,35.65360897276715,0.6217447916666667,45.77020202020203,1016.9191919191929,31.77872474747478,0
1131,4,0,0,35,0.0,0.0,1.0,35,850,600,250,0.7058823529411765,11,6,5,397.0443441832641,0.42142857142857143,0.17971744101536924,0.2214380878735589,129426.12879106733,3277.582485205605,132703.71127627292,900,7,251.17142857142858,32,3,14,35.51205691359558,0.6233723958333333,45.612373737373744,1017.5505050505058,31.798453282828305,0
1132,4,0,1,34,0.0,0.02857142857142857,0.9714285714285714,35,1200,800,400,0.6666666666666666,16,8,8,401.39720321058485,0.42034313725490197,0.18914887963865024,0.22496653536437572,129618.91842987953,3405.7342681869086,133024.65269806643,901,8,252.17142857142858,32,3,14,35.204329406902254,0.6253255208333333,45.42297979797979,1018.3080808080801,31.822127525252505,0
1133,4,1,0,35,0.02857142857142857,0.0,1.0,35,1150,900,250,0.782608695652174,14,9,5,392.2275897546856,0.4252801120448179,0.17159838675440442,0.22182283017218762,129972.7387511478,3195.7788108356194,133168.51756198343,902,0,242.14285714285714,32,3,16,35.076925458147585,0.62890625,45.07575757575757,1019.6969696969693,31.86553030303029,0
1134,4,0,0,35,0.0,0.0,1.0,35,1300,800,500,0.6153846153846154,18,8,10,389.5805203548639,0.42503501400560223,0.1671771654935803,0.22068944203552524,130037.12153096613,3131.985894296487,133169.10742526263,903,1,243.14285714285714,32,3,17,35.07881488817364,0.6295572916666667,45.012626262626256,1019.9494949494942,31.873421717171695,0
1135,4,2,0,37,0.05405405405405406,0.0,1.0,37,1250,900,350,0.72,16,9,7,368.0681321825683,0.42792792792792794,0.16616664614746623,0.21175340404599904,130638.16350682429,2216.944259315743,132855.10776614002,904,0,230.94594594594594,33,4,16,35.01708223447614,0.6332070707070707,44.424019607843135,1022.3039215686274,30.978906714200832,0
1136,4,0,0,37,0.0,0.0,1.0,37,1000,800,200,0.8,12,8,4,368.3533765729774,0.42770895895895894,0.16072417534370786,0.21243323617840354,130732.14215986646,2231.1251982410677,132963.26735810752,905,1,231.94594594594594,33,4,16,34.91449470740961,0.6341540404040404,44.33210784313726,1022.6715686274515,30.990047534165196,0
1137,4,1,1,37,0.02631578947368421,0.02631578947368421,0.9736842105263158,38,750,600,150,0.8,9,6,3,359.6267161695521,0.42809091986723563,0.16400572561109872,0.20963606137688529,131145.15306122453,1832.6601473922956,132977.81320861683,906,0,226.81578947368422,34,4,18,34.71955873237253,0.6360294117647058,43.92857142857143,1024.2857142857147,30.126050420168077,0
1138,4,0,0,37,0.0,0.0,1.0,37,950,600,350,0.631578947368421,13,6,7,365.4471086127594,0.42373623623623624,0.16746728775454067,0.2124781205608632,131045.64838343424,2178.0506596020723,133223.69904303632,907,1,233.83783783783784,33,4,18,34.67122980251345,0.6373106060606061,44.025735294117645,1023.8970588235293,31.02718360071301,0
1139,4,0,0,37,0.0,0.0,1.0,37,1250,900,350,0.72,16,9,7,365.11183352029474,0.42373623623623624,0.16544678649941824,0.2131518804629654,131202.5422914263,2180.720155709333,133383.26244713564,908,2,234.83783783783784,33,4,18,34.5210326953748,0.6388888888888888,43.87254901960784,1024.5098039215682,31.045751633986914,0
1140,4,0,0,37,0.0,0.0,1.0,37,1250,700,550,0.56,18,7,11,366.4342213673101,0.42345470470470475,0.16836050239178646,0.21480718002030266,131360.48179076123,2227.0552457352933,133587.53703649653,909,3,235.83783783783784,32,5,18,34.327400747218434,0.6429036458333333,43.718434343434346,1025.1262626262633,32.03519570707073,0
1141,4,0,0,37,0.0,0.0,1.0,37,1000,900,100,0.9,11,9,2,367.4519475559887,0.4228603603603604,0.1728904476996076,0.2159511373407917,131457.57607642087,2260.868470054083,133718.44454647496,910,4,236.83783783783784,32,5,18,34.203141672822774,0.6438802083333333,43.62373737373738,1025.5050505050513,32.04703282828285,0
1142,4,0,0,37,0.0,0.0,1.0,37,1150,900,250,0.782608695652174,14,9,5,365.91357786048644,0.42204704704704704,0.17526657841695958,0.2157774843029256,131587.09092184482,2229.900647893087,133816.9915697379,911,5,237.83783783783784,32,5,15,34.11169907293461,0.6451822916666667,43.497474747474755,1026.010101010102,32.06281565656569,0
1143,4,0,0,37,0.0,0.0,1.0,37,1000,600,400,0.6,14,6,8,365.2019988834573,0.42170295295295296,0.16996110501645556,0.21609113907732977,131716.66953627198,2220.638200183676,133937.30773645567,912,6,238.83783783783784,32,5,15,33.99907749077491,0.646484375,43.37121212121213,1026.5151515151529,32.07859848484853,0
1144,4,1,1,37,0.02631578947368421,0.02631578947368421,0.9736842105263158,38,1050,800,250,0.7619047619047619,13,8,5,385.55515299990236,0.4238679468942627,0.2296352391770795,0.2214552325082083,130575.52984429062,2498.9804014905253,133074.51024578116,913,0,233.52631578947367,33,5,18,34.6337929656275,0.6325757575757576,44.48529411764706,1022.0588235294115,30.971479500891256,7
1145,4,0,1,36,0.0,0.02702702702702703,0.972972972972973,37,1650,1400,250,0.8484848484848485,19,14,5,367.5106152530115,0.42160910910910915,0.16487726404206815,0.19785989488700778,128024.02388038562,2010.037556689359,130034.06143707498,914,1,240.59459459459458,34,3,20,37.69581029682782,0.6044730392156863,46.99404761904763,1012.0238095238105,29.765406162465016,8
1146,4,0,0,36,0.0,0.0,1.0,36,1100,500,600,0.45454545454545453,17,5,12,377.0336866117519,0.4207010582010582,0.17683895282320505,0.20249922465712528,127927.48169273853,2446.5940083141336,130374.07570105266,915,2,247.5,33,3,20,37.55388148596811,0.6057449494949495,47.08946078431374,1011.6421568627463,30.65582293523474,0
1147,4,2,0,38,0.05263157894736842,0.0,1.0,38,1100,800,300,0.7272727272727273,14,8,6,362.9585292780117,0.42502370791844474,0.19257376512517088,0.19838163104412682,128627.1276218821,1737.446587090722,130364.57420897282,916,0,235.42105263157896,34,4,17,37.19413801197042,0.6106004901960784,46.398809523809526,1014.404761904762,29.835434173669473,0
1148,4,0,0,38,0.0,0.0,1.0,38,1100,800,300,0.7272727272727273,14,8,6,363.9037858504478,0.4249792555713608,0.19401953158758922,0.19965532034497563,128778.12500000013,1772.5694444444598,130550.69444444458,917,1,236.42105263157896,34,4,18,37.015941434044876,0.6121323529411764,46.25000000000001,1015.000000000001,29.85294117647062,0
1149,4,1,0,39,0.02564102564102564,0.0,1.0,39,900,600,300,0.6666666666666666,12,6,6,355.363452867098,0.4279970760233918,0.19524560481280306,0.19647928943155674,129083.74592764066,1374.3291323731187,130458.07506001378,918,0,231.33333333333334,35,4,19,36.92103264996204,0.6130952380952381,45.949074074074076,1016.2037037037042,29.034391534391546,0
1150,4,2,1,40,0.04878048780487805,0.024390243902439025,0.975609756097561,41,900,600,300,0.6666666666666666,12,6,6,340.66304832860817,0.4316056910569106,0.1934659067922091,0.19098672945044068,129631.08114448929,632.1574358392609,130263.23858032856,919,0,221.0,36,5,16,36.738130782557384,0.6166087962962963,45.411036036036045,1018.3558558558575,28.287662662662708,0
1151,4,0,1,39,0.0,0.025,0.975,40,1450,1100,350,0.7586206896551724,18,11,7,347.7168061476163,0.4293002136752137,0.19419536310944485,0.19500064864836666,129643.02722318663,1015.8118730709765,130658.83909625761,920,1,227.525,35,5,16,36.54641152403682,0.61875,45.39930555555555,1018.4027777777769,29.097222222222197,0
1152,4,0,0,39,0.0,0.0,1.0,39,1150,800,350,0.6956521739130435,15,8,7,363.46736454686476,0.4257759784075574,0.1975743841537625,0.20374179792489375,129625.34722222216,1622.916666666662,131248.26388888882,921,2,234.30769230769232,34,5,16,36.16339334424441,0.6207107843137255,45.416666666666664,1018.3333333333328,29.950980392156847,0
1153,4,2,0,41,0.04878048780487805,0.0,1.0,41,850,600,250,0.7058823529411765,11,6,5,346.3316369670647,0.43064024390243905,0.19919686065101616,0.19689192560825233,130176.38204082473,816.8398973297728,130993.2219381545,922,0,223.82926829268294,36,5,18,36.04037923931435,0.6221064814814814,44.87612612612613,1020.4954954954965,28.347097097097123,0
1154,4,2,2,41,0.046511627906976744,0.046511627906976744,0.9534883720930233,43,800,400,400,0.5,12,4,8,329.2176900574285,0.43625415282392027,0.19533886152503244,0.18962044223505373,130682.67549871118,4.638245243210491,130687.3137439544,923,0,214.37209302325581,37,6,15,35.965035746201956,0.6252815315315315,44.38048245614035,1022.4780701754389,27.634542437174026,0
1155,4,0,0,41,0.0,0.0,1.0,41,1450,1000,450,0.6896551724137931,19,10,9,346.01360612078025,0.43198678861788614,0.20471892792322421,0.1985025424587631,130528.56445312475,832.9318576388607,131361.4963107636,924,1,225.65853658536585,35,6,15,35.69168365613319,0.6276785714285714,44.531249999999986,1021.8749999999981,29.196428571428516,0
1156,4,2,1,42,0.046511627906976744,0.023255813953488372,0.9767441860465116,43,1050,600,450,0.5714285714285714,15,6,9,333.28266289472487,0.43609265411591,0.20862791941966208,0.19477964257355854,131243.84576263835,148.2596808633216,131392.10544350167,925,0,216.11627906976744,37,6,17,35.29460941680043,0.6309121621621622,43.83223684210525,1024.6710526315776,27.693812233285882,0
1157,4,0,1,41,0.0,0.023809523809523808,0.9761904761904762,42,1250,700,550,0.56,18,7,11,344.2941565739899,0.4335075493612079,0.2115215479331578,0.20074997744852624,131155.0401753103,631.1827875172332,131786.22296282754,926,1,222.1904761904762,36,6,17,35.10219693638231,0.6319444444444444,43.91891891891891,1024.3243243243232,28.453453453453424,0
1158,4,1,1,41,0.023809523809523808,0.023809523809523808,0.9761904761904762,42,1100,700,400,0.6363636363636364,15,7,8,345.1530958640525,0.43307200929152145,0.21459965152965954,0.20200889552789328,131299.269603218,663.6698776479094,131962.93948086593,927,0,223.0,36,6,18,34.93457678643372,0.6333912037037037,43.77815315315315,1024.8873873873868,28.469094094094075,0
1159,4,0,0,41,0.0,0.0,1.0,41,900,600,300,0.6666666666666666,12,6,6,352.61131858661344,0.4316056910569106,0.21942951632906205,0.2055737924566221,131150.2338927467,1049.0113811728168,132199.2452739195,928,1,228.8780487804878,35,6,18,34.89406779661018,0.6339285714285714,43.9236111111111,1024.3055555555538,29.265873015872966,0
1160,4,0,0,41,0.0,0.0,1.0,41,1150,900,250,0.782608695652174,14,9,5,352.9645052548086,0.43056402439024394,0.21534800713860802,0.20673635307781646,131328.125,1070.833333333333,132398.95833333334,929,2,229.8780487804878,35,6,19,34.70528455284553,0.6357142857142857,43.75,1025.0,29.285714285714285,0
1161,4,0,0,41,0.0,0.0,1.0,41,950,500,450,0.5263157894736842,14,5,9,356.31600114171573,0.4301321138211382,0.2222295639820604,0.2091851195569558,131417.11576485346,1165.2042341821098,132582.31999903556,930,3,230.8780487804878,35,6,19,34.529503894344735,0.6366071428571429,43.66319444444445,1025.3472222222229,29.29563492063494,0
1162,4,0,0,41,0.0,0.0,1.0,41,1150,900,250,0.782608695652174,14,9,5,358.3358086333024,0.4302337398373984,0.22016990338018005,0.21102526723700712,131535.81700370798,1226.7986700531533,132762.61567376115,931,4,231.8780487804878,35,6,19,34.35784064838842,0.6377976190476191,43.5474537037037,1025.810185185185,29.30886243386243,0
1163,4,0,2,39,0.0,0.04878048780487805,0.9512195121951219,41,900,700,200,0.7777777777777778,11,7,4,359.0640435819572,0.43041158536585367,0.22292418772563138,0.21161859589830248,131565.50068587108,1248.0881344307284,132813.5888203018,932,5,232.8780487804878,35,6,16,34.30919073405536,0.638095238095238,43.51851851851852,1025.925925925926,29.312169312169317,0
1164,4,0,0,39,0.0,0.0,1.0,39,1600,1200,400,0.75,20,12,8,365.2492403653376,0.4304712100764732,0.22234672789896726,0.21587596246010604,131673.78720023547,1818.7501501826239,133492.5373504181,933,6,235.12820512820514,33,6,16,34.04116915422886,0.6436237373737373,43.41299019607843,1026.3480392156862,31.101455733808674,0
1165,4,1,0,40,0.025,0.0,1.0,40,1200,1000,200,0.8333333333333334,14,10,4,356.9781798066025,0.4307692307692308,0.22057988645579885,0.2126348288413242,131969.53125000012,1422.0486111111254,133391.57986111124,934,0,230.225,34,6,17,33.9551230062179,0.6443014705882353,43.12500000000001,1027.500000000001,30.220588235294144,0
1166,4,0,1,39,0.0,0.025,0.975,40,1450,1100,350,0.7586206896551724,18,11,7,356.4821975814747,0.42980769230769234,0.21986717694732105,0.21340888432033853,132159.87761488356,1422.5287208504985,133582.40633573406,935,1,231.225,35,5,17,33.776076842263244,0.644047619047619,42.939814814814824,1028.240740740742,29.378306878306915,0
1167,4,1,1,39,0.025,0.025,0.975,40,1150,700,450,0.6086956521739131,16,7,9,354.9155343208645,0.42913995726495724,0.22726096737907753,0.21347761164495854,132338.45191400903,1393.7944744513143,133732.24638846033,936,0,232.0,35,5,18,33.636576677915265,0.6458333333333333,42.76620370370371,1028.935185185186,29.39814814814817,0
1168,4,0,0,39,0.0,0.0,1.0,39,800,600,200,0.75,10,6,4,364.0373112960975,0.425944669365722,0.23251464904625396,0.21806895249484662,132183.68055555547,1823.958333333329,134007.63888888882,937,1,238.66666666666666,34,5,18,33.557874122096166,0.6464460784313726,42.916666666666664,1028.3333333333328,30.24509803921567,0
1169,4,0,0,39,0.0,0.0,1.0,39,1050,800,250,0.7619047619047619,13,8,5,363.8182252398246,0.4256635177687809,0.22852022620594736,0.21864513925748022,132306.12953514743,1827.0762471655398,134133.20578231296,938,2,239.66666666666666,34,5,18,33.440127671063806,0.647671568627451,42.79761904761905,1028.809523809524,30.25910364145659,0
1170,4,0,0,39,0.0,0.0,1.0,39,1150,800,350,0.6956521739130435,15,8,7,364.98866213151945,0.4255510571300045,0.22461538461538488,0.22025177887246844,132461.07266435976,1869.3898270092234,134330.462491369,939,3,240.66666666666666,33,6,19,33.25396825396826,0.6515151515151515,42.647058823529406,1029.4117647058815,31.19429590017823,0
1171,4,0,0,39,0.0,0.0,1.0,39,1300,800,500,0.6153846153846154,18,8,10,368.80438014542494,0.42487629329734594,0.22206615757985282,0.2236344990468366,132643.15653344657,1983.875425170052,134627.03195861663,940,4,241.66666666666666,34,5,18,32.972427674409644,0.6510416666666667,42.47023809523809,1030.1190476190463,30.29761904761901,0
1172,4,0,0,39,0.0,0.0,1.0,39,900,800,100,0.8888888888888888,10,8,2,369.436587619384,0.42462325686009894,0.2252700692728431,0.22420085759173536,132673.81660997716,2002.912414965971,134676.72902494314,941,5,242.66666666666666,34,5,18,32.92528503196979,0.6513480392156863,42.44047619047618,1030.238095238094,30.301120448179237,0
1173,4,0,0,39,0.0,0.0,1.0,39,950,500,450,0.5263157894736842,14,5,9,370.3859448177307,0.42459514170040485,0.22805848109141014,0.22496072648403212,132704.4802295917,2030.3748582766275,134734.85508786832,942,6,243.66666666666666,34,5,18,32.86996918929328,0.6516544117647058,42.41071428571428,1030.3571428571418,30.304621848739462,0
1174,4,0,1,38,0.0,0.02564102564102564,0.9743589743589743,39,800,500,300,0.625,11,5,6,371.27375529846455,0.42425775978407554,0.22699875304703787,0.22586907235550271,132765.8180980724,2058.4927721088256,134824.31087018122,943,7,244.66666666666666,34,5,18,32.78536637018212,0.6522671568627452,42.35119047619047,1030.595238095237,30.31162464985991,0
1175,4,0,0,38,0.0,0.0,1.0,38,1400,1200,200,0.8571428571428571,16,12,4,378.27757966312663,0.423675320056899,0.23210294679245957,0.22961585647854896,132681.93310565632,2438.1201040465007,135120.05320970283,944,8,250.26315789473685,33,5,18,32.68940069783116,0.6537247474747474,42.43259803921568,1030.269607843136,31.2202911467617,0
1176,4,0,1,37,0.0,0.02631578947368421,0.9736842105263158,38,1100,800,300,0.7272727272727273,14,8,6,378.5805076058884,0.4233197012802276,0.23549033105951578,0.23038075752283046,132776.64389898095,2453.3298490964776,135229.97374807743,945,9,251.26315789473685,33,5,19,32.58620689655172,0.6546717171717171,42.34068627450979,1030.637254901959,31.23143196672603,0
1177,4,0,0,37,0.0,0.0,1.0,37,1000,700,300,0.7,13,7,6,387.4053849480969,0.423267017017017,0.24040143084260768,0.23521041228991588,132690.5417814507,2881.0060835628838,135571.5478650136,946,10,257.27027027027026,32,5,19,32.44561887254901,0.65625,42.424242424242415,1030.3030303030291,32.19696969696966,0
1178,4,0,0,37,0.0,0.0,1.0,37,950,700,250,0.7368421052631579,12,7,5,387.43824639465834,0.4219532032032032,0.23865599618722344,0.23645894768750225,132885.746671258,2897.0041322314046,135782.7508034894,947,11,258.27027027027026,32,5,19,32.2480406563801,0.658203125,42.234848484848484,1031.060606060606,32.22064393939394,0
1179,4,0,0,37,0.0,0.0,1.0,37,900,400,500,0.4444444444444444,14,4,10,384.7059009169455,0.4214214214214214,0.23570981925737744,0.23540543105547013,132983.402921258,2831.8999655647394,135815.30288682276,948,12,259.27027027027026,32,5,19,32.220130982984465,0.6591796875,42.140151515151516,1031.4393939393938,32.232481060606055,0
1180,4,0,0,37,0.0,0.0,1.0,37,1150,800,350,0.6956521739130435,15,8,7,384.84679531661743,0.4203265765765766,0.23866048578551635,0.23652163194872414,133146.24304917868,2848.180989184776,135994.42403836345,949,13,260.27027027027026,32,5,20,32.052595628415304,0.6608072916666667,41.98232323232323,1032.0707070707072,32.2522095959596,0
1181,4,1,0,38,0.02631578947368421,0.0,1.0,38,1100,700,400,0.6363636363636364,15,7,8,371.00679993918067,0.422460289236605,0.22219413706803448,0.23022077585629952,133503.88259623697,2306.169652297187,135810.05224853416,950,0,254.39473684210526,33,5,21,32.05055041701254,0.6619318181818181,41.6360294117647,1033.4558823529408,31.316844919786085,0
1182,4,0,0,38,0.0,0.0,1.0,38,1100,900,200,0.8181818181818182,13,9,4,376.1245466833967,0.42179350403034616,0.22430661716531963,0.23379591387431486,133567.21460796334,2447.5816092368386,136014.79621720017,951,1,255.39473684210526,33,5,21,31.854747085556223,0.6625631313131313,41.57475490196079,1033.7009803921571,31.324272133095672,0
1183,4,0,0,38,0.0,0.0,1.0,38,650,300,350,0.46153846153846156,10,3,7,375.275541334051,0.42168978188715034,0.22174748319007964,0.23386816970285995,133662.24078479435,2432.0339532872,136094.27473808156,952,2,256.39473684210526,33,5,21,31.781326538674247,0.663510101010101,41.4828431372549,1034.0686274509808,31.335412953060025,0
1184,4,0,0,38,0.0,0.0,1.0,38,950,600,350,0.631578947368421,13,6,7,374.3392272678132,0.4208896396396396,0.22321812706152322,0.2338858191981947,133757.3007527153,2414.1209210399834,136171.42167375528,953,3,257.39473684210526,33,5,19,31.710179481104145,0.6644570707070707,41.39093137254902,1034.4362745098038,31.346553773024358,0
1185,4,0,0,38,0.0,0.0,1.0,38,1050,500,550,0.47619047619047616,16,5,11,372.8534759363983,0.4206229255571361,0.21429283520153497,0.23416307146726828,133947.52206182727,2388.5598387639448,136336.0819005912,954,4,258.39473684210526,33,5,19,31.557924904305278,0.6663510101010102,41.20710784313726,1035.1715686274515,31.368835412953075,0
1186,4,0,2,36,0.0,0.05263157894736842,0.9473684210526316,38,750,700,50,0.9333333333333333,8,7,1,371.84879903161425,0.4193930772878141,0.21492110558085353,0.23393525711229407,134010.95920138893,2366.362847222228,136377.32204861115,955,5,259.39473684210526,33,5,20,31.520372233400398,0.6669823232323233,41.145833333333336,1035.416666666667,31.376262626262637,0
1187,4,0,0,36,0.0,0.0,1.0,36,950,800,150,0.8421052631578947,11,8,3,390.7209479447779,0.41608796296296297,0.23819514378426798,0.24401629013154977,133741.45507812497,3251.1176215277774,136992.57269965275,956,20,272.94444444444446,31,5,21,31.30245048674053,0.6693548387096775,41.40625,1034.3749999999998,33.36693548387096,0
1188,4,0,0,36,0.0,0.0,1.0,36,1250,900,350,0.72,16,9,7,390.53352215822565,0.41562499999999997,0.23441759993288924,0.24456815607497392,133842.48733520505,3253.995598687067,137096.4829338921,957,21,273.94444444444446,31,5,21,31.205827146512327,0.6703629032258065,41.30859375,1034.7656249999998,33.37953629032258,0
1189,4,0,0,36,0.0,0.0,1.0,36,750,500,250,0.6666666666666666,10,5,5,391.22075897071915,0.41572420634920637,0.23913210606505375,0.2454470254978884,133909.8633660211,3277.663675944016,137187.52704196514,958,22,274.94444444444446,31,5,21,31.120397743951024,0.6710349462365591,41.243489583333336,1035.026041666667,33.387936827957,0
1190,4,0,0,36,0.0,0.0,1.0,36,1100,800,300,0.7272727272727273,14,8,6,381.55299399302714,0.414781746031746,0.16286675981201637,0.2236758541851899,131361.49300469283,2825.8043077256893,134187.29731241852,959,23,275.94444444444446,31,5,22,33.93891041110972,0.645497311827957,43.717447916666664,1025.1302083333328,33.06871639784944,7
1191,4,0,1,35,0.0,0.027777777777777776,0.9722222222222222,36,1200,900,300,0.75,15,9,6,381.12045442102567,0.41372354497354497,0.16821477437828847,0.22420357128263005,131495.00740898965,2823.087395562042,134318.09480455169,960,24,276.94444444444446,31,5,24,33.81482480639836,0.6468413978494624,43.58723958333332,1025.6510416666654,33.08551747311824,0
1192,4,0,0,35,0.0,0.0,1.0,35,1650,1500,150,0.9090909090909091,18,15,3,378.90870338258384,0.41390056022408966,0.15867001739802866,0.2240108254397834,131684.26890432087,2979.263117283937,134663.5320216048,961,25,277.45714285714286,32,3,18,33.68008570139828,0.6461588541666667,43.40277777777777,1026.388888888888,32.07465277777775,0
1193,4,0,0,35,0.0,0.0,1.0,35,1250,800,450,0.64,17,8,9,378.7199192981421,0.4134803921568628,0.16194340517468508,0.22466295431449945,131813.89534550044,2984.1095615243285,134798.00490702476,962,26,278.45714285714286,32,3,19,33.55388540513956,0.6474609375,43.27651515151515,1026.893939393939,32.090435606060595,0
1194,4,1,0,36,0.027777777777777776,0.0,1.0,36,1000,600,400,0.6,14,6,8,371.4736718705274,0.41486441798941803,0.1574383010274336,0.22267193245267602,132208.8860053825,2622.4240676662794,134831.31007304878,963,0,271.69444444444446,33,3,21,33.34127740705435,0.648989898989899,42.8921568627451,1028.4313725490192,31.164587046939975,0
1195,4,0,0,36,0.0,0.0,1.0,36,600,300,300,0.5,9,3,6,373.1580939214648,0.414484126984127,0.15985874472113037,0.22386818315102613,132240.39619677534,2669.3148368416096,134909.71103361694,964,1,272.69444444444446,33,3,21,33.266189086143214,0.6493055555555556,42.86151960784314,1028.553921568628,31.16830065359479,0
1196,4,0,0,36,0.0,0.0,1.0,36,1250,1100,150,0.88,14,11,3,374.17550198812853,0.4143022486772487,0.15867815635506877,0.22466589153707786,132271.91014273348,2698.58167531718,134970.49181805065,965,2,273.69444444444446,33,3,21,33.20824398379796,0.6496212121212122,42.830882352941174,1028.6764705882347,31.172014260249536,0
1197,4,1,0,37,0.02702702702702703,0.0,1.0,37,600,500,100,0.8333333333333334,7,5,2,363.599512499744,0.41638513513513514,0.15101938405913629,0.2197815182750253,132524.15687475976,2237.203839869281,134761.36071462903,966,0,267.27027027027026,33,4,22,33.22621598032214,0.6521464646464646,42.58578431372549,1029.6568627450984,31.20172311348783,0
1198,4,0,0,37,0.0,0.0,1.0,37,1200,800,400,0.6666666666666666,16,8,8,363.1540566458118,0.41607232232232233,0.14785751958526805,0.21988088559448163,132587.2561034219,2229.9199826989757,134817.1760861209,967,1,268.27027027027026,33,4,23,33.17418292876407,0.6527777777777778,42.524509803921575,1029.9019607843147,31.209150326797417,0
1199,4,0,0,37,0.0,0.0,1.0,37,800,500,300,0.625,11,5,6,369.11824840127326,0.4152277277277277,0.1505502171613744,0.22405610933642625,132681.93310565644,2395.0645484909596,135076.9976541474,968,2,269.27027027027026,33,4,17,32.92531521351254,0.6537247474747474,42.432598039215684,1030.269607843137,31.220291146761728,0
1200,4,0,1,36,0.0,0.02702702702702703,0.972972972972973,37,900,600,300,0.6666666666666666,12,6,6,369.2930832448028,0.4146021021021021,0.15603119467107085,0.2249184737995681,132808.22167255377,2409.03153234332,135217.2532048971,969,3,270.27027027027026,33,4,18,32.79373736773272,0.6549873737373737,42.31004901960784,1030.7598039215682,31.235145573380855,0
1201,4,0,1,35,0.0,0.027777777777777776,0.9722222222222222,36,900,400,500,0.4444444444444444,14,4,10,378.06191806389455,0.41240079365079363,0.15327301937398685,0.22973665773041296,132723.06596584548,2835.507378073682,135558.57334391915,970,7,278.69444444444446,32,4,19,32.65352489482496,0.6565755208333333,42.392676767676775,1030.4292929292942,32.200915404040444,0
1202,4,0,2,33,0.0,0.05714285714285714,0.9428571428571428,35,1250,900,350,0.72,16,9,7,374.34006723841054,0.41218487394957987,0.10807214868664738,0.21363023563222172,130325.14537677822,2757.1847366397624,133082.330113418,971,8,285.8285714285714,33,2,20,35.17462794047047,0.630050505050505,44.73039215686275,1021.0784313725495,30.941770647653016,8
1203,4,1,0,34,0.029411764705882353,0.0,1.0,34,950,700,250,0.7368421052631579,12,7,5,381.8644085924573,0.41354723707664887,0.14535737657238457,0.21847829317630685,130423.75299714309,3160.837860932551,133584.59085807565,972,0,293.88235294117646,32,2,22,34.88231355583024,0.6334635416666667,44.63383838383838,1021.4646464646461,31.92077020202019,0
1204,4,0,0,34,0.0,0.0,1.0,34,700,200,500,0.2857142857142857,12,2,10,380.78940496635175,0.413305852644088,0.14908671982323152,0.21840741703704356,130520.50053884806,3140.164747219667,133660.66528606773,973,1,294.88235294117646,32,2,16,34.81146258083117,0.6344401041666667,44.53914141414141,1021.8434343434342,31.932607323232318,0
1205,4,0,0,34,0.0,0.0,1.0,34,950,800,150,0.8421052631578947,11,8,3,380.7634762700113,0.4134543969102793,0.1485408539110349,0.21912166790037524,130649.55305899898,3149.3155991735425,133798.86865817252,974,2,295.88235294117646,32,2,16,34.68105471162159,0.6357421875,44.41287878787878,1022.3484848484841,31.948390151515127,0
1206,4,0,0,34,0.0,0.0,1.0,34,700,300,400,0.42857142857142855,11,3,8,381.79698216735306,0.41258169934640526,0.14747276688453237,0.2202674897119341,130746.38429752042,3183.7149908172405,133930.09928833766,975,3,296.88235294117646,32,2,16,34.55632716049384,0.63671875,44.318181818181806,1022.7272727272708,31.960227272727213,0
1207,4,0,0,34,0.0,0.0,1.0,34,650,400,250,0.6153846153846154,9,4,5,381.5672645747087,0.4121546345811052,0.14751628339275502,0.2203190598944913,130778.66934815308,3180.1718255790047,133958.8411737321,976,4,297.88235294117646,32,2,17,34.52943052298069,0.6370442708333333,44.28661616161615,1022.8535353535341,31.96417297979794,0
1208,4,0,0,34,0.0,0.0,1.0,34,1000,800,200,0.8,12,8,4,383.5298657617235,0.41156045751633985,0.15080378851108645,0.22219510807710968,130907.84940631036,3241.413981991608,134149.26338830197,977,5,298.88235294117646,32,2,18,34.348139008842274,0.6383463541666667,44.16035353535352,1023.3585858585841,31.979955808080753,0
1209,4,1,0,35,0.02857142857142857,0.0,1.0,35,1150,900,250,0.782608695652174,14,9,5,375.06894405156845,0.41425070028011207,0.147972730534625,0.21914405598987863,131233.93233672142,2844.3544850538146,134078.28682177523,978,0,291.3142857142857,33,2,20,34.23421739823784,0.6392045454545454,43.84191176470588,1024.6323529411761,31.0494652406417,0
1210,4,0,0,35,0.0,0.0,1.0,35,1150,900,250,0.782608695652174,14,9,5,377.3952936904263,0.413515406162465,0.14943478706328395,0.22140876767279827,131390.93888168,2917.264393502483,134308.2032751825,979,1,292.3142857142857,33,2,21,34.015658618216584,0.6407828282828283,43.68872549019607,1025.2450980392146,31.068033273915592,0
1211,4,0,0,35,0.0,0.0,1.0,35,950,600,350,0.631578947368421,13,6,7,379.466081975104,0.4128851540616247,0.15716162943495404,0.2235405047300205,131548.03929077744,2983.6038122356563,134531.6431030131,980,2,293.3142857142857,33,2,22,33.80358280571816,0.6423611111111112,43.53553921568626,1025.8578431372537,31.086601307189504,0
1212,4,0,0,35,0.0,0.0,1.0,35,1150,900,250,0.782608695652174,14,9,5,379.75267542882625,0.4121148459383754,0.15800085287846488,0.22444803505408717,131673.78720023533,3000.694594627041,134674.48179486237,981,3,294.3142857142857,33,2,18,33.669029850746256,0.6436237373737373,43.41299019607842,1026.3480392156848,31.10145573380863,0
1213,4,0,0,35,0.0,0.0,1.0,35,950,700,250,0.7368421052631579,12,7,5,383.6503897001784,0.41183473389355746,0.1605429185281182,0.22731421251118047,131768.13755526708,3110.5794646289737,134878.71701989605,982,4,295.3142857142857,33,2,18,33.47358160261002,0.6445707070707071,43.32107843137254,1026.7156862745087,31.112596553772992,0
1214,4,0,0,35,0.0,0.0,1.0,35,1550,1100,450,0.7096774193548387,20,11,9,377.0830912178832,0.41053921568627455,0.09602541524223906,0.2055326414187594,128517.04422577866,2703.2691753172007,131220.31340109586,983,5,296.3142857142857,33,2,16,36.948573845781965,0.6117424242424243,46.50735294117648,1013.970588235295,30.726381461675608,8
1215,4,0,0,35,0.0,0.0,1.0,35,1050,600,450,0.5714285714285714,15,6,9,376.66923382109235,0.4103291316526611,0.0991166321601098,0.20627124709250325,128703.50346020784,2695.730007689374,131399.23346789723,984,6,297.3142857142857,33,2,16,36.768317230273745,0.6136363636363636,46.32352941176472,1014.705882352943,30.748663101604336,0
1216,4,2,0,37,0.05405405405405406,0.0,1.0,37,1050,700,350,0.6666666666666666,14,7,7,356.4481441804936,0.4178553553553554,0.09664328102505926,0.19797902947856338,129263.69214965405,1817.0829728950441,131080.7751225491,985,0,282.18918918918916,33,4,18,36.710151040411326,0.6193181818181819,45.77205882352941,1016.9117647058829,30.81550802139039,0
1217,4,0,0,37,0.0,0.0,1.0,37,1100,700,400,0.6363636363636364,15,7,8,356.78113238520086,0.41791791791791794,0.0935703748090786,0.19832060399630136,129294.8494118847,1825.9925569492386,131120.84196883393,986,1,283.18918918918916,33,4,18,36.669955215487825,0.6196338383838385,45.741421568627445,1017.034313725489,30.81922162804512,0
1218,4,0,0,37,0.0,0.0,1.0,37,900,600,300,0.6666666666666666,12,6,6,354.79638036558157,0.4171046046046046,0.09443330529218663,0.19765905258176408,129383.0002834468,1780.9240362811956,131163.924319728,987,2,284.18918918918916,34,3,18,36.63068492082067,0.6182598039215687,45.65476190476191,1017.3809523809532,29.922969187675093,0
1219,4,0,0,37,0.0,0.0,1.0,37,800,500,300,0.625,11,5,6,355.5174894985927,0.41660410410410414,0.09725682631625499,0.19836576372284415,129443.56575963722,1803.8903061224496,131247.45606575967,988,3,285.18918918918916,34,3,12,36.55070386835127,0.6188725490196079,45.595238095238095,1017.6190476190479,29.92997198879553,0
1220,4,1,2,36,0.02631578947368421,0.05263157894736842,0.9473684210526316,38,850,400,450,0.47058823529411764,13,4,9,347.6609909771339,0.41890410146989093,0.11038285663050318,0.19585124923567895,129819.89354263114,1426.6625675154307,131246.55611014657,989,0,278.6578947368421,35,3,14,36.3681856899489,0.6205357142857143,45.22569444444444,1019.097222222222,29.117063492063483,0
1221,4,1,1,36,0.02702702702702703,0.02702702702702703,0.972972972972973,37,1100,800,300,0.7272727272727273,14,8,6,353.5386148918815,0.41647897897897895,0.1156679067126829,0.19849514411527444,129688.4273420382,1769.9733940021326,131458.40073604032,990,0,286.94594594594594,36,1,15,36.35203611571771,0.6171875,45.35472972972974,1018.5810810810827,28.293918918918965,0
1222,4,0,1,35,0.0,0.027777777777777776,0.9722222222222222,36,1150,1000,150,0.8695652173913043,13,10,3,381.41909739283363,0.41301256613756615,0.08054542328334757,0.2144623103861383,129745.78622118737,2697.5041342017653,132443.29035538915,991,1,295.5833333333333,36,0,15,35.58361887918646,0.6177662037037037,45.29842342342342,1018.806306306306,28.30017517517517,8
1223,4,1,0,36,0.027777777777777776,0.0,1.0,36,850,600,250,0.7058823529411765,11,6,5,378.70552734183866,0.41159060846560847,0.11200360678664745,0.21450506323546173,130032.77084094234,2648.8258106079097,132681.59665155024,992,0,296.52777777777777,36,0,16,35.36054064995766,0.6206597222222222,45.016891891891895,1019.9324324324328,28.33145645645647,0
1224,4,0,0,36,0.0,0.0,1.0,36,750,400,350,0.5333333333333333,11,4,7,384.1841732087778,0.41164021164021164,0.11593696345352034,0.218089511859118,130118.92804967117,2797.9265583150614,132916.85460798623,993,1,297.52777777777777,36,0,16,35.13314017660045,0.6215277777777778,44.93243243243243,1020.2702702702693,28.340840840840812,0
1225,4,0,0,36,0.0,0.0,1.0,36,900,600,300,0.6666666666666666,12,6,6,385.6726364014998,0.41135912698412697,0.11371882086167817,0.21974371143806362,130262.58680555537,2847.8223155587825,133110.40912111415,994,2,298.52777777777777,35,1,16,34.948979591836725,0.625,44.79166666666666,1020.8333333333319,29.166666666666625,0
1226,4,1,0,37,0.02702702702702703,0.0,1.0,37,800,600,200,0.75,10,6,4,383.3471346307148,0.41341341341341337,0.13503094459146903,0.2206980745283614,130665.25298524874,2618.03006553851,133283.28305078726,995,0,291.43243243243245,36,1,16,34.599074787972256,0.627025462962963,44.39752252252252,1022.4099099099097,28.40027527527527,0
1227,4,1,0,38,0.02631578947368421,0.0,1.0,38,950,500,450,0.5263157894736842,14,5,9,374.7144265886827,0.4156146277856804,0.1394810113740128,0.21787567344241057,131047.29940943344,2221.062730840238,133268.36214027368,996,0,284.7368421052632,37,1,17,34.43233740272722,0.6289414414414414,44.024122807017534,1023.903508771928,27.673067804646703,0
1228,4,0,0,38,0.0,0.0,1.0,38,900,600,300,0.6666666666666666,12,6,6,373.73916153497,0.4151701043148412,0.14064014425786087,0.21762617012073665,131103.4404816865,2199.697983995059,133303.13846568155,997,1,285.7368421052632,37,1,18,34.40042826552462,0.6295045045045045,43.96929824561403,1024.1228070175425,27.678994784257906,0
1229,4,0,0,38,0.0,0.0,1.0,38,1250,800,450,0.64,17,8,9,370.32143665865993,0.41444404931247036,0.13444003266593474,0.216426130429967,131243.84576263832,2120.481903085544,133364.32766572386,998,2,286.7368421052632,37,1,18,34.34579543427858,0.6309121621621622,43.83223684210525,1024.6710526315774,27.693812233285875,0
1230,4,0,0,38,0.0,0.0,1.0,38,950,700,250,0.7368421052631579,12,7,5,372.79397184215765,0.4144292318634424,0.13115104835258906,0.21835075493612074,131328.12499999997,2191.6666666666665,133519.79166666663,999,3,287.7368421052632,37,1,18,34.197154471544714,0.6317567567567568,43.75,1024.9999999999998,27.702702702702698,0
1231,4,1,1,38,0.02564102564102564,0.02564102564102564,0.9743589743589743,39,900,600,300,0.6666666666666666,12,6,6,362.64857055487687,0.4165823211875843,0.11949620068699884,0.2143978349120433,131684.268904321,1751.0223765432104,133435.2912808642,1000,0,281.3333333333333,38,1,14,34.09731619305368,0.6334978070175439,43.40277777777778,1026.3888888888891,27.010233918128662,0
1232,4,0,0,38,0.0,0.0,1.0,38,900,700,200,0.7777777777777778,11,7,4,367.0221053347501,0.41471076339497387,0.12177028379883259,0.21655692696863757,131609.25116381966,2060.7008887350007,133669.95205255467,1001,5,289.7368421052632,37,1,14,34.06087483080431,0.634572072072072,43.47587719298246,1026.0964912280704,27.732337600758658,0
1233,4,0,0,38,0.0,0.0,1.0,38,950,500,450,0.5263157894736842,14,5,9,367.01640002922056,0.41471076339497387,0.12741790373369355,0.21687332728999398,131665.51246537402,2064.6804786088123,133730.19294398284,1002,6,290.7368421052632,37,1,14,34.00418447293448,0.6351351351351351,43.42105263157895,1026.3157894736846,27.738264580369854,0
1234,4,0,0,38,0.0,0.0,1.0,38,950,600,350,0.631578947368421,13,6,7,371.24491610154564,0.41527382645803695,0.1314104004674359,0.22067400850503063,131890.6779008927,2192.74873037859,134083.42663127132,1003,7,291.7368421052632,37,1,14,33.668250071164245,0.6373873873873874,43.20175438596492,1027.1929824561414,27.761972498814632,0
1235,4,0,0,38,0.0,0.0,1.0,38,850,400,450,0.47058823529411764,13,4,9,370.4016884423023,0.4155701754385965,0.13192720328034557,0.2204996074145093,131946.9993170977,2174.678266389674,134121.67758348738,1004,8,292.7368421052632,37,1,14,33.63304873710422,0.6379504504504505,43.14692982456141,1027.4122807017557,27.76789947842583,0
1236,4,0,1,37,0.0,0.02631578947368421,0.9736842105263158,38,900,500,400,0.5555555555555556,13,5,8,361.3310224901653,0.41555535798956855,0.10028339183878132,0.20008428276050505,129144.15048494443,1733.527056198221,130877.67754114265,1005,9,293.7368421052632,36,2,19,36.70784400620429,0.6116898148148149,45.88963963963964,1016.4414414414417,28.234484484484494,8
1237,4,1,0,38,0.02631578947368421,0.0,1.0,38,1200,900,300,0.75,15,9,6,360.22091513491995,0.4184892128971076,0.1075901601049396,0.20020627332641006,129289.65627411268,1714.580341708545,131004.23661582122,1006,0,294.2894736842105,35,3,20,36.58778593376578,0.6151785714285714,45.74652777777778,1017.0138888888891,29.05753968253969,0
1238,4,0,0,38,0.0,0.0,1.0,38,650,400,250,0.6153846153846154,9,4,5,360.2705894733002,0.41807432432432434,0.11438456699517685,0.20095092879510776,129430.46932067221,1725.9982955929133,131156.46761626512,1007,1,295.2894736842105,36,2,17,36.44311642319611,0.6145833333333333,45.60810810810812,1017.5675675675692,28.26576576576581,0
1239,4,0,0,38,0.0,0.0,1.0,38,850,500,350,0.5882352941176471,12,5,7,366.4889086850964,0.4187855618776672,0.12410922217047049,0.20501607268027705,129545.08562616698,1895.367411330282,131440.45303749727,1008,2,296.2894736842105,36,2,17,36.168187684365776,0.6157407407407407,45.49549549549551,1018.0180180180203,28.27827827827834,0
1240,4,1,1,38,0.02564102564102564,0.02564102564102564,0.9743589743589743,39,1050,800,250,0.7619047619047619,13,8,5,358.97512046269554,0.4211369770580297,0.12017047439390782,0.2026828757073989,129908.37191358033,1526.7746913580327,131435.14660493835,1009,0,289.6666666666667,38,1,18,35.99000908265212,0.6156798245614035,45.13888888888889,1019.444444444445,26.827485380116975,0
1241,4,0,1,37,0.0,0.02631578947368421,0.9736842105263158,38,1300,1000,300,0.7692307692307693,16,10,6,362.6446405242309,0.4168889284020863,0.11981384183349908,0.20455974382968786,129871.11418898143,1819.4127039089203,131690.52689289034,1010,1,298.2105263157895,37,1,18,35.934362449799195,0.6171171171171171,45.17543859649124,1019.2982456140368,27.548601232811805,0
1242,4,0,0,37,0.0,0.0,1.0,37,600,400,200,0.6666666666666666,8,4,4,363.0924703656191,0.41541541541541543,0.10047308490157736,0.20535929538792547,129975.34855379055,2038.6140786056635,132013.9626323962,728,2,279.97297297297297,36,1,18,35.816997975335894,0.6200810185185186,45.07319819819821,1019.7072072072094,28.32520020020026,0
1243,4,2,0,39,0.05128205128205128,0.0,1.0,39,1200,900,300,0.75,15,9,6,349.2726368003805,0.42141812865497075,0.10607536557311192,0.20015513097822538,130486.54994806093,1315.3933134817432,131801.94326154268,729,0,266.56410256410254,37,2,20,35.65098018172713,0.6233108108108107,44.57236842105263,1021.7105263157894,27.613798008534847,0
1244,4,1,2,38,0.025,0.05,0.95,40,900,500,400,0.5555555555555556,13,5,8,345.9386320719343,0.4247462606837607,0.11684856396866827,0.19990117091664286,130808.47447083425,1050.3409443713892,131858.81541520564,730,0,260.875,38,2,17,35.410356832027844,0.6247258771929824,44.25747863247863,1022.9700854700855,26.92026540710751,0
1245,4,1,0,39,0.02564102564102564,0.0,1.0,39,700,500,200,0.7142857142857143,9,5,4,355.4993321349033,0.4224583895636527,0.12690768351145754,0.20520406993529533,130766.77439212041,1497.5001923668567,132264.27458448726,731,0,268.4871794871795,37,2,18,35.20806532304174,0.6261261261261262,44.298245614035075,1022.8070175438577,27.64343290659075,0
1246,4,0,0,39,0.0,0.0,1.0,39,1200,900,300,0.75,15,9,6,358.1160381878623,0.4225989653621232,0.12239323567155558,0.20716557670991553,130850.90033712266,1571.9612044090145,132422.86154153166,732,1,269.4871794871795,37,2,18,35.055973814882286,0.6269707207207207,44.21600877192981,1023.1359649122783,27.65232337600752,0
1247,4,0,0,39,0.0,0.0,1.0,39,1100,500,600,0.45454545454545453,17,5,12,355.4428811746041,0.4222334682860998,0.12078966449146433,0.2063690757864489,130991.17036011058,1511.9758002462054,132503.1461603568,733,2,270.4871794871795,37,2,18,34.982415738360466,0.6283783783783784,44.07894736842104,1023.684210526314,27.667140825035514,0
1248,4,1,0,40,0.025,0.0,1.0,40,1200,900,300,0.75,15,9,6,327.35132444598366,0.4243723290598291,0.10069901315789531,0.17770500469924808,128355.55555555534,403.47222222220216,128759.02777777755,734,0,264.7,39,1,18,38.37376644736842,0.5982905982905983,46.66666666666666,1013.3333333333317,25.98290598290594,8
1249,4,1,0,41,0.024390243902439025,0.0,1.0,41,900,500,400,0.5555555555555556,13,5,8,323.74380298539955,0.4259908536585366,0.11340425272054389,0.17732209944098798,128711.08596280304,133.8832911956949,128844.96925399874,735,0,259.219512195122,40,1,14,38.1031964613587,0.6002604166666667,46.316056910569095,1014.7357723577221,25.368394308943053,0
1250,4,0,0,41,0.0,0.0,1.0,41,800,400,400,0.5,12,4,8,324.8832519728518,0.42621951219512194,0.11904529337644143,0.17829307256620028,128788.44024720743,168.24145680481536,128956.68170401224,736,1,260.219512195122,40,1,15,37.99559471365637,0.6010416666666667,46.239837398373986,1015.0406504065047,25.37601626016262,0
1251,4,0,1,40,0.0,0.024390243902439025,0.975609756097561,41,650,400,250,0.6153846153846154,9,4,5,325.9455379524289,0.4261432926829268,0.12027898279183002,0.17922519921203708,128865.81776926748,200.6476592967008,129066.46542856417,737,2,261.219512195122,40,1,15,37.8899342741801,0.6018229166666667,46.163617886178855,1015.3455284552833,25.383638211382085,0
1252,4,0,0,40,0.0,0.0,1.0,40,1300,900,400,0.6923076923076923,17,9,8,328.4002743006044,0.4249065170940171,0.11503281378178887,0.18114024179748248,128989.67013888869,472.04861111109096,129461.71874999978,738,3,258.725,39,1,16,37.70166803390758,0.6047008547008548,46.04166666666666,1015.8333333333317,26.047008547008506,0
1253,4,1,0,41,0.024390243902439025,0.0,1.0,41,950,600,350,0.631578947368421,13,6,7,325.53085717833756,0.427515243902439,0.12426064332557041,0.18147076514863678,129408.11107806205,225.266665014216,129633.37774307627,739,0,253.390243902439,40,1,17,37.349555533359975,0.6072916666666667,45.63008130081301,1017.4796747967483,25.436991869918707,0
1254,4,1,0,42,0.023809523809523808,0.0,1.0,42,1150,800,350,0.6956521739130435,15,8,7,315.1544348851429,0.4299748354626403,0.12714174454828675,0.17748170806689612,129807.25623582758,-218.13350340136998,129589.1227324262,740,0,248.33333333333334,41,1,15,37.20916082554517,0.6097560975609756,45.238095238095234,1019.0476190476184,24.85481997677118,0
1255,4,0,0,42,0.0,0.0,1.0,42,1150,900,250,0.782608695652174,14,9,5,351.98024850371854,0.4293336236933798,0.10566442386498065,0.1879617144321175,127696.68104383658,768.2676423433705,128464.94868617995,741,1,249.33333333333334,39,3,14,38.4237907520011,0.5916132478632479,47.31770833333332,1010.7291666666648,25.91613247863243,8
1256,4,0,0,42,0.0,0.0,1.0,42,900,600,300,0.6666666666666666,12,6,6,351.6075350987074,0.42903116531165314,0.1061497719582174,0.1886248157905218,127880.99500868034,592.7842881944241,128473.77929687477,742,2,250.33333333333334,39,3,16,38.24450738070717,0.593482905982906,47.13541666666666,1011.4583333333317,25.934829059829017,0
1257,4,0,2,40,0.0,0.047619047619047616,0.9523809523809523,42,1550,1300,250,0.8387096774193549,18,13,5,350.3687516747769,0.4288133952768099,0.11079417357721244,0.18870192856275653,128039.08420138869,572.1788194444246,128611.26302083311,743,3,251.33333333333334,39,3,16,38.1141073143955,0.5950854700854701,46.97916666666666,1012.0833333333317,25.95085470085466,0
1258,4,1,1,40,0.024390243902439025,0.024390243902439025,0.975609756097561,41,1400,1100,300,0.7857142857142857,17,11,6,372.30444635665316,0.42837906504065043,0.16595193888380821,0.1895779753552736,125756.3490125872,1163.9295789930948,126920.2785915803,744,0,257.4146341463415,39,2,17,39.90906376570776,0.5718482905982907,49.244791666666686,1003.0208333333366,25.718482905982988,8
1259,4,3,0,43,0.06976744186046512,0.0,1.0,43,1200,800,400,0.6666666666666666,16,8,8,336.3852872854035,0.434108527131783,0.19155947024903397,0.1639798487734726,123936.3807763955,-261.59675597687647,123674.78402041862,745,0,246.27906976744185,42,1,15,42.69211431166471,0.5486111111111112,51.06589147286821,995.7364341085258,23.708010335917283,8
1260,4,8,3,48,0.1568627450980392,0.058823529411764705,0.9411764705882353,51,1100,800,300,0.7272727272727273,14,8,6,311.5526527634763,0.4491339869281046,0.25531943203950536,0.15810995365598873,125617.25673475151,-2368.1752403908376,123249.08149436068,746,0,208.49019607843138,48,3,15,41.575479967201055,0.5583767361111112,49.383503401360535,1002.4659863945561,20.884708049886587,0
1261,4,0,2,46,0.0,0.041666666666666664,0.9583333333333334,48,1100,900,200,0.8181818181818182,13,9,4,322.88572226328097,0.4440288859338062,0.24968517177932625,0.16241284099824838,125249.21829874231,-1511.763137339852,123737.45516140247,747,1,222.52083333333334,45,3,15,41.67071984435798,0.5581018518518519,49.750905797101446,1000.9963768115936,22.244363929146523,0
1262,4,2,1,47,0.041666666666666664,0.020833333333333332,0.9791666666666666,48,1450,800,650,0.5517241379310345,21,8,13,331.445964142588,0.4462174940898345,0.28303168920710764,0.1686751323592032,125732.45282084608,-1265.2971901564724,124467.15563068961,748,0,220.97916666666666,46,2,17,40.95822652405785,0.5618206521739131,49.268617021276576,1002.9255319148899,21.80272895467152,0
1263,4,4,0,51,0.0784313725490196,0.0,1.0,51,1200,700,500,0.5833333333333334,17,7,10,329.52211618590695,0.45127450980392153,0.33378058530638777,0.17183711195631374,126733.61177209321,-1844.2284765832153,124889.38329551,749,0,208.64705882352942,40,11,18,39.97737518503566,0.5802083333333333,48.27235772357723,1006.91056910569,25.17276422764225,0
1264,4,0,0,51,0.0,0.0,1.0,51,1450,900,550,0.6206896551724138,20,9,11,326.5972969643035,0.45158496732026143,0.3291505906096044,0.17052577517999176,126784.78109095097,-1918.4866398969043,124866.29445105407,750,1,209.64705882352942,40,11,18,39.99852842246889,0.5807291666666667,48.221544715447145,1007.1138211382099,25.177845528455247,0
1265,4,1,0,52,0.019230769230769232,0.0,1.0,52,1350,800,550,0.5925925925925926,19,8,11,329.3533948519062,0.4526693690296631,0.3541127419829819,0.17370679050478308,127194.50744431208,-2021.2396308414495,125173.26781347064,751,0,206.59615384615384,40,12,19,39.509243401168646,0.5848958333333334,47.815040650406495,1008.7398373983726,25.218495934959314,0
1266,4,1,2,51,0.018867924528301886,0.03773584905660377,0.9622641509433962,53,950,500,450,0.5263157894736842,14,5,9,329.86562650509154,0.45275459603289797,0.37466783780478385,0.1754802408085076,127542.56129535116,-2185.6186224490116,125356.94267290215,752,0,203.67924528301887,41,12,17,39.14014928304852,0.586890243902439,47.47023809523808,1010.1190476190451,24.63704994192793,0
1267,4,0,1,50,0.0,0.0196078431372549,0.9803921568627451,51,1200,900,300,0.75,15,9,6,335.42538097241345,0.45166666666666666,0.37293178490957657,0.17825975594138205,127502.2359789146,-1646.5027843876078,125855.733194527,753,1,210.33333333333334,40,11,18,39.041012611524806,0.5880208333333333,47.510162601626014,1009.9593495934954,25.248983739837385,0
1268,4,1,0,51,0.0196078431372549,0.0,1.0,51,1400,1000,400,0.7142857142857143,18,10,8,335.55586393843834,0.4519607843137255,0.37674661619298244,0.1791252317159298,127681.91599122556,-1631.1168740498326,126050.79911717572,754,0,211.15686274509804,40,11,19,38.85390480978716,0.58984375,47.332317073170735,1010.6707317073178,25.266768292682947,0
1269,4,0,1,50,0.0,0.0196078431372549,0.9803921568627451,51,1350,1000,350,0.7407407407407407,17,10,7,312.68770176897624,0.45179738562091504,0.2511872673597739,0.16273546322525687,126652.71392945146,-2269.626427088399,124383.08750236307,755,1,212.15686274509804,42,9,13,40.484012001026834,0.5763888888888888,48.35271317829458,1006.5891472868226,23.966408268733872,8
1270,4,3,2,51,0.05660377358490566,0.03773584905660377,0.9622641509433962,53,1100,800,300,0.7272727272727273,14,8,6,316.7092061173563,0.4532988630865989,0.31024369987802136,0.16806393638490344,127442.37075617262,-2525.2839476961353,124917.08680847648,756,0,204.9811320754717,41,12,12,39.57473635946817,0.5858739837398375,47.569444444444436,1009.7222222222204,24.62737127371269,0
1271,4,2,1,52,0.03773584905660377,0.018867924528301886,0.9811320754716981,53,1750,1000,750,0.5714285714285714,25,10,15,315.8401961216075,0.4552491533623609,0.32686691245572286,0.16961788310234444,127923.87777176821,-2519.299471185653,125404.57830058255,757,0,204.64150943396226,42,11,15,39.1052043422733,0.5892857142857143,47.09302325581394,1011.6279069767417,24.08637873754147,0
1272,4,0,0,52,0.0,0.0,1.0,52,1500,1000,500,0.6666666666666666,20,10,10,319.7980676628906,0.4534313725490196,0.3226554370937835,0.17225870571788804,128044.10450522753,-2210.3485607206308,125833.7559445069,758,1,209.34615384615384,41,11,16,38.882490361367054,0.5919715447154472,46.97420634920633,1012.1031746031707,24.685443283004165,0
1273,4,0,1,51,0.0,0.019230769230769232,0.9807692307692307,52,1200,800,400,0.6666666666666666,16,8,8,322.0917780310115,0.4530385872297637,0.32767685523687584,0.17382054969891395,128119.42087309419,-2146.757586136347,125972.66328695785,759,2,210.34615384615384,41,11,17,38.74765229462681,0.5927337398373984,46.89980158730157,1012.4007936507903,24.692702284165616,0
1274,4,1,0,52,0.019230769230769232,0.0,1.0,52,1450,1000,450,0.6896551724137931,19,10,9,321.16064846166955,0.4537298893916541,0.32376424313693697,0.17436798801711115,128360.96871803988,-2155.0942284444654,126205.87448959542,760,0,211.1153846153846,38,14,18,38.52508346512035,0.6000548245614035,46.661324786324776,1013.3547008546996,26.667228969860513,0
1275,4,3,2,53,0.05454545454545454,0.03636363636363636,0.9636363636363636,55,1600,1300,300,0.8125,19,13,6,311.3178529761946,0.456986531986532,0.34913813459267984,0.17331989478819265,129356.41503899782,-2943.065440887434,126413.34959811038,761,0,200.54545454545453,40,15,18,37.76348651348649,0.6067708333333333,45.68089430894308,1017.2764227642266,25.431910569105664,0
1276,4,2,3,52,0.03636363636363636,0.05454545454545454,0.9454545454545454,55,1700,1300,400,0.7647058823529411,21,13,8,313.84427905060556,0.45635521885521885,0.3594676678147999,0.1761749159656949,129680.91699932252,-2860.0772195452623,126820.83977977726,762,0,201.21818181818182,41,14,18,37.37043845979025,0.6084857723577235,45.362103174603156,1018.5515873015845,24.84272164150206,0
1277,4,2,3,51,0.037037037037037035,0.05555555555555555,0.9444444444444444,54,1600,1200,400,0.75,20,12,8,313.1444449698216,0.45445347076636383,0.37027820175341475,0.17853854109913916,130288.52390276972,-2637.571316829264,127650.95258594045,763,0,202.25925925925927,40,14,21,36.7737573827062,0.6161458333333334,44.76626016260163,1020.9349593495951,25.52337398373988,0
1278,4,0,0,51,0.0,0.0,1.0,51,1100,700,400,0.6363636363636364,15,7,8,330.29497201930815,0.45325163398692814,0.3675829809047795,0.18716715081094198,130050.00000000057,-1609.0277777777187,128440.97222222284,764,1,210.31372549019608,39,12,21,36.57747821350762,0.6153846153846154,45.00000000000003,1020.0000000000045,26.15384615384627,0
1279,4,0,0,51,0.0,0.0,1.0,51,1450,1100,350,0.7586206896551724,18,11,7,329.1509903777098,0.4525326797385621,0.36143117040630623,0.18715567340281086,130182.8464084205,-1630.037434895792,128552.80897352472,765,2,211.31372549019608,39,12,21,36.47215559184786,0.6167200854700854,44.869791666666686,1020.5208333333363,26.16720085470093,0
1280,4,0,0,51,0.0,0.0,1.0,51,1400,1000,400,0.7142857142857143,18,10,8,329.66734170092025,0.4523366013071895,0.36037566313405356,0.1882294176808484,130344.39718934942,-1605.917400533133,128738.47978881629,766,3,212.31372549019608,38,13,21,36.2955116133082,0.6200657894736843,44.711538461538474,1021.1538461538486,26.872469635627596,0
1281,4,0,0,51,0.0,0.0,1.0,51,1600,1000,600,0.625,22,10,12,329.9594023230601,0.4517156862745098,0.362461178930537,0.18932583582603912,130535.3879597671,-1585.7242813572839,128949.66367840982,767,4,213.31372549019608,38,13,19,36.09492071789509,0.621984649122807,44.524572649572654,1021.9017094017105,26.892150247413433,0
1282,4,0,0,51,0.0,0.0,1.0,51,1200,700,500,0.5833333333333334,17,7,10,330.42717740588245,0.45120915032679737,0.3648165222201736,0.19026402453515617,130671.89554569364,-1564.4908777120281,129107.40466798161,768,5,214.31372549019608,38,13,19,35.94501044932081,0.6233552631578947,44.39102564102564,1022.4358974358976,26.906207827260463,0
1283,4,0,1,50,0.0,0.0196078431372549,0.9803921568627451,51,1200,800,400,0.6666666666666666,16,8,8,328.6772644112962,0.4509967320261438,0.36328890691343907,0.1896580742742216,130753.83434007225,-1604.8374835634575,129148.99685650879,769,6,215.31372549019608,38,13,19,35.90697795884258,0.6241776315789473,44.31089743589743,1022.7564102564097,26.914642375168675,0
1284,4,1,0,51,0.0196078431372549,0.0,1.0,51,1750,1300,450,0.7428571428571429,22,13,9,333.57198786547576,0.45050653594771245,0.37770574729578743,0.19371435077133242,130999.80481591044,-1460.4269395134938,129539.37787639695,770,0,216.13725490196077,38,13,20,35.53342204132748,0.6266447368421053,44.07051282051281,1023.7179487179476,26.93994601889336,0
1285,4,0,1,50,0.0,0.0196078431372549,0.9803921568627451,51,700,300,400,0.42857142857142855,11,3,8,332.5723770699926,0.4504738562091503,0.3784317816423468,0.1936840101210781,131109.19922017658,-1479.340391920542,129629.85882825604,771,1,217.13725490196077,38,13,20,35.44861429862995,0.6277412280701755,43.9636752136752,1024.1452991452975,26.951192082770987,0
1286,4,0,1,49,0.0,0.02,0.98,50,1600,1000,600,0.625,22,10,12,336.80854033958644,0.4492517006802721,0.37690766823161304,0.19601152757467682,131081.84633875705,-1170.102933925084,129911.74340483197,772,2,222.32,38,12,20,35.36776212832554,0.627467105263158,43.9903846153846,1024.0384615384587,26.948380566801546,0
1287,4,0,0,49,0.0,0.0,1.0,49,1550,1200,350,0.7741935483870968,19,12,7,339.3008469598264,0.44853670634920634,0.3743710250057475,0.1978842165845992,131163.91354372093,-899.1946088100254,130264.71893491091,773,3,225.42857142857142,38,11,20,35.22110972048393,0.6282894736842105,43.910256410256395,1024.358974358972,26.95681511470979,0
1288,4,0,0,49,0.0,0.0,1.0,49,1450,1100,350,0.7586206896551724,18,11,7,340.22814222130796,0.44811153628117917,0.37676992114320584,0.19886062002560934,131248.05908203113,-869.1433376736261,130378.91574435751,774,4,226.42857142857142,39,10,20,35.11243688794008,0.6274038461538461,43.82812499999999,1024.687499999999,26.27403846153844,0
1289,4,0,0,49,0.0,0.0,1.0,49,1000,700,300,0.7,13,7,6,340.22814222130796,0.44811153628117917,0.37676992114320584,0.19886062002560934,131248.05908203113,-869.1433376736261,130378.91574435751,775,5,227.42857142857142,39,10,20,35.11243688794008,0.6274038461538461,43.82812499999999,1024.687499999999,26.27403846153844,0
1290,4,0,0,49,0.0,0.0,1.0,49,2250,1700,550,0.7555555555555555,28,17,11,342.0593738589062,0.44734977324263037,0.38100766397234787,0.20093839600053273,131440.53939673697,-807.8574507300826,130632.6819460069,776,6,228.42857142857142,37,12,20,34.87132877102937,0.6328828828828829,43.64035087719296,1025.4385964912244,27.714556661924984,0
1291,4,0,0,49,0.0,0.0,1.0,49,1550,900,650,0.5806451612903226,22,9,13,382.94318758706845,0.44688917233560094,0.4033863835221232,0.20904425990592496,128577.58881446758,99.53342367617972,128677.12223814377,777,7,229.42857142857142,38,11,16,36.73803504336528,0.6022478070175439,46.44764957264956,1014.2094017093998,26.689721097615784,8
1292,4,0,0,49,0.0,0.0,1.0,49,1250,800,450,0.64,17,8,9,382.3452658065776,0.4469423185941043,0.40542126084929153,0.2092872039979862,128685.96734832686,40.49407827449829,128726.46142660135,778,8,230.42857142857142,38,11,16,36.642272998490746,0.6033442982456141,46.34081196581195,1014.6367521367499,26.70096716149342,0
1293,4,1,1,49,0.02,0.02,0.98,50,1500,800,700,0.5333333333333333,22,8,14,375.09962484595303,0.44816326530612244,0.39619523904780896,0.20719591432098583,129046.45568940457,-318.94457664087446,128727.51111276369,779,0,226.8,40,10,17,36.457708208308325,0.6036458333333333,45.98577235772358,1016.0569105691067,25.401422764227668,0
1294,4,1,1,49,0.02,0.02,0.98,50,1300,800,500,0.6153846153846154,18,8,10,376.4513515143802,0.4483248299319728,0.3877722665516501,0.20905448107451258,129257.13320444747,-267.9166505884182,128989.21655385905,780,0,226.44,37,13,18,36.20830637624902,0.6109234234234234,45.77850877192982,1016.8859649122802,27.483404457088653,0
1295,4,0,0,49,0.0,0.0,1.0,49,1450,1100,350,0.7586206896551724,18,11,7,383.6958855111013,0.44754464285714285,0.38499087161113943,0.2139531389700075,129418.71667031923,131.48581890569017,129550.20248922492,781,1,227.3265306122449,38,11,18,35.859189066218676,0.6107456140350878,45.61965811965812,1017.5213675213674,26.776878092667562,0
1296,4,1,1,49,0.02,0.02,0.98,50,1250,700,550,0.56,18,7,11,377.2919057228877,0.44811224489795914,0.38944495553511205,0.21249549301594745,129811.04736328112,-204.66851128473496,129606.37885199639,782,0,223.76,39,11,14,35.622274183106754,0.6129807692307692,45.23437499999999,1019.062499999999,26.129807692307665,0
1297,4,1,1,49,0.02,0.02,0.98,50,1550,1000,550,0.6451612903225806,21,10,11,379.9031959530304,0.4479676870748299,0.4018092709822345,0.21557195255874725,130103.13042534716,-114.68098958333724,129988.44943576382,783,0,224.7,39,11,16,35.258406507385494,0.6159188034188035,44.947916666666664,1020.2083333333328,26.15918803418802,0
1298,4,0,2,47,0.0,0.04081632653061224,0.9591836734693877,49,1550,1100,450,0.7096774193548387,20,11,9,380.43782997005076,0.4459856859410431,0.4029396646337231,0.21577728657374673,130085.41907793198,97.88290895060453,130183.30198688258,784,1,230.20408163265307,41,8,18,35.2627921488541,0.6125508130081301,44.96527777777777,1020.1388888888879,24.881436314363118,0
1299,4,0,0,47,0.0,0.0,1.0,47,1400,900,500,0.6428571428571429,19,9,10,393.5879532938032,0.4460376194881283,0.39347033858710945,0.2228814141526676,130023.43885633661,835.1318359374826,130858.5706922741,785,2,230.4468085106383,39,8,18,34.99057382630306,0.6151175213675213,45.02604166666666,1019.8958333333318,26.151175213675174,0
1300,4,0,0,47,0.0,0.0,1.0,47,1350,1000,350,0.7407407407407407,17,10,7,392.33849817116135,0.445613629355535,0.3884960846285017,0.22278003417892886,130129.69970703112,810.9781901041531,130940.67789713528,786,3,231.4468085106383,39,8,19,34.91417815211842,0.6161858974358974,44.92187499999999,1020.312499999999,26.16185897435895,0
1301,4,0,0,47,0.0,0.0,1.0,47,1250,900,350,0.72,16,9,7,389.20675299780913,0.4453052728954672,0.38579025679297474,0.2219212844451659,130291.32806793273,742.2563987393132,131033.58446667204,787,4,232.4468085106383,36,11,20,34.82953709831604,0.6232638888888888,44.76351351351351,1020.9459459459454,28.359609609609592,0
1302,4,0,0,47,0.0,0.0,1.0,47,1550,900,650,0.5806451612903226,22,9,13,385.52850209577605,0.4449969164353993,0.3836637393651272,0.22093201614566046,130486.54994806091,661.2568290243132,131147.80677708524,788,5,233.4468085106383,37,10,20,34.72490520140231,0.6233108108108107,44.57236842105263,1021.7105263157893,27.613798008534843,0
1303,4,0,0,47,0.0,0.0,1.0,47,1500,1200,300,0.8,18,12,6,386.20620988703337,0.4445343817452976,0.37624250390207825,0.22228312969053712,130654.64854570647,691.927323791946,131346.57586949843,789,6,234.4468085106383,37,10,16,34.53676891176892,0.625,44.40789473684211,1022.3684210526324,27.631578947368443,0
1304,4,0,0,47,0.0,0.0,1.0,47,900,300,600,0.3333333333333333,15,3,12,392.0094133673052,0.4440525747764416,0.3836082624721726,0.22627870098330594,130766.77439212067,852.361303477996,131619.13569559867,790,7,235.4468085106383,37,10,16,34.2744961406518,0.6261261261261262,44.29824561403509,1022.8070175438598,27.643432906590807,0
1305,4,0,1,46,0.0,0.02127659574468085,0.9787234042553191,47,1600,800,800,0.5,24,8,16,390.8137082926231,0.4435900400863398,0.38641616784211497,0.22657485423623255,130935.05333371805,834.2427477685451,131769.2960814866,791,8,236.4468085106383,37,10,16,34.13416898792944,0.6278153153153153,44.13377192982456,1023.4649122807016,27.661213845424367,0
1306,4,0,0,46,0.0,0.0,1.0,46,1200,800,400,0.6666666666666666,16,8,8,391.55907713477404,0.44408212560386473,0.37553556126820964,0.22733803135138375,130991.17036011082,1058.1563558017897,132049.3267159126,792,9,236.7173913043478,37,9,16,34.05812624964297,0.6283783783783784,44.078947368421055,1023.6842105263158,27.667140825035563,0
1307,4,2,1,47,0.041666666666666664,0.020833333333333332,0.9791666666666666,48,1350,1100,250,0.8148148148148148,16,11,5,374.32596674223254,0.44590351654846333,0.3664810140474095,0.22091050576134874,131616.8533398264,254.81964965452977,131871.67298948093,793,0,227.8125,36,12,16,33.86582711442786,0.6365740740740741,43.46846846846847,1026.1261261261268,28.503503503503524,0
1308,4,1,0,48,0.020833333333333332,0.0,1.0,48,1500,900,600,0.6,21,9,12,374.3533008876019,0.44424128250591016,0.36939504788351374,0.22169955447252482,131749.92696069943,264.2040098876582,132014.13097058708,794,0,228.79166666666666,37,11,17,33.730619637580546,0.6359797297297297,43.338815789473685,1026.6447368421052,27.747155049786628,0
1309,4,0,0,48,0.0,0.0,1.0,48,1950,1200,750,0.6153846153846154,27,12,15,372.5936514076656,0.4432716459810875,0.36143169058016245,0.22203257368270923,131985.99810979614,235.42899408283773,132221.427103879,795,1,229.79166666666666,38,10,17,33.537377833229364,0.6365131578947368,43.10897435897436,1027.5641025641023,27.041160593792167,0
1310,4,0,1,47,0.0,0.020833333333333332,0.9791666666666666,48,1050,700,350,0.6666666666666666,14,7,7,374.9912704490849,0.442542109929078,0.36204709203644114,0.22427228064210925,132123.26189139063,309.01396650592903,132432.27585789657,796,2,230.79166666666666,38,10,17,33.33723024697772,0.6378837719298245,42.97542735042734,1028.0982905982887,27.055218173639176,0
1311,4,0,0,47,0.0,0.0,1.0,47,1650,1000,650,0.6060606060606061,23,10,13,382.42806643107394,0.44245297563983965,0.373909117925288,0.2291880405787247,132200.59447378034,711.4435451292605,132912.0380189096,797,3,222.95744680851064,37,10,17,33.068002096883106,0.6404842342342343,42.90021929824561,1028.399122807017,27.794570886676134,0
1312,4,0,1,46,0.0,0.02127659574468085,0.9787234042553191,47,1550,1100,450,0.7096774193548387,20,11,9,381.7764302264766,0.4417977181621955,0.3756206318236357,0.22932783821901082,132288.07259706702,700.8936235298504,132988.96622059686,798,4,223.95744680851064,38,9,17,32.99646034548413,0.6395285087719298,42.815170940170944,1028.7393162393166,27.0720872694557,0
1313,4,0,0,46,0.0,0.0,1.0,46,1200,600,600,0.5,18,6,12,383.8597413093262,0.44132447665056357,0.38594833018273467,0.2309063982337639,132341.5858725762,960.1213835026163,133301.7072560788,799,5,228.91304347826087,37,9,17,32.8888711281614,0.6418918918918919,42.76315789473684,1028.9473684210527,27.809388335704128,0
1314,4,0,0,46,0.0,0.0,1.0,46,1950,1600,350,0.8205128205128205,23,16,7,385.32721170358695,0.43984500805152976,0.38825808468953515,0.2334259262729896,132606.53941883135,1019.4056634442709,133625.94508227563,800,6,229.91304347826087,35,11,18,32.58383432595422,0.6485119047619048,42.50578703703703,1029.976851851851,29.42791005291003,0
1315,4,0,0,46,0.0,0.0,1.0,46,1750,1200,550,0.6857142857142857,23,12,11,380.5754809258835,0.4389794685990338,0.37988904570516047,0.23128078543912223,132725.77649444874,902.4352441272314,133628.21173857598,801,7,230.91304347826087,35,11,18,32.58604309408813,0.649702380952381,42.3900462962963,1030.439814814815,29.44113756613757,0
1316,4,0,1,45,0.0,0.021739130434782608,0.9782608695652174,46,1700,1100,600,0.6470588235294118,23,11,12,378.24573154780694,0.4386473429951691,0.3773638772711523,0.23096581373265324,132904.73257726766,854.1295599708465,133758.8621372385,802,8,231.91304347826087,35,11,18,32.465881879747066,0.6514880952380953,42.21643518518518,1031.1342592592591,29.460978835978832,0
1317,4,0,0,45,0.0,0.0,1.0,45,1000,800,200,0.8,12,8,4,383.175499125018,0.4371212121212121,0.3791647956892683,0.23378954426066148,132874.898191015,1182.8810871056166,134057.7792781206,803,9,237.17777777777778,35,10,18,32.368844484358625,0.6511904761904762,42.24537037037037,1031.0185185185178,29.457671957671938,0
1318,4,0,1,44,0.0,0.022222222222222223,0.9777777777777777,45,1400,900,500,0.6428571428571429,19,9,10,388.6439561166216,0.4362794612794613,0.37938144329897017,0.23822481974601206,133047.67001625468,1341.6345654431768,134389.30458169786,804,10,238.17777777777778,37,8,18,32.053862436674095,0.6489301801801801,42.077850877192965,1031.6885964912256,27.883475580843935,0
1319,4,1,0,45,0.022222222222222223,0.0,1.0,45,1150,900,250,0.782608695652174,14,9,5,386.409707842553,0.4359427609427609,0.38554387455311345,0.23829863908011245,133274.0136989264,1299.6745392812986,134573.6882382077,805,0,238.22222222222223,37,8,19,31.883716505610415,0.6511824324324325,41.85855263157894,1032.5657894736828,27.907183499288724,0
1320,4,0,0,45,0.0,0.0,1.0,45,1150,800,350,0.6956521739130435,15,8,7,384.4153871984382,0.4352483164983165,0.3812846145007476,0.23798314943718896,133417.0284991597,1257.5117338738883,134674.5402330336,806,1,239.22222222222223,38,7,19,31.7914081351258,0.6507675438596492,41.72008547008546,1033.1196581196564,27.187359424201485,0
1321,4,0,0,45,0.0,0.0,1.0,45,700,400,300,0.5714285714285714,10,4,6,350.06484860808155,0.4348695286195286,0.2876741693461955,0.20236090690913233,130822.8553497228,195.83370232106904,131018.68905204386,807,2,240.22222222222223,37,8,14,35.29028224365845,0.6266891891891893,44.24342105263157,1023.026315789472,27.649359886201946,8
1322,4,0,0,45,0.0,0.0,1.0,45,1000,800,200,0.8,12,8,4,352.5817094590771,0.43423821548821545,0.2928786824402694,0.20446324313667985,130945.12473518858,233.77118489295333,131178.89592008153,808,3,241.22222222222223,38,7,14,35.10220946416145,0.6260964912280702,44.12393162393161,1023.5042735042715,26.934322986954513,0
1323,4,1,1,45,0.021739130434782608,0.021739130434782608,0.9782608695652174,46,1400,800,600,0.5714285714285714,20,8,12,354.7866921625741,0.435799114331723,0.31786599147556105,0.20854852774455285,131465.04635336762,128.9690855796547,131594.01543894727,809,0,236.95652173913044,38,8,17,34.52030593464597,0.6313048245614035,43.61645299145299,1025.5341880341878,26.987741790373363,0
1324,4,0,1,44,0.0,0.022222222222222223,0.9777777777777777,45,1050,600,450,0.5714285714285714,15,6,9,360.8812559410081,0.4361321548821549,0.31774546145803617,0.2119950694447429,131440.5393967374,486.88538781162913,131927.42478454905,810,1,236.7111111111111,37,8,17,34.3888116623895,0.6328828828828829,43.64035087719298,1025.4385964912278,27.714556661925076,0
1325,4,0,0,44,0.0,0.0,1.0,44,1100,400,700,0.36363636363636365,18,4,14,372.65836854428403,0.43584830866807606,0.3214549648966871,0.21843587436307893,131356.98356718203,990.2558386088754,132347.2394057909,811,2,241.27272727272728,36,8,17,34.17142700208721,0.6339699074074074,43.721846846846844,1025.1126126126126,28.47535035035035,0
1326,4,0,0,44,0.0,0.0,1.0,44,1100,700,400,0.6363636363636364,15,7,8,373.8240224320304,0.43513257575757575,0.323222341997045,0.21994762250070643,131501.32395909436,1031.6707755052507,132532.9947345996,812,3,242.27272727272728,36,8,18,33.99552591128677,0.6354166666666667,43.58108108108109,1025.6756756756768,28.490990990991023,0
1327,4,0,1,43,0.0,0.022727272727272728,0.9772727272727273,44,1500,1000,500,0.6666666666666666,20,10,10,378.6342804872156,0.4344058315715293,0.3255664366348878,0.22413182473515958,131732.43344696047,1175.6830310039795,132908.11647796445,813,4,243.27272727272728,36,8,14,33.638428769928346,0.6377314814814814,43.35585585585586,1026.5765765765766,28.516016016016017,0
1328,4,0,1,42,0.0,0.023255813953488372,0.9767441860465116,43,1250,700,550,0.56,18,7,11,381.0164150821908,0.43387781469176817,0.3165684894338221,0.22578467723407578,131773.380232446,1441.5641878858005,133214.9444203318,814,5,237.90697674418604,35,8,14,33.535889414947576,0.6401785714285715,43.31597222222222,1026.7361111111113,29.335317460317466,0
1329,4,0,0,42,0.0,0.0,1.0,42,1300,900,400,0.6923076923076923,17,9,8,384.3141294346511,0.43211624080526523,0.3192429962249157,0.22836517277976368,131877.80612244888,1736.5008503401252,133614.306972789,815,6,243.21428571428572,34,8,16,33.34564789058877,0.6433823529411764,43.21428571428571,1027.1428571428564,30.210084033613423,0
1330,4,0,0,42,0.0,0.0,1.0,42,1550,1100,450,0.7096774193548387,20,11,9,386.6123285759129,0.4312209639953542,0.32718031032637795,0.23065820543164137,132030.6990504533,1808.939200680243,133839.63825113353,816,7,244.21428571428572,34,8,17,33.13207073632185,0.6449142156862745,43.065476190476176,1027.7380952380934,30.22759103641451,0
1331,4,0,1,41,0.0,0.023809523809523808,0.9761904761904762,42,1200,700,500,0.5833333333333334,17,7,10,386.6081436257618,0.4309668989547038,0.3258747621804945,0.23102846506632882,132091.88102324255,1813.5593820861518,133905.4404053287,817,8,245.21428571428572,34,8,18,33.07035321366531,0.6455269607843137,43.00595238095237,1027.9761904761897,30.23459383753499,0
1332,4,0,0,41,0.0,0.0,1.0,41,850,500,350,0.5882352941176471,12,5,7,394.9793360166991,0.42990345528455287,0.3331131820205242,0.23499728699985695,131925.46323829758,2221.566374711628,134147.02961300922,818,9,251.90243902439025,33,8,18,33.02355461449759,0.6461489898989898,43.167892156862735,1027.3284313725476,31.131164587046896,0
1333,4,0,0,41,0.0,0.0,1.0,41,1500,1200,300,0.8,18,12,6,400.5921308548675,0.43005589430894314,0.3393344307876667,0.23893069767773215,132019.90370290252,2377.2269079200073,134397.13061082253,819,10,252.90243902439025,33,8,18,32.78380634390652,0.6470959595959596,43.07598039215685,1027.6960784313708,31.142305407011236,0
1334,4,0,0,41,0.0,0.0,1.0,41,1850,1400,450,0.7567567567567568,23,14,9,403.2259696171048,0.42929369918699184,0.3355119579671315,0.2417397051715591,132214.2874858276,2462.4468537414914,134676.73433956908,820,11,253.90243902439025,34,7,18,32.51943704904117,0.6467524509803921,42.88690476190476,1028.4523809523805,30.248599439775898,0
1335,4,0,0,41,0.0,0.0,1.0,41,1250,1100,150,0.88,14,11,3,403.58802143182015,0.42878556910569104,0.3394146680099226,0.24274260746243698,132336.75063775503,2481.9054705215335,134818.65610827657,821,12,254.90243902439025,34,7,19,32.38627598441899,0.6479779411764706,42.76785714285714,1028.9285714285706,30.262605042016784,0
1336,4,0,0,41,0.0,0.0,1.0,41,1200,700,500,0.5833333333333334,17,7,10,402.3996459538756,0.42878556910569104,0.3410684309272243,0.24242125012343255,132398.00347222234,2455.410289115664,134853.413761338,822,13,255.90243902439025,32,9,19,32.35492577597841,0.6533203125,42.70833333333334,1029.1666666666677,32.161458333333364,0
1337,4,1,0,42,0.023809523809523808,0.0,1.0,42,1200,800,400,0.6666666666666666,16,8,8,361.6512926678286,0.4307854239256678,0.23355409670985083,0.2112352799691667,131221.37586805577,1091.276041666691,132312.65190972245,823,0,250.78571428571428,39,3,17,34.59061949301885,0.6271367521367521,43.85416666666668,1024.583333333335,26.271367521367566,8
1338,4,0,0,42,0.0,0.0,1.0,42,1100,600,500,0.5454545454545454,16,6,10,329.01890387949254,0.4304829655439411,0.12567296219771285,0.18979480600992113,130741.54188368063,203.3311631944546,130944.87304687509,824,1,251.78571428571428,39,3,15,35.91065729612277,0.6223290598290598,44.32291666666667,1022.708333333334,26.223290598290617,8
1339,4,0,0,42,0.0,0.0,1.0,42,1200,1000,200,0.8333333333333334,14,10,4,327.151455319996,0.43070073557878435,0.12166618174764832,0.18897807595543326,130794.81336805574,157.94270833335284,130952.7560763891,825,2,252.78571428571428,39,3,15,35.90461642905634,0.6228632478632479,44.27083333333334,1022.9166666666681,26.228632478632516,0
1340,4,0,0,42,0.0,0.0,1.0,42,1200,800,400,0.6666666666666666,16,8,8,328.62417638383465,0.4301079171506001,0.12548472157592738,0.1903540040562965,130901.38888888882,203.47222222221762,131104.86111111104,826,3,253.78571428571428,39,3,15,35.759364820846926,0.6239316239316239,44.166666666666664,1023.3333333333327,26.239316239316224,0
1341,4,0,1,41,0.0,0.023809523809523808,0.9761904761904762,42,1250,1000,250,0.8,15,10,5,328.117576247183,0.42920054200542007,0.12458516828239086,0.19071955392865544,131034.66932508687,198.95562065972686,131233.6249457466,827,4,254.78571428571428,39,3,17,35.637844643402175,0.625267094017094,44.036458333333336,1023.8541666666672,26.252670940170955,0
1342,4,0,1,40,0.0,0.024390243902439025,0.975609756097561,41,900,600,300,0.6666666666666666,12,6,6,326.5032156148384,0.42815040650406505,0.11452378885761383,0.19057324187370545,131194.69536675356,367.0979817708377,131561.7933485244,828,5,250.0731707317073,39,2,17,35.51781477715641,0.6268696581196581,43.880208333333336,1024.4791666666672,26.268696581196593,0
1343,4,0,0,40,0.0,0.0,1.0,40,1350,800,550,0.5925925925925926,19,8,11,355.0484136406181,0.4250801282051282,0.1245300751879701,0.20531060440957463,130835.79881656796,1310.2076302853707,132146.00644685334,829,20,257.2,38,2,17,35.14972326649958,0.625,44.230769230769226,1023.0769230769223,26.923076923076902,8
1344,4,0,0,40,0.0,0.0,1.0,40,550,200,350,0.36363636363636365,9,2,7,372.629409808957,0.4248397435897436,0.12687479621780273,0.1967047159869311,127230.25504241671,1569.2661671558697,128799.52120957259,830,21,258.2,37,3,15,38.38113157990071,0.5903716216216216,47.77960526315788,1008.881578947367,27.26706970128019,8
1345,4,0,0,40,0.0,0.0,1.0,40,1200,900,300,0.75,15,9,6,366.4877943263069,0.4243856837606838,0.12119007302360085,0.1942200318894709,127388.43831041313,1337.2615558111977,128725.69986622433,831,22,259.2,38,2,15,38.37354922919532,0.5901864035087719,47.62286324786323,1009.5085470085442,26.566014394961687,0
1346,4,0,0,40,0.0,0.0,1.0,40,1450,1100,350,0.7586206896551724,18,11,7,362.5943513958166,0.4245592948717949,0.11297334461603636,0.19279904376243193,127523.29082657566,1247.8449850244274,128771.13581160008,832,23,260.2,38,2,15,38.33342147944433,0.5915570175438596,47.48931623931622,1010.0427350427316,26.580071974808725,0
1347,4,2,0,42,0.047619047619047616,0.0,1.0,42,1050,500,550,0.47619047619047616,16,5,11,348.24851742165083,0.4302651955090979,0.036190284834046293,0.18697226226618704,127913.11905115984,520.0799312087242,128433.19898236856,833,0,248.76190476190476,40,2,14,38.296580938986004,0.5921875,47.10365853658536,1011.5853658536571,25.289634146341427,8
1348,4,0,1,41,0.0,0.023809523809523808,0.9761904761904762,42,1000,800,200,0.8,12,8,4,347.1117816605672,0.42967237708091366,0.03922032715084267,0.18695977466509384,128041.65556423078,488.9534379337549,128530.60900216454,834,1,249.76190476190476,40,2,15,38.19388660173378,0.5934895833333333,46.976626016260155,1012.093495934958,25.30233739837395,0
1349,4,0,0,41,0.0,0.0,1.0,41,1100,900,200,0.8181818181818182,13,9,4,349.6042053197145,0.42845528455284554,0.05706427393455393,0.18892073402853823,128173.03790276774,762.0905460483328,128935.12844881607,835,2,255.8780487804878,36,5,17,37.99650615361802,0.6018518518518519,46.84684684684685,1012.6126126126135,28.128128128128154,0
1350,4,2,3,40,0.046511627906976744,0.06976744186046512,0.9302325581395349,43,1500,1200,300,0.8,18,12,6,335.13171376653554,0.43136304909560724,0.06158787828339296,0.18369394974427727,128740.17373666831,28.983010994249867,128769.15674766256,836,0,244.93023255813952,38,5,13,37.78467908902693,0.6038925438596492,46.28739316239317,1014.8504273504288,26.706590193432337,0
1351,4,2,0,42,0.047619047619047616,0.0,1.0,42,1000,700,300,0.7,13,7,6,342.17826338855775,0.43191056910569103,0.07412001744177332,0.18781257541621543,128794.39153928349,414.1282462196056,129208.5197855031,837,0,249.6904761904762,38,4,16,37.550652562888104,0.6044407894736843,46.233974358974365,1015.0641025641036,26.712213225371148,0
1352,4,1,1,42,0.023255813953488372,0.023255813953488372,0.9767441860465116,43,1400,900,500,0.6428571428571429,19,9,10,333.2437516796557,0.4340854558877815,0.0907357987037738,0.1847988077496275,129201.38888888911,11.111111111131322,129212.50000000023,838,0,244.86046511627907,40,3,18,37.36338797814208,0.6052083333333333,45.83333333333334,1016.6666666666684,25.41666666666671,0
1353,4,1,0,43,0.023255813953488372,0.0,1.0,43,1050,700,350,0.6666666666666666,14,7,7,336.5147591191817,0.4334856035437431,0.10334647543949882,0.18761850268699581,129413.28125000001,109.89583333333394,129523.17708333334,839,0,245.72093023255815,39,4,19,37.06490581490582,0.608974358974359,45.625,1017.5000000000001,26.08974358974359,0
1354,4,0,0,43,0.0,0.0,1.0,43,1400,1000,400,0.7142857142857143,18,10,8,331.7177749540073,0.43263196751568844,0.09776772968569047,0.18577307922102848,129589.12854658272,-2.596524059750891,129586.53202252297,840,1,246.72093023255815,40,3,14,37.00843397544666,0.6091145833333333,45.452235772357724,1018.191056910569,25.454776422764226,0
1355,4,0,0,43,0.0,0.0,1.0,43,1500,1000,500,0.6666666666666666,20,10,10,328.84342759062474,0.4326550387596899,0.09836803340486,0.1848937387322495,129744.38707325314,-66.88220883735232,129677.50486441578,841,2,247.72093023255815,40,3,14,36.924147963424765,0.6106770833333333,45.29979674796747,1018.8008130081283,25.47002032520321,0
1356,4,0,1,42,0.0,0.023255813953488372,0.9767441860465116,43,1350,800,550,0.5925925925925926,19,8,11,332.02356316195403,0.4322166851236619,0.11170487766992099,0.18742421846243998,129899.7385505485,25.954809471862973,129925.69336002036,842,3,248.72093023255815,40,3,15,36.685649486591565,0.6122395833333334,45.14735772357723,1019.4105691056901,25.485264227642254,0
1357,4,1,0,43,0.023255813953488372,0.0,1.0,43,1150,600,550,0.5217391304347826,17,6,11,332.1918874373181,0.4346391657438169,0.11735669343344846,0.18801723578305027,130003.35784131453,37.212162899054874,130040.57000421359,843,0,249.58139534883722,40,3,17,36.57635774788243,0.61328125,45.04573170731707,1019.8170731707304,25.49542682926826,0
1358,4,0,1,42,0.0,0.023255813953488372,0.9767441860465116,43,1750,1600,150,0.9142857142857143,19,16,3,329.5826915930716,0.4346391657438169,0.12013651561038419,0.1876603488866674,130236.65229030345,-15.250718818157793,130221.40157148529,844,1,250.58139534883722,40,3,17,36.40668558343289,0.615625,44.81707317073171,1020.7317073170736,25.51829268292684,0
1359,4,1,1,42,0.023255813953488372,0.023255813953488372,0.9767441860465116,43,1250,800,450,0.64,17,8,9,323.21915354887363,0.4365771502399409,0.12667419282004966,0.18536510476355228,130515.89269967253,-162.95272738724267,130352.9399722853,845,0,249.27906976744185,41,2,14,36.28681229773464,0.6168699186991871,44.5436507936508,1021.8253968253973,24.922570654277983,0
1360,4,0,0,42,0.0,0.0,1.0,42,1750,1300,450,0.7428571428571429,22,13,9,326.0821688652694,0.4336769260549748,0.12266035975889822,0.18728774256299358,130574.00238160165,115.57077880230952,130689.57316040396,846,3,256.2142857142857,40,2,14,36.15495840376521,0.6190104166666667,44.486788617886184,1022.052845528456,25.5513211382114,0
1361,4,0,0,42,0.0,0.0,1.0,42,1300,1100,200,0.8461538461538461,15,11,4,328.06738100225715,0.4332534843205575,0.12535737953233017,0.188807657487569,130651.91436975346,172.52627404323363,130824.4406437967,847,4,257.2142857142857,40,2,14,36.02551358515575,0.6197916666666667,44.41056910569106,1022.3577235772358,25.558943089430894,0
1362,4,0,0,42,0.0,0.0,1.0,42,1250,1000,250,0.8,15,10,5,326.55864057002583,0.4329510259388308,0.12713315828070004,0.1885721581949117,130781.81932257587,141.58662585102408,130923.4059484269,848,5,258.2142857142857,40,2,14,35.93289451896011,0.62109375,44.28353658536586,1022.8658536585368,25.57164634146342,0
1363,4,0,0,42,0.0,0.0,1.0,42,1100,700,400,0.6363636363636364,15,7,8,330.04738938187893,0.4324670925280681,0.13348794984183754,0.19135908223747253,130937.79047070182,243.13518325730763,131180.92565395913,849,6,259.2142857142857,40,2,15,35.686211233574966,0.62265625,44.131097560975604,1023.4756097560964,25.58689024390241,0
1364,4,0,0,42,0.0,0.0,1.0,42,1550,1100,450,0.7096774193548387,20,11,9,335.0545640806632,0.4326485675571041,0.13511278692862372,0.1951838090638684,131119.87428944407,386.46246447220454,131506.33675391626,850,7,260.2142857142857,40,2,16,35.37428888006882,0.6244791666666667,43.953252032520325,1024.1869918699183,25.604674796747958,0
1365,4,0,0,42,0.0,0.0,1.0,42,1700,1300,400,0.7647058823529411,21,13,8,340.30394595860855,0.4322009291521487,0.12492622234813666,0.19918544950624273,131302.084624314,536.5235020490254,131838.60812636305,851,8,261.2142857142857,40,2,16,35.05598248223434,0.6263020833333333,43.77540650406503,1024.898373983738,25.622459349593452,0
1366,4,0,0,42,0.0,0.0,1.0,42,1050,700,350,0.6666666666666666,14,7,7,346.13765889691473,0.4322372241579559,0.13708132582573884,0.20330424308957198,131434.91753472213,698.9175125173408,132133.83504723947,852,9,262.2142857142857,39,3,16,34.772450223486395,0.6292735042735043,43.64583333333333,1025.4166666666658,26.29273504273502,0
1367,4,0,0,42,0.0,0.0,1.0,42,1000,700,300,0.7,13,7,6,345.6804323718919,0.43157181571815717,0.14361365295280715,0.20403223123400246,131621.90890841995,699.823676215258,132321.7325846352,853,10,263.2142857142857,39,3,14,34.59557828308463,0.6311431623931624,43.46354166666666,1026.1458333333317,26.311431623931583,0
1368,4,0,0,42,0.0,0.0,1.0,42,1650,1200,450,0.7272727272727273,21,12,9,344.77675249456337,0.431003193960511,0.13574539079289694,0.20443804619748043,131797.29327781076,688.1285527794236,132485.42183059017,854,11,264.2142857142857,40,2,14,34.44201141462127,0.63125,43.292682926829265,1026.8292682926824,25.67073170731706,0
1369,4,0,0,42,0.0,0.0,1.0,42,1300,900,400,0.6923076923076923,17,9,8,341.9119282247347,0.4307370305845915,0.13736336192077525,0.20371664739424203,131979.9735297274,625.1054473196925,132605.0789770471,855,12,265.2142857142857,40,2,16,34.33162727062935,0.6330729166666667,43.11483739837397,1027.540650406502,25.68851626016255,0
1370,4,1,0,43,0.023255813953488372,0.0,1.0,43,850,400,450,0.47058823529411764,13,4,9,334.68726762261264,0.4318706164636397,0.13937785594271657,0.20067685965550136,132219.38898533914,250.42920524688108,132469.81819058603,856,0,260.0232558139535,41,2,17,34.27653049741166,0.6338922764227642,42.88194444444443,1028.4722222222194,25.0846883468834,0
1371,4,0,0,43,0.0,0.0,1.0,43,1050,800,250,0.7619047619047619,13,8,5,335.5629555994272,0.43157069029162054,0.1354892242829271,0.20160995652178745,132295.92328829644,278.7222064751417,132574.6454947716,857,1,261.0232558139535,41,2,17,34.17711346833814,0.6346544715447154,42.80753968253966,1028.7698412698383,25.091947348044837,0
1372,4,0,0,43,0.0,0.0,1.0,43,1200,600,600,0.5,18,6,12,353.7225195227054,0.43080933923957176,0.17337150644857724,0.2025588638225596,130458.54403518385,712.4677657336855,131171.01180091753,858,2,262.0232558139535,37,6,21,35.56569979607169,0.6230292792792793,44.59978070175438,1021.600877192982,27.610834518729245,8
1373,4,0,0,43,0.0,0.0,1.0,43,1650,1200,450,0.7272727272727273,21,12,9,349.63352566149945,0.4312246216315984,0.16359588878889753,0.20196477776446625,130794.81336805563,546.0503472222268,131340.86371527787,859,3,263.0232558139535,37,6,18,35.32968431771893,0.6264076576576576,44.270833333333336,1022.9166666666673,27.646396396396415,0
1374,4,0,0,43,0.0,0.0,1.0,43,1450,1200,250,0.8275862068965517,17,12,5,349.90516984638145,0.4309016242155777,0.1621028917752374,0.20256296805250804,130878.94833025541,559.0441289627545,131437.99245921816,860,4,264.0232558139535,37,6,18,35.23762323189027,0.6272522522522522,44.18859649122807,1023.2456140350873,27.65528686581317,0
1375,4,0,0,43,0.0,0.0,1.0,43,1200,800,400,0.6666666666666666,16,8,8,357.4311929483888,0.43085548172757476,0.12107028749880899,0.19893259186092438,129344.54038075262,757.3984566330819,130101.9388373857,861,5,265.0232558139535,36,7,21,36.60282667257094,0.6137152777777778,45.69256756756758,1017.2297297297317,28.256381381381438,8
1376,4,0,0,43,0.0,0.0,1.0,43,950,800,150,0.8421052631578947,11,8,3,353.7436808035159,0.4308324104835733,0.12096626813039735,0.19716682023811047,129401.82317029891,555.0154461894616,129956.83861648837,862,6,266.0232558139535,36,7,21,36.63830474082274,0.6142939814814814,45.636261261261275,1017.4549549549569,28.26263763763769,0
1377,4,0,0,43,0.0,0.0,1.0,43,1200,900,300,0.75,15,9,6,352.64115179680056,0.4300018456995201,0.1233312206108188,0.1970841548542865,129508.13140822176,533.9793253693435,130042.11073359111,863,7,267.0232558139535,37,6,17,36.55820226938131,0.6134572072072072,45.531798245614034,1017.8728070175438,27.510075865339022,0
1378,4,0,0,43,0.0,0.0,1.0,43,1150,700,450,0.6086956521739131,16,7,9,351.05285744649876,0.4301633444075304,0.12242239116220488,0.19683740218706022,129636.2270801373,501.83358901307054,130138.06066915036,864,8,268.0232558139535,38,5,17,36.46838718701916,0.6129385964912281,45.4059829059829,1018.376068376068,26.799370220422844,0
1379,4,0,0,43,0.0,0.0,1.0,43,800,200,600,0.25,14,2,12,350.0114573175682,0.42977113325950533,0.11987719294073451,0.1965974750780296,129704.91672091998,479.64138454859255,130184.55810546858,865,9,269.0232558139535,39,4,17,36.42509885127995,0.6119123931623931,45.33854166666666,1018.645833333332,26.119123931623896,0
1380,4,0,0,43,0.0,0.0,1.0,43,950,800,150,0.8421052631578947,11,8,3,377.90248560576777,0.42997877445551863,0.15622812581337242,0.19976086013956817,127285.5725439559,1085.5276608547897,128371.10020481069,866,10,270.0232558139535,37,6,14,38.19123745879967,0.5909346846846847,47.72478070175439,1009.100877192983,27.272996680891435,8
1381,4,1,1,43,0.022727272727272728,0.022727272727272728,0.9772727272727273,44,1250,1200,50,0.96,13,12,1,376.16498828284807,0.4310584038054968,0.1746172476429375,0.20068497598237225,127658.2146819527,804.1101660092105,128462.3248479619,867,0,264.8636363636364,38,6,12,37.852177820065556,0.5929276315789473,47.35576923076923,1010.5769230769233,26.594129554655876,0
1382,4,0,0,43,0.0,0.0,1.0,43,1150,800,350,0.6956521739130435,15,8,7,382.9201663005823,0.42762550756736806,0.1884278423982828,0.2046458558333373,127728.54538175206,1181.9671677823933,128910.51254953445,868,1,271.4651162790698,37,6,12,37.609262573670314,0.5954391891891893,47.286184210526315,1010.8552631578946,27.320412517780934,0
1383,4,1,0,44,0.022727272727272728,0.0,1.0,44,1650,1200,450,0.7272727272727273,21,12,9,356.4835983674574,0.42962693798449614,0.21632996632996626,0.19250114311842714,128144.53125000013,353.1709275931219,128497.70217759325,869,0,266.27272727272725,38,6,15,37.85150891632373,0.5978618421052632,46.87500000000001,1012.500000000001,26.64473684210529,8
1384,4,1,1,44,0.022222222222222223,0.022222222222222223,0.9777777777777777,45,1500,1200,300,0.8,18,12,6,351.97463835138456,0.43120791245791246,0.2102388455039501,0.1915781420825322,128461.13281250001,43.01215277777848,128504.1449652778,870,0,261.3333333333333,39,6,12,37.642142759282095,0.5993589743589743,46.5625,1013.7500000000001,25.993589743589748,0
1385,4,0,0,44,0.0,0.0,1.0,44,1250,700,550,0.56,18,7,11,354.5881028335524,0.4296819943622269,0.20479452054794556,0.19317113064812927,128496.3348765432,312.65432098765666,128808.98919753086,871,2,268.27272727272725,38,6,13,37.539954337899545,0.6014254385964912,46.52777777777778,1013.8888888888888,26.6812865497076,0
1386,4,1,0,45,0.022222222222222223,0.0,1.0,45,1450,1300,150,0.896551724137931,16,13,3,347.50112054106603,0.4318181818181818,0.2044996052002357,0.19107780381539874,128865.81776926777,-43.79678514771592,128822.02098412006,872,0,263.2888888888889,40,5,14,37.342775164314546,0.6018229166666667,46.16361788617887,1015.3455284552857,25.38363821138214,0
1387,4,2,0,47,0.0425531914893617,0.0,1.0,47,1200,800,400,0.6666666666666666,16,8,8,339.6989770542532,0.4335299105766266,0.23076628889767137,0.18961792398111985,129459.8174449732,-603.6537857756655,128856.16365919754,873,0,253.04255319148936,40,7,13,36.93662206244591,0.6078125,45.579268292682926,1017.682926829268,25.4420731707317,0
1388,4,0,0,47,0.0,0.0,1.0,47,1350,1100,250,0.8148148148148148,16,11,5,338.7157999037267,0.4333371877890842,0.2276411026206666,0.1899424191849605,129640.87106095903,-617.7177316742752,129023.15332928476,874,1,254.04255319148936,40,7,14,36.777766689951086,0.6096354166666667,45.40142276422764,1018.3943089430891,25.459857723577226,0
1389,4,0,1,46,0.0,0.02127659574468085,0.9787234042553191,47,1650,1200,450,0.7272727272727273,21,12,9,341.19951395244266,0.432836108541474,0.23819100264895976,0.19227331908027703,129832.53146455371,-540.2406738157918,129292.29079073793,875,2,255.04255319148936,41,6,14,36.519983614004374,0.610010162601626,45.213293650793666,1019.1468253968278,24.857239643825068,0
1390,4,0,0,46,0.0,0.0,1.0,46,1150,500,650,0.43478260869565216,18,5,13,347.95044745957205,0.4310487117552335,0.23956644499286672,0.19582460525245302,129781.98346757695,-168.46015605315336,129613.5233115238,876,3,261.5217391304348,41,5,14,36.399307921980984,0.6095020325203252,45.26289682539683,1018.9484126984136,24.852400309717403,0
1391,4,1,0,47,0.02127659574468085,0.0,1.0,47,1200,900,300,0.75,15,9,6,340.1478133937251,0.4323350292938637,0.2405477579345534,0.19310091477513974,130120.84297839527,-547.9359567901037,129572.90702160518,877,0,256.93617021276594,44,3,15,36.25442417642254,0.6086647727272727,44.930555555555564,1020.2777777777795,23.188131313131354,0
1392,4,0,0,47,0.0,0.0,1.0,47,1250,900,350,0.72,16,9,7,332.5519046854707,0.4318146777674992,0.18742780489622524,0.18800706690634036,129958.94451530615,-562.2067113882558,129396.7378039179,878,1,257.93617021276594,41,6,16,36.61218135824091,0.6112804878048781,45.089285714285715,1019.6428571428575,24.869337979094084,8
1393,4,0,1,46,0.0,0.02127659574468085,0.9787234042553191,47,2050,1600,450,0.7804878048780488,25,16,9,331.05788288110847,0.43150632130743144,0.1856813869617484,0.18776989573449748,130085.41907793214,-786.8393132716025,129298.57976466054,879,2,258.93617021276594,41,6,16,36.52215225777173,0.6125508130081301,44.96527777777778,1020.1388888888891,24.88143631436315,0
1394,4,0,1,45,0.0,0.021739130434782608,0.9782608695652174,46,1750,1400,350,0.8,21,14,7,340.24703887522537,0.4292673107890499,0.1941371011029729,0.19373249764528155,130236.65229030355,-337.4729410403638,129899.17934926318,880,3,264.6521739130435,40,6,16,36.13454964821454,0.615625,44.81707317073172,1020.7317073170744,25.518292682926862,0
1395,4,0,1,44,0.0,0.022222222222222223,0.9777777777777777,45,1450,1200,250,0.8275862068965517,17,12,5,340.4861136208251,0.4290193602693602,0.1982204993936092,0.19439635246505269,130342.35161675372,-124.04526960067807,130218.30634715303,881,4,268.77777777777777,39,6,17,36.02139226087251,0.6183226495726496,44.71354166666668,1021.1458333333353,26.183226495726547,0
1396,4,0,0,44,0.0,0.0,1.0,44,1350,1100,250,0.8148148148148148,16,11,5,342.2054354995079,0.42745771670190275,0.189712468265967,0.19580048885761786,130426.23325525968,126.51319033530348,130552.74644559498,882,5,265.3863636363636,38,6,18,35.89255830980023,0.6208881578947368,44.631410256410255,1021.4743589743588,26.88090418353576,0
1397,4,0,2,42,0.0,0.045454545454545456,0.9545454545454546,44,1300,800,500,0.6153846153846154,18,8,10,343.34825945060527,0.42752378435517974,0.19013507128762397,0.19737999238364323,130608.41064453125,168.83409288194383,130777.24473741319,883,6,266.3863636363636,39,5,13,35.67896752607087,0.6209935897435898,44.453125,1022.1875,26.209935897435898,0
1398,4,0,0,42,0.0,0.0,1.0,42,1900,1400,500,0.7368421052631579,24,14,10,339.4712954436822,0.4268655632984901,0.17070040884538473,0.196025222109639,130781.15297866902,479.2894842574325,131260.44246292647,884,7,272.9047619047619,38,4,14,35.60337023884129,0.6244517543859649,44.284188034188034,1022.863247863248,26.917453891138106,0
1399,4,0,0,42,0.0,0.0,1.0,42,950,600,350,0.631578947368421,13,6,7,340.7339529785687,0.4258251064653504,0.1702413268502223,0.19731256358093907,130890.4560687413,519.7645006939836,131410.22056943527,885,8,273.9047619047619,38,4,16,35.46060416231643,0.6255482456140351,44.177350427350426,1023.2905982905982,26.92869995501574,0
1400,4,0,1,41,0.0,0.023809523809523808,0.9761904761904762,42,750,300,450,0.4,12,3,9,339.5830789753515,0.4254500580720093,0.162431062390354,0.19697422278700144,130954.69292534729,493.9995659722251,131448.69249131953,886,9,274.9047619047619,39,3,16,35.4251475676776,0.624465811965812,44.114583333333336,1023.5416666666672,26.244658119658133,0
1401,4,0,0,41,0.0,0.0,1.0,41,1100,700,400,0.6363636363636364,15,7,8,341.3668263887922,0.42390752032520324,0.15479826992796286,0.19842072954319573,131034.66932508686,746.1778428819471,131780.8471679688,887,10,276.609756097561,39,2,16,35.2987121443348,0.625267094017094,44.036458333333336,1023.8541666666671,26.25267094017095,0
1402,4,0,1,40,0.0,0.024390243902439025,0.975609756097561,41,1200,700,500,0.5833333333333334,17,7,10,343.86576215180264,0.42416158536585363,0.15879816620673037,0.20098677969621406,131248.05908203125,826.3427734374993,132074.40185546875,888,11,277.609756097561,39,2,17,35.019251296126875,0.6274038461538461,43.828125,1024.6875,26.27403846153846,0
1403,4,0,0,40,0.0,0.0,1.0,40,950,700,250,0.7368421052631579,12,7,5,348.23527845351117,0.4217815170940171,0.15743116395494372,0.20309488137544185,131163.9135437212,1135.1803911900026,132299.0939349112,889,16,285.275,38,2,17,34.99230809345015,0.6282894736842105,43.91025641025641,1024.3589743589741,26.956815114709844,0
1404,4,0,0,40,0.0,0.0,1.0,40,1000,600,400,0.6,14,6,8,348.30424897328544,0.4215678418803419,0.15291970802919752,0.20342495418110876,131218.6392815398,1140.801921250626,132359.44120279042,890,17,286.275,38,2,17,34.935262426138344,0.6288377192982456,43.8568376068376,1024.5726495726485,26.962438146648644,0
1405,4,0,0,40,0.0,0.0,1.0,40,1150,700,450,0.6086956521739131,16,7,9,346.02842083732537,0.42134081196581197,0.14940842280829725,0.2025290202008823,131300.74929003208,1086.7581863174692,132387.50747634954,891,18,287.275,38,2,17,34.91065533896243,0.6296600877192983,43.7767094017094,1024.893162393162,26.970872694556892,0
1406,4,0,0,40,0.0,0.0,1.0,40,900,800,100,0.8888888888888888,10,8,2,348.9628337915568,0.42122061965811963,0.15463734889537317,0.20468504603079316,131382.8849806413,1169.5487709109404,132552.43375155225,892,19,288.275,38,2,18,34.752544462970675,0.6304824561403508,43.69658119658119,1025.2136752136744,26.979307242465115,0
1407,4,0,0,40,0.0,0.0,1.0,40,1300,1000,300,0.7692307692307693,16,10,6,351.81537004437365,0.42136752136752137,0.1545812063756642,0.2068019434816865,131465.04635336762,1250.2847861421492,132715.33113950977,893,20,289.275,38,2,20,34.59648574504287,0.6313048245614035,43.61645299145299,1025.5341880341878,26.987741790373363,0
1408,4,0,1,39,0.0,0.025,0.975,40,650,400,250,0.6153846153846154,9,4,5,354.8319063444815,0.42088675213675214,0.1605982505467045,0.209174388988708,131574.63480029578,1337.3756985535726,132912.01049884935,894,21,290.275,38,2,15,34.40851817140477,0.6324013157894737,43.50961538461538,1025.9615384615377,26.99898785425099,0
1409,4,0,0,39,0.0,0.0,1.0,39,900,500,400,0.5555555555555556,13,5,8,362.6355807302713,0.42094017094017094,0.1679139049248104,0.213339196361695,131496.76462950106,1737.0811211141581,133233.84575061523,895,22,298.1794871794872,37,2,20,34.287025158577435,0.6334459459459459,43.58552631578946,1025.6578947368396,27.720483641536205,0
1410,4,0,1,38,0.0,0.02564102564102564,0.9743589743589743,39,850,700,150,0.8235294117647058,10,7,3,360.5793987624634,0.4206027890238417,0.1719211998147554,0.21259870410966408,131581.12502164117,1689.088589758377,133270.21361139955,896,23,299.1794871794872,37,2,18,34.25454650707136,0.6342905405405406,43.503289473684205,1025.9868421052624,27.72937411095304,0
1411,4,1,1,38,0.02564102564102564,0.02564102564102564,0.9743589743589743,39,1000,800,200,0.8,12,8,4,386.03697683032226,0.4218679712100765,0.1800823290184994,0.21008538633818596,128454.92118415995,2233.105044515297,130688.02622867524,897,0,292.12820512820514,33,6,18,36.78523936170213,0.6111111111111112,46.568627450980394,1013.7254901960785,30.718954248366014,8
1412,4,0,0,38,0.0,0.0,1.0,38,1450,1000,450,0.6896551724137931,19,10,9,394.72105422551203,0.41900782361308675,0.1874160116944501,0.21486205724587354,128464.33280086212,2541.515374706659,131005.84817556878,898,1,299.2631578947368,32,6,18,36.55550712002326,0.6136067708333333,46.55934343434343,1013.7626262626259,31.68008207070706,0
1413,4,0,0,38,0.0,0.0,1.0,38,1000,700,300,0.7,13,7,6,392.9521156347831,0.4190374585111427,0.18806394383930147,0.21468413604680517,128610.25694744803,2507.534511966548,131117.79145941458,899,2,300.2631578947368,33,5,18,36.45078228826871,0.6126893939393939,46.41544117647059,1014.3382352941171,30.73752228163991,0
1414,4,0,0,38,0.0,0.0,1.0,38,950,500,450,0.5263157894736842,14,5,9,394.0401803509591,0.41841512565196776,0.19397288656976275,0.21595279506858325,128734.59314025864,2545.3204596789765,131279.91359993763,900,3,301.2631578947368,33,5,18,36.29581270377973,0.6139520202020202,46.29289215686275,1014.8284313725497,30.75237670825908,0
1415,4,0,0,38,0.0,0.0,1.0,38,950,500,450,0.5263157894736842,14,5,9,393.17390742971344,0.41832622095779987,0.20077419928486506,0.2164938319514975,128921.21006644082,2537.6911824778936,131458.9012489187,901,4,302.2631578947368,33,5,19,36.126739672579525,0.6158459595959596,46.10906862745098,1015.5637254901964,30.774658348187767,0
1416,4,0,0,38,0.0,0.0,1.0,38,1450,1200,250,0.8275862068965517,17,12,5,392.2296849973556,0.41800023707918443,0.19988828801381198,0.21682456986653795,129076.82742214517,2525.5526720491926,131602.38009419438,902,5,303.2631578947368,33,5,20,35.991517928927486,0.6174242424242424,45.95588235294117,1016.176470588234,30.793226381461636,0
1417,4,0,0,38,0.0,0.0,1.0,38,1400,1000,400,0.7142857142857143,18,10,8,390.69426132267813,0.4178224276908487,0.19881226153765796,0.21736415533256162,129329.7877767574,2505.74125354061,131835.529030298,903,6,304.2631578947368,32,6,20,35.771991890102626,0.6223958333333333,45.707070707070706,1017.1717171717165,31.78661616161614,0
1418,4,0,0,38,0.0,0.0,1.0,38,1450,1100,350,0.7586206896551724,18,11,7,390.05079203184886,0.4171260075865339,0.19691965247361276,0.21824979432011088,129554.63927469138,2506.577932098771,132061.21720679014,904,7,305.2631578947368,32,6,18,35.558776716689415,0.6246744791666667,45.486111111111114,1018.0555555555558,31.814236111111118,0
1419,4,0,0,38,0.0,0.0,1.0,38,1000,800,200,0.8,12,8,4,393.1552314441984,0.4169926505452821,0.19736026769116344,0.22107104965318722,129747.52456700846,2602.1836100908026,132349.70817709927,905,8,306.2631578947368,32,6,19,35.2829243607221,0.6266276041666667,45.29671717171717,1018.8131313131312,31.83791035353535,0
1420,4,0,0,38,0.0,0.0,1.0,38,900,600,300,0.6666666666666666,12,6,6,393.45128434363085,0.41671111901375063,0.1972950771577775,0.22196591324291626,129876.19447314051,2619.991104224061,132496.18557736458,906,9,307.2631578947368,32,6,19,35.1441533506751,0.6279296875,45.17045454545455,1019.318181818182,31.853693181818187,0
1421,4,0,0,38,0.0,0.0,1.0,38,850,600,250,0.7058823529411765,11,6,5,394.8725282519719,0.4168741109530583,0.19995111618054406,0.22313475616757694,129940.55333958272,2661.9909639322514,132602.54430351497,907,10,308.2631578947368,32,6,19,35.042311661506695,0.6285807291666667,45.10732323232323,1019.5707070707073,31.861584595959602,0
1422,4,1,0,39,0.02564102564102564,0.0,1.0,39,1150,700,450,0.6086956521739131,16,7,9,386.17762144579285,0.4218679712100765,0.2100300260310155,0.22039650138547104,130327.04132550243,2266.275922099777,132593.31724760222,908,0,301.3333333333333,32,7,20,34.8705226495198,0.6324869791666667,44.72853535353535,1021.085858585858,31.908933080808062,0
1423,4,0,0,39,0.0,0.0,1.0,39,1200,900,300,0.75,15,9,6,384.52667075132797,0.42214912280701755,0.20974295584925984,0.22000146862646705,130423.75299714321,2230.28230537701,132654.0353025202,909,1,302.3333333333333,32,7,21,34.81432838895756,0.6334635416666667,44.63383838383839,1021.464646464647,31.92077020202022,0
1424,4,0,0,39,0.0,0.0,1.0,39,1000,500,500,0.5,15,5,10,382.52903024966787,0.42217723796671164,0.20736748855750853,0.21900837885722726,130450.30757400986,2180.205930411368,132630.51350442122,910,2,303.3333333333333,33,6,21,34.838351727447225,0.6313131313131313,44.607843137254896,1021.5686274509793,30.9566250742721,0
1425,4,0,0,39,0.0,0.0,1.0,39,1050,700,350,0.6666666666666666,14,7,7,383.8001815365328,0.4219242015294647,0.20937864262801353,0.21991354731753082,130481.60750973182,2215.77292988274,132697.38043961456,911,3,304.3333333333333,33,6,21,34.77407440726082,0.6316287878787878,44.57720588235294,1021.6911764705881,30.96033868092691,0
1426,4,0,0,39,0.0,0.0,1.0,39,1100,900,200,0.8181818181818182,13,9,4,387.44870245090834,0.42167116509221775,0.21323766749974626,0.22272292399331695,130606.8447982748,2320.690509659757,132927.53530793457,912,4,305.3333333333333,33,6,17,34.55358570115493,0.6328914141414141,44.454656862745104,1022.1813725490205,30.975193107546076,0
1427,4,0,0,39,0.0,0.0,1.0,39,1300,800,500,0.6153846153846154,18,8,10,386.4219666516214,0.42141812865497075,0.2144578017061236,0.22267298962300647,130700.81218762032,2301.132977700907,133001.94516532123,913,5,306.3333333333333,33,6,18,34.48436001917547,0.6338383838383839,44.36274509803923,1022.5490196078446,30.98633392751044,0
1428,4,0,1,38,0.0,0.02564102564102564,0.9743589743589743,39,1200,1000,200,0.8333333333333334,14,10,4,385.79863280710504,0.4213618983355825,0.21742950714913323,0.22267464657040806,130763.47588667825,2289.6740436370683,133053.14993031533,914,6,307.3333333333333,33,6,18,34.43665628245068,0.634469696969697,44.3014705882353,1022.7941176470592,30.993761140819977,0
1429,4,0,0,38,0.0,0.0,1.0,38,1050,700,350,0.6666666666666666,14,7,7,382.86676147921276,0.42225284495021337,0.21584791714016682,0.22181094365897208,130907.84940631059,2424.0528708805236,133331.9022771911,915,7,312.94736842105266,32,6,19,34.365103845362945,0.6383463541666667,44.160353535353536,1023.3585858585859,31.97995580808081,0
1430,4,0,0,38,0.0,0.0,1.0,38,800,500,300,0.625,11,5,6,381.2593791039998,0.4223862019914652,0.21545443920682517,0.22106498762639676,130940.15438475684,2384.432392102867,133324.5867768597,916,8,313.94736842105266,32,6,19,34.37345793239575,0.638671875,44.12878787878789,1023.4848484848499,31.983901515151558,0
1431,4,2,0,40,0.05,0.0,1.0,40,1100,800,300,0.7272727272727273,14,8,6,363.08730950188317,0.4277110042735042,0.20757487810540987,0.21334475334578606,131450.17715419506,1545.5782312925273,132995.75538548757,917,0,299.2,34,6,21,34.322517606996364,0.639093137254902,43.63095238095239,1025.476190476191,30.161064425770324,0
1432,4,1,2,39,0.024390243902439025,0.04878048780487805,0.9512195121951219,41,1350,1000,350,0.7407407407407407,17,10,7,354.182889806323,0.4283536585365854,0.20718738050224483,0.21045616533703423,131876.9799148813,1141.7139690366257,133018.6938839179,918,0,292.8780487804878,36,5,16,34.120207945035276,0.6391782407407407,43.2150900900901,1027.139639639641,28.531656656656693,0
1433,4,0,0,39,0.0,0.0,1.0,39,1250,1000,250,0.8,15,10,5,373.02260076946544,0.4225708502024292,0.2145528215837995,0.220060355649009,131602.8220663265,2018.1653911564563,133620.98745748296,919,1,308.84615384615387,34,5,17,33.91344703561899,0.640625,43.482142857142854,1026.0714285714282,30.178571428571416,0
1434,4,0,0,39,0.0,0.0,1.0,39,700,600,100,0.8571428571428571,8,6,2,371.41007209671864,0.4225708502024292,0.21021766099018846,0.21940660288351796,131654.57182623888,1979.566802769203,133634.13862900808,920,2,309.84615384615387,35,4,18,33.902508364347206,0.6389880952380953,43.43171296296296,1026.2731481481483,29.32208994708995,0
1435,4,0,0,39,0.0,0.0,1.0,39,1150,900,250,0.782608695652174,14,9,5,369.47902355581977,0.42288011695906436,0.21134981829535926,0.21860636823993085,131713.96933138277,1933.1097554440928,133647.07908682685,921,3,310.84615384615387,35,4,18,33.89204438681551,0.6395833333333334,43.37384259259259,1026.5046296296289,29.32870370370368,0
1436,4,0,0,39,0.0,0.0,1.0,39,850,600,250,0.7058823529411765,11,6,5,370.11840790963254,0.42271142600089967,0.2094513173066086,0.21966960758409165,131832.80452942822,1958.7495445387588,133791.55407396698,922,4,311.84615384615387,35,4,18,33.75561159322289,0.6407738095238096,43.258101851851855,1026.967592592593,29.34193121693123,0
1437,4,0,0,39,0.0,0.0,1.0,39,1000,700,300,0.7,13,7,6,371.1222298271183,0.4226833108412056,0.21409202353002343,0.22130250360208076,132011.157795889,1998.4550486539779,134009.61284454298,923,5,312.84615384615387,35,4,19,33.549785073394155,0.6425595238095239,43.08449074074074,1027.6620370370367,29.361772486772477,0
1438,4,0,0,39,0.0,0.0,1.0,39,1250,900,350,0.72,16,9,7,371.60018983123837,0.4224302744039586,0.21210362658397797,0.22193552695973304,132070.63567654754,2015.4946577074834,134086.13033425502,924,6,313.84615384615387,35,4,19,33.47748470517585,0.643154761904762,43.026620370370374,1027.893518518519,29.368386243386254,0
1439,4,0,0,39,0.0,0.0,1.0,39,650,200,450,0.3076923076923077,11,2,9,373.7962784702389,0.4219804318488529,0.21464327161242225,0.22342251314755468,132100.3796403464,2075.7260588134404,134176.10569915985,925,7,314.84615384615387,35,4,19,33.391034301583716,0.6434523809523809,42.99768518518518,1028.0092592592594,29.371693121693124,0
1440,4,0,0,39,0.0,0.0,1.0,39,1200,800,400,0.6666666666666666,16,8,8,370.1967672139248,0.4212494376968061,0.20836210720160775,0.22216670642128722,132253.17166829004,1991.9393210778508,134245.11098936788,926,8,315.84615384615387,36,3,20,33.32945587913291,0.6429398148148149,42.84909909909911,1028.6036036036048,28.572322322322357,0
1441,4,0,1,38,0.0,0.02564102564102564,0.9743589743589743,39,1200,700,500,0.5833333333333334,17,7,10,369.0980884728952,0.4211088618983356,0.20687681426059945,0.22274291009026756,132462.98408644527,1978.683883957483,134441.66797040275,927,9,316.84615384615387,32,7,20,33.14628562083486,0.6539713541666667,42.64520202020202,1029.419191919192,32.16934974747475,0
1442,4,0,0,38,0.0,0.0,1.0,38,1050,800,250,0.7619047619047619,13,8,5,365.1830619815141,0.41976351351351354,0.14684350194371376,0.2048831025161795,129659.75265806346,1869.9090982874736,131529.66175635092,928,10,321.6842105263158,36,2,14,36.08469703670943,0.6168981481481481,45.38288288288288,1018.4684684684684,28.290790790790787,8
1443,4,0,0,38,0.0,0.0,1.0,38,1550,1100,450,0.7096774193548387,20,11,9,366.7944201947438,0.42023767188240874,0.14112241930793834,0.20669299519068682,129831.84831791246,1924.3195053161244,131756.16782322858,929,11,322.6842105263158,36,2,15,35.86855432780847,0.6186342592592593,45.21396396396396,1019.1441441441439,28.309559559559553,0
1444,4,1,1,38,0.02564102564102564,0.02564102564102564,0.9743589743589743,39,950,800,150,0.8421052631578947,11,8,3,360.48903530628303,0.42276765632028795,0.14732776267105296,0.20495244053729836,130178.65022170272,1585.5952071791212,131764.24542888184,930,0,315.38461538461536,37,2,18,35.67688746821389,0.6202139639639639,44.873903508771924,1020.5043859649113,27.581199620673278,0
1445,4,1,0,39,0.02564102564102564,0.0,1.0,39,900,600,300,0.6666666666666666,12,6,6,358.6506456013396,0.42054655870445345,0.15163094644736108,0.20500648014002504,130387.71896626301,1552.8361235184464,131940.55508978147,931,0,316.05128205128204,33,6,20,35.51165906727463,0.6306818181818181,44.669117647058826,1021.3235294117651,30.949197860962578,0
1446,4,0,0,39,0.0,0.0,1.0,39,900,600,300,0.6666666666666666,12,6,6,357.34099563648704,0.4208277103013945,0.14934605075614282,0.20455924506715767,130444.94224773235,1522.6651077097415,131967.6073554421,932,1,317.05128205128204,34,5,20,35.48707415608126,0.6289828431372548,44.613095238095234,1021.5476190476185,30.045518207282896,0
1447,4,0,1,38,0.0,0.02564102564102564,0.9743589743589743,39,1300,900,400,0.6923076923076923,17,9,8,353.8467262693423,0.4204059829059829,0.14432474955513608,0.2036174679568143,130646.86381440745,1445.793011616927,132092.65682602438,933,2,318.05128205128204,35,4,16,35.371735725876455,0.6288690476190476,44.41550925925925,1022.3379629629619,29.209656084656054,0
1448,4,0,0,38,0.0,0.0,1.0,38,1200,800,400,0.6666666666666666,16,8,8,361.2984759299012,0.41983760075865334,0.14742910029236356,0.20780107252579116,130627.42524092972,1839.0979308390038,132466.52317176873,934,4,327.36842105263156,34,4,16,35.20098210473196,0.6308210784313726,44.43452380952381,1022.2619047619048,30.06652661064426,0
1449,4,1,0,39,0.02564102564102564,0.0,1.0,39,900,600,300,0.6666666666666666,12,6,6,352.0504044948844,0.42276765632028795,0.14955428346063937,0.20398621733576472,130913.23329260977,1417.6113468792933,132330.84463948908,935,0,319.94871794871796,35,4,17,35.148062278519184,0.631547619047619,44.155092592592595,1023.37962962963,29.239417989418,0
1450,4,0,0,39,0.0,0.0,1.0,39,1550,1400,150,0.9032258064516129,17,14,3,349.1664676357303,0.4218117408906883,0.145881105291511,0.20282890461830197,131010.89000740618,1348.921937139854,132359.81194454603,936,1,320.94871794871796,36,3,19,35.1231071022623,0.6304976851851851,44.05968468468469,1023.7612612612623,28.437812812812844,0
1451,4,0,0,39,0.0,0.0,1.0,39,1050,600,450,0.5714285714285714,15,6,9,349.7125470412414,0.4213618983355825,0.14403410532726602,0.20360345088303802,131097.3705969485,1369.2790763736966,132466.6496733222,937,2,321.94871794871796,36,3,19,35.02171761601057,0.6313657407407407,43.97522522522524,1024.0990990991006,28.44719719719724,0
1452,4,0,0,39,0.0,0.0,1.0,39,1150,800,350,0.6956521739130435,15,8,7,348.19005003044566,0.42130566801619435,0.1419797453654772,0.20317414272783632,131183.8797200919,1335.3843285853677,132519.2640486773,938,3,322.94871794871796,36,3,20,34.97329705763807,0.6322337962962963,43.89076576576578,1024.4369369369385,28.456581581581627,0
1453,4,0,0,39,0.0,0.0,1.0,39,1100,500,600,0.45454545454545453,17,5,12,347.53731791846485,0.4212494376968061,0.137820512820513,0.20296179366438377,131215.75869498326,1320.4745690982063,132536.23326408147,939,4,323.94871794871796,37,2,20,34.95781606735161,0.6306306306306306,43.85964912280703,1024.5614035087733,27.69084874348036,0
1454,4,0,0,39,0.0,0.0,1.0,39,1300,1000,300,0.7692307692307693,16,10,6,347.60674017392927,0.4199561403508772,0.13023360794492733,0.20438907263976044,131476.4596863213,1340.516895675303,132816.9765819966,940,5,324.94871794871796,35,4,23,34.69287232441788,0.637202380952381,43.60532407407408,1025.5787037037048,29.30224867724871,0
1455,4,0,0,39,0.0,0.0,1.0,39,950,700,250,0.7368421052631579,12,7,5,348.5074091933948,0.4197312190733244,0.12440988614273807,0.20539691988632008,131565.5006858712,1370.310356652965,132935.81104252418,941,6,325.94871794871796,35,4,16,34.57994885679903,0.638095238095238,43.518518518518526,1025.925925925927,29.312169312169342,0
1456,4,0,0,39,0.0,0.0,1.0,39,1250,800,450,0.64,17,8,9,349.72145572588636,0.4181286549707602,0.11839389471858452,0.20707805823021455,131743.67310742466,1414.7178283607777,133158.39093578543,942,7,326.94871794871796,35,4,16,34.36912814731304,0.6398809523809523,43.34490740740741,1026.6203703703711,29.332010582010604,0
1457,4,0,0,39,0.0,0.0,1.0,39,950,600,350,0.631578947368421,13,6,7,364.321832983017,0.4180443094916779,0.08224003687303494,0.21307583548556172,131271.93583602645,1765.046456602029,133036.98229262847,943,8,327.94871794871796,37,2,21,34.47107496968398,0.6311936936936937,43.80482456140351,1024.7807017543857,27.696775723091505,8
1458,4,0,1,38,0.0,0.02564102564102564,0.9743589743589743,39,900,700,200,0.7777777777777778,11,7,4,362.80664380748397,0.417538236617184,0.08109719737626753,0.21283054641368837,131387.4488275892,1733.6719153733052,133121.1207429625,944,9,328.94871794871796,35,4,21,34.393109806577876,0.6363095238095238,43.69212962962963,1025.2314814814818,29.29232804232805,0
1459,4,0,1,37,0.0,0.02631578947368421,0.9736842105263158,38,1200,800,400,0.6666666666666666,16,8,8,363.1411920987804,0.4167259364627786,0.07646757022531969,0.2138884246285162,131541.75347222228,1953.645833333344,133495.39930555562,945,10,322.8157894736842,34,4,21,34.228608177633355,0.6400122549019608,43.54166666666667,1025.833333333334,30.171568627451,0
1460,4,0,0,37,0.0,0.0,1.0,37,550,200,350,0.36363636363636365,9,2,7,359.48073061622205,0.4139139139139139,0.10083401266695957,0.21224136287067358,131633.36167800458,2063.9314058956998,133697.2930839003,946,16,332.27027027027026,34,3,19,34.229988399071935,0.6409313725490196,43.452380952380956,1026.1904761904766,30.182072829131666,0
1461,4,0,0,37,0.0,0.0,1.0,37,950,600,350,0.631578947368421,13,6,7,360.58903108462533,0.41341341341341337,0.10840156809707135,0.1901226422140654,127182.05959467124,1774.305555555562,128956.3651502268,947,17,333.27027027027026,34,3,20,38.734312915535625,0.5958946078431373,47.827380952380956,1008.6904761904766,29.667366946778724,8
1462,4,5,1,41,0.11904761904761904,0.023809523809523808,0.9761904761904762,42,1350,800,550,0.5925925925925926,19,8,11,328.8189629732125,0.42440960123886956,0.14993402270822997,0.17925449612744151,128523.41666894936,55.81543528542733,128579.23210423479,948,0,294.4761904761905,38,4,18,38.16554279492852,0.6016995614035088,46.50106837606837,1013.9957264957252,26.684098065676977,0
1463,4,1,0,42,0.023809523809523808,0.0,1.0,42,1350,1100,250,0.8148148148148148,16,11,5,322.5834224580233,0.42561943476577624,0.14753088275074466,0.17766384784970835,128929.98598327112,-81.86477281029491,128848.12121046083,949,0,290.64285714285717,38,4,21,37.91004803983451,0.6058114035087719,46.100427350427346,1015.5982905982896,26.72627080521815,0
1464,4,1,0,43,0.023255813953488372,0.0,1.0,43,1150,700,450,0.6086956521739131,16,7,9,322.9206355581814,0.42619509043927645,0.17048246537701717,0.1795810440909882,129312.8895429359,-247.86919087433262,129065.02035206156,950,0,284.86046511627904,37,6,22,37.51257726031335,0.6114864864864865,45.723684210526294,1017.1052631578916,27.489331436699775,0
1465,4,0,0,43,0.0,0.0,1.0,43,1050,400,650,0.38095238095238093,17,4,13,318.9700380708893,0.4252491694352159,0.1687145326860906,0.1778612788399967,129418.71667031899,-343.8614033165612,129074.85526700242,951,1,285.86046511627904,38,5,23,37.505687386252255,0.6107456140350878,45.619658119658105,1017.5213675213655,26.776878092667513,0
1466,4,1,0,44,0.022727272727272728,0.0,1.0,44,1650,1200,450,0.7272727272727273,21,12,9,312.99524394735596,0.4270502995066949,0.17206950325031545,0.1762157951184804,129796.16057117115,-674.8838117192272,129121.27675945192,952,0,280.34090909090907,40,4,13,37.27539809181875,0.6111979166666667,45.24898373983739,1019.0040650406495,25.475101626016237,0
1467,4,0,0,44,0.0,0.0,1.0,44,950,600,350,0.631578947368421,13,6,7,312.7445181901954,0.42736962649753346,0.17526058189069227,0.17642449479458133,129873.84018276141,-676.5336853063797,129197.30649745504,953,1,281.34090909090907,40,4,14,37.203182120305755,0.6119791666666667,45.17276422764227,1019.3089430894295,25.48272357723574,0
1468,4,0,0,44,0.0,0.0,1.0,44,1300,1000,300,0.7692307692307693,16,10,6,312.7445181901954,0.4276669309372798,0.17526058189069227,0.17642449479458133,129873.84018276141,-676.5336853063797,129197.30649745504,954,2,282.34090909090907,40,4,14,37.203182120305755,0.6119791666666667,45.17276422764227,1019.3089430894295,25.48272357723574,0
1469,4,1,3,42,0.022222222222222223,0.06666666666666667,0.9333333333333333,45,1850,1300,550,0.7027027027027027,24,13,11,322.3075698049638,0.42809343434343433,0.1453354656918746,0.17481291611354724,128320.37278163571,-727.6935570528706,127592.67922458284,955,0,277.0444444444444,41,4,19,38.537382910669415,0.5947662601626016,46.701388888888886,1013.1944444444438,24.71205962059619,8
1470,4,0,0,42,0.0,0.0,1.0,42,1100,600,500,0.5454545454545454,16,6,10,340.6737955835379,0.4229094076655053,0.1507553910386088,0.18325710332929723,127990.23321311738,320.5837092669911,128310.81692238437,956,1,297.3333333333333,40,2,19,38.409326771785366,0.59296875,47.027439024390254,1011.8902439024405,25.29725609756101,0
1471,4,2,2,42,0.045454545454545456,0.045454545454545456,0.9545454545454546,44,1450,1200,250,0.8275862068965517,17,12,5,327.34173603686196,0.42819547216349546,0.14956383098885295,0.17829133701997316,128488.14791967125,-388.09331996274466,128100.0545997085,957,0,284.77272727272725,42,2,16,38.23891331358119,0.5949900793650793,46.53585271317829,1013.8565891472864,24.139442598744914,0
1472,4,0,0,42,0.0,0.0,1.0,42,1000,600,400,0.6,14,6,8,337.44481500837935,0.42410714285714285,0.15514045923314623,0.18292481570519517,128298.92223750765,258.7612160420608,128557.6834535497,958,1,299.14285714285717,40,2,20,38.17584511987161,0.59609375,46.72256097560977,1013.1097560975628,25.32774390243907,0
1473,4,1,1,42,0.023255813953488372,0.023255813953488372,0.9767441860465116,43,1250,800,450,0.64,17,8,9,328.16475870873205,0.4273717238833518,0.15231955303704137,0.1791152337575746,128571.78411005627,-161.454298154426,128410.32981190184,959,0,293.16279069767444,41,2,18,38.13286624930712,0.5973069105691057,46.45337301587303,1014.1865079365095,24.736256291134378,0
1474,4,1,0,43,0.023255813953488372,0.0,1.0,43,1450,900,550,0.6206896551724138,20,9,11,324.7075490938752,0.42891749723145073,0.1466314574826908,0.1787255837449485,128906.0152635061,-228.64874406583084,128677.36651944027,960,0,289.16279069767444,42,1,19,37.880486641221374,0.5992063492063492,46.12403100775195,1015.5038759689947,24.178663713547493,0
1475,4,0,0,43,0.0,0.0,1.0,43,1300,1100,200,0.8461538461538461,15,11,4,329.3090081233254,0.42861757105943155,0.14471270207134856,0.18159633520025395,128979.82698042523,-105.15622183158564,128874.67075859365,961,1,290.16279069767444,42,1,19,37.688599001558075,0.5999503968253967,46.051356589147304,1015.7945736434139,24.18558508674795,0
1476,4,0,1,42,0.0,0.023255813953488372,0.9767441860465116,43,1200,900,300,0.75,15,9,6,329.04729526180074,0.42834071613141383,0.14101179533464459,0.1819040055566953,129078.27546609302,-105.42851616487258,128972.84694992815,962,2,291.16279069767444,42,1,20,37.59515749658308,0.6009424603174602,45.954457364341096,1016.1821705426376,24.194813584348513,0
1477,4,0,2,40,0.0,0.047619047619047616,0.9523809523809523,42,1700,1300,400,0.7647058823529411,21,13,8,331.5640956732059,0.4260912698412698,0.1313427010148316,0.18386736214605065,129201.38888888896,167.76701745688905,129369.15590634586,963,3,298.85714285714283,40,2,20,37.40607923497268,0.6052083333333333,45.833333333333336,1016.6666666666673,25.416666666666682,0
1478,4,1,0,41,0.024390243902439025,0.0,1.0,41,550,400,150,0.7272727272727273,7,4,3,336.0889378590109,0.43109756097560975,0.12253330768481252,0.1867522083276907,129280.82817925356,489.9712456597278,129770.79942491329,963,0,279.4878048780488,39,2,21,37.210322134589774,0.6076388888888888,45.755208333333336,1016.9791666666673,26.076388888888907,0
1479,4,0,1,40,0.0,0.024390243902439025,0.975609756097561,41,1300,900,400,0.6923076923076923,17,9,8,337.16105010953044,0.43041158536585367,0.13221159847217745,0.1882321976897208,129466.28146701396,530.1974826388997,129996.47894965287,964,1,280.4878048780488,39,2,15,36.99462640736951,0.6095085470085471,45.57291666666667,1017.7083333333339,26.095085470085486,0
1480,4,0,0,40,0.0,0.0,1.0,40,1350,900,450,0.6666666666666666,18,9,9,339.172513354754,0.4280582264957265,0.1339048106448315,0.18935516888433992,129466.28146701396,782.2808159722329,130248.5622829862,965,2,287.075,39,1,15,36.943449334698066,0.6095085470085471,45.57291666666667,1017.7083333333339,26.095085470085486,0
1481,4,0,0,40,0.0,0.0,1.0,40,1050,800,250,0.7619047619047619,13,8,5,341.6382676722416,0.428258547008547,0.13159846547314547,0.19137616426912113,129598.82948133688,855.1839192708385,130454.01340060773,966,3,288.075,39,1,15,36.746057118499564,0.610844017094017,45.442708333333336,1018.2291666666673,26.108440170940188,0
1482,4,0,1,39,0.0,0.025,0.975,40,1650,1300,350,0.7878787878787878,20,13,7,343.77224784794964,0.4281784188034188,0.13116501380226975,0.19335459207595151,129757.97661675354,921.4382595486163,130679.41487630215,967,4,289.075,39,1,16,36.530113655727085,0.6124465811965811,45.286458333333336,1018.8541666666672,26.124465811965827,0
1483,4,0,0,39,0.0,0.0,1.0,39,700,400,300,0.5714285714285714,10,4,6,348.0920789204892,0.4283625730994152,0.12323506156105313,0.19544816728079756,129690.63321827742,1228.8564266929645,130919.48964497038,968,5,277.79487179487177,38,1,16,36.48848856723308,0.6134868421052632,45.3525641025641,1018.5897435897433,26.804993252361665,0
1484,4,0,2,37,0.0,0.05128205128205128,0.9487179487179487,39,1750,1400,350,0.8,21,14,7,347.4970158687485,0.4284750337381917,0.12709520853321266,0.19606558417526496,129881.14458917745,1226.662032471325,131107.80662164878,969,6,278.79487179487177,38,1,17,36.31017887712678,0.6154057017543859,45.16559829059829,1019.3376068376069,26.824673864147552,0
1485,4,0,0,37,0.0,0.0,1.0,37,1150,800,350,0.6956521739130435,15,8,7,355.9530932973138,0.424486986986987,0.1313073728054357,0.20021284158103145,129759.37307633119,1837.6500461680534,131597.02312249923,970,7,288.9189189189189,37,0,17,36.21843162577128,0.615990990990991,45.28508771929825,1018.8596491228071,27.53674727358938,0
1486,4,1,1,37,0.02631578947368421,0.02631578947368421,0.9736842105263158,38,1150,800,350,0.6956521739130435,15,8,7,348.8091128299516,0.4268610715979137,0.13436266619628223,0.1977689672981222,130071.7957849369,1474.045538388498,131545.84132332538,971,0,282.2894736842105,38,0,19,36.083254782851554,0.6173245614035088,44.978632478632484,1020.0854700854708,26.844354475933443,0
1487,4,0,0,37,0.0,0.0,1.0,37,800,400,400,0.5,12,4,8,356.12202004221,0.4227665165165165,0.13871878115345138,0.2013117729101832,129954.95158366051,1855.9639744921674,131810.9155581527,972,1,290.56756756756755,37,0,19,36.015409363013944,0.6179617117117118,45.09320175438597,1019.6271929824574,27.557491702228578,0
1488,4,0,0,37,0.0,0.0,1.0,37,900,700,200,0.7777777777777778,11,7,4,360.5485968708199,0.4219844844844845,0.14219185325280104,0.2043987566538233,130066.77685682144,1979.078779047408,132045.85563586885,973,2,291.56756756756755,37,0,19,35.788970403812385,0.6190878378378378,44.98355263157895,1020.0657894736851,27.56934566145095,0
1489,4,0,1,36,0.0,0.02702702702702703,0.972972972972973,37,1400,800,600,0.5714285714285714,20,8,12,358.6838817159513,0.4218280780780781,0.14009928295642537,0.2043663977218794,130262.58680555568,1944.6180555555648,132207.20486111124,974,3,292.56756756756755,37,0,20,35.63775510204081,0.6210585585585586,44.79166666666667,1020.8333333333344,27.59009009009012,0
1490,4,1,0,37,0.02702702702702703,0.0,1.0,37,1100,600,500,0.5454545454545454,16,6,10,365.26524460197663,0.4243305805805806,0.11716202743121973,0.20240941455015643,129172.76810171679,2040.8048250953898,131213.5729268122,975,0,286.35135135135135,36,1,18,36.57868985635687,0.6119791666666667,45.8614864864865,1016.5540540540558,28.23761261261266,8
1491,4,1,0,38,0.02631578947368421,0.0,1.0,38,950,700,250,0.7368421052631579,12,7,5,356.97967473767994,0.42834281650071127,0.11672429248303251,0.1999882415723733,129602.41280131499,1653.0886038065305,131255.50140512153,976,0,279.7894736842105,36,2,17,36.35188564476889,0.6163194444444444,45.4391891891892,1018.2432432432445,28.28453453453457,0
1492,4,1,2,37,0.02564102564102564,0.05128205128205128,0.9487179487179487,39,1000,800,200,0.8,12,8,4,348.7126536989656,0.4325798470535313,0.05572550829160461,0.18978907548960636,128458.27880245114,1263.1245688255865,129721.40337127673,977,0,273.5897435897436,36,3,16,37.727727171739616,0.6047453703703703,46.56531531531532,1013.7387387387391,28.15940940940942,8
1493,4,1,0,38,0.02631578947368421,0.0,1.0,38,950,700,250,0.7368421052631579,12,7,5,354.63553877607734,0.42828354670459934,0.09833826610555163,0.1941967375671374,128701.77636584787,1528.4447605881326,130230.221126436,978,0,281.6842105263158,35,3,17,37.329022660735355,0.6092261904761904,46.32523148148148,1014.6990740740737,28.991402116402107,0
1494,4,0,1,37,0.0,0.02631578947368421,0.9736842105263158,38,1450,800,650,0.5517241379310345,21,8,13,355.57052198005806,0.4283131816026553,0.10312068655104101,0.19514101863361139,128789.87295310362,1558.7764703360858,130348.64942343971,979,1,282.6842105263158,35,3,17,37.21541239072596,0.6101190476190477,46.23842592592593,1015.0462962962968,29.001322751322764,0
1495,4,0,0,37,0.0,0.0,1.0,37,900,500,400,0.5555555555555556,13,5,8,360.9778757713254,0.42761511511511513,0.10979412808681133,0.19835176060424364,128838.54875283442,1901.5731292516984,130740.12188208612,980,2,285.64864864864865,34,3,18,37.02851391494685,0.6127450980392157,46.19047619047619,1015.238095238095,29.85994397759103,0
1496,4,1,0,38,0.02631578947368421,0.0,1.0,38,950,700,250,0.7368421052631579,12,7,5,354.9126717669237,0.4292614983404457,0.12496928875758884,0.1966686432888887,129171.97312510696,1568.9540198473787,130740.92714495434,981,0,279.10526315789474,35,3,19,36.84259839083079,0.6139880952380952,45.86226851851851,1016.5509259259243,29.04431216931212,0
1497,4,3,1,40,0.07317073170731707,0.024390243902439025,0.975609756097561,41,1200,1000,200,0.8333333333333334,14,10,4,334.45346282807265,0.43600101626016263,0.13940729084710202,0.1891981267823037,129982.9033933517,494.6497786504226,130477.55317200212,982,0,259.609756097561,37,4,21,36.539426523297486,0.6182432432432432,45.065789473684205,1019.7368421052624,27.56045519203412,0
1498,4,0,0,40,0.0,0.0,1.0,40,1450,900,550,0.6206896551724138,20,9,11,340.35743633645075,0.4346153846153846,0.14313714664310995,0.19264230896643122,130004.05811216628,849.5695864783802,130853.62769864466,983,1,267.1,36,4,21,36.36746356007068,0.6203703703703703,45.04504504504505,1019.8198198198203,28.32832832832834,0
1499,4,0,0,40,0.0,0.0,1.0,40,900,500,400,0.5555555555555556,13,5,8,345.8245008747178,0.4337873931623932,0.14773178807947018,0.19631390839128743,130118.92804967145,999.6626694262033,131118.59071909764,984,2,268.1,36,4,21,36.1115710080942,0.6215277777777778,44.93243243243244,1020.2702702702716,28.340840840840876,0
1500,4,0,1,39,0.0,0.025,0.975,40,1250,1000,250,0.8,15,10,5,346.41624625627503,0.43314636752136754,0.14775687010263772,0.19679483431524222,130147.65346004812,1017.052314138492,131164.70577418662,985,3,269.1,36,4,21,36.06734907846817,0.6218171296296297,44.904279279279294,1020.3828828828848,28.343968968969023,0
1501,4,0,0,39,0.0,0.0,1.0,39,950,700,250,0.7368421052631579,12,7,5,354.5297940549119,0.4318488529014845,0.15789917456773117,0.20184623975276103,130233.05047850228,1434.299313057276,131667.34979155957,986,4,275.56410256410254,35,4,21,35.77373190459991,0.624702380952381,44.820601851851855,1020.717592592593,29.1633597883598,0
1502,4,0,0,39,0.0,0.0,1.0,39,1000,700,300,0.7,13,7,6,354.21404904944814,0.43100539811066124,0.15710068112606645,0.20243424668473647,130380.7656035666,1436.5397805212729,131817.30538408787,987,5,276.56410256410254,35,4,21,35.63198851616803,0.6261904761904762,44.67592592592593,1021.2962962962969,29.179894179894195,0
1503,4,0,1,38,0.0,0.02564102564102564,0.9743589743589743,39,1300,900,400,0.6923076923076923,17,9,8,353.8443339358758,0.43013382816014395,0.15687299747569372,0.20268552470162096,130469.4348663625,1433.1740558556457,131902.60892221815,988,6,277.56410256410254,35,4,21,35.55155111211811,0.6270833333333333,44.58912037037038,1021.6435185185201,29.18981481481486,0
1504,4,0,0,38,0.0,0.0,1.0,38,1200,700,500,0.5833333333333334,17,7,10,354.5891075662579,0.43040244191559984,0.16673026017694892,0.20326705464902123,130498.99798525387,1654.704646776418,132153.7026320303,989,7,284.7894736842105,35,3,16,35.50256758797766,0.6273809523809524,44.56018518518519,1021.75925925926,29.193121693121714,0
1505,4,0,0,38,0.0,0.0,1.0,38,1500,1100,400,0.7333333333333333,19,11,8,354.81155482041595,0.4300764580369843,0.1688358123569793,0.20401664402173916,130617.28395061726,1668.9043209876513,132286.18827160491,990,8,285.7894736842105,35,3,17,35.37703804347827,0.6285714285714286,44.44444444444444,1022.2222222222221,29.206349206349202,0
1506,4,0,0,38,0.0,0.0,1.0,38,850,800,50,0.9411764705882353,9,8,1,353.1822973422238,0.4300023707918445,0.16839662271267408,0.20323512914813452,130646.86381440761,1628.4319005058317,132275.29571491343,991,9,286.7894736842105,35,3,17,35.38871749877354,0.6288690476190476,44.41550925925926,1022.3379629629633,29.209656084656093,0
1507,4,0,0,38,0.0,0.0,1.0,38,750,600,150,0.8,9,6,3,354.2118072719571,0.4295282124229493,0.168999362727289,0.204452628403807,130765.2167593664,1663.7167513288773,132428.9335106953,992,10,287.7894736842105,35,3,17,35.24256440722719,0.6300595238095238,44.29976851851852,1022.8009259259259,29.222883597883595,0
1508,4,1,0,39,0.02564102564102564,0.0,1.0,39,1400,1100,300,0.7857142857142857,17,11,6,349.9199199547639,0.430921052631579,0.1781284531944165,0.2040302302505469,131155.04017531042,1378.7522319616933,132533.79240727212,993,0,281.38461538461536,36,3,18,34.9581317795368,0.6319444444444444,43.91891891891892,1024.3243243243242,28.45345345345345,0
1509,4,0,0,39,0.0,0.0,1.0,39,950,600,350,0.631578947368421,13,6,7,351.877067986958,0.43080859199280247,0.17785291631445488,0.20578928783298953,131270.4173768363,1438.2099159970744,132708.62729283338,994,1,282.38461538461536,36,3,18,34.79143772893773,0.6331018518518519,43.806306306306304,1024.7747747747746,28.465965965965964,0
1510,4,0,0,39,0.0,0.0,1.0,39,1050,600,450,0.5714285714285714,15,6,9,356.3960051853027,0.43094916779127307,0.18241094715781192,0.2090791823335033,131389.14399092973,1565.338571817818,132954.48256274755,995,2,283.38461538461536,34,5,18,34.55570715281002,0.6384803921568627,43.69047619047619,1025.2380952380954,30.154061624649867,0
1511,4,0,0,39,0.0,0.0,1.0,39,950,600,350,0.631578947368421,13,6,7,352.7263310094137,0.429880791722897,0.1787147374420308,0.20772182536454695,131535.81700370798,1479.2292256087085,133015.04622931668,996,3,284.38461538461536,35,4,19,34.501697130392266,0.6377976190476191,43.5474537037037,1025.810185185185,29.30886243386243,0
1512,4,0,0,39,0.0,0.0,1.0,39,1000,500,500,0.5,15,5,10,356.29810493402016,0.4294309491677913,0.1837630929975047,0.2108077313315428,131713.96933138295,1585.8875332218859,133299.85686460484,997,4,285.38461538461536,35,4,16,34.230301236516695,0.6395833333333334,43.373842592592595,1026.5046296296302,29.32870370370372,0
1513,4,0,0,39,0.0,0.0,1.0,39,1350,1000,350,0.7407407407407407,17,10,7,358.94123089957475,0.4290092217723797,0.1898222006427599,0.21286942516985483,131803.09070644723,1661.9127229080973,133465.00342935533,998,5,286.38461538461536,35,4,16,34.072550345656744,0.6404761904761904,43.28703703703704,1026.8518518518522,29.33862433862435,0
1514,4,0,0,39,0.0,0.0,1.0,39,750,300,450,0.4,12,3,9,359.1196245350593,0.42841880341880345,0.1861356857519556,0.21338958276119077,131876.9799148812,1671.9223023699465,133548.90221725116,999,6,287.38461538461536,36,3,16,33.9934400467785,0.6391782407407407,43.215090090090094,1027.1396396396403,28.531656656656676,0
1515,4,0,0,39,0.0,0.0,1.0,39,850,500,350,0.5882352941176471,12,5,7,358.81387824217785,0.4280251911830859,0.18539006852973072,0.21337028665744126,131905.89871966577,1665.9334165246514,133571.8321361904,1000,7,288.38461538461536,36,3,16,33.97212782284586,0.6394675925925926,43.186936936936945,1027.2522522522536,28.534784784784822,0
1516,4,0,0,39,0.0,0.0,1.0,39,1050,800,250,0.7619047619047619,13,8,5,362.7054815301856,0.4274910031488979,0.18777950066293614,0.21667379812876558,132079.4781267756,1781.1901428455653,133860.66826962115,1001,8,289.38461538461536,36,3,16,33.69714066608238,0.6412037037037037,43.018018018018026,1027.9279279279292,28.553553553553588,0
1517,4,0,0,39,0.0,0.0,1.0,39,1000,700,300,0.7,13,7,6,361.24032192273654,0.42684435447593344,0.18471310750360126,0.21629412324436134,132166.31063073222,1748.760119917231,133915.07075064944,1002,9,290.38461538461536,36,3,16,33.6472821523747,0.6420717592592593,42.933558558558566,1028.265765765767,28.56293793793797,0
1518,4,0,0,39,0.0,0.0,1.0,39,1250,800,450,0.64,17,8,9,364.2895364825555,0.42670377867746284,0.1808177954444652,0.21862159173664011,132253.17166828993,1835.6893210778358,134088.86098936776,1003,10,291.38461538461536,36,3,17,33.481360849573015,0.6429398148148149,42.8490990990991,1028.6036036036037,28.572322322322325,0
1519,4,1,1,39,0.025,0.025,0.975,40,1000,600,400,0.6,14,6,8,339.6494596574558,0.427590811965812,0.15413566739606166,0.20477546578292538,132426.9793442092,995.9089156724451,133422.88825988164,1004,0,285.075,36,4,21,33.940326404084615,0.6446759259259259,42.68018018018019,1029.2792792792802,28.591091091091116,8
1520,4,0,0,39,0.0,0.0,1.0,39,850,600,250,0.7058823529411765,11,6,5,339.6494596574558,0.4275472334682861,0.15557986870897178,0.20477546578292538,132426.9793442092,1195.7503956659523,133622.72973987515,1005,1,289.8974358974359,36,3,21,33.940326404084615,0.6446759259259259,42.68018018018019,1029.2792792792802,28.591091091091116,0
1521,4,0,0,39,0.0,0.0,1.0,39,1450,1000,450,0.6896551724137931,19,10,9,337.37587536903465,0.4270411605937922,0.1502680754649257,0.20403207700889242,132542.91453615788,1143.356363119888,133686.27089927776,1006,2,290.8974358974359,36,3,22,33.88241834354038,0.6458333333333333,42.56756756756757,1029.7297297297305,28.603603603603624,0
1522,4,0,0,39,0.0,0.0,1.0,39,1450,1100,350,0.7586206896551724,18,11,7,337.3607257776702,0.4261414754835808,0.15644136531665187,0.20481176377836152,132687.90486009672,1152.7375771041452,133840.64243720088,1007,3,291.8974358974359,36,3,17,33.73729369329981,0.6472800925925926,42.42680180180181,1030.2927927927938,28.61924424424427,0
1523,4,0,0,39,0.0,0.0,1.0,39,1500,1000,500,0.6666666666666666,20,10,10,335.91334016983603,0.42535425101214575,0.15922864088001698,0.205041502839668,132891.02447041645,1127.9735816898053,134018.99805210627,1008,4,292.8974358974359,36,3,18,33.57088248143293,0.6493055555555556,42.22972972972973,1031.0810810810817,28.64114114114116,0
1524,4,0,1,38,0.0,0.02564102564102564,0.9743589743589743,39,900,700,200,0.7777777777777778,11,7,4,338.59032764491985,0.425410481331534,0.1628952688135914,0.20699667694073273,132949.08717839463,1203.0549975651302,134152.14217595977,1009,5,293.8974358974359,36,3,18,33.44366491956029,0.6498842592592593,42.17342342342342,1031.3063063063064,28.6473973973974,0
1525,4,0,1,37,0.0,0.02631578947368421,0.9736842105263158,38,850,400,450,0.47058823529411764,13,4,9,345.6237955006383,0.4246088193456614,0.16616625786814,0.21037456588743553,132785.41512613583,1578.759832604576,134364.17495874042,1010,17,302.5,35,3,18,33.42656279243871,0.6502976190476191,42.33217592592592,1030.6712962962952,29.44775132275129,0
1526,4,0,0,37,0.0,0.0,1.0,37,700,600,100,0.8571428571428571,8,6,2,346.8949542965586,0.4232982982982983,0.15668334177706744,0.21182228566333364,132904.7325772675,1820.7962266374989,134725.528803905,1011,18,301.4594594594595,35,2,19,33.274053391701266,0.6514880952380953,42.216435185185176,1031.134259259258,29.4609788359788,0
1527,4,0,1,36,0.0,0.02702702702702703,0.972972972972973,37,1200,1100,100,0.9166666666666666,13,11,2,349.3806587611888,0.4222347347347348,0.15706730069387187,0.21385167794503526,132994.2558299039,1893.1241426611723,134887.37997256508,1012,19,302.4594594594595,35,2,19,33.120137642130466,0.6523809523809524,42.129629629629626,1031.4814814814808,29.470899470899454,0
1528,4,0,0,36,0.0,0.0,1.0,36,750,300,450,0.4,12,3,9,357.7776211954889,0.4200066137566138,0.1722159483029051,0.2093933136606776,131298.46810967493,2195.130717378239,133493.59882705315,1013,31,311.3333333333333,35,1,20,34.61191887822322,0.6354166666666667,43.778935185185176,1024.884259259258,29.282407407407373,8
1529,4,1,0,37,0.02702702702702703,0.0,1.0,37,950,700,250,0.7368421052631579,12,7,5,355.8214067881932,0.4220783283283283,0.1873834339001641,0.21046801576082963,131703.53366457697,1972.587325501199,133676.12099007817,1014,0,303.8918918918919,36,1,20,34.253062717132934,0.6374421296296297,43.38400900900902,1026.4639639639656,28.512887887887935,0
1530,4,0,0,37,0.0,0.0,1.0,37,1400,1000,400,0.7142857142857143,18,10,8,355.4993524006522,0.4214527027027027,0.18331323319811332,0.211238409983476,131876.9799148815,1976.4361912588633,133853.41610614036,1015,1,304.8918918918919,36,1,20,34.086403172166776,0.6391782407407407,43.21509009009011,1027.1396396396426,28.53165665665674,0
1531,4,0,0,37,0.0,0.0,1.0,37,1250,1100,150,0.88,14,11,3,354.54209647975546,0.42139014014014015,0.17926802542187148,0.21147393284145438,132021.60564280517,1961.4433690447456,133983.04901184991,1016,2,305.8918918918919,36,1,20,33.96522755497115,0.640625,43.07432432432434,1027.7027027027043,28.54729729729734,0
1532,4,0,0,37,0.0,0.0,1.0,37,950,600,350,0.631578947368421,13,6,7,352.2315679280871,0.4205455455455456,0.1791306252052991,0.21122330334124909,132224.21481870403,1914.7085007304806,134138.9233194345,1017,3,306.8918918918919,36,1,21,33.82057739333551,0.642650462962963,42.87725225225226,1028.4909909909925,28.569194194194235,0
1533,4,0,0,37,0.0,0.0,1.0,37,1150,800,350,0.6956521739130435,15,8,7,349.2147172378229,0.4195758258258258,0.17489329101455575,0.21005759522067108,132340.0612394492,1843.0194129941046,134183.08065244328,1018,4,307.8918918918919,36,1,21,33.78160227645836,0.6438078703703703,42.764639639639654,1028.9414414414437,28.58170670670677,0
1534,4,0,0,37,0.0,0.0,1.0,37,1000,600,400,0.6,14,6,8,345.81367806358395,0.4192942942942943,0.16861120650618,0.20849634162843772,132427.78427479873,1759.0805131763311,134186.86478797506,1019,5,308.8918918918919,35,2,21,33.780899771355756,0.6467261904761905,42.67939814814816,1029.282407407409,29.408068783068828,0
1535,4,0,0,37,0.0,0.0,1.0,37,1000,600,400,0.6,14,6,8,343.9352739327171,0.4186061061061061,0.16661553089562453,0.20802121904686513,132546.94097490155,1717.513690629296,134264.45466553085,1020,6,309.8918918918919,35,2,21,33.709513506425374,0.6479166666666667,42.56365740740741,1029.7453703703713,29.421296296296322,0
1536,4,0,0,37,0.0,0.0,1.0,37,1200,900,300,0.75,15,9,6,343.16677187223814,0.4178240740740741,0.15927118129365314,0.2080506995683189,132636.34366426617,1703.2771776406091,134339.62084190678,1021,7,310.8918918918919,35,2,19,33.639513108614224,0.6488095238095238,42.476851851851855,1030.092592592593,29.431216931216944,0
1537,4,0,0,37,0.0,0.0,1.0,37,1050,800,250,0.7619047619047619,13,8,5,344.52792650398055,0.41804304304304307,0.16221681742409744,0.2090417909892251,132666.15125868062,1741.4388020833426,134407.59006076396,1022,8,311.8918918918919,35,2,19,33.57452814290531,0.6491071428571429,42.44791666666667,1030.208333333334,29.434523809523828,0
1538,4,0,0,37,0.0,0.0,1.0,37,1450,1200,250,0.8275862068965517,17,12,5,344.6486443306942,0.41766766766766766,0.1675396483391094,0.2099480729418032,132815.23946544924,1754.9184456447183,134570.15791109396,1023,9,312.8918918918919,35,2,19,33.42175686802905,0.6505952380952381,42.30324074074074,1030.787037037037,29.4510582010582,0
1539,4,0,0,37,0.0,0.0,1.0,37,1100,800,300,0.7272727272727273,14,8,6,345.4644495228026,0.4167605105105105,0.17688873793003057,0.21145461360901205,132994.25582990394,1788.957475994505,134783.21330589845,1024,10,313.8918918918919,35,2,20,33.22112507480551,0.6523809523809524,42.129629629629626,1031.481481481481,29.470899470899457,0
1540,4,0,0,37,0.0,0.0,1.0,37,1200,800,400,0.6666666666666666,16,8,8,344.4255991469654,0.4167605105105105,0.17633520427192595,0.2109873103228111,133024.10361207562,1763.381317515429,134787.48492959104,1025,11,314.8918918918919,35,2,20,33.217982160888575,0.6526785714285714,42.10069444444444,1031.5972222222222,29.474206349206348,0
1541,4,0,0,37,0.0,0.0,1.0,37,850,600,250,0.7058823529411765,11,6,5,342.463597316908,0.4163538538538538,0.1691030494439716,0.2104581597019206,133143.5282305598,1719.3623274605588,134862.89055802036,1026,12,315.8918918918919,35,2,20,33.14887761205188,0.6538690476190476,41.9849537037037,1032.060185185185,29.487433862433857,0
1542,4,0,0,37,0.0,0.0,1.0,37,1450,1300,150,0.896551724137931,16,13,3,357.8812487457863,0.4165102602602602,0.15614800689427533,0.20768384277609805,130972.46334876542,2054.9769858110412,133027.44033457647,1027,13,316.8918918918919,35,2,19,34.938941655359564,0.6321428571428571,44.09722222222222,1023.6111111111111,29.246031746031747,7
1543,4,1,0,38,0.02631578947368421,0.0,1.0,38,1000,700,300,0.7,13,7,6,353.95597858417614,0.41881519677572304,0.15982028241335078,0.20731707317073167,131328.125,1697.3572530864199,133025.48225308643,1028,0,309.5263157894737,35,3,20,34.67987804878048,0.6357142857142857,43.75,1025.0,29.285714285714285,0
1544,4,0,0,38,0.0,0.0,1.0,38,850,700,150,0.8235294117647058,10,7,3,356.1998060668817,0.41865220483641535,0.15491794512245827,0.20895482663181716,131387.44882758922,1760.0367584019282,133147.48558599115,1029,1,310.5263157894737,35,3,20,34.5624482576955,0.6363095238095238,43.69212962962963,1025.231481481482,29.292328042328055,0
1545,4,0,0,38,0.0,0.0,1.0,38,850,500,350,0.5882352941176471,12,5,7,357.18016920113706,0.4182224988146041,0.1539834520281067,0.21001814726551274,131476.45968632118,1792.1568233453397,133268.61650966652,1030,2,311.5263157894737,35,3,20,34.447414701124785,0.637202380952381,43.605324074074076,1025.578703703704,29.302248677248684,0
1546,4,0,0,38,0.0,0.0,1.0,38,700,500,200,0.7142857142857143,9,5,4,360.5682069777666,0.4182224988146041,0.15174785304493454,0.2121749966956817,131506.1366705246,1883.3863811728327,133389.52305169744,1031,3,312.5263157894737,35,3,20,34.33056872037915,0.6375,43.576388888888886,1025.694444444444,29.30555555555554,0
1547,4,0,0,38,0.0,0.0,1.0,38,1350,1200,150,0.8888888888888888,15,12,3,359.6886948625148,0.4177483404457089,0.14703232736218452,0.21259421303352521,131674.63705259308,1872.3756695885054,133547.0127221816,1032,4,313.5263157894737,36,2,16,34.18298771121353,0.6371527777777778,43.41216216216216,1026.351351351351,28.50975975975975,0
1548,4,0,0,38,0.0,0.0,1.0,38,1400,1000,400,0.7142857142857143,18,10,8,358.22593832722987,0.41751126126126126,0.14963979455364784,0.2126200341174168,131834.36850761782,1845.298072483849,133679.66658010168,1033,5,314.5263157894737,37,1,16,34.05936365577621,0.6368243243243243,43.256578947368425,1026.9736842105272,27.756045519203436,0
1549,4,0,0,38,0.0,0.0,1.0,38,900,800,100,0.8888888888888888,10,8,2,360.2045174715737,0.41730381697486957,0.1542605178902432,0.21442924578835096,131946.99931709754,1905.5810441674375,133852.58036126496,1034,6,315.5263157894737,37,1,17,33.89496620419781,0.6379504504504505,43.146929824561404,1027.4122807017543,27.767899478425793,0
1550,4,0,0,38,0.0,0.0,1.0,38,950,600,350,0.631578947368421,13,6,7,358.14299003475776,0.4170074679943101,0.16157075349923078,0.21447413541161917,132172.40521121878,1867.324080486292,134039.72929170507,1035,7,316.5263157894737,37,1,18,33.7207649107841,0.6402027027027026,42.92763157894736,1028.28947368421,27.79160739687054,0
1551,4,0,0,38,0.0,0.0,1.0,38,750,400,350,0.5333333333333333,11,4,7,361.65944293605764,0.41697783309625414,0.1668200024683324,0.21722720189667677,132285.18029586025,1968.4369228993503,134253.6172187596,1036,8,317.5263157894737,37,1,19,33.51675193633198,0.6413288288288288,42.81798245614035,1028.7280701754385,27.80346135609293,0
1552,4,0,0,38,0.0,0.0,1.0,38,1100,800,300,0.7272727272727273,14,8,6,364.73757242212423,0.4161184210526316,0.15293799567411703,0.21300674229452043,131215.75869498303,1971.911549707594,133187.6702446906,1037,9,318.5263157894737,37,1,16,34.51724814497716,0.6306306306306306,43.859649122807014,1024.5614035087715,27.69084874348031,7
1553,4,1,0,39,0.02564102564102564,0.0,1.0,39,1000,600,400,0.6,14,6,8,357.1647326916617,0.4176225820962663,0.1583145149666072,0.21100396200714028,131656.8560979618,1604.637163050616,133261.49326101242,1038,0,311.3333333333333,38,1,14,34.265693316677066,0.6332236842105263,43.429487179487175,1026.2820512820508,27.007422402159232,0
1554,4,0,0,39,0.0,0.0,1.0,39,900,700,200,0.7777777777777778,11,7,4,361.0638987859593,0.4175663517768781,0.1607307252015342,0.21376851530710275,131739.10307774472,1713.2468359631598,133452.34991370788,1039,1,312.3333333333333,38,1,14,34.082630866895606,0.634046052631579,43.349358974358964,1026.6025641025626,27.015856950067437,0
1555,4,0,0,39,0.0,0.0,1.0,39,1250,900,350,0.72,16,9,7,359.9184394472926,0.4167791273054431,0.16211934518570748,0.21386006655415726,131876.2384487542,1692.9379885309086,133569.1764372851,1040,2,313.3333333333333,38,1,16,33.97367554261146,0.6354166666666667,43.21581196581195,1027.13675213675,27.02991452991447,0
1556,4,0,0,39,0.0,0.0,1.0,39,1100,700,400,0.6363636363636364,15,7,8,358.8877840482765,0.41599190283400805,0.16205106879813203,0.21401993767888203,132013.44515897785,1675.6025595368328,133689.0477185147,1041,3,314.3333333333333,38,1,16,33.861801296046,0.6367872807017544,43.08226495726495,1027.6709401709388,27.043972109761548,0
1557,4,0,0,39,0.0,0.0,1.0,39,1100,800,300,0.7272727272727273,14,8,6,357.99853907962046,0.4160762483130904,0.15925155925155976,0.2136442894507409,132040.89506172814,1654.0895061728133,133694.98456790094,1042,4,315.3333333333333,38,1,16,33.856981981981974,0.6370614035087719,43.05555555555554,1027.7777777777758,27.046783625730942,0
1558,4,0,0,39,0.0,0.0,1.0,39,1500,1000,500,0.6666666666666666,20,10,10,355.72676673975394,0.4159075573549258,0.1656263736263739,0.21305974672496142,132178.18737900862,1603.8638459712129,133782.05122497983,1043,5,316.3333333333333,38,1,16,33.77705627705627,0.6384320175438596,42.922008547008545,1028.3119658119654,27.060841205578036,0
1559,4,0,0,39,0.0,0.0,1.0,39,1100,700,400,0.6363636363636364,15,7,8,352.1987134773353,0.4159356725146199,0.15795319254340767,0.2112533965511717,132233.12428090064,1514.4672501643522,133747.591531065,1044,6,317.3333333333333,38,1,16,33.812454554897684,0.6389802631578947,42.86858974358974,1028.5256410256402,27.066464237516847,0
1560,4,0,0,39,0.0,0.0,1.0,39,550,200,350,0.36363636363636365,9,2,7,355.21446386725745,0.4156545209176788,0.1571527838789808,0.21368335424769241,132343.03232750745,1602.0318549565327,133945.06418246398,1045,7,318.3333333333333,38,1,16,33.62427750666253,0.6400767543859649,42.761752136752136,1028.9529914529912,27.077710301394507,0
1561,4,0,1,38,0.0,0.02564102564102564,0.9743589743589743,39,1300,900,400,0.6923076923076923,17,9,8,353.1719381719204,0.4157950967161494,0.15490000399185644,0.21307524259777427,132452.9860312113,1555.735558660248,134008.72158987154,1046,8,319.3333333333333,38,1,16,33.566208268465665,0.6411732456140351,42.654914529914535,1029.3803418803427,27.08895636527218,0
1562,4,0,0,38,0.0,0.0,1.0,38,1100,800,300,0.7272727272727273,14,8,6,362.73336720811676,0.4149774774774775,0.15352652887278895,0.21852473585464602,132398.0034722223,2005.0347222222272,134403.03819444453,1047,9,326.7631578947368,37,1,17,33.37550607287449,0.642454954954955,42.708333333333336,1029.1666666666672,27.81531531531533,0
1563,4,0,0,38,0.0,0.0,1.0,38,700,300,400,0.42857142857142855,11,3,8,360.92677200945496,0.4141328828828829,0.15208009908703124,0.21825262819966484,132539.10007165684,1967.3819107802537,134506.48198243708,1048,10,327.7631578947368,37,1,17,33.279979945337736,0.6438626126126126,42.57127192982457,1029.714912280703,27.830132764343322,0
1564,4,0,0,38,0.0,0.0,1.0,38,850,400,450,0.47058823529411764,13,4,9,360.0123357036461,0.41371799431009953,0.14805258114945619,0.21802681297642473,132595.55975155818,1947.2074340181632,134542.76718557635,1049,11,328.7631578947368,37,1,18,33.24672184960431,0.6444256756756757,42.516447368421055,1029.9342105263158,27.836059743954483,0
1565,4,0,0,38,0.0,0.0,1.0,38,1250,900,350,0.72,16,9,7,360.330736277855,0.4118213608345187,0.1427895464803084,0.21920702849680027,132765.01092884364,1967.8628279855498,134732.87375682918,1050,12,329.7631578947368,37,1,16,33.06812338192005,0.6461148648648649,42.351973684210535,1030.592105263159,27.853840682788082,0
1566,4,1,0,39,0.02564102564102564,0.0,1.0,39,650,400,250,0.6153846153846154,9,4,5,356.11666216581125,0.4120838956365272,0.15519987259117696,0.21883504812479262,133141.23109796204,1682.762163050642,134823.99326101269,1051,0,322.28205128205127,38,1,17,32.798913043478265,0.6480263157894737,41.987179487179496,1032.0512820512834,27.159244264507457,0
1567,4,0,0,39,0.0,0.0,1.0,39,1000,800,200,0.8,12,8,4,357.5531070660267,0.4119995501574449,0.15645749406875464,0.2200431923867487,133196.3677496532,1724.955027759538,134921.32277741274,1052,1,323.28205128205127,38,1,17,32.70652211412408,0.6485745614035088,41.933760683760696,1032.2649572649589,27.164867296446285,0
1568,4,0,0,39,0.0,0.0,1.0,39,1200,900,300,0.75,15,9,6,359.0461064905543,0.41126855600539813,0.1546418000700167,0.22194742695336858,133361.8461903721,1776.6103258090702,135138.45651618118,1053,2,324.28205128205127,38,1,18,32.50198248517446,0.6502192982456141,41.77350427350429,1032.905982905985,27.181736392262764,0
1569,4,0,0,39,0.0,0.0,1.0,39,1100,800,300,0.7272727272727273,14,8,6,358.81404635408313,0.4110436347278452,0.14971138204747403,0.22280508570049984,133528.88028047088,1782.45322481008,135311.33350528096,1054,3,325.28205128205127,37,2,18,32.34051205884433,0.6537162162162162,41.61184210526316,1033.5526315789473,27.933854907539114,0
1570,4,0,1,38,0.0,0.02564102564102564,0.9743589743589743,39,1100,700,400,0.6363636363636364,15,7,8,359.65145253095096,0.41081871345029236,0.15038072074649889,0.22398370383491276,133637.87187705465,1812.6109467455747,135450.48282380024,1055,4,326.28205128205127,38,1,18,32.209650754288084,0.6529605263157895,41.50641025641026,1033.9743589743598,27.209851551956838,0
1571,4,0,0,38,0.0,0.0,1.0,38,1250,1000,250,0.8,15,10,5,355.37017883421134,0.4091097676623992,0.13165505169658265,0.22198026267566692,133748.36205164742,1906.0358682153656,135654.3979198628,1056,5,314.3157894736842,38,0,16,32.20968463816016,0.6540570175438596,41.399572649572654,1034.4017094017101,27.221097615834477,0
1572,4,0,0,38,0.0,0.0,1.0,38,1500,1100,400,0.7333333333333333,19,11,8,354.37499718264365,0.40811699857752487,0.13465958175090864,0.22218968269956438,133886.5389751808,1889.208374424723,135775.74734960552,1057,6,315.3157894736842,38,0,16,32.097140497574074,0.6554276315789473,41.26602564102564,1034.9358974358975,27.23515519568151,0
1573,4,0,0,38,0.0,0.0,1.0,38,1050,700,350,0.6666666666666666,14,7,7,352.8449245426066,0.4079243717401612,0.14083780437474225,0.22206318238097028,134024.7872379282,1857.993187961132,135882.78042588933,1058,7,316.3157894736842,38,0,17,31.998469528133164,0.6567982456140351,41.13247863247863,1035.470085470085,27.24921277552855,0
1574,4,0,0,38,0.0,0.0,1.0,38,600,500,100,0.8333333333333334,7,5,2,351.1382703123249,0.40756875296348977,0.13975003529041308,0.22132213214614274,134080.10651800703,1816.1313372050417,135896.23785521206,1059,8,317.3157894736842,38,0,17,31.987354721133347,0.6573464912280702,41.07905982905982,1035.6837606837596,27.25483580746736,0
1575,4,0,0,38,0.0,0.0,1.0,38,1250,1100,150,0.88,14,11,3,348.2739040746359,0.4073909435751541,0.13905742909552732,0.2201799427454901,134190.7793209876,1747.0293209876531,135937.80864197525,1060,9,318.3157894736842,38,0,17,31.950960679177847,0.6584429824561404,40.97222222222222,1036.1111111111109,27.266081871345023,0
1576,4,0,0,38,0.0,0.0,1.0,38,900,600,300,0.6666666666666666,12,6,6,346.2010134354166,0.40696123755334285,0.13700432402519525,0.21936616795146807,134273.81388569289,1697.1460890130768,135970.95997470597,1061,10,319.3157894736842,38,0,17,31.92175205305294,0.659265350877193,40.89209401709402,1036.4316239316238,27.274516419253256,0
1577,4,0,0,38,0.0,0.0,1.0,38,1500,1200,300,0.8,18,12,6,346.28582260125654,0.40669452347083923,0.13528371583395282,0.21975221299542105,134329.18453000564,1703.2584328657817,136032.44296287143,1062,11,320.3157894736842,38,0,17,31.86428595966882,0.6598135964912281,40.8386752136752,1036.6452991452975,27.28013945119204,0
1578,4,0,2,36,0.0,0.05263157894736842,0.9473684210526316,38,850,800,50,0.9411764705882353,9,8,1,347.6446256270933,0.40595365101944053,0.14114881827004933,0.2212843528499798,134439.96006145433,1747.4659169771226,136187.42597843145,1063,12,321.3157894736842,38,0,19,31.718519281618086,0.6609100877192983,40.7318376068376,1037.0726495726485,27.2913855150697,0
1579,4,0,0,36,0.0,0.0,1.0,36,850,600,250,0.7058823529411765,11,6,5,358.3231018415692,0.4018353174603175,0.15154780445989835,0.22695440510997694,134258.8508060427,2421.6095741011486,136680.46038014384,1064,13,335.1388888888889,36,0,20,31.62261400268029,0.6629050925925926,40.90653153153154,1036.3738738738753,28.7881631631632,0
1580,4,0,0,36,0.0,0.0,1.0,36,800,500,300,0.625,11,5,6,364.13883595375916,0.40196759259259257,0.1572867262831421,0.23137517340415903,134375.5849388241,2586.273816045791,136961.85875486987,1065,14,336.1388888888889,36,0,20,31.355218855218855,0.6640625,40.793918918918926,1036.8243243243253,28.800675675675702,0
1581,4,0,0,36,0.0,0.0,1.0,36,850,700,150,0.8235294117647058,10,7,3,363.9219641429443,0.4017030423280423,0.15435081623049896,0.23160728181011592,134433.97102761565,2584.6949567811257,137018.6659843968,1066,15,337.1388888888889,36,0,20,31.3024848879719,0.6646412037037037,40.73761261261262,1037.049549549551,28.806931931931974,0
1582,4,0,0,36,0.0,0.0,1.0,36,1150,900,250,0.782608695652174,14,9,5,362.90129369200577,0.4003306878306878,0.1476858886235921,0.23188436338960774,134579.99173159664,2567.8506208911854,137147.84235248782,1067,16,338.1388888888889,36,0,20,31.183072860140374,0.666087962962963,40.59684684684686,1037.6126126126142,28.822572572572614,0
1583,4,0,0,36,0.0,0.0,1.0,36,1250,1100,150,0.88,14,11,3,364.4492684374806,0.3992559523809524,0.14122052320186995,0.2341872267778406,134784.5538739755,2624.4264112085248,137408.98028518402,1068,17,339.1388888888889,36,0,17,30.938663557820917,0.6681134259259259,40.399774774774784,1038.4009009009021,28.8444694694695,0
1584,4,0,0,36,0.0,0.0,1.0,36,1000,600,400,0.6,14,6,8,360.0486220360001,0.3986607142857143,0.14135146851631064,0.2324820598688716,134960.01649876242,2518.4335940670576,137478.45009282947,1069,18,340.1388888888889,36,0,17,30.877903616198843,0.669849537037037,40.230855855855864,1039.0765765765777,28.86323823823827,0
1585,4,0,0,36,0.0,0.0,1.0,36,1350,1100,250,0.8148148148148148,16,11,5,356.60718205390316,0.39785052910052915,0.14052606235704834,0.23081937520038798,135047.79061155778,2431.8024105186587,137479.59302207644,1070,19,341.1388888888889,36,0,17,30.8798302636331,0.6707175925925926,40.14639639639641,1039.4144144144166,28.872622622622682,0
1586,4,0,0,36,0.0,0.0,1.0,36,1200,700,500,0.5833333333333334,17,7,10,354.5935406306886,0.39618055555555554,0.1374153464929686,0.23082315255853939,135252.70783875114,2391.9473104861886,137644.65514923734,1071,20,342.1388888888889,36,0,19,30.728095341200255,0.6727430555555556,39.94932432432434,1040.2027027027045,28.89451951951957,0
1587,4,0,0,36,0.0,0.0,1.0,36,1100,800,300,0.7272727272727273,14,8,6,351.7839419352276,0.39578373015873014,0.13223977683992838,0.2297410181924694,135369.87314595017,2324.1895189108245,137694.062664861,1072,21,343.1388888888889,36,0,19,30.68458500162322,0.673900462962963,39.83671171171172,1040.6531531531543,28.907032032032063,0
1588,4,0,0,36,0.0,0.0,1.0,36,850,500,350,0.5882352941176471,12,5,7,368.9670126558233,0.395651455026455,0.1041002236152353,0.21465240218038412,131068.54056336754,2471.9935729648723,133540.53413633243,1073,22,344.1388888888889,36,0,19,34.557947505407085,0.6310763888888888,44.003378378378386,1023.9864864864875,28.444069069069098,8
1589,4,0,0,36,0.0,0.0,1.0,36,900,600,300,0.6666666666666666,12,6,6,371.01901097485944,0.39502314814814815,0.10179485300404245,0.21649518555729952,131183.8797200918,2534.342661918685,133718.22238201048,1074,23,345.1388888888889,36,0,19,34.388626287054336,0.6322337962962963,43.89076576576577,1024.4369369369376,28.456581581581602,0
1590,4,0,0,36,0.0,0.0,1.0,36,1100,700,400,0.6363636363636364,15,7,8,372.7939718421576,0.3944775132275132,0.10840108401084025,0.2183507549361207,131328.12499999988,2591.6666666666524,133919.79166666654,1075,24,346.1388888888889,36,0,19,34.19715447154471,0.6336805555555556,43.74999999999999,1024.999999999999,28.472222222222197,0
1591,4,0,0,36,0.0,0.0,1.0,36,750,400,350,0.5333333333333333,11,4,7,371.9975315396712,0.3942625661375661,0.10963113503484845,0.21804852090184312,131356.98356718197,2572.8947274977636,133929.87829467974,1076,25,347.1388888888889,36,0,19,34.18836281079497,0.6339699074074074,43.721846846846844,1025.112612612612,28.475350350350336,0
1592,4,0,0,36,0.0,0.0,1.0,36,900,600,300,0.6666666666666666,12,6,6,357.5550741716145,0.39479166666666665,0.022546938569226516,0.1997674283522988,129495.73072059352,2064.4799591101646,131560.21067970368,1077,26,348.1388888888889,35,1,15,36.44577742400121,0.6172619047619048,45.543981481481495,1017.8240740740761,29.08068783068789,8
1593,4,1,0,37,0.02702702702702703,0.0,1.0,37,900,700,200,0.7777777777777778,11,7,4,349.4108238454254,0.3993681181181181,0.02629834254143626,0.19689713298886102,129831.84831791288,1672.9306164272787,131504.77893434017,1078,0,339.7027027027027,36,1,16,36.31146408839779,0.6186342592592593,45.213963963963984,1019.1441441441472,28.309559559559645,0
1594,4,0,0,37,0.0,0.0,1.0,37,800,600,200,0.75,10,6,4,348.7590380348893,0.3995558058058058,0.02850513755386208,0.1966740220095818,129860.54202428806,1658.0075430160255,131518.5495673041,1079,1,340.7027027027027,36,1,16,36.29893566088464,0.6189236111111112,45.18581081081083,1019.2567567567589,28.31268768768775,0
1595,4,0,0,37,0.0,0.0,1.0,37,1150,800,350,0.6956521739130435,15,8,7,350.66772341168166,0.3985548048048048,0.031577785138567016,0.19862398817633575,130032.7708409427,1719.6591439412887,131752.429984884,1080,2,341.7027027027027,36,1,17,36.07545728902139,0.6206597222222222,45.016891891891916,1019.9324324324358,28.33145645645655,0
1596,4,1,0,38,0.02631578947368421,0.0,1.0,38,1200,700,500,0.5833333333333334,17,7,10,340.74745264723254,0.40254563774300617,0.028530190992131166,0.19512870413732428,130458.54403518396,1290.6833112111515,131749.2273463951,1081,0,333.6842105263158,37,1,19,35.897083288612215,0.6230292792792793,44.59978070175439,1021.6008771929829,27.61083451872927,0
1597,4,0,1,37,0.0,0.02631578947368421,0.9736842105263158,38,900,400,500,0.4444444444444444,14,4,10,348.77018575093757,0.4021455666192508,-0.05921405012262826,0.2023474011177752,130963.11034404818,1549.5159568328727,132512.62630088106,1082,1,334.6842105263158,37,1,19,35.18155240135691,0.6280968468468469,44.10635964912281,1023.5745614035088,27.66417733522997,8
1598,4,0,1,36,0.0,0.02702702702702703,0.972972972972973,37,1350,1100,250,0.8148148148148148,16,11,5,358.13361314129213,0.3979291791791792,-0.05081318942705104,0.20788215475442803,130982.06948502547,1981.8163602791842,132963.88584530464,1083,5,344.7027027027027,36,1,19,34.92276310964429,0.6302083333333333,44.08783783783783,1023.6486486486478,28.43468468468466,0
1599,4,0,1,35,0.0,0.027777777777777776,0.9722222222222222,36,1150,1000,150,0.8695652173913043,13,10,3,365.4188826408971,0.3938822751322751,-0.03244457006469448,0.21222127491521536,131002.08340031272,2374.1269879543634,133376.2103882671,1084,33,355.1388888888889,35,1,20,34.71605897870736,0.6324404761904762,44.068287037037024,1023.7268518518501,29.249338624338577,0
1600,4,0,0,35,0.0,0.0,1.0,35,1150,900,250,0.782608695652174,14,9,5,367.9543117882265,0.3918067226890756,-0.011299697744710624,0.21415040527755916,131084.19075963713,2646.5986394557744,133730.7893990929,1085,34,364.9714285714286,34,1,20,34.56802681546927,0.6354166666666667,43.988095238095234,1024.0476190476186,30.119047619047606,0
1601,4,1,0,36,0.027777777777777776,0.0,1.0,36,750,600,150,0.8,9,6,3,360.36005668539724,0.3980654761904762,-0.010553749290395764,0.21140468720535685,131389.1439909296,2269.706632653046,133658.85062358264,1086,0,355.80555555555554,34,2,21,34.45410473757548,0.6384803921568627,43.69047619047618,1025.2380952380943,30.15406162464983,0
1602,4,0,0,36,0.0,0.0,1.0,36,950,600,350,0.631578947368421,13,6,7,361.1343440239915,0.39794973544973544,-0.00662603985296939,0.2123667149328796,131480.6990504535,2296.4392006802705,133777.13825113376,1087,1,356.80555555555554,34,2,22,34.34174888759915,0.6393995098039216,43.601190476190474,1025.5952380952378,30.164565826330524,0
1603,4,0,0,36,0.0,0.0,1.0,36,750,500,250,0.6666666666666666,10,5,5,362.8112377182731,0.3975198412698413,-0.009951259138911484,0.2136940830771263,131541.75347222216,2344.965277777774,133886.71874999994,1088,2,357.80555555555554,34,2,22,34.23707013268345,0.6400122549019608,43.541666666666664,1025.833333333333,30.17156862745097,0
1604,4,0,0,36,0.0,0.0,1.0,36,700,600,100,0.8571428571428571,8,6,2,360.7299243286998,0.3963128306878307,-0.010026031598752594,0.21332053549808302,131694.45153061222,2301.225907029472,133995.6774376417,1089,3,358.80555555555554,34,2,18,34.13626962035104,0.6415441176470589,43.39285714285714,1026.428571428571,30.18907563025209,0
1605,4,0,0,36,0.0,0.0,1.0,36,1050,800,250,0.7619047619047619,13,8,5,364.4256691321224,0.39568452380952385,-0.008552953602803282,0.21619916244385742,131816.6737528344,2407.4759070294685,134224.14965986388,1090,4,359.80555555555554,34,2,19,33.918048149006864,0.6427696078431373,43.27380952380952,1026.9047619047615,30.203081232492984,0
1606,4,0,0,36,0.0,0.0,1.0,36,1400,1100,300,0.7857142857142857,17,11,6,363.30532160287896,0.3954530423280423,-0.008116192335611228,0.21647145269733947,131981.42387902946,2389.9107295953318,134371.3346086248,1091,5,360.80555555555554,35,1,19,33.78059998498159,0.6422619047619047,43.113425925925924,1027.546296296296,29.358465608465604,0
1607,4,0,0,36,0.0,0.0,1.0,36,1050,800,250,0.7619047619047619,13,8,5,392.7839953206891,0.39489087301587306,0.05450286407951155,0.21830442548278908,129289.65627411267,2964.9539984139246,132254.6102725266,1092,6,361.80555555555554,35,1,18,35.759858313417546,0.6151785714285714,45.74652777777778,1017.013888888889,29.057539682539687,8
1608,4,0,0,36,0.0,0.0,1.0,36,1150,600,550,0.5217391304347826,17,6,11,396.9735080530652,0.3947751322751323,0.05889192194924697,0.22145882505092312,129436.83556241429,3076.598936899869,132513.43449931414,1093,7,362.80555555555554,35,1,15,35.50291932059449,0.6166666666666667,45.601851851851855,1017.5925925925927,29.074074074074076,0
1609,4,1,1,36,0.02702702702702703,0.02702702702702703,0.972972972972973,37,950,600,350,0.631578947368421,13,6,7,393.542958648699,0.39805430430430433,0.07100118235778852,0.2220916996064853,129889.23890106325,2823.3990747504267,132712.63797581368,1094,0,353.97297297297297,36,1,17,35.128516718220645,0.619212962962963,45.15765765765766,1019.3693693693696,28.31581581581582,0
1610,4,1,0,37,0.02702702702702703,0.0,1.0,37,1350,1000,350,0.7407407407407407,17,10,7,389.3266225524554,0.40296546546546547,0.06204668422623283,0.2221828369251409,130325.1453767781,2749.4171295055867,133074.5625062837,1095,0,336.35135135135135,33,4,18,34.79206673067691,0.630050505050505,44.73039215686274,1021.0784313725485,30.941770647652984,0
1611,4,0,0,37,0.0,0.0,1.0,37,1250,1100,150,0.88,14,11,3,387.5495287223456,0.4021834334334334,0.04902456413247758,0.22260076236531443,130575.52984429078,2720.897010765103,133296.42685505588,1096,1,337.35135135135135,33,4,15,34.58283373301359,0.6325757575757576,44.485294117647065,1022.0588235294127,30.971479500891295,0
1612,4,0,0,37,0.0,0.0,1.0,37,1350,1000,350,0.7407407407407407,17,10,7,384.12411849921176,0.4028403403403404,0.04467058745787367,0.22127713305095464,130688.2812500001,2640.104166666682,133328.38541666677,1097,2,338.35135135135135,34,3,16,34.555827220863904,0.6314338235294117,44.37500000000001,1022.5000000000008,30.073529411764728,0
1613,4,1,1,37,0.02631578947368421,0.02631578947368421,0.9736842105263158,38,1350,1000,350,0.7407407407407407,17,10,7,376.1076202802442,0.4053016832622096,0.05009640791259007,0.21826087885554346,130972.46334876552,2251.9483024691494,133224.41165123467,1098,0,330.42105263157896,35,3,18,34.47252374491181,0.6321428571428571,44.09722222222223,1023.6111111111119,29.24603174603177,0
1614,4,0,0,37,0.0,0.0,1.0,37,850,500,350,0.5882352941176471,12,5,7,376.9131963223361,0.4044044044044044,0.06917033312382137,0.21901712759270908,131023.24263038568,2476.877834467141,133500.1204648528,1099,1,338.4594594594595,34,3,18,34.40043604651163,0.6348039215686274,44.04761904761906,1023.8095238095253,30.112044817927217,0
1615,4,0,0,37,0.0,0.0,1.0,37,1100,900,200,0.8181818181818182,13,9,4,379.4838485597281,0.4035910910910911,0.07402590875394166,0.22121131659945137,131145.15306122456,2553.493480725628,133698.64654195018,1100,2,339.4594594594595,34,3,18,34.211074306524075,0.6360294117647058,43.92857142857143,1024.285714285715,30.126050420168085,0
1616,4,0,0,37,0.0,0.0,1.0,37,1400,1100,300,0.7857142857142857,17,11,6,380.6986248141087,0.4017454954954955,0.07523373241757136,0.22334675281871227,131390.93888168025,2604.1975000784746,133995.13638175873,1101,3,340.4594594594595,33,4,19,33.930990517172674,0.6407828282828283,43.688725490196084,1025.2450980392166,31.068033273915656,0
1617,4,0,0,37,0.0,0.0,1.0,37,1600,1300,300,0.8125,19,13,6,382.3565868892939,0.4006819319319319,0.060342712516625596,0.22542882714346268,131579.4706362938,2662.055459438683,134241.52609573246,1102,4,341.4594594594595,33,4,14,33.69764293677337,0.6426767676767677,43.504901960784316,1025.9803921568632,31.090314913844338,0
1618,4,0,0,37,0.0,0.0,1.0,37,700,400,300,0.5714285714285714,10,4,6,384.69702829137924,0.4006819319319319,0.06892456635740252,0.22737033252930827,131673.78720023535,2730.9029279603874,134404.69012819574,1103,5,342.4594594594595,33,4,15,33.54216417910449,0.6436237373737373,43.412990196078425,1026.3480392156853,31.101455733808645,0
1619,4,0,0,37,0.0,0.0,1.0,37,700,400,300,0.5714285714285714,10,4,6,383.5890327483173,0.40080705705705705,0.06688350241358854,0.22690266513417395,131705.23356401373,2704.1366301422395,134409.37019415598,1104,6,343.4594594594595,33,4,15,33.53878143903216,0.6439393939393939,43.382352941176464,1026.4705882352932,31.10516934046343,0
1620,4,0,0,37,0.0,0.0,1.0,37,850,700,150,0.8235294117647058,10,7,3,382.9916146945808,0.40049424424424424,0.0689450491312511,0.22692388599089072,131768.13755526708,2693.2183535178624,134461.35590878493,1105,7,344.4594594594595,33,4,15,33.49049096840933,0.6445707070707071,43.32107843137254,1026.7156862745087,31.112596553772992,0
1621,4,0,0,37,0.0,0.0,1.0,37,850,500,350,0.5882352941176471,12,5,7,368.8671253162527,0.40055680680680683,0.0550768920059026,0.20471508620394274,129232.53864198842,2144.875318387132,131377.41396037556,1106,8,345.4594594594595,33,4,20,36.426193202362306,0.6190025252525253,45.80269607843136,1016.7892156862725,30.81179441473553,8
1622,4,0,0,37,0.0,0.0,1.0,37,1050,800,250,0.7619047619047619,13,8,5,364.8880061656473,0.40065065065065064,0.04989264448723896,0.20343755960194304,129413.28124999991,2044.2708333333183,131457.55208333323,1107,9,346.4594594594595,34,3,21,36.34316134316133,0.6185661764705883,45.62499999999999,1017.4999999999993,29.926470588235276,0
1623,4,0,0,37,0.0,0.0,1.0,37,1150,800,350,0.6956521739130435,15,8,7,364.91228070175447,0.3999311811811812,0.04305357989568526,0.20392156862745106,129504.14540816324,2051.530612244896,131555.67602040814,1108,10,347.4594594594595,34,3,16,36.25000000000001,0.6194852941176471,45.535714285714285,1017.8571428571427,29.93697478991596,0
1624,4,1,0,38,0.02631578947368421,0.0,1.0,38,1000,700,300,0.7,13,7,6,359.53195880881134,0.4032865101944049,0.0443854868779574,0.20299727520435948,129908.37191358012,1741.2422839505962,131649.61419753073,1109,0,339.2894736842105,35,3,18,35.97581743869209,0.6214285714285714,45.13888888888888,1019.4444444444434,29.126984126984098,0
1625,4,0,0,38,0.0,0.0,1.0,38,1150,900,250,0.782608695652174,14,9,5,357.5098455475543,0.4033754148885728,0.04351721336932868,0.20246637268412895,130026.38996056237,1697.1429183813389,131723.53287894372,1110,1,340.2894736842105,35,3,19,35.907474655772425,0.6226190476190476,45.023148148148145,1019.907407407407,29.14021164021163,0
1626,4,0,0,38,0.0,0.0,1.0,38,850,400,450,0.47058823529411764,13,4,9,358.7330997016325,0.40327169274537694,0.04125783083602563,0.20331284936787686,130055.90284475725,1731.0714323988177,131786.97427715606,1111,2,341.2894736842105,35,3,19,35.84631132039788,0.6229166666666667,44.994212962962955,1020.0231481481471,29.14351851851849,0
1627,4,0,0,38,0.0,0.0,1.0,38,650,400,250,0.6153846153846154,9,4,5,360.52449482913374,0.4030049786628734,0.04297021901470233,0.20494806388836048,130173.98787133486,1786.1822434413561,131960.1701147762,1112,3,342.2894736842105,35,3,20,35.68071623001021,0.6241071428571429,44.87847222222222,1020.486111111111,29.156746031746028,0
1628,4,0,0,38,0.0,0.0,1.0,38,1800,1400,400,0.7777777777777778,22,14,8,358.6838817159516,0.402619724988146,0.04027926960257755,0.20436639772187956,130262.58680555563,1744.648196373466,132007.2350019291,1113,4,343.2894736842105,34,4,22,35.63775510204082,0.6271446078431373,44.79166666666667,1020.833333333334,30.02450980392159,0
1629,4,1,1,38,0.02564102564102564,0.02564102564102564,0.9743589743589743,39,900,600,300,0.6666666666666666,12,6,6,351.66282282540175,0.40721997300944673,0.0457638708483008,0.20225911986615686,130627.4252409296,1387.361819727878,132014.7870606575,1114,0,335.46153846153845,34,5,18,35.44723613213772,0.6308210784313726,44.4345238095238,1022.2619047619039,30.06652661064423,0
1630,4,0,0,38,0.0,0.0,1.0,38,1100,900,200,0.8181818181818182,13,9,4,358.20487185119015,0.40257527264106213,0.03343976173499286,0.20591225610687647,130606.8447982748,1756.8016207708677,132363.64641904566,1115,6,345.2894736842105,33,5,19,35.300898173680196,0.6328914141414141,44.454656862745104,1022.1813725490205,30.975193107546076,0
1631,4,0,0,38,0.0,0.0,1.0,38,1200,700,500,0.5833333333333334,17,7,10,392.449671082013,0.40260490753911804,0.07269712065753109,0.2032674954381871,126456.23692735439,2337.7403011593806,128793.97722851377,1116,7,346.2894736842105,32,6,17,38.67975353586074,0.5930989583333333,48.5479797979798,1005.8080808080811,31.431502525252533,7
1632,4,4,1,41,0.09523809523809523,0.023809523809523808,0.9761904761904762,42,900,500,400,0.5555555555555556,13,5,8,352.0933292222593,0.4203929539295393,0.08762166644843083,0.18738235228365108,127559.26354595333,584.1473800859296,128143.41092603926,1117,0,314.2142857142857,35,7,18,38.561717079132286,0.5976190476190476,47.4537037037037,1010.185185185185,28.862433862433857,0
1633,4,0,0,41,0.0,0.0,1.0,41,750,500,250,0.6666666666666666,10,5,5,361.2843731772362,0.41712398373983745,0.08292452884443913,0.19176558531222263,127452.38803854868,1009.3112244897823,128461.69926303846,1118,1,322.8780487804878,34,7,18,38.43924388901987,0.5986519607843137,47.5595238095238,1009.7619047619041,29.69887955182071,0
1634,4,2,0,43,0.046511627906976744,0.0,1.0,43,1450,1000,450,0.6896551724137931,19,10,9,348.1098931657874,0.42153469915097824,0.08247854952051847,0.18717937702541027,127973.55791179718,309.77231454430313,128283.33022634148,1119,0,308.8139534883721,36,7,20,38.23826748284178,0.5998263888888888,47.04391891891893,1011.8243243243263,28.106231231231288,0
1635,4,3,5,41,0.06521739130434782,0.10869565217391304,0.8913043478260869,46,1100,700,400,0.6363636363636364,15,7,8,329.02312343695814,0.4306964573268921,0.11541531858544163,0.180796741833994,128839.34389667996,-721.5470610998316,128117.79683558013,1120,0,289.60869565217394,37,9,15,37.83874698491558,0.6067004504504505,46.18969298245615,1015.2412280701772,27.438952110004788,0
1636,4,0,0,41,0.0,0.0,1.0,41,1350,900,450,0.6666666666666666,18,9,9,368.9018818420682,0.4159298780487805,0.09833581569137251,0.1983110116240189,127963.79145408167,1241.2166950113428,129205.00814909302,1121,1,325.7317073170732,34,7,18,37.7223300780484,0.6038602941176471,47.05357142857143,1011.7857142857147,29.75840336134455,0
1637,4,1,0,42,0.023809523809523808,0.0,1.0,42,1500,1100,400,0.7333333333333333,19,11,8,359.5797816012222,0.4190500387146729,0.1022029426336224,0.1947763089590894,128268.64216887744,824.8171695148758,129093.45933839232,1122,0,318.95238095238096,33,9,19,37.64618114364062,0.6092171717171717,46.75245098039216,1012.9901960784321,30.696672608437336,0
1638,4,2,0,44,0.045454545454545456,0.0,1.0,44,1150,800,350,0.6956521739130435,15,8,7,342.2612486605692,0.4257950140944327,0.11680749374848753,0.18816020840998113,128858.1486892297,20.63017409300437,128878.7788633227,1123,0,305.40909090909093,36,8,20,37.48359398107069,0.6087962962962963,46.17117117117117,1015.3153153153148,28.203203203203188,0
1639,4,1,0,45,0.022222222222222223,0.0,1.0,45,1200,1000,200,0.8333333333333334,14,10,4,354.6873333204837,0.42784090909090905,0.15873222934860043,0.18697815353668398,127174.94956380836,29.08087590265137,127204.03043971102,1124,0,299.6,37,8,20,38.890436460484835,0.5898085585585586,47.83442982456142,1008.6622807017566,27.261142721669096,8
1640,4,3,0,48,0.0625,0.0,1.0,48,850,600,250,0.7058823529411765,11,6,5,336.7118239582201,0.43525598404255317,0.18751255776572173,0.1807782899503846,127913.11905116042,-986.0280752197361,126927.09097594068,1125,0,281.8125,40,8,20,38.58833969593465,0.5921875,47.103658536585385,1011.5853658536618,25.289634146341545,0
1641,4,0,1,47,0.0,0.020833333333333332,0.9791666666666666,48,1400,1000,400,0.7142857142857143,18,10,8,332.8742638237457,0.4350435874704492,0.18270437882896418,0.17906153673112074,127990.23321311754,-1079.0690685107688,126911.16414460677,1126,1,282.8125,40,8,20,38.60663352415388,0.59296875,47.02743902439026,1011.8902439024419,25.297256097561046,0
1642,4,1,0,48,0.020833333333333332,0.0,1.0,48,1200,800,400,0.6666666666666666,16,8,8,331.78288147877305,0.4334644651300236,0.1826207933326296,0.1794050161744035,128198.62349559886,-1092.992357754303,127105.63113784455,1127,0,283.7291666666667,38,10,22,38.421554664697396,0.5984100877192983,46.82158119658121,1012.7136752136769,26.650359874044128,0
1643,4,1,1,48,0.02040816326530612,0.02040816326530612,0.9795918367346939,49,1300,1100,200,0.8461538461538461,15,11,4,331.78974493490136,0.4351261337868481,0.2034067401223607,0.1811910682238441,128593.16541883704,-1266.8212890624757,127326.34412977457,1128,0,278.9183673469388,39,10,18,38.01917513950224,0.6006944444444444,46.43229166666668,1014.2708333333353,26.006944444444496,0
1644,4,0,1,47,0.0,0.020833333333333332,0.9791666666666666,48,1100,800,300,0.7272727272727273,14,8,6,336.6431809146806,0.43282727541371163,0.19894923814415333,0.18359783564170404,128540.34423828128,-945.5539279513882,127594.79031032989,1129,1,285.7083333333333,39,9,19,37.949944358842664,0.6001602564102564,46.484375,1014.0625000000002,26.00160256410257,0
1645,4,1,0,48,0.020833333333333332,0.0,1.0,48,1450,1100,350,0.7586206896551724,18,11,7,337.1669742902092,0.4331781914893617,0.205093162919618,0.18461739722096285,128698.84033203126,-921.4002821180552,127777.4400499132,1130,0,286.5416666666667,39,9,20,37.77514714437259,0.6017628205128205,46.328125,1014.6875000000001,26.017628205128208,0
1646,4,0,1,47,0.0,0.020833333333333332,0.9791666666666666,48,1300,900,400,0.6923076923076923,17,9,8,337.5333301693091,0.4325410017730496,0.20313889458923384,0.18543403809639716,128830.99500868046,-903.0490451388933,127927.94596354157,1131,1,287.5416666666667,39,9,20,37.63125042752582,0.6030982905982907,46.197916666666664,1015.2083333333326,26.030982905982885,0
1647,4,0,0,47,0.0,0.0,1.0,47,1350,1000,350,0.7407407407407407,17,10,7,342.4500754236558,0.4306005242059821,0.1946386997296199,0.1876349063429274,128725.26584201369,-583.604600694469,128141.66124131922,1132,2,294.531914893617,39,8,20,37.6141962636009,0.6020299145299146,46.30208333333332,1014.791666666665,26.020299145299102,0
1648,4,0,0,47,0.0,0.0,1.0,47,1400,1100,300,0.7857142857142857,17,11,6,344.35414624734216,0.43088960838729573,0.19734085140452806,0.1894706293669297,128891.61544054469,-523.1275613060959,128368.48787923859,1133,3,295.531914893617,40,7,21,37.396375433680284,0.6020833333333333,46.13821138211382,1015.447154471545,25.386178861788625,0
1649,4,1,0,48,0.020833333333333332,0.0,1.0,48,1050,500,550,0.47619047619047616,16,5,11,340.91861252795724,0.43339982269503546,0.21058673927891025,0.18918840777808166,129229.25954380176,-787.1808176683277,128442.07872613343,1134,0,290.3541666666667,37,11,23,37.1399717818757,0.6106418918918919,45.80592105263157,1016.7763157894722,27.48044096728303,0
1650,4,0,0,48,0.0,0.0,1.0,48,1650,1100,550,0.6666666666666666,22,11,11,337.41522775592375,0.43321513002364065,0.21119015119697604,0.18814652395476653,129418.71667031902,-866.4308477610066,128552.28582255801,1135,1,291.3541666666667,38,10,23,37.03647802043956,0.6107456140350878,45.619658119658105,1017.5213675213657,26.77687809266752,0
1651,4,1,1,48,0.02040816326530612,0.02040816326530612,0.9795918367346939,49,1550,1200,350,0.7741935483870968,19,12,7,329.86940216180824,0.4340809240362811,0.21596988309887055,0.18603873776099694,129864.12896050357,-1232.3594835069334,128631.76947699663,1136,0,286.38775510204084,39,10,20,36.776635155850784,0.6135149572649572,45.18229166666667,1019.2708333333342,26.135149572649595,0
1652,4,1,0,49,0.02040816326530612,0.0,1.0,49,1250,700,550,0.56,18,7,11,332.12766107430775,0.4354450113378685,0.22237033815816454,0.1889834617659644,130210.72035701305,-1150.6836002049029,129060.03675680814,1137,0,279.38775510204084,40,9,22,36.36799263168376,0.6153645833333333,44.84247967479675,1020.6300813008132,25.515752032520332,0
1653,4,0,0,49,0.0,0.0,1.0,49,1700,1300,400,0.7647058823529411,21,13,8,332.3615160349853,0.4355513038548753,0.22557267805081205,0.18936877076411968,130262.58680555565,-1141.1355054861428,129121.4513000695,1138,1,280.38775510204084,39,10,22,36.30952380952381,0.6175213675213675,44.79166666666667,1020.8333333333342,26.175213675213698,0
1654,4,1,0,50,0.02,0.0,1.0,50,1750,1600,150,0.9142857142857143,19,16,3,322.64025902574065,0.436734693877551,0.2202144082332762,0.18623690199208615,130766.77439212079,-1561.874807633102,129204.89958448769,1139,0,275.76,37,13,19,36.04827758719268,0.6261261261261262,44.298245614035096,1022.8070175438608,27.64343290659083,0
1655,4,0,0,50,0.0,0.0,1.0,50,1850,1400,450,0.7567567567567568,23,14,9,321.5013734099788,0.43647959183673474,0.2210816454374609,0.18617534186945453,130890.45606874142,-1583.7077215282218,129306.7483472132,1140,1,276.76,38,12,19,35.952617108651786,0.6255482456140351,44.17735042735043,1023.2905982905991,26.928699955015766,0
1656,4,1,2,49,0.0196078431372549,0.0392156862745098,0.9607843137254902,51,1050,600,450,0.5714285714285714,15,6,9,304.31742821903754,0.4386601307189542,0.04066577802069937,0.17472160671889964,130559.50969180022,-1930.2097708281551,128629.29992097207,1141,0,272.3137254901961,42,9,13,36.72568818937454,0.6158234126984127,44.500968992248055,1021.9961240310066,24.3332410483573,8
1657,4,0,1,48,0.0,0.02040816326530612,0.9795918367346939,49,900,500,400,0.5555555555555556,13,5,8,308.12786242766725,0.4380491780045352,0.03613768131730977,0.17705752184005874,130591.93244716854,-1752.1974009511368,128839.7350462174,1142,1,277.18367346938777,41,8,13,36.5956315312692,0.6176321138211383,44.469246031746025,1022.1230158730148,24.929829655439384,0
1658,4,0,1,47,0.0,0.020833333333333332,0.9791666666666666,48,1250,1000,250,0.8,15,10,5,317.1139170434353,0.4360593971631206,0.03629212645392199,0.18238129740079548,130625.94112507426,-1315.3392284685144,129310.60189660575,1143,2,283.6041666666667,40,8,13,36.331684726778676,0.61953125,44.43597560975609,1022.2560975609748,25.55640243902437,0
1659,4,0,0,47,0.0,0.0,1.0,47,1300,1100,200,0.8461538461538461,15,11,4,323.21529508896873,0.43316373728029606,0.04078447692867937,0.18619021928364554,130688.2812500001,-951.9097222222065,129736.3715277779,1144,3,290.4468085106383,39,8,14,36.11280901928825,0.6217948717948718,44.37500000000001,1022.5000000000008,26.217948717948737,0
1660,4,0,0,47,0.0,0.0,1.0,47,1450,1000,450,0.6896551724137931,19,10,9,325.16042326023177,0.4325084798026519,0.04281319062269806,0.18782796214208702,130794.81336805575,-894.1406249999809,129900.67274305577,1145,4,291.4468085106383,39,8,14,35.955532926001354,0.6228632478632479,44.27083333333334,1022.9166666666682,26.22863247863252,0
1661,4,0,0,47,0.0,0.0,1.0,47,1700,1200,500,0.7058823529411765,22,12,10,322.4866449369992,0.43102451433857536,0.04802116186794181,0.1874465542924759,131034.66932508699,-948.6138237847033,130086.05550130228,1146,5,292.4468085106383,39,8,18,35.781975955505835,0.625267094017094,44.03645833333334,1023.8541666666681,26.252670940170976,0
1662,4,0,2,45,0.0,0.0425531914893617,0.9574468085106383,47,1200,800,400,0.6666666666666666,16,8,8,323.9632619145736,0.4306583410422448,0.04655139293200716,0.1888505330732787,131145.89659139732,-902.7095107079092,130243.18708068941,1147,6,293.4468085106383,40,7,18,35.63204848364587,0.6247395833333333,43.927845528455286,1024.288617886179,25.607215447154477,0
1663,4,1,0,46,0.021739130434782608,0.0,1.0,46,1500,1200,300,0.8,18,12,6,343.6707657295769,0.43037439613526574,0.013893161078641914,0.1896899251930145,129016.12548828141,-288.4242019285048,128727.70128635291,1148,0,298.2391304347826,39,7,16,37.28692453604018,0.6049679487179487,46.01562500000001,1015.9375000000013,26.04967948717952,8
1664,4,1,1,46,0.02127659574468085,0.02127659574468085,0.9787234042553191,47,1400,900,500,0.6428571428571429,19,9,10,337.0961122031665,0.4329131976564909,0.026265034509360907,0.18731185790776983,129280.82817925354,-683.8541666666621,128596.97401258688,1149,0,292.8723404255319,39,8,17,37.1847152514596,0.6076388888888888,45.755208333333336,1016.9791666666672,26.076388888888903,0
1665,4,1,2,45,0.02127659574468085,0.0425531914893617,0.9574468085106383,47,1300,800,500,0.6153846153846154,18,8,10,331.6563070325308,0.43395390070921985,0.05252274782712041,0.1861063554916027,129666.74619108996,-799.0411626677253,128867.70502842224,1150,0,292.7659574468085,40,7,14,36.93125124725603,0.6098958333333333,45.3760162601626,1018.4959349593496,25.46239837398374,0
1666,4,0,1,44,0.0,0.022222222222222223,0.9777777777777777,45,1300,900,400,0.6923076923076923,17,9,8,337.382832967843,0.4289772727272727,0.054765401020907545,0.18943509596675023,129690.63321827762,-248.92135108479795,129441.71186719283,1151,1,306.31111111111113,38,7,16,36.761196769456674,0.6134868421052632,45.35256410256411,1018.589743589745,26.80499325236171,0
1667,4,0,1,43,0.0,0.022727272727272728,0.9772727272727273,44,1050,700,350,0.6666666666666666,14,7,7,341.9046540713143,0.42664288231148695,0.0617833522482687,0.19231101971129846,129759.37307633105,73.06671283470689,129832.43978916576,1152,2,313.95454545454544,37,7,16,36.57626632228442,0.615990990990991,45.28508771929824,1018.859649122806,27.536747273589352,0
1668,4,0,0,43,0.0,0.0,1.0,43,1150,800,350,0.6956521739130435,15,8,7,347.6324081813445,0.4244186046511628,0.07244853105616378,0.1954649096840662,129745.78622118752,420.7680230906705,130166.55424427819,1153,3,321.6046511627907,36,7,16,36.44417118013338,0.6177662037037037,45.29842342342343,1018.8063063063072,28.300175175175198,0
1669,4,0,0,43,0.0,0.0,1.0,43,1250,1100,150,0.88,14,11,3,347.02295507719117,0.4242571059431524,0.07646665782446926,0.1953291533332729,129787.30384589478,407.83474242073487,130195.13858831552,1154,4,322.6046511627907,37,6,16,36.41753201334337,0.6162725225225225,45.257675438596486,1018.9692982456132,27.539710763394954,0
1670,4,0,0,43,0.0,0.0,1.0,43,1150,600,550,0.5217391304347826,17,6,11,348.44040516933455,0.4238879660391288,0.08956201842158595,0.1969694424115284,129954.95158366037,456.31119671437625,130411.26278037475,1155,5,323.6046511627907,37,6,16,36.211218948274016,0.6179617117117118,45.093201754385966,1019.6271929824562,27.557491702228546,0
1671,4,0,0,43,0.0,0.0,1.0,43,1250,1100,150,0.88,14,11,3,348.50604045717967,0.4242571059431524,0.09525357363424303,0.1972887816367757,130010.8582087757,461.91388215603956,130472.77209093173,1156,6,324.6046511627907,37,6,16,36.15281062968138,0.6185247747747749,45.03837719298245,1019.8464912280696,27.563418681839718,0
1672,4,1,0,44,0.022727272727272728,0.0,1.0,44,1450,1100,350,0.7586206896551724,18,11,7,342.0615116004506,0.42534355179704014,0.10647217287758437,0.19545772509488327,130374.544330948,119.46620594798799,130494.01053689599,1157,0,318.20454545454544,37,7,17,35.948572042087186,0.6221846846846847,44.68201754385965,1021.2719298245615,27.601944049312475,0
1673,4,1,0,45,0.022222222222222223,0.0,1.0,45,950,400,550,0.42105263157894735,15,4,11,336.1525620643506,0.42605218855218857,0.11656569876749501,0.19410884373969198,130781.15297866904,-207.5160712981227,130573.63690737092,1158,0,312.1111111111111,38,7,17,35.68823549892067,0.6244517543859649,44.284188034188034,1022.8632478632481,26.91745389113811,0
1674,4,0,0,45,0.0,0.0,1.0,45,850,300,550,0.35294117647058826,14,3,11,337.28075913315587,0.42588383838383836,0.1181441648393724,0.19517449125185685,130863.1260158703,-172.47710296589707,130690.64891290439,1159,1,313.1111111111111,38,7,17,35.576554940656436,0.6252741228070176,44.20405982905982,1023.1837606837597,26.925888439046307,0
1675,4,1,0,46,0.021739130434782608,0.0,1.0,46,1400,900,500,0.6428571428571429,19,9,10,327.4633377022467,0.42610708534621583,0.12166091463872708,0.19166637594600847,131301.4336480033,-600.7188585069629,130700.71478949633,1160,0,307.2826086956522,39,7,18,35.38564640715521,0.6279380341880342,43.77604166666666,1024.895833333332,26.279380341880305,0
1676,4,0,0,46,0.0,0.0,1.0,46,1350,800,550,0.5925925925925926,19,8,11,327.8202186161703,0.425805152979066,0.12647026840893894,0.19228379082156274,131382.8849806413,-586.0040719710012,130796.88090867031,1161,1,308.2826086956522,38,8,19,35.29443691816035,0.6304824561403508,43.69658119658119,1025.2136752136744,26.979307242465115,0
1677,4,0,0,46,0.0,0.0,1.0,46,1900,1500,400,0.7894736842105263,23,15,8,329.9109741686739,0.42433574879227054,0.1322846804907094,0.19420449190640332,131519.83486969466,-522.0326311271821,130997.80223856748,1162,2,309.2826086956522,38,8,19,35.10289726764573,0.6318530701754386,43.56303418803419,1025.7478632478633,26.99336482231219,0
1678,4,0,0,46,0.0,0.0,1.0,46,950,500,450,0.5263157894736842,14,5,9,329.1018963634156,0.4239834943639291,0.12832267090447247,0.19400647702749418,131574.63480029584,-539.7076347797602,131034.92716551608,1163,3,310.2826086956522,38,8,15,35.06846818702487,0.6324013157894737,43.50961538461538,1025.961538461538,26.998987854251002,0
1679,4,0,0,46,0.0,0.0,1.0,46,1550,1100,450,0.7096774193548387,20,11,9,333.90772922326636,0.42328904991948474,0.13687734696647524,0.19783312440416706,131766.52444480968,-400.4278069983149,131366.09663781137,1164,4,311.2826086956522,38,8,15,34.75199445022546,0.6343201754385965,43.322649572649574,1026.7094017094016,27.018668466036885,0
1680,4,0,0,46,0.0,0.0,1.0,46,1300,800,500,0.6153846153846154,18,8,10,335.5637445201722,0.4224537037037037,0.13160608171054933,0.19938874164505158,131876.23844875445,-349.4231225801734,131526.81532617428,1165,5,312.2826086956522,38,8,16,34.59906559877957,0.6354166666666667,43.215811965811966,1027.136752136752,27.029914529914524,0
1681,4,0,1,45,0.0,0.021739130434782608,0.9782608695652174,46,1450,1100,350,0.7586206896551724,18,11,7,332.4531065064735,0.42180958132045093,0.1360949553286963,0.1985432239415756,132068.3478180474,-418.69349934253796,131649.65431870485,1166,6,313.2826086956522,38,8,18,34.485760315975455,0.6373355263157895,43.02884615384615,1027.8846153846157,27.04959514170041,0
1682,4,0,0,45,0.0,0.0,1.0,45,1450,1300,150,0.896551724137931,16,13,3,330.44574401361564,0.4219486531986532,0.1371158392434988,0.19766663596450826,132130.12695312503,-267.63237847221995,131862.4945746528,1167,7,316.53333333333336,39,6,19,34.475261735900034,0.6362179487179487,42.96875,1028.1250000000002,26.362179487179493,0
1683,4,0,1,44,0.0,0.022222222222222223,0.9777777777777777,45,1300,900,400,0.6923076923076923,17,9,8,333.1714256303522,0.42165404040404036,0.14384804087052472,0.1998623728234565,132237.24500868042,-188.46571180556367,132048.77929687485,1168,8,317.53333333333336,39,6,19,34.29756599824455,0.6372863247863247,42.86458333333333,1028.5416666666656,26.372863247863222,0
1684,4,1,0,45,0.022222222222222223,0.0,1.0,45,1550,1400,150,0.9032258064516129,17,14,3,322.8374380495362,0.4224116161616162,0.14373551889891778,0.19534400912488858,132562.98539201164,-440.64342691898895,132122.34196509267,1169,0,314.3777777777778,38,7,20,34.23656499636891,0.6422697368421053,42.54807692307691,1029.8076923076908,27.100202429149757,0
1685,4,0,0,45,0.0,0.0,1.0,45,1350,900,450,0.6666666666666666,18,9,9,323.87289984845336,0.42192760942760943,0.1447667823489116,0.19693144426556522,132746.6484917533,-401.391601562519,132345.25689019077,1170,1,315.3777777777778,39,6,15,34.02584740051887,0.6423611111111112,42.36979166666666,1030.520833333332,26.423611111111075,0
1686,4,1,0,46,0.021739130434782608,0.0,1.0,46,1350,900,450,0.6666666666666666,18,9,9,317.585334845023,0.42271537842190016,0.16334543965160564,0.19514709027718669,133139.26214293577,-743.3845702632998,132395.87757267247,1171,0,309.5,41,5,17,33.79503909128778,0.6430386178861789,41.9890873015873,1032.04365079365,25.17179636082073,0
1687,4,0,1,45,0.0,0.021739130434782608,0.9782608695652174,46,1200,900,300,0.75,15,9,6,317.28062089875647,0.42285628019323673,0.162627748205467,0.1953622568681928,133216.06217718564,-746.625015747043,132469.4371614386,1172,1,310.5,41,5,17,33.72613556281632,0.6438008130081301,41.91468253968254,1032.3412698412694,25.17905536198218,0
1688,4,0,0,45,0.0,0.0,1.0,45,1100,600,500,0.5454545454545454,16,6,10,307.77679538102035,0.4202020202020202,0.11276077778804972,0.17947286229846343,131158.31723664197,-926.5026866678193,130231.81454997415,1173,2,317.1777777777778,43,2,15,36.03403978305753,0.6203972868217054,43.915719696969695,1024.337121212121,23.821793516560955,8
1689,4,0,1,44,0.0,0.022222222222222223,0.9777777777777777,45,1250,600,650,0.48,19,6,13,309.3396787626412,0.4203493265993266,0.11382113821138207,0.18118466898954705,131328.12500000015,-874.9999999999847,130453.12500000016,1174,3,318.1777777777778,43,2,16,35.82317073170733,0.622093023255814,43.75000000000001,1025.0000000000011,23.837209302325608,0
1690,4,0,1,43,0.0,0.022727272727272728,0.9772727272727273,44,1250,1000,250,0.8,15,10,5,316.4897823232276,0.418560606060606,0.12680305375738832,0.18586581761891363,131429.83119173592,-480.76026706978786,130949.07092466614,1175,4,326.02272727272725,41,3,17,35.53760319917441,0.6260162601626016,43.65079365079365,1025.3968253968253,25.00967866821525,0
1691,4,0,1,42,0.0,0.023255813953488372,0.9767441860465116,43,1300,900,400,0.6923076923076923,17,9,8,323.97815814154706,0.41662052417866374,0.11629981947752199,0.18988772116059213,131354.16795764773,-88.82372017315976,131265.34423747458,1176,5,333.8139534883721,40,3,17,35.42183007831863,0.6268229166666667,43.72459349593497,1025.1016260162617,25.62754065040654,0
1692,4,0,0,42,0.0,0.0,1.0,42,1150,700,450,0.6086956521739131,16,7,9,350.9378729910933,0.41471883468834686,0.08341955444925975,0.1960929686795393,129500.26167223671,693.4404154813069,130193.70208771802,1177,6,341.42857142857144,38,4,16,36.60954830131905,0.6115679824561404,45.53952991452991,1017.8418803418793,26.78531264057577,7
1693,4,0,0,42,0.0,0.0,1.0,42,850,400,450,0.47058823529411764,13,4,9,346.36559600288047,0.41446476964769646,0.08089043422656528,0.1942092271234973,129636.22708013727,580.3058112352921,130216.53289137255,1178,7,342.42857142857144,38,4,17,36.58772205902923,0.6129385964912281,45.4059829059829,1018.3760683760678,26.799370220422837,0
1694,4,0,0,42,0.0,0.0,1.0,42,1200,700,500,0.5833333333333334,17,7,10,345.9302231257401,0.4147430313588851,0.07937423527355358,0.19436916190359066,129717.84056770042,574.6643061947651,130292.50487389519,1179,8,343.42857142857144,38,4,17,36.515906310085654,0.6137609649122807,45.325854700854705,1018.6965811965819,26.807804768331103,0
1695,4,0,0,42,0.0,0.0,1.0,42,1000,800,200,0.8,12,8,4,345.8295104715763,0.4139082462253194,0.08194464226368514,0.19508830090156973,129873.84018276156,582.8413146936334,130456.6814974552,1180,9,344.42857142857144,40,2,17,36.36008640744433,0.6119791666666667,45.172764227642276,1019.3089430894307,25.482723577235767,0
1696,4,0,0,42,0.0,0.0,1.0,42,1050,700,350,0.6666666666666666,14,7,7,343.56863893729076,0.4139687379016647,0.07193611581498827,0.19497374597464476,130107.01844346964,540.138248562381,130647.15669203202,1181,10,345.42857142857144,40,2,18,36.18118504499122,0.6143229166666666,44.94410569105692,1020.2235772357735,25.50558943089434,0
1697,4,0,0,42,0.0,0.0,1.0,42,1500,1000,500,0.6666666666666666,20,10,10,343.33354184482516,0.413666279519938,0.07469580144346111,0.19522963913962274,130184.79100568459,539.3610780620141,130724.1520837466,1182,11,346.42857142857144,40,2,18,36.10834495120494,0.6151041666666667,44.867886178861795,1020.528455284554,25.513211382113848,0
1698,4,0,0,42,0.0,0.0,1.0,42,1450,800,650,0.5517241379310345,21,8,13,348.2826889888868,0.4134243128145567,0.05058328552304414,0.1877107999095951,128067.37061273075,539.3843157181769,128606.75492844894,1183,12,347.42857142857144,40,2,18,38.137968540829974,0.59375,46.95121951219513,1012.1951219512214,25.304878048780534,8
1699,4,0,0,42,0.0,0.0,1.0,42,1100,800,300,0.7272727272727273,14,8,6,348.25689147161916,0.41312185443283006,0.048278991111386116,0.18831971016580068,128200.04712988618,529.3796929623207,128729.4268228485,1184,13,348.42857142857144,37,5,19,38.003013570088065,0.6002252252252251,46.82017543859649,1012.7192982456145,27.370791844476067,0
1700,4,1,0,43,0.023255813953488372,0.0,1.0,43,1150,900,250,0.782608695652174,14,9,5,341.0847719251967,0.4154900332225913,0.05089807483718034,0.18589693000671167,128513.93771701414,166.8294270833593,128680.7671440975,1185,0,341.30232558139534,39,4,18,37.86427299500033,0.5998931623931624,46.51041666666668,1013.9583333333354,25.99893162393168,0
1701,4,1,0,44,0.022727272727272728,0.0,1.0,44,650,500,150,0.7692307692307693,8,5,3,336.3865232687997,0.41741543340380555,0.06356402580504272,0.1849663045667905,128865.81776926779,-130.25511848104634,128735.56265078674,1186,0,334.52272727272725,40,4,19,37.62490408033897,0.6018229166666667,46.16361788617887,1015.3455284552858,25.383638211382145,0
1702,4,1,1,44,0.022222222222222223,0.022222222222222223,0.9777777777777777,45,1150,800,350,0.6956521739130435,15,8,7,329.2125772641766,0.41877104377104374,0.07795992714025557,0.18256333830104327,129201.38888888876,-491.7465009253831,128709.64238796338,1187,0,328.06666666666666,38,7,20,37.46584699453554,0.6085526315789473,45.83333333333333,1016.6666666666656,26.754385964912252,0
1703,4,2,1,45,0.043478260869565216,0.021739130434782608,0.9782608695652174,46,1650,1300,350,0.7878787878787878,20,13,7,322.03038172832,0.423419887278583,0.09326200308495225,0.18112588635334642,129757.97661675335,-842.7978515625091,128915.17876519084,1188,0,320.7826086956522,39,7,19,37.083908427904454,0.6124465811965811,45.28645833333333,1018.8541666666656,26.124465811965784,0
1704,4,1,0,46,0.021739130434782608,0.0,1.0,46,1600,1200,400,0.75,20,12,8,321.51398136062323,0.4216485507246377,0.10318588789407102,0.18132647306130814,129864.12896050337,-849.3733723958385,129014.75558810752,1189,0,321.7608695652174,39,7,20,36.98954607392268,0.6135149572649572,45.182291666666664,1019.2708333333325,26.13514957264955,0
1705,4,0,0,46,0.0,0.0,1.0,46,1000,500,500,0.5,15,5,10,319.20021104684554,0.42160829307568437,0.1021919049671034,0.180266154963386,129917.22140842023,-906.0791015624964,129011.14230685773,1190,1,322.7608695652174,39,7,20,36.99475920438677,0.6140491452991452,45.130208333333336,1019.4791666666674,26.140491452991473,0
1706,4,0,1,45,0.0,0.021739130434782608,0.9782608695652174,46,1300,900,400,0.6923076923076923,17,9,8,315.67037871786243,0.42184983896940415,0.11749363674600288,0.17772189148815343,129796.16057117155,-1004.9809254344614,128791.1796457371,1191,2,323.7608695652174,40,6,14,37.207248761676816,0.6111979166666667,45.24898373983741,1019.0040650406527,25.47510162601632,8
1707,4,0,2,43,0.0,0.044444444444444446,0.9555555555555556,45,1450,1000,450,0.6896551724137931,19,10,9,324.12969952518336,0.4214225589225589,0.10430338342021894,0.18255387740097131,129811.0473632814,-584.8768446180404,129226.17051866335,1192,3,331.26666666666665,39,6,15,36.97666445194045,0.6129807692307692,45.23437500000001,1019.0625000000011,26.129807692307722,0
1708,4,0,0,43,0.0,0.0,1.0,43,1100,800,300,0.7272727272727273,14,8,6,331.8356529261966,0.41719730527870064,0.09083257911928921,0.1861912465771296,129663.42872242315,5.3897061509275375,129668.81842857409,1193,4,345.83720930232556,38,5,16,36.930050001748306,0.6132127192982456,45.379273504273506,1018.4829059829062,26.80218173639227,0
1709,4,0,0,43,0.0,0.0,1.0,43,950,400,550,0.42105263157894735,15,4,11,332.6975378635605,0.41726651901070505,0.08954000614691071,0.18680437726685456,129690.63321827762,29.550871137423968,129720.18408941505,1194,5,346.83720930232556,38,5,16,36.88050660792951,0.6134868421052632,45.35256410256411,1018.589743589745,26.80499325236171,0
1710,4,0,0,43,0.0,0.0,1.0,43,950,700,250,0.7368421052631579,12,7,5,333.5559394623473,0.417312661498708,0.09156016591439453,0.18767687284085002,129772.26382725194,57.26187541092992,129829.52570266287,1195,6,347.83720930232556,38,5,16,36.7758467023173,0.6143092105263157,45.272435897435905,1018.9102564102575,26.813427800269935,0
1711,4,1,2,42,0.022727272727272728,0.045454545454545456,0.9545454545454546,44,1100,1000,100,0.9090909090909091,12,10,2,327.6250587380921,0.42052061310782246,0.09284016636957815,0.18565419995158558,130050.00000000003,-278.4722222222209,129771.52777777781,1196,0,340.90909090909093,39,5,17,36.64556100217864,0.6153846153846154,45.0,1020.0000000000002,26.15384615384616,0
1712,4,0,0,42,0.0,0.0,1.0,42,1200,800,400,0.6666666666666666,16,8,8,340.4280207157258,0.4170417150600077,0.09447467388074227,0.19175381966860347,129815.2376211912,438.54888042475284,130253.78650161596,1197,1,357.7857142857143,37,5,17,36.557187432752315,0.6165540540540541,45.23026315789474,1019.0789473684216,27.542674253200584,0
1713,4,0,0,42,0.0,0.0,1.0,42,1150,600,550,0.5217391304347826,17,6,11,339.37453318460325,0.4165577816492451,0.09177088774851727,0.19170743678921265,129927.00277970143,418.7831832871658,130345.7859629886,1198,2,358.7857142857143,37,5,17,36.47065677206568,0.6176801801801801,45.12061403508772,1019.5175438596491,27.554528212422948,0
1714,4,0,0,42,0.0,0.0,1.0,42,1550,1300,250,0.8387096774193549,18,13,5,342.86270291840435,0.41695702671312423,0.09311128514611222,0.19437243907677768,130066.77685682158,519.0093346029807,130585.78619142456,1199,3,359.7857142857143,37,5,18,36.23998978824036,0.6190878378378378,44.98355263157896,1020.0657894736862,27.569345661450978,0
1715,4,0,0,42,0.0,0.0,1.0,42,1000,800,200,0.8,12,8,4,346.4858430503931,0.4166545683313976,0.09682676121915357,0.1969910654410516,130178.65022170314,621.011873845832,130799.66209554896,1200,4,360.7857142857143,37,5,18,36.03414544608003,0.6202139639639639,44.873903508771946,1020.5043859649147,27.58119962067337,0
1716,4,0,0,42,0.0,0.0,1.0,42,950,700,250,0.7368421052631579,12,7,5,347.62833925081856,0.41600125822686795,0.09740164261558193,0.1985071650079612,130348.82010388775,662.6158227964437,131011.4359266842,1201,5,361.7857142857143,36,6,18,35.83250624908101,0.6238425925925926,44.70720720720721,1021.1711711711717,28.36586586586588,0
1717,4,1,0,43,0.023255813953488372,0.0,1.0,43,850,400,450,0.47058823529411764,13,4,9,345.8238613085696,0.417312661498708,0.1116628218716873,0.19918514556531272,130682.67549871113,438.63748941981845,131121.31298813096,1202,0,354.3488372093023,37,6,16,35.540549597855225,0.6252815315315315,44.38048245614035,1022.4780701754386,27.634542437174016,0
1718,4,0,0,43,0.0,0.0,1.0,43,850,600,250,0.7058823529411765,11,6,5,347.97433227836314,0.41678202288667404,0.11680007578269347,0.20100634958667785,130794.81336805545,502.6475694444344,131297.46093749988,1203,1,355.3488372093023,37,6,16,35.37211473183978,0.6264076576576576,44.27083333333333,1022.9166666666657,27.64639639639637,0
1719,4,0,0,43,0.0,0.0,1.0,43,1000,600,400,0.6,14,6,8,342.425233706,0.41705887781469175,0.08251647057980693,0.18724757726348895,128645.99745008703,211.41221788196438,128857.409667969,1204,2,356.3488372093023,39,4,17,37.69562668994078,0.6012286324786325,46.38020833333334,1014.4791666666684,26.01228632478637,8
1720,4,0,0,43,0.0,0.0,1.0,43,1600,1100,500,0.6875,21,11,10,346.47285252983374,0.41671280915466963,0.09340500714590738,0.19047213161919285,128857.43408203126,329.1205512152785,129186.55463324655,1205,3,357.3488372093023,39,4,18,37.37741954789507,0.6033653846153846,46.171875,1015.3125000000001,26.03365384615385,0
1721,4,0,0,43,0.0,0.0,1.0,43,1050,500,550,0.47619047619047616,16,5,11,342.79818369925005,0.41652823920265786,0.10080311194245128,0.18910654769634125,128994.83194527071,243.83881948576095,129238.67076475646,1206,4,358.3488372093023,40,3,18,37.33076563958917,0.603125,46.03658536585366,1015.8536585365856,25.39634146341464,0
1722,4,1,0,44,0.022727272727272728,0.0,1.0,44,1200,800,400,0.6666666666666666,16,8,8,340.15212937659794,0.41912218111346017,0.10121596961007073,0.18913698127751127,129307.3133680554,-2.8379116680064556,129304.4754563874,1207,0,351.1818181818182,39,5,20,37.08009012699713,0.607905982905983,45.72916666666666,1017.0833333333321,26.079059829059798,0
1723,4,0,0,44,0.0,0.0,1.0,44,1600,1300,300,0.8125,19,13,6,338.83119877125876,0.41870375264270615,0.09923258559622194,0.18863739152949377,129356.41503899782,-34.00216471678502,129322.41287428103,1208,1,352.1818181818182,40,4,20,37.06376956376956,0.6067708333333333,45.68089430894308,1017.2764227642266,25.431910569105664,0
1724,4,3,0,47,0.06382978723404255,0.0,1.0,47,1400,1200,200,0.8571428571428571,16,12,4,349.8297676493807,0.42691951896392233,0.17696093200763285,0.18818233368367843,127990.23321311736,-376.7070898605131,127613.52612325684,1209,0,330.63829787234044,40,7,18,38.177705801613634,0.59296875,47.027439024390254,1011.8902439024404,25.29725609756101,7
1725,4,2,2,47,0.04081632653061224,0.04081632653061224,0.9591836734693877,49,950,700,250,0.7368421052631579,12,7,5,340.07158739715004,0.43172477324263037,0.19842085180075775,0.18534472742014868,128513.93771701379,-1058.9333877094539,127455.00432930434,1210,0,318.1020408163265,39,10,17,37.889956167385805,0.5998931623931624,46.510416666666664,1013.9583333333325,25.9989316239316,0
1726,4,1,0,48,0.020833333333333332,0.0,1.0,48,1600,1300,300,0.8125,19,13,6,345.1412060386147,0.4294012263593381,0.21468878248974055,0.18969791098814048,128848.6207561726,-705.8063271605192,128142.81442901208,1211,0,325.2291666666667,38,10,20,37.42020063839489,0.6049890350877193,46.18055555555554,1015.2777777777759,26.71783625730989,0
1727,4,1,1,48,0.02040816326530612,0.02040816326530612,0.9795918367346939,49,1800,1100,700,0.6111111111111112,25,11,14,337.6173079018919,0.43140589569161,0.22790580979686226,0.1873529982100464,129228.54487407736,-1073.5590620206435,128154.98581205671,1212,0,319.57142857142856,38,11,21,37.2246156001541,0.6088267543859649,45.80662393162391,1016.7735042735012,26.75719748088161,0
1728,4,0,1,47,0.0,0.020833333333333332,0.9791666666666666,48,1500,1100,400,0.7333333333333333,19,11,8,345.284776298476,0.430786421394799,0.22575622775800763,0.191611354315725,129229.25954380188,-675.8208054401439,128553.43873836173,1213,1,325.0833333333333,37,11,21,37.02898648405767,0.6106418918918919,45.805921052631575,1016.7763157894731,27.480440967283055,0
1729,4,0,0,47,0.0,0.0,1.0,47,1200,800,400,0.6666666666666666,16,8,8,351.3840365493145,0.43106305889608393,0.22218346703871594,0.1948584202682564,129201.38888888908,-320.1388888888695,128881.2500000002,1214,2,318.97872340425533,36,11,22,36.902322404371574,0.6122685185185186,45.83333333333334,1016.6666666666682,28.240740740740783,0
1730,4,0,0,47,0.0,0.0,1.0,47,1300,800,500,0.6153846153846154,18,8,10,351.00959501447676,0.4306197964847363,0.22605935991417936,0.19518757853608745,129310.02995105543,-322.1877511140441,128987.84219994138,1215,3,319.97872340425533,38,9,22,36.80125175070028,0.6096491228070176,45.72649572649572,1017.0940170940158,26.76563202878989,0
1731,4,1,0,48,0.020833333333333332,0.0,1.0,48,1350,900,450,0.6666666666666666,18,9,9,343.3189156815148,0.43116504137115835,0.22968648805262948,0.19283835016941625,129704.91672092023,-693.9697265624878,129010.94699435774,1216,0,314.2916666666667,39,9,18,36.59553209257935,0.6119123931623931,45.33854166666667,1018.645833333334,26.11912393162395,0
1732,4,0,0,48,0.0,0.0,1.0,48,1600,900,700,0.5625,23,9,14,341.7466503384987,0.43108192966903075,0.229967129913482,0.19286809228446086,129890.67382812513,-722.0594618055404,129168.61436631958,1217,1,315.2916666666667,39,9,18,36.44705020777984,0.6137820512820513,45.15625000000001,1019.375000000001,26.13782051282054,0
1733,4,0,0,48,0.0,0.0,1.0,48,1250,900,350,0.72,16,9,7,341.4120256674851,0.43100805260047287,0.22909855605503315,0.192941160925713,129943.77170138911,-727.1267361110849,129216.64496527803,1218,2,316.2916666666667,39,9,18,36.401716387413174,0.6143162393162394,45.10416666666668,1019.5833333333352,26.14316239316244,0
1734,4,1,0,49,0.02040816326530612,0.0,1.0,49,1250,800,450,0.64,17,8,9,337.24769120211965,0.43266369047619047,0.2298458212436707,0.19202470580692138,130236.65229030357,-1015.5979410403656,129221.0543492632,1219,0,310.81632653061223,40,9,20,36.21108787999471,0.615625,44.81707317073172,1020.7317073170746,25.518292682926862,0
1735,4,1,0,50,0.02,0.0,1.0,50,500,300,200,0.6,7,3,4,328.8918151526666,0.43380102040816326,0.2319465687774036,0.1882920041565795,130448.74267578151,-1419.2900834722118,129029.4525923093,1220,0,305.58,39,11,21,36.20978637707761,0.6193910256410257,44.609375000000014,1021.562500000002,26.19391025641031,0
1736,4,1,1,50,0.0196078431372549,0.0196078431372549,0.9803921568627451,51,900,500,400,0.5555555555555556,13,5,8,321.30019702204777,0.4354575163398693,0.23651765952804027,0.1854108476393287,130755.83316808795,-1797.6250082622548,128958.20815982569,1221,0,300.5686274509804,40,11,15,36.09358439321675,0.6208333333333333,44.308943089430905,1022.7642276422778,25.569105691056944,0
1737,4,0,1,49,0.0,0.02,0.98,50,1000,600,400,0.6,14,6,8,326.42014553806234,0.43433673469387757,0.23413799960230608,0.18760764707553337,130599.97046235722,-1473.907726882131,129126.06273547509,1222,1,307.56,40,10,15,36.120086829720954,0.6192708333333333,44.461382113821145,1022.1544715447167,25.553861788617915,0
1738,4,0,0,49,0.0,0.0,1.0,49,1300,700,600,0.5384615384615384,19,7,12,333.02910570677795,0.4326814058956916,0.23614609443976486,0.1910215435186339,130522.07396597594,-1106.470086423421,129415.60387955252,1223,2,314.7755102040816,40,9,15,36.02996021879662,0.6184895833333333,44.53760162601626,1021.849593495935,25.546239837398375,0
1739,4,0,2,47,0.0,0.04081632653061224,0.9591836734693877,49,1650,1200,450,0.7272727272727273,21,12,9,336.35110094401693,0.4317602040816326,0.24480870769936058,0.19370511886649994,130677.8901963943,-1009.2695526802877,129668.62064371402,1224,3,315.7755102040816,40,9,15,35.78752940396913,0.6200520833333334,44.385162601626014,1022.4593495934956,25.561483739837392,0
1740,4,1,1,47,0.020833333333333332,0.020833333333333332,0.9791666666666666,48,1450,1100,350,0.7586206896551724,18,11,7,330.25514679969206,0.43237477836879434,0.2502866046631791,0.192158603453575,131074.03175390515,-942.4252802973197,130131.60647360783,1225,0,315.7083333333333,41,7,17,35.5434185881289,0.6224593495934959,43.998015873015866,1024.0079365079355,24.97580332946184,0
1741,4,0,1,46,0.0,0.02127659574468085,0.9787234042553191,47,1100,800,300,0.7272727272727273,14,8,6,330.91321884820985,0.43229648473635524,0.2427967989056663,0.19290192786414734,131145.89659139735,-720.4178440412434,130425.4787473561,1226,1,315.1914893617021,40,7,17,35.45407943909779,0.6247395833333333,43.927845528455286,1024.2886178861793,25.60721544715448,0
1742,4,2,1,47,0.041666666666666664,0.020833333333333332,0.9791666666666666,48,600,400,200,0.6666666666666666,8,4,4,325.46818595499167,0.43482195626477543,0.2521248389334918,0.19102085678300815,131406.26161882802,-1046.1619654306337,130360.0996533974,1227,0,309.375,40,8,20,35.33117752007138,0.62734375,43.673780487804876,1025.3048780487802,25.632621951219505,0
1743,4,0,2,45,0.0,0.0425531914893617,0.9574468085106383,47,1300,900,400,0.6923076923076923,17,9,8,331.9953717358617,0.4340695343817453,0.2512696778983248,0.1947191459343822,131380.21349725698,-676.4754362482579,130703.73806100871,1228,1,316.4255319148936,40,7,20,35.19011862278616,0.6270833333333333,43.69918699186992,1025.2032520325206,25.630081300813014,0
1744,4,0,0,45,0.0,0.0,1.0,45,900,700,200,0.7777777777777778,11,7,4,334.7769120457206,0.43449074074074073,0.2325655723467086,0.19622385284536864,131355.50356353624,-205.04202735775078,131150.46153617848,1229,2,299.8,38,7,20,35.143738058016325,0.6302083333333333,43.72329059829059,1025.1068376068363,26.976495726495692,0
1745,4,0,1,44,0.0,0.022222222222222223,0.9777777777777777,45,1850,1600,250,0.8648648648648649,21,16,5,347.8116073965793,0.4337962962962963,0.24155583554995563,0.19394366211036443,129418.71667031935,61.66390441231556,129480.38057473167,1230,3,300.8,38,7,18,36.77201455970881,0.6107456140350878,45.619658119658126,1017.5213675213686,26.776878092667594,8
1746,4,0,1,43,0.0,0.022727272727272728,0.9772727272727273,44,1650,1100,550,0.6666666666666666,22,11,11,349.5041526816358,0.4305518851303735,0.2507585298832149,0.1954269698797319,129527.44904668005,254.07626561475152,129781.5253122948,1231,4,308.5681818181818,38,6,18,36.61838790931989,0.611842105263158,45.512820512820525,1017.9487179487198,26.78812415654526,0
1747,4,0,0,43,0.0,0.0,1.0,43,950,500,450,0.5263157894736842,14,5,9,360.78929323559714,0.4285944998154301,0.23018738961793206,0.19624598169231944,128434.73442925338,671.7359152849635,129106.47034453835,1232,7,316.6511627906977,39,4,17,37.445727571678155,0.5990918803418803,46.588541666666664,1013.6458333333326,25.990918803418783,8
1748,4,1,0,44,0.022727272727272728,0.0,1.0,44,1400,900,500,0.6428571428571429,19,9,10,363.10524738953177,0.43073907681465823,0.24315679315679328,0.19952813099127728,128840.02267995237,556.4976617753961,129396.52034172777,1233,0,310.4318181818182,40,4,18,36.973014681348005,0.6015625,46.1890243902439,1015.243902439024,25.3810975609756,0
1749,4,1,1,44,0.022222222222222223,0.022222222222222223,0.9777777777777777,45,1500,1100,400,0.7333333333333333,19,11,8,362.4348257209687,0.4319234006734007,0.25275564660950534,0.20128649676260632,129260.23046339171,372.7182072015162,129632.94867059322,1234,0,304.5111111111111,35,10,20,36.56148038546174,0.6148809523809524,45.77546296296297,1016.8981481481487,29.05423280423282,0
1750,4,0,0,44,0.0,0.0,1.0,44,1050,700,350,0.6666666666666666,14,7,7,363.0388558824278,0.430794133192389,0.2516813340001911,0.20178535756692145,129292.1786422903,587.6169217687107,129879.79556405901,1235,1,309.25,34,10,20,36.51356861367981,0.6173406862745099,45.74404761904762,1017.0238095238099,29.912464985994408,0
1751,4,0,0,44,0.0,0.0,1.0,44,1150,1000,150,0.8695652173913043,13,10,3,358.8747096728759,0.4302545806906272,0.24935625339475687,0.20046413016214207,129487.77113261937,493.9772542813368,129981.7483869007,1236,2,310.25,36,8,17,36.420299476285315,0.615162037037037,45.551801801801815,1017.7927927927949,28.27202202202208,0
1752,4,0,1,43,0.0,0.022727272727272728,0.9772727272727273,44,1350,900,450,0.6666666666666666,18,9,9,362.90936448523263,0.4292415433403805,0.26076938539625094,0.20375637503221206,129688.42734203831,613.0289495577033,130301.45629159601,1237,3,311.25,36,8,17,36.11341440943431,0.6171875,45.35472972972975,1018.5810810810837,28.29391891891899,0
1753,4,0,0,43,0.0,0.0,1.0,43,1250,800,450,0.64,17,8,9,364.86765550529566,0.42787929125138424,0.2774687047807125,0.19366376020451126,127451.59718615358,700.5930911434496,128152.19027729704,1238,4,317.2093023255814,37,6,18,38.349599124045334,0.5926238738738738,47.56030701754387,1009.7587719298258,27.29077761972502,8
1754,4,1,0,44,0.022727272727272728,0.0,1.0,44,1200,700,500,0.5833333333333334,17,7,10,357.3458977649743,0.4300673890063425,0.2740599337271281,0.19141363454134042,127820.21747616719,335.2060733070578,128155.42354947425,1239,0,310.97727272727275,38,6,19,38.16164817749605,0.5945723684210527,47.19551282051283,1011.2179487179502,26.610998650472375,0
1755,4,0,0,44,0.0,0.0,1.0,44,750,500,250,0.6666666666666666,10,5,5,356.06995033267197,0.4299792988019732,0.2755186781747134,0.1912436959557615,127928.27641034791,310.28300551539706,128238.5594158633,1240,1,311.97727272727275,38,6,19,38.08326292815151,0.5956688596491229,47.088675213675224,1011.6452991453007,26.622244714350018,0
1756,4,1,0,45,0.022222222222222223,0.0,1.0,45,1200,900,300,0.75,15,9,6,344.9135888292133,0.43354377104377106,0.27259800934389644,0.1867997357322569,128261.745541838,-151.4256935820469,128110.31984825595,1241,0,306.02222222222224,35,10,20,38.02464198659354,0.6047619047619048,46.75925925925925,1012.9629629629618,28.941798941798908,0
1757,4,0,1,44,0.0,0.022222222222222223,0.9777777777777777,45,1400,1000,400,0.7142857142857143,18,10,8,344.69091833961454,0.4328703703703704,0.20647109010960207,0.18066926462816288,126942.00857426273,-233.36281529075518,126708.64575897196,1242,1,307.02222222222224,41,4,20,39.38152195314039,0.5807926829268293,48.065476190476176,1007.7380952380927,24.578977932636406,7
1758,4,1,1,44,0.022222222222222223,0.022222222222222223,0.9777777777777777,45,900,400,500,0.4444444444444444,14,4,10,343.86280874618996,0.430976430976431,0.2174428859652302,0.1810249714962051,127119.65610812917,-257.3012923717819,126862.3548157574,1243,0,307.97777777777776,37,8,22,39.220103475771054,0.5892454954954955,47.8892543859649,1008.4429824561383,27.255215742057793,0
1759,4,3,1,46,0.06382978723404255,0.02127659574468085,0.9787234042553191,47,850,800,50,0.9411764705882353,9,8,1,333.8455547180894,0.4372109158186864,0.2278858465910094,0.17839412241103167,127723.00347222202,-872.0486111111294,126850.95486111089,1244,0,295.6170212765957,39,8,16,38.85511129431163,0.5918803418803419,47.29166666666666,1010.8333333333317,25.918803418803375,0
1760,4,0,0,46,0.0,0.0,1.0,46,1200,500,700,0.4166666666666667,19,5,14,343.03430051810847,0.4349738325281804,0.2310424727304523,0.18311734399638152,127681.91599122541,-440.14465182762495,127241.77133939779,1245,1,303.04347826086956,40,6,17,38.6649488855371,0.58984375,47.33231707317073,1010.6707317073166,25.266768292682915,0
1761,4,0,0,46,0.0,0.0,1.0,46,1250,900,350,0.72,16,9,7,354.7084351722901,0.43488325281803547,0.23633787239925352,0.18623673265723753,127011.23078977653,-162.1162862547672,126849.11450352176,1246,2,304.04347826086956,38,8,17,39.05802861685215,0.5863486842105263,47.996794871794876,1008.012820512821,26.526653171390027,8
1762,4,2,1,47,0.041666666666666664,0.020833333333333332,0.9791666666666666,48,850,600,250,0.7058823529411765,11,6,5,340.9032381977798,0.43971631205673756,0.23788839623290015,0.18145332623721583,127565.10959201398,-902.502529688518,126662.60706232546,1247,0,292.3333333333333,39,9,17,38.83833436447375,0.5902777777777778,47.44791666666667,1010.2083333333342,25.9027777777778,0
1763,4,1,0,48,0.020833333333333332,0.0,1.0,48,1950,1400,550,0.717948717948718,25,14,11,339.1572398151744,0.4384511672576832,0.2400870446700849,0.181278724580416,127733.27637525625,-935.6669104038452,126797.6094648524,1248,0,293.3125,40,8,18,38.71037331188634,0.5903645833333333,47.28150406504066,1010.8739837398383,25.271849593495958,0
1764,4,0,2,46,0.0,0.041666666666666664,0.9583333333333334,48,1450,1000,450,0.6896551724137931,19,10,9,341.38018437050886,0.43809101654846333,0.2396210142015005,0.1830504092055661,127861.72251966438,-870.1083184612162,126991.61420120316,1249,1,294.3125,40,8,19,38.522826232583064,0.5916666666666667,47.154471544715456,1011.3821138211396,25.284552845528488,0
1765,4,2,2,46,0.041666666666666664,0.041666666666666664,0.9583333333333334,48,1200,700,500,0.5833333333333334,17,7,10,343.60581224489806,0.4406767139479906,0.27376666666666694,0.1858189652127848,128203.13169795947,-788.1696732304906,127414.96202472899,1250,0,294.5625,35,13,21,38.117619047619044,0.6041666666666667,46.817129629629626,1012.731481481481,28.93518518518517,0
1766,4,0,1,45,0.0,0.021739130434782608,0.9782608695652174,46,1600,1400,200,0.875,18,14,4,352.4756359681145,0.439975845410628,0.26763197348694057,0.19078003479217204,128237.60880730968,-159.8734561226483,128077.73535118703,1251,1,300.9347826086956,33,13,21,37.85780903407944,0.6089015151515151,46.783088235294116,1012.8676470588234,30.692959001782526,0
1767,4,0,0,45,0.0,0.0,1.0,45,1350,800,550,0.5925925925925926,19,8,11,352.91507963988914,0.44002525252525254,0.25829678362573105,0.19158247180451138,128355.55555555563,59.72222222223428,128415.27777777787,1252,2,298.77777777777777,34,11,21,37.726151315789465,0.607843137254902,46.66666666666667,1013.333333333334,29.803921568627473,0
1768,4,0,1,44,0.0,0.022222222222222223,0.9777777777777777,45,1100,600,500,0.5454545454545454,16,6,10,352.9780095158659,0.43952020202020203,0.26144711946238686,0.19205161348419167,128446.04768990936,67.72604875284316,128513.7737386622,1253,3,299.77777777777777,34,11,18,37.63211978860833,0.6087622549019608,46.577380952380956,1013.6904761904767,29.814425770308137,0
1769,4,1,0,45,0.022222222222222223,0.0,1.0,45,1300,700,600,0.5384615384615384,19,7,12,351.17251641720077,0.4396464646464646,0.2650487113084228,0.19222748316640226,128686.69979100728,38.246439006581454,128724.94623001387,1254,0,299.4888888888889,36,9,19,37.43225120236773,0.6070601851851851,46.340090090090094,1014.6396396396401,28.184434434434447,0
1770,4,0,0,45,0.0,0.0,1.0,45,1550,1100,450,0.7096774193548387,20,11,9,349.2356345217325,0.4390151515151515,0.2591928574000073,0.19190342670841073,128839.3438966797,-0.9419965758765443,128838.40190010383,1255,1,300.4888888888889,37,8,19,37.32573262051338,0.6067004504504505,46.18969298245614,1015.241228070175,27.43895211000473,0
1771,4,0,0,45,0.0,0.0,1.0,45,1400,1100,300,0.7857142857142857,17,11,6,351.7840048826669,0.4383207070707071,0.26824645657330515,0.19414475347819365,129011.37689248659,76.82776773320944,129088.2046602198,1256,2,301.4888888888889,38,7,20,37.08569951274231,0.6066337719298245,46.02029914529914,1015.9188034188028,26.73470535312639,0
1772,4,1,2,44,0.021739130434782608,0.043478260869565216,0.9565217391304348,46,450,200,250,0.4444444444444444,7,2,5,344.911309231022,0.4417471819645733,0.2679462972481914,0.19170964962658568,129292.1786422902,-280.4339539344235,129011.74468835577,1257,0,295.9130434782609,34,12,21,36.974472277498144,0.6173406862745099,45.74404761904761,1017.0238095238091,29.912464985994383,0
1773,4,0,0,44,0.0,0.0,1.0,44,1150,700,450,0.6086956521739131,16,7,9,359.9243800069194,0.43857910500352365,0.2797585763756054,0.19889202322743696,129062.08070031143,490.5178756925011,129552.59857600393,1258,1,309.8636363636364,37,7,22,36.82724991906766,0.6089527027027026,45.970394736842096,1016.1184210526299,27.462660028449456,0
1774,4,1,0,45,0.022222222222222223,0.0,1.0,45,900,700,200,0.7777777777777778,11,7,4,351.4101183996998,0.43954124579124576,0.27383754401467386,0.1953350684929074,129294.84941188476,87.47938462698409,129382.32879651175,1259,0,303.9555555555556,33,12,23,36.806517853556656,0.6196338383838385,45.741421568627445,1017.0343137254895,30.819221628045135,0
1775,4,0,1,44,0.0,0.022222222222222223,0.9777777777777777,45,1150,900,250,0.782608695652174,14,9,5,351.6379048859855,0.4393518518518518,0.2711362693537811,0.19608123064260147,129419.51600646373,101.76149197422347,129521.27749843795,1260,1,304.9555555555556,33,12,23,36.67386787907985,0.6208964646464646,45.6188725490196,1017.5245098039205,30.83407605466426,0
1776,4,0,0,44,0.0,0.0,1.0,44,850,600,250,0.7058823529411765,11,6,5,352.92669503009006,0.4406382135306554,0.26421001926782295,0.19695586529098533,129450.69204152223,337.32098231446236,129788.01302383668,1261,2,310.8181818181818,33,11,16,36.60936496467565,0.6212121212121212,45.58823529411763,1017.6470588235272,30.837789661319007,0
1777,4,0,2,42,0.0,0.045454545454545456,0.9545454545454546,44,1200,800,400,0.6666666666666666,16,8,8,336.3486204162873,0.4407813601127555,0.23712017006377328,0.178485727768351,127442.37075617285,-226.9868827160526,127215.3838734568,1262,3,311.8181818181818,38,6,15,39.07897753324159,0.590734649122807,47.56944444444444,1009.7222222222224,26.57163742690059,8
1778,4,0,1,41,0.0,0.023809523809523808,0.9761904761904762,42,1350,900,450,0.6666666666666666,18,9,9,357.0114695951918,0.4380202284165699,0.26433858891173845,0.1887421698550158,127290.8059030316,688.8555362795414,127979.66143931115,1263,6,327.4047619047619,36,6,18,38.71289476620912,0.5928819444444444,47.719594594594604,1009.1216216216233,28.0311561561562,0
1779,4,2,1,42,0.046511627906976744,0.023255813953488372,0.9767441860465116,43,1050,700,350,0.6666666666666666,14,7,7,350.1356706878006,0.4398532668881506,0.27469149035442353,0.18738253159676213,127783.97108966224,348.34528412588634,128132.31637378813,1264,0,320.3720930232558,37,6,18,38.38102790731302,0.5960022522522522,47.23135964912281,1011.074561403509,27.326339497392137,0
1780,4,0,0,42,0.0,0.0,1.0,42,1300,900,400,0.6923076923076923,17,9,8,352.3680447477037,0.44043989547038326,0.278734564077149,0.18896760725307088,127867.13219452146,611.2582717759399,128478.3904662974,1265,1,327.6904761904762,37,5,19,38.23946588609426,0.5968468468468469,47.14912280701755,1011.4035087719303,27.335229966808928,0
1781,4,0,0,42,0.0,0.0,1.0,42,1150,1000,150,0.8695652173913043,13,10,3,365.0417697935277,0.44021002710027096,0.25875050875050887,0.18401085130408443,125338.06610664728,773.5574391350742,126111.62354578235,1266,2,328.6904761904762,36,6,12,40.52378542510121,0.5729166666666667,49.66216216216217,1001.3513513513522,27.81531531531534,7
1782,4,1,1,42,0.023255813953488372,0.023255813953488372,0.9767441860465116,43,1150,900,250,0.782608695652174,14,9,5,361.0980445252117,0.4428525286083425,0.2710864662705528,0.18380433017652267,125741.22716845575,480.9822493459615,126222.20941780171,1267,0,322.0232558139535,37,6,13,40.20569130133743,0.5751689189189189,49.25986842105264,1002.96052631579,27.10704125177811,0
1783,4,4,3,43,0.08695652173913043,0.06521739130434782,0.9347826086956522,46,1250,1000,250,0.8,15,10,5,340.7326175717445,0.44910426731078906,0.2826788997266425,0.17779460281824228,126759.19514054152,-561.801527695136,126197.39361284638,1268,0,298.0,40,6,13,39.668903690247944,0.58046875,48.246951219512205,1007.0121951219526,25.175304878048813,0
1784,4,4,2,45,0.0851063829787234,0.0425531914893617,0.9574468085106383,47,1600,1300,300,0.8125,19,13,6,334.3941772496482,0.4540163428923836,0.3002215260046057,0.17717955012172473,127381.02349175367,-880.032787364582,126500.99070438909,1269,0,291.1914893617021,39,8,13,39.1911094486293,0.5884081196581197,47.63020833333334,1009.4791666666683,25.88408119658124,0
1785,4,1,0,46,0.021739130434782608,0.0,1.0,46,1300,800,500,0.6153846153846154,18,8,10,345.45035799296124,0.45014090177133653,0.31980349224456717,0.1834380215589591,127469.34125940544,-393.134085762284,127076.20717364315,1270,0,298.5,38,8,14,38.82158978699394,0.5910087719298245,47.542735042735046,1009.8290598290605,26.574448942870013,0
1786,4,2,2,46,0.041666666666666664,0.041666666666666664,0.9583333333333334,48,1500,1100,400,0.7333333333333333,19,11,8,336.0997087546768,0.4533928043735225,0.32246267657494787,0.1809124810691391,128015.94309769329,-994.7757617819966,127021.16733591129,1271,0,287.0208333333333,40,8,16,38.49877820178082,0.5932291666666667,47.00203252032521,1011.9918699187001,25.299796747967502,0
1787,4,1,0,47,0.02127659574468085,0.0,1.0,47,1550,1200,350,0.7741935483870968,19,12,7,343.69285544731906,0.45210838729571384,0.3279359052680211,0.1852281462219413,128065.44189453137,-596.9645182291513,127468.47737630221,1272,0,293.97872340425533,39,8,17,38.25608469692293,0.5953525641025641,46.95312500000001,1012.1875000000009,25.953525641025664,0
1788,4,0,0,47,0.0,0.0,1.0,47,950,600,350,0.631578947368421,13,6,7,350.56363839039307,0.4519542090656799,0.3391862974761539,0.18969867181089967,128227.8095784278,-409.5496781461823,127818.25990028161,1273,1,294.97872340425533,37,10,17,37.916238136480096,0.6005067567567568,46.792763157894726,1012.8289473684197,27.37375533428161,0
1789,4,0,0,47,0.0,0.0,1.0,47,1450,900,550,0.6206896551724138,20,9,11,350.5581245584327,0.4518193031144002,0.3342688803597291,0.19022358361975772,128338.88942992063,-401.95192270700284,127936.93750721363,1274,2,295.97872340425533,37,10,17,37.80288478880351,0.6016328828828829,46.68311403508771,1013.2675438596482,27.385609293504004,0
1790,4,0,0,47,0.0,0.0,1.0,47,1350,1000,350,0.7407407407407407,17,10,7,350.93696093636754,0.45166512488436633,0.33005186831798516,0.19109323561941396,128477.8068732685,-382.4777816251337,128095.32909164338,1275,3,296.97872340425533,37,10,15,37.65141682889899,0.6030405405405406,46.54605263157894,1013.8157894736827,27.400426742531966,0
1791,4,0,0,47,0.0,0.0,1.0,47,1650,1200,450,0.7272727272727273,21,12,9,355.8561396869534,0.4513567684242985,0.3333440628319444,0.1948575571989979,128700.2310807171,-240.2465181594372,128459.98456255767,1276,4,297.97872340425533,37,10,15,37.299636193357834,0.6052927927927928,46.32675438596491,1014.6929824561399,27.424134660976755,0
1792,4,0,2,45,0.0,0.0425531914893617,0.9574468085106383,47,1350,1100,250,0.8148148148148148,16,11,5,361.7635477247217,0.45052806043786614,0.3414732430689875,0.19896995124859707,128875.73964497042,-75.4910420775833,128800.24860289284,1277,5,298.97872340425533,38,9,15,36.970617634680124,0.6052631578947368,46.15384615384615,1015.3846153846155,26.720647773279353,0
1793,4,0,0,45,0.0,0.0,1.0,45,1650,1300,350,0.7878787878787878,20,13,7,376.5164713602178,0.4458333333333333,0.3574840626888127,0.20624862756394666,128715.26668137734,692.6836042123234,129407.95028558966,1278,7,313.02222222222224,36,9,16,36.76016350386564,0.607349537037037,46.31193693693694,1014.7522522522524,28.18756256256257,0
1794,4,0,0,45,0.0,0.0,1.0,45,1450,800,650,0.5517241379310345,21,8,13,382.67113630041604,0.4452651515151515,0.36537404655404027,0.21052749457113173,128886.73460200054,864.2466368395271,129750.98123884006,1279,8,314.02222222222224,36,9,16,36.42864404273409,0.6090856481481481,46.14301801801801,1015.427927927927,28.206331331331306,0
1795,4,0,0,45,0.0,0.0,1.0,45,1200,700,500,0.5833333333333334,17,7,10,388.73574521654064,0.44507575757575757,0.4142546394699873,0.20238257580027144,126666.55411746228,848.347080188323,127514.9011976506,1280,9,315.02222222222224,36,9,16,38.55599992542046,0.5865162037037037,48.33896396396398,1006.6441441441459,27.962337337337388,8
1796,4,0,0,45,0.0,0.0,1.0,45,1500,1000,500,0.6666666666666666,20,10,10,388.13068247325947,0.4452020202020202,0.41358424942550154,0.20291227087804276,126836.65242522949,845.8392936856017,127682.49171891509,1281,10,316.02222222222224,36,9,16,38.395751816657366,0.5882523148148149,48.17004504504506,1007.3198198198215,27.981106106106154,0
1797,4,2,1,46,0.0425531914893617,0.02127659574468085,0.9787234042553191,47,1250,700,550,0.56,18,7,11,375.7981625766621,0.4487935553499846,0.4131195513015915,0.19956414902503786,127471.58893014811,181.48818736698794,127653.0771175151,1282,0,303.531914893617,35,12,16,38.05312798471822,0.5967261904761905,47.540509259259245,1009.8379629629612,28.852513227513178,0
1798,4,0,0,46,0.0,0.0,1.0,46,1750,1400,350,0.8,21,14,7,383.76008648020695,0.44691022544283415,0.4229211732261675,0.20369543513924346,127452.38803854852,582.2278911564347,128034.61592970496,1283,1,311.1304347826087,34,12,16,37.87186591212763,0.5986519607843137,47.559523809523796,1009.7619047619029,29.698879551820674,0
1799,4,3,1,48,0.061224489795918366,0.02040816326530612,0.9795918367346939,49,1400,1000,400,0.7142857142857143,18,10,8,362.7910013542704,0.450077947845805,0.42256409300418074,0.1973492912956954,128437.66744898818,-477.0454201485321,127960.62202883966,1284,0,293.0204081632653,35,14,17,37.39200350156045,0.6065476190476191,46.58564814814814,1013.6574074074061,28.961640211640177,0
1800,4,2,0,50,0.04,0.0,1.0,50,1300,900,400,0.6923076923076923,17,9,8,357.4826282428824,0.45040816326530614,0.430632692722954,0.1968492332214966,128922.84765504758,-782.4643159433831,128140.3833391042,1285,0,288.12,37,13,19,37.031238753329006,0.607545045045045,46.10745614035087,1015.5701754385955,27.4478425794215,0
1801,4,1,0,51,0.0196078431372549,0.0,1.0,51,1650,1400,250,0.8484848484848485,19,14,5,356.96447092959244,0.45076797385620915,0.43926809784055876,0.19879449947687639,129368.65790435522,-963.6965220067675,128404.96138234845,1286,0,283.45098039215685,37,14,20,36.59014155349574,0.6120495495495495,45.66885964912281,1017.3245614035089,27.495258416311053,0
1802,4,0,0,51,0.0,0.0,1.0,51,1300,900,400,0.6923076923076923,17,9,8,355.84885691020025,0.450718954248366,0.4380669823700576,0.19831360620238728,129396.54659366349,-990.8773613034741,128405.66923236001,1287,1,284.45098039215685,37,14,20,36.59012734849301,0.6123310810810811,45.641447368421055,1017.4342105263162,27.498221906116655,0
1803,4,0,0,51,0.0,0.0,1.0,51,1800,1400,400,0.7777777777777778,22,14,8,358.35484300333263,0.4508169934640523,0.43632255271521636,0.20056206855249825,129563.94184989617,-914.0267918975038,128649.91505799867,1288,2,285.45098039215685,37,14,17,36.356017770597745,0.6140202702702703,45.47697368421053,1018.0921052631583,27.516002844950222,0
1804,4,1,2,50,0.019230769230769232,0.038461538461538464,0.9615384615384616,52,1700,1400,300,0.8235294117647058,20,14,6,350.3777540445389,0.4522294494720965,0.4283139816158674,0.19755341451447436,129853.9201183434,-1300.4150230111563,128553.50509533225,1289,0,280.9423076923077,38,14,18,36.26441299790355,0.6151315789473684,45.1923076923077,1019.230769230771,26.821862348178183,0
1805,4,0,1,49,0.0,0.02,0.98,50,1700,1300,400,0.7647058823529411,21,13,8,360.12272419729896,0.45182823129251704,0.42359739255330875,0.2030822913837855,129860.54202428799,-646.8535680950959,129213.68845619289,1290,1,284.2,36,14,18,36.009372813317135,0.6189236111111112,45.18581081081082,1019.2567567567584,28.31268768768773,0
1806,4,0,0,49,0.0,0.0,1.0,49,1800,1400,400,0.7777777777777778,22,14,8,366.14247645410643,0.44947562358276644,0.42965812042890494,0.20662853471711795,129889.23890106326,-288.4064808051281,129600.83242025813,1291,2,290.8979591836735,36,13,19,35.82679702459861,0.619212962962963,45.15765765765766,1019.3693693693697,28.315815815815824,0
1807,4,0,0,49,0.0,0.0,1.0,49,1800,1300,500,0.7222222222222222,23,13,10,369.9122899188268,0.4488024376417234,0.43009207215284784,0.20983315180805598,130090.20580969496,-175.60681458484336,129914.59899511012,1292,3,291.8979591836735,36,13,19,35.52636420502632,0.6212384259259259,44.96058558558559,1020.1576576576587,28.33771271271274,0
1808,4,0,0,49,0.0,0.0,1.0,49,1450,900,550,0.6206896551724138,20,9,11,374.1184787464432,0.4484658446712018,0.4346316094121361,0.2128542053894802,130206.62607725461,-57.45902585410218,130149.16705140051,1293,4,292.8979591836735,37,12,20,35.300726973213,0.6204954954954955,44.84649122807018,1020.6140350877199,27.584163110478915,0
1809,4,0,0,49,0.0,0.0,1.0,49,1950,1800,150,0.9230769230769231,21,18,3,371.0777559948393,0.44800524376417233,0.42924453018201447,0.21191061754967425,130351.21588059411,-125.88861810579195,130225.32726248832,1294,5,293.8979591836735,35,14,20,35.231426385583134,0.6258928571428571,44.70486111111111,1021.1805555555554,29.176587301587297,0
1810,4,0,0,49,0.0,0.0,1.0,49,1550,1000,550,0.6451612903225806,21,10,11,366.9620859531921,0.4472611961451247,0.41960515092887296,0.2105203545731471,130528.56445312503,-220.19314236111052,130308.37131076392,1295,6,294.8979591836735,35,14,17,35.15651546041452,0.6276785714285714,44.53125,1021.8750000000002,29.196428571428577,0
1811,4,0,2,47,0.0,0.04081632653061224,0.9591836734693877,49,1650,1200,450,0.7272727272727273,21,12,9,365.32325340185326,0.44678287981859416,0.4195745714015946,0.21016505034106603,130636.47050766974,-255.09191624057598,130381.37859142917,1296,7,295.8979591836735,36,13,17,35.08895131086143,0.6267361111111112,44.42567567567567,1022.2972972972966,28.397147147147127,0
1812,4,0,0,47,0.0,0.0,1.0,47,1600,1300,300,0.8125,19,13,6,384.30869113135606,0.44518963922294175,0.4221159590581087,0.2203421172999617,130505.7557397958,630.899234693868,131136.65497448968,1297,8,306.3191489361702,34,13,17,34.73654316672493,0.6295955882352942,44.55357142857142,1021.7857142857133,30.052521008403332,0
1813,4,0,0,47,0.0,0.0,1.0,47,1200,1000,200,0.8333333333333334,14,10,4,385.2998361024521,0.44505473327166206,0.4214074676290378,0.2210838096994283,130536.16780045342,659.1128117913721,131195.2806122448,1298,9,307.3191489361702,34,13,17,34.680316091954026,0.6299019607843137,44.52380952380952,1021.9047619047611,30.056022408963564,0
1814,4,0,0,47,0.0,0.0,1.0,47,1150,700,450,0.6086956521739131,16,7,9,388.7446740883265,0.44443802035152635,0.42083160763992544,0.22421331202640038,130735.62349965707,764.555469821673,131500.17896947876,1299,10,308.3191489361702,35,12,18,34.38961822845933,0.6297619047619047,44.3287037037037,1022.6851851851852,29.21957671957672,0
1815,4,0,0,47,0.0,0.0,1.0,47,1300,1000,300,0.7692307692307693,16,10,6,389.7030458642529,0.44416820844896704,0.4218919270269097,0.22511081825805676,130794.81336805562,794.2274305555601,131589.04079861118,1300,11,309.3191489361702,35,12,19,34.30498981670061,0.6303571428571428,44.270833333333336,1022.9166666666672,29.226190476190492,0
1816,4,0,1,46,0.0,0.02127659574468085,0.9787234042553191,47,700,400,300,0.5714285714285714,10,4,6,386.97405868020724,0.44418748072772124,0.4201790699913359,0.22387766222074815,130854.01663237308,727.4219821673503,131581.43861454044,1301,12,310.3191489361702,35,12,19,34.314668174962286,0.6309523809523809,44.21296296296296,1023.1481481481479,29.232804232804227,0
1817,4,0,0,46,0.0,0.0,1.0,46,1350,1200,150,0.8888888888888888,15,12,3,398.0045562902418,0.4419182769726248,0.4343523814344279,0.22945363345860248,130718.71456916102,1205.3287981859376,131924.04336734695,1302,16,317.80434782608694,34,12,19,34.170062087698874,0.6317401960784313,44.345238095238095,1022.6190476190478,30.077030812324935,0
1818,4,0,2,44,0.0,0.043478260869565216,0.9565217391304348,46,1800,1300,500,0.7222222222222222,23,13,10,345.04852734559626,0.44202898550724634,0.24291403916362442,0.20000600478881908,130928.03955078125,-109.33386701034514,130818.70568377091,1303,17,318.80434782608694,39,7,17,35.31223494486853,0.624198717948718,44.140625,1023.4375,26.24198717948718,8
1819,4,0,0,44,0.0,0.0,1.0,44,1600,1300,300,0.8125,19,13,6,350.0958347115879,0.44353417899929526,0.24188294298096102,0.2031165082058839,130963.11034404808,369.92788646505375,131333.03823051314,1304,18,324.70454545454544,37,7,17,35.14762988752008,0.6280968468468469,44.1063596491228,1023.574561403508,27.664177335229947,0
1820,4,0,0,44,0.0,0.0,1.0,44,1300,900,400,0.6923076923076923,17,9,8,346.53406006171036,0.44278541226215645,0.23637385962008461,0.20134340502776513,131019.23338190577,280.52537800090175,131299.75875990666,1305,19,325.70454545454544,37,7,17,35.18204901645781,0.6286599099099099,44.05153508771929,1023.7938596491211,27.67010431484111,0
1821,4,0,1,43,0.0,0.022727272727272728,0.9772727272727273,44,1550,1200,350,0.7741935483870968,19,12,7,346.5807541028289,0.4420696793516561,0.23189498236431905,0.20212994345121169,131163.91354372108,291.77761341221145,131455.6911571333,1306,20,326.70454545454544,38,6,18,35.03467876512306,0.6282894736842105,43.9102564102564,1024.3589743589732,26.956815114709823,0
1822,4,0,0,43,0.0,0.0,1.0,43,800,500,300,0.625,11,5,6,353.8757112921792,0.4428525286083425,0.22933120860514955,0.2060597969743734,131103.4404816865,678.8646506617262,131782.30513234824,1307,21,322.6046511627907,37,6,18,34.908993576017124,0.6295045045045045,43.96929824561403,1024.1228070175425,27.678994784257906,0
1823,4,0,0,43,0.0,0.0,1.0,43,1700,1200,500,0.7058823529411765,22,12,10,355.7704898228281,0.4425987449243263,0.22614754812298576,0.20792215305780648,131243.84576263835,738.5374586410996,131982.38322127945,1308,22,323.6046511627907,37,6,18,34.71854378455502,0.6309121621621622,43.83223684210525,1024.6710526315776,27.693812233285882,0
1824,4,0,1,42,0.0,0.023255813953488372,0.9767441860465116,43,1000,800,200,0.8,12,8,4,355.93892524291095,0.4417912513842746,0.22707506144828904,0.20847851335656217,131328.125,749.0124365189295,132077.13743651894,1309,23,324.6046511627907,35,8,19,34.62906504065042,0.6357142857142857,43.75,1025.0,29.285714285714285,0
1825,4,0,0,42,0.0,0.0,1.0,42,1500,1100,400,0.7333333333333333,19,11,8,332.89872211420715,0.4413230739450252,0.09331244654257498,0.19379667375764675,131093.8545694528,332.5356104170915,131426.39017986986,1310,24,332.3809523809524,40,2,15,35.455740795871804,0.62421875,43.97865853658537,1024.0853658536591,25.602134146341477,8
1826,4,0,0,42,0.0,0.0,1.0,42,1000,700,300,0.7,13,7,6,332.7374520021857,0.4410327138985675,0.09186913503246075,0.19383399082531974,131119.8742894443,325.69857558333166,131445.57286502764,1311,25,333.3809523809524,40,2,15,35.4336177813058,0.6244791666666667,43.95325203252033,1024.1869918699201,25.604674796748004,0
1827,4,0,0,42,0.0,0.0,1.0,42,950,600,350,0.631578947368421,13,6,7,330.0740898211135,0.4411536972512582,0.08704648526077108,0.1925432190623165,131171.9214753125,259.290518210082,131431.2119935226,1312,26,334.3809523809524,40,2,15,35.449322089947096,0.625,43.902439024390254,1024.3902439024405,25.60975609756101,0
1828,4,0,0,42,0.0,0.0,1.0,42,1100,900,200,0.8181818181818182,13,9,4,329.2832078843937,0.4409117305458769,0.09250864169547257,0.19260393667669548,131276.04683059044,245.3995637517566,131521.4463943422,1313,27,335.3809523809524,40,2,18,35.364603993124426,0.6260416666666666,43.80081300813009,1024.7967479674812,25.619918699187032,0
1829,4,0,0,42,0.0,0.0,1.0,42,1350,900,450,0.6666666666666666,18,9,9,312.0299045708904,0.4406213704994193,0.0893520325935715,0.17279700303186557,129147.08547921687,-330.9013537435179,128816.18412547334,1314,28,336.3809523809524,38,4,17,37.95765888865532,0.6080043859649122,45.886752136752136,1016.4529914529913,26.748762932973456,6
1830,4,0,1,41,0.0,0.023809523809523808,0.9761904761904762,42,550,300,250,0.5454545454545454,8,3,5,313.73943125452,0.4405124854819977,0.0923929634912295,0.1738631734645753,129174.23575726856,-294.58974815545946,128879.6460091131,1315,29,337.3809523809524,38,4,17,37.88667016990715,0.6082785087719298,45.86004273504273,1016.5598290598286,26.751574448942858,0
1831,4,0,0,41,0.0,0.0,1.0,41,1300,800,500,0.6153846153846154,18,8,10,315.39334740800143,0.440015243902439,0.10197978395183482,0.17502348955801278,129229.25954380176,-48.39024988460238,129180.86929391716,1316,30,345.3658536585366,37,4,18,37.788808907581135,0.6106418918918919,45.80592105263157,1016.7763157894722,27.48044096728303,0
1832,4,2,1,42,0.046511627906976744,0.023255813953488372,0.9767441860465116,43,1050,800,250,0.7619047619047619,13,8,5,305.63862332846236,0.44158361018826137,0.11551137510118004,0.17207403010188022,129796.16057117101,-665.8560339414655,129130.30453722955,1317,0,330.25581395348837,40,3,17,37.4628087497091,0.6111979166666667,45.248983739837385,1019.0040650406485,25.47510162601621,0
1833,4,0,0,42,0.0,0.0,1.0,42,1150,900,250,0.782608695652174,14,9,5,313.3336352804677,0.44028261711188543,0.11546438430192651,0.17623440406430427,129757.97661675327,-268.4922960069697,129489.4843207463,1318,1,339.1190476190476,39,3,17,37.305426336775376,0.6124465811965811,45.28645833333332,1018.8541666666649,26.124465811965766,0
1834,4,0,0,42,0.0,0.0,1.0,42,1300,900,400,0.6923076923076923,17,9,8,313.6330177458618,0.4397381920247774,0.11893081026359842,0.1767618344254325,129837.58680555534,-255.72916666669067,129581.85763888866,1319,2,340.1190476190476,39,3,17,37.21722540201688,0.6132478632478633,45.20833333333332,1019.1666666666649,26.132478632478588,0
1835,4,0,0,42,0.0,0.0,1.0,42,1300,1200,100,0.9230769230769231,14,12,2,367.8739184496185,0.4398954703832753,0.10340918801807608,0.19811652242599426,128036.38100162546,1028.7559810797013,129065.13698270515,1320,3,341.1190476190476,38,4,18,37.673959322988125,0.596765350877193,46.98183760683761,1012.0726495726501,26.633490778227635,8
1836,4,0,1,41,0.0,0.023809523809523808,0.9761904761904762,42,1100,800,300,0.7272727272727273,14,8,6,365.2712832008918,0.4398712737127371,0.09872560252467388,0.19711336444257685,128117.48940755353,959.5279512747505,129077.01735882828,1321,4,342.1190476190476,38,4,18,37.65675566343042,0.5975877192982456,46.901709401709404,1012.3931623931626,26.64192532613586,0
1837,4,2,3,40,0.046511627906976744,0.06976744186046512,0.9302325581395349,43,950,600,350,0.631578947368421,13,6,7,350.74946132027605,0.4446059431524548,0.10078608723632643,0.19165878716325307,128616.79945993,422.46033259880346,129039.2597925288,1322,0,331.6279069767442,37,6,15,37.5143002558282,0.6044481981981982,46.40899122807018,1014.3640350877196,27.41524419155999,0
1838,4,0,0,40,0.0,0.0,1.0,40,900,400,500,0.4444444444444444,14,4,10,371.0351773566097,0.4372863247863248,0.0834146198143142,0.20096361070193486,128265.09530895713,1518.1724773242888,129783.26778628142,1323,6,340.475,34,6,20,37.35970736866847,0.6069240196078431,46.755952380952394,1012.9761904761923,29.793417366946834,0
1839,4,0,0,40,0.0,0.0,1.0,40,1250,800,450,0.64,17,8,9,373.4598543774449,0.4368990384615385,0.085311398354877,0.20242951342369792,128295.24518140596,1582.6247165532984,129877.86989795926,1324,7,341.475,34,6,20,37.26743047395221,0.6072303921568627,46.72619047619048,1013.0952380952386,29.79691876750702,0
1840,4,2,0,42,0.047619047619047616,0.0,1.0,42,1050,600,450,0.5714285714285714,15,6,9,331.5895577787961,0.4421094657375145,0.09389057125216826,0.17882282588758833,128091.80230034728,94.78081597222643,128186.58311631951,1325,0,326.1666666666667,39,3,19,38.53544968100433,0.5956196581196581,46.927083333333336,1012.2916666666671,25.956196581196593,8
1841,4,0,1,41,0.0,0.023809523809523808,0.9761904761904762,42,1000,500,500,0.5,15,5,10,338.7773491080619,0.44196428571428575,0.09203118233001306,0.18319365318279038,128200.04712988606,286.2761258271675,128486.32325571323,1326,1,327.1666666666667,37,5,19,38.24301645734083,0.6002252252252251,46.820175438596486,1012.7192982456136,27.37079184447604,0
1842,4,1,0,42,0.023809523809523808,0.0,1.0,42,1450,900,550,0.6206896551724138,20,9,11,337.03057169567285,0.4432951025938831,0.10081108517424897,0.18288311879270183,128338.88942992066,250.82585507077619,128589.71528499144,1327,0,327.92857142857144,37,5,20,38.14556054539551,0.6016328828828829,46.68311403508771,1013.2675438596484,27.38560929350401,0
1843,4,0,0,42,0.0,0.0,1.0,42,750,600,150,0.8,9,6,3,337.03057169567285,0.4434765776229191,0.10081108517424897,0.18288311879270183,128338.88942992066,250.82585507077619,128589.71528499144,1328,1,328.92857142857144,37,5,20,38.14556054539551,0.6016328828828829,46.68311403508771,1013.2675438596484,27.38560929350401,0
1844,4,2,1,43,0.045454545454545456,0.022727272727272728,0.9772727272727273,44,950,700,250,0.7368421052631579,12,7,5,324.24221171550766,0.4453180056377731,0.11341718197673867,0.1782509214659364,128857.43408203126,-443.79611545138846,128413.63796657987,1329,0,314.9318181818182,39,5,18,37.94169573543995,0.6033653846153846,46.171875,1015.3125000000001,26.03365384615385,0
1845,4,0,1,42,0.0,0.023255813953488372,0.9767441860465116,43,1250,800,450,0.64,17,8,9,330.1062232170184,0.4424141749723145,0.10766091143998047,0.18155842276936016,128875.73964497047,-91.46326429980357,128784.27638067066,1330,1,323.2093023255814,38,5,19,37.77422664141412,0.6052631578947368,46.15384615384615,1015.3846153846158,26.720647773279364,0
1846,4,0,0,42,0.0,0.0,1.0,42,1600,1300,300,0.8125,19,13,6,333.95747888985306,0.441117402245451,0.11397366892346894,0.18402427881955422,128950.68825263534,212.8093499922913,129163.49760262764,1331,2,330.85714285714283,37,5,19,37.60019702040375,0.6078265765765766,46.080043859649116,1015.6798245614028,27.450806069227102,0
1847,4,0,1,41,0.0,0.023809523809523808,0.9761904761904762,42,1100,700,400,0.6363636363636364,15,7,8,333.16854364803396,0.43967770034843207,0.11239506840263691,0.18437651865757687,129119.93805473375,203.7403435240007,129323.67839825775,1332,3,331.85714285714283,38,4,19,37.44809734048145,0.6077302631578947,45.91346153846154,1016.346153846154,26.745951417004054,0
1848,4,1,1,41,0.023809523809523808,0.023809523809523808,0.9761904761904762,42,1250,800,450,0.64,17,8,9,328.41373371194175,0.4405487804878048,0.13161368716340927,0.1830008183814407,129391.54071015053,98.81748118928056,129490.35819133981,1333,0,331.6904761904762,38,4,20,37.29304490881725,0.6104714912280702,45.64636752136752,1017.4145299145302,26.774066576698164,0
1849,4,0,0,41,0.0,0.0,1.0,41,850,600,250,0.7058823529411765,11,6,5,329.2378864447087,0.4399136178861789,0.12166736753574448,0.18361343667108765,129424.43828870427,322.2857032933281,129746.7239919976,1334,1,337.7560975609756,37,4,20,37.23868534482757,0.6126126126126126,45.6140350877193,1017.5438596491232,27.50118539592225,0
1850,4,0,1,40,0.0,0.024390243902439025,0.975609756097561,41,850,400,450,0.47058823529411764,13,4,9,328.98598585506824,0.43927845528455284,0.12074773624271429,0.18373332856237928,129480.23069598338,319.43626885195135,129799.66696483533,1335,2,338.7560975609756,37,4,17,37.188465129641585,0.6131756756756757,45.55921052631579,1017.7631578947368,27.507112375533428,0
1851,4,2,1,41,0.047619047619047616,0.023809523809523808,0.9761904761904762,42,1350,700,650,0.5185185185185185,20,7,13,322.8750937943348,0.441298877274487,0.12363095846287786,0.18234152007877422,129917.22140842024,-10.5929904513836,129906.62841796885,1336,0,331.5952380952381,39,3,19,36.90109754436156,0.6140491452991452,45.130208333333336,1019.4791666666675,26.140491452991476,0
1852,4,0,0,41,0.0,0.0,1.0,41,1100,700,400,0.6363636363636364,15,7,8,331.9781565144288,0.4394308943089431,0.12494059572902438,0.18796343310122984,130017.309746877,432.5813609467365,130449.89110782373,1337,1,340.5121951219512,38,3,19,36.56767232348628,0.6167763157894737,45.03205128205128,1019.8717948717944,26.83873144399459,0
1853,4,1,0,42,0.023809523809523808,0.0,1.0,42,1050,600,450,0.5714285714285714,15,6,9,327.9847892874878,0.4406092721641502,0.13975510788131507,0.18795585895330938,130486.54994806091,159.98299601970965,130646.53294408062,1338,0,333.3809523809524,37,5,21,36.19473062889032,0.6233108108108107,44.57236842105263,1021.7105263157893,27.613798008534843,0
1854,4,0,0,42,0.0,0.0,1.0,42,1650,1300,350,0.7878787878787878,20,13,7,326.345404064272,0.43970189701897017,0.13250517598343658,0.18764860733695657,130617.28395061742,125.27006172840657,130742.55401234583,1339,1,334.3809523809524,38,4,15,36.10450634057969,0.6228070175438596,44.44444444444445,1022.2222222222233,26.900584795321667,0
1855,4,0,0,42,0.0,0.0,1.0,42,850,700,150,0.8235294117647058,10,7,3,326.12194832958636,0.4390001935733643,0.13341530969115722,0.18799407908112462,130714.91021050359,125.80023871528215,130840.71044921887,1340,2,335.3809523809524,39,3,15,36.01161675325115,0.6220619658119658,44.348958333333336,1022.6041666666675,26.22061965811968,0
1856,4,0,1,41,0.0,0.023809523809523808,0.9761904761904762,42,1150,1000,150,0.8695652173913043,13,10,3,339.9113143380195,0.43785085172280297,0.014996119435675581,0.18812689843356561,129123.9106703185,378.13563768258905,129502.04630800108,1341,3,336.3809523809524,40,2,15,37.272731060227315,0.6044270833333334,45.90955284552845,1016.3617886178854,25.409044715447134,8
1857,4,1,3,39,0.023809523809523808,0.07142857142857142,0.9285714285714286,42,1400,1200,200,0.8571428571428571,16,12,4,333.6642860171515,0.4390001935733643,0.03833204941653112,0.18624939577345334,129459.8174449732,239.2235111375473,129699.04095611075,1342,0,337.23809523809524,40,2,14,37.090157113374616,0.6078125,45.579268292682926,1017.682926829268,25.4420731707317,0
1858,4,0,1,38,0.0,0.02564102564102564,0.9743589743589743,39,1400,1100,300,0.7857142857142857,17,11,6,354.2168975813892,0.4319050832208727,0.0508065519386276,0.19684611893753068,129285.00987082574,1358.987020044639,130643.99689087039,1343,5,363.6923076923077,37,2,16,36.74517070979335,0.611204954954955,45.751096491228076,1016.9956140350886,27.486367946894287,0
1859,4,1,1,38,0.02564102564102564,0.02564102564102564,0.9743589743589743,39,800,700,100,0.875,9,7,2,351.9154802779729,0.4355319388214125,0.03678869706237453,0.19639973376186787,129452.33298947735,1311.255987419185,130763.58897689653,1344,0,344.0,37,2,15,36.6334222246166,0.6128941441441442,45.586622807017534,1017.6535087719284,27.504148885727794,0
1860,4,1,0,39,0.02564102564102564,0.0,1.0,39,1500,1000,500,0.6666666666666666,20,10,10,353.5030382107803,0.43395748987854255,0.05684022861936966,0.19869308699433508,129731.4453125,1372.0920138888873,131103.53732638888,1345,0,344.97435897435895,37,2,16,36.30921949556918,0.6157094594594594,45.3125,1018.75,27.533783783783782,0
1861,4,0,0,39,0.0,0.0,1.0,39,650,500,150,0.7692307692307693,8,5,3,353.54886351700173,0.4340418353576248,0.06317154246148315,0.19928663956279752,129843.17440221988,1381.1813490689378,131224.35575128882,1346,1,345.97435897435895,37,2,16,36.19452662721892,0.6168355855855856,45.20285087719298,1019.1885964912278,27.545637743006157,0
1862,4,0,1,38,0.0,0.02564102564102564,0.9743589743589743,39,1100,600,500,0.5454545454545454,16,6,10,357.18587103263917,0.43347953216374274,0.06113486556449743,0.20220242157483695,130010.85820877553,1487.6083266004684,131498.466535376,1347,2,346.97435897435895,37,2,16,35.931508260760495,0.6185247747747749,45.038377192982445,1019.8464912280682,27.563418681839682,0
1863,4,0,0,38,0.0,0.0,1.0,38,800,500,300,0.625,11,5,6,362.12793497121163,0.43160265528686587,0.05170429110443164,0.20451305023670477,129917.93894823873,1809.3829894083224,131727.32193764707,1348,3,356.5263157894737,36,2,17,35.89993188261718,0.6195023148148149,45.1295045045045,1019.4819819819816,28.318943943943932,0
1864,4,0,0,38,0.0,0.0,1.0,38,950,600,350,0.631578947368421,13,6,7,361.4459330461528,0.43152856804172596,0.04763233464708794,0.20427787002496045,129946.6421658144,1793.7370647674607,131740.37923058186,1349,4,357.5263157894737,36,2,17,35.888143362049924,0.6197916666666667,45.10135135135135,1019.5945945945941,28.32207207207206,0
1865,4,0,0,38,0.0,0.0,1.0,38,1850,1600,250,0.8648648648648649,21,16,5,364.39514750777266,0.43105440967283076,0.051748186721219946,0.20624765348939925,130004.05811216618,1874.5695864783659,131878.62769864456,1350,5,358.5263157894737,36,2,17,35.754610203180206,0.6203703703703703,45.04504504504504,1019.8198198198195,28.32832832832832,0
1866,4,1,1,38,0.02564102564102564,0.02564102564102564,0.9743589743589743,39,1450,1100,350,0.7586206896551724,18,11,7,357.56743381349196,0.43137089518668464,0.05291534561977573,0.20509272404700557,130521.37230135548,1534.2952327327412,132055.66753408822,1351,0,350.3076923076923,36,3,14,35.4038094188524,0.6255787037037037,44.53828828828829,1021.8468468468475,28.38463463463465,0
1867,4,0,0,38,0.0,0.0,1.0,38,900,500,400,0.5555555555555556,13,5,8,367.89274313369185,0.43207681365576106,0.05099802065199199,0.2108933205444306,130498.99798525377,2001.9268689986245,132500.9248542524,1352,1,339.60526315789474,35,3,15,35.162739767406734,0.6273809523809524,44.56018518518518,1021.7592592592592,29.193121693121693,0
1868,4,0,0,38,0.0,0.0,1.0,38,1200,900,300,0.75,15,9,6,368.0648259384077,0.4313655761024182,0.049863221069319286,0.21147563291230168,130587.70743580667,2012.9483614111728,132600.65579721786,1353,2,340.60526315789474,35,3,15,35.06834352470464,0.6282738095238095,44.473379629629626,1022.1064814814808,29.20304232804231,0
1869,4,1,0,39,0.02564102564102564,0.0,1.0,39,1300,800,500,0.6153846153846154,18,8,10,360.46631337928477,0.43437921727395407,0.05158679770763008,0.20876720138161642,130895.62694028488,1636.692816126939,132532.31975641183,1354,0,332.84615384615387,36,3,17,34.950570411943815,0.6293402777777778,44.1722972972973,1023.3108108108108,28.4253003003003,0
1870,4,0,0,39,0.0,0.0,1.0,39,800,600,200,0.75,10,6,4,362.12393908474974,0.43426675663517766,0.04624355730087926,0.21004112841999312,130953.25213304527,1684.2614996753573,132637.51363272063,1355,1,333.84615384615387,36,3,17,34.84981846187699,0.6299189814814814,44.115990990990994,1023.5360360360366,28.431556556556572,0
1871,4,0,0,39,0.0,0.0,1.0,39,1000,800,200,0.8,12,8,4,361.79765271419916,0.433816914080072,0.047053396378733625,0.21036528524565326,131047.29940943363,1682.5210641735862,132729.82047360722,1356,2,334.84615384615387,37,2,17,34.76297565502963,0.6289414414414414,44.02412280701754,1023.9035087719295,27.673067804646745,0
1872,4,0,0,39,0.0,0.0,1.0,39,1000,600,400,0.6,14,6,8,358.1498385945257,0.43297345928924874,0.04572736478976425,0.209006492316593,131187.67463306023,1596.9688990843383,132784.64353214458,1357,3,335.84615384615387,37,2,19,34.71438064147847,0.6303490990990991,43.887061403508774,1024.4517543859654,27.68788525367474,0
1873,4,1,0,40,0.025,0.0,1.0,40,850,700,150,0.8235294117647058,10,7,3,350.7014568114134,0.43366720085470084,0.051007450050795766,0.20588894671254587,131417.1157648536,1217.8602196776621,132634.97598453125,1358,0,328.425,35,5,20,34.67342533017272,0.6366071428571429,43.66319444444446,1025.347222222224,29.29563492063497,0
1874,4,0,0,40,0.0,0.0,1.0,40,1100,600,500,0.5454545454545454,16,6,10,350.7014568114134,0.43366720085470084,0.051007450050795766,0.20588894671254587,131417.1157648536,1217.6347897376804,132634.75055459127,1359,1,329.425,35,5,20,34.67342533017272,0.6366071428571429,43.66319444444446,1025.347222222224,29.29563492063497,0
1875,4,0,0,40,0.0,0.0,1.0,40,1050,600,450,0.5714285714285714,15,6,9,348.0448839885224,0.43361378205128204,0.047491183071497245,0.20520831628737254,131581.12502164117,1159.227478647266,132740.35250028843,1360,2,330.425,37,3,14,34.57605268782729,0.6342905405405406,43.503289473684205,1025.9868421052624,27.72937411095304,0
1876,4,0,1,39,0.0,0.025,0.975,40,950,600,350,0.631578947368421,13,6,7,340.4785345003226,0.4337606837606838,0.09575076435284813,0.19562563033001612,130587.70743580667,941.6210058787021,131529.3284416854,1361,3,331.425,35,5,14,35.77324670667724,0.6282738095238095,44.473379629629626,1022.1064814814808,29.20304232804231,8
1877,4,0,1,38,0.0,0.02564102564102564,0.9743589743589743,39,1100,800,300,0.7272727272727273,14,8,6,349.72274432416805,0.4330015744489429,0.09598059598059594,0.20066978858814555,130536.16780045345,1330.2933673469283,131866.4611678004,1362,8,340.84615384615387,34,5,15,35.5892260795278,0.6299019607843137,44.52380952380952,1021.9047619047614,30.05602240896357,0
1878,4,0,0,38,0.0,0.0,1.0,38,800,500,300,0.625,11,5,6,358.1872698574702,0.43160265528686587,0.09554427630789886,0.20523761297606383,130481.60750973181,1747.3701521049622,132228.97766183678,1363,9,350.5263157894737,33,5,18,35.428286553916294,0.6316287878787878,44.57720588235294,1021.691176470588,30.960338680926906,0
1879,4,0,0,38,0.0,0.0,1.0,38,1200,700,500,0.5833333333333334,17,7,10,356.36305416831027,0.43123221906116643,0.09678754253134292,0.20464058996889264,130566.58340419504,1705.8212868480757,132272.4046910431,1364,10,351.5263157894737,34,4,17,35.3887594641817,0.6302083333333333,44.49404761904762,1022.0238095238097,30.059523809523817,0
1880,4,1,1,38,0.02564102564102564,0.02564102564102564,0.9743589743589743,39,1250,1100,150,0.88,14,11,3,346.74578839933446,0.4327204228520018,0.09894501186064164,0.20091259901880187,130913.2332926098,1278.7224579904037,132191.9557506002,1365,0,343.4871794871795,35,4,18,35.28377817989896,0.631547619047619,44.155092592592595,1023.3796296296302,29.23941798941801,0
1881,4,0,1,37,0.0,0.02631578947368421,0.9736842105263158,38,1100,700,400,0.6363636363636364,15,7,8,345.78630457796794,0.4324027975343765,0.019150094106442417,0.19339036456035275,129536.03512619277,1408.2035940427215,130944.23872023549,1366,1,348.07894736842104,37,1,17,36.704276174062905,0.6137387387387387,45.50438596491229,1017.9824561403516,27.513039355144638,7
1882,4,0,0,37,0.0,0.0,1.0,37,900,600,300,0.6666666666666666,12,6,6,348.46933883503567,0.4315565565565565,0.028092274915449522,0.19516805068891085,129591.85157933214,1631.7573676515894,131223.60894698373,1367,2,355.81081081081084,37,0,17,36.579259099720005,0.6143018018018018,45.449561403508774,1018.2017543859652,27.518966334755817,0
1883,4,0,0,37,0.0,0.0,1.0,37,650,500,150,0.7692307692307693,8,5,3,346.95021305272456,0.43124374374374375,0.025213972452047484,0.19445543926497602,129619.76431450054,1594.320968951977,131214.08528345253,1368,3,356.81081081081084,37,0,17,36.58956516277234,0.6145833333333333,45.422149122807014,1018.3114035087714,27.52192982456139,0
1884,4,0,0,37,0.0,0.0,1.0,37,1150,800,350,0.6956521739130435,15,8,7,345.4736305050581,0.4308996496496496,0.02210799756812043,0.19418000611146366,129731.4453125,1563.7586805555557,131295.20399305556,1369,4,357.81081081081084,37,0,17,36.51371847307429,0.6157094594594594,45.3125,1018.75,27.533783783783782,0
1885,4,0,0,37,0.0,0.0,1.0,37,1100,700,400,0.6363636363636364,15,7,8,344.9321011609752,0.43096221221221226,0.027841094106154207,0.1945684958975988,129871.11418898133,1559.3432594644614,131430.45744844578,1370,5,358.81081081081084,37,0,17,36.38572145725759,0.6171171171171171,45.17543859649123,1019.298245614036,27.548601232811784,0
1886,4,1,0,38,0.02631578947368421,0.0,1.0,38,800,600,200,0.75,10,6,4,337.94813577104406,0.43280286865813183,0.03922157503485457,0.19201324477984794,130153.54624379074,1197.0296634158942,131350.57590720663,1371,0,350.3421052631579,38,0,18,36.27739678218688,0.6181469298245614,44.89850427350428,1020.4059829059837,26.852789023841677,0
1887,4,1,0,39,0.02564102564102564,0.0,1.0,39,1000,700,300,0.7,13,7,6,334.5515773455645,0.4342948717948718,0.03937470332198956,0.19142116283668112,130426.23325525968,926.9060696544657,131353.13932491414,1372,0,342.3333333333333,38,1,19,36.088013806087226,0.6208881578947368,44.631410256410255,1021.4743589743588,26.88090418353576,0
1888,4,0,1,38,0.0,0.02564102564102564,0.9743589743589743,39,1000,500,500,0.5,15,5,10,333.8602214643655,0.43373256860098963,0.04305312082857582,0.19169909234862678,130562.68376981521,917.9373036744889,131480.6210734897,1373,1,343.3333333333333,38,1,17,35.96766325179454,0.6222587719298245,44.49786324786325,1022.0085470085472,26.89496176338282,0
1889,4,0,1,37,0.0,0.02631578947368421,0.9736842105263158,38,1250,1000,250,0.8,15,10,5,342.5286996733844,0.4317804646752015,0.04547456507377201,0.19671657484014882,130570.58572108718,1344.8345885272277,131915.4203096144,1374,3,353.3421052631579,37,1,17,35.738185280549274,0.6241554054054055,44.49013157894736,1022.03947368421,27.62268847795162,0
1890,4,0,0,37,0.0,0.0,1.0,37,1400,1200,200,0.8571428571428571,16,12,4,345.2298705583265,0.43180680680680683,0.053768305750684586,0.1989014736465483,130694.03863322765,1623.897208018809,132317.93584124645,1375,4,360.5405405405405,36,1,17,35.54423641703377,0.6273148148148149,44.36936936936936,1022.5225225225212,28.403403403403367,0
1891,4,0,1,36,0.0,0.02702702702702703,0.972972972972973,37,1350,1100,250,0.8148148148148148,16,11,5,343.6042880903877,0.43058683683683685,0.04732336279700222,0.19891533600865335,130878.94833025517,1594.1135734071704,132473.06190366234,1376,5,361.5405405405405,37,0,18,35.39880697242462,0.6272522522522522,44.188596491228054,1023.2456140350854,27.655286865813117,0
1892,4,0,0,36,0.0,0.0,1.0,36,700,500,200,0.7142857142857143,9,5,4,350.7304024323909,0.42786044973544973,0.05193768578663449,0.20252283822589978,130780.4145995656,1973.7334885561029,132754.1480881217,1377,12,372.44444444444446,36,0,18,35.316204264376665,0.6281828703703703,44.2849099099099,1022.860360360359,28.41278778778775,0
1893,4,0,0,36,0.0,0.0,1.0,36,1200,1000,200,0.8333333333333334,14,10,4,349.5076203135166,0.427281746031746,0.05158118717440763,0.2022691871444974,130866.81909950473,1947.7901042934618,132814.6092037982,1378,13,373.44444444444446,36,0,18,35.26006126641719,0.6290509259259259,44.20045045045044,1023.1981981981968,28.422172172172132,0
1894,4,0,0,36,0.0,0.0,1.0,36,750,600,150,0.8,9,6,3,347.2092655796151,0.426603835978836,0.05280803413161217,0.20139023706784406,130953.25213304503,1893.6364996753296,132846.88863272037,1379,14,374.44444444444446,36,0,18,35.23146110683242,0.6299189814814814,44.11599099099098,1023.5360360360346,28.431556556556515,0
1895,4,0,1,35,0.0,0.027777777777777776,0.9722222222222222,36,700,600,100,0.8571428571428571,8,6,2,348.43598201600906,0.42624007936507935,0.05888840011241858,0.2027081499981811,131068.54056336732,1933.7991285203989,133002.33969188773,1380,15,375.44444444444446,36,0,18,35.08353495362732,0.6310763888888888,44.00337837837837,1023.9864864864858,28.444069069069048,0
1896,4,0,0,35,0.0,0.0,1.0,35,1400,1100,300,0.7857142857142857,17,11,6,386.22714684834824,0.4256302521008403,0.036874115983027034,0.21915135860496157,130101.52025303528,3056.969965088294,133158.49021812357,1381,16,382.2857142857143,32,3,20,35.09875206270626,0.6302083333333333,44.94949494949494,1020.2020202020193,31.881313131313103,8
1897,4,2,1,36,0.05405405405405406,0.02702702702702703,0.972972972972973,37,750,500,250,0.6666666666666666,10,5,5,372.3513628370762,0.4315565565565565,0.053380725317484945,0.21543738935043283,130857.4995945068,2345.0933013607805,133202.59289586756,1382,0,362.56756756756755,33,4,18,34.68516688625386,0.6354166666666667,44.209558823529406,1023.1617647058813,31.00490196078428,0
1898,4,1,0,37,0.02702702702702703,0.0,1.0,37,1000,700,300,0.7,13,7,6,370.1020059893426,0.42820945945945943,0.05281143212177675,0.21465916347381853,130951.55709342548,2293.0867935409306,133244.6438869664,1383,0,363.5405405405405,33,4,19,34.6473898467433,0.6363636363636364,44.11764705882352,1023.529411764705,31.016042780748634,0
1899,4,0,1,36,0.0,0.02702702702702703,0.972972972972973,37,1300,900,400,0.6923076923076923,17,9,8,373.5529184945317,0.42748998998999,0.06300592802926164,0.21754576584381888,131108.39468293442,2395.1846945886136,133503.57937752304,1384,1,364.5405405405405,33,4,19,34.40017849307965,0.6379419191919191,43.96446078431372,1024.1421568627447,31.034610814022567,0
1900,4,0,0,36,0.0,0.0,1.0,36,800,600,200,0.75,10,6,4,381.6603017624181,0.4263888888888889,0.07028723345940868,0.22166917812963385,131004.77629833698,2799.8644908682827,133804.64078920527,1385,2,375.1388888888889,32,4,19,34.29765869100477,0.6393229166666667,44.06565656565657,1023.7373737373744,31.99179292929295,0
1901,4,0,0,36,0.0,0.0,1.0,36,950,500,450,0.5263157894736842,14,5,9,382.3144333059979,0.42567791005291006,0.07003506032841678,0.2229846870892569,131166.40082963483,2829.3616403938536,133995.76247002868,1386,3,376.1388888888889,32,4,20,34.117054932413,0.6409505208333333,43.90782828282829,1024.3686868686877,32.01152146464649,0
1902,4,0,0,36,0.0,0.0,1.0,36,850,500,350,0.5882352941176471,12,5,7,400.6105181892657,0.42569444444444443,0.06604275300282847,0.2266598215858154,129989.29280045326,3220.770742104588,133210.06354255785,1387,4,377.1388888888889,34,2,18,34.84634018211534,0.6243872549019608,45.059523809523796,1019.7619047619027,29.99299719887949,8
1903,4,0,0,36,0.0,0.0,1.0,36,1400,900,500,0.6428571428571429,19,9,10,403.5005612321129,0.4253968253968254,0.06941366305066321,0.22954282093184475,130201.83000283432,3307.302295918349,133509.13229875267,1388,5,378.1388888888889,34,2,18,34.555921692134206,0.626531862745098,44.85119047619047,1020.5952380952369,30.017507002801086,0
1904,4,1,0,37,0.02702702702702703,0.0,1.0,37,900,600,300,0.6666666666666666,12,6,6,372.2563059514929,0.42689564564564564,0.031031280284268714,0.20312246259527103,128560.35098459339,2213.0654456073803,130773.41643020077,1389,0,368.8918918918919,32,5,18,37.026633051128826,0.6145833333333333,46.464646464646464,1014.141414141414,31.691919191919187,7
1905,4,1,0,38,0.02631578947368421,0.0,1.0,38,750,300,450,0.4,12,3,9,362.082697790066,0.4285947131341868,0.043885056595144745,0.19921761181198455,128890.09785899655,1733.7748702422166,130623.87272923876,1390,0,360.1578947368421,33,5,19,36.94786386676322,0.615530303030303,46.13970588235294,1015.4411764705883,30.77094474153298,0
1906,4,0,0,38,0.0,0.0,1.0,38,1050,700,350,0.6666666666666666,14,7,7,361.63044533011094,0.42835763394973925,0.04292025287531387,0.19990931017848512,129076.8274221452,1735.6221164936371,130812.44953863884,1391,1,361.1578947368421,33,5,20,36.76887361312107,0.6174242424242424,45.95588235294117,1016.1764705882342,30.793226381461643,0
1907,4,0,0,38,0.0,0.0,1.0,38,800,500,300,0.625,11,5,6,368.94968477739883,0.42773530109056423,0.031162285899627218,0.18959789525893408,126133.51048752859,1707.383786848105,127840.8942743767,1392,2,362.1578947368421,34,4,16,39.60357904716758,0.585171568627451,48.869047619047635,1004.5238095238116,29.54481792717093,8
1908,4,2,0,40,0.05,0.0,1.0,40,900,500,400,0.5555555555555556,13,5,8,355.8853705288548,0.43353365384615383,0.03986577181208073,0.18540881191887915,126694.89590942311,1017.7719949679617,127712.66790439107,1393,0,345.0,36,4,17,39.353560775540636,0.5868055555555556,48.31081081081082,1006.7567567567583,27.965465465465506,0
1909,4,0,0,40,0.0,0.0,1.0,40,1000,700,300,0.7,13,7,6,355.6253720226186,0.43414797008547007,0.04196668157423922,0.1857893298697608,126808.2947812679,1019.2494014284702,127827.54418269638,1394,1,346.0,36,4,17,39.24348725402504,0.587962962962963,48.198198198198206,1007.2072072072085,27.977977977978014,0
1910,4,1,2,39,0.024390243902439025,0.04878048780487805,0.9512195121951219,41,850,600,250,0.7058823529411765,11,6,5,348.8590187973824,0.43671239837398373,0.05228520321470875,0.1836621529173167,127121.19187510712,670.1089332066972,127791.30080831381,1395,0,338.5365853658537,35,6,18,39.09256761926625,0.5931547619047619,47.88773148148148,1008.4490740740737,28.812830687830676,0
1911,4,1,0,40,0.025,0.0,1.0,40,1500,1300,200,0.8666666666666667,17,13,4,355.9627918309101,0.4383146367521367,0.07803834808259591,0.18796166110697582,127242.10778061216,1058.6911848072473,128300.79896541941,1396,0,347.525,34,6,19,38.78933136676499,0.5965073529411764,47.76785714285714,1008.9285714285708,29.67436974789914,0
1912,4,0,0,40,0.0,0.0,1.0,40,1100,800,300,0.7272727272727273,14,8,6,353.0467628327505,0.4372863247863248,0.07511205472988891,0.18683710707216356,127332.20663265313,990.8446712018183,128323.05130385495,1397,1,348.525,34,6,13,38.77044507352361,0.5974264705882353,47.67857142857143,1009.2857142857149,29.68487394957985,0
1913,4,1,1,40,0.024390243902439025,0.024390243902439025,0.975609756097561,41,1350,1100,250,0.8148148148148148,16,11,5,362.9031477784964,0.4397611788617886,0.034283049760760465,0.19222591360465113,127368.57133925824,1044.4910934133597,128413.0624326716,1398,0,341.0,37,4,14,38.484412339778416,0.5917792792792793,47.64254385964912,1009.4298245614036,27.281887150308204,8
1914,4,1,1,40,0.024390243902439025,0.024390243902439025,0.975609756097561,41,1500,1300,200,0.8666666666666667,17,13,4,360.0382612392388,0.4367632113821138,0.04797586120191055,0.19188852384728666,127617.7300347223,989.4531250000064,128607.1831597223,1399,0,341.8536585365854,37,4,15,38.301116838487964,0.5943130630630631,47.395833333333336,1010.4166666666674,27.30855855855858,0
1915,4,0,0,40,0.0,0.0,1.0,40,1300,1000,300,0.7692307692307693,16,10,6,358.984335192424,0.4337072649572649,0.05419750475787688,0.1913908592023645,127631.2242037402,1163.5220341149793,128794.74623785519,1400,1,351.325,38,2,15,38.31390533587087,0.5926535087719298,47.38247863247863,1010.4700854700853,26.591318038686456,0
1916,4,1,0,41,0.024390243902439025,0.0,1.0,41,900,500,400,0.5555555555555556,13,5,8,356.7931392522053,0.4353658536585366,0.06527334500154414,0.19178371674359043,127960.02739800388,931.0519748264294,128891.07937283031,1401,0,343.7317073170732,39,2,17,38.032469370946146,0.594284188034188,47.057291666666686,1011.7708333333366,25.942841880341962,0
1917,4,2,2,41,0.046511627906976744,0.046511627906976744,0.9534883720930233,43,1450,1300,150,0.896551724137931,16,13,3,345.36554102770566,0.43895348837209297,0.08500071629817096,0.1889809196410032,128672.41753472234,288.06966145834394,128960.48719618068,1402,0,328.69767441860466,39,4,16,37.59411362080767,0.6014957264957265,46.35416666666667,1014.5833333333343,26.01495726495729,0
1918,4,0,0,41,0.0,0.0,1.0,41,900,500,400,0.5555555555555556,13,5,8,355.9285010447835,0.43559451219512196,0.0815785007944958,0.19337558768103175,128388.03624260347,939.3922583826343,129327.4285009861,1403,1,345.5121951219512,38,3,16,37.61661922833648,0.600328947368421,46.63461538461538,1013.4615384615379,26.670040485829944,0
1919,4,1,0,42,0.023809523809523808,0.0,1.0,42,1250,1000,250,0.8,15,10,5,348.9704778672662,0.4373790166473093,0.08839172667321726,0.19108046233305465,128698.84033203126,582.4191623263898,129281.25949435766,1404,0,338.26190476190476,39,3,17,37.47572545597646,0.6017628205128205,46.328125,1014.6875000000001,26.017628205128208,0
1920,4,0,0,42,0.0,0.0,1.0,42,1450,700,750,0.4827586206896552,22,7,15,341.8733551793069,0.4360844947735192,0.07907201707862166,0.18822812332268954,128917.41569378355,414.6858888558483,129332.1015826394,1405,1,339.26190476190476,40,2,17,37.433078154708284,0.60234375,46.112804878048784,1015.5487804878056,25.38871951219514,0
1921,4,0,0,42,0.0,0.0,1.0,42,1000,600,400,0.6,14,6,8,341.96805005290724,0.43545538133952766,0.07314813491666561,0.18877165082158542,129020.64252635662,424.1875082622716,129444.83003461889,1406,2,340.26190476190476,40,2,17,37.32557267180154,0.6033854166666667,46.011178861788615,1015.9552845528451,25.398882113821127,0
1922,4,1,1,42,0.023255813953488372,0.023255813953488372,0.9767441860465116,43,1200,800,400,0.6666666666666666,16,8,8,337.22932125010203,0.4373154300479882,0.07826017937931584,0.18784827210319366,129377.9538001543,126.00790895061584,129503.96170910491,1407,0,333.3255813953488,41,2,18,37.082622298065985,0.6054369918699187,45.65972222222222,1017.361111111111,24.813685636856366,0
1923,4,2,2,42,0.045454545454545456,0.045454545454545456,0.9545454545454546,44,1750,1100,650,0.6285714285714286,24,11,13,329.2671602639262,0.4404950669485553,0.08155487145784868,0.18501259518196986,129719.10609526165,-257.5516608076482,129461.55443445401,1408,0,326.52272727272725,42,2,16,36.93898823678621,0.607390873015873,45.32461240310077,1018.7015503875965,24.2547988187523,0
1924,4,0,0,42,0.0,0.0,1.0,42,1550,1100,450,0.7096774193548387,20,11,9,341.4031224755479,0.435334397986837,0.07588854813018586,0.19069449367499228,129485.67450137154,441.3627181241343,129927.03721949567,1409,2,343.07142857142856,40,2,16,36.86699117989682,0.6080729166666667,45.55386178861789,1017.7845528455285,25.444613821138212,0
1925,4,1,1,42,0.023255813953488372,0.023255813953488372,0.9767441860465116,43,1100,700,400,0.6363636363636364,15,7,8,335.85074321978556,0.4372231450719823,0.08524037950011198,0.18925917087750163,129832.5314645533,120.87043729527676,129953.40190184859,1410,0,336.06976744186045,41,2,17,36.65626318180343,0.610010162601626,45.213293650793645,1019.1468253968245,24.85723964382499,0
1926,4,1,0,43,0.023255813953488372,0.0,1.0,43,950,600,350,0.631578947368421,13,6,7,331.0300968196805,0.4365771502399409,0.09848457448732306,0.18836491350004805,130211.95515243121,20.815224237830364,130232.77037666904,1411,0,333.7906976744186,41,2,18,36.394747926386714,0.6138211382113821,44.841269841269835,1020.6349206349196,24.893534649632183,0
1927,4,1,1,43,0.022727272727272728,0.022727272727272728,0.9772727272727273,44,1450,1000,450,0.6896551724137931,19,10,9,327.41714678448216,0.43761011275546163,0.10551076483667443,0.1881806664204757,130599.97046235719,-247.84637641602046,130352.12408594116,1412,0,327.1818181818182,40,4,17,36.094609597666874,0.6192708333333333,44.461382113821145,1022.1544715447164,25.553861788617912,0
1928,4,0,0,43,0.0,0.0,1.0,43,1100,600,500,0.5454545454545454,16,6,10,334.5002551017753,0.4358388704318937,0.10426000995661755,0.19189751476891362,130528.56445312529,132.36762152780676,130660.9320746531,1413,1,335.6046511627907,39,4,18,35.98581379544683,0.6201923076923077,44.531250000000014,1021.8750000000023,26.201923076923133,0
1929,4,0,2,41,0.0,0.046511627906976744,0.9534883720930233,43,700,400,300,0.5714285714285714,10,4,6,332.8050495824553,0.4357004429678848,0.10545827772813121,0.19105619318042558,130555.17713758699,89.88444010418601,130645.06157769117,1414,2,336.6046511627907,39,4,18,36.00221265246493,0.6204594017094017,44.50520833333334,1021.9791666666681,26.204594017094053,0
1930,4,0,0,41,0.0,0.0,1.0,41,1250,900,350,0.72,16,9,7,334.0435158144138,0.4324186991869919,0.1077614811611276,0.19203099125289091,130608.41064453151,525.7785373264182,131134.18918185792,1415,3,349.3414634146341,39,2,19,35.916747341961354,0.6209935897435898,44.453125000000014,1022.187500000002,26.20993589743595,0
1931,4,0,0,41,0.0,0.0,1.0,41,750,400,350,0.5333333333333333,11,4,7,332.43073725389314,0.43226626016260167,0.1098244210515853,0.19163080138705088,130714.9102105038,490.7307942708675,131205.64100477466,1416,4,350.3414634146341,39,2,20,35.850331907235756,0.6220619658119658,44.34895833333335,1022.6041666666692,26.220619658119723,0
1932,4,0,1,40,0.0,0.024390243902439025,0.975609756097561,41,1150,800,350,0.6956521739130435,15,8,7,332.4608741460335,0.4318343495934959,0.11087377676220722,0.19204504612435633,130794.81336805588,496.83159722225685,131291.64496527813,1417,5,351.3414634146341,39,2,20,35.76883910386966,0.6228632478632479,44.27083333333335,1022.9166666666692,26.228632478632544,0
1933,4,1,0,41,0.024390243902439025,0.0,1.0,41,1250,900,350,0.72,16,9,7,329.442501261344,0.43351117886178864,0.11977498145110643,0.19148967149010956,131034.66932508699,433.677842881964,131468.34716796895,1418,0,349.0975609756098,39,2,21,35.60393139349545,0.625267094017094,44.03645833333334,1023.8541666666681,26.252670940170976,0
1934,4,0,0,41,0.0,0.0,1.0,41,1400,1200,200,0.8571428571428571,16,12,4,334.44306915658944,0.4324695121951219,0.11928528029560925,0.19520757181929135,131194.69536675364,575.4313151041871,131770.12668185783,1419,1,350.0975609756098,39,2,21,35.31445941365871,0.6268696581196581,43.88020833333334,1024.479166666668,26.268696581196618,0
1935,4,0,0,41,0.0,0.0,1.0,41,1100,600,500,0.5454545454545454,16,6,10,334.34462029542107,0.43191056910569103,0.12409819564753843,0.1955578106103661,131274.74500868074,578.2009548611313,131852.94596354186,1420,2,351.0975609756098,39,2,21,35.23624381649388,0.6276709401709402,43.80208333333334,1024.7916666666683,26.276709401709443,0
1936,4,0,0,41,0.0,0.0,1.0,41,1250,900,350,0.72,16,9,7,333.7388276130757,0.43173272357723574,0.11990027371358392,0.19589550633655578,131410.26925131486,571.3526899449248,131981.6219412598,1421,3,352.0975609756098,38,3,22,35.11514014796288,0.6307565789473684,43.66987179487179,1025.3205128205122,26.982118758434535,0
1937,4,0,0,41,0.0,0.0,1.0,41,1200,1000,200,0.8333333333333334,14,10,4,342.0681280721259,0.43165650406504064,0.101935563093831,0.19206581466664593,129690.63321827745,676.3046515450362,130366.93786982249,1422,4,353.0975609756098,38,3,18,36.64188693098385,0.6134868421052632,45.3525641025641,1018.5897435897435,26.804993252361673,8
1938,4,1,0,42,0.023809523809523808,0.0,1.0,42,1050,700,350,0.6666666666666666,14,7,7,339.30592934341496,0.4342092528068138,0.12161531279178339,0.1922733599612685,130050.0,425.34722222222234,130475.34722222222,1423,0,345.6666666666667,39,3,19,36.347698801742915,0.6153846153846154,45.0,1020.0,26.153846153846153,0
1939,4,0,1,41,0.0,0.023809523809523808,0.9761904761904762,42,1100,700,400,0.6363636363636364,15,7,8,341.2052629689265,0.43394308943089427,0.12466816418215299,0.19361322975189252,130103.13042534715,478.3745659722173,130581.50499131937,1424,1,346.6666666666667,39,3,19,36.245405350214426,0.6159188034188035,44.947916666666664,1020.2083333333327,26.159188034188016,0
1940,4,1,0,42,0.023809523809523808,0.0,1.0,42,1050,900,150,0.8571428571428571,12,9,3,343.105975199831,0.4341124661246612,0.13100621300687454,0.19577985381603968,130320.07250071032,543.0120814437884,130863.0845821541,1425,0,347.5,36,6,20,35.97707804860114,0.6235532407407407,44.73536036036037,1021.0585585585598,28.36273773773777,0
1941,4,0,0,42,0.0,0.0,1.0,42,1100,700,400,0.6363636363636364,15,7,8,343.31583856679345,0.43366482771970577,0.13650583690266194,0.19662634390643657,130463.84222059918,558.0606789221845,131021.90289952136,1426,1,348.5,36,6,21,35.82612250146972,0.625,44.594594594594604,1021.6216216216233,28.378378378378425,0
1942,4,0,1,41,0.0,0.023809523809523808,0.9761904761904762,42,1750,1600,150,0.9142857142857143,19,16,3,342.88675861825465,0.4324186991869919,0.12533692722371947,0.19792374284598271,130766.7743921207,567.6390812557743,131334.41347337648,1427,2,349.5,37,5,19,35.530571040594616,0.6261261261261262,44.29824561403509,1022.8070175438601,27.643432906590814,0
1943,4,0,1,40,0.0,0.024390243902439025,0.975609756097561,41,1050,600,450,0.5714285714285714,15,6,9,352.03361763349244,0.43038617886178865,0.12759875120231734,0.20251971995417276,130636.47050766984,997.6858615372162,131634.15636920705,1428,5,358.9756097560976,36,5,19,35.42860027906294,0.6267361111111112,44.42567567567568,1022.2972972972974,28.39714714714715,0
1944,4,0,0,40,0.0,0.0,1.0,40,1400,1000,400,0.7142857142857143,18,10,8,350.1553236342521,0.4301682692307693,0.11740167184653316,0.20256040451526397,130850.90033712305,1163.6278710757244,132014.52820819878,1429,6,354.9,37,3,20,35.25959614903726,0.6269707207207207,44.21600877192983,1023.1359649122815,27.652323376007608,0
1945,4,0,0,40,0.0,0.0,1.0,40,800,600,200,0.75,10,6,4,353.1594656082782,0.4301682692307693,0.11599282424761714,0.20519290170407534,131019.2333819059,1254.136489112026,132273.36987101793,1430,7,355.9,37,3,20,35.01247277855128,0.6286599099099099,44.051535087719294,1023.7938596491222,27.67010431484114,0
1946,4,0,0,40,0.0,0.0,1.0,40,950,700,250,0.7368421052631579,12,7,5,349.57287654459054,0.4295806623931624,0.10691842415159036,0.2037030717281983,131131.51552641182,1168.0042176438762,132299.5197440557,1431,8,356.9,37,3,20,34.99078881632945,0.6297860360360361,43.941885964912274,1024.2324561403498,27.681958274063508,0
1947,4,1,0,41,0.024390243902439025,0.0,1.0,41,1000,800,200,0.8,12,8,4,340.47127399162423,0.43145325203252033,0.1053548791919543,0.2004208891228439,131519.83486969463,755.7451466505938,132275.58001634522,1432,0,349.1707317073171,38,3,21,34.83209214317953,0.6318530701754386,43.56303418803419,1025.747863247863,26.993364822312184,0
1948,4,0,1,40,0.0,0.024390243902439025,0.975609756097561,41,1600,1300,300,0.8125,19,13,6,337.928774026269,0.43145325203252033,0.11287501237664599,0.1997834912043301,131684.26890432087,699.98070987653,132384.24961419738,1433,1,350.1707317073171,38,3,17,34.731619305367616,0.6334978070175439,43.40277777777777,1026.388888888888,27.01023391812863,0
1949,4,0,1,39,0.0,0.025,0.975,40,1050,900,150,0.8571428571428571,12,9,3,350.8626325598168,0.42803151709401704,0.11391857234451841,0.20702222670206571,131609.25116381954,1235.3536665127644,132844.6048303323,1434,11,359.9,37,3,17,34.47540428866567,0.634572072072072,43.47587719298245,1026.0964912280695,27.732337600758633,0
1950,4,0,0,39,0.0,0.0,1.0,39,1150,800,350,0.6956521739130435,15,8,7,351.1456537731272,0.4263945119208277,0.1263955517746418,0.19285526169343162,128819.24518014856,1251.5766020807032,130070.82178222926,1435,12,369.12820512820514,35,4,16,37.297747311214984,0.6104166666666666,46.209490740740755,1015.162037037039,29.004629629629687,8
1951,4,2,0,41,0.04878048780487805,0.0,1.0,41,1000,800,200,0.8,12,8,4,337.30854829141657,0.43033536585365856,0.138215881328708,0.18800633768124325,129401.82317029891,530.2342015478296,129932.05737184675,1436,0,352.0731707317073,36,5,18,37.05635491606716,0.6142939814814814,45.636261261261275,1017.4549549549569,28.26263763763769,0
1952,4,1,1,41,0.023809523809523808,0.023809523809523808,0.9761904761904762,42,1250,700,550,0.56,18,7,11,333.3783867740566,0.43201945412311266,0.15560315130455593,0.18770738211634921,129799.4797373805,254.46823179196053,130053.94796917247,1437,0,344.6666666666667,38,4,16,36.75276962326134,0.6145833333333333,45.2457264957265,1019.017094017095,26.816239316239344,0
1953,4,0,0,41,0.0,0.0,1.0,41,1200,800,400,0.6666666666666666,16,8,8,346.3580525143068,0.4291412601626016,0.16591666885452483,0.1945384708499343,129703.52055440148,784.7717566943802,130488.29231109585,1438,1,354.0487804878049,37,4,16,36.5195550771439,0.615427927927928,45.33991228070176,1018.6403508771939,27.530820293978213,0
1954,4,0,0,41,0.0,0.0,1.0,41,1050,700,350,0.6666666666666666,14,7,7,346.6885404118758,0.4288363821138212,0.16395241107258784,0.19514092102044608,129787.30384589505,799.1541868652089,130586.45803276026,1439,2,355.0487804878049,37,4,16,36.42605097026436,0.6162725225225225,45.2576754385965,1018.9692982456153,27.539710763395007,0
1955,4,0,0,41,0.0,0.0,1.0,41,1150,900,250,0.782608695652174,14,9,5,347.6703303896722,0.42840447154471545,0.17024112157868876,0.19625325207242172,129899.05698147521,832.4096116112778,130731.46659308649,1440,3,356.0487804878049,37,4,16,36.2875793266645,0.6173986486486487,45.14802631578948,1019.4078947368432,27.551564722617385,0
1956,4,1,0,42,0.023809523809523808,0.0,1.0,42,1250,800,450,0.64,17,8,9,346.5570420165089,0.4299990321331785,0.18324537718867595,0.1977413710329493,130318.55955678683,633.0708727685585,130951.63042955539,1441,0,348.54761904761904,37,5,17,35.89051761168386,0.6216216216216216,44.736842105263165,1021.0526315789484,27.596017069701308,0
1957,4,0,1,41,0.0,0.023809523809523808,0.9761904761904762,42,1100,600,500,0.5454545454545454,16,6,10,350.61889742590165,0.4292247386759582,0.19081103187383364,0.2004920214562479,130402.5412266276,744.319045283185,131146.8602719108,1442,1,349.54761904761904,37,5,17,35.70171318661657,0.6224662162162162,44.654605263157904,1021.3815789473699,27.604907539118106,0
1958,4,0,0,41,0.0,0.0,1.0,41,1400,1000,400,0.7142857142857143,18,10,8,363.89927489936906,0.42804878048780487,0.12932354566264093,0.20151411459481194,129145.65659626042,1199.2021583564183,130344.85875461684,1443,2,358.3170731707317,37,4,17,36.64104638619202,0.6097972972972974,45.88815789473684,1016.4473684210529,27.471550497866296,8
1959,4,1,1,41,0.023809523809523808,0.023809523809523808,0.9761904761904762,42,1050,600,450,0.5714285714285714,15,6,9,356.0099047426829,0.43064024390243905,0.1260430289509451,0.19924966639757744,129563.94184989604,825.2213421437243,130389.16319203976,1444,0,350.76190476190476,37,5,13,36.41570184886016,0.6140202702702703,45.47697368421052,1018.0921052631572,27.516002844950197,0
1960,4,0,0,41,0.0,0.0,1.0,41,1300,800,500,0.6153846153846154,18,8,10,363.7679328202676,0.42764227642276426,0.123913342707622,0.20304946318077552,129459.1186414454,1218.6151945864672,130677.73383603187,1445,4,360.3170731707317,36,5,13,36.324969569547406,0.6148726851851851,45.57995495495495,1017.6801801801794,28.26889389389387,0
1961,4,1,2,40,0.023809523809523808,0.047619047619047616,0.9523809523809523,42,900,700,200,0.7777777777777778,11,7,4,357.5177420636414,0.42875290360046453,0.13073327490505382,0.20094962743577083,129731.44531250001,876.2586805555553,130607.70399305558,1446,0,352.7142857142857,37,5,14,36.206970006816626,0.6157094594594594,45.3125,1018.7500000000001,27.533783783783786,0
1962,4,1,0,41,0.024390243902439025,0.0,1.0,41,750,600,150,0.8,9,6,3,358.7738961513546,0.42947154471544713,0.14393314907304156,0.20276771883610237,129946.64216581425,1124.292620323003,131070.93478613725,1447,0,358.8780487804878,36,5,15,35.956253221412254,0.6197916666666667,45.10135135135134,1019.594594594593,28.32207207207203,0
1963,4,0,0,41,0.0,0.0,1.0,41,900,600,300,0.6666666666666666,12,6,6,359.346091294826,0.42921747967479673,0.1428513722036855,0.20353955902796966,130032.77084094212,1145.3535883856598,131178.12442932779,1448,1,359.8780487804878,36,5,16,35.85417356740643,0.6206597222222222,45.01689189189188,1019.932432432431,28.33145645645642,0
1964,4,0,0,41,0.0,0.0,1.0,41,1150,800,350,0.6956521739130435,15,8,7,343.3733659262406,0.429344512195122,0.10812169977369845,0.18300668403761183,127617.73003472228,609.0019390167231,128226.731973739,1449,2,360.8780487804878,37,4,16,38.72207903780068,0.5943130630630631,47.395833333333336,1010.4166666666672,27.308558558558573,8
1965,4,0,0,41,0.0,0.0,1.0,41,1150,800,350,0.6956521739130435,15,8,7,340.02543573530653,0.4291666666666667,0.11660311293378456,0.17377179303658652,125906.24188452234,363.35002116038106,126269.59190568273,1450,3,361.8780487804878,37,4,15,40.56399996358208,0.5768581081081081,49.09539473684212,1003.618421052633,27.124822190611702,7
1966,4,3,2,42,0.06818181818181818,0.045454545454545456,0.9545454545454546,44,1300,800,500,0.6153846153846154,18,8,10,324.88562552375987,0.4372577519379845,0.14948628566186573,0.16963206264175273,126784.78109095138,-561.8894176746405,126222.89167327674,1451,0,338.1363636363636,40,4,14,40.041624621594345,0.5807291666666667,48.221544715447166,1007.1138211382133,25.177845528455332,0
1967,4,2,1,43,0.045454545454545456,0.022727272727272728,0.9772727272727273,44,1100,900,200,0.8181818181818182,13,9,4,330.2879359198583,0.43800651867512336,0.17754809266141525,0.17422227323772654,127199.76463766542,-396.74685266970664,126803.01778499571,1452,0,334.6818181818182,38,6,17,39.48029195791851,0.5882675438596492,47.80982905982906,1008.7606837606849,26.546333783175918,0
1968,4,2,2,43,0.044444444444444446,0.044444444444444446,0.9555555555555556,45,1350,1000,350,0.7407407407407407,17,10,7,328.8229691652912,0.4422138047138047,0.19987636513496798,0.1759402281542624,127775.65646701408,-596.8858506944252,127178.77061631966,1453,0,328.0888888888889,39,6,16,38.92824026375437,0.5924145299145299,47.23958333333334,1011.0416666666682,25.92414529914534,0
1969,4,0,0,43,0.0,0.0,1.0,43,850,300,550,0.35294117647058826,14,3,11,343.43687170728913,0.43865356220007384,0.20678511284535928,0.18253877814748085,127506.962779413,158.1184835718795,127665.08126298488,1454,1,344.04651162790697,37,6,16,38.833889733289894,0.5931869369369369,47.505482456140356,1009.9780701754395,27.296704599336202,0
1970,4,2,0,45,0.044444444444444446,0.0,1.0,45,1250,1000,250,0.8,15,10,5,332.5027641936672,0.4415824915824916,0.22377494450579483,0.17932106302832268,128093.08824319195,-481.7388170070656,127611.34942618488,1455,0,329.7111111111111,40,5,18,38.5110263360439,0.5940104166666667,46.925813008130085,1012.2967479674802,25.307418699187004,0
1971,4,1,1,45,0.021739130434782608,0.021739130434782608,0.9782608695652174,46,1350,900,450,0.6666666666666666,18,9,9,325.0669545231466,0.44281400966183576,0.22207663092533525,0.17644216676920493,128350.40655570429,-855.494517978715,127494.91203772557,1456,0,323.5217391304348,40,6,19,38.43688362919131,0.5966145833333334,46.671747967479675,1013.3130081300815,25.332825203252035,0
1972,4,1,2,44,0.021739130434782608,0.043478260869565216,0.9565217391304348,46,1100,800,300,0.7272727272727273,14,8,6,329.27532431548514,0.4439814814814815,0.23406043922538844,0.18000143961211235,128633.75491605522,-728.8157264194609,127904.93918963576,1457,0,321.9347826086956,40,6,17,38.041599879783625,0.5994791666666667,46.392276422764226,1014.4308943089427,25.36077235772357,0
1973,4,0,0,44,0.0,0.0,1.0,44,1350,1100,250,0.8148148148148148,16,11,5,342.60392642947943,0.44195956659619445,0.23393185650774195,0.18638910859879007,128442.17985243621,0.9590273212041893,128443.13887975742,1458,1,337.29545454545456,38,6,18,37.89896887296235,0.6008771929824561,46.58119658119658,1013.6752136752133,26.675663517768772,0
1974,4,1,0,45,0.022222222222222223,0.0,1.0,45,1350,1100,250,0.8148148148148148,16,11,5,336.36801579604924,0.44396043771043775,0.23240427253969886,0.18491703609498542,128857.43408203125,-331.2961154513903,128526.13796657986,1459,0,330.77777777777777,39,6,19,37.633908724051835,0.6033653846153846,46.171875,1015.3125,26.033653846153847,0
1975,4,0,2,43,0.0,0.044444444444444446,0.9555555555555556,45,1350,700,650,0.5185185185185185,20,7,13,334.58872782773875,0.44356060606060604,0.23393381371764121,0.1840974982629275,128891.61544054454,-374.8636724172219,128516.75176812732,1460,1,331.77777777777777,40,5,19,37.64428209234054,0.6020833333333333,46.138211382113816,1015.4471544715439,25.386178861788597,0
1976,4,0,0,43,0.0,0.0,1.0,43,1650,1100,550,0.6666666666666666,22,11,11,345.80892960471243,0.4410760428202289,0.2407503659798489,0.19099775194588686,129042.58355034713,324.81553819443434,129367.39908854157,1461,2,326.74418604651163,39,4,19,37.205676303738635,0.6052350427350428,45.98958333333333,1016.0416666666658,26.052350427350405,0
1977,4,0,1,42,0.0,0.023255813953488372,0.9767441860465116,43,1550,1100,450,0.7096774193548387,20,11,9,350.0403117441545,0.4405454042081949,0.24990468928707554,0.1941132637853951,129201.38888888904,445.43185763890665,129646.82074652794,1462,3,327.74418604651163,36,7,19,36.93647540983607,0.6122685185185186,45.83333333333334,1016.6666666666679,28.240740740740776,0
1978,4,0,0,42,0.0,0.0,1.0,42,1400,900,500,0.6428571428571429,19,9,10,357.99842090291963,0.439484126984127,0.2424843401174761,0.19911962803132002,129319.08543381347,859.2056755829956,130178.29110939646,1463,4,335.0952380952381,35,7,20,36.614322561068114,0.6154761904761905,45.717592592592595,1017.1296296296299,29.060846560846567,0
1979,4,0,0,42,0.0,0.0,1.0,42,1300,800,500,0.6153846153846154,18,8,10,356.3921595172239,0.43879452187379014,0.2367120357050645,0.19893242406159092,129459.11864144576,827.6429723642891,130286.76161381006,1464,5,336.0952380952381,36,6,17,36.512624027147666,0.6148726851851851,45.57995495495497,1017.6801801801823,28.268893893893953,0
1980,4,1,0,43,0.023255813953488372,0.0,1.0,43,1450,1100,350,0.7586206896551724,18,11,7,347.0353229698188,0.4406607604282023,0.2395495100190137,0.19566885231277045,129853.92011834338,412.77942143328454,130266.69953977666,1465,0,329.25581395348837,38,5,18,36.34958071278825,0.6151315789473684,45.1923076923077,1019.2307692307708,26.82186234817818,0
1981,4,1,0,44,0.022727272727272728,0.0,1.0,44,1100,700,400,0.6363636363636364,15,7,8,339.05156267360803,0.44155214940098664,0.23866805505251687,0.1925383308395378,130132.94004891276,24.355335778973597,130157.29538469174,1466,0,322.75,40,4,19,36.27012782204515,0.6145833333333333,44.91869918699187,1020.3252032520331,25.508130081300827,0
1982,4,1,0,45,0.022222222222222223,0.0,1.0,45,850,600,250,0.7058823529411765,11,6,5,330.4425347313705,0.44162457912457914,0.23149406857448285,0.18933624683260045,130480.8049003765,-376.5247718513705,130104.28012852513,1467,0,316.55555555555554,38,7,21,36.13776185994632,0.6214364035087719,44.57799145299147,1021.6880341880365,26.886527215474644,0
1983,4,0,0,45,0.0,0.0,1.0,45,1250,900,350,0.72,16,9,7,329.1093236481117,0.4413510101010101,0.2320476638444653,0.1891044383988883,130589.98243343222,-404.3238412228475,130185.65859220937,1468,1,317.55555555555554,38,7,19,36.061461273126376,0.622532894736842,44.47115384615386,1022.1153846153868,26.897773279352283,0
1984,4,0,1,44,0.0,0.022222222222222223,0.9777777777777777,45,1150,900,250,0.782608695652174,14,9,5,332.50195534708604,0.44097222222222227,0.23971404034073762,0.19200082753275038,130781.15297866901,-303.0021824092336,130478.15079625977,1469,2,318.55555555555554,38,7,19,35.781587285008015,0.6244517543859649,44.284188034188034,1022.8632478632479,26.917453891138102,0
1985,4,1,1,44,0.022222222222222223,0.022222222222222223,0.9777777777777777,45,1200,1000,200,0.8333333333333334,14,10,4,332.29154104127025,0.43937289562289567,0.24902639256394576,0.19274478643869697,130954.69292534742,-296.9726562499812,130657.72026909744,1470,0,319.1777777777778,39,6,20,35.61172738991792,0.624465811965812,44.11458333333334,1023.5416666666682,26.24465811965816,0
1986,4,0,0,44,0.0,0.0,1.0,44,1250,900,350,0.72,16,9,7,333.13024589906934,0.43768719168428466,0.25178244271364436,0.19340754852687783,130989.80150910531,-72.66704260027728,130917.13446650503,1471,1,325.8863636363636,40,4,20,35.55482477911247,0.6231770833333333,44.08028455284554,1023.6788617886201,25.591971544715502,0
1987,4,0,1,43,0.0,0.022727272727272728,0.9772727272727273,44,1450,1100,350,0.7586206896551724,18,11,7,337.2027843676526,0.43740089852008457,0.2539649246258351,0.19630227949583134,131093.854569453,41.04255486154989,131134.89712431454,1472,2,326.8863636363636,40,4,21,35.34554761668485,0.62421875,43.97865853658538,1024.0853658536607,25.60213414634152,0
1988,4,0,0,43,0.0,0.0,1.0,43,1000,500,500,0.5,15,5,10,338.1065529868426,0.43699243263196746,0.24659867163698923,0.19693504910939796,131114.670138889,266.1458333333387,131380.81597222234,1473,3,331.1162790697674,39,4,21,35.301396799566035,0.6260683760683761,43.958333333333336,1024.1666666666674,26.26068376068378,0
1989,4,0,0,43,0.0,0.0,1.0,43,1350,1000,350,0.7407407407407407,17,10,7,338.3462065381706,0.43699243263196746,0.24742524916943465,0.1973686204805997,131171.92147531244,276.3044070989563,131448.2258824114,1474,4,332.1162790697674,40,3,21,35.23747519841269,0.625,43.90243902439025,1024.3902439024398,25.609756097560997,0
1990,4,0,0,43,0.0,0.0,1.0,43,1600,800,800,0.5,24,8,16,337.990049379481,0.4364156515319306,0.2514856279761557,0.19783108810168695,131302.08462431424,275.7596131601525,131577.8442374744,1475,5,333.1162790697674,40,3,21,35.11527020327218,0.6263020833333333,43.77540650406504,1024.89837398374,25.6224593495935,0
1991,4,0,0,43,0.0,0.0,1.0,43,1000,500,500,0.5,15,5,10,337.18782601752184,0.43611572535991144,0.24375708551643815,0.19839190693589068,131501.3239590942,268.13943668574893,131769.46339577995,1476,6,334.1162790697674,36,7,22,34.93494729907772,0.6354166666666667,43.58108108108108,1025.6756756756756,28.49099099099099,0
1992,4,0,0,43,0.0,0.0,1.0,43,1100,800,300,0.7272727272727273,14,8,6,337.0116558955883,0.4356312292358804,0.24590823918845772,0.1988496264735758,131609.25116381937,270.7703331794173,131880.0214969988,1477,7,335.1162790697674,37,6,19,34.830715252546845,0.634572072072072,43.475877192982445,1026.096491228068,27.732337600758598,0
1993,4,0,1,42,0.0,0.023255813953488372,0.9767441860465116,43,950,600,350,0.631578947368421,13,6,7,335.6215930169322,0.43556201550387597,0.2399848947351857,0.19841948579161006,131684.26890432075,239.21682098762722,131923.4857253084,1478,8,336.1162790697674,38,5,19,34.790820929183575,0.6334978070175439,43.402777777777764,1026.388888888887,27.01023391812861,0
1994,4,0,0,42,0.0,0.0,1.0,42,1200,800,400,0.6666666666666666,16,8,8,339.46028289656505,0.4348262679055362,0.2389748126455371,0.20148193977244758,131834.3685076175,550.5064058171522,132384.87491343464,1479,9,339.54761904761904,37,5,19,34.541159513132605,0.6368243243243243,43.25657894736841,1026.9736842105247,27.75604551920337,0
1995,4,1,1,42,0.023255813953488372,0.023255813953488372,0.9767441860465116,43,850,600,250,0.7058823529411765,11,6,5,324.611789009296,0.4366694352159468,0.2356037754208422,0.185603391323497,130398.95171305432,-122.8790226431858,130276.07269041114,1480,0,332.6279069767442,38,5,19,36.369421199442115,0.6206140350877193,44.65811965811966,1021.3675213675217,26.87809266756636,8
1996,4,0,0,42,0.0,0.0,1.0,42,1250,900,350,0.72,16,9,7,330.6486833321377,0.4370281649245064,0.22697901490172034,0.18907258964020038,130402.54122662745,223.48571194983728,130626.02693857728,1481,1,326.6666666666667,37,5,19,36.211643406691714,0.6224662162162162,44.6546052631579,1021.3815789473687,27.604907539118074,0
1997,4,0,0,42,0.0,0.0,1.0,42,1150,900,250,0.782608695652174,14,9,5,329.23235806992676,0.43664101819589624,0.2116751217169628,0.18908039492112078,130570.5857210874,197.61236630503456,130768.19808739243,1482,2,327.6666666666667,37,5,13,36.07791992990739,0.6241554054054055,44.49013157894738,1022.0394736842117,27.622688477951666,0
1998,4,1,0,43,0.023255813953488372,0.0,1.0,43,1000,600,400,0.6,14,6,8,324.73925758691763,0.43724621631598376,0.2165266786425204,0.18831731765633622,130945.12473518899,-95.39548177366851,130849.72925341532,1483,0,321.0232558139535,38,5,14,35.81463117606124,0.6260964912280702,44.12393162393163,1023.5042735042748,26.9343229869546,0
1999,4,0,1,42,0.0,0.023255813953488372,0.9767441860465116,43,1600,1100,500,0.6875,21,11,10,327.2062911287934,0.4364156515319306,0.22139243731120595,0.19042333336183878,131081.84633875746,-21.839045036148946,131060.00729372131,1484,1,322.0232558139535,38,5,15,35.61358894105373,0.627467105263158,43.99038461538462,1024.0384615384621,26.948380566801635,0
2000,4,0,0,42,0.0,0.0,1.0,42,1150,800,350,0.6956521739130435,15,8,7,349.43483892270564,0.43529810298102983,0.21925648872265668,0.19955104102362628,130351.21588059382,880.4832104586345,131231.69909105246,1485,2,330.26190476190476,35,7,18,35.78395953757225,0.6258928571428571,44.70486111111109,1021.180555555553,29.17658730158723,8
2001,4,0,0,42,0.0,0.0,1.0,42,1600,1500,100,0.9375,17,15,2,351.7087023503252,0.43514082462253195,0.21977436704709463,0.20188212990697027,130550.14209733372,783.1242137407573,131333.2663110745,1486,3,331.26190476190476,36,6,17,35.52433425160697,0.6258680555555556,44.51013513513513,1021.9594594594587,28.38776276276274,0
2002,4,0,0,42,0.0,0.0,1.0,42,1100,800,300,0.7272727272727273,14,8,6,344.3296101855148,0.43493515292295776,0.19137409835084274,0.19495672946802625,130017.30974687697,553.761916502292,130571.07166337926,1487,4,332.26190476190476,38,4,17,36.25274984286614,0.6167763157894737,45.03205128205128,1019.8717948717941,26.838731443994583,8
2003,4,0,1,41,0.0,0.023809523809523808,0.9761904761904762,42,1000,400,600,0.4,16,4,12,346.196891690846,0.43475367789392183,0.18883802342803313,0.19642508132833583,130099.0430843196,607.9768655489888,130707.01994986858,1488,5,333.26190476190476,38,4,17,36.122237930673364,0.6175986842105263,44.95192307692308,1020.1923076923083,26.847165991902852,0
2004,4,0,0,41,0.0,0.0,1.0,41,1300,700,600,0.5384615384615384,19,7,12,352.8185917447103,0.43376524390243903,0.1933595594020454,0.19958715956361356,129982.90339335185,972.0769852262273,130954.98037857808,1489,9,342.2682926829268,37,4,17,36.071236559139784,0.6182432432432432,45.06578947368421,1019.7368421052636,27.56045519203415,0
2005,4,2,0,43,0.046511627906976744,0.0,1.0,43,1600,1100,500,0.6875,21,11,10,337.64325378071817,0.4349390919158361,0.19527300303336692,0.1941448709239131,130617.2839506174,220.70952387060385,130837.99347448802,1490,0,327.30232558139534,38,5,16,35.81578351449275,0.6228070175438596,44.44444444444445,1022.2222222222232,26.900584795321663,0
2006,4,0,0,43,0.0,0.0,1.0,43,1300,600,700,0.46153846153846156,20,6,14,336.9799235116471,0.43480066445182725,0.18564332989252508,0.19472436738829327,130808.47447083423,215.9659443713888,131024.44041520562,1491,1,328.30232558139534,38,5,16,35.63946910356832,0.6247258771929824,44.25747863247863,1022.9700854700853,26.920265407107507,0
2007,4,0,0,43,0.0,0.0,1.0,43,1150,900,250,0.782608695652174,14,9,5,338.2094934611211,0.4345699520118125,0.18601737813094021,0.19598963931422114,130917.78897518062,255.5278188691434,131173.31679404975,1492,2,329.30232558139534,38,5,16,35.497572815533964,0.6258223684210527,44.150641025641015,1023.3974358974344,26.931511470985118,0
2008,4,0,1,42,0.0,0.023255813953488372,0.9767441860465116,43,1300,1000,300,0.7692307692307693,16,10,6,338.38830577395305,0.4344084533038022,0.188045968086346,0.196790869086017,131054.4963109063,269.46179414125174,131323.95810504755,1493,3,330.30232558139534,38,5,17,35.354931830829166,0.6271929824561404,44.017094017094,1023.9316239316217,26.94556905083215,0
2009,4,0,0,42,0.0,0.0,1.0,42,1100,700,400,0.6363636363636364,15,7,8,341.5944935771874,0.43368902439024387,0.18567756937857638,0.19861826780969938,131047.29940943349,553.0071752846827,131600.30658471817,1494,4,333.8333333333333,37,5,17,35.28012779324623,0.6289414414414414,44.024122807017534,1023.9035087719284,27.673067804646713,0
2010,4,0,0,42,0.0,0.0,1.0,42,1500,1100,400,0.7333333333333333,19,11,8,348.399005388902,0.4324670925280681,0.1894547270068827,0.2039126802360715,131300.0289151467,748.9598963142188,132048.9888114609,1495,5,334.8333333333333,37,5,18,34.850642808744325,0.6314752252252251,43.77741228070174,1024.8903508771907,27.699739212897047,0
2011,4,0,1,41,0.0,0.023809523809523808,0.9761904761904762,42,1500,1100,400,0.7333333333333333,19,11,8,351.3052106711672,0.4322493224932249,0.1937858975925706,0.20636974435909217,131440.53939673706,835.1492767004864,132275.68867343754,1496,6,335.8333333333333,37,5,18,34.634302822925584,0.6328828828828829,43.640350877192965,1025.438596491225,27.714556661925002,0
2012,4,0,0,41,0.0,0.0,1.0,41,1400,900,500,0.6428571428571429,19,9,10,357.12869893587487,0.430005081300813,0.19924817066472333,0.20933306802403537,131356.983567182,1182.2697274977627,132539.25329467977,1497,7,344.6341463414634,36,5,18,34.56941850671939,0.6339699074074074,43.721846846846844,1025.1126126126123,28.475350350350343,0
2013,4,0,1,40,0.0,0.024390243902439025,0.975609756097561,41,1250,900,350,0.72,16,9,7,356.836963113544,0.4295985772357724,0.20155101056776603,0.2094777916923803,131414.71021274655,1178.7252201525846,132593.43543289913,1498,8,345.6341463414634,36,5,18,34.51857953505398,0.6345486111111112,43.66554054054054,1025.337837837838,28.481606606606608,0
2014,4,0,1,39,0.0,0.025,0.975,40,1300,1000,300,0.7692307692307693,16,10,6,366.7707464518452,0.4284722222222222,0.1970930232558139,0.21515597828281088,131387.4488275891,1637.8145361796903,133025.26336376878,1499,9,354.3,35,5,18,34.29150673590728,0.6363095238095238,43.692129629629626,1025.231481481481,29.29232804232803,0
2015,4,1,0,40,0.025,0.0,1.0,40,1150,800,350,0.6956521739130435,15,8,7,362.79948048720337,0.4286858974358974,0.19725355289871405,0.21415314207720046,131624.8780971367,1550.6874785665527,133175.56557570325,1500,0,353.05,35,5,17,34.15341379051056,0.6386904761904761,43.46064814814816,1026.1574074074092,29.31878306878312,0
2016,4,0,0,40,0.0,0.0,1.0,40,1150,1000,150,0.8695652173913043,13,10,3,366.49387223710477,0.4289529914529915,0.20246955345060869,0.2166711772665765,131684.26890432113,1652.295524691374,133336.5644290125,1501,1,354.05,35,5,17,33.99864682002707,0.6392857142857142,43.402777777777786,1026.38888888889,29.325396825396858,0
2017,4,0,0,40,0.0,0.0,1.0,40,1200,700,500,0.5833333333333334,17,7,10,363.5514330248207,0.4276709401709402,0.20193868349864696,0.2156034969115117,131803.09070644746,1583.440500685902,133386.53120713338,1502,2,355.05,35,5,17,33.95420048091373,0.6404761904761904,43.28703703703705,1026.851851851854,29.3386243386244,0
2018,4,0,0,40,0.0,0.0,1.0,40,1200,700,500,0.5833333333333334,17,7,10,364.7869232295176,0.4269230769230769,0.20356901408450678,0.21684420252257028,131892.2422223296,1622.5130476251989,133514.7552699548,1503,3,356.05,35,5,17,33.8325117370892,0.6413690476190477,43.200231481481495,1027.199074074076,29.348544973545028,0
2019,4,0,0,40,0.0,0.0,1.0,40,1400,1100,300,0.7857142857142857,17,11,6,368.69392381309785,0.4268696581196581,0.20656164383561615,0.21974735824915234,131992.67415642022,1732.979389862867,133725.65354628308,1504,4,357.05,36,4,17,33.630821917808234,0.6403356481481481,43.10247747747749,1027.5900900900922,28.544169169169226,0
2020,4,0,1,39,0.0,0.025,0.975,40,1300,900,400,0.6923076923076923,17,9,8,375.2052463302118,0.4262019230769231,0.209886448448662,0.2248594252607706,132200.59447378057,1920.4713229070696,134121.06579668765,1505,5,358.05,37,3,18,33.25370064328108,0.6404842342342343,42.900219298245624,1028.399122807019,27.79457088667619,0
2021,4,0,0,39,0.0,0.0,1.0,39,800,600,200,0.75,10,6,4,382.1845712918559,0.4267881241565452,0.20734638408751382,0.22900981004181323,132195.26113951812,2304.597841084354,134499.85898060247,1506,6,365.0769230769231,36,3,18,33.07964666374655,0.6423611111111112,42.90540540540542,1028.3783783783801,28.566066066066114,0
2022,4,0,0,39,0.0,0.0,1.0,39,800,300,500,0.375,13,3,10,384.42586591870327,0.4255229419703104,0.21186402622479683,0.23106017835745235,132311.0948786626,2372.7614438763294,134683.85632253895,1507,7,366.0769230769231,36,3,18,32.90508245767659,0.6435185185185186,42.7927927927928,1028.8288288288302,28.578578578578615,0
2023,4,0,1,38,0.0,0.02564102564102564,0.9743589743589743,39,1300,900,400,0.6923076923076923,17,9,8,385.36592233067546,0.42448268106162845,0.21346767042131276,0.23276101708772792,132495.48037190075,2411.962734037358,134907.44310593812,1508,8,367.0769230769231,32,7,20,32.69484302182979,0.654296875,42.61363636363636,1029.545454545454,32.17329545454544,0
2024,4,0,0,38,0.0,0.0,1.0,38,1000,700,300,0.7,13,7,6,389.62445333510925,0.4240161213845424,0.20787343635025723,0.23533316981440594,132495.48037190078,2724.6958218549053,135220.17619375567,1502,9,338.05263157894734,32,6,21,32.58523424086337,0.654296875,42.61363636363636,1029.5454545454543,32.173295454545446,0
2025,4,0,0,38,0.0,0.0,1.0,38,650,500,150,0.7692307692307693,8,5,3,390.8515140280059,0.4233197012802276,0.20681945761793252,0.23668714179112424,132592.99314164367,2764.834423783281,135357.82756542697,1503,10,339.05263157894734,32,6,21,32.45525315679784,0.6552734375,42.51893939393939,1029.924242424242,32.185132575757564,0
2026,4,0,0,38,0.0,0.0,1.0,38,1550,1300,250,0.8387096774193549,18,13,5,393.09385443038445,0.4229492650545282,0.20106590057019114,0.23901129587166303,132745.0698799739,2836.2542351499214,135581.3241151238,1504,11,340.05263157894734,33,5,16,32.24409858484956,0.6543560606060606,42.371323529411754,1030.5147058823518,31.227718360071265,0
2027,4,0,0,38,0.0,0.0,1.0,38,1250,1000,250,0.8,15,10,5,394.0599856118682,0.42241583688952106,0.2114798997017313,0.24122202901055212,132997.7671598663,2881.81964268549,135879.58680255178,1505,12,341.05263157894734,33,5,16,31.964451902894925,0.6568813131313131,42.12622549019607,1031.4950980392148,31.25742721330954,0
2028,4,0,0,38,0.0,0.0,1.0,38,1050,600,450,0.5714285714285714,15,6,9,394.82930404989804,0.4224010194404931,0.2075189756286655,0.24189760418428236,133029.3712153978,2904.7788110342008,135934.150026432,1506,13,342.05263157894734,33,5,16,31.9127662944484,0.6571969696969697,42.09558823529411,1031.6176470588225,31.261140819964318,0
2029,4,0,1,37,0.0,0.02631578947368421,0.9736842105263158,38,650,500,150,0.7692307692307693,8,5,3,350.7742502531782,0.4221194879089616,0.1257966580917289,0.2026993186577523,130809.21292914511,1585.5512373169688,132394.7641664621,1507,14,343.05263157894734,36,2,15,35.285942316160295,0.6284722222222222,44.256756756756744,1022.972972972971,28.41591591591586,8
2030,4,0,1,36,0.0,0.02702702702702703,0.972972972972973,37,1250,1000,250,0.8,15,10,5,358.10690267330915,0.42001376376376376,0.14894762676821038,0.20709110189605404,130838.01442912484,1970.799219827904,132808.81364895275,1508,25,352.94594594594594,36,1,15,35.069253348009525,0.6287615740740741,44.22860360360359,1023.0855855855837,28.41904404404399,0
2031,4,0,0,36,0.0,0.0,1.0,36,1050,700,350,0.6666666666666666,14,7,7,368.3995004197295,0.41879960317460313,0.15299145299145311,0.21313164814858673,130854.01663237298,2441.310871056224,133295.3275034292,1509,26,355.3333333333333,35,1,15,34.789781297134226,0.6309523809523809,44.212962962962955,1023.1481481481471,29.232804232804202,0
2032,4,1,0,37,0.02702702702702703,0.0,1.0,37,1550,1100,450,0.7096774193548387,20,11,9,360.24735543002356,0.4211086086086086,0.14423131212575968,0.20989427915669845,131126.20380092924,2047.5736293726063,133173.77743030185,1510,0,346.7027027027027,36,1,18,34.72283305845703,0.6316550925925926,43.94707207207207,1024.2117117117111,28.45032532532531,0
2033,4,0,0,37,0.0,0.0,1.0,37,1450,1200,250,0.8275862068965517,17,12,5,364.92835854828655,0.4209834834834835,0.1520117260449394,0.21391409771676625,131358.63272392293,2187.6087434304136,133546.24146735333,1511,1,347.7027027027027,34,3,18,34.36786281113304,0.6381740196078431,43.720238095238095,1025.1190476190477,30.150560224089638,0
2034,4,0,0,37,0.0,0.0,1.0,37,850,600,250,0.7058823529411765,11,6,5,365.7287834788632,0.4203578578578579,0.1540797821271469,0.2148968445352614,131450.1771541952,2215.022675736988,133665.1998299322,1512,2,348.7027027027027,34,3,18,34.25479839021748,0.639093137254902,43.630952380952394,1025.4761904761922,30.16106442577036,0
2035,4,0,0,37,0.0,0.0,1.0,37,1050,800,250,0.7619047619047619,13,8,5,366.4407359038537,0.420482982982983,0.15438997079939365,0.21583184014241352,131541.7534722223,2240.4513888888987,133782.2048611112,1513,3,349.7027027027027,34,3,18,34.1439886271324,0.6400122549019608,43.54166666666667,1025.8333333333342,30.171568627451006,0
2036,4,0,0,37,0.0,0.0,1.0,37,550,400,150,0.7272727272727273,7,4,3,365.11899487065574,0.420264014014014,0.15281027139927095,0.21522541024591746,131572.2859977325,2207.908163265315,133780.19416099784,1514,4,350.7027027027027,34,3,14,34.14703720894252,0.6403186274509804,43.511904761904766,1025.9523809523816,30.175070028011223,0
2037,4,0,0,37,0.0,0.0,1.0,37,950,500,450,0.5263157894736842,14,5,9,361.2203156443352,0.41954454454454454,0.15228760560289656,0.21355345060893102,131684.268904321,2113.4066358024706,133797.67554012348,1515,5,351.7027027027027,35,2,15,34.1339648173207,0.6392857142857142,43.40277777777778,1026.3888888888891,29.325396825396833,0
2038,4,0,0,37,0.0,0.0,1.0,37,1150,800,350,0.6956521739130435,15,8,7,358.0996075715602,0.4193255755755756,0.14454717875770484,0.21262164199561415,131848.06428049685,2042.9480155831639,133891.01229608,1516,6,352.7027027027027,36,1,16,34.04879385964912,0.6388888888888888,43.24324324324325,1027.027027027028,28.528528528528554,0
2039,4,0,1,36,0.0,0.02702702702702703,0.972972972972973,37,1350,900,450,0.6666666666666666,18,9,9,356.8597765772219,0.4190753253253254,0.14709646077467187,0.2125318930476877,131963.7458404351,2018.5105713822006,133982.2564118173,1517,7,353.7027027027027,36,1,17,33.96399605436212,0.6400462962962963,43.130630630630634,1027.477477477478,28.541041041041055,0
2040,4,0,1,35,0.0,0.027777777777777776,0.9722222222222222,36,1450,1100,350,0.7586206896551724,18,11,7,375.31044558071596,0.41574074074074074,0.16028528528528518,0.22397558849171748,132040.8950617283,2711.265432098755,134752.16049382708,1518,35,364.3333333333333,35,1,17,33.41216216216216,0.6428571428571428,43.05555555555555,1027.7777777777771,29.365079365079346,0
2041,4,0,1,34,0.0,0.02857142857142857,0.9714285714285714,35,750,500,250,0.6666666666666666,10,5,5,381.31565774665216,0.4137605042016807,0.16002780674313533,0.22713150048387537,131969.53125,3064.409722222222,135033.94097222222,1519,36,373.6857142857143,34,1,17,33.32995404163289,0.6443014705882353,43.125,1027.5,30.220588235294116,0
2042,4,0,0,34,0.0,0.0,1.0,34,700,400,300,0.5714285714285714,10,4,6,389.9307524044276,0.4100564468211527,0.17334287076776422,0.23295862900059383,132082.88278546708,3500.6355728565945,135583.51835832366,1520,37,383.5882352941176,33,1,17,32.99405897313625,0.6477272727272727,43.01470588235294,1027.9411764705878,31.149732620320844,0
2043,4,0,0,34,0.0,0.0,1.0,34,1100,900,200,0.8181818181818182,13,9,4,403.45228096937655,0.4096293820558527,0.2001086562839549,0.22145760392772343,128796.78376405714,3592.6712382256874,132389.45500228283,1521,38,384.5882352941176,33,1,18,35.993274377238514,0.6145833333333333,46.231617647058826,1015.0735294117651,30.75980392156864,8
2044,4,0,0,34,0.0,0.0,1.0,34,1000,700,300,0.7,13,7,6,405.62443453129055,0.40890522875817,0.1721174034237889,0.21034560853236675,126505.73284614095,3471.057105440218,129976.78995158117,1522,39,385.5882352941176,33,1,17,38.29727027246516,0.5912247474747474,48.49877450980392,1006.0049019607847,30.484997029114687,8
2045,4,3,0,37,0.08108108108108109,0.0,1.0,37,750,300,450,0.4,12,3,9,382.3463658042617,0.41973223223223227,0.18598059093324926,0.20268786110009707,127401.12727076124,2346.337796760861,129747.46506752209,1523,0,355.2432432432432,33,4,17,37.96026543659463,0.6003787878787878,47.61029411764706,1009.5588235294117,30.592691622103384,0
2046,4,0,0,37,0.0,0.0,1.0,37,1100,600,500,0.5454545454545454,16,6,10,383.3626348222283,0.41935685685685686,0.19080910563560427,0.20384998943256802,127524.87775134559,2377.654628027676,129902.53237937327,1524,1,356.2432432432432,33,4,17,37.80736876162744,0.6016414141414141,47.48774509803921,1010.0490196078428,30.607546048722508,0
2047,4,1,1,37,0.02631578947368421,0.02631578947368421,0.9736842105263158,38,1100,900,200,0.8181818181818182,13,9,4,375.1626297577855,0.4227862731152205,0.19965944272445801,0.20182799702159346,127993.90589569164,2003.7060657596426,129997.61196145129,1525,0,347.8421052631579,34,4,18,37.53308823529412,0.6041666666666667,47.023809523809526,1011.9047619047622,29.76190476190477,0
2048,4,0,0,37,0.0,0.0,1.0,37,900,500,400,0.5555555555555556,13,5,8,382.6228373702423,0.4222034534534535,0.19987281399046108,0.20584139985107966,127993.90589569163,2394.6782879818647,130388.58418367349,1526,1,347.18918918918916,34,3,19,37.34436274509804,0.6041666666666667,47.023809523809526,1011.904761904762,29.761904761904766,0
2049,4,1,0,38,0.02631578947368421,0.0,1.0,38,1400,1000,400,0.7142857142857143,18,10,8,374.9554100288582,0.4237790422000948,0.2014934870727776,0.2038958708973498,128423.86529519911,2030.8217680454727,130454.68706324458,1527,0,339.0263157894737,33,5,18,37.09786704550034,0.6107954545454546,46.59926470588236,1013.6029411764719,30.71524064171127,0
2050,4,2,0,40,0.05,0.0,1.0,40,1150,800,350,0.6956521739130435,15,8,7,361.54827997789687,0.4272702991452992,0.19968390477275233,0.1997503052187513,129054.34355977802,1331.8751875428684,130386.21874732089,1528,0,323.025,35,5,20,36.79388787637162,0.612797619047619,45.97800925925926,1016.0879629629635,29.031084656084673,0
2051,4,0,3,37,0.0,0.075,0.925,40,850,600,250,0.7058823529411765,11,6,5,380.1132389386257,0.42694978632478636,0.1434644319061844,0.21248259534732425,129516.42679419267,1866.1215224311318,131382.5483166238,1529,1,324.025,36,4,14,35.85066563410406,0.6154513888888888,45.52364864864864,1017.905405405404,28.27515015015011,8
2052,4,0,0,37,0.0,0.0,1.0,37,1100,800,300,0.7272727272727273,14,8,6,392.4024443677886,0.4202327327327327,0.15042062766942887,0.2191148593664416,129473.85381235815,2761.1713435374,132235.02515589556,1530,2,329.81081081081084,34,3,14,35.58140328303506,0.6191789215686274,45.56547619047618,1017.7380952380942,29.93347338935571,0
2053,4,0,1,36,0.0,0.02702702702702703,0.972972972972973,37,550,200,350,0.36363636363636365,9,2,7,390.00335590731595,0.42001376376376376,0.1482820519303214,0.2182793651648797,129564.7392290248,2706.136621315176,132270.87585033997,1531,3,330.81081081081084,34,3,15,35.549676488930466,0.6200980392156863,45.47619047619047,1018.0952380952369,29.94397759103638,0
2054,4,0,0,36,0.0,0.0,1.0,36,900,700,200,0.7777777777777778,11,7,4,392.23935322151135,0.4155588624338624,0.155963364086108,0.21993988024768943,129637.82709775078,2969.81149077277,132607.63858852355,1532,4,340.8333333333333,33,3,16,35.418170878459684,0.6231060606060606,45.40441176470588,1018.3823529411758,30.86007130124775,0
2055,4,0,0,36,0.0,0.0,1.0,36,950,600,350,0.631578947368421,13,6,7,390.43271510905174,0.41564153439153434,0.1542099493308735,0.21910103276646353,129669.02941476816,2925.4062439926684,132594.43565876083,1533,5,341.8333333333333,33,3,16,35.43233365419323,0.6234217171717171,45.37377450980391,1018.5049019607827,30.863784907902506,0
2056,4,0,0,36,0.0,0.0,1.0,36,1300,1000,300,0.7692307692307693,16,10,6,395.73709195840235,0.4146329365079365,0.15223441940130011,0.22338145803822013,129898.25857426306,3081.111819727894,132979.37039399095,1534,6,342.8333333333333,34,2,17,35.063402623691076,0.623468137254902,45.148809523809526,1019.404761904762,29.982492997198882,0
2057,4,1,1,36,0.02702702702702703,0.02702702702702703,0.972972972972973,37,750,600,150,0.8,9,6,3,369.72373478507086,0.41741741741741745,0.07546960269252256,0.20156500562862478,128525.6736137901,2176.123384506814,130701.79699829692,1535,0,334.5405405405405,35,2,18,37.126303123692104,0.6074404761904761,46.49884259259258,1014.0046296296281,28.971560846560802,8
2058,4,1,0,37,0.02702702702702703,0.0,1.0,37,950,800,150,0.8421052631578947,11,8,3,367.1132436153083,0.4206393893893894,0.08999349526325706,0.20102946950502215,128701.77636584778,2049.6253161436744,130751.40168199145,1536,0,335.3243243243243,35,2,19,37.01249477206189,0.6092261904761904,46.325231481481474,1014.699074074073,28.991402116402085,0
2059,4,0,0,37,0.0,0.0,1.0,37,1050,700,350,0.6666666666666666,14,7,7,346.9592651922065,0.4199512012012012,0.04213555283961723,0.18559027443073606,127763.95486379012,1493.272703403617,129257.22756719374,1537,1,336.3243243243243,35,2,18,38.48180213699678,0.5997023809523809,47.2511574074074,1010.9953703703688,28.885582010581967,8
2060,4,0,2,35,0.0,0.05405405405405406,0.9459459459459459,37,1350,1100,250,0.8148148148148148,16,11,5,347.81925823027166,0.41973223223223227,0.040692099744514154,0.18645672873718472,127851.72994898817,1493.8587748628033,129345.58872385097,1538,2,337.3243243243243,35,2,18,38.37024109254596,0.6005952380952381,47.16435185185184,1011.3425925925912,28.895502645502606,0
2061,4,2,0,37,0.05405405405405406,0.0,1.0,37,1250,1100,150,0.88,14,11,3,340.98527613564596,0.42336086086086083,0.06439182241764185,0.1848076855737031,128291.05748724692,1349.0723326045702,129640.12981985149,1539,0,335.6756756756757,35,2,20,38.094201035835304,0.6050595238095238,46.73032407407406,1013.0787037037023,28.94510582010578,0
2062,4,0,0,37,0.0,0.0,1.0,37,750,600,150,0.8,9,6,3,344.2643365086966,0.42336086086086083,0.06527852809977319,0.18685891296550755,128349.69142500426,1437.244271905006,129786.93569690926,1540,1,336.6756756756757,35,2,20,37.95128973919666,0.6056547619047619,46.6724537037037,1013.310185185185,28.951719576719572,0
2063,4,2,0,39,0.05128205128205128,0.0,1.0,39,1350,1100,250,0.8148148148148148,16,11,5,326.1735282132777,0.42656320287899235,0.06543416994723361,0.17960875257499265,128922.84765504763,610.2440173899513,129533.09167243759,1541,0,320.35897435897436,37,2,21,37.826153458576236,0.607545045045045,46.10745614035087,1015.5701754385959,27.44784257942151,0
2064,4,0,1,38,0.0,0.02564102564102564,0.9743589743589743,39,1250,1000,250,0.8,15,10,5,325.2505152275785,0.425410481331534,0.06705944181672274,0.1801118444539817,129145.65659626045,600.9382694675303,129746.59486572798,1542,1,321.35897435897436,37,2,21,37.62315713772023,0.6097972972972974,45.88815789473684,1016.4473684210532,27.471550497866303,0
2065,4,0,0,38,0.0,0.0,1.0,38,1150,900,250,0.782608695652174,14,9,5,331.9740386878611,0.4233937885253675,0.07487590193482152,0.18342937851075156,129058.3166570288,968.8021213781512,130027.11877840695,1543,2,330.3157894736842,36,2,21,37.54109867375964,0.6108217592592593,45.97409909909911,1016.1036036036048,28.225100100100136,0
2066,4,1,3,36,0.02564102564102564,0.07692307692307693,0.9230769230769231,39,1450,1300,150,0.896551724137931,16,13,3,322.35578557187154,0.42633828160143955,0.08149945703964723,0.17676096867613966,128755.86718990434,506.6323288268903,129262.49951873123,1544,0,322.8205128205128,37,2,19,38.09285868625754,0.6058558558558558,46.27192982456139,1014.9122807017525,27.430061640587905,8
2067,4,0,0,36,0.0,0.0,1.0,36,1100,600,500,0.5454545454545454,16,6,10,334.3769093138792,0.41987433862433865,0.10797961357066765,0.1826982065602765,128613.70991941007,1401.090963648822,130014.8008830589,1545,1,347.75,35,1,19,37.93264110756123,0.6083333333333334,46.41203703703703,1014.3518518518513,28.981481481481467,0
2068,4,2,0,38,0.05263157894736842,0.0,1.0,38,1100,800,300,0.7272727272727273,14,8,6,325.3455002506522,0.4239420341394025,0.12438360051071107,0.18080164858147385,129285.0098708256,812.4592422668485,130097.46911309245,1546,0,330.39473684210526,37,1,21,37.47922282120395,0.611204954954955,45.75109649122807,1016.9956140350873,27.48636794689425,0
2069,4,2,2,38,0.05,0.05,0.95,40,1100,800,300,0.7272727272727273,14,8,6,312.63016228207084,0.427457264957265,0.13129599345870768,0.17619663063178478,129837.58680555565,118.22916666667274,129955.81597222232,1547,0,314.825,39,1,17,37.24277732352138,0.6132478632478633,45.208333333333336,1019.1666666666674,26.13247863247865,0
2070,4,1,0,39,0.02564102564102564,0.0,1.0,39,700,400,300,0.5714285714285714,10,4,6,321.10926303127576,0.4286437246963563,0.14302985363337428,0.18155609042479223,129962.8351230914,546.4540415662066,130509.2891646576,1548,0,316.5897435897436,38,1,20,36.8999284017882,0.6162280701754386,45.08547008547008,1019.6581196581186,26.833108412055754,0
2071,4,0,0,39,0.0,0.0,1.0,39,1300,1100,200,0.8461538461538461,15,11,4,320.56248458101476,0.42853126405757985,0.14579138139347547,0.18200783161407183,130126.29323727071,542.7215738914341,130669.01481116215,1549,1,317.5897435897436,38,1,21,36.74847294938916,0.6178728070175439,44.92521367521367,1020.2991452991447,26.84997750787223,0
2072,4,1,0,40,0.025,0.0,1.0,40,1000,700,300,0.7,13,7,6,315.46270694118283,0.4302083333333333,0.14943383063217808,0.18064941859686534,130458.54403518383,231.10376741684806,130689.64780260068,1550,0,310.625,37,3,22,36.54285624843476,0.6230292792792793,44.59978070175438,1021.6008771929819,27.61083451872924,0
2073,4,1,2,39,0.024390243902439025,0.04878048780487805,0.9512195121951219,41,1050,700,350,0.6666666666666666,14,7,7,332.87140218493124,0.4333841463414634,0.14714838961686394,0.18146366904866054,128523.41666894939,425.17924758089043,128948.59591653028,1551,0,304.0243902439024,38,3,14,38.062813893864345,0.6016995614035088,46.50106837606837,1013.9957264957254,26.684098065676984,7
2074,4,0,0,39,0.0,0.0,1.0,39,1250,800,450,0.64,17,8,9,347.361155666067,0.42884053081421497,0.16005560018001752,0.18905351410555818,128458.27880245095,1124.2832359386305,129582.56203838959,1552,1,319.87179487179486,36,3,15,37.76197881952161,0.6047453703703703,46.56531531531531,1013.7387387387375,28.159409409409378,0
2075,4,1,0,40,0.025,0.0,1.0,40,950,500,450,0.5263157894736842,14,5,9,341.1506300878231,0.4315705128205128,0.16344907657414431,0.18746075275864385,128839.34389667957,790.7246700907755,129630.06856677034,1553,0,312.85,37,3,17,37.530938366274256,0.6067004504504505,46.18969298245613,1015.241228070174,27.438952110004703,0
2076,4,1,0,41,0.024390243902439025,0.0,1.0,41,1100,600,500,0.5454545454545454,16,6,10,335.25933888739604,0.43201219512195127,0.17732906837265117,0.1859165424739195,129201.3888888888,463.1944444444359,129664.58333333324,1554,0,306.1951219512195,38,3,18,37.31215846994535,0.6085526315789473,45.83333333333333,1016.666666666666,26.754385964912263,0
2077,4,0,0,41,0.0,0.0,1.0,41,850,400,450,0.47058823529411764,13,4,9,339.61800882783353,0.43198678861788614,0.17853381811473334,0.18872293205091328,129282.86540516099,581.3578648915111,129864.2232700525,1555,1,307.1951219512195,38,3,18,37.11852610568338,0.609375,45.753205128205124,1016.9871794871789,26.762820512820497,0
2078,4,1,1,41,0.023809523809523808,0.023809523809523808,0.9761904761904762,42,1100,600,500,0.5454545454545454,16,6,10,333.11382496232596,0.4343544328300426,0.1811068711590662,0.18609806653555672,129492.78564453128,227.16742621527897,129719.95307074656,1556,0,300.85714285714283,39,3,15,37.07068962576331,0.609775641025641,45.546875,1017.8125000000002,26.097756410256416,0
2079,4,1,0,42,0.023809523809523808,0.0,1.0,42,750,400,350,0.5333333333333333,11,4,7,334.1822759188862,0.4348262679055362,0.19422533839711775,0.1878334861199258,129731.44531250013,270.7899305555708,130002.23524305571,1557,0,301.54761904761904,39,3,17,36.801295160190875,0.6121794871794872,45.31250000000001,1018.750000000001,26.121794871794897,0
2080,4,0,2,40,0.0,0.047619047619047616,0.9523809523809523,42,1100,800,300,0.7272727272727273,14,8,6,339.59379326260864,0.4341245644599303,0.1558706121713156,0.18478779392070727,128450.017373134,388.18482610033277,128838.20219923434,1558,1,302.54761904761904,37,5,15,37.96725707589687,0.602759009009009,46.5734649122807,1013.7061403508769,27.397463252726403,8
2081,4,0,1,39,0.0,0.025,0.975,40,1100,800,300,0.7272727272727273,14,8,6,353.1646129546234,0.429286858974359,0.17746772535130795,0.19140865988803837,128291.05748724713,1061.572332604601,129352.62981985173,1559,5,318.6,35,5,18,37.78573536692181,0.6050595238095238,46.730324074074076,1013.0787037037042,28.945105820105834,0
2082,4,2,0,41,0.04878048780487805,0.0,1.0,41,1100,700,400,0.6363636363636364,15,7,8,344.11328603130664,0.4354928861788618,0.20606293760098437,0.1900416579650248,129038.51290269566,680.7733399079586,129719.28624260362,1560,0,308.2926829268293,38,3,17,37.25289169295477,0.606907894736842,45.993589743589745,1016.0256410256416,26.73751686909583,0
2083,4,0,1,40,0.0,0.024390243902439025,0.975609756097561,41,1450,1200,250,0.8275862068965517,17,12,5,342.31389411448504,0.43460365853658534,0.20031987205117896,0.18982861400894177,129201.38888888898,645.5888395792285,129846.9777284682,1561,1,309.2926829268293,37,4,17,37.13285519125681,0.6103603603603603,45.833333333333336,1016.6666666666674,27.4774774774775,0
2084,4,2,2,40,0.047619047619047616,0.047619047619047616,0.9523809523809523,42,1200,800,400,0.6666666666666666,16,8,8,341.5429433160725,0.4361207897793264,0.21297198203733392,0.19163795636445674,129663.42872242317,457.12581726203996,130120.55453968521,1562,0,302.6904761904762,38,4,16,36.6828822686108,0.6132127192982456,45.379273504273506,1018.4829059829063,26.80218173639227,0
2085,4,1,0,41,0.024390243902439025,0.0,1.0,41,800,600,200,0.75,10,6,4,353.3123043752861,0.4325711382113821,0.23338682186218862,0.1980212052343564,129619.76431450079,959.251524507562,130579.01583900835,1563,0,311.0487804878049,37,4,17,36.42760040917414,0.6145833333333333,45.42214912280703,1018.3114035087733,27.52192982456144,0
2086,4,0,0,41,0.0,0.0,1.0,41,1400,1100,300,0.7857142857142857,17,11,6,351.6164242753416,0.431885162601626,0.2342353401514512,0.19783869252589595,129772.26382725195,926.0118754109296,130698.27570266288,1564,1,312.0487804878049,38,3,17,36.31579637202475,0.6143092105263157,45.272435897435905,1018.9102564102576,26.813427800269938,0
2087,4,0,0,41,0.0,0.0,1.0,41,900,700,200,0.7777777777777778,11,7,4,379.6858688422872,0.43216463414634143,0.20120562554720078,0.20319694698750615,127783.97108966218,1512.8248617064262,129296.79595136861,1565,2,313.0487804878049,37,4,17,37.63409156635218,0.5960022522522522,47.23135964912281,1011.0745614035086,27.326339497392123,8
2088,4,0,0,41,0.0,0.0,1.0,41,1400,1100,300,0.7857142857142857,17,11,6,385.293389769439,0.43107215447154473,0.20635457872358431,0.2066247806530991,127867.13219452133,1653.2721606648122,129520.40435518614,1566,3,314.0487804878049,37,4,17,37.40694564903152,0.5968468468468469,47.14912280701754,1011.4035087719293,27.3352299668089,0
2089,4,1,0,42,0.023809523809523808,0.0,1.0,42,1500,1100,400,0.7333333333333333,19,11,8,375.47862287888034,0.4327211575687186,0.20986046708590078,0.20348227056737403,128287.09621783948,1234.4135907075788,129521.50980854707,1567,0,307.54761904761904,36,6,18,37.22464613902475,0.6030092592592593,46.734234234234236,1013.0630630630633,28.140640640640648,0
2090,4,1,1,42,0.023255813953488372,0.023255813953488372,0.9767441860465116,43,1400,900,500,0.6428571428571429,19,9,10,369.7890462351744,0.4352390180878553,0.22435641325242162,0.20262863368303943,128728.04763244445,920.4443915435369,129648.49202398799,1568,0,301.3720930232558,37,6,16,36.917769674050064,0.6055743243243243,46.29934210526315,1014.8026315789461,27.427098150782328,0
2091,4,0,0,42,0.0,0.0,1.0,42,1300,900,400,0.6923076923076923,17,9,8,339.87841205989344,0.43529810298102983,0.17504836593171214,0.17699510499840512,126677.7412881849,288.5838671514395,126966.32515533634,1569,1,301.54761904761904,37,5,15,39.77405783683693,0.584740990990991,48.327850877192986,1006.6885964912287,27.207799905168343,8
2092,4,2,2,42,0.045454545454545456,0.045454545454545456,0.9545454545454546,44,950,700,250,0.7368421052631579,12,7,5,328.2670952254672,0.4363658386187456,0.19840041279669762,0.17382011763578017,127354.736328125,-438.72612847222297,126916.01019965278,1570,0,288.79545454545456,39,5,15,39.372635018919844,0.5881410256410257,47.65625,1009.375,25.881410256410255,0
2093,4,0,0,42,0.0,0.0,1.0,42,1200,900,300,0.75,15,9,6,334.52527888290547,0.43324138598528844,0.22191645498165413,0.17716338760570008,127361.47636788659,121.12668018116244,127482.60304806774,1571,1,302.95238095238096,38,4,15,39.20781294101044,0.5899122807017544,47.64957264957265,1009.401709401709,26.563202878992342,0
2094,4,1,0,43,0.023255813953488372,0.0,1.0,43,1100,900,200,0.8181818181818182,13,9,4,330.4473588882188,0.4357004429678848,0.2258478881880397,0.17657825829577523,127723.00347222235,-158.85416666665753,127564.1493055557,1572,0,296.8837209302326,39,4,16,38.940986534762295,0.5918803418803419,47.29166666666667,1010.8333333333344,25.918803418803446,0
2095,4,0,0,43,0.0,0.0,1.0,43,850,400,450,0.47058823529411764,13,4,9,329.16264871754595,0.4355389442598745,0.22364492833490623,0.1761219773127069,127775.65646701395,-188.20529513888368,127587.45117187506,1573,1,297.8837209302326,39,4,16,38.91965450923827,0.5924145299145299,47.239583333333336,1011.0416666666672,25.924145299145312,0
2096,4,0,1,42,0.0,0.023255813953488372,0.9767441860465116,43,1250,600,650,0.48,19,6,13,329.5164323963424,0.4347775932078258,0.2212558905789046,0.17700572961467248,127933.68055555562,-168.7499999999959,127764.93055555562,1574,2,298.8837209302326,39,4,17,38.74931356397583,0.594017094017094,47.083333333333336,1011.6666666666672,25.940170940170955,0
2097,4,0,1,41,0.0,0.023809523809523808,0.9761904761904762,42,1350,1000,350,0.7407407407407407,17,10,7,337.6438985173945,0.4329268292682927,0.2363608027670534,0.18171380720208838,128009.35057345289,244.3152348600838,128253.66580831297,1575,3,305.8809523809524,38,4,18,38.466444960585605,0.5964912280701755,47.008547008547,1011.96581196581,26.630679262258155,0
2098,4,2,0,43,0.046511627906976744,0.0,1.0,43,1400,900,500,0.6428571428571429,19,9,10,398.64470037612523,0.4377999261720192,0.3416076728621349,0.20297620290596322,125753.44676997571,1499.3687874641482,127252.81555743986,1576,0,297.5813953488372,35,8,14,39.25157704438803,0.5791666666666666,49.24768518518517,1003.0092592592569,28.657407407407337,8
2099,4,2,2,43,0.044444444444444446,0.044444444444444446,0.9555555555555556,45,1150,800,350,0.6956521739130435,15,8,7,384.4054616300131,0.44149831649831645,0.33740744888689767,0.1987467496754134,126383.31056986055,716.8218663640023,127100.13243622455,1577,0,285.31111111111113,36,9,15,38.95733004815769,0.5836226851851851,48.620495495495504,1005.5180180180192,27.93105605605609,0
2100,4,4,2,45,0.0851063829787234,0.0425531914893617,0.9574468085106383,47,1700,1200,500,0.7058823529411765,22,12,10,369.67967221959805,0.45081714461917977,0.3347271504135283,0.19423234895446628,127039.50195312499,-7.2157118055556,127032.28624131942,1578,0,273.93617021276594,39,8,17,38.65166701109046,0.5849358974358974,47.96875,1008.1249999999999,25.84935897435897,0
2101,4,1,1,45,0.021739130434782608,0.021739130434782608,0.9782608695652174,46,1150,800,350,0.6956521739130435,15,8,7,345.7571032412533,0.4474838969404187,0.26829284338966364,0.18087019337364355,126861.55443395143,-422.55812899687044,126438.99630495456,1579,0,280.8695652173913,40,6,16,39.43727092370288,0.5815104166666667,48.145325203252035,1007.4186991869925,25.185467479674813,8
2102,4,2,2,45,0.0425531914893617,0.0425531914893617,0.9574468085106383,47,1050,700,350,0.6666666666666666,14,7,7,339.09785582631173,0.44883209990749307,0.2820179538875687,0.17922659475542874,127280.60766171737,-767.2563540120875,126513.35130770528,1580,0,275.82978723404256,38,9,19,39.175269101817534,0.5890899122807017,47.72970085470085,1009.0811965811961,26.55476833108411,0
2103,4,1,1,45,0.021739130434782608,0.021739130434782608,0.9782608695652174,46,1400,1100,300,0.7857142857142857,17,11,6,317.7435511157104,0.44534017713365537,0.15723064767464834,0.16538359820289592,126656.87715851999,-1113.668581920781,125543.20857659921,1581,0,281.82608695652175,40,6,16,40.35251556452969,0.5794270833333333,48.34857723577235,1006.6056910569099,25.16514227642275,8
2104,4,0,0,45,0.0,0.0,1.0,45,1800,1500,300,0.8333333333333334,21,15,6,324.5268635028528,0.44379208754208754,0.1611076611697606,0.1687609556062734,126619.79709201372,-781.6948784722423,125838.10221354147,1582,1,289.06666666666666,39,6,17,40.21984751259228,0.5806623931623931,48.38541666666666,1006.4583333333319,25.806623931623896,0
2105,4,4,1,48,0.08163265306122448,0.02040816326530612,0.9795918367346939,49,1900,1400,500,0.7368421052631579,24,14,10,299.07535338505716,0.44922760770975056,0.17992846623185343,0.15939730372720046,127617.73003472199,-2166.5364583333576,125451.19357638863,1583,0,266.38775510204084,43,6,14,39.841065292096225,0.5847868217054264,47.39583333333332,1010.4166666666647,23.49806201550383,0
2106,4,1,1,48,0.02040816326530612,0.02040816326530612,0.9795918367346939,49,1350,1000,350,0.7407407407407407,17,10,7,298.6327106601712,0.44990079365079366,0.18106438979075734,0.1598246341713608,127785.23090457136,-2167.830022526392,125617.40088204497,1584,0,267.3673469387755,43,6,15,39.68157800256001,0.5864825581395349,47.23011363636364,1011.0795454545461,23.513477801268515,0
2107,4,0,0,48,0.0,0.0,1.0,48,1550,1200,350,0.7741935483870968,19,12,7,304.04096485116395,0.44765809692671393,0.18629001341767304,0.16268530396189962,127776.88108436986,-1830.1187578871557,125946.7623264827,1585,1,273.8333333333333,42,6,15,39.553383170404445,0.5877976190476191,47.23837209302325,1011.0465116279064,24.07253599114063,0
2108,4,1,1,48,0.02040816326530612,0.02040816326530612,0.9795918367346939,49,1100,800,300,0.7272727272727273,14,8,6,301.093116318581,0.4494579081632653,0.19726554669018892,0.16229875543768577,128072.63082709177,-2087.642493830365,125984.9883332614,1586,0,269.2244897959184,43,6,17,39.32674166588705,0.5893895348837209,46.94602272727272,1012.2159090909076,23.53990486257925,0
2109,4,3,1,50,0.058823529411764705,0.0196078431372549,0.9803921568627451,51,1900,1700,200,0.8947368421052632,21,17,4,293.9606202228096,0.4506862745098039,0.21396366033044245,0.16100186270780656,128709.28730244575,-2632.847084493981,126076.44021795176,1587,0,259.4901960784314,42,9,14,38.860572638146174,0.5972222222222222,46.31782945736434,1014.7286821705425,24.16020671834625,0
2110,4,1,4,47,0.0196078431372549,0.0784313725490196,0.9215686274509804,51,2200,1900,300,0.8636363636363636,25,19,6,298.78157595711207,0.45083333333333336,0.21674524771740789,0.16445540525370472,128906.01526350593,-2497.0515218436235,126408.96374166232,1588,0,260.47058823529414,42,9,17,38.538684796437686,0.5992063492063492,46.124031007751945,1015.5038759689933,24.178663713547458,0
2111,4,0,1,46,0.0,0.02127659574468085,0.9787234042553191,47,1350,1000,350,0.7407407407407407,17,10,7,313.3837931368867,0.447540857230959,0.23833012997137115,0.17165624378397626,128713.06911571334,-1332.682034845501,127380.38708086783,1589,1,282.27659574468083,38,9,17,38.36399768372288,0.6036184210526316,46.31410256410256,1014.7435897435897,26.70377867746289,0
2112,4,2,1,47,0.041666666666666664,0.020833333333333332,0.9791666666666666,48,1700,1200,500,0.7058823529411765,22,12,10,305.8727077631629,0.4486092641843971,0.24722022955523726,0.16939306937303872,129148.44292534713,-1699.4032118055593,127449.03971354157,1590,0,277.1041666666667,39,9,19,38.11274509803923,0.6063034188034189,45.885416666666664,1016.4583333333326,26.06303418803417,0
2113,4,0,0,47,0.0,0.0,1.0,47,1500,1000,500,0.6666666666666666,20,10,10,315.11698496662933,0.4464423373419673,0.24805854975790576,0.17498736656431585,129255.70371283498,-1253.8664712543098,128001.83724158067,1591,1,283.8510638297872,38,9,19,37.769007844785314,0.6091008771929824,45.77991452991452,1016.8803418803407,26.76000899685107,0
2114,4,1,0,48,0.020833333333333332,0.0,1.0,48,1500,800,700,0.5333333333333333,22,8,14,310.3587624984269,0.44768580082742315,0.2540635334628889,0.17408936436873898,129651.86767578126,-1552.2813585069441,128099.58631727433,1592,0,278.9166666666667,39,9,17,37.488599945450204,0.6113782051282051,45.390625,1018.4375000000001,26.113782051282055,0
2115,4,1,2,47,0.02040816326530612,0.04081632653061224,0.9591836734693877,49,1500,1000,500,0.6666666666666666,20,10,10,309.7012349010331,0.4488732993197279,0.2659850394341001,0.17587106325827914,130132.94004891276,-1739.5335531099154,128393.40649580285,1593,0,274.2040816326531,40,9,18,37.0187998007968,0.6145833333333333,44.91869918699187,1020.3252032520331,25.508130081300827,0
2116,4,0,0,47,0.0,0.0,1.0,47,1200,800,400,0.6666666666666666,16,8,8,319.6928473293324,0.4460376194881283,0.2665901352779263,0.18042181107063734,129890.67382812526,-1094.976128472193,128795.69769965307,1594,1,286.74468085106383,39,8,19,37.009077593841546,0.6137820512820513,45.156250000000014,1019.375000000002,26.137820512820564,0
2117,4,0,1,46,0.0,0.02127659574468085,0.9787234042553191,47,1700,1300,400,0.7647058823529411,21,13,8,320.00926504604854,0.4456907184705519,0.2627952969812879,0.18109194825438263,129996.88042534742,-1079.9587673610902,128916.92165798633,1595,2,287.74468085106383,39,8,19,36.89351378958119,0.6148504273504274,45.05208333333334,1019.7916666666682,26.14850427350431,0
2118,4,0,0,46,0.0,0.0,1.0,46,2350,2000,350,0.851063829787234,27,20,7,330.97925241786834,0.44354871175523347,0.2714250600830239,0.18818534637473075,130180.80210387896,-582.571088099941,129598.23101577902,1596,3,294.8478260869565,38,8,19,36.42758061139029,0.618421052631579,44.87179487179487,1020.51282051282,26.855600539811054,0
2119,4,0,0,46,0.0,0.0,1.0,46,1150,800,350,0.6956521739130435,15,8,7,335.8320719586403,0.44354871175523347,0.20676728486416085,0.1891447990772239,129811.04736328126,-481.0574001736122,129329.98996310766,1597,4,295.8478260869565,39,7,15,36.678528229241195,0.6129807692307692,45.234375,1019.0625000000001,26.129807692307697,8
2120,4,1,0,47,0.02127659574468085,0.0,1.0,47,1350,1000,350,0.7407407407407407,17,10,7,329.1925870587298,0.4451510946654333,0.20851106209223036,0.1870641067717435,130158.86423631778,-830.533350684107,129328.33088563367,1598,0,290.531914893617,40,7,16,36.49536898715267,0.61484375,44.893292682926834,1020.4268292682935,25.51067073170734,0
2121,4,0,1,46,0.0,0.02127659574468085,0.9787234042553191,47,1550,1300,250,0.8387096774193549,18,13,5,329.64028545344104,0.4452667283379587,0.20605288989100212,0.18834617385830485,130371.67302441732,-804.7662750602398,129566.90674935708,1599,1,291.531914893617,38,9,17,36.268612476897864,0.6203399122807017,44.684829059829056,1021.2606837606829,26.87528115159692,0
2122,4,0,1,45,0.0,0.021739130434782608,0.9782608695652174,46,1200,800,400,0.6666666666666666,16,8,8,330.97194828389803,0.4434983896940419,0.19344164616091408,0.18910704444983734,130371.67302441732,-570.1266756154645,129801.54634880186,1600,2,298.4130434782609,38,8,18,36.234613104578585,0.6203399122807017,44.684829059829056,1021.2606837606829,26.87528115159692,0
2123,4,0,1,44,0.0,0.022222222222222223,0.9777777777777777,45,1400,900,500,0.6428571428571429,19,9,10,336.3532494185185,0.44196127946127944,0.19224990114669827,0.19150887633757605,130235.32238476149,-238.9852253634309,129996.33715939806,1601,3,305.75555555555553,38,7,18,36.23525922824645,0.6189692982456141,44.81837606837607,1020.7264957264957,26.86122357174989,0
2124,4,0,0,44,0.0,0.0,1.0,44,1200,800,400,0.6666666666666666,16,8,8,343.337887108661,0.4396471987315011,0.1990973801661542,0.19534882879982385,130208.06081753605,141.0720971217809,130349.13291465784,1602,4,313.5,38,6,19,36.08465054607626,0.6186951754385965,44.84508547008547,1020.6196581196588,26.858412055780494,0
2125,4,0,0,44,0.0,0.0,1.0,44,1400,900,500,0.6428571428571429,19,9,10,343.32625457515894,0.43940495066948554,0.19535431492432576,0.1963410547917209,130406.3248214432,154.4058433200136,130560.7306647632,1603,5,314.5,36,8,19,35.88409592061741,0.6244212962962963,44.65090090090091,1021.3963963963974,28.37212212212215,0
2126,4,0,0,44,0.0,0.0,1.0,44,850,500,350,0.5882352941176471,12,5,7,343.8247985997502,0.4393719168428471,0.1952601196620598,0.19677190839737135,130435.08193582106,169.3631553851241,130604.44509120619,1604,6,315.5,36,8,19,35.84224451548892,0.6247106481481481,44.62274774774775,1021.5090090090098,28.37525025025027,0
2127,4,0,1,43,0.0,0.022727272727272728,0.9772727272727273,44,1150,900,250,0.782608695652174,14,9,5,344.31388010165216,0.43953708597603947,0.1964636443803114,0.1971979495127644,130463.84222059899,184.10234558883792,130647.94456618783,1605,7,316.5,36,8,19,35.800631981187536,0.625,44.5945945945946,1021.6216216216217,28.37837837837838,0
2128,4,0,1,42,0.0,0.023255813953488372,0.9767441860465116,43,950,500,450,0.5263157894736842,14,5,9,348.6024715609129,0.4395302694721299,0.19447634903741817,0.1998352349960868,130498.99798525362,498.45464677638836,130997.45263203,1606,8,322.0232558139535,35,8,17,35.655490107234556,0.6273809523809524,44.560185185185176,1021.759259259258,29.193121693121658,0
2129,4,0,0,42,0.0,0.0,1.0,42,850,500,350,0.5882352941176471,12,5,7,354.94238316941346,0.43741531165311653,0.1957132310903149,0.20286813492407696,130384.14292800437,855.7716836734487,131239.9146116778,1607,9,330.0952380952381,34,8,19,35.60996813925477,0.6283700980392157,44.67261904761904,1021.3095238095225,30.038515406162425,0
2130,4,0,1,41,0.0,0.023809523809523808,0.9761904761904762,42,1350,900,450,0.6666666666666666,18,9,9,358.00537486769423,0.4380081300813008,0.20120240036382575,0.20574525760468682,130597.00255102033,950.8857709750446,131547.8883219954,1608,10,331.0952380952381,34,8,17,35.315969795791595,0.6305147058823529,44.46428571428571,1022.1428571428565,30.063025210084017,0
2131,4,0,0,41,0.0,0.0,1.0,41,1200,800,400,0.6666666666666666,16,8,8,366.8357854893613,0.435645325203252,0.20332517107107018,0.21019312327318238,130481.60750973175,1373.0645965493923,131854.67210628116,1609,11,339.0,33,8,20,35.20738375114949,0.6316287878787878,44.577205882352935,1021.6911764705875,30.960338680926895,0
2132,4,0,0,41,0.0,0.0,1.0,41,1000,700,300,0.7,13,7,6,367.3109313049721,0.4361788617886179,0.199417088510508,0.21109314967767634,130597.00255102015,1393.9413265305852,131990.94387755074,1610,12,340.0,34,7,18,35.078179594689026,0.6305147058823529,44.4642857142857,1022.1428571428551,30.06302521008397,0
2133,4,0,0,41,0.0,0.0,1.0,41,450,100,350,0.2222222222222222,8,1,7,366.94696223253936,0.43569613821138214,0.19714997429466585,0.2110498033952317,130627.42524092946,1386.667375283419,132014.09261621287,1611,13,341.0,34,7,18,35.056626295563085,0.6308210784313726,44.434523809523796,1022.2619047619028,30.0665266106442,0
2134,4,0,0,41,0.0,0.0,1.0,41,1500,1000,500,0.6666666666666666,20,10,10,365.83660256946166,0.43579776422764227,0.20154871837343236,0.21083929443582422,130706.03358892715,1363.4102527005814,132069.44384162774,1612,14,342.0,35,6,19,35.005305602716476,0.6294642857142857,44.35763888888887,1022.5694444444418,29.216269841269767,0
2135,4,1,0,42,0.023809523809523808,0.0,1.0,42,1300,1000,300,0.7692307692307693,16,10,6,361.5713555617948,0.43782665505226476,0.20028534778397344,0.21066569371137245,131126.20380092927,1082.2958515948294,132208.4996525241,1613,0,334.8333333333333,36,6,20,34.68893164742533,0.6316550925925926,43.94707207207207,1024.2117117117114,28.450325325325316,0
2136,4,0,2,40,0.0,0.047619047619047616,0.9523809523809523,42,1400,1100,300,0.7857142857142857,17,11,6,363.55544433681325,0.43707655826558267,0.19570177779871223,0.21245927989856533,131241.5683208546,1142.7173372697023,132384.2856581243,1614,1,335.8333333333333,36,6,20,34.521421767959865,0.6328125,43.83445945945946,1024.6621621621618,28.462837837837828,0
2137,4,0,0,40,0.0,0.0,1.0,40,950,500,450,0.5263157894736842,14,5,9,380.34927798269865,0.4334001068376068,0.20717401419099635,0.22048973316367243,130931.84700963728,1959.9666950113465,132891.81370464864,1615,2,352.55,34,6,20,34.405170408281954,0.6338848039215687,44.136904761904766,1023.4523809523816,30.10154061624652,0
2138,4,1,0,41,0.024390243902439025,0.0,1.0,41,1150,800,350,0.6956521739130435,15,8,7,374.0919625667428,0.4343241869918699,0.22532550451012479,0.2194707825268846,131390.93888168037,1631.6564003052451,133022.59528198562,1616,0,344.9268292682927,33,8,21,34.100326719260494,0.6407828282828283,43.68872549019609,1025.2450980392175,31.06803327391568,0
2139,4,0,0,41,0.0,0.0,1.0,41,1050,600,450,0.5714285714285714,15,6,9,370.9538960473555,0.4340701219512195,0.21257102893609536,0.21834628058483602,131516.6116998272,1557.319900999637,133073.93160082682,1617,1,345.9268292682927,33,8,21,34.05366387893269,0.6420454545454546,43.566176470588246,1025.7352941176487,31.08288770053481,0
2140,4,1,2,40,0.023809523809523808,0.047619047619047616,0.9523809523809523,42,1200,700,500,0.5833333333333334,17,7,10,363.18756563747087,0.43425764614789003,0.20790890269151108,0.21529159818716076,131786.11288265322,1172.6155045351659,132958.7283871884,1618,0,338.6666666666667,34,8,19,33.98067632850241,0.6424632352941176,43.30357142857144,1026.7857142857156,30.199579831932812,0
2141,4,0,0,40,0.0,0.0,1.0,40,1150,900,250,0.782608695652174,14,9,5,376.9628356921363,0.43311965811965814,0.21329826504245197,0.22248198733986876,131619.4795971075,1923.1304522497899,133542.6100493573,1619,1,336.975,32,8,21,33.7955272548296,0.6455078125,43.4659090909091,1026.1363636363642,32.06676136363638,0
2142,4,0,0,40,0.0,0.0,1.0,40,800,500,300,0.625,11,5,6,376.00950183769675,0.4331330128205128,0.21245224450811828,0.22241917990060392,131705.233564014,1904.4838523644894,133609.7174163785,1620,2,337.975,33,7,21,33.73328557784146,0.6439393939393939,43.38235294117648,1026.4705882352953,31.105169340463494,0
2143,4,0,0,40,0.0,0.0,1.0,40,1000,800,200,0.8,12,8,4,375.745089633007,0.43273237179487184,0.21093936500358068,0.2226302942677039,131768.13755526723,1902.2461312956539,133670.38368656288,1621,3,338.975,33,7,21,33.67649399220178,0.6445707070707071,43.32107843137255,1026.7156862745098,31.112596553773024,0
2144,4,0,0,40,0.0,0.0,1.0,40,1500,1100,400,0.7333333333333333,19,11,8,374.2695885130311,0.4322115384615384,0.207744439295644,0.2231143016605309,132000.1133786849,1880.7256235827813,133880.8390022677,1622,4,339.975,34,6,21,33.480074142724746,0.6446078431372548,43.0952380952381,1027.6190476190484,30.224089635854366,0
2145,4,0,0,40,0.0,0.0,1.0,40,1200,900,300,0.75,15,9,6,385.88250447050837,0.4321581196581197,0.20687862257074663,0.21640408902715133,129643.02722318676,2014.157252889585,131657.18447607633,1623,5,340.975,35,5,18,35.57471019434026,0.61875,45.39930555555556,1018.4027777777779,29.09722222222223,8
2146,4,1,0,41,0.024390243902439025,0.0,1.0,41,1250,1000,250,0.8,15,10,5,377.1441498030931,0.4345782520325203,0.20792319255200464,0.21315000825950117,129946.64216581464,1601.7231758786013,131548.36534169325,1624,0,333.6341463414634,36,5,19,35.487997938296154,0.6197916666666667,45.10135135135136,1019.5945945945961,28.322072072072114,0
2147,4,0,0,41,0.0,0.0,1.0,41,1000,700,300,0.7,13,7,6,376.7836349494362,0.4345274390243902,0.21074463643587293,0.21310279915472496,129975.34855379039,1594.5168563834259,131569.8654101738,1625,1,334.6341463414634,36,5,19,35.46797349530648,0.6200810185185186,45.073198198198206,1019.7072072072082,28.32520020020023,0
2148,4,0,0,41,0.0,0.0,1.0,41,1350,900,450,0.6666666666666666,18,9,9,365.2492787171002,0.4345020325203252,0.12471006450619004,0.20395271611707924,129473.853812358,1258.9974635763415,130732.85127593433,1626,2,335.6341463414634,34,7,16,36.272273560260466,0.6191789215686274,45.565476190476176,1017.7380952380929,29.933473389355672,8
2149,4,1,0,42,0.023809523809523808,0.0,1.0,42,1200,1000,200,0.8333333333333334,14,10,4,356.588853053332,0.43418505613627567,0.1315971602675361,0.20118373022682215,129878.87577428405,862.6718696416216,130741.54764392567,1627,0,328.6190476190476,35,7,17,36.08079274062298,0.6211309523809524,45.16782407407407,1019.3287037037031,29.123677248677232,0
2150,4,0,0,42,0.0,0.0,1.0,42,1050,500,550,0.47619047619047616,16,5,11,360.3413690995751,0.43366482771970577,0.14203612479474592,0.20468875708645937,130144.46159122068,979.2866941014892,131123.74828532216,1628,1,329.6190476190476,35,7,18,35.71536600120992,0.6238095238095238,44.9074074074074,1020.370370370369,29.153439153439113,0
2151,4,1,0,43,0.023255813953488372,0.0,1.0,43,1200,1000,200,0.8333333333333334,14,10,4,352.82345196850014,0.43383167220376523,0.1563797185523792,0.20267250949785492,130578.91506371237,614.2607134161169,131193.1757771285,1629,0,322.93023255813955,36,7,16,35.46670706625532,0.6261574074074074,44.48198198198198,1022.0720720720722,28.390890890890894,0
2152,4,0,1,42,0.0,0.023255813953488372,0.9767441860465116,43,1250,800,450,0.64,17,8,9,355.9223622498267,0.43362403100775193,-0.023960380312110008,0.20460464104760465,130607.6912004911,838.3889801964219,131446.0801806875,1630,1,323.93023255813955,36,7,13,35.358369138114654,0.6264467592592593,44.45382882882883,1022.1846846846852,28.394019019019034,8
2153,4,0,1,41,0.0,0.023809523809523808,0.9761904761904762,42,1150,900,250,0.782608695652174,14,9,5,355.5299571412219,0.43129355400696867,-0.0032180859665573713,0.20474261025981466,130676.4470271778,891.8783221879478,131568.32534936574,1631,2,332.5,35,7,14,35.298751037657546,0.6291666666666667,44.38657407407408,1022.453703703705,29.212962962962997,0
2154,4,0,0,41,0.0,0.0,1.0,41,1950,1500,450,0.7692307692307693,24,15,9,357.8465329080264,0.4313770325203252,-0.007550543937211884,0.20670899724451894,130794.81336805566,1160.894097222228,131955.7074652779,1632,3,320.7317073170732,35,6,16,35.11965376782076,0.6303571428571428,44.270833333333336,1022.9166666666675,29.2261904761905,0
2155,4,0,0,41,0.0,0.0,1.0,41,1750,1400,350,0.8,21,14,7,345.9384892614464,0.4305132113821138,-0.011931917880329657,0.18804365924658514,128408.3387586806,684.2773437500039,129092.6161024306,1633,4,321.7317073170732,39,2,13,37.84900650907844,0.5988247863247863,46.614583333333336,1013.5416666666671,25.988247863247874,8
2156,4,0,0,41,0.0,0.0,1.0,41,1150,900,250,0.782608695652174,14,9,5,346.7111024388133,0.4299542682926829,-0.01282642243020593,0.18921408594979205,128566.7534722224,715.1041666666863,129281.85763888908,1634,5,322.7317073170732,39,2,14,37.66776225691592,0.6004273504273504,46.45833333333334,1014.1666666666681,26.00427350427354,0
2157,4,0,0,41,0.0,0.0,1.0,41,1050,900,150,0.8571428571428571,12,9,3,342.42523370600003,0.4297256097560975,-0.013974490294240693,0.187247577263489,128645.99745008699,610.3271484375192,129256.3245985245,1635,6,323.7317073170732,39,2,14,37.695626689940795,0.6012286324786325,46.38020833333334,1014.4791666666681,26.012286324786363,0
2158,4,0,1,40,0.0,0.024390243902439025,0.975609756097561,41,1400,1200,200,0.8571428571428571,16,12,4,343.8838872846008,0.4295223577235772,-0.006608194160759195,0.18867143005074036,128778.12499999999,656.9444444444443,129435.06944444442,1636,7,324.7317073170732,39,2,15,37.52394636015324,0.6025641025641026,46.25,1014.9999999999999,26.025641025641022,0
2159,4,1,1,40,0.024390243902439025,0.024390243902439025,0.975609756097561,41,1350,1000,350,0.7407407407407407,17,10,7,340.30676510127137,0.43041158536585367,0.005420054200542035,0.18821047620907047,129095.5078125,586.414930555555,129681.92274305556,1637,0,313.1463414634146,39,2,17,37.29158124914583,0.6057692307692308,45.9375,1016.25,26.057692307692307,0
2160,4,0,0,40,0.0,0.0,1.0,40,900,600,300,0.6666666666666666,12,6,6,338.8430734399941,0.4297943376068376,0.026428729648908744,0.18804020344743172,129230.01284646161,757.8257522725712,129987.83859873419,1638,1,321.5,36,4,17,37.19196478015283,0.6125578703703703,45.805180180180194,1016.7792792792816,28.243868868868933,0
2161,4,2,1,41,0.047619047619047616,0.023809523809523808,0.9761904761904762,42,1250,1000,250,0.8,15,10,5,324.3500377978436,0.43425764614789003,0.03485806148838266,0.1826240059336382,129799.47973738033,20.09323179194496,129819.57296917228,1639,0,307.14285714285717,38,4,16,36.98277067169917,0.6145833333333333,45.245726495726494,1019.0170940170937,26.816239316239308,0
2162,4,0,0,41,0.0,0.0,1.0,41,900,700,200,0.7777777777777778,11,7,4,332.04085359239554,0.43175813008130076,0.04282740667624774,0.18695428934854016,129799.47973738048,419.746009569738,130219.22574695021,1640,1,315.0,38,3,17,36.78684385265954,0.6145833333333333,45.2457264957265,1019.0170940170948,26.816239316239336,0
2163,4,0,0,41,0.0,0.0,1.0,41,850,600,250,0.7058823529411765,11,6,5,333.58329187981207,0.43165650406504064,0.04439423140825438,0.1883462586459862,129908.3719135803,467.0524691358106,130375.42438271611,1641,2,316.0,38,3,17,36.63714804722979,0.6156798245614035,45.13888888888889,1019.4444444444448,26.82748538011697,0
2164,4,0,0,41,0.0,0.0,1.0,41,1250,900,350,0.72,16,9,7,352.35711527069464,0.4317073170731707,0.04150768387545534,0.19321193477165557,128755.86718990437,881.3252368249787,129637.19242672935,1642,3,317.0,37,4,18,37.3316407375396,0.6058558558558558,46.27192982456139,1014.9122807017527,27.430061640587912,8
2165,4,1,0,42,0.023809523809523808,0.0,1.0,42,1250,800,450,0.64,17,8,9,363.68304502627615,0.4352618079752226,0.10915176014270989,0.19369062233278658,127588.49511584829,890.6581339338247,128479.15324978212,1643,0,310.42857142857144,35,7,16,38.239035590178354,0.5979166666666667,47.42476851851854,1010.3009259259289,28.865740740740826,8
2166,4,0,1,41,0.0,0.023809523809523808,0.9761904761904762,42,1200,700,500,0.5833333333333334,17,7,10,362.32797935322054,0.43539488966318235,0.1087952359138804,0.19338923690173146,127676.20991941047,852.1326303155428,128528.342549726,1644,1,311.42857142857144,35,7,16,38.183310429073146,0.5988095238095238,47.33796296296298,1010.6481481481508,28.87566137566145,0
2167,4,2,1,42,0.046511627906976744,0.023255813953488372,0.9767441860465116,43,1350,1000,350,0.7407407407407407,17,10,7,350.79640857315553,0.43897655961609455,0.12019267812497514,0.1901251371046956,128291.05748724724,402.5231213563296,128693.58060860356,1645,0,289.48837209302326,35,8,18,37.84571480254388,0.6050595238095238,46.73032407407408,1013.078703703705,28.945105820105855,0
2168,4,1,0,43,0.023255813953488372,0.0,1.0,43,1400,1200,200,0.8571428571428571,16,12,4,351.5097911926692,0.4367847914359542,0.15014841390702838,0.1924121031984175,128686.69979100738,446.9269945621525,129133.62678556953,1646,0,290.3255813953488,36,7,17,37.42369589345173,0.6070601851851851,46.3400900900901,1014.6396396396409,28.18443443443447,0
2169,4,1,0,44,0.022727272727272728,0.0,1.0,44,1250,1000,250,0.8,15,10,5,345.0940890284898,0.4381826990838619,0.1517408541372276,0.19029474052142456,128978.53185595584,101.94579101263903,129080.47764696847,1647,0,284.70454545454544,37,7,18,37.28905800230282,0.6081081081081081,46.05263157894738,1015.7894736842118,27.45376955903275,0
2170,4,0,0,44,0.0,0.0,1.0,44,1150,900,250,0.782608695652174,14,9,5,343.4392805871447,0.4382047216349542,0.15532428296778722,0.18991618451561199,129089.93632656202,66.91097260695398,129156.84729916898,1648,1,285.70454545454544,37,7,18,37.21766652280247,0.6092342342342343,45.94298245614035,1016.2280701754386,27.465623518255097,0
2171,4,0,0,44,0.0,0.0,1.0,44,1450,900,550,0.6206896551724138,20,9,11,340.6064724144783,0.4383148343904158,0.15565828811870208,0.1892933570692402,129287.27027280662,7.264302864109908,129294.53457567072,1649,2,286.70454545454544,36,8,19,37.08891595615105,0.6131365740740741,45.748873873873876,1017.0045045045048,28.250125125125134,0
2172,4,0,1,43,0.0,0.022727272727272728,0.9772727272727273,44,1250,600,650,0.48,19,6,13,339.47971823296587,0.4380835976039465,0.15602237514588158,0.1893542428366097,129430.46932067194,-12.1961488515594,129418.27317182037,1650,3,287.70454545454544,36,8,13,36.972019330087065,0.6145833333333333,45.608108108108105,1017.5675675675668,28.265765765765746,0
2173,4,0,1,42,0.0,0.023255813953488372,0.9767441860465116,43,1400,1000,400,0.7142857142857143,18,10,8,345.3342065456147,0.4373385012919897,0.1628118585606364,0.19265091014905095,129436.83556241421,339.7933813442994,129776.62894375851,1651,4,294.6046511627907,35,8,13,36.81661358811039,0.6166666666666667,45.60185185185185,1017.5925925925922,29.074074074074062,0
2174,4,0,0,42,0.0,0.0,1.0,42,850,600,250,0.7058823529411765,11,6,5,345.21694810187586,0.43733062330623307,0.15886461463493862,0.19301863055028592,129525.18332315245,542.8576978309358,130068.0410209834,1652,5,297.8333333333333,35,7,14,36.729794390752325,0.6175595238095238,45.5150462962963,1017.939814814815,29.083994708994716,0
2175,4,0,1,41,0.0,0.023809523809523808,0.9761904761904762,42,1700,1500,200,0.8823529411764706,19,15,4,345.0984434836342,0.4366047231900891,0.1587266485541583,0.1936147842968975,129659.75265806347,549.0757649541405,130208.8284230176,1653,6,298.8333333333333,36,6,14,36.596085802742145,0.6168981481481481,45.38288288288288,1018.4684684684685,28.29079079079079,0
2176,4,0,2,39,0.0,0.04878048780487805,0.9512195121951219,41,1100,900,200,0.8181818181818182,13,9,4,364.7914166900643,0.437525406504065,0.1446919647076006,0.19877981420020988,128506.3934948981,1242.9102917037483,129749.30378660186,1654,7,304.6341463414634,34,7,14,37.271046143008114,0.609375,46.51785714285715,1013.9285714285727,29.82142857142861,8
2177,4,0,0,39,0.0,0.0,1.0,39,1300,900,400,0.6923076923076923,17,9,8,382.0784347977988,0.4330015744489429,0.1607860052719865,0.20731436370874498,128336.36435376505,2006.9114439853258,130343.27579775038,1655,9,320.84615384615387,32,7,18,37.007009345794394,0.6123046875,46.68560606060607,1013.2575757575768,31.664299242424274,0
2178,4,0,0,39,0.0,0.0,1.0,39,650,400,250,0.6153846153846154,9,4,5,383.3131656777819,0.4325798470535313,0.15667030867628906,0.20815097887211623,128368.35048719526,2041.0557596163746,130409.40624681163,1656,10,321.84615384615387,32,7,15,36.94295622560011,0.6126302083333333,46.65404040404041,1013.383838383839,31.66824494949497,0
2179,4,3,0,42,0.07142857142857142,0.0,1.0,42,950,600,350,0.631578947368421,13,6,7,358.0625056986352,0.4408875338753388,0.16903535758872845,0.19917226879486588,129322.44897959183,863.7982653269473,130186.24724491878,1657,0,299.7857142857143,34,8,19,36.609267712234704,0.6176470588235294,45.714285714285715,1017.1428571428571,29.915966386554622,0
2180,4,0,0,42,0.0,0.0,1.0,42,950,800,150,0.8421052631578947,11,8,3,357.53912056937367,0.4403673054587689,0.1737964340023066,0.19964741618207524,129473.85381235812,858.393565759622,130332.24737811774,1658,1,300.7857142857143,34,8,15,36.46844660194176,0.6191789215686274,45.56547619047618,1017.7380952380939,29.933473389355704,0
2181,4,0,2,40,0.0,0.047619047619047616,0.9523809523809523,42,1150,800,350,0.6956521739130435,15,8,7,356.1010497668228,0.44056087882307393,0.16510794170368648,0.19961260679589773,129625.34722222207,831.9444444444254,130457.2916666665,1659,2,301.7857142857143,34,8,16,36.350927441352965,0.6207107843137255,45.41666666666666,1018.3333333333321,29.950980392156826,0
2182,4,0,0,40,0.0,0.0,1.0,40,950,600,350,0.631578947368421,13,6,7,372.3298967642156,0.4378205128205128,0.16974860335195596,0.2069784208720326,129297.68207644607,1628.2785238750926,130925.96060032117,1660,3,317.025,32,8,18,36.27172563625079,0.6220703125,45.73863636363635,1017.0454545454528,31.7826704545454,0
2183,4,1,0,41,0.024390243902439025,0.0,1.0,41,1600,1300,300,0.8125,19,13,6,364.7557096943113,0.4398373983739838,0.16324785106413287,0.2046219735367103,129655.65653344669,1258.5282029478412,130914.18473639453,1661,0,310.2682926829268,34,7,17,36.09974673680108,0.6210171568627452,45.38690476190476,1018.4523809523807,29.95448179271708,0
2184,4,0,0,41,0.0,0.0,1.0,41,1650,1200,450,0.7272727272727273,21,12,9,362.347421172155,0.43915142276422764,0.1627535901527244,0.20405881087063454,129807.25623582758,1207.0649092970436,131014.32114512462,1662,1,311.2682926829268,34,7,18,36.006863317757016,0.6225490196078431,45.238095238095234,1019.0476190476184,29.971988795518186,0
2185,4,1,0,42,0.023809523809523808,0.0,1.0,42,1300,1100,200,0.8461538461538461,15,11,4,353.33793366952045,0.44048828881145957,0.16941059545415338,0.2007105169607275,130144.46159122078,796.9950274348371,130941.45661865562,1663,0,304.8333333333333,35,7,20,35.89401845130069,0.6238095238095238,44.907407407407405,1020.3703703703698,29.153439153439137,0
2186,4,0,0,42,0.0,0.0,1.0,42,1600,1300,300,0.8125,19,13,6,354.5005800250278,0.43877032520325204,0.1698867958049488,0.2022988339903302,130323.35778061223,839.9947684835197,131163.35254909575,1664,1,305.8333333333333,34,8,20,35.682882515253965,0.6277573529411764,44.732142857142854,1021.0714285714286,30.031512605042018,0
2187,4,0,1,41,0.0,0.023809523809523808,0.9761904761904762,42,1250,1000,250,0.8,15,10,5,352.65239810694356,0.43854045683313975,0.16597291597291575,0.20171717171717168,130414.5408163265,798.2001133786775,131212.74092970518,1665,2,306.8333333333333,34,8,21,35.637626262626256,0.6286764705882353,44.64285714285714,1021.4285714285711,30.04201680672268,0
2188,4,2,0,43,0.046511627906976744,0.0,1.0,43,1000,400,600,0.4,16,4,12,363.1828719608246,0.4410760428202289,0.21981724075999143,0.20233121406631072,129383.00028344667,878.2773526077101,130261.27763605438,1666,0,295.83720930232556,34,9,20,36.41737850066309,0.6182598039215687,45.654761904761905,1017.3809523809521,29.92296918767506,8
2189,4,0,0,43,0.0,0.0,1.0,43,1050,500,550,0.47619047619047616,16,5,11,364.90596524588796,0.4408222591362126,0.22408070431271798,0.2036041900079538,129443.56575963722,846.9458616780034,130290.51162131522,1667,1,296.83720930232556,34,9,17,36.31185657463733,0.6188725490196079,45.595238095238095,1017.6190476190479,29.92997198879553,0
2190,4,0,0,43,0.0,0.0,1.0,43,700,300,400,0.42857142857142855,11,3,8,365.24742655859944,0.44056847545219635,0.22662858697130472,0.2041088560180408,129504.14540816321,860.2111678004517,130364.35657596367,1668,2,297.83720930232556,34,9,18,36.2414717348928,0.6194852941176471,45.535714285714285,1017.8571428571424,29.936974789915954,0
2191,4,0,0,43,0.0,0.0,1.0,43,1150,1000,150,0.8695652173913043,13,10,3,362.02118412995617,0.44056847545219635,0.22208826422158068,0.202566051883403,129554.6392746914,780.3047839506241,130334.94405864202,1669,3,298.83720930232556,35,8,18,36.27216916780354,0.6178571428571429,45.486111111111114,1018.055555555556,29.0873015873016,0
2192,4,1,0,44,0.022727272727272728,0.0,1.0,44,1150,800,350,0.6956521739130435,15,8,7,356.1120114340959,0.44287350246652574,0.2278025532085861,0.20082054925171353,129860.54202428783,448.9797652382169,130309.52178952604,1670,0,293.02272727272725,36,8,19,36.11157146539978,0.6189236111111112,45.185810810810814,1019.256756756757,28.312687687687696,0
2193,4,1,0,45,0.022222222222222223,0.0,1.0,45,1500,1100,400,0.7333333333333333,19,11,8,347.6494438271763,0.4442340067340067,0.2260050251256287,0.19766354091888022,130180.80210387893,51.45668967783769,130232.25879355677,1671,0,287.4888888888889,38,7,20,36.002277010050264,0.618421052631579,44.87179487179487,1020.5128205128198,26.855600539811046,0
2194,4,0,0,45,0.0,0.0,1.0,45,1200,900,300,0.75,15,9,6,350.6872136609746,0.44404461279461277,0.22585034013605454,0.199810156620788,130262.58680555563,136.2847222222316,130398.87152777787,1672,1,288.4888888888889,38,7,21,35.84183673469388,0.6192434210526316,44.79166666666667,1020.833333333334,26.864035087719316,0
2195,4,0,0,45,0.0,0.0,1.0,45,850,400,450,0.47058823529411764,13,4,9,351.6174081305902,0.4439814814814815,0.22415458937198096,0.2010629930470503,130402.54122662744,170.36071194983708,130572.90193857727,1673,2,289.4888888888889,37,8,21,35.67621667561282,0.6224662162162162,44.6546052631579,1021.3815789473686,27.60490753911807,0
2196,4,0,0,45,0.0,0.0,1.0,45,1000,600,400,0.6,14,6,8,349.15193974198377,0.44377104377104376,0.22601807326875312,0.20047943910995322,130562.68376981534,117.24285923005999,130679.9266290454,1674,3,290.4888888888889,38,7,15,35.576956582340244,0.6222587719298245,44.49786324786326,1022.0085470085482,26.89496176338285,0
2197,4,0,1,44,0.0,0.022222222222222223,0.9777777777777777,45,1200,800,400,0.6666666666666666,16,8,8,348.69547272530747,0.44400252525252526,0.22573319400905634,0.2007831332118648,130671.89554569362,112.93967784352702,130784.83522353716,1675,4,291.4888888888889,38,7,16,35.4780564263323,0.6233552631578947,44.39102564102564,1022.4358974358975,26.90620782726046,0
2198,4,0,0,44,0.0,0.0,1.0,44,1100,1000,100,0.9090909090909091,12,10,2,348.4137191349301,0.4440296863988724,0.2238408521303259,0.20147402019541602,130835.79881656797,316.9974523339815,131152.79626890196,1676,5,296.6818181818182,38,6,17,35.319418337510434,0.625,44.230769230769226,1023.0769230769224,26.923076923076906,0
2199,4,1,1,44,0.022222222222222223,0.022222222222222223,0.9777777777777777,45,550,200,350,0.36363636363636365,9,2,7,345.82935200912254,0.4458333333333333,0.22982925974891755,0.20157320796121542,131141.34250217027,70.50509982639875,131211.84760199668,1677,0,291.06666666666666,39,6,19,35.07671870232889,0.6263354700854701,43.93229166666667,1024.2708333333344,26.263354700854727,0
2200,4,1,2,43,0.022222222222222223,0.044444444444444446,0.9555555555555556,45,1150,1000,150,0.8695652173913043,13,10,3,347.9579518694932,0.44574915824915823,0.2396991564183346,0.20366200407162097,131301.43364800359,137.47558593750966,131438.90923394109,1678,0,291.9111111111111,39,6,20,34.86052529051054,0.6279380341880342,43.77604166666667,1024.8958333333344,26.27938034188037,0
2201,4,0,0,43,0.0,0.0,1.0,43,1250,1000,250,0.8,15,10,5,362.3380375509763,0.44336009597637505,0.2432379976012622,0.21191560068532056,131271.93583602642,912.9631232686934,132184.8989592951,1679,1,296.1860465116279,37,6,20,34.52189885155859,0.6311936936936937,43.80482456140351,1024.7807017543855,27.696775723091502,0
2202,4,0,0,43,0.0,0.0,1.0,43,1150,700,450,0.6086956521739131,16,7,9,365.56348592103666,0.44366002214839423,0.24783625638885165,0.21461411012421935,131417.1157648536,1008.2838355979445,132425.39960045155,1680,2,297.1860465116279,35,8,20,34.29245682356925,0.6366071428571429,43.66319444444446,1025.347222222224,29.29563492063497,0
2203,4,0,0,43,0.0,0.0,1.0,43,1450,900,550,0.6206896551724138,20,9,11,361.70320217909773,0.44306016980435586,0.24424901351691708,0.2131740149012982,131565.5006858712,917.532578875187,132483.0332647464,1681,3,298.1860465116279,35,8,16,34.241501203369445,0.638095238095238,43.518518518518526,1025.925925925927,29.312169312169342,0
2204,4,0,0,43,0.0,0.0,1.0,43,1100,800,300,0.7272727272727273,14,8,6,366.493872237105,0.4420681063122924,0.24546055323032379,0.2166711772665765,131684.26890432098,1052.295524691359,132736.56442901233,1682,4,299.1860465116279,35,8,16,33.998646820027076,0.6392857142857142,43.40277777777778,1026.388888888889,29.325396825396826,0
2205,4,0,0,43,0.0,0.0,1.0,43,1300,900,400,0.6923076923076923,17,9,8,368.82947853817313,0.441860465116279,0.2481424189192729,0.2183923547819489,131743.67310742455,1118.1900505829842,132861.86315800753,1683,5,300.1860465116279,35,8,16,33.87871101089815,0.6398809523809523,43.344907407407405,1026.6203703703702,29.33201058201058,0
2206,4,0,0,43,0.0,0.0,1.0,43,1400,1000,400,0.7142857142857143,18,10,8,366.16769674034174,0.44137596899224807,0.24735086059354305,0.21732481425933467,131832.80452942822,1054.5828778720902,132887.38740730032,1684,6,301.1860465116279,35,8,16,33.85704290168676,0.6407738095238096,43.258101851851855,1026.967592592593,29.34193121693123,0
2207,4,0,1,42,0.0,0.023255813953488372,0.9767441860465116,43,1350,1100,250,0.8148148148148148,16,11,5,365.3433696362398,0.44158361018826137,0.24101479915433388,0.21751529793835664,131951.69331114963,1041.535252700608,132993.22856385025,1685,7,302.1860465116279,35,8,16,33.758237580263604,0.6419642857142858,43.14236111111111,1027.430555555555,29.355158730158713,0
2208,4,0,1,41,0.0,0.023809523809523808,0.9761904761904762,42,1100,600,500,0.5454545454545454,16,6,10,372.7231957341936,0.4403673054587689,0.2407514730029947,0.22138859698428606,131862.52170138882,1429.6440972222165,133292.16579861104,1686,8,309.7142857142857,35,7,17,33.65872210953347,0.6410714285714285,43.229166666666664,1027.0833333333328,29.34523809523808,0
2209,4,0,0,41,0.0,0.0,1.0,41,900,600,300,0.6666666666666666,12,6,6,380.6750409185929,0.43762703252032525,0.24691548087708104,0.2257586205233794,131803.0907064472,1834.829389574762,133637.92009602196,1687,9,318.0487804878049,35,6,17,33.514615269011124,0.6404761904761904,43.28703703703704,1026.851851851852,29.338624338624342,0
2210,4,0,0,41,0.0,0.0,1.0,41,1200,900,300,0.75,15,9,6,376.00978040449803,0.43734756097560973,0.2040234595306425,0.20774007943178674,129054.34355977809,1506.4786683384925,130560.82222811658,1688,10,319.0487804878049,35,6,16,36.426533963625324,0.612797619047619,45.97800925925927,1016.0879629629641,29.031084656084687,8
2211,4,0,1,40,0.0,0.024390243902439025,0.975609756097561,41,1200,900,300,0.75,15,9,6,377.9226014512226,0.4368902439024391,0.20711715313874435,0.20957526080476907,129201.38888888905,1565.6250000000193,130767.01388888907,1689,11,320.0487804878049,35,6,16,36.22780054644809,0.6142857142857143,45.83333333333334,1016.666666666668,29.047619047619087,0
2212,4,0,1,39,0.0,0.025,0.975,40,1250,900,350,0.72,16,9,7,384.5937778878397,0.43657852564102567,0.2102668353210455,0.2141189101439947,129357.17520004346,1949.9929414167918,131307.16814146025,1690,12,325.675,33,7,16,35.899163755370864,0.6202651515151515,45.68014705882354,1017.2794117647076,30.826648841354775,0
2213,4,0,0,39,0.0,0.0,1.0,39,1350,1200,150,0.8888888888888888,15,12,3,385.96811845767655,0.4346603688708952,0.1882605715979182,0.21573695773280385,129513.0553753366,2197.5820597847214,131710.63743512132,1691,13,325.4871794871795,33,6,14,35.70511276988522,0.6218434343434344,45.52696078431374,1017.8921568627466,30.845216874628683,0
2214,4,2,0,41,0.04878048780487805,0.0,1.0,41,1150,700,450,0.6086956521739131,16,7,9,370.7471641602453,0.43658536585365854,0.19445220890425174,0.21012184937262013,130055.90284475747,1443.5714323988466,131499.47427715632,1692,0,310.5609756097561,35,6,16,35.53994572411969,0.6229166666666667,44.99421296296297,1020.0231481481488,29.143518518518537,0
2215,4,1,1,41,0.023809523809523808,0.023809523809523808,0.9761904761904762,42,1250,1000,250,0.8,15,10,5,360.16499270643374,0.43869773519163763,0.1861199674159908,0.2063060603906352,130469.43486636222,998.2687114197462,131467.70357778197,1693,0,304.14285714285717,35,7,19,35.39011461047544,0.6270833333333333,44.58912037037037,1021.6435185185179,29.1898148148148,0
2216,4,0,1,40,0.0,0.024390243902439025,0.975609756097561,41,1450,1200,250,0.8275862068965517,17,12,5,359.9994226756821,0.4374491869918699,0.17070898172294058,0.2068912344774705,130597.00255102055,1202.9691043084072,131799.97165532896,1694,1,308.8536585365854,34,7,16,35.265014752698185,0.6305147058823529,44.46428571428572,1022.1428571428582,30.063025210084067,0
2217,4,0,0,40,0.0,0.0,1.0,40,1250,800,450,0.64,17,8,9,373.0886477139604,0.4338675213675214,0.17125809546653903,0.21394863443184348,130512.91120001931,1738.5771097654895,132251.4883097848,1695,3,317.55,33,7,18,35.01589110098346,0.6319444444444444,44.54656862745099,1021.8137254901968,30.964052287581723,0
2218,4,0,1,39,0.0,0.025,0.975,40,850,600,250,0.7058823529411765,11,6,5,374.59502748117484,0.43333333333333335,0.17208138559271258,0.21568297545034093,130669.48596993939,1789.6279375720815,132459.11390751146,1696,4,318.55,33,7,19,34.818485556754155,0.6335227272727273,44.393382352941174,1022.4264705882348,30.9826203208556,0
2219,4,1,0,40,0.025,0.0,1.0,40,750,600,150,0.8,9,6,3,409.0977356595123,0.43434829059829055,0.11092142188961662,0.22896621959163277,129564.73922902493,2761.634957291737,132326.37418631665,1697,0,318.775,34,6,14,35.063679061428125,0.6200980392156863,45.476190476190474,1018.095238095238,29.94397759103641,8
2220,4,0,1,39,0.0,0.025,0.975,40,1450,1400,50,0.9655172413793104,15,14,1,408.2737578996016,0.4340544871794872,0.11313559322033884,0.22903488516925186,129655.6565334467,2587.0004251700634,132242.65695861678,1698,1,319.775,34,6,14,34.991720241574114,0.6210171568627452,45.38690476190476,1018.4523809523808,29.954481792717083,0
2221,4,1,0,40,0.025,0.0,1.0,40,1000,700,300,0.7,13,7,6,408.84351174946073,0.4348824786324786,0.1238415672913118,0.23031779404696112,129819.89354263118,2615.2042341820957,132435.0977768133,1699,0,320.6,35,5,15,34.80941226575808,0.6205357142857143,45.22569444444444,1019.0972222222223,29.117063492063494,0
2222,4,0,2,38,0.0,0.05,0.95,40,1150,800,350,0.6956521739130435,15,8,7,382.0231214305388,0.4345219017094017,0.10364403114186915,0.2083107209309917,128533.39489073546,1820.5457448445527,130353.94063558002,1700,1,321.6,37,3,17,36.806606833910024,0.6036036036036037,46.49122807017543,1014.035087719297,27.406353722143162,8
2223,4,1,0,39,0.02564102564102564,0.0,1.0,39,1500,1300,200,0.8666666666666667,17,13,4,378.9443577615717,0.43182073774179036,0.121118498351384,0.2078773887099847,128772.40997331799,1959.5156389497683,130731.92561226776,1701,0,329.38461538461536,36,3,19,36.64013092200155,0.6079282407407407,46.255630630630634,1014.9774774774781,28.193818818818837,0
2224,4,0,0,39,0.0,0.0,1.0,39,1300,1100,200,0.8461538461538461,15,11,4,374.818236047329,0.43238304093567254,0.1459849531705819,0.19571947118218985,126788.14785559034,1704.5019861880746,128492.64984177842,1702,1,330.38461538461536,37,2,15,38.780960805661394,0.5858671171171171,48.21820175438597,1007.1271929824575,27.219653864390743,8
2225,4,4,3,40,0.09302325581395349,0.06976744186046512,0.9302325581395349,43,1650,1500,150,0.9090909090909091,18,15,3,356.88512916340443,0.44227574750830567,0.15153909080285133,0.1911198619577977,127810.33631601586,523.0853705484194,128333.42168656428,1703,0,300.5581395348837,40,3,17,38.18341708542714,0.5911458333333333,47.20528455284554,1011.17886178862,25.2794715447155,0
2226,4,1,0,41,0.024390243902439025,0.0,1.0,41,1100,800,300,0.7272727272727273,14,8,6,361.9731916435209,0.43790650406504067,0.17937550254623402,0.19376212023270856,127793.2098765435,1051.5432098765712,128844.75308642007,1704,0,315.9268292682927,38,3,18,38.07234432234432,0.5942982456140351,47.222222222222236,1011.1111111111134,26.608187134502984,0
2227,4,2,1,42,0.046511627906976744,0.023255813953488372,0.9767441860465116,43,1550,1000,550,0.6451612903225806,21,10,11,348.2379362434559,0.4413298265042451,0.18318848958430478,0.189630002836502,128479.16253552781,348.26368233195075,128827.42621785976,1705,0,302.1860465116279,40,3,18,37.718440924886416,0.5979166666666667,46.54471544715447,1013.8211382113823,25.34552845528456,0
2228,4,0,0,42,0.0,0.0,1.0,42,1400,1200,200,0.8571428571428571,16,12,4,355.6070834938772,0.43828639179248935,0.17631375541792638,0.19381183374744712,128513.9377170141,740.0933159722482,129254.03103298634,1706,1,310.3809523809524,39,3,18,37.49614752414218,0.5998931623931624,46.51041666666668,1013.9583333333351,25.998931623931668,0
2229,4,1,0,43,0.023255813953488372,0.0,1.0,43,950,600,350,0.631578947368421,13,6,7,350.01442692331636,0.43754614248800294,0.19208674104494117,0.19296162146158577,128969.02394614663,428.20380147400886,129397.22774762064,1707,0,304.13953488372096,40,3,20,37.173795230948805,0.6028645833333333,46.06199186991871,1015.7520325203265,25.393800813008163,0
2230,4,0,0,43,0.0,0.0,1.0,43,1150,800,350,0.6956521739130435,15,8,7,352.052907060883,0.4373154300479882,0.19584284009796327,0.19459242773365232,129072.27143441407,488.0536758873721,129560.32511030145,1708,1,305.13953488372096,40,3,20,37.01682668266826,0.60390625,45.96036585365854,1016.1585365853662,25.403963414634156,0
2231,4,0,0,43,0.0,0.0,1.0,43,1150,700,450,0.6086956521739131,16,7,9,350.3762429454451,0.4368078626799557,0.19576820434616882,0.19429955290611028,129201.38888888877,453.8839934893176,129655.27288237809,1709,2,306.13953488372096,39,4,20,36.92793715846996,0.6068376068376069,45.83333333333333,1016.6666666666657,26.068376068376043,0
2232,4,1,1,43,0.022727272727272728,0.022727272727272728,0.9772727272727273,44,1550,900,650,0.5806451612903226,22,9,13,342.1898258781479,0.4371806730091614,0.19376976429007997,0.1915926995628712,129579.88989866772,68.18399234692845,129648.07389101465,1710,0,300.15909090909093,41,3,14,36.75125450647956,0.6074695121951219,45.46130952380952,1018.1547619047612,24.833042973286858,0
2233,4,1,0,44,0.022727272727272728,0.0,1.0,44,1700,1500,200,0.8823529411764706,19,15,4,342.1070914806336,0.43601347780126853,0.1974717982747185,0.19303406726872605,129883.08930342937,86.78518282309753,129969.87448625246,1711,0,301.1363636363636,41,3,16,36.445559610705594,0.6105182926829269,45.16369047619046,1019.3452380952353,24.86207897793257,0
2234,4,0,0,44,0.0,0.0,1.0,44,1100,700,400,0.6363636363636364,15,7,8,344.73118442368576,0.4357602184637068,0.1958082773257872,0.19514518589622706,130009.52695893143,163.6676429830869,130173.19460191451,1712,1,302.1363636363636,41,3,16,36.25040531776911,0.6117886178861789,45.039682539682524,1019.8412698412675,24.874177313201645,0
2235,4,2,1,45,0.043478260869565216,0.021739130434782608,0.9782608695652174,46,1200,700,500,0.5833333333333334,17,7,10,334.3581319408379,0.4389593397745572,0.20647740802350856,0.1915027832439789,130465.21183704933,-475.0870023935794,129990.12483465574,1713,0,289.95652173913044,41,5,18,36.053521719427714,0.6163617886178862,44.593253968253954,1021.6269841269816,24.917731320170283,0
2236,4,0,1,44,0.0,0.022222222222222223,0.9777777777777777,45,1400,900,500,0.6428571428571429,19,9,10,340.84937092443295,0.4364267676767677,0.20741772515725376,0.1949844636972952,130418.24811826629,-109.40443436446259,130308.84368390182,1714,1,297.22222222222223,40,5,18,35.93527178058568,0.6174479166666667,44.639227642276424,1021.4430894308946,25.536077235772364,0
2237,4,0,0,44,0.0,0.0,1.0,44,800,400,400,0.5,12,4,8,341.24965743786197,0.43582628611698376,0.20154811198319056,0.19532227474361644,130439.87509645037,102.51253858022156,130542.3876350306,1715,2,300.90909090909093,41,3,18,35.903155449807386,0.6161077235772358,44.61805555555554,1021.5277777777758,24.915311653116483,0
2238,4,0,0,44,0.0,0.0,1.0,44,1650,1300,350,0.7878787878787878,20,13,7,338.98230345149017,0.4356501057082452,0.20155397892730464,0.19465973746695928,130566.58340419491,51.952239229013685,130618.53564342392,1716,3,301.90909090909093,41,3,15,35.832847990681415,0.6173780487804879,44.49404761904761,1022.0238095238087,24.927409988385577,0
2239,4,0,0,44,0.0,0.0,1.0,44,1750,1300,450,0.7428571428571429,22,13,9,339.8572244523648,0.43513257575757575,0.20504369527068156,0.19605977206935785,130744.07837498408,86.86391802089187,130830.94229300496,1717,4,302.90909090909093,41,3,17,35.63098182817604,0.6191565040650406,44.3204365079365,1022.7182539682526,24.944347657762258,0
2240,4,0,1,43,0.0,0.022727272727272728,0.9772727272727273,44,1600,1000,600,0.625,22,10,12,339.13798626978,0.43453796687808316,0.2035719634566422,0.1969366843172686,130997.85175933807,85.26953026582066,131083.12128960388,1718,5,303.90909090909093,41,3,17,35.3929442452434,0.6216971544715447,44.07242063492064,1023.710317460318,24.96854432830044,0
2241,4,0,1,42,0.0,0.023255813953488372,0.9767441860465116,43,1050,600,450,0.5714285714285714,15,6,9,344.3959660348607,0.43397009966777406,0.2044008967098323,0.19994815941608973,130989.80150910527,422.4718462886095,131412.27335539387,1719,6,310.5581395348837,40,3,18,35.26651278996659,0.6231770833333333,44.08028455284554,1023.6788617886198,25.591971544715495,0
2242,4,0,0,42,0.0,0.0,1.0,42,1350,700,650,0.5185185185185185,20,7,13,350.02104254478803,0.43291473093302363,0.21149884890342907,0.20288830342197917,130928.03955078151,765.5137803819741,131693.55333116348,1720,7,318.76190476190476,39,3,18,35.18500848176423,0.624198717948718,44.140625000000014,1023.437500000002,26.241987179487232,0
2243,4,0,0,42,0.0,0.0,1.0,42,900,500,400,0.5555555555555556,13,5,8,391.3370632396102,0.4324912891986063,0.21057966423820051,0.21576163266633783,128972.51136271421,1727.6428356407669,130700.15419835498,1721,8,319.76190476190476,36,6,18,36.12088876570584,0.6099537037037037,46.058558558558566,1015.7657657657669,28.215715715715746,8
2244,4,0,0,42,0.0,0.0,1.0,42,1000,500,500,0.5,15,5,10,389.8851454075092,0.43244289585753,0.213752625856372,0.2152719572745746,129029.71172185703,1661.3535833130484,130691.06530517008,1722,9,320.76190476190476,36,6,18,36.09925737087119,0.6105324074074074,46.002252252252255,1015.9909909909913,28.221971971971982,0
2245,4,1,0,43,0.023255813953488372,0.0,1.0,43,1250,1100,150,0.88,14,11,3,381.3971598578804,0.43360095976375046,0.2227485030670362,0.2142971077928631,129717.84056770019,1315.093755914726,131032.93432361491,1723,0,314.27906976744185,38,5,16,35.61265513022198,0.6137609649122807,45.32585470085469,1018.6965811965798,26.80780476833105,8
2246,4,0,0,43,0.0,0.0,1.0,43,1850,1300,550,0.7027027027027027,24,13,11,362.5211485170133,0.43281653746770027,0.1876399992715485,0.19699553474732992,128395.77034517495,709.2364260518868,129105.00677122684,1724,1,315.27906976744185,41,2,13,37.44167645523361,0.5955284552845528,46.62698412698412,1013.4920634920622,24.719318621757616,8
2247,4,0,1,42,0.0,0.023255813953488372,0.9767441860465116,43,1350,1200,150,0.8888888888888888,15,12,3,361.5501853759472,0.4327934662236988,0.18247919444153715,0.1972126998352685,128546.63190507682,695.211718946834,129241.84362402366,1725,2,316.27906976744185,41,2,14,37.312088306267526,0.5970528455284553,46.4781746031746,1014.0873015873015,24.733836624080524,0
2248,4,3,1,44,0.06666666666666667,0.022222222222222223,0.9777777777777777,45,1600,1200,400,0.75,20,12,8,348.40227462452634,0.43760521885521886,0.19733055988906223,0.19419639829071422,129403.18720080619,20.199514991177352,129423.38671579737,1726,0,301.4,41,4,17,36.77278341133646,0.6056910569105691,45.63492063492063,1017.460317460317,24.81610530391017,0
2249,4,0,3,41,0.0,0.06818181818181818,0.9318181818181819,44,1450,1000,450,0.6896551724137931,19,10,9,356.8384036021598,0.43613460183227626,0.21836425355794353,0.19944717915620713,129511.53413973158,442.9378180976838,129954.47195782926,1727,1,308.95454545454544,40,4,14,36.44793330670925,0.6083333333333334,45.52845528455284,1017.8861788617882,25.447154471544703,0
2250,4,1,2,40,0.023809523809523808,0.047619047619047616,0.9523809523809523,42,1350,1200,150,0.8888888888888888,15,12,3,364.8754560665506,0.43453590785907864,0.21047390909652597,0.2043424926959626,129589.12854658275,1056.7784759402489,130645.907022523,1728,0,316.9761904761905,40,2,14,36.164412616029544,0.6091145833333333,45.452235772357724,1018.1910569105693,25.454776422764233,0
2251,4,0,0,40,0.0,0.0,1.0,40,1150,800,350,0.6956521739130435,15,8,7,388.09649532389045,0.43086271367521367,0.18751285567363762,0.21003292706118504,128232.43694540879,1978.238132242098,130210.67507765089,1729,3,333.2,35,5,14,36.9611330133699,0.6044642857142857,46.788194444444436,1012.8472222222208,28.938492063492024,7
2252,4,2,2,40,0.047619047619047616,0.047619047619047616,0.9523809523809523,42,800,400,400,0.5,12,4,8,374.4156815923775,0.43468108788230736,0.2011610470426759,0.2061083274897847,128910.32036675343,1253.209092881941,130163.52945963536,1730,0,318.2857142857143,39,3,16,36.614118542072696,0.6038995726495726,46.119791666666664,1015.5208333333329,26.038995726495717,0
2253,4,1,0,41,0.024390243902439025,0.0,1.0,41,1450,900,550,0.6206896551724138,20,9,11,388.3318343771722,0.4319359756097561,0.2464145187957396,0.21519961584733793,129174.23575726854,1832.493585177876,131006.72934244642,1731,0,326.8292682926829,38,3,17,35.99097915571904,0.6082785087719298,45.86004273504273,1016.5598290598285,26.751574448942858,0
2254,4,1,0,42,0.023809523809523808,0.0,1.0,42,1150,600,550,0.5217391304347826,17,6,11,385.2676804793936,0.43374951606658924,0.2536277668962321,0.21615142073546156,129659.7526580637,1590.750992326513,131250.50365039022,1732,0,320.0238095238095,36,6,17,35.573308270676705,0.6168981481481481,45.382882882882896,1018.4684684684703,28.29079079079084,0
2255,4,1,0,43,0.023255813953488372,0.0,1.0,43,1050,700,350,0.6666666666666666,14,7,7,377.96578184825955,0.4353082318198597,0.25276591903109047,0.21374390748195363,129970.32470703141,1224.8670789930704,131195.1917860245,1733,0,313.5581395348837,39,4,18,35.44295042054007,0.6145833333333333,45.07812500000001,1019.6875000000013,26.145833333333364,0
2256,4,0,1,42,0.0,0.023255813953488372,0.9767441860465116,43,1300,1000,300,0.7692307692307693,16,10,6,377.56520115266557,0.4353313030638612,0.2546334673751163,0.21380803264810605,130023.43885633704,1218.4651692708567,131241.9040256079,1734,1,314.5581395348837,39,4,19,35.39911227998502,0.6151175213675213,45.02604166666668,1019.8958333333353,26.151175213675263,0
2257,4,0,0,42,0.0,0.0,1.0,42,1250,1000,250,0.8,15,10,5,382.3093773504291,0.4327090592334495,0.2507196487814609,0.21630960324895362,129990.07100820012,1539.2846217766194,131529.35562997672,1735,2,322.95238095238096,38,4,19,35.31211803736686,0.6165021929824561,45.05876068376069,1019.7649572649581,26.835919928025213,0
2258,4,0,0,42,0.0,0.0,1.0,42,1250,1000,250,0.8,15,10,5,383.60220388695484,0.4321041424699961,0.24989778110196958,0.21780030006661233,130126.29323727082,1583.346573891447,131709.63981116225,1736,3,323.95238095238096,38,4,19,35.14048865619547,0.6178728070175439,44.925213675213676,1020.2991452991455,26.84997750787225,0
2259,4,1,1,42,0.023255813953488372,0.023255813953488372,0.9767441860465116,43,900,600,300,0.6666666666666666,12,6,6,370.4776464899752,0.4342700258397933,0.24172135704142428,0.2122132501990272,130469.43486636224,1067.4871904892634,131536.9220568515,1737,0,317.3953488372093,35,8,20,35.12671821305842,0.6270833333333333,44.58912037037037,1021.643518518518,29.1898148148148,0
2260,4,0,0,42,0.0,0.0,1.0,42,800,600,200,0.75,10,6,4,370.9914167975773,0.433894696089818,0.2421854912764001,0.21295048117887527,130550.14209733397,1286.5964359630084,131836.73853329697,1738,1,322.3095238095238,36,6,18,35.03168044077135,0.6258680555555556,44.510135135135144,1021.9594594594607,28.387762762762797,0
2261,4,0,1,41,0.0,0.023809523809523808,0.9761904761904762,42,2100,1700,400,0.8095238095238095,25,17,8,372.25395223368224,0.4337616144018583,0.23865102085758294,0.21479100344258592,130751.61944038632,1334.5614195276332,132086.18085991396,1739,2,323.3095238095238,36,6,18,34.79501578213315,0.6278935185185186,44.31306306306306,1022.7477477477477,28.409659659659656,0
2262,4,0,1,40,0.0,0.024390243902439025,0.975609756097561,41,1000,800,200,0.8,12,8,4,398.0188407274987,0.43252032520325207,0.21998586916540752,0.21242267834310075,127673.13169677192,1973.5630040215844,129646.69470079351,1740,3,325.0,37,4,19,37.284704893132236,0.5948761261261262,47.341008771929815,1010.6359649122793,27.31448553816971,8
2263,4,2,0,42,0.047619047619047616,0.0,1.0,42,1250,1100,150,0.88,14,11,3,392.23246717209196,0.43717334494773524,0.23431467181467203,0.21109238233261665,128009.35057345308,1641.8846793045418,129651.23525275761,1741,0,318.0238095238095,38,4,21,37.085400830518005,0.5964912280701755,47.008547008547005,1011.9658119658114,26.630679262258194,0
2264,4,2,0,44,0.045454545454545456,0.0,1.0,44,700,400,300,0.5714285714285714,10,4,6,379.6061183472684,0.4410786645525018,0.25527387910072075,0.20795389156761662,128717.71541950105,972.8344978688233,129690.54991736988,1742,0,304.52272727272725,34,10,17,36.67927811669013,0.6115196078431373,46.3095238095238,1014.761904761904,29.84593837535012,0
2265,4,2,2,44,0.043478260869565216,0.043478260869565216,0.9565217391304348,46,1350,1100,250,0.8148148148148148,16,11,5,370.1284483583215,0.4422504025764895,0.28755053025885347,0.20741338144309,129613.5612247085,395.640289937991,130009.20151464648,1743,0,292.2391304347826,35,11,17,36.00581571569297,0.618452380952381,45.42824074074074,1018.287037037037,29.09391534391534,0
2266,4,0,0,44,0.0,0.0,1.0,44,1300,700,600,0.5384615384615384,19,7,12,388.8021094367784,0.4378303382663848,0.30320546505517654,0.21697666107278252,129450.69204152234,1266.1404267589207,130716.83246828127,1744,1,306.34090909090907,33,11,17,35.69665221579962,0.6212121212121212,45.58823529411764,1017.6470588235281,30.837789661319036,0
2267,4,0,0,44,0.0,0.0,1.0,44,1300,900,400,0.6923076923076923,17,9,8,386.7808209175441,0.4378853946441155,0.30149472578456704,0.21653470755949833,129575.43372741247,1223.45852556708,130798.89225297955,1745,2,307.34090909090907,33,11,17,35.62078719306692,0.6224747474747474,45.4656862745098,1018.1372549019603,30.85264408793819,0
2268,4,1,0,45,0.022222222222222223,0.0,1.0,45,1550,1000,550,0.6451612903225806,21,10,11,371.7221658216808,0.4407828282828283,0.2892910423558408,0.2101518383011681,129958.94451530614,661.7240646258518,130620.668579932,1746,0,301.4888888888889,34,11,19,35.613689433741975,0.6240808823529411,45.089285714285715,1019.6428571428573,29.989495798319332,0
2269,4,1,1,45,0.021739130434782608,0.021739130434782608,0.9782608695652174,46,1000,800,200,0.8,12,8,4,364.42488757239937,0.4411332528180354,0.28941738319273225,0.20779972312638936,130292.97052154188,296.7545351473867,130589.72505668926,1747,0,295.9130434782609,34,12,20,35.46039334577115,0.6274509803921569,44.76190476190476,1020.9523809523804,30.028011204481775,0
2270,4,0,1,44,0.0,0.022222222222222223,0.9777777777777777,45,1400,1000,400,0.7142857142857143,18,10,8,372.01166180757986,0.4390572390572391,0.1627210884353738,0.21196013289036547,130262.58680555568,691.8402777777883,130954.42708333346,1748,1,286.22222222222223,39,6,19,35.29761904761905,0.6175213675213675,44.79166666666667,1020.8333333333344,26.1752136752137,8
2271,4,1,0,45,0.022222222222222223,0.0,1.0,45,1000,500,500,0.5,15,5,10,371.9218391033063,0.43634259259259256,0.20531007197673867,0.2140616807283474,130654.64854570634,718.6634349030425,131373.31198060937,1749,0,287.15555555555557,37,8,17,34.90186615186615,0.625,44.4078947368421,1022.3684210526313,27.631578947368414,0
2272,4,1,0,46,0.021739130434782608,0.0,1.0,46,1500,1000,500,0.6666666666666666,20,10,10,366.93920308412294,0.4372181964573269,0.2066249778774114,0.21294030919133738,130972.4633487653,411.7862654320826,131384.24961419738,1750,0,281.89130434782606,38,8,18,34.707146087743084,0.6263706140350878,44.097222222222214,1023.6111111111102,26.937134502923954,0
2273,4,0,2,44,0.0,0.043478260869565216,0.9565217391304348,46,1700,1200,500,0.7058823529411765,22,12,10,366.27751205546645,0.4365438808373591,0.21063482343335393,0.21316150291752536,131081.8463387573,402.46651051939114,131484.3128492767,1751,1,282.89130434782606,38,8,18,34.613328116849246,0.627467105263158,43.99038461538461,1024.038461538461,26.948380566801603,0
2274,4,0,1,43,0.0,0.022727272727272728,0.9772727272727273,44,1100,800,300,0.7272727272727273,14,8,6,352.00566450136654,0.4329413319238901,0.20174566732928279,0.19274239336187818,128698.84033203126,260.5441623263895,128959.38449435766,1752,2,296.1136363636364,39,5,17,37.39873130753174,0.6017628205128205,46.328125,1014.6875000000001,26.017628205128208,8
2275,4,0,2,41,0.0,0.046511627906976744,0.9534883720930233,43,600,200,400,0.3333333333333333,10,2,8,358.8451571134107,0.4319859726836471,0.205755409781454,0.19602278030119202,128604.67916757963,629.833260281963,129234.51242786158,1753,4,303.95348837209303,38,5,17,37.321378414437206,0.6025219298245614,46.42094017094016,1014.3162393162378,26.692532613585204,0
2276,4,2,0,43,0.046511627906976744,0.0,1.0,43,1050,500,550,0.47619047619047616,16,5,11,355.9106191317088,0.43297803617571057,0.21364230180204458,0.19601890761680302,128929.98598327102,577.5102271896909,129507.49621046071,1754,0,302.51162790697674,38,5,20,37.063871940528784,0.6058114035087719,46.10042735042734,1015.5982905982888,26.726270805218128,0
2277,4,1,0,44,0.022727272727272728,0.0,1.0,44,1650,1400,250,0.8484848484848485,19,14,5,351.38759286968184,0.4366521317829457,0.21088339526397748,0.19499450270208493,129228.54487407746,282.14681952659834,129510.69169360405,1755,0,296.6136363636364,38,6,21,36.8745840776155,0.6088267543859649,45.80662393162392,1016.7735042735021,26.757197480881633,0
2278,4,0,0,44,0.0,0.0,1.0,44,1000,500,500,0.5,15,5,10,353.32694439891816,0.4365420190274842,0.20903791618527467,0.19661167958048487,129337.19735051853,339.6633473957028,129676.86069791424,1756,1,297.6136363636364,38,6,21,36.7146745790008,0.6099232456140351,45.69978632478632,1017.2008547008536,26.768443544759304,0
2279,4,0,1,43,0.0,0.022727272727272728,0.9772727272727273,44,1000,800,200,0.8,12,8,4,349.3223456573435,0.4363878611698379,0.22095528492395267,0.18802983340842366,128015.94309769358,143.76590488469853,128159.70900257828,1757,2,298.6136363636364,40,4,19,38.16424817567115,0.5932291666666667,47.00203252032522,1011.9918699187025,25.299796747967562,8
2280,4,0,0,43,0.0,0.0,1.0,43,1400,1000,400,0.7142857142857143,18,10,8,353.8682116648137,0.4337163159837578,0.222053042599748,0.1903364234834998,127986.37695312525,458.06206597225184,128444.4390190975,1758,4,306.51162790697674,39,4,19,38.07949008304167,0.594551282051282,47.031250000000014,1011.8750000000019,25.94551282051287,0
2281,4,0,1,42,0.0,0.023255813953488372,0.9767441860465116,43,1350,1000,350,0.7407407407407407,17,10,7,355.80619485512005,0.43406238464377994,0.22662455737391096,0.19213534522176504,128144.53125000015,518.9236111111243,128663.45486111127,1759,5,307.51162790697674,39,4,19,37.86865569272979,0.5961538461538461,46.87500000000001,1012.5000000000011,25.961538461538492,0
2282,4,1,0,43,0.023255813953488372,0.0,1.0,43,1600,1300,300,0.8125,19,13,6,355.14669838270737,0.4352620893318568,0.22375319990837617,0.19244576811482866,128283.34349270911,511.88117978606886,128795.22467249518,1760,0,308.3720930232558,37,6,20,37.74342010318577,0.6010698198198199,46.73793859649122,1013.0482456140337,27.379682313892804,0
2283,4,0,0,43,0.0,0.0,1.0,43,1000,900,100,0.9,11,9,2,355.6499747541342,0.4357465854558878,0.22543305831729432,0.19309330340829778,128360.96871803998,530.3150567974232,128891.2837748374,1761,1,309.3720930232558,38,5,20,37.651335441925845,0.6000548245614035,46.66132478632478,1013.3547008547004,26.667228969860535,0
2284,4,2,1,44,0.044444444444444446,0.022222222222222223,0.9777777777777777,45,1350,900,450,0.6666666666666666,18,9,9,342.41457421981687,0.4413510101010101,0.23232606230404906,0.18864891150787488,128943.21852898407,-169.5925457730225,128773.62598321105,1762,0,296.5777777777778,40,5,19,37.39306083650189,0.6026041666666666,46.08739837398374,1015.650406504065,25.391260162601625,0
2285,4,1,0,45,0.022222222222222223,0.0,1.0,45,1450,1200,250,0.8275862068965517,17,12,5,344.6654125235154,0.44008838383838383,0.24262295081967244,0.19113263785394913,129201.38888888869,-93.2336076409814,129108.1552812477,1763,0,297.5111111111111,38,7,20,37.07308743169397,0.6085526315789473,45.83333333333332,1016.666666666665,26.754385964912238,0
2286,4,0,0,45,0.0,0.0,1.0,45,1300,800,500,0.6153846153846154,18,8,10,349.63558131594016,0.43994107744107747,0.24992706181656965,0.19455759028106726,129337.19735051839,44.17723628457648,129381.37458680297,1764,1,298.5111111111111,38,7,21,36.808546021076204,0.6099232456140351,45.69978632478631,1017.2008547008525,26.768443544759275,0
2287,4,2,0,47,0.0425531914893617,0.0,1.0,47,1750,1400,350,0.8,21,14,7,339.723388785625,0.44231806968855997,0.2657751244456128,0.19240767098490574,130029.26911891061,-565.203210721142,129464.06590818947,1765,0,286.7659574468085,40,7,19,36.358069283911256,0.6135416666666667,45.02032520325203,1019.9186991869911,25.497967479674777,0
2288,4,1,1,47,0.020833333333333332,0.020833333333333332,0.9791666666666666,48,1200,700,500,0.5833333333333334,17,7,10,332.02705787881905,0.44469377955082745,0.2673407632203153,0.1893108929051311,130289.85407991824,-947.4211989605742,129342.43288095767,1766,0,281.7708333333333,38,10,20,36.29046323426817,0.6195175438596492,44.76495726495727,1020.9401709401714,26.86684660368872,0
2289,4,1,0,48,0.020833333333333332,0.0,1.0,48,900,600,300,0.6666666666666666,12,6,6,330.8910364893303,0.44249593676122934,0.2658652337621583,0.1893267025657983,130426.23325525984,-968.625698553572,129457.60755670627,1767,0,282.6666666666667,38,10,22,36.18149252170273,0.6208881578947368,44.63141025641026,1021.4743589743601,26.880904183535794,0
2290,4,0,0,48,0.0,0.0,1.0,48,1050,700,350,0.6666666666666666,14,7,7,330.53370555092295,0.4424128250591017,0.2640750841064321,0.18949182453237906,130501.95448133691,-972.9410807291583,129529.01340060776,1768,1,283.6666666666667,39,9,18,36.114049172528624,0.6199252136752137,44.55729166666667,1021.7708333333343,26.19925213675216,0
2291,4,0,1,47,0.0,0.020833333333333332,0.9791666666666666,48,1500,900,600,0.6,21,9,12,330.1454674055165,0.44244052895981084,0.2603476539938163,0.18952938447721035,130555.17713758696,-979.5600043402605,129575.61713324669,1769,2,284.6666666666667,39,9,18,36.07016359188667,0.6204594017094017,44.50520833333334,1021.9791666666679,26.20459401709405,0
2292,4,1,3,45,0.020833333333333332,0.0625,0.9375,48,1300,800,500,0.6153846153846154,18,8,10,330.30751540066524,0.4417756353427896,0.2634838020471033,0.19048048868062445,130729.84959556165,-963.7896382774634,129766.05995728419,1770,0,285.6041666666667,40,8,19,35.889521017589196,0.6205729166666667,44.33434959349594,1022.6626016260175,25.56656504065044,0
2293,4,1,1,45,0.021739130434782608,0.021739130434782608,0.9782608695652174,46,1150,800,350,0.6956521739130435,15,8,7,343.24632032335745,0.43945249597423514,0.27050692081605177,0.19778510125315216,130699.20562358476,-227.59572010372324,130471.60990348103,1771,0,280.0652173913044,38,8,21,35.589715459896205,0.6236293859649122,44.364316239316246,1022.5427350427361,26.909019343229897,0
2294,4,0,0,45,0.0,0.0,1.0,45,1400,1100,300,0.7857142857142857,17,11,6,351.80208295898035,0.43794191919191916,0.27370151921358365,0.20262843876420591,130682.67549871112,194.88748941981657,130877.56298813094,1772,1,286.64444444444445,37,8,21,35.3877345844504,0.6252815315315315,44.38048245614035,1022.4780701754385,27.634542437174012,0
2295,4,1,2,44,0.021739130434782608,0.043478260869565216,0.9565217391304348,46,1350,1000,350,0.7407407407407407,17,10,7,340.1208347290582,0.43913043478260866,0.21655200605338454,0.18787448097354276,129046.45568940455,-421.72235441865325,128624.7333349859,1773,0,281.39130434782606,40,6,15,37.34621924384877,0.6036458333333333,45.98577235772358,1016.0569105691065,25.401422764227664,8
2296,4,1,0,45,0.022222222222222223,0.0,1.0,45,1400,1000,400,0.7142857142857143,18,10,8,344.9333465675353,0.4400462962962963,0.2275187576140545,0.19115301130906182,129174.91455078137,-88.65288628470813,129086.26166449666,1774,0,281.68888888888887,39,6,17,37.093217371998506,0.6065705128205128,45.85937500000001,1016.5625000000009,26.065705128205153,0
2297,4,0,1,44,0.0,0.022222222222222223,0.9777777777777777,45,1450,900,550,0.6206896551724138,20,9,11,345.40861894011243,0.4399621212121212,0.22601696133390803,0.19208695139619242,129312.88954293655,-66.8372570165543,129246.05228592,1775,1,282.68888888888887,37,8,17,36.9407611039241,0.6114864864864865,45.72368421052633,1017.1052631578968,27.489331436699914,0
2298,4,2,1,45,0.043478260869565216,0.021739130434782608,0.9782608695652174,46,1450,1100,350,0.7586206896551724,18,11,7,336.5902189488379,0.4410527375201288,0.23314773131145627,0.19004401592957462,129908.37191358028,-454.8225308641903,129453.5493827161,1776,0,277.2826086956522,38,8,17,36.5605131698456,0.6156798245614035,45.13888888888889,1019.4444444444447,26.827485380116965,0
2299,4,0,0,45,0.0,0.0,1.0,45,1200,900,300,0.75,15,9,6,342.1836573655168,0.4403409090909091,0.23473073934612398,0.19288035750227298,129843.17440221999,-113.95753981993664,129729.21686240005,1777,1,284.44444444444446,37,8,18,36.484108839878076,0.6168355855855856,45.202850877192986,1019.1885964912286,27.54563774300618,0
2300,4,0,1,44,0.0,0.022222222222222223,0.9777777777777777,45,1200,700,500,0.5833333333333334,17,7,10,345.58114481292756,0.44006734006734005,0.24089866713229746,0.1955288694273498,129990.07100819996,-15.576489334507272,129974.49451886545,1778,2,285.44444444444446,38,7,18,36.248472149467446,0.6165021929824561,45.05876068376068,1019.7649572649568,26.83591992802518,0
2301,4,1,1,44,0.022222222222222223,0.022222222222222223,0.9777777777777777,45,1300,900,400,0.6923076923076923,17,9,8,341.357767596835,0.4403409090909091,0.24181405895691666,0.19449454200284771,130262.58680555547,-106.48547647746886,130156.10132907801,1779,0,286.0888888888889,37,8,19,36.079931972789126,0.6210585585585586,44.791666666666664,1020.8333333333327,27.590090090090072,0
2302,4,0,1,43,0.0,0.022727272727272728,0.9772727272727273,44,1000,700,300,0.7,13,7,6,340.4859689803476,0.4401537174066244,0.23307219866517048,0.1949537027179691,130453.51765103366,83.51847286141458,130537.03612389507,1780,1,288.29545454545456,38,6,19,35.90884926444955,0.6211622807017544,44.60470085470085,1021.5811965811965,26.88371569950517,0
2303,4,0,1,42,0.0,0.023255813953488372,0.9767441860465116,43,1800,1200,600,0.6666666666666666,24,12,12,345.19174891178614,0.4390919158361019,0.2348280945598411,0.19853316934636508,130626.62459843393,418.24659991533565,131044.87119834927,1781,2,295.27906976744185,37,6,16,35.6134246844721,0.6247184684684685,44.43530701754385,1022.2587719298228,27.62861545756278,0
2304,4,0,1,41,0.0,0.023809523809523808,0.9761904761904762,42,1300,1100,200,0.8461538461538461,15,11,4,350.16435327670325,0.4400043554006969,0.22763331864257408,0.20114504242654146,130578.91506371221,744.8162689716582,131323.73133268388,1782,3,298.04761904761904,36,6,16,35.53465182899956,0.6261574074074074,44.481981981981974,1022.0720720720708,28.390890890890855,0
2305,4,0,0,41,0.0,0.0,1.0,41,1300,1000,300,0.7692307692307693,16,10,6,348.2908251945949,0.43915142276422764,0.2108610580654866,0.200814538640769,130722.8274516068,905.9122889781393,131628.73974058495,1783,4,290.7317073170732,36,5,16,35.43685533898615,0.6276041666666667,44.3412162162162,1022.6351351351334,28.406531531531485,0
2306,4,0,0,41,0.0,0.0,1.0,41,1100,700,400,0.6363636363636364,15,7,8,350.4771331965668,0.4382367886178862,0.21230385116179185,0.20267885137433522,130838.01442912496,971.146442050141,131809.1608711751,1784,5,291.7317073170732,36,5,16,35.26440102733442,0.6287615740740741,44.228603603603595,1023.0855855855847,28.419044044044018,0
2307,4,0,2,39,0.0,0.04878048780487805,0.9512195121951219,41,1450,1200,250,0.8275862068965517,17,12,5,348.47452709546405,0.43678861788617884,0.21115319820158174,0.20257867009922997,131039.71370018659,932.8004524794976,131972.5141526661,1785,6,292.7317073170732,36,5,17,35.111682431441565,0.630787037037037,44.03153153153153,1023.8738738738732,28.440940940940923,0
2308,4,0,0,39,0.0,0.0,1.0,39,1600,1200,400,0.75,20,12,8,363.9875797155726,0.4350539811066127,0.22315928950007136,0.2101734734486695,130779.59183673482,1720.429421768719,132500.02125850355,1786,7,307.53846153846155,34,5,19,34.97803189013035,0.6323529411764706,44.28571428571429,1022.8571428571438,30.084033613445406,0
2309,4,0,0,39,0.0,0.0,1.0,39,1550,1000,550,0.6451612903225806,21,10,11,360.6539352725475,0.43415429599640126,0.2219418946564795,0.20923768795366834,130962.30867346936,1646.4143990929642,132608.72307256234,1787,8,308.53846153846155,34,5,19,34.87826626347212,0.6341911764705883,44.107142857142854,1023.5714285714284,30.10504201680672,0
2310,4,0,1,38,0.0,0.02564102564102564,0.9743589743589743,39,1150,900,250,0.782608695652174,14,9,5,360.8151526607126,0.4338731443994602,0.21710375331205278,0.21016200124171386,131114.67013888896,1661.631944444449,132776.3020833334,1788,9,309.53846153846155,34,5,20,34.719962028749656,0.6357230392156863,43.958333333333336,1024.1666666666672,30.12254901960786,0
2311,4,0,1,37,0.0,0.02631578947368421,0.9736842105263158,38,1200,1000,200,0.8333333333333334,14,10,4,366.26992861870934,0.4333511142721669,0.21924576308546895,0.2133043758513279,131108.39468293454,2004.212472366405,133112.60715530094,1789,10,317.1578947368421,33,5,20,34.58664891707551,0.6379419191919191,43.96446078431373,1024.1421568627457,31.034610814022596,0
2312,4,0,0,37,0.0,0.0,1.0,37,1050,800,250,0.7619047619047619,13,8,5,362.21825632890426,0.4319944944944945,0.20369149637442252,0.21215640727835847,131328.12500000017,2113.8888888889023,133442.01388888908,1790,11,312.4594594594595,33,4,21,34.46815718157179,0.6401515151515151,43.75000000000001,1025.0000000000014,31.0606060606061,0
2313,4,0,0,37,0.0,0.0,1.0,37,1050,800,250,0.7619047619047619,13,8,5,362.47184941998836,0.4320257757757758,0.20217301431450618,0.21300312050185835,131453.7677816224,2129.658064206069,133583.42584582846,1791,12,313.4594594594595,33,4,21,34.33466778202676,0.6414141414141414,43.627450980392155,1025.490196078431,31.07546048722518,0
2314,4,1,1,37,0.02631578947368421,0.02631578947368421,0.9736842105263158,38,950,600,350,0.631578947368421,13,6,7,354.2953161100612,0.43256578947368424,0.2048970251716251,0.21002041934359283,131786.11288265293,1738.240504535136,133524.35338718808,1792,0,306.1842105263158,34,4,21,34.208937198067616,0.6424632352941176,43.30357142857142,1026.7857142857133,30.199579831932745,0
2315,4,0,0,37,0.0,0.0,1.0,37,1300,1200,100,0.9230769230769231,14,12,2,359.6051019958657,0.43133758758758756,0.19657661958927153,0.21306729452060566,131768.13755526725,2076.898909073431,133845.0364643407,1793,1,304.4054054054054,33,4,21,34.09077345428501,0.6445707070707071,43.32107843137255,1026.71568627451,31.11259655377303,0
2316,4,0,0,37,0.0,0.0,1.0,37,950,700,250,0.7368421052631579,12,7,5,359.9671908909152,0.43083708708708707,0.20214152099593607,0.2136349192397926,131831.05656478286,2090.9710207612557,133922.02758554413,1794,2,305.4054054054054,33,4,21,34.01799920445504,0.6452020202020202,43.25980392156863,1026.9607843137262,31.120023767082614,0
2317,4,0,0,37,0.0,0.0,1.0,37,1050,600,450,0.5714285714285714,15,6,9,360.24179097954664,0.4299924924924925,0.20537187951310076,0.21450761190145737,131956.9396386006,2107.280853517884,134064.22049211847,1795,3,306.4054054054054,33,4,22,33.88398536895674,0.6464646464646464,43.13725490196079,1027.4509803921574,31.134878193701738,0
2318,4,0,0,37,0.0,0.0,1.0,37,1050,800,250,0.7619047619047619,13,8,5,360.68512162502964,0.4286161161161161,0.2064081248630607,0.21548623932982547,132082.88278546714,2128.0661284121506,134210.94891387929,1796,4,307.4054054054054,33,4,22,33.7456286758862,0.6477272727272727,43.01470588235294,1027.9411764705883,31.149732620320858,0
2319,4,0,1,36,0.0,0.02702702702702703,0.972972972972973,37,1150,700,450,0.6086956521739131,16,7,9,360.2558319312017,0.4283971471471471,0.20576099875349052,0.2157677862765678,132177.3795685554,2123.534367791233,134300.91393634662,1797,5,308.4054054054054,33,4,22,33.661437850077455,0.6486742424242424,42.92279411764706,1028.308823529412,31.16087344028521,0
2320,4,0,0,36,0.0,0.0,1.0,36,1000,700,300,0.7,13,7,6,366.691581038187,0.42784391534391536,0.20396864382496238,0.21939526409948265,132138.24043783802,2490.796060350989,134629.036498189,1798,6,313.69444444444446,32,4,22,33.535449670473604,0.6507161458333333,42.96085858585859,1028.156565656566,32.12989267676769,0
2321,4,0,0,36,0.0,0.0,1.0,36,1350,1100,250,0.8148148148148148,16,11,5,365.78651399244416,0.4272982804232804,0.20789297744863577,0.21982802878461088,132306.12953514745,2479.159580498874,134785.28911564633,1799,7,314.69444444444446,34,2,23,33.389502815706244,0.647671568627451,42.79761904761905,1028.8095238095243,30.259103641456598,0
2322,4,0,0,36,0.0,0.0,1.0,36,1300,1200,100,0.9230769230769231,14,12,2,366.8551328903942,0.42744708994708996,0.20738362451309378,0.22064919370714522,132336.75063775506,2509.683248299311,134846.43388605438,1800,8,315.69444444444446,34,2,23,33.331163947703345,0.6479779411764706,42.76785714285714,1028.9285714285709,30.26260504201679,0
2323,4,0,0,36,0.0,0.0,1.0,36,1300,800,500,0.6153846153846154,18,8,10,365.28164545173973,0.4261904761904762,0.2086821674668362,0.2206133072207093,132492.61289227704,2479.438101833872,134972.0509941109,1801,9,316.69444444444446,33,3,23,33.214671864460584,0.6518308080808081,42.61642156862745,1029.5343137254904,31.198009506833042,0
2324,4,0,0,36,0.0,0.0,1.0,36,1050,700,350,0.6666666666666666,14,7,7,365.3711690408356,0.42536375661375664,0.207498843281116,0.2214091330777376,132618.81134960108,2491.018027921951,135109.82937752304,1802,10,317.69444444444446,33,3,23,33.08534106682529,0.6530934343434344,42.493872549019606,1030.0245098039213,31.212863933452162,0
2325,4,0,0,36,0.0,0.0,1.0,36,1150,900,250,0.782608695652174,14,9,5,367.7051713695713,0.42485119047619047,0.20644359868907913,0.22338620526556052,132713.49961553258,2559.8880238369948,135273.38763936958,1803,11,318.69444444444446,33,3,20,32.92994766888678,0.654040404040404,42.40196078431373,1030.3921568627457,31.224004753416533,0
2326,4,0,0,36,0.0,0.0,1.0,36,1200,600,600,0.5,18,6,12,366.05444792194095,0.42397486772486775,0.20962597567257046,0.2233224126444733,132871.3884833957,2527.632551182226,135399.02103457795,1804,12,319.69444444444446,33,3,20,32.813676255002186,0.6556186868686869,42.248774509803916,1031.0049019607836,31.242572786690413,0
2327,4,0,1,35,0.0,0.027777777777777776,0.9722222222222222,36,1250,1200,50,0.96,13,12,1,363.4647012632909,0.4234126984126984,0.2119754796347595,0.22239111382380997,132980.6122448978,2466.7517006802505,135447.36394557805,1805,13,320.69444444444446,34,2,20,32.770660203139414,0.6544117647058824,42.14285714285713,1031.4285714285702,30.336134453781476,0
2328,4,1,0,36,0.027777777777777776,0.0,1.0,36,850,600,250,0.7058823529411765,11,6,5,359.59770449052814,0.4242559523809524,0.20795709253922534,0.22202918764806645,133318.4966695012,2388.2050736961587,135706.70174319737,1806,0,317.72222222222223,34,2,21,32.53121998078771,0.657781862745098,41.8154761904762,1032.7380952380959,30.374649859943997,0
2329,4,0,1,35,0.0,0.027777777777777776,0.9722222222222222,36,800,600,200,0.75,10,6,4,358.94424538049685,0.42402447089947093,0.20211941980002823,0.2223609640012373,133441.47002551032,2379.6095521542056,135821.07957766452,1807,1,318.72222222222223,34,2,21,32.42477051887698,0.6590073529411764,41.69642857142858,1033.2142857142865,30.388655462184897,0
2330,4,1,0,36,0.027777777777777776,0.0,1.0,36,1050,700,350,0.6666666666666666,14,7,7,351.08806080712554,0.42351190476190476,0.18802165215946398,0.2200438725736368,133872.32320011337,2200.1984126984144,136072.52161281178,1808,0,312.47222222222223,34,2,19,32.19640323632041,0.663296568627451,41.279761904761905,1034.8809523809525,30.437675070028014,0
2331,4,0,0,36,0.0,0.0,1.0,36,800,600,200,0.75,10,6,4,352.2246629681816,0.42328042328042326,0.18990799309948292,0.2211258804699161,133933.9303429705,2234.9666950113387,136168.89703798183,1809,1,313.47222222222223,34,2,19,32.10537665324899,0.6639093137254901,41.220238095238095,1035.1190476190475,30.444677871148457,0
2332,4,0,0,36,0.0,0.0,1.0,36,900,700,200,0.7777777777777778,11,7,4,352.1141026988091,0.42208994708994707,0.1860782209960279,0.22179873855010432,134057.18714569157,2240.685232426302,136297.87237811787,1810,2,314.47222222222223,34,2,19,31.984998275663873,0.6651348039215687,41.101190476190474,1035.5952380952378,30.45868347338935,0
2333,4,0,1,35,0.0,0.027777777777777776,0.9722222222222222,36,1500,1000,500,0.6666666666666666,20,10,10,349.23377380500176,0.4212466931216931,0.18573033428915497,0.2206063168192355,134160.80092860505,2170.696560999653,136331.4974896047,1811,3,315.47222222222223,35,1,19,31.956043086433546,0.6639880952380952,41.001157407407405,1035.9953703703698,29.599867724867707,0
2334,4,0,0,35,0.0,0.0,1.0,35,1550,1200,350,0.7741935483870968,19,12,7,384.92574544073784,0.42051820728291317,0.22947667676654326,0.22791184834700415,131741.75663371474,3223.99444516259,134965.75107887734,1812,4,318.77142857142854,30,5,18,33.46753076721654,0.6520833333333333,43.34677419354838,1026.6129032258052,34.22043010752684,8
2335,4,0,0,35,0.0,0.0,1.0,35,1300,1000,300,0.7692307692307693,16,10,6,388.36778089090933,0.42041316526610645,0.17508688494603963,0.2157291869671408,129267.58660210492,3040.67314995658,132308.2597520615,1813,5,319.77142857142854,31,4,19,35.89468629961588,0.6243279569892473,45.76822916666666,1016.9270833333323,32.804099462365556,8
2336,4,0,0,35,0.0,0.0,1.0,35,1200,700,500,0.5833333333333334,17,7,10,383.94701333623266,0.4196778711484594,0.18074160712001341,0.21453279508572753,129499.41211276574,2944.182501898862,132443.59461466462,1814,6,320.77142857142854,31,4,16,35.77046288004778,0.6266801075268817,45.54036458333333,1017.8385416666658,32.833501344085995,0
2337,4,0,0,35,0.0,0.0,1.0,35,1100,700,400,0.6363636363636364,15,7,8,386.37342600608054,0.41939775910364147,0.17376570260005808,0.21716851185858999,129731.44531249993,3024.956597222209,132756.40190972213,1815,7,321.77142857142854,31,4,16,35.47205180640762,0.6290322580645161,45.31249999999999,1018.7499999999994,32.862903225806434,0
2338,4,1,0,36,0.027777777777777776,0.0,1.0,36,1050,800,250,0.7619047619047619,13,8,5,380.22222086069996,0.4227017195767196,0.164280803080308,0.21574406914006006,130101.52025303539,2693.4977935924885,132795.01804662787,1816,0,313.80555555555554,32,4,18,35.25190800330033,0.6302083333333333,44.94949494949495,1020.2020202020201,31.881313131313128,0
2339,4,2,1,37,0.05263157894736842,0.02631578947368421,0.9736842105263158,38,900,500,400,0.5555555555555556,13,5,8,362.53702187071787,0.4274241346609768,0.15521382919401128,0.20884174921848386,130688.28124999991,1875.8680555555402,132564.14930555545,1817,0,298.2368421052632,34,4,14,35.10764737842976,0.6314338235294117,44.37499999999999,1022.4999999999993,30.073529411764685,0
2340,4,0,0,37,0.0,0.0,1.0,37,750,400,350,0.5333333333333333,11,4,7,371.4926785219184,0.42401776776776773,0.16129335524801536,0.21286147497163105,130481.60750973172,2294.592374327169,132776.19988405888,1818,1,307.2972972972973,33,4,20,35.088436088121234,0.6316287878787878,44.577205882352935,1021.6911764705873,30.96033868092689,0
2341,4,1,1,37,0.02631578947368421,0.02631578947368421,0.9736842105263158,38,1150,1000,150,0.8695652173913043,13,10,3,365.2293393033349,0.4271574205784732,0.1623949939996574,0.21155737201155425,130901.38888888885,1961.8055555555507,132863.1944444444,1819,0,300.1842105263158,34,4,16,34.82288273615636,0.633578431372549,44.166666666666664,1023.3333333333329,30.098039215686264,0
2342,4,1,1,37,0.02631578947368421,0.02631578947368421,0.9736842105263158,38,1150,600,550,0.5217391304347826,17,6,11,364.26004706059314,0.4277501185395922,0.162451980718882,0.2123369542621508,131145.15306122453,1954.187925170072,133099.34098639459,1820,0,301.07894736842104,34,4,19,34.600912366341234,0.6360294117647058,43.92857142857143,1024.2857142857147,30.126050420168077,0
2343,4,0,0,37,0.0,0.0,1.0,37,1500,1000,500,0.6666666666666666,20,10,10,371.43093254757315,0.42648898898898896,0.17142007454171093,0.2170184505262236,131233.93233672148,2348.868373942718,133582.8007106642,1821,1,309.4594594594595,33,4,19,34.327408005422,0.6392045454545454,43.841911764705884,1024.6323529411766,31.049465240641716,0
2344,4,0,0,37,0.0,0.0,1.0,37,1150,800,350,0.6956521739130435,15,8,7,370.144008654739,0.4261136136136136,0.17409088706159848,0.21697649841604008,131359.5300635573,2324.388606545558,133683.91867010284,1822,2,310.4594594594595,33,4,19,34.23328850368598,0.6404671717171717,43.71936274509804,1025.1225490196077,31.06431966726084,0
2345,4,0,0,37,0.0,0.0,1.0,37,1050,700,350,0.6666666666666666,14,7,7,367.98373893221094,0.425487987987988,0.1772611320998423,0.21659802354870636,131516.6116998269,2279.194900999608,133795.8066008265,1823,3,311.4594594594595,33,4,20,34.12982875348466,0.6420454545454546,43.56617647058823,1025.7352941176464,31.08288770053474,0
2346,4,1,0,38,0.02631578947368421,0.0,1.0,38,1350,1200,150,0.8888888888888888,15,12,3,364.67011919131994,0.4264017306780465,0.18750381167286734,0.2170415950773166,131938.95266439905,2022.8387188208633,133961.7913832199,1824,0,304.2368421052632,34,4,18,33.78838354577059,0.6439950980392157,43.154761904761905,1027.380952380952,30.217086834733884,0
2347,4,0,0,38,0.0,0.0,1.0,38,1700,1400,300,0.8235294117647058,20,14,6,364.4175281430148,0.4257349454717876,0.19126179274030353,0.21794389009993587,132122.47732426302,2029.5493197278881,134152.02664399092,1825,1,305.2368421052632,34,4,18,33.60979234213371,0.6458333333333333,42.976190476190474,1028.0952380952378,30.23809523809523,0
2348,4,0,0,38,0.0,0.0,1.0,38,1000,700,300,0.7,13,7,6,366.348368026783,0.42533487434803224,0.1942118054075126,0.2199872305850888,132275.5119756234,2091.7835884353526,134367.29556405876,1826,2,306.2368421052632,34,4,19,33.40590402345407,0.6473651960784313,42.82738095238094,1028.6904761904748,30.255602240896316,0
2349,4,0,0,38,0.0,0.0,1.0,38,1250,1000,250,0.8,15,10,5,353.9259206138621,0.42453473210052156,0.12938543964702154,0.20494323419734733,130888.84833958093,1665.0479186772768,132553.8962582582,1827,3,307.2368421052632,33,5,17,35.124750499002,0.6357323232323233,44.17892156862745,1023.2843137254903,31.0086155674391,8
2350,4,0,0,38,0.0,0.0,1.0,38,1300,1000,300,0.7692307692307693,16,10,6,353.6902188331986,0.42419393077287815,0.1311254983216088,0.20597833859157094,131108.39468293457,1674.3513612553093,132782.74604418987,1828,4,308.2368421052632,33,5,17,34.90873419488654,0.6379419191919191,43.96446078431374,1024.142156862746,31.03461081402261,0
2351,4,0,0,38,0.0,0.0,1.0,38,900,600,300,0.6666666666666666,12,6,6,354.8090424380814,0.42371977240398295,0.13779978718179597,0.20696781477598913,131171.15600069697,1708.142451220705,132879.29845191768,1829,5,309.2368421052632,33,5,17,34.81663974957133,0.6385732323232323,43.903186274509814,1024.3872549019618,31.042038027332175,0
2352,4,0,1,37,0.0,0.02631578947368421,0.9736842105263158,38,1000,800,200,0.8,12,8,4,351.63413250621403,0.4236012328117591,0.13551860639282065,0.20578840099016582,131296.72369100834,1633.68190719917,132930.40559820752,1830,6,310.2368421052632,33,5,18,34.77108991988523,0.6398358585858586,43.78063725490197,1024.877450980393,31.056892453951303,0
2353,4,0,1,36,0.0,0.02702702702702703,0.972972972972973,37,1100,800,300,0.7272727272727273,14,8,6,356.7724570268628,0.4189502002002002,0.15145845705988048,0.2091488871312352,131361.4930046928,1973.236278165807,133334.7292828586,1831,7,319.35135135135135,31,6,19,34.57399233667812,0.645497311827957,43.717447916666664,1025.1302083333326,33.068716397849435,0
2354,4,0,0,36,0.0,0.0,1.0,36,1050,600,450,0.5714285714285714,15,6,9,364.8621852072179,0.41810515873015874,0.15492321589882585,0.21370499419279906,131328.125,2383.333333333333,133711.45833333334,1832,8,326.77777777777777,30,6,20,34.400406504065046,0.6479166666666667,43.75,1025.0,34.166666666666664,0
2355,4,0,0,36,0.0,0.0,1.0,36,1400,1000,400,0.7142857142857143,18,10,8,364.75483569269113,0.41875,0.15749479325963778,0.21421975685138878,131431.47193678463,2388.0529902300823,133819.52492701472,1833,9,327.77777777777777,30,6,21,34.298673919692405,0.6489583333333333,43.649193548387096,1025.4032258064517,34.18010752688172,0
2356,4,0,0,36,0.0,0.0,1.0,36,1200,700,500,0.5833333333333334,17,7,10,363.8582123029919,0.4186177248677249,0.15311448914515347,0.21407879861866844,131500.3924767314,2369.49954474505,133869.89202147644,1834,10,328.77777777777777,30,6,21,34.25200934783558,0.6496527777777779,43.581989247311824,1025.6720430107523,34.18906810035841,0
2357,4,0,0,36,0.0,0.0,1.0,36,1150,800,350,0.6956521739130435,15,8,7,365.22773605591743,0.4184193121693122,0.1503158798783062,0.2152728424181324,131569.3310823505,2410.553785119653,133979.88486747013,1835,11,329.77777777777777,30,6,18,34.14723350364643,0.6503472222222222,43.51478494623655,1025.9408602150531,34.198028673835104,0
2358,4,0,0,36,0.0,0.0,1.0,36,1500,1300,200,0.8666666666666667,17,13,4,363.7369452591761,0.41860119047619043,0.1513525305410126,0.21575700790218205,131810.75846918722,2388.888527575446,134199.64699676266,1836,12,330.77777777777777,30,6,19,33.94169938917976,0.6527777777777778,43.27956989247312,1026.8817204301076,34.229390681003586,0
2359,4,0,0,36,0.0,0.0,1.0,36,1300,1000,300,0.7692307692307693,16,10,6,393.0883124235885,0.4185515873015873,0.12265368920998054,0.21954259816260283,129481.87183114678,2979.562097510582,132461.43392865735,1837,13,331.77777777777777,33,3,16,35.555764599638756,0.6215277777777778,45.55759803921569,1017.7696078431381,30.841503267973884,8
2360,4,1,0,37,0.02702702702702703,0.0,1.0,37,1050,900,150,0.8571428571428571,12,9,3,384.3767052939361,0.42204704704704704,0.1253980828896164,0.21696886799156068,129898.25857426306,2585.972930839007,132484.23150510207,1838,0,323.7837837837838,34,3,17,35.352923430261995,0.623468137254902,45.148809523809526,1019.404761904762,29.982492997198882,0
2361,4,1,2,36,0.02631578947368421,0.05263157894736842,0.9473684210526316,38,850,400,450,0.47058823529411764,13,4,9,376.1952950321035,0.4233493361782836,0.1274780179438042,0.2138564742938788,130173.98787133503,2194.168354552483,132368.1562258875,1839,0,316.2368421052632,35,3,18,35.28092038108199,0.6241071428571429,44.87847222222223,1020.4861111111123,29.156746031746067,0
2362,4,0,0,36,0.0,0.0,1.0,36,1200,800,400,0.6666666666666666,16,8,8,388.57177741827184,0.42037037037037034,0.12781247497798076,0.22068544466470194,130137.51471789693,2913.553080545943,133051.06779844288,1840,1,328.6388888888889,33,3,18,35.00230202578268,0.6281565656565656,44.91421568627451,1020.3431372549018,30.919489007724295,0
2363,4,0,0,36,0.0,0.0,1.0,36,1050,700,350,0.6666666666666666,14,7,7,390.6419416784093,0.42027116402116405,0.131991140996905,0.22221762911870158,130200.0432525951,2972.319540561319,133172.3627931564,1841,2,329.6388888888889,33,3,18,34.88582692923471,0.6287878787878788,44.85294117647059,1020.5882352941172,30.926916221033856,0
2364,4,1,1,36,0.02702702702702703,0.02702702702702703,0.972972972972973,37,1000,700,300,0.7,13,7,6,380.4312686446382,0.4215465465465465,0.1258123629372241,0.21893048914112556,130649.55305899918,2540.665080142428,133190.21813914162,1842,0,321.7027027027027,32,5,16,34.68954551068296,0.6357421875,44.412878787878796,1022.3484848484858,31.94839015151518,0
2365,4,0,0,36,0.0,0.0,1.0,36,1000,700,300,0.7,13,7,6,392.5305259722867,0.41875,0.13527908721563975,0.22538201158423402,130561.83073255756,3049.900817871102,133611.73155042867,1843,4,331.6388888888889,31,5,16,34.469491867329154,0.6374327956989247,44.49869791666667,1022.0052083333338,32.967909946236574,0
2366,4,1,0,37,0.02702702702702703,0.0,1.0,37,1250,1000,250,0.8,15,10,5,380.8165979482911,0.42092092092092087,0.1324471065339774,0.22043840784092528,130875.54841342736,2567.9162202836696,133443.46463371103,1844,0,323.64864864864865,32,5,17,34.45032288581773,0.6380208333333333,44.191919191919204,1023.2323232323245,31.97601010101014,0
2367,4,0,1,36,0.0,0.02702702702702703,0.972972972972973,37,900,600,300,0.6666666666666666,12,6,6,385.93881462307314,0.42095220220220225,0.1342183431735673,0.22396606801354726,130972.4633487655,2709.471450617296,133681.93479938278,1845,1,324.64864864864865,32,5,17,34.2209407507915,0.6389973958333333,44.09722222222223,1023.6111111111117,31.98784722222224,0
2368,4,0,0,36,0.0,0.0,1.0,36,1200,800,400,0.6666666666666666,16,8,8,395.51260381733306,0.41840277777777773,0.13864215807220992,0.22932941105459964,130940.15438475671,3157.6962809917427,134097.85066574844,1846,2,334.5,32,4,17,34.00875894399211,0.638671875,44.12878787878788,1023.4848484848488,31.983901515151526,0
2369,4,0,0,36,0.0,0.0,1.0,36,750,500,250,0.6666666666666666,10,5,5,395.5751888235998,0.41820436507936504,0.14041687222496302,0.22975097643135728,131004.77629833692,3164.4478242016157,134169.22412253852,1847,3,335.5,32,4,17,33.94152894260814,0.6393229166666667,44.06565656565657,1023.7373737373739,31.991792929292934,0
2370,4,0,0,36,0.0,0.0,1.0,36,1050,700,350,0.6666666666666666,14,7,7,397.2572812454161,0.41779100529100527,0.09928887788506513,0.22503817096076226,130037.12153096612,3154.659282216088,133191.7808131822,1848,4,336.5,32,4,18,34.883067178344476,0.6295572916666667,45.012626262626256,1019.9494949494941,31.87342171717169,8
2371,4,0,1,35,0.0,0.027777777777777776,0.9722222222222222,36,850,500,350,0.5882352941176471,12,5,7,394.8393113129399,0.4187169312169312,0.09723253320135283,0.22440867187279753,130165.93491735542,3078.9256198347184,133244.86053719014,1849,5,337.5,32,4,19,34.81347438752784,0.630859375,44.88636363636364,1020.4545454545458,31.889204545454557,0
2372,4,1,2,34,0.027777777777777776,0.05555555555555555,0.9444444444444444,36,1200,900,300,0.75,15,9,6,390.63487070783066,0.4194279100529101,0.1102972486641669,0.2233106338625896,130391.51178770026,2987.094269717379,133378.60605741764,1850,0,338.3333333333333,32,4,20,34.69114435241274,0.6331380208333333,44.66540404040404,1021.3383838383841,31.916824494949502,0
2373,4,0,0,34,0.0,0.0,1.0,34,800,700,100,0.875,9,7,2,396.8261877325427,0.41861631016042783,0.09617043298257721,0.22667937293418292,130362.29663425019,3546.2346394856727,133908.53127373586,1851,1,302.38235294117646,31,3,20,34.56280016150283,0.6354166666666667,44.694010416666664,1021.223958333333,32.94270833333332,0
2374,4,0,0,34,0.0,0.0,1.0,34,750,500,250,0.6666666666666666,10,5,5,395.22404554303034,0.4185049019607843,0.10122055449760858,0.22634509936719807,130462.0446099174,3512.3474121093564,133974.39202202676,1852,2,303.38235294117646,31,3,20,34.50218795139774,0.6364247311827957,44.59635416666666,1021.6145833333322,32.95530913978491,0
2375,4,0,0,34,0.0,0.0,1.0,34,800,400,400,0.5,12,4,8,393.5278184627702,0.417929292929293,0.10218986307735012,0.22595463402445362,130561.83073255747,3475.942484537756,134037.77321709524,1853,3,304.38235294117646,31,3,19,34.444010914341526,0.6374327956989247,44.498697916666664,1022.005208333333,32.96790994623655,0
2376,4,0,0,34,0.0,0.0,1.0,34,700,600,100,0.8571428571428571,8,6,2,396.7203763771392,0.41802213309566255,0.0954870995774777,0.2283759820610919,130661.65500217001,3567.2281901041483,134228.88319227417,1854,4,305.38235294117646,31,3,19,34.260910171506204,0.6384408602150538,44.40104166666666,1022.3958333333322,32.98051075268814,0
2377,4,0,0,34,0.0,0.0,1.0,34,900,800,100,0.8888888888888888,10,8,2,397.7964545079093,0.4182078134284017,0.09413712008867736,0.22939011407526558,130728.2257080077,3600.6449381510292,134328.87064615873,1855,5,306.38235294117646,31,3,19,34.16571173924116,0.6391129032258065,44.33593749999999,1022.6562499999991,32.98891129032255,0
2378,4,0,0,34,0.0,0.0,1.0,34,550,300,250,0.5454545454545454,8,3,5,395.82859441962273,0.4178921568627451,0.09070655633354563,0.2284521388072105,130761.5174187553,3551.8295288085756,134313.34694756387,1856,6,307.38235294117646,31,3,19,34.182182261828984,0.6394489247311828,44.30338541666666,1022.7864583333323,32.993111559139756,0
2379,4,0,1,33,0.0,0.029411764705882353,0.9705882352941176,34,950,800,150,0.8421052631578947,11,8,3,394.2840368945222,0.4176693404634581,0.06728723404255299,0.21058351970502914,127702.62458087652,3325.5682871264394,131028.19286800297,1857,7,308.38235294117646,30,4,21,37.34873670212765,0.6111111111111112,47.311827956989255,1010.7526881720439,33.69175627240146,8
2380,4,0,0,33,0.0,0.0,1.0,33,900,400,500,0.4444444444444444,14,4,10,398.19206919474203,0.41489109848484845,0.07934704664297842,0.21302992492765654,127770.56054168119,3575.4447768528253,131346.005318534,1858,8,318.1515151515151,30,3,21,37.18010502525924,0.6118055555555555,47.24462365591398,1011.0215053763446,33.700716845878155,0
2381,4,1,0,34,0.029411764705882353,0.0,1.0,34,850,700,150,0.8235294117647058,10,7,3,385.95065115412643,0.41807783719548425,0.0749213265553137,0.20841335162322808,128144.53124999988,3092.586028731631,131237.11727873152,1859,0,309.7647058823529,29,5,22,37.10562414266119,0.6185344827586207,46.87499999999999,1012.4999999999991,34.91379310344824,0
2382,4,0,0,34,0.0,0.0,1.0,34,850,600,250,0.7058823529411765,11,6,5,383.26891648344787,0.4167966428995841,0.07929966612364692,0.20769416618352673,128285.19483024691,3033.5455246913502,131318.74035493826,1860,1,310.7647058823529,29,5,22,37.02929348322821,0.6199712643678161,46.73611111111111,1013.0555555555555,34.93295019157088,0
2383,4,0,0,34,0.0,0.0,1.0,34,1300,1100,200,0.8461538461538461,15,11,4,382.1984288434902,0.41722370766488415,0.08015673374612975,0.207479147086466,128355.55555555545,3011.4583333333153,131367.01388888876,1861,2,311.7647058823529,29,5,23,36.98430646929824,0.6206896551724138,46.66666666666666,1013.3333333333325,34.94252873563215,0
2384,4,1,1,34,0.02857142857142857,0.02857142857142857,0.9714285714285714,35,950,600,350,0.631578947368421,13,6,7,371.4749415711126,0.4204481792717087,0.07545642015248721,0.2037042326654661,128757.66210327763,2566.0490013296107,131323.71110460724,1862,0,303.8285714285714,30,5,18,36.84473358937006,0.621875,46.27016129032257,1014.919354838708,33.83064516129027,0
2385,4,0,0,34,0.0,0.0,1.0,34,950,600,350,0.631578947368421,13,6,7,382.52382226306406,0.41649955436720143,0.07174151150054797,0.209128293249208,128637.19135802465,3041.3580246913502,131678.549382716,1863,1,313.6764705882353,29,5,18,36.68765972982841,0.6235632183908046,46.388888888888886,1014.4444444444441,34.98084291187738,0
2386,4,0,0,34,0.0,0.0,1.0,34,1050,700,350,0.6666666666666666,14,7,7,378.53111914603335,0.4156268568033274,0.06259055346276443,0.2076805869909318,128778.125,2949.305555555556,131727.43055555556,1864,2,314.6764705882353,29,5,19,36.64477285166939,0.625,46.25,1015.0,35.0,0
2387,4,0,0,34,0.0,0.0,1.0,34,800,300,500,0.375,13,3,10,380.4182140651086,0.4162396019013666,0.06454447402759045,0.20937767477020325,128903.70898776577,3007.4637518988625,131911.17273966465,1865,3,315.6764705882353,31,3,19,36.46848420737702,0.6206317204301075,46.12630208333333,1015.4947916666661,32.75789650537632,0
2388,4,0,0,34,0.0,0.0,1.0,34,950,700,250,0.7368421052631579,12,7,5,384.0057191611189,0.41610962566844917,0.06635640803406617,0.21241421956431814,129102.12410820836,3115.1908026800975,132217.31491088847,1866,4,316.6764705882353,31,3,20,36.17459427717276,0.6226478494623655,45.93098958333332,1016.276041666665,32.78309811827952,0
2389,4,0,0,34,0.0,0.0,1.0,34,800,600,200,0.75,10,6,4,380.7150979241814,0.4158125371360666,0.07175848528439843,0.2113066555976838,129235.55333347771,3040.4234155007907,132275.97674897852,1867,5,317.6764705882353,30,4,21,36.12194315928618,0.6267361111111112,45.79973118279569,1016.801075268816,33.8933691756272,0
2390,4,0,0,34,0.0,0.0,1.0,34,1050,800,250,0.7619047619047619,13,8,5,379.1361663113881,0.4157382650029709,0.06888852071362406,0.21077812064471518,129300.69181654172,3004.5137193467654,132305.20553588847,1868,6,318.6764705882353,31,3,21,36.09559702129475,0.6246639784946236,45.73567708333332,1017.0572916666653,32.80829973118275,0
2391,4,0,0,34,0.0,0.0,1.0,34,900,600,300,0.6666666666666666,12,6,6,377.4741259825527,0.41597964943553184,0.0683063399361794,0.21073841204854504,129466.28146701376,2974.034288194427,132440.3157552082,1869,7,319.6764705882353,31,3,16,35.96895257591264,0.6263440860215054,45.57291666666666,1017.7083333333322,32.82930107526878,0
2392,4,0,0,34,0.0,0.0,1.0,34,650,300,350,0.46153846153846156,10,3,7,377.82850713954014,0.41590537730243615,0.06918910786821164,0.21164892018848147,129598.82948133671,2993.226453993046,132592.05593532976,1870,8,320.6764705882353,31,3,17,35.82480818414323,0.6276881720430108,45.44270833333333,1018.2291666666658,32.84610215053761,0
2393,4,0,1,33,0.0,0.029411764705882353,0.9705882352941176,34,750,500,250,0.6666666666666666,10,5,5,376.9765188111787,0.415701128936423,0.07730974276454838,0.21170763149029778,129698.28499688033,2978.6415947808064,132676.92659166115,1871,9,321.6764705882353,31,3,17,35.74515850696666,0.6286962365591398,45.34505208333333,1018.6197916666658,32.85870295698922,0
2394,4,0,0,33,0.0,0.0,1.0,33,900,500,400,0.5555555555555556,13,5,8,376.68064720045123,0.4124842171717172,0.056363326675028746,0.21243920074100373,129864.12896050341,3183.4608289930516,133047.58978949647,1872,10,298.1818181818182,31,2,19,35.583801737353085,0.6303763440860215,45.182291666666664,1019.2708333333328,32.87970430107525,0
2395,4,0,0,33,0.0,0.0,1.0,33,950,700,250,0.7368421052631579,12,7,5,377.2887786275728,0.4124447601010101,0.05504856999109853,0.21314366065323917,129930.49621582031,3204.2636447482646,133134.75986056856,1873,11,299.1818181818182,31,2,20,35.50074499787142,0.6310483870967742,45.1171875,1019.53125,32.88810483870968,0
2396,4,0,0,33,0.0,0.0,1.0,33,1000,800,200,0.8,12,8,4,378.3739815884742,0.41157670454545453,0.05563936531513769,0.21448493283387168,130063.28158908414,3242.5123426649266,133305.79393174907,1874,12,300.1818181818182,31,2,20,35.33794996170539,0.6323924731182795,44.986979166666664,1020.0520833333328,32.904905913978475,0
2397,4,1,0,34,0.029411764705882353,0.0,1.0,34,800,500,300,0.625,11,5,6,367.99902846520024,0.41549688057041,0.06154885972179813,0.21124710187215115,130552.7576905418,2808.6575987144183,133361.41528925623,1875,0,292.3235294117647,32,2,17,35.105479367432665,0.634765625,44.50757575757576,1021.969696969697,31.93655303030303,0
2398,4,1,0,35,0.02857142857142857,0.0,1.0,35,900,600,300,0.6666666666666666,12,6,6,359.49587865709555,0.4182072829131653,0.06609195402298873,0.2085076096211153,130951.55709342558,2415.3090157631673,133366.86610918876,1876,0,284.9428571428571,33,2,19,34.91878192848021,0.6363636363636364,44.11764705882353,1023.5294117647057,31.01604278074866,0
2399,4,0,0,35,0.0,0.0,1.0,35,900,700,200,0.7777777777777778,11,7,4,359.90339880121576,0.4173669467787115,0.06915133693496567,0.20942568247792184,131077.01965590153,2435.0129757785407,133512.03263168008,1877,1,285.9428571428571,33,2,19,34.78139460666985,0.6376262626262627,43.995098039215684,1024.019607843137,31.030897207367786,0
2400,4,0,0,35,0.0,0.0,1.0,35,1450,1100,350,0.7586206896551724,18,11,7,352.27489442503173,0.4176470588235294,0.04473657183937574,0.2033254681100495,130763.47588667825,2212.9379325259574,132976.4138192042,1878,2,286.9428571428571,33,2,18,35.29385334291876,0.634469696969697,44.3014705882353,1022.7941176470592,30.993761140819977,8
2401,4,0,2,33,0.0,0.05714285714285714,0.9428571428571428,35,1350,800,550,0.5925925925925926,19,8,11,354.72746526017687,0.4184873949579832,0.04636570470602308,0.20557453590477032,130920.20083922062,2288.198199010012,133208.39903823062,1879,3,287.9428571428571,33,2,18,35.07252125493954,0.6360479797979798,44.1482843137255,1023.406862745099,31.01232917409391,0
2402,4,0,0,33,0.0,0.0,1.0,33,750,600,150,0.8,9,6,3,362.5475276990927,0.4159564393939394,0.05799310469969132,0.20993563497138878,130888.84833958105,2890.6856737793332,133779.5340133604,1880,4,299.8181818181818,33,0,18,34.904191616766475,0.6357323232323233,44.17892156862746,1023.2843137254912,31.008615567439126,0
2403,4,0,1,32,0.0,0.030303030303030304,0.9696969696969697,33,950,700,250,0.7368421052631579,12,7,5,364.5833281080258,0.4153645833333333,0.05106494128402428,0.21163061429370003,130982.91710219647,2950.837568483304,133933.75467067977,1881,5,300.8181818181818,33,0,18,34.756848836745284,0.6366792929292929,44.08700980392158,1023.6519607843153,31.019756387403493,0
2404,4,0,0,32,0.0,0.0,1.0,32,1200,900,300,0.75,15,9,6,377.89347936038456,0.41202536962365593,0.05076727328809372,0.21892971052293897,130907.84940631059,3493.844537547192,134401.69394385777,1882,6,310.25,32,0,19,34.49234011926794,0.6383463541666667,44.160353535353536,1023.3585858585859,31.97995580808081,0
2405,4,0,0,32,0.0,0.0,1.0,32,950,600,350,0.631578947368421,13,6,7,379.00984708409817,0.41087029569892475,0.052401948692649025,0.22012978797692476,131004.77629833695,3530.420046423839,134535.1963447608,1883,7,311.25,32,0,19,34.36549292879461,0.6393229166666667,44.06565656565657,1023.7373737373741,31.99179292929294,0
2406,4,0,0,32,0.0,0.0,1.0,32,900,500,400,0.5555555555555556,13,5,8,378.36505637057536,0.41166834677419356,0.05593565088757391,0.22049549836768004,131134.06795224975,3523.3098025711633,134657.37775482092,1884,8,312.25,32,0,19,34.250955374753445,0.640625,43.93939393939394,1024.242424242424,32.00757575757575,0
2407,4,0,1,31,0.0,0.03125,0.96875,32,950,600,350,0.631578947368421,13,6,7,376.6161793898476,0.41189936155913975,0.06112523105360457,0.22003169875799952,131231.07854109272,3484.7494834710737,134715.8280245638,1885,9,313.25,32,0,19,34.19747381392482,0.6416015625,43.84469696969697,1024.621212121212,32.019412878787875,0
2408,4,0,0,31,0.0,0.0,1.0,31,700,500,200,0.7142857142857143,9,5,4,387.1140872259729,0.40676523297491035,0.06404041895294599,0.22555847482366664,131128.0059814452,3952.2996690538057,135080.305650499,1886,10,324.03225806451616,31,0,19,34.03307483685058,0.6431451612903225,43.94531249999999,1024.218749999999,33.039314516129004,0
2409,4,2,1,32,0.06060606060606061,0.030303030303030304,0.9696969696969697,33,800,500,300,0.625,11,5,6,365.3280169133044,0.41508838383838387,0.05201194083250438,0.21634975276926985,131749.07415378516,3026.4781860438584,134775.552339829,1887,0,305.3333333333333,32,1,17,33.963124666912655,0.6468098958333333,43.33964646464646,1026.641414141413,32.082544191919155,0
2410,4,0,0,32,0.0,0.0,1.0,32,900,400,500,0.4444444444444444,14,4,10,369.82465949056876,0.4103242607526882,0.05652270421106054,0.21889621737414722,131728.82080078102,3343.3132595485836,135072.1340603296,1888,1,315.875,31,1,18,33.86817182479284,0.6491935483870968,43.359374999999986,1026.5624999999982,33.11491935483865,0
2411,4,0,0,32,0.0,0.0,1.0,32,900,600,300,0.6666666666666666,12,6,6,369.58693633280774,0.40958921370967744,0.054904431342716054,0.21933274393204294,131829.09011840797,3344.4619072807905,135173.55202568875,1889,2,316.875,31,1,18,33.77300726934618,0.6502016129032258,43.261718749999986,1026.9531249999982,33.12752016129026,0
2412,4,0,0,32,0.0,0.0,1.0,32,1100,700,400,0.6363636363636364,15,7,8,365.94259566982856,0.40891717069892475,0.04852442656190603,0.21793607716457475,131962.84188164593,3258.164978027326,135221.00685967325,1890,3,317.875,31,1,20,33.73159823427533,0.6515456989247312,43.13151041666666,1027.4739583333323,33.14432123655911,0
2413,4,0,0,32,0.0,0.0,1.0,32,650,400,250,0.6153846153846154,9,4,5,364.82827409977233,0.409148185483871,0.04513712946541637,0.21784829014701979,132063.20020887576,3236.0778808593577,135299.2780897351,1891,4,318.875,31,1,21,33.659002618022114,0.6525537634408602,43.03385416666666,1027.8645833333323,33.156922043010724,0
2414,4,1,0,33,0.030303030303030304,0.0,1.0,33,700,400,300,0.5714285714285714,10,4,6,354.0257436095572,0.411300505050505,0.04770134808157622,0.21364706792366514,132462.98408644507,2779.061288388914,135242.04537483398,1892,0,310.1818181818182,32,1,22,33.53417964757349,0.6539713541666667,42.64520202020201,1029.4191919191903,32.1693497474747,0
2415,4,0,0,33,0.0,0.0,1.0,33,1000,700,300,0.7,13,7,6,354.1281899854936,0.41114267676767674,0.0455938910874536,0.21407823493934003,132527.980642919,2786.3787815018723,135314.35942442087,1893,1,311.1818181818182,32,1,22,33.46617617003885,0.6546223958333333,42.5820707070707,1029.6717171717162,32.17724116161613,0
2416,4,0,0,33,0.0,0.0,1.0,33,650,400,250,0.6153846153846154,9,4,5,351.2654733344647,0.4108664772727273,0.0428528451570489,0.21308364289486223,132658.02158261908,2719.636548566465,135377.65813118554,1894,2,312.1818181818182,32,1,17,33.40916983290433,0.6559244791666667,42.455808080808076,1030.1767676767674,32.19302398989898,0
2417,4,0,0,33,0.0,0.0,1.0,33,850,500,350,0.5882352941176471,12,5,7,350.11624134948124,0.41062973484848486,0.040819964349376514,0.2125705751050419,132690.54178145068,2691.42275022955,135381.96453168022,1895,3,313.1818181818182,32,1,17,33.40609681372549,0.65625,42.424242424242415,1030.303030303029,32.19696969696965,0
2418,4,0,0,33,0.0,0.0,1.0,33,650,400,250,0.6153846153846154,9,4,5,349.2843697406267,0.4103535353535353,0.03878758173575014,0.2122494222973382,132723.06596584522,2671.6184891847643,135394.68445503,1896,4,314.1818181818182,32,1,17,33.394855614099576,0.6565755208333333,42.39267676767676,1030.4292929292922,32.20091540404038,0
2419,4,0,1,32,0.0,0.030303030303030304,0.9696969696969697,33,750,500,250,0.6666666666666666,10,5,5,350.2060619616225,0.4105113636363636,0.038644437762409334,0.2131791263081821,132788.12629132217,2700.641356749294,135488.76764807146,1897,5,315.1818181818182,32,1,17,33.30576993752297,0.6572265625,42.329545454545446,1030.681818181817,32.208806818181785,0
2420,4,0,0,32,0.0,0.0,1.0,32,700,400,300,0.5714285714285714,10,4,6,361.986747362793,0.40727906586021506,0.04276087093919867,0.21943886271165183,132632.61795043945,3202.249993218317,135834.86794365777,1898,11,325.875,31,1,17,33.158603000042135,0.658266129032258,42.48046875,1030.078125,33.228326612903224,0
2421,4,0,0,32,0.0,0.0,1.0,32,650,300,350,0.46153846153846156,10,3,7,364.4357204515701,0.40727906586021506,0.04716526601794557,0.22131848472243104,132699.6888054743,3272.1013387044454,135971.79014417873,1899,12,326.875,31,1,17,33.02806036480055,0.6589381720430108,42.41536458333334,1030.3385416666677,33.23672715053767,0
2422,4,0,0,32,0.0,0.0,1.0,32,550,400,150,0.7272727272727273,7,4,3,363.2864633987848,0.4070480510752688,0.04454585649317866,0.22121351109729095,132800.32687717024,3248.9122178819634,136049.2390950522,1900,13,327.875,31,1,18,32.956459491325596,0.6599462365591398,42.31770833333334,1030.7291666666677,33.249327956989276,0
2423,4,0,1,31,0.0,0.03125,0.96875,32,1100,800,300,0.7272727272727273,14,8,6,365.95170389275677,0.4060819892473118,0.04809604216639274,0.22383810397950032,132968.14176771385,3331.9836086697146,136300.12537638357,1901,14,328.875,31,1,18,32.71906430164542,0.6616263440860215,42.15494791666667,1031.3802083333342,33.27032930107529,0
2424,4,0,0,31,0.0,0.0,1.0,31,1050,800,250,0.7619047619047619,13,8,5,373.14559738802154,0.40425627240143375,0.033105246008471756,0.22803342062601326,132934.57031250012,3720.78993055557,136655.36024305568,1902,15,303.4516129032258,31,0,18,32.56734006734007,0.6612903225806452,42.18750000000001,1031.250000000001,33.26612903225809,0
2425,4,0,1,30,0.0,0.03225806451612903,0.967741935483871,31,950,600,350,0.631578947368421,13,6,7,373.03143110432495,0.4027329749103943,0.03100421748546678,0.22878491177017587,133068.8815646702,3727.7750651041765,136796.6566297744,1903,16,304.4516129032258,31,0,18,32.43521790341577,0.6626344086021505,42.05729166666667,1031.770833333334,33.2829301075269,0
2426,4,0,0,30,0.0,0.0,1.0,30,700,400,300,0.5714285714285714,10,4,6,393.03276333049337,0.3973659003831418,0.06636588818117484,0.2127798063547845,128246.61810613952,4081.0245404093084,132327.64264654883,1904,28,315.06666666666666,30,0,18,36.82158970276009,0.6166666666666667,46.7741935483871,1012.9032258064523,33.76344086021508,8
2427,4,1,0,31,0.03225806451612903,0.0,1.0,31,650,500,150,0.7692307692307693,8,5,3,381.7560425070437,0.4012096774193548,0.0601521192774126,0.208720093134904,128639.3928527834,3621.7731051975115,132261.1659579809,1905,0,305.8709677419355,31,0,18,36.70487849227742,0.6179435483870968,46.386718750000014,1014.4531250000016,32.72429435483876,0
2428,4,1,0,32,0.03125,0.0,1.0,32,550,200,350,0.36363636363636365,9,2,7,372.33060039499304,0.40633400537634407,0.059741732968672245,0.20513885956009076,128944.78242016125,3202.017651260081,132146.80007142134,1906,0,297.28125,32,0,19,36.63185811370794,0.6184895833333333,46.08585858585859,1015.656565656566,31.73926767676769,0
2429,4,0,0,32,0.0,0.0,1.0,32,900,600,300,0.6666666666666666,12,6,6,374.03653377943084,0.40646001344086025,0.05791811630218713,0.20674766647368564,129073.05377002365,3255.6075272931616,132328.6612973168,1907,1,298.28125,32,0,19,36.457556742876086,0.6197916666666667,45.95959595959597,1016.1616161616175,31.755050505050548,0
2430,4,0,0,32,0.0,0.0,1.0,32,600,500,100,0.8333333333333334,7,5,2,373.3436280863944,0.4060609879032258,0.05419539694371989,0.20653215549604037,129105.1315713958,3240.11564508724,132345.24721648305,1908,2,299.28125,32,0,19,36.442415206858,0.6201171875,45.928030303030305,1016.287878787879,31.758996212121218,0
2431,4,4,1,35,0.1111111111111111,0.027777777777777776,0.9722222222222222,36,850,600,250,0.7058823529411765,11,6,5,360.47963129451296,0.41760912698412694,0.09661283770058882,0.19523005774069171,128261.74554183817,2159.637870001928,130421.3834118401,1909,0,266.9166666666667,35,1,23,37.63044637416209,0.6047619047619048,46.75925925925926,1012.9629629629633,28.94179894179895,8
2432,4,0,0,35,0.0,0.0,1.0,35,1200,1000,200,0.8333333333333334,14,10,4,365.3884863811749,0.4136904761904762,0.10986118804236611,0.19820404127407126,128325.3985969387,2377.724631519272,130703.12322845797,1910,1,275.45714285714286,34,1,24,37.441007715505435,0.6075367647058824,46.69642857142857,1013.2142857142851,29.80042016806721,0
2433,4,0,0,35,0.0,0.0,1.0,35,950,800,150,0.8421052631578947,11,8,3,365.42644130886436,0.4140056022408964,0.1068139097744365,0.19837435385338353,128355.55555555552,2380.9027777777746,130736.4583333333,1911,2,276.45714285714286,34,1,24,37.40919682017543,0.607843137254902,46.666666666666664,1013.333333333333,29.80392156862744,0
2434,4,0,0,35,0.0,0.0,1.0,35,950,600,350,0.631578947368421,13,6,7,362.08943266593076,0.41362044817927174,0.10661701806471058,0.19730746628379597,128506.39349489781,2306.1614229024735,130812.55491780028,1912,3,277.45714285714286,34,1,20,37.33953661304839,0.609375,46.51785714285713,1013.9285714285703,29.821428571428537,0
2435,4,0,0,35,0.0,0.0,1.0,35,950,600,350,0.631578947368421,13,6,7,363.90978006811093,0.4135854341736695,0.1050122372347213,0.1990525767484233,128657.32001133761,2363.931405895667,131021.25141723327,1913,4,278.45714285714286,34,1,20,37.13916920910587,0.610906862745098,46.369047619047606,1014.5238095238074,29.838935574229627,0
2436,4,0,0,35,0.0,0.0,1.0,35,1150,900,250,0.782608695652174,14,9,5,361.23284630081935,0.41372549019607846,0.1088333305423923,0.1989462499543116,128929.21095521524,2314.6931689342236,131243.90412414947,1914,5,279.45714285714286,34,1,21,36.92953151252296,0.6136642156862745,46.10119047619047,1015.5952380952367,29.87044817927167,0
2437,4,0,0,35,0.0,0.0,1.0,35,700,400,300,0.5714285714285714,10,4,6,355.89209303900833,0.4134803921568628,0.1459118648639539,0.1877851554428739,127212.08191609972,2076.867205215413,129288.94912131513,1915,6,280.45714285714286,34,1,20,38.82193572496264,0.5962009803921569,47.797619047619044,1008.8095238095234,29.670868347338924,8
2438,4,2,0,37,0.05405405405405406,0.0,1.0,37,1100,800,300,0.7272727272727273,14,8,6,344.0783516198578,0.420482982982983,0.15423214844408029,0.18488037744933042,127945.0734518303,1404.6259942374882,129349.6994460678,1916,0,266.2432432432432,36,1,22,38.36936962006528,0.599537037037037,47.072072072072075,1011.7117117117125,28.103103103103123,0
2439,4,1,1,37,0.02631578947368421,0.02631578947368421,0.9736842105263158,38,900,600,300,0.6666666666666666,12,6,6,340.7414467072893,0.4220898530109056,0.17170739483932707,0.1852831725507165,128422.23087873182,1151.7553477993151,129573.98622653114,1917,0,260.2105263157895,37,1,19,37.96651882302034,0.6024774774774775,46.60087719298245,1013.5964912280695,27.394499762920795,0
2440,4,1,0,38,0.02631578947368421,0.0,1.0,38,1250,700,550,0.56,18,7,11,338.45154127100096,0.42330488383119963,0.1713058321479377,0.18480972590063494,128588.99493113253,1104.2287049861397,129693.22363611867,1918,0,252.39473684210526,37,1,20,37.85450450450451,0.6041666666666667,46.436403508771924,1014.2543859649113,27.41228070175436,0
2441,4,0,0,38,0.0,0.0,1.0,38,1000,800,200,0.8,12,8,4,341.12989868370266,0.42228247984826933,0.18059939150956827,0.18692464252916896,128728.04763244448,1182.597169321314,129910.64480176578,1919,1,253.39473684210526,37,1,20,37.64485413290112,0.6055743243243243,46.29934210526315,1014.8026315789464,27.427098150782335,0
2442,4,1,0,39,0.02564102564102564,0.0,1.0,39,1000,700,300,0.7,13,7,6,337.2241662605953,0.4244264507422402,0.19456541876470768,0.18713822224622947,129229.25954380163,916.7145179285567,130145.97406173019,1920,0,247.87179487179486,37,2,22,37.233882418490964,0.6106418918918919,45.80592105263156,1016.7763157894711,27.480440967283005,0
2443,4,0,1,38,0.0,0.02564102564102564,0.9743589743589743,39,850,500,350,0.5882352941176471,12,5,7,337.7669153813183,0.4243983355825461,0.19592784573916733,0.18770450210675382,129285.00987082535,933.6397978223745,130218.64966864772,1921,1,248.87179487179486,37,2,23,37.16340970350402,0.611204954954955,45.751096491228054,1016.9956140350854,27.486367946894198,0
2444,4,0,0,38,0.0,0.0,1.0,38,650,500,150,0.7692307692307693,8,5,3,340.6064724144784,0.4243569227121859,0.18521292157422709,0.18929335706924016,129287.27027280646,1207.2162111435662,130494.48648395002,1922,2,244.28947368421052,36,2,23,37.08891595615105,0.6131365740740741,45.74887387387387,1017.0045045045034,28.250125125125095,0
2445,4,1,0,39,0.02564102564102564,0.0,1.0,39,1000,600,400,0.6,14,6,8,332.42847825529157,0.42676000899685107,0.18617789722605682,0.18626548067320275,129609.02829141993,817.1464086127398,130426.17470003267,1923,0,239.0,38,1,16,36.97015003672228,0.6126644736842105,45.4326923076923,1018.2692307692292,26.7965587044534,0
2446,4,0,1,38,0.0,0.02564102564102564,0.9743589743589743,39,1400,1100,300,0.7857142857142857,17,11,6,335.06285612134593,0.42571974808816915,0.19147952159697157,0.18839383230973783,129745.05077069173,894.549455767396,130639.60022645912,1924,1,240.0,38,1,17,36.765065715883665,0.6140350877192983,45.299145299145295,1018.8034188034183,26.81061628430048,0
2447,4,0,0,38,0.0,0.0,1.0,38,950,800,150,0.8421052631578947,11,8,3,342.00785362456713,0.4252904220009483,0.19058976828508278,0.19209510037316982,129703.52055440134,1271.9245344721435,130975.44508887349,1925,2,247.1578947368421,37,1,19,36.63033728022964,0.615427927927928,45.33991228070175,1018.6403508771929,27.530820293978184,0
2448,4,0,0,38,0.0,0.0,1.0,38,1000,800,200,0.8,12,8,4,346.2688965846172,0.42440137505926984,0.19622474861853378,0.19532255234530346,129871.11418898121,1394.0654816866684,131265.1796706679,1926,3,248.1578947368421,37,1,20,36.35165662650602,0.6171171171171171,45.175438596491226,1019.2982456140351,27.54860123281176,0
2449,4,0,0,38,0.0,0.0,1.0,38,1700,1600,100,0.9411764705882353,18,16,2,347.5344484907408,0.424268018018018,0.19870500178210704,0.19702090032354425,130066.77685682132,1440.5371123807286,131507.31396920205,1927,4,249.1578947368421,37,1,21,36.12085259235371,0.6190878378378378,44.983552631578945,1020.0657894736842,27.569345661450924,0
2450,4,0,0,38,0.0,0.0,1.0,38,1000,600,400,0.6,14,6,8,347.53587432508033,0.42392721669037453,0.19641806580078702,0.19716303504393595,130094.74068944292,1442.5178901200343,131537.25857956294,1928,5,250.1578947368421,37,1,22,36.09245127543708,0.6193693693693694,44.95614035087719,1020.1754385964914,27.572309151256526,0
2451,4,1,1,38,0.02564102564102564,0.02564102564102564,0.9743589743589743,39,950,600,350,0.631578947368421,13,6,7,343.62674042987885,0.4246513720197931,0.21269876243986663,0.19753641056884177,130607.69120049107,1176.2754532017682,131783.96665369283,1929,0,244.71794871794873,36,3,16,35.6725790459403,0.6264467592592593,44.45382882882883,1022.184684684685,28.394019019019026,0
2452,4,0,0,38,0.0,0.0,1.0,38,1000,600,400,0.6,14,6,8,355.5077985871378,0.4208007349454718,0.21586216758924404,0.20457331497851375,130646.86381440742,1689.1957893947038,132336.05960380213,1930,1,251.6315789473684,35,3,17,35.329281293633734,0.6288690476190476,44.41550925925925,1022.3379629629617,29.209656084656046,0
2453,4,0,0,38,0.0,0.0,1.0,38,1200,800,400,0.6666666666666666,16,8,8,353.50780676731415,0.4198820531057373,0.21526905282212172,0.20435941818288345,130824.41332572432,1649.490285279471,132473.9036110038,1931,2,252.6315789473684,35,3,17,35.20064958328618,0.6306547619047619,44.24189814814814,1023.0324074074064,29.229497354497326,0
2454,4,0,0,38,0.0,0.0,1.0,38,400,200,200,0.5,6,2,4,355.46364734546813,0.41968942626837363,0.21909978566325372,0.20564781691976006,130854.01663237285,1702.7692043895424,132556.7858367624,1932,3,253.6315789473684,35,3,17,35.12066365007542,0.6309523809523809,44.21296296296295,1023.148148148146,29.23280423280417,0
2455,4,0,1,37,0.0,0.02631578947368421,0.9736842105263158,38,1150,800,350,0.6956521739130435,15,8,7,355.0878320985531,0.4199709577999052,0.21735752683371157,0.2055881809812249,130883.62328800138,1695.036410108011,132578.6596981094,1933,4,254.6315789473684,35,3,17,35.10031387852054,0.63125,44.18402777777777,1023.2638888888877,29.236111111111075,0
2456,4,0,0,37,0.0,0.0,1.0,37,1050,600,450,0.5714285714285714,15,6,9,360.7052681913569,0.4170733233233233,0.21533575460277055,0.20877183704408833,130870.93431122445,2041.1670918367308,132912.10140306118,1934,5,262.2432432432432,34,3,18,34.9694589877836,0.6332720588235294,44.19642857142857,1023.2142857142853,30.09453781512604,0
2457,4,0,0,37,0.0,0.0,1.0,37,1400,1000,400,0.7142857142857143,18,10,8,358.03136830719313,0.41660410410410414,0.20719673161533625,0.20804525455688253,131023.24263038553,1982.0861678004599,133005.328798186,1935,6,263.2432432432432,34,3,18,34.88372093023256,0.6348039215686274,44.04761904761905,1023.8095238095241,30.112044817927178,0
2458,4,1,0,38,0.02631578947368421,0.0,1.0,38,1200,1100,100,0.9166666666666666,13,11,2,352.1912293468406,0.41928935514461835,0.21072183593415894,0.2069423771892009,131450.17715419494,1659.4742063492033,133109.65136054414,1936,0,257.2894736842105,34,4,19,34.60185937620927,0.639093137254902,43.63095238095238,1025.4761904761901,30.1610644257703,0
2459,4,0,0,38,0.0,0.0,1.0,38,800,700,100,0.875,9,7,2,351.91189503840326,0.4189337363679469,0.21274373259052926,0.2071088038012896,131511.2244897958,1656.0728458049703,133167.29733560077,1937,1,258.2894736842105,34,4,20,34.547402120086645,0.6397058823529411,43.57142857142856,1025.7142857142846,30.168067226890724,0
2460,4,0,0,38,0.0,0.0,1.0,38,1300,1000,300,0.7692307692307693,16,10,6,352.1610574622026,0.4185781175912755,0.20854851115262063,0.20825326731406768,131694.45153061207,1675.531462585011,133369.98299319707,1938,2,259.2894736842105,34,4,19,34.35615286476455,0.6415441176470589,43.39285714285713,1026.42857142857,30.18907563025206,0
2461,4,0,0,38,0.0,0.0,1.0,38,950,500,450,0.5263157894736842,14,5,9,350.2672217118521,0.41863738738738737,0.20340585988504767,0.2077995223168112,131816.67375283438,1634.2120181405785,133450.88577097497,1939,3,260.2894736842105,34,4,19,34.28153257593321,0.6427696078431373,43.27380952380952,1026.9047619047612,30.203081232492977,0
2462,4,0,0,38,0.0,0.0,1.0,38,1350,900,450,0.6666666666666666,18,9,9,350.1958325333091,0.4184595779990517,0.20467158626578041,0.2084268989491349,131938.95266439897,1640.8942743764035,133579.84693877536,1940,4,261.2894736842105,34,4,19,34.16014870606413,0.6439950980392157,43.1547619047619,1027.3809523809514,30.217086834733863,0
2463,4,0,0,38,0.0,0.0,1.0,38,1400,1000,400,0.7142857142857143,18,10,8,351.4500613405603,0.417066737790422,0.21163867979154594,0.21001877367998184,132091.8810232426,1684.7399376417216,133776.62096088432,1941,5,262.2894736842105,34,4,20,33.97389500096507,0.6455269607843137,43.00595238095238,1027.9761904761904,30.234593837535012,0
2464,4,0,0,38,0.0,0.0,1.0,38,900,700,200,0.7777777777777778,11,7,4,349.26147064927034,0.4168741109530583,0.207199522306577,0.20921779358310652,132183.68055555547,1633.3333333333294,133817.01388888882,1942,6,263.2894736842105,34,4,20,33.93773635872501,0.6464460784313726,42.916666666666664,1028.3333333333328,30.24509803921567,0
2465,4,0,0,38,0.0,0.0,1.0,38,1350,700,650,0.5185185185185185,20,7,13,347.86522633744846,0.4169333807491702,0.2051656920077971,0.208719135802469,132244.89795918367,1600.6802721088372,133845.57823129251,1943,7,264.2894736842105,34,4,20,33.91203703703702,0.6470588235294117,42.857142857142854,1028.5714285714284,30.25210084033613,0
2466,4,0,0,38,0.0,0.0,1.0,38,950,600,350,0.631578947368421,13,6,7,347.5047719623217,0.4172149122807018,0.19987881887989678,0.20901069896105395,132336.75063775506,1597.5304705215333,133934.2811082766,1944,8,265.2894736842105,34,4,20,33.82891742836207,0.6479779411764706,42.76785714285714,1028.9285714285709,30.26260504201679,0
2467,4,0,0,38,0.0,0.0,1.0,38,1150,800,350,0.6956521739130435,15,8,7,350.05746709913774,0.41685929350403034,0.20817381142227553,0.21123146671362478,132459.27047902488,1673.6713435374043,134132.94182256228,1945,9,266.2894736842105,34,4,20,33.64003893450521,0.649203431372549,42.64880952380952,1029.4047619047615,30.27661064425769,0
2468,4,0,0,38,0.0,0.0,1.0,38,900,700,200,0.7777777777777778,11,7,4,347.54087601061366,0.4163406827880512,0.20751784095541126,0.21039720912301044,132581.84700963716,1615.5222505668935,134197.36926020405,1946,10,267.2894736842105,34,4,20,33.58161869533386,0.6504289215686274,42.529761904761905,1029.8809523809523,30.290616246498598,0
2469,4,0,0,38,0.0,0.0,1.0,38,950,500,450,0.5263157894736842,14,5,9,346.4908738284936,0.4157924371740161,0.2084774626150816,0.21023280626771806,132666.15125868062,1593.5221354166756,134259.6733940973,1947,11,268.2894736842105,35,3,18,33.523972025615116,0.6491071428571429,42.44791666666667,1030.208333333334,29.434523809523828,0
2470,4,0,0,38,0.0,0.0,1.0,38,1300,1000,300,0.7692307692307693,16,10,6,345.8791228343722,0.41534791370317686,0.20866393122775517,0.210028373224528,132695.9622020747,1579.3526020233182,134275.31480409802,1948,12,269.2894736842105,35,3,18,33.50979180708456,0.6494047619047619,42.41898148148148,1030.3240740740737,29.437830687830676,0
2471,4,0,0,38,0.0,0.0,1.0,38,950,600,350,0.631578947368421,13,6,7,345.6248983971684,0.4147700331910858,0.20385208558614476,0.21071053867375614,132845.06715374216,1582.91256751542,134427.97972125758,1949,13,270.2894736842105,35,3,19,33.3666638598855,0.6508928571428572,42.27430555555555,1030.9027777777767,29.454365079365047,0
2472,4,0,0,38,0.0,0.0,1.0,38,1500,1200,300,0.8,18,12,6,345.2848042626629,0.41471076339497387,0.2040389478410891,0.21067102988847947,132874.89819101503,1575.936642661172,134450.8348336762,1950,14,271.2894736842105,35,3,19,33.34549468642418,0.6511904761904762,42.24537037037037,1031.018518518518,29.457671957671945,0
2473,4,0,0,38,0.0,0.0,1.0,38,1400,1100,300,0.7857142857142857,17,11,6,348.87598910831014,0.41336237553342814,0.2078174242513664,0.21457076350813142,133173.39275763018,1692.1998242455288,134865.5925818757,1951,15,272.2894736842105,35,3,19,32.9534835912387,0.6541666666666667,41.95601851851851,1032.175925925925,29.490740740740712,0
2474,4,0,0,38,0.0,0.0,1.0,38,1250,800,450,0.64,17,8,9,350.1690181467252,0.4130215742057847,0.20507721708589433,0.21625589666152317,133326.80389426593,1737.3832024592227,135064.18709672516,1952,16,273.2894736842105,36,2,19,32.76632864464072,0.6536458333333333,41.807432432432435,1032.7702702702707,28.688063063063073,0
2475,4,0,0,38,0.0,0.0,1.0,38,700,500,200,0.7142857142857143,9,5,4,354.26192190899053,0.41278449502133713,0.20778144270758636,0.2194701643156641,133443.13221583058,1854.7640968671233,135297.8963126977,1953,17,274.2894736842105,36,2,19,32.54405086285195,0.6548032407407407,41.69481981981981,1033.2207207207198,28.70057557557555,0
2476,4,0,0,38,0.0,0.0,1.0,38,1350,900,450,0.6666666666666666,18,9,9,353.1396060876079,0.4120880749170223,0.20556724360447665,0.2194773710486028,133561.93636670508,1833.2050897673919,135395.14145647248,1954,18,275.2894736842105,35,3,19,32.4540225058784,0.6580357142857143,41.5798611111111,1033.680555555554,29.533730158730116,0
2477,4,0,0,38,0.0,0.0,1.0,38,1050,800,250,0.7619047619047619,13,8,5,357.9771708186557,0.4112286628733997,0.21309751715606806,0.22320488634087146,133681.60211173265,1970.9923428926543,135652.5944546253,1955,19,276.2894736842105,35,3,20,32.20912609587762,0.6592261904761905,41.46412037037037,1034.1435185185182,29.546957671957664,0
2478,4,0,0,38,0.0,0.0,1.0,38,950,500,450,0.5263157894736842,14,5,9,382.33881426986824,0.41131756756756754,0.23342893373943752,0.2285284891214647,132100.37964034622,2504.2369952417507,134604.61663558797,1956,20,277.2894736842105,35,3,20,33.17148915409442,0.6434523809523809,42.997685185185176,1028.009259259258,29.371693121693085,8
2479,4,0,0,38,0.0,0.0,1.0,38,850,500,350,0.5882352941176471,12,5,7,386.88905856075723,0.41065078236130864,0.23396321416935706,0.23179428761377768,132189.63162562138,2628.5444262259734,134818.17605184735,1957,21,278.2894736842105,35,3,20,32.96438285499907,0.6443452380952381,42.91087962962962,1028.35648148148,29.381613756613714,0
2480,4,0,0,38,0.0,0.0,1.0,38,650,200,450,0.3076923076923077,11,2,9,387.57491902665674,0.41071005215742057,0.23439026845836364,0.232571121228217,132249.14969403695,2651.290696802098,134900.44039083907,1958,22,279.2894736842105,35,3,20,32.886636847830154,0.6449404761904762,42.853009259259245,1028.587962962961,29.388227513227456,0
2481,4,0,0,38,0.0,0.0,1.0,38,1000,800,200,0.8,12,8,4,387.57491902665674,0.41071005215742057,0.23439026845836364,0.232571121228217,132249.14969403695,2651.290696802098,134900.44039083907,1959,23,280.2894736842105,35,3,20,32.886636847830154,0.6449404761904762,42.853009259259245,1028.587962962961,29.388227513227456,0
2482,4,0,0,38,0.0,0.0,1.0,38,700,500,200,0.7142857142857143,9,5,4,389.6801426255916,0.41017662399241345,0.23833402403646953,0.2343881236766919,132338.45191400877,2713.9333633401743,135052.38527734895,1960,24,281.2894736842105,35,3,20,32.7423134608174,0.6458333333333333,42.766203703703695,1028.935185185184,29.398148148148117,0
2483,4,0,0,38,0.0,0.0,1.0,38,950,800,150,0.8421052631578947,11,8,3,388.1765489311745,0.4099691797060218,0.23417826424119048,0.23366809049066145,132368.22601862552,2676.4482328103422,135044.67425143585,1961,25,282.2894736842105,35,3,20,32.750932591009644,0.6461309523809524,42.73726851851851,1029.0509259259247,29.401455026454993,0
2484,4,0,0,38,0.0,0.0,1.0,38,1350,700,650,0.5185185185185185,20,7,13,385.44119740179116,0.40948020388809864,0.22427584248390775,0.23294054973412567,132517.1467764058,2615.5135459533362,135132.66032235915,1962,26,283.2894736842105,35,3,20,32.67105065947241,0.6476190476190475,42.59259259259258,1029.629629629628,29.41798941798937,0
2485,4,0,0,38,0.0,0.0,1.0,38,800,600,200,0.75,10,6,4,387.15895472480406,0.4095839260312944,0.22097631963464925,0.23416405303783672,132546.94097490126,2663.347023962599,135210.28799886385,1963,27,284.2894736842105,35,3,20,32.59677887677494,0.6479166666666667,42.5636574074074,1029.745370370369,29.42129629629626,0
2486,4,0,0,38,0.0,0.0,1.0,38,650,300,350,0.46153846153846156,10,3,7,383.08900391364733,0.4092134898055951,0.21321111768184475,0.23225423261794687,132636.34366426602,2562.3049554183717,135198.6486196844,1964,28,285.2894736842105,35,3,15,32.611423220973776,0.6488095238095238,42.47685185185185,1030.092592592592,29.431216931216913,0
2487,4,0,0,38,0.0,0.0,1.0,38,850,400,450,0.47058823529411764,13,4,9,386.1494758102601,0.40888750592697964,0.2185416371116471,0.234854845123945,132755.5941358024,2652.700617283942,135408.29475308635,1965,29,286.2894736842105,35,3,16,32.412398921832875,0.65,42.36111111111111,1030.555555555555,29.44444444444443,0
2488,4,0,1,37,0.0,0.02631578947368421,0.9736842105263158,38,1400,1100,300,0.7857142857142857,17,11,6,379.67513536026667,0.40899122807017546,0.2432867883995704,0.2163265306122449,130262.5868055555,2291.493055555551,132554.07986111107,1966,30,287.2894736842105,35,3,18,35.10204081632653,0.625,44.791666666666664,1020.8333333333329,29.166666666666654,8
2489,4,0,0,37,0.0,0.0,1.0,37,1400,1000,400,0.7142857142857143,18,10,8,390.8527516018712,0.4095970970970971,0.24510847989514395,0.22321803616783265,130353.74858276627,2789.8242630385266,133143.5728458048,1967,31,288.8918918918919,34,3,19,34.72400326416414,0.6280637254901961,44.70238095238094,1021.1904761904748,30.0350140056022,0
2490,4,0,0,37,0.0,0.0,1.0,37,1050,600,450,0.5714285714285714,15,6,9,389.59389483865033,0.40953453453453453,0.23826623826623883,0.22284770784770772,130414.54081632633,2761.7417800453286,133176.28259637166,1968,32,289.8918918918919,34,3,19,34.69429875679876,0.6286764705882353,44.64285714285713,1021.4285714285699,30.042016806722643,0
2491,4,1,0,38,0.02631578947368421,0.0,1.0,38,1250,1000,250,0.8,15,10,5,386.04927748085765,0.41174727358937885,0.2476255088195385,0.22403017126251334,130972.4633487653,2512.3649691357855,133484.8283179011,1969,0,283.2368421052632,35,3,19,34.21811397557664,0.6321428571428571,44.097222222222214,1023.6111111111102,29.24603174603172,0
2492,4,0,0,38,0.0,0.0,1.0,38,700,400,300,0.5714285714285714,10,4,6,384.64368282163053,0.41174727358937885,0.24802512610640526,0.22390311221090692,131090.96364883392,2484.662208504785,133575.6258573387,1970,1,284.2368421052632,35,3,19,34.1338908981314,0.6333333333333333,43.981481481481474,1024.0740740740732,29.259259259259235,0
2493,4,0,0,38,0.0,0.0,1.0,38,1500,1200,300,0.8,18,12,6,389.20922451779654,0.41085822664770033,0.25216251404519485,0.22743691515881506,131239.16437596426,2615.8986786265177,133855.06305459078,1971,2,285.2368421052632,35,3,19,33.866697729583194,0.6348214285714286,43.83680555555554,1024.6527777777758,29.275793650793595,0
2494,4,0,1,37,0.0,0.02631578947368421,0.9736842105263158,38,550,500,50,0.9090909090909091,6,5,1,390.97098288056094,0.4104285206258891,0.2503209242618749,0.22899728997289967,131328.12499999974,2669.097222222193,133997.22222222193,1972,3,286.2368421052632,35,3,19,33.731368563685635,0.6357142857142857,43.749999999999986,1024.999999999998,29.285714285714228,0
2495,4,0,0,37,0.0,0.0,1.0,37,1100,800,300,0.7272727272727273,14,8,6,396.25884063718706,0.40947197197197194,0.24236431553504745,0.2320944638017808,131328.12499999988,3007.9861111110977,134336.11111111098,1973,4,287.81081081081084,34,3,19,33.59586720867209,0.6378676470588236,43.74999999999999,1024.999999999999,30.147058823529385,0
2496,4,0,0,37,0.0,0.0,1.0,37,1250,900,350,0.72,16,9,7,398.3878198477624,0.40906531531531537,0.2399201709546539,0.2339000880946676,131419.65880102027,3071.198270975041,134490.8570719953,1974,5,288.81081081081084,34,3,19,33.44846936800959,0.6387867647058824,43.66071428571428,1025.3571428571418,30.157563025210052,0
2497,4,1,0,38,0.02631578947368421,0.0,1.0,38,800,700,100,0.875,9,7,2,389.90944741960834,0.4127400426742532,0.23658099471251126,0.23069425544793234,131713.9693313828,2671.3041998885374,134385.27353127135,1975,0,282.1842105263158,35,3,17,33.36774626977863,0.6395833333333334,43.37384259259259,1026.504629629629,29.328703703703688,0
2498,4,0,0,38,0.0,0.0,1.0,38,850,700,150,0.8235294117647058,10,7,3,388.26265183673723,0.4130363916548127,0.23036327714789206,0.23007868967559733,131773.38023244584,2632.5364101080086,134405.91664255384,1976,1,283.1842105263158,35,3,18,33.34989009130875,0.6401785714285715,43.315972222222214,1026.73611111111,29.335317460317427,0
2499,4,0,0,38,0.0,0.0,1.0,38,1150,900,250,0.782608695652174,14,9,5,384.86065463201754,0.41262150308202944,0.22626241660489232,0.22877684593832237,131892.24222232928,2552.0269365140457,134444.26915884332,1977,2,284.1842105263158,35,3,18,33.31701877934272,0.6413690476190477,43.200231481481474,1027.1990740740732,29.34854497354495,0
2500,4,0,0,38,0.0,0.0,1.0,38,750,300,450,0.4,12,3,9,379.1587503225632,0.41268077287814126,0.224278323327743,0.22644982256991814,132070.63567654742,2415.147435485247,134485.78311203266,1978,3,285.1842105263158,35,3,19,33.28324982171677,0.643154761904762,43.02662037037037,1027.893518518518,29.36838624338623,0
2501,4,0,0,38,0.0,0.0,1.0,38,850,600,250,0.7058823529411765,11,6,5,379.47097828614415,0.41205844001896635,0.22264745610085557,0.2271711705589016,132159.8776148832,2430.1676097393447,134590.04522462256,1979,4,286.1842105263158,35,3,19,33.18512681975087,0.644047619047619,42.9398148148148,1028.240740740739,29.37830687830683,0
2502,4,0,0,38,0.0,0.0,1.0,38,1050,900,150,0.8571428571428571,12,9,3,380.52095038486766,0.41176209103840683,0.2179165284949547,0.22851825723112848,132278.9137517146,2466.9795953360667,134745.89334705067,1980,5,287.1842105263158,35,3,19,33.037991299129914,0.6452380952380952,42.82407407407407,1028.703703703703,29.39153439153437,0
2503,4,1,0,39,0.02564102564102564,0.0,1.0,39,650,200,450,0.3076923076923077,11,2,9,373.86233159285064,0.4142206477732793,0.21771740197109235,0.22627207295940585,132571.90626014545,2112.728395625374,134684.63465577082,1981,0,280.79487179487177,36,3,20,32.91393293238564,0.6461226851851851,42.53941441441442,1029.8423423423437,28.60673173173177,0
2504,4,0,0,39,0.0,0.0,1.0,39,1100,800,300,0.7272727272727273,14,8,6,372.9132208454121,0.4143612235717499,0.21187200789299587,0.2262208318497239,132658.90045450884,2094.051568460385,134752.95202296923,1982,1,281.79487179487177,36,3,16,32.85075972890249,0.6469907407407407,42.45495495495497,1030.1801801801826,28.61611611611618,0
2505,4,0,0,39,0.0,0.0,1.0,39,1100,900,200,0.8181818181818182,13,9,4,373.2659317845615,0.4144174538911381,0.21037296037296027,0.2271362904050737,132774.93709926153,2112.072122798487,134887.00922206,1983,2,282.79487179487177,36,3,16,32.72485977564104,0.6481481481481481,42.34234234234235,1030.6306306306315,28.62862862862865,0
2506,4,1,1,39,0.025,0.025,0.975,40,1000,700,300,0.7,13,7,6,363.6395996689514,0.41543803418803416,0.20105439286093718,0.2235754116057376,133160.81781173067,1684.509296129594,134845.32710786027,1984,0,276.7,37,3,18,32.5851437727965,0.6500563063063063,41.96820175438597,1032.1271929824572,27.895329540066413,0
2507,4,0,0,39,0.0,0.0,1.0,39,750,400,350,0.5333333333333333,11,4,7,370.9170118493385,0.4128992352676563,0.20923144097470003,0.22728901308038787,133036.20501836334,2069.078326637489,135105.28334500082,1985,1,284.56410256410254,36,3,18,32.52260488301859,0.6507523148148149,42.088963963963984,1031.644144144147,28.656781781781863,0
2508,4,0,0,39,0.0,0.0,1.0,39,1050,1000,50,0.9523809523809523,11,10,1,376.0149219215272,0.41267431399010346,0.21104816260299053,0.23113190874653278,133152.4065239229,2213.45834855129,135365.8648724742,1986,2,285.56410256410254,36,3,18,32.27427714129843,0.6519097222222222,41.97635135135137,1032.094594594597,28.669294294294364,0
2509,4,0,1,38,0.0,0.02564102564102564,0.9743589743589743,39,800,600,200,0.75,10,6,4,376.47998463431435,0.41230881691408006,0.20977088647245679,0.23196024859727166,133239.59094229396,2232.40783012746,135471.99877242142,1987,3,286.56410256410254,36,3,18,32.17463823443863,0.6527777777777778,41.89189189189191,1032.432432432435,28.67867867867875,0
2510,4,0,0,38,0.0,0.0,1.0,38,1200,700,500,0.5833333333333334,17,7,10,374.8027472831568,0.4115398293029872,0.1811634953060799,0.23165032332083016,133355.88121905713,2396.4301294538077,135752.31134851094,1988,4,283.5263157894737,36,2,18,32.10109572612299,0.6539351851851851,41.779279279279294,1032.8828828828848,28.691191191191244,0
2511,4,0,0,38,0.0,0.0,1.0,38,1200,900,300,0.75,15,9,6,376.0538722538587,0.41165836889521096,0.18721640613796042,0.2329705791984575,133443.13221583085,2436.361319089375,135879.4935349202,1989,5,284.5263157894737,36,2,19,31.981153496821076,0.6548032407407407,41.69481981981983,1033.2207207207218,28.700575575575606,0
2512,4,0,0,38,0.0,0.0,1.0,38,1550,1200,350,0.7741935483870968,19,12,7,378.22767377788296,0.41158428165007116,0.1875748666013286,0.2357952972370875,133675.94103816655,2511.9880437870343,136187.9290819536,1990,6,285.5263157894737,36,2,19,31.691259210860668,0.6571180555555556,41.4695945945946,1034.1216216216217,28.7256006006006,0
2513,4,0,0,38,0.0,0.0,1.0,38,1100,1000,100,0.9090909090909091,12,10,2,377.3111894011547,0.41108048838312,0.18552817768815166,0.23596718155401006,133792.4215389376,2496.275540743445,136288.69707968103,1991,7,286.5263157894737,36,2,16,31.598091506113715,0.658275462962963,41.35698198198198,1034.5720720720722,28.738113113113116,0
2514,4,0,1,37,0.0,0.02631578947368421,0.9736842105263158,38,1100,700,400,0.6363636363636364,15,7,8,378.52105892192475,0.4107841394025604,0.1870851920356873,0.2374735189454886,133908.95276611065,2537.471720030835,136446.42448614148,1992,8,287.5263157894737,36,2,16,31.449923838537696,0.6594328703703703,41.244369369369366,1035.022522522522,28.75062562562561,0
2515,4,0,0,37,0.0,0.0,1.0,37,1150,700,450,0.6086956521739131,16,7,9,389.5860546822221,0.4086586586586587,0.2003265009976425,0.24390051322542428,133831.25964506142,3027.7584876542883,136859.01813271572,1993,12,296.0810810810811,35,2,17,31.24161073825503,0.6607142857142857,41.31944444444443,1034.72222222222,29.563492063491996,0
2516,4,0,0,37,0.0,0.0,1.0,37,1050,900,150,0.8571428571428571,12,9,3,388.5396232090916,0.4085648148148148,0.20323454044384315,0.2440378082852606,133951.0459533606,3009.057784636472,136960.10373799707,1994,13,297.0810810810811,35,2,18,31.148442158616582,0.6619047619047619,41.203703703703695,1035.1851851851839,29.57671957671954,0
2517,4,0,0,37,0.0,0.0,1.0,37,900,500,400,0.5555555555555556,13,5,8,389.8580951911091,0.40759509509509506,0.205343795018619,0.24586610950424495,134100.85419077936,3056.0607156635824,137156.91490644295,1995,14,298.0810810810811,35,2,18,30.964004358028827,0.6633928571428571,41.05902777777778,1035.7638888888891,29.593253968253975,0
2518,4,0,0,37,0.0,0.0,1.0,37,700,300,400,0.42857142857142855,11,3,8,391.8306032530961,0.40746996996997,0.20447793638142153,0.24771663561594026,134190.77932098752,3116.0108024691185,137306.79012345665,1996,15,299.0810810810811,35,2,18,30.822721179624647,0.6642857142857144,40.972222222222214,1036.1111111111102,29.603174603174576,0
2519,4,0,0,37,0.0,0.0,1.0,37,850,500,350,0.5882352941176471,12,5,7,394.8657931855227,0.40740740740740744,0.20846661757782803,0.2504545356777294,134310.72638031538,3206.9423010973774,137517.66868141276,1997,16,300.0810810810811,35,2,18,30.62379038261128,0.6654761904761906,40.856481481481474,1036.574074074073,29.616402116402085,0
2520,4,0,0,37,0.0,0.0,1.0,37,1050,800,250,0.7619047619047619,13,8,5,399.2215358276427,0.40668793793793795,0.21303053248582815,0.25384142934562465,134400.72183909893,3331.132517789775,137731.8543568887,1998,17,301.0810810810811,35,2,18,30.42064311493097,0.6663690476190476,40.769675925925924,1036.9212962962963,29.62632275132275,0
2521,4,0,0,37,0.0,0.0,1.0,37,1150,1000,150,0.8695652173913043,13,10,3,396.9113340040973,0.40637512512512514,0.21643337344709979,0.2527876662409888,134460.73555651997,3273.7979841820875,137734.53354070205,1999,18,302.0810810810811,35,2,19,30.42036324070974,0.6669642857142857,40.71180555555555,1037.152777777777,29.632936507936485,0
2522,4,0,0,37,0.0,0.0,1.0,37,1400,1200,200,0.8571428571428571,16,12,4,383.110579346416,0.4065002502502502,0.1621492752736049,0.22907445831340584,132114.37795859767,2760.559198318488,134874.93715691616,2000,19,303.0810810810811,33,4,15,33.13751639051138,0.6480429292929293,42.98406862745098,1028.0637254901962,31.153446226975642,8
2523,4,0,1,36,0.0,0.02702702702702703,0.972972972972973,37,900,800,100,0.8888888888888888,10,8,2,379.6113056806029,0.4066253753753754,0.08675205399872787,0.21193156894282786,129466.28146701373,2475.6328320237226,131941.91429903745,2001,20,304.0810810810811,35,2,18,35.91457693619924,0.6169642857142856,45.57291666666666,1017.708333333332,29.077380952380913,8
2524,4,2,1,37,0.05263157894736842,0.02631578947368421,0.9736842105263158,38,1100,1000,100,0.9090909090909091,12,10,2,366.11837385125483,0.4114805595068753,0.09749394974328851,0.20830255646744972,130206.62607725443,1934.2076408125495,132140.83371806698,2002,0,290.2368421052632,37,1,20,35.504852456668104,0.6204954954954955,44.84649122807017,1020.6140350877184,27.584163110478876,0
2525,4,1,0,38,0.02631578947368421,0.0,1.0,38,1050,700,350,0.6666666666666666,14,7,7,365.15498647266327,0.41309566145092463,0.11698258334178013,0.2091643780398572,130469.43486636238,1928.3369906047856,132397.77185696716,2003,0,290.6578947368421,35,3,21,35.262664740757515,0.6270833333333333,44.589120370370374,1021.6435185185192,29.189814814814834,0
2526,4,0,1,37,0.0,0.02631578947368421,0.9736842105263158,38,900,600,300,0.6666666666666666,12,6,6,364.7802457466918,0.41308084400189665,0.1176344393592672,0.2097486413043478,130617.28395061727,1929.3209876543183,132546.6049382716,2004,1,291.6578947368421,35,3,17,35.12228260869566,0.6285714285714286,44.44444444444444,1022.2222222222222,29.206349206349206,0
2527,4,0,1,36,0.0,0.02702702702702703,0.972972972972973,37,1350,1100,250,0.8148148148148148,16,11,5,376.973015400824,0.4098160660660661,0.12164523288576845,0.21647580850943635,130566.58340419494,2444.015731292505,133010.59913548746,2005,3,300.5135135135135,34,3,17,34.86216268685691,0.6302083333333333,44.49404761904761,1022.023809523809,30.059523809523792,0
2528,4,0,1,35,0.0,0.027777777777777776,0.9722222222222222,36,1000,500,500,0.5,15,5,10,388.44565122135344,0.40788690476190476,0.11903382221689385,0.22329601494399104,130606.8447982748,2946.7321763264254,133553.57697460122,2006,4,299.4166666666667,33,3,18,34.528109139591564,0.6328914141414141,44.454656862745104,1022.1813725490205,30.975193107546076,0
2529,4,0,0,35,0.0,0.0,1.0,35,1000,600,400,0.6,14,6,8,395.420993217531,0.4043067226890756,0.12561119839014334,0.22679958172285453,130520.50053884803,3322.109191664111,133842.60973051214,2007,5,308.85714285714283,32,3,18,34.43768277111908,0.6344401041666667,44.53914141414141,1021.843434343434,31.93260732323231,0
2530,4,0,0,35,0.0,0.0,1.0,35,1350,900,450,0.6666666666666666,18,9,9,425.31548476663164,0.40378151260504197,0.12240457870598531,0.23064950533603354,128314.69859232275,3950.341068281162,132265.0396606039,2008,6,309.85714285714283,30,5,19,35.93404528168391,0.6173611111111111,46.706989247311824,1013.1720430107521,33.77240143369173,8
2531,4,0,0,35,0.0,0.0,1.0,35,1050,700,350,0.6666666666666666,14,7,7,425.78109919375936,0.4042366946778711,0.1301132704473993,0.2316912734573831,128450.91376170644,3938.3942507804195,132389.30801248687,2009,7,310.85714285714283,30,5,16,35.78212012728718,0.61875,46.57258064516128,1013.7096774193539,33.79032258064513,0
2532,4,0,0,35,0.0,0.0,1.0,35,750,400,350,0.5333333333333333,11,4,7,427.10874141060435,0.40392156862745093,0.1296677080374895,0.23301051727715164,128553.1225611341,3981.232476297818,132534.35503743193,2010,8,311.85714285714283,30,5,16,35.64336204992267,0.6197916666666667,46.47177419354838,1014.1129032258054,33.80376344086018,0
2533,4,0,0,35,0.0,0.0,1.0,35,700,400,300,0.5714285714285714,10,4,6,426.36165687121354,0.40420168067226886,0.12929262336974,0.23300155136908388,128621.28434284305,3967.8367802636044,132589.12112310666,2011,9,312.85714285714283,30,5,16,35.59223311691179,0.6204861111111111,46.40456989247311,1014.3817204301071,33.8127240143369,0
2534,4,1,0,36,0.027777777777777776,0.0,1.0,36,1350,800,550,0.5925925925925926,19,8,11,413.0279494987525,0.4062996031746032,0.13558573950680564,0.2282769205303301,129069.04432508665,3461.824544270815,132530.86886935748,2012,0,305.1388888888889,31,5,17,35.47112591833247,0.6223118279569892,45.96354166666666,1016.1458333333321,32.778897849462325,0
2535,4,0,0,36,0.0,0.0,1.0,36,650,500,150,0.7692307692307693,8,5,3,413.0279494987525,0.4062996031746032,0.13558573950680564,0.2282769205303301,129069.04432508665,3461.824544270815,132530.86886935748,2013,1,306.1388888888889,31,5,17,35.47112591833247,0.6223118279569892,45.96354166666666,1016.1458333333321,32.778897849462325,0
2536,4,0,0,36,0.0,0.0,1.0,36,1050,700,350,0.6666666666666666,14,7,7,411.65773839149375,0.4059523809523809,0.1347615387899752,0.22809169365666357,129168.29639010946,3434.6257527669095,132602.92214287637,2014,2,307.1388888888889,31,5,18,35.40425793091669,0.6233198924731183,45.86588541666666,1016.5364583333322,32.79149865591394,0
2537,4,0,0,36,0.0,0.0,1.0,36,1050,700,350,0.6666666666666666,14,7,7,409.0122002595333,0.4056712962962963,0.12998208359033114,0.22720897996796077,129269.72229448479,3374.582947073719,132644.3052415585,2015,3,308.1388888888889,30,6,18,35.36765353775664,0.6270833333333333,45.76612903225806,1016.9354838709667,33.897849462365556,0
2538,4,0,0,36,0.0,0.0,1.0,36,1300,800,500,0.6153846153846154,18,8,10,410.25147936738404,0.4059027777777778,0.13288565976809052,0.22868952126738554,129406.44330269386,3417.836960920325,132824.2802636142,2016,4,309.1388888888889,30,6,19,35.19622413033905,0.6284722222222222,45.63172043010752,1017.4731182795691,33.91577060931897,0
2539,4,1,0,37,0.02702702702702703,0.0,1.0,37,1250,800,450,0.64,17,8,9,399.74160861172345,0.40944069069069067,0.14534104876465648,0.22544505131214476,129864.12896050332,2982.4191623263696,132846.5481228297,2017,0,301.7567567567568,31,6,17,34.9961676034747,0.6303763440860215,45.18229166666666,1019.2708333333321,32.87970430107523,0
2540,4,0,0,37,0.0,0.0,1.0,37,700,500,200,0.7142857142857143,9,5,4,400.5567374517577,0.4095658158158158,0.1392485437429256,0.22667343697414485,129996.88042534716,3014.225260416657,133011.10568576382,2018,1,302.7567567567568,31,6,18,34.83997276132107,0.6317204301075269,45.05208333333333,1019.7916666666661,32.89650537634407,0
2541,4,1,0,38,0.02631578947368421,0.0,1.0,38,750,600,150,0.8,9,6,3,390.34577381738717,0.41174727358937885,0.14541805930280938,0.22278686741455236,130329.0557861328,2574.950493706597,132904.0062798394,2019,0,295.7631578947368,31,7,19,34.76207175040382,0.6350806451612903,44.7265625,1021.0937499999999,32.93850806451613,0
2542,4,1,0,39,0.02564102564102564,0.0,1.0,39,1250,1000,250,0.8,15,10,5,378.90435887227596,0.414923526765632,0.1432452457396889,0.21823381921391824,130681.82615294353,2103.182710947855,132785.0088638914,2020,0,289.15384615384613,32,7,19,34.69580966493784,0.6360677083333333,44.38131313131313,1022.4747474747471,31.952335858585847,0
2543,4,0,0,39,0.0,0.0,1.0,39,1000,500,500,0.5,15,5,10,381.78034350460763,0.4142206477732793,0.13716566866267454,0.22107252900578866,130888.84833958093,2194.15789600154,133083.00623558246,2021,1,290.15384615384613,33,6,19,34.41217564870259,0.6357323232323233,44.17892156862745,1023.2843137254903,31.0086155674391,0
2544,4,0,0,39,0.0,0.0,1.0,39,750,400,350,0.5333333333333333,11,4,7,381.58065504650665,0.4144736842105263,0.1351227704957796,0.22113671410779864,130920.20083922052,2191.3231990099966,133111.5240382305,2022,2,291.15384615384613,33,6,20,34.38547778709137,0.6360479797979798,44.14828431372549,1023.4068627450982,31.012329174093885,0
2545,4,0,0,39,0.0,0.0,1.0,39,1050,900,150,0.8571428571428571,12,9,3,379.38236740505846,0.41475483580746736,0.13287159838883977,0.22004177309493403,130951.55709342573,2136.1423490965144,133087.69944252225,2023,3,292.15384615384613,33,6,20,34.4099217752235,0.6363636363636364,44.117647058823536,1023.5294117647069,31.016042780748695,0
2546,4,0,0,39,0.0,0.0,1.0,39,900,500,400,0.5555555555555556,13,5,8,376.08059812914513,0.4142206477732793,0.12892358968396622,0.2187065060519795,131053.71492346935,2057.351899092963,133111.0668225623,2024,4,293.15384615384613,34,5,20,34.39086540324768,0.6351102941176471,44.01785714285714,1023.9285714285711,30.115546218487385,0
2547,4,0,1,38,0.0,0.02564102564102564,0.9743589743589743,39,900,600,300,0.6666666666666666,12,6,6,367.590479980154,0.4146986054880792,0.04907715991947348,0.21401202464401534,131097.37059694828,1838.029076373668,132935.39967332195,2025,5,294.15384615384613,36,3,18,34.56399824059819,0.6313657407407407,43.97522522522522,1024.099099099099,28.447197197197195,8
2548,4,0,1,37,0.0,0.02631578947368421,0.9736842105263158,38,1100,700,400,0.6363636363636364,15,7,8,372.7986210858949,0.41308084400189665,0.05846565566458528,0.21734306960541294,131150.23389274688,2178.525270061722,133328.7591628086,2026,6,300.0263157894737,35,3,18,34.37711864406779,0.6339285714285714,43.92361111111111,1024.3055555555552,29.265873015873005,0
2549,4,0,0,37,0.0,0.0,1.0,37,1050,800,250,0.7619047619047619,13,8,5,379.68381419731054,0.4094094094094094,0.05405405405405417,0.22115232589976058,131114.67013888893,2556.4236111111168,133671.09375000006,2027,8,308.97297297297297,34,3,19,34.23684567398969,0.6357230392156863,43.958333333333336,1024.166666666667,30.122549019607852,0
2550,4,0,0,37,0.0,0.0,1.0,37,800,500,300,0.625,11,5,6,382.46406956847653,0.40831456456456455,0.05669175623863665,0.22348053270712026,131236.62308673482,2638.658588435391,133875.2816751702,2028,9,309.97297297297297,34,3,20,34.04205878935749,0.6369485294117647,43.83928571428572,1024.6428571428582,30.136554621848774,0
2551,4,0,0,37,0.0,0.0,1.0,37,700,500,200,0.7142857142857143,9,5,4,383.21666928663217,0.40787662662662666,0.05779036471415666,0.22409844356109587,131267.12018140603,2660.7497165533027,133927.86989795935,2029,10,310.97297297297297,34,3,20,33.99187771065676,0.6372549019607843,43.80952380952382,1024.7619047619057,30.14005602240899,0
2552,4,0,2,35,0.0,0.05405405405405406,0.9459459459459459,37,1300,1000,300,0.7692307692307693,16,10,6,381.63306770648535,0.4078140640640641,0.05790221802045936,0.22371688640497867,131360.48179076117,2626.329072913223,133986.8108636744,2030,11,311.97297297297297,32,5,21,33.93788233362074,0.6429036458333333,43.718434343434346,1025.1262626262628,32.03519570707071,0
2553,4,0,0,35,0.0,0.0,1.0,35,800,600,200,0.75,10,6,4,396.4603100303743,0.40479691876750695,0.06198045946659625,0.23162529992055356,131231.07854109284,3405.582816804419,134636.66135789725,2031,14,326.0857142857143,32,3,22,33.689155884165125,0.6416015625,43.844696969696976,1024.621212121213,32.019412878787904,0
2554,4,0,0,35,0.0,0.0,1.0,35,1250,900,350,0.72,16,9,7,395.4300946940789,0.40504201680672264,0.06757271688047783,0.23181095573540456,131361.49300469286,3388.8933936645344,134750.3863983574,2032,15,327.0857142857143,31,4,22,33.583264532791404,0.645497311827957,43.717447916666664,1025.130208333333,33.06871639784945,0
2555,4,0,1,34,0.0,0.02857142857142857,0.9714285714285714,35,800,300,500,0.375,13,3,10,393.2126219479639,0.40479691876750695,0.07005731698469186,0.23111512018374353,131461.62245008675,3338.4738498263832,134800.09629991313,2033,16,328.0857142857143,31,4,22,33.538598273235145,0.646505376344086,43.619791666666664,1025.520833333333,33.081317204301065,0
2556,4,0,0,34,0.0,0.0,1.0,34,650,500,150,0.7692307692307693,8,5,3,393.2126219479639,0.4034090909090909,0.0935231380515642,0.23111512018374353,131461.62245008675,3538.4738498263832,135000.09629991313,2034,17,335.88235294117646,31,3,22,33.538598273235145,0.646505376344086,43.619791666666664,1025.520833333333,33.081317204301065,0
2557,4,0,0,34,0.0,0.0,1.0,34,850,300,550,0.35294117647058826,14,3,11,394.61980468448064,0.4030191622103387,0.09402806808002429,0.23275479497857074,131595.1877170138,3586.0134548611004,135181.20117187488,2035,18,336.88235294117646,31,3,17,33.36717428087988,0.6478494623655914,43.48958333333333,1026.0416666666658,33.09811827956987,0
2558,4,0,0,34,0.0,0.0,1.0,34,950,700,250,0.7368421052631579,12,7,5,395.3885677349891,0.402963458110517,0.09444400222876714,0.23375372124492558,131684.26890432098,3613.2908950617293,135297.55979938273,2036,19,337.88235294117646,32,2,17,33.25721695985567,0.6461588541666667,43.40277777777778,1026.388888888889,32.07465277777778,0
2559,4,0,0,34,0.0,0.0,1.0,34,1000,700,300,0.7,13,7,6,412.5069419923216,0.40255496137849084,0.12130021141649072,0.22954798066160914,129338.07376575308,3942.9086214205677,133280.98238717366,2037,20,338.88235294117646,30,4,19,35.20882884073291,0.6277777777777778,45.698924731182785,1017.2043010752674,33.90681003584225,8
2560,4,0,0,34,0.0,0.0,1.0,34,550,400,150,0.7272727272727273,7,4,3,415.5362064349474,0.4017751039809863,0.12188313544911433,0.2323792605084703,129532.5469970701,3965.0926378037916,133497.6396348739,2038,21,339.88235294117646,31,3,16,34.93274068389186,0.627016129032258,45.507812499999986,1017.9687499999983,32.83770161290317,0
2561,4,0,0,34,0.0,0.0,1.0,34,950,700,250,0.7368421052631579,12,7,5,414.4261728339212,0.40181224004753413,0.1318528434129982,0.23254243356577659,129665.12891981313,3947.324625651009,133612.45354546414,2039,22,340.88235294117646,31,3,17,34.82538566436545,0.6283602150537635,45.37760416666665,1018.4895833333314,32.85450268817198,0
2562,4,1,0,35,0.02857142857142857,0.0,1.0,35,1450,1200,250,0.8275862068965517,17,12,5,412.46094410598903,0.40378151260504197,0.13325321220904573,0.23461800219624984,130198.1482278594,3740.330227782879,133938.4784556423,2040,0,332.1142857142857,32,3,19,34.331054888861395,0.6311848958333333,44.85479797979798,1020.5808080808081,31.893150252525253,0
2563,4,1,1,35,0.027777777777777776,0.027777777777777776,0.9722222222222222,36,1200,900,300,0.75,15,9,6,403.6492879811806,0.4075892857142857,0.1261380853263101,0.23136858749366893,130495.30241224518,3334.8990652199172,133830.2014774651,2041,0,323.8611111111111,31,5,13,34.25313814196508,0.636760752688172,44.56380208333334,1021.744791666668,32.959509408602194,0
2564,4,0,0,35,0.0,0.0,1.0,35,950,700,250,0.7368421052631579,12,7,5,415.14547028491825,0.40374649859943973,0.12468594799883137,0.23334038502221285,129731.44531250013,3771.4843750000146,133502.92968750015,2042,2,334.1142857142857,31,4,20,34.73926380368099,0.6290322580645161,45.31250000000001,1018.750000000001,32.862903225806484,8
2565,4,1,0,36,0.027777777777777776,0.0,1.0,36,950,600,350,0.631578947368421,13,6,7,406.60290319913173,0.4071263227513227,0.12553299771670678,0.23033227573931175,130037.12153096621,3374.694227629834,133411.81575859603,2043,0,325.80555555555554,32,4,21,34.644765618552455,0.6295572916666667,45.01262626262626,1019.9494949494948,31.873421717171713,0
2566,4,1,0,37,0.02702702702702703,0.0,1.0,37,900,500,400,0.5555555555555556,13,5,8,398.0674743988233,0.4133508508508508,0.1266541021733898,0.22737074385153153,130359.27456382013,2978.5527305887263,133337.82729440887,2044,0,317.97297297297297,32,5,22,34.534186449060336,0.6328125,44.6969696969697,1021.212121212122,31.912878787878814,0
2567,4,0,0,37,0.0,0.0,1.0,37,1200,800,400,0.6666666666666666,16,8,8,396.1740676963882,0.4136636636636637,0.1244579561019612,0.22666536122091827,130423.7529971433,2934.101749821469,133357.85474696476,2045,1,318.97297297297297,32,5,22,34.51689328388959,0.6334635416666667,44.633838383838395,1021.4646464646477,31.92077020202024,0
2568,4,0,0,37,0.0,0.0,1.0,37,1150,900,250,0.782608695652174,14,9,5,398.41381808709,0.4136011011011011,0.12381070060546207,0.22851616086313417,130520.50053884825,3000.23419166414,133520.7347305124,2046,2,319.97297297297297,32,5,17,34.361227810041605,0.6344401041666667,44.539141414141426,1021.8434343434358,31.932607323232368,0
2569,4,1,1,37,0.02631578947368421,0.02631578947368421,0.9736842105263158,38,900,800,100,0.8888888888888888,10,8,2,391.31426065383664,0.41519973921289716,0.12108035894333558,0.22696227117922516,130951.55709342558,2648.6423490965017,133600.19944252208,2047,0,312.5263157894737,33,5,19,34.10460568326948,0.6363636363636364,44.11764705882353,1023.5294117647057,31.01604278074866,0
2570,4,1,1,37,0.02631578947368421,0.02631578947368421,0.9736842105263158,38,1000,600,400,0.6,14,6,8,395.460019820155,0.4095098387861546,0.13436228762861924,0.23049196971107785,131139.77346453292,2772.1074826989698,133911.8809472319,2048,0,313.42105263157896,33,5,20,33.80743000717876,0.6382575757575757,43.93382352941177,1024.2647058823534,31.038324420677377,0
2571,4,0,0,37,0.0,0.0,1.0,37,1300,1000,300,0.7692307692307693,16,10,6,402.87310443475326,0.40549924924924924,0.1365811053423267,0.23423832898763855,131045.64838343441,3158.953437379878,134204.60182081428,2049,1,322.7567567567568,33,4,20,33.71322062637145,0.6373106060606061,44.02573529411766,1023.8970588235306,31.027183600713048,0
2572,4,1,1,37,0.02631578947368421,0.02631578947368421,0.9736842105263158,38,1050,800,250,0.7619047619047619,13,8,5,398.05503652114805,0.40936166429587484,0.1331734508685507,0.23354096073350605,131392.84256708508,2860.92478895109,134253.76735603617,2050,0,315.2368421052632,32,6,21,33.48419540229884,0.6432291666666667,43.68686868686869,1025.252525252526,32.03914141414144,0
2573,4,1,0,38,0.02631578947368421,0.0,1.0,38,1050,700,350,0.6666666666666666,14,7,7,395.3872814973659,0.4103544333807492,0.13599136953549684,0.23256559649551795,131489.94880943268,2797.890680797876,134287.83949023054,2051,0,315.94736842105266,32,6,23,33.454132299232626,0.6442057291666667,43.592171717171716,1025.631313131313,32.05097853535353,0
2574,4,0,0,38,0.0,0.0,1.0,38,500,300,200,0.6,7,3,4,396.2382917074855,0.4106655998103366,0.13892560055974523,0.23326375955301518,131522.32552800723,2822.8363177226697,134345.1618457299,2052,1,316.94736842105266,32,6,23,33.39949532250124,0.64453125,43.560606060606055,1025.7575757575748,32.054924242424214,0
2575,4,0,0,38,0.0,0.0,1.0,38,550,500,50,0.9090909090909091,6,5,1,393.24196026661804,0.41093231389284024,0.13670882892850855,0.23184659798254412,131579.47063629376,2748.513792772017,134327.98442906578,2053,2,317.94736842105266,33,5,18,33.41843844561236,0.6426767676767677,43.504901960784316,1025.980392156863,31.090314913844335,0
2576,4,0,1,37,0.0,0.02631578947368421,0.9736842105263158,38,1000,700,300,0.7,13,7,6,395.3569252218746,0.4105470602181129,0.13841715585835823,0.23347806007108438,131642.34459102261,2809.1425173010275,134451.48710832364,2054,3,318.94736842105266,33,5,18,33.30049359127458,0.6433080808080809,43.44362745098039,1026.2254901960778,31.09774212715387,0
2577,4,0,1,36,0.0,0.02702702702702703,0.972972972972973,37,650,300,350,0.46153846153846156,10,3,7,406.4683884284,0.40700075075075076,0.14547486925625797,0.23928617301393615,131522.32552800723,3291.933539944892,134814.25906795214,2055,5,328.4864864864865,32,5,22,33.13715534219597,0.64453125,43.560606060606055,1025.7575757575748,32.054924242424214,0
2578,4,0,0,36,0.0,0.0,1.0,36,1150,900,250,0.782608695652174,14,9,5,393.71136791185165,0.4061342592592592,0.13433515482695846,0.2183308494783905,129201.38888888892,2973.6111111111154,132175.00000000003,2056,6,334.8611111111111,33,3,20,35.82650273224043,0.6186868686868687,45.833333333333336,1016.666666666667,30.808080808080817,8
2579,4,1,1,36,0.02702702702702703,0.02702702702702703,0.972972972972973,37,1250,800,450,0.64,17,8,9,383.93776597470094,0.41147397397397395,0.13121996075345765,0.21505040683573154,129595.04145408173,2551.286139455792,132146.3275935375,2057,0,326.7837837837838,34,3,16,35.67315561791185,0.6204044117647058,45.44642857142858,1018.2142857142866,29.947478991596665,0
2580,4,0,0,36,0.0,0.0,1.0,36,950,700,250,0.7368421052631579,12,7,5,393.55853161705153,0.4052744708994709,0.13987246912093365,0.21945711806691595,129419.51600646383,2986.830936418682,132406.34694288252,2058,8,336.8611111111111,33,3,20,35.607486249949815,0.6208964646464646,45.618872549019606,1017.5245098039214,30.834076054664287,0
2581,4,0,0,36,0.0,0.0,1.0,36,700,600,100,0.8571428571428571,8,6,2,428.47190808825206,0.4043650793650793,0.14317549158967058,0.22579025268920228,127159.78725864246,3807.2147536294624,130967.00201227193,2059,9,337.8611111111111,30,6,19,37.045520167022026,0.6055555555555556,47.849462365591386,1008.6021505376332,33.62007168458777,8
2582,4,1,0,37,0.02702702702702703,0.0,1.0,37,750,600,150,0.8,9,6,3,420.69063630290725,0.40919044044044045,0.14985530563420024,0.22439725280734443,127650.62332153309,3340.284389919691,130990.90771145278,2060,0,329.7027027027027,31,6,18,36.73509105355839,0.6078629032258065,47.36328124999999,1010.5468749999991,32.59828629032255,0
2583,4,2,0,39,0.05128205128205128,0.0,1.0,39,1400,1300,100,0.9285714285714286,15,13,2,404.3993361865669,0.41489541160593796,0.1611694224778344,0.2194256033060983,128336.3643537647,2580.7817849683547,130917.14613873305,2061,0,313.7435897435897,32,7,21,36.44158878504674,0.6123046875,46.68560606060605,1013.257575757574,31.66429924242419,0
2584,4,1,1,39,0.025,0.025,0.975,40,850,600,250,0.7058823529411765,11,6,5,386.7278578979428,0.4189903846153846,0.1682093775262734,0.19594362326145598,125550.3730093663,1725.1133881516323,127275.48639751793,2062,0,306.875,35,5,17,39.760773953882286,0.5770833333333334,49.450231481481474,1002.199074074073,28.634259259259228,8
2585,4,2,0,41,0.04878048780487805,0.0,1.0,41,1200,900,300,0.75,15,9,6,378.26483703792985,0.42477134146341466,0.17811962351988653,0.19396133133221496,126043.83680555549,1336.5581329303743,127380.39493848586,2063,0,300.3170731707317,35,6,19,39.46230982019363,0.5821428571428571,48.95833333333333,1004.1666666666661,28.690476190476172,0
2586,4,2,0,43,0.046511627906976744,0.0,1.0,43,950,800,150,0.8421052631578947,11,8,3,360.6819862829478,0.4340854558877815,0.17380874939014435,0.1842054429945054,125878.73191751304,493.4590450907891,126372.19096260383,2064,0,287.30232558139534,37,6,18,40.07411858974357,0.5765765765765766,49.122807017543856,1003.5087719298242,27.121858700806058,8
2587,4,1,0,44,0.022727272727272728,0.0,1.0,44,850,700,150,0.8235294117647058,10,7,3,353.9012979830958,0.4355179704016913,0.1771240668325631,0.1819971391638847,126163.40880102052,130.3116520153915,126293.7204530359,2065,0,281.75,34,10,19,39.95067543547813,0.5854779411764706,48.83928571428572,1004.642857142858,29.548319327731118,0
2588,4,2,1,45,0.043478260869565216,0.021739130434782608,0.9782608695652174,46,1650,1400,250,0.8484848484848485,19,14,5,348.7735522160118,0.4389392109500805,0.21110209763134935,0.1828783167344993,126957.38965821112,-344.12404576665745,126613.26561244446,2066,0,270.45652173913044,38,8,20,39.26287147955759,0.5858004385964912,48.05021367521368,1007.7991452991465,26.521030139451224,0
2589,4,1,1,45,0.021739130434782608,0.021739130434782608,0.9782608695652174,46,1100,900,200,0.8181818181818182,13,9,4,349.3613824192333,0.4372383252818035,0.21900826446280952,0.18379446640316202,127092.013888889,-319.7916666666579,126772.22222222235,2067,0,271.39130434782606,39,7,21,39.10984848484847,0.5854700854700854,47.91666666666667,1008.3333333333344,25.854700854700884,0
2590,4,1,1,45,0.021739130434782608,0.021739130434782608,0.9782608695652174,46,1000,500,500,0.5,15,5,10,349.0063752526785,0.43665458937198065,0.22556106459156045,0.18463961835977025,127319.21744379535,-312.9562839866628,127006.2611598087,2068,0,272.0,36,10,18,38.885711894666386,0.5931712962962963,47.691441441441455,1009.2342342342358,28.03428428428433,0
2591,4,1,0,46,0.021739130434782608,0.0,1.0,46,1350,1000,350,0.7407407407407407,17,10,7,349.28342822755803,0.43761070853462153,0.22389898069033687,0.18530622588688112,127432.89531085161,-297.9602913724317,127134.93501947918,2069,0,272.9782608695652,36,10,19,38.762175626440595,0.5943287037037037,47.57882882882884,1009.6846846846865,28.046796796796848,0
2592,4,3,2,47,0.061224489795918366,0.04081632653061224,0.9591836734693877,49,1100,700,400,0.6363636363636364,15,7,8,330.42864610262615,0.442265447845805,0.23151929829849394,0.1786727402399768,128198.62349559872,-1325.9189811446345,126872.70451445408,2070,0,257.2040816326531,38,11,22,38.455840981819456,0.5984100877192983,46.8215811965812,1012.7136752136757,26.6503598740441,0
2593,4,0,0,47,0.0,0.0,1.0,47,1850,1300,550,0.7027027027027027,24,13,11,344.5757580512583,0.4380781683626272,0.22732497767218063,0.18547488641483437,128015.94309769341,-577.7618728930956,127438.18122480031,2071,1,268.9574468085106,40,7,22,38.284335877351545,0.5932291666666667,47.002032520325216,1011.991869918701,25.299796747967527,0
2594,4,0,0,47,0.0,0.0,1.0,47,800,500,300,0.625,11,5,6,345.07793833419674,0.4380781683626272,0.22956248277512237,0.1858643151903877,128041.65556423109,-563.1298953995508,127478.52566883153,2072,2,269.9574468085106,40,7,22,38.24534759179303,0.5934895833333333,46.97662601626017,1012.0934959349605,25.302337398374014,0
2595,4,1,0,48,0.020833333333333332,0.0,1.0,48,1700,1400,300,0.8235294117647058,20,14,6,342.7659973728658,0.44003028959810875,0.23150684931506915,0.18673072991208328,128496.33487654294,-791.0411892906477,127705.2936872523,2073,0,265.3125,38,10,20,37.83961187214613,0.6014254385964912,46.527777777777764,1013.8888888888868,26.681286549707547,0
2596,4,1,0,49,0.02040816326530612,0.0,1.0,49,1500,1200,300,0.8,18,12,6,341.87335517930717,0.4425843253968254,0.2493092103247787,0.18822812332268954,128917.41569378338,-985.3141111441672,127932.10158263921,2074,0,260.8775510204082,40,9,21,37.433078154708284,0.60234375,46.11280487804878,1015.5487804878043,25.388719512195106,0
2597,4,1,1,49,0.02,0.02,0.98,50,1250,700,550,0.56,18,7,11,340.401197435888,0.4440136054421769,0.25731118493909144,0.18904199340996725,129258.63997443386,-1198.478747867565,128060.16122656628,2075,0,256.64,36,14,22,37.123246585455874,0.6128472222222222,45.777027027027025,1016.8918918918916,28.24699699699699,0
2598,4,1,2,48,0.02,0.04,0.96,50,1350,1100,250,0.8148148148148148,16,11,5,340.24113675283564,0.44273809523809526,0.26265000538619043,0.1901540320575899,129508.13140822158,-1187.2012301862285,128320.93017803536,2076,0,257.52,37,13,17,36.87374322237783,0.6134572072072072,45.53179824561403,1017.8728070175424,27.510075865338983,0
2599,4,1,0,49,0.02040816326530612,0.0,1.0,49,1000,700,300,0.7,13,7,6,340.2128839373713,0.439749858276644,0.25588713495264837,0.19010018447339183,129500.26167223658,-988.4685011688505,128511.79317106772,2077,0,263.57142857142856,38,11,18,36.882456876946215,0.6115679824561404,45.5395299145299,1017.8418803418783,26.785312640575746,0
2600,4,1,1,49,0.02,0.02,0.98,50,1300,900,400,0.6923076923076923,17,9,8,334.0612341383347,0.4408843537414966,0.254056815859391,0.18853075186146137,129890.67382812488,-1321.712239583349,128568.96158854154,2078,0,259.28,39,11,19,36.64290823625588,0.6137820512820513,45.15624999999999,1019.3749999999991,26.13782051282049,0
2601,4,0,0,49,0.0,0.0,1.0,49,1300,800,500,0.6153846153846154,18,8,10,341.5160814263196,0.439891581632653,0.2588663800386759,0.19234610389140366,129811.04736328112,-933.4879557291831,128877.55940755193,2079,1,265.51020408163265,39,10,19,36.533719206787296,0.6129807692307692,45.23437499999999,1019.062499999999,26.129807692307665,0
2602,4,0,1,48,0.0,0.02040816326530612,0.9795918367346939,49,1700,1200,500,0.7058823529411765,22,12,10,344.6053967018465,0.43939554988662133,0.2662256290075844,0.19465548083969125,129925.63950029707,-845.3846916518336,129080.25480864523,2080,2,266.51020408163265,40,9,19,36.33871610845294,0.6125,45.12195121951218,1019.5121951219481,25.487804878048703,0
2603,4,0,1,47,0.0,0.020833333333333332,0.9791666666666666,48,1300,800,500,0.6153846153846154,18,8,10,365.94412424251027,0.43991947399527187,0.2984032524157436,0.19481818308167764,127572.62613378683,-53.415383231422766,127519.21075055542,2081,3,266.6875,34,14,19,38.19820881451802,0.5998774509803921,47.44047619047619,1010.2380952380952,29.712885154061624,8
2604,4,0,0,47,0.0,0.0,1.0,47,900,400,500,0.4444444444444444,14,4,10,370.8064484503607,0.43823234659266114,0.30254752308120625,0.1969662556170576,127482.44224773243,54.262329931974136,127536.7045776644,2082,4,273.1063829787234,34,13,19,38.168002672010694,0.5989583333333333,47.529761904761905,1009.8809523809523,29.70238095238095,0
2605,4,1,0,48,0.020833333333333332,0.0,1.0,48,1150,600,550,0.5217391304347826,17,6,11,363.8108250941128,0.44000258569739953,0.3136829213983521,0.19520602335694895,127888.11404309732,-294.5839420501411,127593.53010104717,2083,0,268.3958333333333,36,12,20,37.92863504787353,0.5989583333333333,47.128378378378386,1011.4864864864878,28.096846846846883,0
2606,4,2,1,49,0.04,0.02,0.98,50,1150,800,350,0.6956521739130435,15,8,7,349.9497096342175,0.44306122448979596,0.3123681205754736,0.19036394763829065,128437.66744898843,-1009.8847067944992,127427.78274219393,2084,0,258.62,35,15,16,37.71742026337824,0.6065476190476191,46.58564814814815,1013.6574074074082,28.961640211640233,0
2607,4,1,1,49,0.02,0.02,0.98,50,1550,1000,550,0.6451612903225806,21,10,11,348.1620489491321,0.44368197278911564,0.3170908283366638,0.19003317653550836,128572.46393352827,-1047.1895036928695,127525.2744298354,2085,0,259.6,36,14,18,37.62514804944851,0.6059027777777778,46.45270270270271,1014.1891891891904,28.171921921921957,0
2608,4,0,0,49,0.0,0.0,1.0,49,1850,1400,450,0.7567567567567568,23,14,9,354.8825389473529,0.44359410430839,0.31499241205916295,0.19425830351856935,128686.69979100728,-666.2674498823071,128020.43234112498,2086,1,265.14285714285717,36,13,19,37.33814280429153,0.6070601851851851,46.340090090090094,1014.6396396396401,28.184434434434447,0
2609,4,2,1,50,0.0392156862745098,0.0196078431372549,0.9803921568627451,51,1400,1000,400,0.7142857142857143,18,10,8,338.28271969900527,0.44586601307189544,0.3188685310189645,0.18759314456035775,129201.38888888912,-1458.6805555555352,127742.70833333359,2087,0,255.7058823529412,39,12,21,37.235314207650276,0.6068376068376069,45.83333333333334,1016.6666666666686,26.068376068376118,0
2610,4,3,6,47,0.05660377358490566,0.11320754716981132,0.8867924528301887,53,1450,1200,250,0.8275862068965517,17,12,5,321.0062048436906,0.4491261490082245,0.3053446590994515,0.18074127401411566,129799.47973738021,-2266.7123237636224,127532.76741361659,2088,0,245.58490566037736,38,15,14,37.067956245194644,0.6145833333333333,45.24572649572649,1019.0170940170927,26.816239316239283,0
2611,4,0,0,47,0.0,0.0,1.0,47,1350,1300,50,0.9629629629629629,14,13,1,357.7667293738246,0.4425107924761024,0.30746424834321684,0.19839791356184786,129201.38888888866,-155.20833333335872,129046.1805555553,2089,1,270.40425531914894,33,14,21,36.74009562841532,0.6186868686868687,45.83333333333332,1016.6666666666648,30.808080808080753,0
2612,4,0,1,46,0.0,0.02127659574468085,0.9787234042553191,47,850,600,250,0.7058823529411765,11,6,5,358.7985291911025,0.4424722479185939,0.30280559786259764,0.19928448428566023,129263.69214965375,-124.07547577857349,129139.61667387518,2090,2,271.40425531914894,33,14,22,36.65039768618945,0.6193181818181819,45.7720588235294,1016.9117647058805,30.81550802139032,0
2613,4,0,0,46,0.0,0.0,1.0,46,1300,900,400,0.6923076923076923,17,9,8,360.5810610710581,0.44264291465378425,0.29753866083717884,0.20044723581279314,129297.68207644625,124.4590794306614,129422.1411558769,2091,3,272.5217391304348,32,14,22,36.57045313469894,0.6220703125,45.73863636363636,1017.0454545454543,31.782670454545446,0
2614,4,0,0,46,0.0,0.0,1.0,46,1250,800,450,0.64,17,8,9,363.8449041618721,0.44164653784219005,0.2993871286220646,0.20292222025193943,129426.12879106711,218.2074852055755,129644.33627627269,2092,4,273.5217391304348,32,14,16,36.356609587624604,0.6233723958333333,45.61237373737373,1017.5505050505041,31.798453282828252,0
2615,4,0,0,46,0.0,0.0,1.0,46,900,700,200,0.7777777777777778,11,7,4,362.5095224447915,0.44157608695652173,0.2969827992336602,0.20262477075548033,129513.05537533636,189.94317089580235,129702.99854623216,2093,5,274.5217391304348,33,13,16,36.3020707921984,0.6218434343434344,45.52696078431372,1017.8921568627447,30.84521687462863,0
2616,4,1,0,47,0.02127659574468085,0.0,1.0,47,950,600,350,0.631578947368421,13,6,7,352.20952458633883,0.4426649707061363,0.2941493710965366,0.19850334035442038,129837.58680555549,-253.99305555556606,129583.59374999993,2094,0,269.6595744680851,34,13,18,36.23432815481056,0.6228553921568627,45.20833333333333,1019.1666666666661,29.975490196078415,0
2617,4,1,1,47,0.020833333333333332,0.020833333333333332,0.9791666666666666,48,1450,1000,450,0.6896551724137931,19,10,9,341.7474038089896,0.4436133274231679,0.28797640069160857,0.1941425220008309,130147.65346004779,-704.4754636393291,129443.17799640846,2095,0,265.0208333333333,36,12,19,36.18644925137033,0.6218171296296297,44.90427927927927,1020.3828828828821,28.343968968968948,0
2618,4,2,2,47,0.04081632653061224,0.04081632653061224,0.9591836734693877,49,1400,1000,400,0.7142857142857143,18,10,8,331.33934014849643,0.44439129818594103,0.28078771191016094,0.18976707663050263,130463.84222059904,-1154.3885946757532,129309.45362592328,2096,0,260.3673469387755,36,13,22,36.13200874485595,0.625,44.5945945945946,1021.621621621622,28.37837837837839,0
2619,4,0,0,47,0.0,0.0,1.0,47,1550,1300,250,0.8387096774193549,18,13,5,344.1519776744123,0.44158572309589883,0.2819063207972041,0.19566416959167687,130178.65022170258,-439.7520150431148,129738.89820665948,2097,1,271.9148936170213,37,10,22,36.093688442391034,0.6202139639639639,44.87390350877192,1020.5043859649103,27.58119962067325,0
2620,4,0,2,45,0.0,0.0425531914893617,0.9574468085106383,47,1400,900,500,0.6428571428571429,19,9,10,336.3994896602459,0.44031375269811907,0.25460498834436107,0.18128832565649394,128063.41428336591,-773.8012854091947,127289.61299795672,2098,2,272.9148936170213,38,9,19,38.44271163183449,0.5970394736842105,46.95512820512819,1012.1794871794848,26.63630229419697,8
2621,4,2,1,46,0.0425531914893617,0.02127659574468085,0.9787234042553191,47,1400,1000,400,0.7142857142857143,18,10,8,336.7583324396796,0.44002466851680544,0.2883444625142706,0.18350420456741837,128506.39349489778,-744.7775152960819,127761.6159796017,2099,0,273.7659574468085,34,13,20,37.98163476967632,0.609375,46.51785714285713,1013.9285714285701,29.82142857142853,0
2622,4,1,1,46,0.02127659574468085,0.02127659574468085,0.9787234042553191,47,1300,700,600,0.5384615384615384,19,7,12,336.42483441611824,0.44029448041936475,0.2956832803865561,0.18422464230644012,128701.77636584779,-740.3052394118806,127961.4711264359,2100,0,274.48936170212767,35,12,21,37.7909822820425,0.6092261904761904,46.325231481481474,1014.6990740740731,28.99140211640209,0
2623,4,1,1,46,0.02127659574468085,0.02127659574468085,0.9787234042553191,47,1250,800,450,0.64,17,8,9,356.7907428186761,0.44104609929078015,0.29374563387970554,0.18795883461891097,127147.3013331026,-265.2688889731845,126882.03244412942,2101,0,274.6170212765957,37,10,19,38.86578604044359,0.589527027027027,47.861842105263165,1008.5526315789483,27.25817923186347,8
2624,4,1,0,47,0.02127659574468085,0.0,1.0,47,1350,1000,350,0.7407407407407407,17,10,7,357.5711780758221,0.4414508171446192,0.2943358720399414,0.1892721503270811,127340.90206842488,-293.31272603108664,127047.5893423938,2102,0,275.3191489361702,37,10,17,38.647361035669014,0.5914977477477478,47.66995614035088,1009.3201754385964,27.278923660502606,0
2625,4,3,2,48,0.06,0.04,0.96,50,1400,900,500,0.6428571428571429,19,9,10,341.5807210960387,0.44689625850340137,0.3130041152263374,0.1844535893918611,128144.53125000013,-1245.659722222209,126898.87152777793,2103,0,259.74,40,10,20,38.22873799725653,0.59453125,46.87500000000001,1012.500000000001,25.312500000000025,0
2626,4,1,0,49,0.02040816326530612,0.0,1.0,49,1650,1300,350,0.7878787878787878,20,13,7,350.41000480780497,0.44506448412698413,0.33564017662482226,0.18987906360230555,128283.34349270926,-809.6465979916948,127473.69689471756,2104,0,265.7755102040816,37,12,21,37.86338258108741,0.6010698198198199,46.737938596491226,1013.0482456140348,27.379682313892832,0
2627,4,1,0,50,0.02,0.0,1.0,50,1350,700,650,0.5185185185185185,20,7,13,348.720460704529,0.44585034013605446,0.3393890878449548,0.19049206294181809,128604.67916757977,-1030.5834063846871,127574.09576119509,2105,0,261.44,38,12,18,37.57811951407907,0.6025219298245614,46.42094017094017,1014.316239316239,26.69253261358524,0
2628,4,0,1,49,0.0,0.02,0.98,50,1350,800,550,0.5925925925925926,19,8,11,349.1275950371305,0.44587585034013605,0.34250157927984803,0.19123494219507875,128713.06911571333,-1012.5431459566124,127700.52596975671,2106,1,262.44,38,12,18,37.457227837439454,0.6036184210526316,46.31410256410256,1014.7435897435896,26.703778677462886,0
2629,4,0,0,49,0.0,0.0,1.0,49,1500,900,600,0.6,21,9,12,355.1364163174488,0.4441078514739229,0.3456261761001016,0.19405593546088123,128616.79945993001,-664.6981523160916,127952.10130761392,2107,2,268.734693877551,37,12,18,37.403051021511196,0.6044481981981982,46.40899122807018,1014.3640350877197,27.415244191559992,0
2630,4,1,1,49,0.02,0.02,0.98,50,1450,1000,450,0.6896551724137931,19,10,9,342.7678651394682,0.4456377551020408,0.3378801261829656,0.1892986293540267,129038.51290269547,-1153.9488823142792,127884.56402038119,2108,0,264.34,38,12,19,37.28706624605677,0.606907894736842,45.99358974358974,1016.02564102564,26.73751686909579,0
2631,4,0,0,49,0.0,0.0,1.0,49,1700,1300,400,0.7647058823529411,21,13,8,348.14954870682425,0.4443735827664399,0.34234211034571627,0.1922707437980191,129038.51290269519,-815.059993425419,128223.45290926978,2109,1,270.61224489795916,38,11,19,37.1503680336488,0.606907894736842,45.99358974358972,1016.0256410256378,26.73751686909573,0
2632,4,2,2,49,0.0392156862745098,0.0392156862745098,0.9607843137254902,51,1250,800,450,0.64,17,8,9,330.9972324003278,0.4466013071895425,0.33326150973209856,0.18485657708422612,129480.2306959832,-1628.1722124103924,127852.05848357281,2110,0,260.96078431372547,37,14,15,37.1372908137614,0.6131756756756757,45.55921052631578,1017.7631578947354,27.50711237553339,0
2633,4,1,1,49,0.02,0.02,0.98,50,1850,1500,350,0.8108108108108109,22,15,7,337.082091670494,0.4460799319727891,0.3403876803790653,0.18879036810930097,129591.85157933226,-1263.381521237287,128328.47005809497,2111,0,267.16,37,13,17,36.86912197573409,0.6143018018018018,45.44956140350878,1018.2017543859661,27.518966334755838,0
2634,4,1,0,50,0.02,0.0,1.0,50,1700,1200,500,0.7058823529411765,22,12,10,335.7319032644928,0.4453996598639456,0.3390268456375847,0.1887700135336205,129745.05077069179,-1288.0894331214806,128456.9613375703,2112,0,268.14,38,12,18,36.74802502796424,0.6140350877192983,45.2991452991453,1018.8034188034187,26.810616284300494,0
2635,4,0,0,50,0.0,0.0,1.0,50,1500,900,600,0.6,21,9,12,329.87788167498366,0.4449404761904762,0.3285994483604049,0.18654965821585318,129970.32470703137,-1425.132921006931,128545.19178602443,2113,1,269.14,39,11,19,36.668816188238516,0.6145833333333333,45.07812500000001,1019.6875000000009,26.145833333333357,0
2636,4,0,0,50,0.0,0.0,1.0,50,1150,1000,150,0.8695652173913043,13,10,3,332.41880019643617,0.4450340136054422,0.3287674869804962,0.1884989756991142,130076.56385633697,-1352.02094184026,128724.5429144967,2114,2,270.14,39,11,19,36.49641325436537,0.6156517094017093,44.97395833333334,1020.104166666668,26.15651709401713,0
2637,4,1,0,51,0.0196078431372549,0.0,1.0,51,2050,1600,450,0.7804878048780488,25,16,9,329.998165594756,0.44454248366013077,0.3209260879815552,0.18983599045409918,130635.03146701379,-1578.002929687511,129057.02853732627,2115,0,265.8235294117647,39,12,17,35.99322396576321,0.6212606837606838,44.42708333333333,1022.2916666666658,26.212606837606817,0
2638,4,0,1,50,0.0,0.0196078431372549,0.9803921568627451,51,1550,1100,450,0.7096774193548387,20,11,9,329.0189038794929,0.4440686274509804,0.3208113149517302,0.189794806009921,130741.54188368031,-1596.712239583357,129144.82964409696,2116,1,266.8235294117647,39,12,18,35.91065729612278,0.6223290598290598,44.32291666666666,1022.7083333333314,26.22329059829055,0
2639,4,0,0,50,0.0,0.0,1.0,50,2350,1800,550,0.7659574468085106,29,18,11,329.7994807347411,0.4426445578231293,0.3030534351145042,0.19116695564712863,130928.03955078122,-1364.000108506944,129564.03944227428,2117,2,262.7,39,11,18,35.70239609838846,0.624198717948718,44.140625,1023.4374999999998,26.241987179487175,0
2640,4,0,0,50,0.0,0.0,1.0,50,1350,1100,250,0.8148148148148148,16,11,5,327.9246684997969,0.442312925170068,0.30024415055951237,0.1907396148729586,131061.33355034713,-1404.3511284722272,129656.9824218749,2118,3,263.7,39,11,19,35.615886741268234,0.625534188034188,44.010416666666664,1023.9583333333326,26.25534188034186,0
2641,4,0,2,48,0.0,0.04,0.96,50,1100,900,200,0.8181818181818182,13,9,4,327.9037455572269,0.44198979591836735,0.2935680984029361,0.19140692871814752,131197.94894118918,-1395.9402265516455,129802.00871463754,2119,4,264.7,40,10,19,35.4786644843435,0.6252604166666667,43.87703252032521,1024.4918699186999,25.6122967479675,0
2642,4,0,0,48,0.0,0.0,1.0,48,1150,900,250,0.782608695652174,14,9,5,343.93501510101606,0.438635859929078,0.29699076489617093,0.1998744238758661,131027.14913662405,-587.0350966104427,130440.1140400136,2120,5,276.1666666666667,38,10,20,35.24057358516818,0.6269188596491229,44.04380341880341,1023.8247863247843,26.942757534862746,0
2643,4,0,0,48,0.0,0.0,1.0,48,1350,700,650,0.5185185185185185,20,7,13,344.9657663737025,0.43842346335697396,0.29778261549692386,0.20133151148858364,131191.2749858461,-548.7002565929043,130642.5747292532,2121,6,277.1666666666667,38,10,20,35.048406159835935,0.6285635964912281,43.883547008547,1024.4658119658104,26.95962663067922,0
2644,4,1,0,49,0.02040816326530612,0.0,1.0,49,1550,1200,350,0.7741935483870968,19,12,7,340.9668328230768,0.43773030045351474,0.3091234620604413,0.20187001211318173,131739.1030777447,-816.1957137117606,130922.90736403293,2122,0,272.48979591836735,38,11,19,34.598423353106476,0.634046052631579,43.349358974358964,1026.6025641025624,27.01585695006743,0
2645,4,0,0,49,0.0,0.0,1.0,49,1550,1100,450,0.7096774193548387,20,11,9,340.1713895063839,0.4371634070294785,0.3135435992578848,0.20212655987109857,131876.23844875436,-827.8953448024101,131048.34310395195,2123,1,273.48979591836735,38,11,19,34.48074856112613,0.6354166666666667,43.21581196581196,1027.1367521367513,27.029914529914507,0
2646,4,0,0,49,0.0,0.0,1.0,49,1750,1500,250,0.8571428571428571,20,15,5,335.4387357792498,0.43652565192743764,0.3087117295235886,0.20036982110591048,132076.58420138908,-939.279513888868,131137.3046875002,2124,2,274.48979591836735,39,10,19,34.40075665450614,0.6356837606837606,43.02083333333334,1027.9166666666683,26.35683760683765,0
2647,4,0,0,49,0.0,0.0,1.0,49,1600,1200,400,0.75,20,12,8,336.68255412793286,0.4350552721088435,0.3136910530132875,0.20239887931354822,132317.61203342033,-890.1936848958146,131427.41834852452,2125,3,275.48979591836735,39,10,19,34.12652711687083,0.6380876068376069,42.78645833333334,1028.8541666666683,26.38087606837611,0
2648,4,0,0,49,0.0,0.0,1.0,49,1500,1200,300,0.8,18,12,6,336.67434644014224,0.4348426870748299,0.3072006817213453,0.203129740641392,132454.43309479856,-881.1492328168194,131573.28386198173,2126,4,276.48979591836735,37,12,20,33.98931259764235,0.6430180180180181,42.65350877192983,1029.385964912282,27.821242294926538,0
2649,4,0,0,49,0.0,0.0,1.0,49,1950,1600,350,0.8205128205128205,23,16,7,334.15310292941905,0.43478954081632654,0.30167927918532467,0.20236622152263276,132595.5597515582,-938.5564548707241,131657.00329668747,2127,5,277.48979591836735,37,12,21,33.9125545619078,0.6444256756756757,42.516447368421055,1029.934210526316,27.83605974395449,0
2650,4,0,0,49,0.0,0.0,1.0,49,850,300,550,0.35294117647058826,14,3,11,331.5822567084755,0.4341340702947846,0.2700363299441637,0.18879887677890742,130236.65229030345,-1148.857092894798,129087.79519740865,2128,6,278.48979591836735,40,9,18,36.355660095579445,0.615625,44.81707317073171,1020.7317073170736,25.51829268292684,8
2651,4,1,0,50,0.02,0.0,1.0,50,2050,1600,450,0.7804878048780488,25,16,9,335.8244858010854,0.43608843537414965,0.24739752144899918,0.18599782766913317,129152.13647767545,-1325.510035454617,127826.62644222083,2129,0,273.9,42,8,18,37.347870988242775,0.6016865079365079,45.881782945736425,1016.4728682170529,24.20173495754888,8
2652,4,0,1,49,0.0,0.02,0.98,50,1150,700,450,0.6086956521739131,16,7,9,331.78334054933833,0.4358673469387755,0.2481231261243253,0.18422997256030382,129253.05394441125,-1423.1792183043572,127829.8747261069,2130,1,274.9,40,10,19,37.34800786194949,0.6057291666666667,45.782520325203244,1016.8699186991859,25.421747967479646,0
2653,4,0,1,48,0.0,0.02040816326530612,0.9795918367346939,49,1350,700,650,0.5185185185185185,20,7,13,328.277834701532,0.43491354875283444,0.23316565315673854,0.18297921047276655,129403.18720080593,-1303.9603804485098,128099.22682035742,2131,2,272.2857142857143,41,8,19,37.284678887155486,0.6056910569105691,45.63492063492062,1017.4603174603149,24.816105303910117,0
2654,4,0,2,46,0.0,0.041666666666666664,0.9583333333333334,48,1400,800,600,0.5714285714285714,20,8,12,335.00532846984083,0.433344414893617,0.23671443312695573,0.18699795759737914,129459.81744497309,-926.0542666402441,128533.76317833284,2132,3,278.2291666666667,40,8,16,37.05603821316823,0.6078125,45.57926829268292,1017.6829268292671,25.44207317073168,0
2655,4,3,0,49,0.061224489795918366,0.0,1.0,49,1350,1100,250,0.8148148148148148,16,11,5,334.92521482049887,0.4333014455782313,0.2676193707886958,0.18962280182817362,130015.40927716167,-1090.9122235743203,128924.49705358734,2133,0,272.0816326530612,42,7,19,36.49445764053841,0.6103670634920635,45.03391472868216,1019.8643410852701,24.28248431155405,0
2656,4,1,1,49,0.02,0.02,0.98,50,1250,1100,150,0.88,14,11,3,329.36276551436936,0.4350085034013605,0.27567346938775583,0.18766018035121035,130262.58680555545,-1418.3318873565336,128844.25491819892,2134,0,267.62,39,11,20,36.38605442176872,0.6175213675213675,44.791666666666664,1020.8333333333325,26.17521367521365,0
2657,4,0,3,46,0.0,0.061224489795918366,0.9387755102040817,49,1450,1100,350,0.7586206896551724,18,11,7,352.26027437739623,0.4343112244897959,0.2913150871859529,0.18705416367500838,127469.34125940532,-767.4396413178536,126701.90161808748,2135,1,270.7142857142857,38,11,15,38.64966850049371,0.5910087719298245,47.54273504273504,1009.8290598290595,26.574448942869985,8
2658,4,0,0,46,0.0,0.0,1.0,46,1300,900,400,0.6923076923076923,17,9,8,372.1406212151396,0.4292270531400966,0.317051440778773,0.19591530058680628,127120.40323685174,261.3331659362103,127381.73640278795,2136,3,289.2608695652174,36,10,16,38.50642099385817,0.5911458333333333,47.888513513513516,1008.4459459459462,28.012387387387392,0
2659,4,2,0,48,0.041666666666666664,0.0,1.0,48,1700,1100,600,0.6470588235294118,23,11,12,362.09975361725543,0.4345633865248227,0.3375528262017964,0.19396005478139908,127820.21747616693,-343.26614891519495,127476.95132725174,2137,0,278.1666666666667,38,10,17,38.04146856840994,0.5945723684210527,47.19551282051282,1011.2179487179482,26.61099865047232,0
2660,4,2,0,50,0.04,0.0,1.0,50,900,600,300,0.6666666666666666,12,6,6,351.41564976476366,0.4377636054421769,0.3459142412797154,0.19126019825770274,128458.27880245114,-969.9064419048786,127488.37236054626,2138,0,268.0,36,14,16,37.65922387617566,0.6047453703703703,46.56531531531532,1013.7387387387391,28.15940940940942,0
2661,4,1,1,50,0.0196078431372549,0.0196078431372549,0.9803921568627451,51,1150,800,350,0.6956521739130435,15,8,7,359.8342942212766,0.4392320261437908,0.27762710807693525,0.1889280225919725,127011.2307897765,-927.806883926939,126083.42390584956,2139,0,263.72549019607845,38,13,20,38.928855325914164,0.5863486842105263,47.996794871794876,1008.0128205128208,26.52665317139002,8
2662,4,1,1,50,0.0196078431372549,0.0196078431372549,0.9803921568627451,51,1600,1200,400,0.75,20,12,8,317.7583247019227,0.44047385620915036,0.16774788188166911,0.16336148316961083,126151.14239763691,-2164.136921067995,123987.00547656891,2140,0,264.2352941176471,38,13,17,40.871042929561504,0.5775767543859649,48.851495726495735,1004.5940170940181,26.436684660368897,8
2663,4,4,4,50,0.07407407407407407,0.07407407407407407,0.9259259259259259,54,1200,900,300,0.75,15,9,6,299.0852846382305,0.44608956440717445,0.20116170193071103,0.15706129308892053,127018.74441327159,-3202.1125345531914,123816.6318787184,2141,0,250.42592592592592,42,12,16,40.452073119933374,0.580109126984127,47.98934108527133,1008.042635658916,24.001015134736093,0
2664,4,2,0,52,0.038461538461538464,0.0,1.0,52,1700,1000,700,0.5882352941176471,24,10,14,312.88290965445043,0.4429675716440422,0.22719439759477922,0.16493174483794878,127172.82267011817,-2441.9171902318512,124730.90547988632,2142,0,260.88461538461536,38,14,21,39.946774706069256,0.5879934210526316,47.83653846153845,1008.6538461538447,26.54352226720644,0
2665,4,1,0,53,0.018867924528301886,0.0,1.0,53,1050,600,450,0.5714285714285714,15,6,9,375.0870621415219,0.44495343492985,0.35239737896238577,0.18802544164310533,125106.8604353859,-1182.7044068230148,123924.15602856288,2143,0,256.9433962264151,38,15,15,40.51197849921685,0.5668859649122807,49.893162393162385,1000.427350427349,26.327035537561816,8
2666,4,2,3,52,0.03636363636363636,0.05454545454545454,0.9454545454545454,55,2100,1500,600,0.7142857142857143,27,15,12,365.67936279173443,0.4488215488215488,0.3740192949173271,0.18626619834696323,125770.0314645532,-1801.699007149178,123968.33245740403,2144,0,248.56363636363636,41,14,15,40.06105149507137,0.5688516260162602,49.231150793650784,1003.0753968253952,24.4652535811072,0
2667,4,4,4,52,0.07142857142857142,0.07142857142857142,0.9285714285714286,56,1300,1000,300,0.7692307692307693,16,10,6,363.4490999099984,0.45336850649350646,0.4213464530628708,0.19048421113676242,126938.35101460772,-1971.6832460698135,124966.6677685379,2145,0,241.51785714285714,40,16,18,38.91270001344628,0.5822916666666667,48.06910569105691,1007.7235772357724,25.19308943089431,0
2668,4,0,0,52,0.0,0.0,1.0,52,1350,1100,250,0.8148148148148148,16,11,5,387.37360098418685,0.45016339869281047,0.421046344959388,0.20118435405952945,126567.38281250012,-594.2274305555408,125973.15538194457,2146,1,253.6153846153846,37,15,18,38.692632850241544,0.5836148648648649,48.43750000000001,1006.2500000000009,27.195945945945972,0
2669,4,1,1,52,0.018867924528301886,0.018867924528301886,0.9811320754716981,53,2350,2000,350,0.851063829787234,27,20,7,375.9141370218784,0.4524673439767779,0.41686280119111063,0.19691386744359063,126917.01630015444,-1058.019868827145,125858.9964313273,2147,0,249.81132075471697,41,12,19,38.62063519411902,0.5805386178861789,48.090277777777786,1007.6388888888898,24.57655826558268,0
2670,4,3,1,54,0.05454545454545454,0.01818181818181818,0.9818181818181818,55,1350,1100,250,0.8148148148148148,16,11,5,334.1505673340538,0.4550925925925926,0.3776097035134929,0.17235921605947963,126287.21160274305,-2554.183155601304,123733.02844714174,2148,0,240.16363636363636,42,13,17,40.31941900446674,0.5726686507936508,48.71608527131782,1005.1356589147272,23.9318014027316,8
2671,4,3,0,57,0.05263157894736842,0.0,1.0,57,1600,1000,600,0.625,22,10,12,325.4764562945624,0.45787646198830406,0.38888459208270487,0.1710322227864475,127045.3360768174,-3129.946844993161,123915.38923182424,2149,0,231.89473684210526,44,13,20,39.75975079598334,0.5776515151515151,47.962962962962955,1008.1481481481469,22.912457912457885,0
2672,4,1,0,58,0.017241379310344827,0.0,1.0,58,1250,800,450,0.64,17,8,9,324.67490475129154,0.4581883948376689,0.40665946456468904,0.1721212908778474,127402.53318877664,-3327.1017875957527,124075.43140118089,2150,0,228.8793103448276,43,15,17,39.41439592908732,0.5826065891472868,47.6089015151515,1009.5643939393913,23.478241719520728,0
2673,4,0,0,58,0.0,0.0,1.0,58,2150,1600,550,0.7441860465116279,27,16,11,326.77543733943406,0.45784810445654367,0.40551136309766544,0.17400911648660586,127582.6485339502,-3261.8248456790557,124320.82368827114,2151,1,229.8793103448276,44,14,17,39.177206488864435,0.5830965909090908,47.430555555555536,1010.2777777777744,22.96085858585851,0
2674,4,0,1,57,0.0,0.017241379310344827,0.9827586206896551,58,1650,1200,450,0.7272727272727273,21,12,9,327.47607533916704,0.4575582274652148,0.4056494105457349,0.17488888641890127,127699.60562414242,-3236.2868655692964,124463.31875857312,2152,2,230.8793103448276,44,14,17,39.03997954073529,0.584280303030303,47.3148148148148,1010.7407407407388,22.971380471380428,0
2675,4,1,3,55,0.017241379310344827,0.05172413793103448,0.9482758620689655,58,1950,1600,350,0.8205128205128205,23,16,7,323.67375848117456,0.45834593668078244,0.40023737571729834,0.17408567915229625,127984.0855797755,-3314.9819989235702,124669.10358085194,2153,0,224.1206896551724,45,13,18,38.84565317936322,0.5858796296296296,47.03351449275361,1011.8659420289833,22.485909822866297,0
2676,4,0,4,51,0.0,0.07272727272727272,0.9272727272727272,55,1400,900,500,0.6428571428571429,19,9,10,343.6778496808986,0.4567340067340067,0.3336702371143463,0.18172103553414892,127297.04231112402,-2224.1994722142445,125072.84283890978,2154,1,236.61818181818182,40,15,19,39.042883517959034,0.5859375,47.713414634146325,1009.1463414634121,25.228658536585304,7
2677,4,3,1,53,0.05555555555555555,0.018518518518518517,0.9814814814814815,54,1300,1000,300,0.7692307692307693,16,10,6,351.8559926164004,0.45556720242254833,0.36705749442765145,0.1880182022218913,127723.00347222202,-1811.979166666686,125911.02430555533,2155,0,227.4814814814815,39,15,16,38.39997251992306,0.5918803418803419,47.29166666666666,1010.8333333333317,25.918803418803375,0
2678,4,1,1,53,0.018518518518518517,0.018518518518518517,0.9814814814814815,54,1750,1200,550,0.6857142857142857,23,12,11,351.8825648406886,0.45381289308176104,0.36377256927418755,0.1889492634902838,127918.62643494853,-1797.533127834513,126121.09330711402,2156,0,228.46296296296296,41,13,17,38.199041384720985,0.5907012195121951,47.09821428571426,1011.6071428571393,24.673344947735103,0
2679,4,2,2,53,0.03636363636363636,0.03636363636363636,0.9636363636363636,55,1350,1200,150,0.8888888888888888,15,12,3,347.3350632366784,0.45523288439955106,0.3649462718698122,0.1879229772104635,128221.7151249256,-2092.421896814946,126129.29322811065,2157,0,225.12727272727273,40,15,19,38.00421432871763,0.5953125,46.798780487804876,1012.8048780487802,25.320121951219505,0
2680,4,0,2,51,0.0,0.03773584905660377,0.9622641509433962,53,1650,900,750,0.5454545454545454,24,9,15,349.4310767203898,0.45456881954523465,0.3547259047735907,0.18214565986827094,126717.16668438206,-1740.4884484715492,124976.67823591051,2158,1,229.71698113207546,41,12,15,39.49311508523008,0.5785060975609756,48.288690476190474,1006.8452380952378,24.557200929152142,8
2681,4,2,1,52,0.03773584905660377,0.018867924528301886,0.9811320754716981,53,1250,1100,150,0.88,14,11,3,343.02552929219695,0.4555212868892114,0.36541357012767417,0.18035015282962202,127067.00685193043,-1882.5545438082797,125184.45230812216,2159,0,230.49056603773585,41,12,17,39.2952171274886,0.5820630081300813,47.941468253968246,1008.2341269841257,24.591076267905507,0
2682,4,2,2,52,0.037037037037037035,0.037037037037037035,0.962962962962963,54,1200,700,500,0.5833333333333334,17,7,10,342.39383245695234,0.4577291521080829,0.3847797559590256,0.18217972345979092,127550.26989051428,-2065.505010353918,125484.76488016036,2160,0,227.12962962962962,38,16,15,38.81588224925082,0.5918311403508771,47.462606837606835,1010.1495726495726,26.582883490778226,0
2683,4,1,3,50,0.018867924528301886,0.05660377358490566,0.9433962264150944,53,1950,1100,850,0.5641025641025641,28,11,17,347.7801268498945,0.4574715771649734,0.39237703937133506,0.18566591422121906,127685.20801373365,-1718.7244320257123,125966.48358170793,2161,0,232.0,38,15,17,38.54166666666668,0.5932017543859649,47.32905982905983,1010.6837606837605,26.596941070625277,0
2684,4,0,0,50,0.0,0.0,1.0,50,1950,1500,450,0.7692307692307693,24,15,9,348.4844517785606,0.454328231292517,0.34742371572035524,0.17795389460644828,125873.61411573821,-1209.102936298034,124664.51117944017,2162,1,246.6,42,8,18,40.385404596369256,0.5684523809523809,49.127906976744185,1003.488372093023,23.89258028792912,8
2685,4,0,0,50,0.0,0.0,1.0,50,1300,1000,300,0.7692307692307693,16,10,6,348.7208523765961,0.45434523809523814,0.3486464568449512,0.17828482669875512,125922.23743314695,-1217.6580058289867,124704.57942731796,2163,2,247.6,42,8,18,40.329334813670606,0.5689484126984127,49.07945736434108,1003.6821705426348,23.8971945367294,0
2686,4,3,0,53,0.05660377358490566,0.0,1.0,53,1350,800,550,0.5925925925925926,19,8,11,340.300376050285,0.45887760038703435,0.37285928449140004,0.17766786938118714,126781.87346655478,-1971.0987883472494,124810.77467820753,2164,0,234.52830188679246,43,10,19,39.656499764927126,0.5763081395348837,48.22443181818182,1007.102272727273,23.420983086680767,0
2687,4,3,5,51,0.05357142857142857,0.08928571428571429,0.9107142857142857,56,1350,1100,250,0.8148148148148148,16,11,5,331.79274518894596,0.4602137445887446,0.3977488902980342,0.17736852852981944,127739.20323800114,-2720.380797451405,125018.82244054973,2165,0,222.91071428571428,38,18,16,38.8904301416191,0.59375,47.275641025641015,1010.8974358974344,26.602564102564063,0
2688,4,1,2,50,0.019230769230769232,0.038461538461538464,0.9615384615384616,52,1500,1300,200,0.8666666666666667,17,13,4,349.72263929240364,0.4592760180995475,0.4043218871612009,0.18658804786028724,127660.40322417018,-1470.8533702621462,126189.54985390803,2166,0,237.17307692307693,36,16,19,38.517987148057365,0.5966435185185186,47.35360360360361,1010.585585585586,28.071821821821835,0
2689,4,0,0,50,0.0,0.0,1.0,50,1250,900,350,0.72,16,9,7,360.3876938331439,0.45651360544217684,0.40114478114478125,0.1910241506690705,127396.243615824,-817.5923120575676,126578.65130376644,2167,1,247.58,37,13,19,38.51949151008289,0.5920608108108107,47.61513157894736,1009.5394736842097,27.284850640113778,0
2690,4,2,0,52,0.038461538461538464,0.0,1.0,52,1600,1200,400,0.75,20,12,8,368.5223222983076,0.4602972599296129,0.43593285167870843,0.19930193234530846,128204.80619331062,-939.7775232842466,127265.02867002638,2168,0,239.01923076923077,34,18,21,37.485061322048516,0.6063112745098039,46.81547619047619,1012.738095238095,29.786414565826323,0
2691,4,1,0,53,0.018867924528301886,0.0,1.0,53,1200,700,500,0.5833333333333334,17,7,10,353.8090047788122,0.46097907595549104,0.42235842098671483,0.19287772914162585,128523.41666894947,-1505.4515715172836,127017.96509743218,2169,0,235.49056603773585,38,15,16,37.53204790503284,0.6016995614035088,46.501068376068375,1013.9957264957261,26.684098065677002,0
2692,4,1,1,53,0.018518518518518517,0.018518518518518517,0.9814814814814815,54,1050,700,350,0.6666666666666666,14,7,7,348.4938198765905,0.46175460051246214,0.42051875410857664,0.1915831507240346,128857.43408203148,-1818.7961154513623,127038.63796658012,2170,0,232.11111111111111,39,15,17,37.32612171266374,0.6033653846153846,46.171875000000014,1015.3125000000018,26.033653846153893,0
2693,4,1,1,53,0.018518518518518517,0.018518518518518517,0.9814814814814815,54,1600,1000,600,0.625,22,10,12,350.5369734928783,0.461019392033543,0.4195159545299598,0.19337569464872045,128994.83194527085,-1756.5084027364446,127238.3235425344,2171,0,233.05555555555554,40,14,18,37.134228691476594,0.603125,46.03658536585367,1015.8536585365869,25.39634146341467,0
2694,4,0,2,51,0.0,0.03773584905660377,0.9622641509433962,53,1300,600,700,0.46153846153846156,20,6,14,358.49716602745735,0.4600266086115143,0.42416574769249293,0.197252405448588,128891.61544054485,-1358.544227972748,127533.0712125721,2172,1,238.35849056603774,40,13,18,37.03733820389645,0.6020833333333333,46.13821138211383,1015.4471544715464,25.386178861788657,0
2695,4,0,1,50,0.0,0.0196078431372549,0.9803921568627451,51,1400,1100,300,0.7857142857142857,17,11,6,365.46336125915684,0.45877450980392154,0.4151798857681208,0.20082392623646764,128840.02267995264,-782.7384493356842,128057.28423061696,2173,2,246.11764705882354,40,11,19,36.91316316316317,0.6015625,46.189024390243915,1015.2439024390262,25.381097560975654,0
2696,4,0,0,50,0.0,0.0,1.0,50,1700,1100,600,0.6470588235294118,23,11,12,362.99158211318183,0.457797619047619,0.40194038807761534,0.2005077258545632,129046.45568940455,-631.4445766408744,128415.01111276368,2174,3,243.04,40,10,19,36.76526972061079,0.6036458333333333,45.98577235772358,1016.0569105691065,25.401422764227664,0
2697,4,0,0,50,0.0,0.0,1.0,50,1650,1200,450,0.7272727272727273,21,12,9,364.48535339962393,0.45727891156462586,0.4034426229508199,0.20212369597615495,129201.38888888879,-581.3183703483454,128620.07051854044,2175,4,244.04,37,13,19,36.56933060109291,0.6103603603603603,45.83333333333333,1016.6666666666658,27.477477477477454,0
2698,4,0,0,50,0.0,0.0,1.0,50,1300,800,500,0.6153846153846154,18,8,10,365.1184474989168,0.45654761904761904,0.40544357011965126,0.2031915919284614,129340.77222077946,-555.0596096875942,128785.71261109186,2176,5,245.04,37,13,19,36.41117369120766,0.6117680180180181,45.69627192982456,1017.2149122807016,27.492294926505448,0
2699,4,2,1,51,0.038461538461538464,0.019230769230769232,0.9807692307692307,52,1350,700,650,0.5185185185185185,20,7,13,355.2001096223291,0.4576734539969834,0.41712365359081716,0.20114310429798885,130023.4388563369,-1163.1320529513805,128860.30680338552,2177,0,236.57692307692307,39,13,16,35.969363871582765,0.6151175213675213,45.02604166666667,1019.8958333333342,26.151175213675234,0
2700,4,0,0,51,0.0,0.0,1.0,51,1350,900,450,0.6666666666666666,18,9,9,359.0899659904229,0.456062091503268,0.4208939467690289,0.2034558994249595,130044.55133912269,-860.4612964789259,129184.09004264376,2178,1,242.09803921568627,38,13,17,35.84873956914912,0.6170504385964912,45.00534188034188,1019.9786324786328,26.84154295996402,0
2701,4,0,0,51,0.0,0.0,1.0,51,1900,1500,400,0.7894736842105263,23,15,8,356.4278762531145,0.45485294117647057,0.4109883503417915,0.20338146972857035,130320.07250070991,-909.6934083085212,129410.37909240139,2179,2,243.09803921568627,36,15,18,35.63701702143303,0.6235532407407407,44.735360360360346,1021.0585585585565,28.362737737737678,0
2702,4,0,0,51,0.0,0.0,1.0,51,1850,1400,450,0.7567567567567568,23,14,9,354.72060159004945,0.454640522875817,0.4036223054210415,0.20313041456757758,130458.54403518375,-944.7333554555412,129513.81067972821,2180,3,244.09803921568627,37,14,18,35.54020875818396,0.6230292792792793,44.599780701754376,1021.6008771929812,27.610834518729224,0
2703,4,0,0,51,0.0,0.0,1.0,51,1300,1000,300,0.7692307692307693,16,10,6,355.1602241966692,0.4543464052287582,0.4033144638608581,0.20397094576322558,130570.58572108716,-925.3043003616624,129645.2814207255,2181,4,245.09803921568627,37,14,15,35.41543736365911,0.6241554054054055,44.49013157894736,1022.0394736842098,27.622688477951616,0
2704,4,0,0,51,0.0,0.0,1.0,51,1300,700,600,0.5384615384615384,19,7,12,356.9923223196075,0.4540522875816993,0.4065945623046481,0.20517154307419092,130598.60365689419,-875.4602377654905,129723.1434191287,2182,5,246.09803921568627,37,14,15,35.34023457054996,0.6244369369369369,44.4627192982456,1022.1491228070156,27.62565196775718,0
2705,4,0,0,51,0.0,0.0,1.0,51,1550,1100,450,0.7096774193548387,20,11,9,360.80988940507115,0.4537745098039216,0.41332021659435725,0.20826947081500582,130766.77439212028,-763.6109187442698,130003.16347337601,2183,6,247.09803921568627,37,14,15,35.07227344196684,0.6261261261261262,44.29824561403507,1022.8070175438567,27.64343290659072,0
2706,4,0,0,51,0.0,0.0,1.0,51,1450,700,750,0.4827586206896552,22,7,15,359.7745203865308,0.4535457516339869,0.409732685272159,0.20812498758380132,130850.90033712279,-784.6360178131948,130066.26431930959,2184,7,248.09803921568627,37,14,15,35.01355249526668,0.6269707207207207,44.216008771929815,1023.1359649122793,27.652323376007548,0
2707,4,0,1,50,0.0,0.0196078431372549,0.9803921568627451,51,1050,700,350,0.6666666666666666,14,7,7,356.2277448232882,0.45351307189542484,0.40047075197511206,0.20657759052101077,130945.1247351887,-870.7427039959211,130074.38203119278,2185,8,249.09803921568627,38,13,15,35.00891614474601,0.6260964912280702,44.12393162393162,1023.5042735042724,26.934322986954538,0
2708,4,0,1,49,0.0,0.02,0.98,50,1850,1200,650,0.6486486486486487,25,12,13,364.95087164400036,0.4520408163265306,0.40219810040705584,0.21178645070994334,130972.46334876529,-440.2970679012494,130532.16628086404,2186,9,254.76,38,12,16,34.75802804161012,0.6263706140350878,44.097222222222214,1023.6111111111101,26.93713450292395,0
2709,4,0,1,48,0.0,0.02040816326530612,0.9795918367346939,49,1200,800,400,0.6666666666666666,16,8,8,363.8006207533975,0.4526821145124717,0.393714311937432,0.211684361197257,131075.36844269373,-262.9399190135641,130812.42852368017,2187,10,245.89795918367346,37,12,19,34.68329496377199,0.629222972972973,43.99671052631578,1024.0131578947353,27.676031294452304,0
2710,4,0,0,48,0.0,0.0,1.0,48,1550,1100,450,0.7096774193548387,20,11,9,369.429803650143,0.4520722517730496,0.39627502944640813,0.21495980911455956,131075.36844269373,84.62952543088073,131159.9979681246,2188,11,251.5625,37,11,19,34.539186029910404,0.629222972972973,43.99671052631578,1024.0131578947353,27.676031294452304,0
2711,4,1,0,49,0.02040816326530612,0.0,1.0,49,1600,1200,400,0.75,20,12,8,358.9133452310134,0.45365646258503406,0.3872573419611749,0.21022067363530772,131328.12499999985,-372.9166666666821,130955.20833333317,2189,0,247.40816326530611,38,11,20,34.552845528455286,0.6299342105263157,43.74999999999999,1024.9999999999989,26.973684210526287,0
2712,4,0,0,49,0.0,0.0,1.0,49,1550,1200,350,0.7741935483870968,19,12,7,358.1383580772217,0.45282383786848074,0.3867047131417689,0.21036792905906804,131437.65637555695,-385.4267112279964,131052.22966432896,2190,1,248.40816326530611,38,11,20,34.46204070292421,0.6310307017543859,43.64316239316239,1025.42735042735,26.984930274403943,0
2713,4,0,1,48,0.0,0.02040816326530612,0.9795918367346939,49,1250,1000,250,0.8,15,10,5,325.25065682836106,0.4523809523809524,0.25078146497710585,0.18763340913506288,130744.07837498418,-1222.1604354745994,129521.91793950959,2191,2,249.40816326530611,41,8,17,36.00444191159828,0.6191565040650406,44.320436507936506,1022.7182539682534,24.94434765776228,7
2714,4,0,0,48,0.0,0.0,1.0,48,1400,1200,200,0.8571428571428571,16,12,4,330.8677711566693,0.4501883865248227,0.2596166278769072,0.19125047400042428,130820.18455530347,-943.1634227765328,129877.02113252693,2192,15,255.5625,41,7,19,35.78395720196535,0.6199186991869918,44.24603174603174,1023.015873015872,24.95160665892371,0
2715,4,0,2,46,0.0,0.041666666666666664,0.9583333333333334,48,1000,500,500,0.5,15,5,10,330.1464892430052,0.4498190011820331,0.25805943377932916,0.19108478619822414,130870.93431122445,-958.6840986394614,129912.25021258499,2193,16,256.5625,41,7,19,35.75116346713205,0.6204268292682926,44.19642857142857,1023.2142857142853,24.95644599303135,0
2716,4,1,0,47,0.02127659574468085,0.0,1.0,47,1300,900,400,0.6923076923076923,17,9,8,328.8581437419308,0.4504509713228492,0.26040523589094167,0.19125173389768751,131055.13232565651,-780.2904911062982,130274.84183455021,2194,0,256.6170212765957,42,5,20,35.59824611211005,0.6207837301587302,44.01647286821706,1023.9341085271318,24.37938353636028,0
2717,4,0,0,47,0.0,0.0,1.0,47,1500,1000,500,0.6666666666666666,20,10,10,332.0555160179432,0.45012334258402714,0.26265896046849146,0.19336059222003535,131104.74623107087,-693.1891675680537,130411.55706350281,2195,1,257.6170212765957,42,5,20,35.466340240325486,0.6212797619047619,43.968023255813954,1024.1279069767443,24.383997785160577,0
2718,4,0,0,47,0.0,0.0,1.0,47,1100,800,300,0.7272727272727273,14,8,6,335.82258884809033,0.44931390687634903,0.27252955082742325,0.19631419994851074,131253.64428407256,-584.4122761552683,130669.2320079173,2196,2,258.6170212765957,42,5,20,35.21966115051221,0.6227678571428572,43.822674418604656,1024.7093023255823,24.39784053156148,0
2719,4,0,2,45,0.0,0.0425531914893617,0.9574468085106383,47,1500,1000,500,0.6666666666666666,20,10,10,332.55326456323286,0.4487935553499846,0.2657391033650838,0.1950529934345254,131381.5158420138,-661.6662218410158,130719.84962017277,2197,3,259.6170212765957,39,8,20,35.1745072139809,0.6287393162393162,43.697916666666664,1025.2083333333326,26.287393162393144,0
2720,4,0,1,44,0.0,0.022222222222222223,0.9777777777777777,45,650,400,250,0.6153846153846154,9,4,5,341.7278075219779,0.4486111111111111,0.28075880758807603,0.2001548586914438,131328.12499999974,-24.305555555585784,131303.81944444415,2198,4,269.4888888888889,38,7,20,34.99322493224931,0.6299342105263157,43.749999999999986,1024.999999999998,26.97368421052626,0
2721,4,0,0,44,0.0,0.0,1.0,44,1100,700,400,0.6363636363636364,15,7,8,344.37173640029107,0.4485663319238901,0.27420546932742074,0.20170344560588438,131328.12499999974,245.13888888885924,131573.26388888858,2199,5,239.54545454545453,37,7,20,34.92547425474254,0.6317567567567568,43.749999999999986,1024.999999999998,27.70270270270265,0
2722,4,1,1,44,0.022222222222222223,0.022222222222222223,0.9777777777777777,45,1200,1000,200,0.8333333333333334,14,10,4,341.67043474155946,0.4490530303030303,0.27316260670414305,0.2018503195650319,131656.8560979618,-3.3489480604955872,131653.5071499013,2200,0,235.2,38,7,17,34.66323131376222,0.6332236842105263,43.429487179487175,1026.2820512820508,27.007422402159232,0
2723,4,0,1,43,0.0,0.022727272727272728,0.9772727272727273,44,1500,1200,300,0.8,18,12,6,351.86305903897374,0.4477074524312896,0.27402658260202784,0.20742424530087566,131574.6348002958,459.25069855357344,132033.88549884938,2201,7,241.54545454545453,38,6,17,34.48466625013017,0.6324013157894737,43.50961538461538,1025.9615384615379,26.998987854251,0
2724,4,0,1,42,0.0,0.023255813953488372,0.9767441860465116,43,900,700,200,0.7777777777777778,11,7,4,359.7642267514067,0.4469822812846069,0.2808785529715767,0.21258795217128545,131665.51246537376,873.7082563865613,132539.22072176033,2202,8,246.69767441860466,37,6,17,34.19025997150998,0.6351351351351351,43.42105263157894,1026.3157894736826,27.738264580369798,0
2725,4,0,0,42,0.0,0.0,1.0,42,1200,800,400,0.6666666666666666,16,8,8,342.07889877688797,0.44631968641114983,0.21896593355218896,0.18929727240375946,129117.7949585448,435.7264975761608,129553.52145612096,2203,9,250.42857142857142,37,5,19,37.22387798036465,0.6095157657657657,45.91557017543859,1016.3377192982445,27.46858700806066,8
2726,4,0,0,42,0.0,0.0,1.0,42,1000,600,400,0.6,14,6,8,343.0874567241712,0.4461382113821138,0.21423825344091085,0.19053380899257513,129258.63997443412,469.4306612835942,129728.07063571771,2204,10,251.42857142857142,36,6,20,37.05495570321151,0.6128472222222222,45.77702702702704,1016.8918918918937,28.246996996997048,0
2727,4,0,0,42,0.0,0.0,1.0,42,900,700,200,0.7777777777777778,11,7,4,340.41932783592483,0.44575106465350367,0.21748289789026964,0.1897147713507236,129396.54659366346,409.8170831409712,129806.36367680442,2205,11,252.42857142857142,37,5,20,36.982590616804984,0.6123310810810811,45.641447368421055,1017.434210526316,27.498221906116648,0
2728,4,0,2,40,0.0,0.047619047619047616,0.9523809523809523,42,1100,700,400,0.6363636363636364,15,7,8,344.2852134394333,0.44582365466511803,0.2219734851398827,0.19268765562297382,129563.94184989604,521.3898747691476,130085.33172466519,2206,12,253.42857142857142,37,5,15,36.71412224017232,0.6140202702702703,45.47697368421052,1018.0921052631572,27.516002844950197,0
2729,4,0,0,40,0.0,0.0,1.0,40,1450,1300,150,0.896551724137931,16,13,3,347.04723249282864,0.4446047008547009,0.22590351176270107,0.19462514969435307,129643.02722318674,998.4507619598799,130641.47798514662,2207,13,262.65,35,5,17,36.56345891578588,0.61875,45.39930555555556,1018.4027777777778,29.097222222222225,0
2730,4,1,0,41,0.024390243902439025,0.0,1.0,41,1300,1000,300,0.7692307692307693,16,10,6,341.73966094701433,0.4458333333333333,0.2255787766625179,0.19314050500713298,129946.64216581453,681.5842869896994,130628.22645280423,2208,0,257.219512195122,36,5,18,36.390453574847214,0.6197916666666667,45.101351351351354,1019.5945945945952,28.32207207207209,0
2731,4,0,1,40,0.0,0.024390243902439025,0.975609756097561,41,1250,1100,150,0.88,14,11,3,346.5577689113891,0.4452997967479675,0.2343660394325544,0.19658527417459457,130090.20580969493,816.7542965262668,130906.9601062212,2209,1,258.219512195122,36,5,18,36.121996541192914,0.6212384259259259,44.96058558558559,1020.1576576576584,28.337712712712733,0
2732,4,1,1,40,0.024390243902439025,0.024390243902439025,0.975609756097561,41,1050,700,350,0.6666666666666666,14,7,7,346.46802107052395,0.446239837398374,0.23578132736314084,0.1972604361170372,130233.84871357857,824.3727680383229,131058.22148161689,2210,0,256.7317073170732,36,5,19,35.978642615475145,0.6226851851851851,44.81981981981983,1020.7207207207217,28.35335335335338,0
2733,4,0,0,40,0.0,0.0,1.0,40,1250,700,550,0.56,18,7,11,347.0001685271531,0.4444043803418803,0.2318555240793203,0.198462507274927,130410.31867551856,1050.4836820170558,131460.8023575356,2211,1,262.425,35,5,20,35.78623701605288,0.6264880952380952,44.64699074074073,1021.412037037036,29.18320105820103,0
2734,4,0,0,40,0.0,0.0,1.0,40,900,300,600,0.3333333333333333,15,3,12,347.0111527794665,0.4443108974358974,0.22856778797145805,0.19907481922611484,130528.56445312485,1058.973524305541,131587.5379774304,2212,2,263.425,35,5,16,35.66619945633708,0.6276785714285714,44.53124999999999,1021.8749999999989,29.196428571428537,0
2735,4,0,0,40,0.0,0.0,1.0,40,1050,600,450,0.5714285714285714,15,6,9,347.0732561316116,0.44421741452991453,0.2278992072480186,0.19926247409896805,130558.1342699759,1062.6473551097276,131620.78162508563,2213,3,264.425,35,5,17,35.634673461683654,0.6279761904761905,44.50231481481481,1021.99074074074,29.199735449735428,0
2736,4,1,1,40,0.024390243902439025,0.024390243902439025,0.975609756097561,41,1150,800,350,0.6956521739130435,15,8,7,335.60214090987307,0.44435975609756095,0.22746116290551321,0.1949917355118533,131019.23338190593,594.0670446675824,131613.30042657352,2214,0,258.9512195121951,37,4,18,35.461849809003596,0.6286599099099099,44.051535087719294,1023.7938596491224,27.670104314841147,0
2737,4,0,2,38,0.0,0.05,0.95,40,850,600,250,0.7058823529411765,11,6,5,344.22714212209866,0.44324252136752135,0.2377420774647887,0.1995112415564818,130924.4379514651,1013.5490219949797,131937.98697346007,2215,1,266.325,36,4,18,35.33689113849766,0.6296296296296297,44.14414414414415,1023.4234234234243,28.428428428428454,0
2738,4,1,1,38,0.02564102564102564,0.02564102564102564,0.9743589743589743,39,1300,900,400,0.6923076923076923,17,9,8,348.7632143428011,0.44348852901484476,0.22902427288590532,0.2027042965884638,131031.70680084024,1339.8078489369068,132371.51464977715,2216,0,266.6923076923077,35,4,20,35.11238601251036,0.6327380952380952,44.039351851851855,1023.842592592593,29.252645502645514,0
2739,4,0,0,38,0.0,0.0,1.0,38,850,600,250,0.7058823529411765,11,6,5,356.06222890928143,0.4415896159317212,0.23451517099905028,0.20608450218688734,130870.93431122461,1719.639314058967,132590.57362528358,2217,1,274.5,34,4,20,35.08822959084739,0.6332720588235294,44.19642857142858,1023.2142857142867,30.094537815126078,0
2740,4,0,0,38,0.0,0.0,1.0,38,1100,900,200,0.8181818181818182,13,9,4,354.8848786533567,0.4412932669511617,0.22563777773698224,0.20638031381322006,131053.71492346957,1701.796343537435,132755.511267007,2218,2,275.5,34,4,22,34.933437972328804,0.6351102941176471,44.01785714285715,1023.9285714285729,30.115546218487438,0
2741,4,0,0,38,0.0,0.0,1.0,38,1100,700,400,0.6363636363636364,15,7,8,353.00767203949323,0.44105618776671407,0.22195306956372773,0.20577764296936318,131145.15306122453,1659.0490362811838,132804.2020975057,2219,3,276.5,34,4,23,34.889053540988684,0.6360294117647058,43.92857142857143,1024.2857142857147,30.126050420168077,0
2742,4,0,0,38,0.0,0.0,1.0,38,1350,1000,350,0.7407407407407407,17,10,7,353.78929084727974,0.44033013276434324,0.22453409313245976,0.206889824430257,131267.1201814059,1688.180272108844,132955.30045351473,2220,4,277.5,34,4,23,34.74577912019828,0.6372549019607843,43.80952380952381,1024.7619047619046,30.14005602240896,0
2743,4,0,0,38,0.0,0.0,1.0,38,950,600,350,0.631578947368421,13,6,7,354.94505219675096,0.4397522522522523,0.22972598861169646,0.20806694895766104,131359.53006355738,1725.097223325619,133084.627286883,2221,5,278.5,33,5,23,34.62280832835225,0.6404671717171717,43.719362745098046,1025.1225490196086,31.064319667260868,0
2744,4,0,1,37,0.0,0.02631578947368421,0.9736842105263158,38,1450,1000,450,0.6896551724137931,19,10,9,354.45302318543935,0.43884838786154573,0.22538514745645477,0.20863374149522682,131516.6116998268,1723.2921232218173,133239.90382304863,2222,6,279.5,33,5,23,34.476802070888084,0.6420454545454546,43.566176470588225,1025.7352941176457,31.08288770053472,0
2745,4,0,1,36,0.0,0.02702702702702703,0.972972972972973,37,1300,1000,300,0.7692307692307693,16,10,6,364.2610539600372,0.4391891891891892,0.22428338941083759,0.21389472300863743,131425.20732897127,2174.616907713472,133599.82423668474,2223,7,279.4864864864865,32,5,23,34.317664080778236,0.6435546875,43.65530303030302,1025.3787878787857,32.043087121212054,0
2746,4,0,0,36,0.0,0.0,1.0,36,1050,700,350,0.6666666666666666,14,7,7,367.3856000000001,0.4380952380952381,0.22777777777777786,0.21646178390137755,131554.70623214444,2466.2609363840083,134020.96716852844,2224,8,284.1111111111111,32,4,20,34.10666666666665,0.6448567708333333,43.52904040404039,1025.8838383838365,32.05886994949489,0
2747,4,0,0,36,0.0,0.0,1.0,36,1300,900,400,0.6923076923076923,17,9,8,367.2266133594768,0.43821097883597887,0.22989802055992992,0.21691990649606271,131651.87225793264,2469.214238342995,134121.08649627565,2225,9,285.1111111111111,32,4,21,34.01256971784776,0.6458333333333333,43.43434343434342,1026.2626262626245,32.070707070707016,0
2748,4,0,0,36,0.0,0.0,1.0,36,900,500,400,0.5555555555555556,13,5,8,366.76109563573465,0.43786375661375665,0.22813849264906927,0.21738347155319146,131781.48275686117,2466.4642000815843,134247.94695694276,2226,10,286.1111111111111,32,4,21,33.893619855714064,0.6471354166666667,43.30808080808079,1026.7676767676737,32.086489898989804,0
2749,4,1,0,37,0.02702702702702703,0.0,1.0,37,1350,1100,250,0.8148148148148148,16,11,5,359.9835423631932,0.43634259259259256,0.23575863756988658,0.21578442053656532,132208.8860053824,2118.6046232218214,134327.49062860422,2227,0,279.35135135135135,33,4,22,33.636697648554176,0.648989898989899,42.89215686274509,1028.4313725490185,31.164587046939957,0
2750,4,0,1,36,0.0,0.02702702702702703,0.972972972972973,37,1150,700,450,0.6086956521739131,16,7,9,361.0501822642532,0.43609234234234234,0.2369775064557058,0.21678506651832163,132271.91014273337,2151.3594530949445,134423.26959582831,2228,1,280.35135135135135,33,4,22,33.54578667302043,0.6496212121212122,42.83088235294117,1028.6764705882338,31.172014260249508,0
2751,4,0,0,36,0.0,0.0,1.0,36,1100,800,300,0.7272727272727273,14,8,6,371.2223050502564,0.4334490740740741,0.24996028909538603,0.22289270590785765,132271.9101427334,2620.456675317167,134892.36681805056,2229,2,288.80555555555554,33,3,23,33.28419108887301,0.6496212121212122,42.83088235294117,1028.676470588234,31.172014260249515,0
2752,4,0,0,36,0.0,0.0,1.0,36,1750,1300,450,0.7428571428571429,22,13,9,371.58452031667446,0.4332837301587302,0.25134952766531704,0.2238570158980944,132398.00347222236,2639.4697952710685,135037.47326749342,2230,3,289.80555555555554,32,4,23,33.14777327935223,0.6533203125,42.70833333333334,1029.1666666666679,32.16145833333337,0
2753,4,0,0,36,0.0,0.0,1.0,36,650,500,150,0.7692307692307693,8,5,3,370.83773128998496,0.43285383597883603,0.2495025079053539,0.22359979182514486,132430.49178655245,2622.044625548425,135052.53641210086,2231,4,290.80555555555554,32,4,23,33.13425130847235,0.6536458333333333,42.67676767676768,1029.2929292929298,32.165404040404056,0
2754,4,0,0,36,0.0,0.0,1.0,36,1450,1100,350,0.7586206896551724,18,11,7,370.50313871979887,0.4321759259259259,0.25295660467334224,0.22397724953743253,132527.98064291934,2620.4065592796924,135148.38720219902,2232,5,291.80555555555554,32,4,24,33.04465563049253,0.6546223958333333,42.58207070707072,1029.6717171717191,32.17724116161622,0
2755,4,0,0,36,0.0,0.0,1.0,36,1050,900,150,0.8571428571428571,12,9,3,369.5745182478304,0.43174603174603177,0.24499407461893674,0.22380247552691585,132592.9931416439,2600.5983126721994,135193.5914543161,2233,6,292.80555555555554,32,4,24,33.00309550079687,0.6552734375,42.518939393939405,1029.9242424242439,32.18513257575762,0
2756,4,0,0,36,0.0,0.0,1.0,36,1000,600,400,0.6,14,6,8,400.7487607551701,0.43156415343915344,0.26358917688031624,0.22205818105972847,129170.2428903546,3152.9629529507797,132323.20584330536,2234,7,293.80555555555554,33,3,20,35.67950070323488,0.6183712121212122,45.86397058823529,1016.5441176470582,30.804367201426007,8
2757,4,0,0,36,0.0,0.0,1.0,36,900,800,100,0.8888888888888888,10,8,2,400.7108188337644,0.43171296296296297,0.26089213093308317,0.22333483155257014,129400.03289116746,3170.406136518246,132570.4390276857,2235,8,294.80555555555554,31,5,20,35.445461138128145,0.6256720430107527,45.63802083333333,1017.447916666666,32.82090053763439,0
2758,4,1,0,37,0.02702702702702703,0.0,1.0,37,650,400,250,0.6153846153846154,9,4,5,388.1294590733409,0.43374624624624625,0.25476589036420694,0.21850348356092258,129793.87622849373,2675.365394319475,132469.2416228132,2236,0,287.81081081081084,33,4,19,35.363675085187396,0.6246843434343434,45.25122549019607,1018.9950980392147,30.878639334521658,0
2759,4,1,0,38,0.02631578947368421,0.0,1.0,38,1150,1000,150,0.8695652173913043,13,10,3,381.1661123918182,0.43461059743954483,0.24751207892588178,0.21683723168779362,130201.83000283418,2325.705073696113,132527.5350765303,2237,0,281.2105263157895,34,4,20,35.125782495431395,0.626531862745098,44.85119047619046,1020.5952380952357,30.01750700280105,0
2760,4,0,0,38,0.0,0.0,1.0,38,1000,700,300,0.7,13,7,6,381.2585327892813,0.43447724039829305,0.2477625133512582,0.2170591407792358,130232.20663265276,2330.428004535113,132562.63463718788,2238,1,282.2105263157895,34,4,20,35.09252779721639,0.6268382352941176,44.821428571428555,1020.7142857142833,30.02100840336127,0
2761,4,0,1,37,0.0,0.02631578947368421,0.9736842105263158,38,1250,900,350,0.72,16,9,7,382.3328967392348,0.43438833570412516,0.2500568512014558,0.2181916229884452,130325.14537677796,2365.5216130569656,132690.66698983492,2239,2,283.2105263157895,33,5,20,34.97059529524723,0.630050505050505,44.730392156862735,1021.0784313725474,30.94177064765295,0
2762,4,1,0,38,0.02631578947368421,0.0,1.0,38,1300,1000,300,0.7692307692307693,16,10,6,383.46754631992155,0.4350403034613561,0.25709424695239336,0.2197229507676416,130481.60750973185,2407.0923743271824,132888.69988405902,2240,0,283.0,33,5,21,34.782570668905684,0.6316287878787878,44.57720588235294,1021.6911764705883,30.960338680926917,0
2763,4,1,0,39,0.02564102564102564,0.0,1.0,39,550,300,250,0.5454545454545454,8,3,5,375.17932946837294,0.43643162393162394,0.2560163758813825,0.21680672347825994,130810.03578514724,2015.444302721069,132825.48008786832,2241,0,276.71794871794873,34,5,20,34.66096435082818,0.6326593137254901,44.25595238095237,1022.9761904761892,30.087535014005567,0
2764,4,0,0,39,0.0,0.0,1.0,39,1250,900,350,0.72,16,9,7,375.83953145391456,0.43570062977957713,0.24885158272780417,0.21770327576670154,130901.38888888896,2039.5833333333421,132940.9722222223,2242,1,277.71794871794873,34,5,20,34.55143865363735,0.633578431372549,44.16666666666667,1023.3333333333339,30.098039215686292,0
2765,4,0,1,38,0.0,0.02564102564102564,0.9743589743589743,39,550,400,150,0.7272727272727273,7,4,3,377.0343642494048,0.43525078722447147,0.2505704136505573,0.21856806671963147,130931.84700963728,2073.1611394557913,133005.00814909308,2243,2,278.71794871794873,34,5,20,34.48998681710674,0.6338848039215687,44.136904761904766,1023.4523809523816,30.10154061624652,0
2766,4,1,0,39,0.02564102564102564,0.0,1.0,39,1400,1000,400,0.7142857142857143,18,10,8,376.8362309077049,0.43482905982905984,0.2540380741217565,0.21966794923644267,131145.1530612245,2084.049036281185,133229.20209750568,2244,0,279.53846153846155,34,5,21,34.27887222997057,0.6360294117647058,43.92857142857143,1024.2857142857144,30.12605042016807,0
2767,4,3,0,42,0.07142857142857142,0.0,1.0,42,1100,700,400,0.6363636363636364,15,7,8,347.9386091627435,0.43731852497096396,0.24491289590940468,0.20780381896263142,132070.6356765477,790.7497597483155,132861.38543629603,2245,0,260.5,35,7,19,34.085524340352045,0.643154761904762,43.02662037037038,1027.8935185185203,29.368386243386293,0
2768,4,1,0,43,0.023255813953488372,0.0,1.0,43,1450,1000,450,0.6896551724137931,19,10,9,338.60178797793264,0.4386766334440753,0.23855914733772043,0.20383024628078739,132369.0307706357,364.0780983686643,132733.10886900435,2246,0,255.41860465116278,36,7,21,34.02549792077043,0.6440972222222222,42.7364864864865,1029.0540540540558,28.584834834834883,0
2769,4,0,1,42,0.0,0.023255813953488372,0.9767441860465116,43,1200,800,400,0.6666666666666666,16,8,8,338.6857236677433,0.43798449612403095,0.2373903843414913,0.20482422336096892,132542.914536158,378.07858534212266,132920.99312150013,2247,1,256.4186046511628,36,7,21,33.84869860017498,0.6458333333333333,42.56756756756758,1029.7297297297316,28.603603603603656,0
2770,4,0,1,41,0.0,0.023809523809523808,0.9761904761904762,42,1050,600,450,0.5714285714285714,15,6,9,355.14577387527737,0.4358546264034069,0.21327421569552296,0.20553213384909377,130866.81909950498,930.9821645970354,131797.80126410202,2248,2,263.35714285714283,36,6,20,35.11583755227823,0.6290509259259259,44.200450450450454,1023.1981981981988,28.42217217217219,7
2771,4,0,0,41,0.0,0.0,1.0,41,950,800,150,0.8421052631578947,11,8,3,362.3280981800126,0.4332317073170732,0.2243615559883263,0.20994135282487994,130913.23329260961,1286.7085691015,132199.94186171112,2249,3,270.6829268292683,35,6,20,34.88511271959588,0.631547619047619,44.15509259259259,1023.3796296296287,29.239417989417962,0
2772,4,0,0,41,0.0,0.0,1.0,41,1300,800,500,0.6153846153846154,18,8,10,363.2578102468242,0.43307926829268295,0.22695090232594062,0.2106418895746009,130942.84664619753,1313.2023480366743,132256.0489942342,2250,4,271.6829268292683,35,6,20,34.83134023144483,0.6318452380952381,44.1261574074074,1023.495370370369,29.242724867724828,0
2773,4,1,0,42,0.023809523809523808,0.0,1.0,42,1150,700,450,0.6086956521739131,16,7,9,358.04508177112297,0.43425764614789003,0.23451373737056658,0.20955423081665517,131299.269603218,1002.2115443145749,132301.48114753258,2251,0,266.1904761904762,36,6,21,34.60425594257041,0.6333912037037037,43.77815315315315,1024.8873873873868,28.469094094094075,0
2774,4,0,0,42,0.0,0.0,1.0,42,1250,1000,250,0.8,15,10,5,357.9852984457679,0.43471738288811457,0.23448063295073007,0.20952339289746946,131300.02891514672,1000.6960074253302,132300.72492257206,2252,1,267.1904761904762,37,5,21,34.60502032737775,0.6314752252252251,43.77741228070174,1024.890350877191,27.699739212897054,0
2775,4,0,0,42,0.0,0.0,1.0,42,1350,1100,250,0.8148148148148148,16,11,5,358.74325012953744,0.43453590785907864,0.23552938499175036,0.21115900165852514,131516.61169982696,1036.1513683741862,132552.76306820114,2253,2,268.1904761904762,33,9,21,34.36678614097968,0.6420454545454546,43.56617647058823,1025.7352941176468,31.08288770053475,0
2776,4,1,0,43,0.023255813953488372,0.0,1.0,43,1600,1200,400,0.75,20,12,8,349.757202832193,0.4356312292358804,0.23339910081832027,0.20783093292260066,131877.8061224491,625.0425170068197,132502.84863945594,2254,0,262.93023255813955,34,9,22,34.23302039870189,0.6433823529411764,43.21428571428572,1027.1428571428582,30.210084033613477,0
2777,4,0,0,43,0.0,0.0,1.0,43,1150,600,550,0.5217391304347826,17,6,11,346.2048511115684,0.43602344038390545,0.23219141122293374,0.20628232672271854,131981.4238790296,538.5218407064582,132519.94571973608,2255,1,263.93023255813955,35,8,22,34.21988811293836,0.6422619047619047,43.11342592592593,1027.5462962962972,29.358465608465636,0
2778,4,0,0,43,0.0,0.0,1.0,43,1100,900,200,0.8181818181818182,13,9,4,344.5545213099708,0.43579272794389073,0.23342741787676125,0.20594436462147803,132100.37964034645,503.1566143690095,132603.53625471547,2256,2,264.93023255813955,35,8,22,34.14255422952788,0.6434523809523809,42.99768518518519,1028.00925925926,29.371693121693145,0
2779,4,0,0,43,0.0,0.0,1.0,43,850,600,250,0.7058823529411765,11,6,5,343.34575146452096,0.43556201550387597,0.23630671287812932,0.20554472075544528,132159.8776148836,475.3064986282767,132635.18411351187,2257,3,265.93023255813955,35,8,22,34.11376256941317,0.644047619047619,42.939814814814824,1028.2407407407422,29.378306878306923,0
2780,4,0,0,43,0.0,0.0,1.0,43,1200,900,300,0.75,15,9,6,344.27058789291453,0.4348468069398302,0.24235032920700084,0.20660759197200287,132253.17166829002,506.17543218896174,132759.34710047898,2258,4,266.93023255813955,36,7,22,33.996149916064525,0.6429398148148149,42.84909909909911,1028.6036036036046,28.57232232232235,0
2781,4,0,1,42,0.0,0.023255813953488372,0.9767441860465116,43,1500,1300,200,0.8666666666666667,17,13,4,344.37542001999697,0.4341777408637874,0.24178514264193596,0.20746519206082767,132398.00347222236,518.9236111111295,132916.9270833335,2259,5,267.93023255813955,36,7,22,33.847840755735504,0.6443865740740741,42.70833333333334,1029.1666666666679,28.587962962962997,0
2782,4,0,0,42,0.0,0.0,1.0,42,1500,1100,400,0.7333333333333333,19,11,8,348.3092658460228,0.43429394115369724,0.24397532292269153,0.20983509430235991,132398.00347222216,823.0902777777691,133221.09374999994,2260,6,274.54761904761904,35,7,22,33.74662618083671,0.6464285714285714,42.70833333333333,1029.166666666666,29.404761904761887,0
2783,4,1,1,42,0.023255813953488372,0.023255813953488372,0.9767441860465116,43,1300,1100,200,0.8461538461538461,15,11,4,341.8845072650247,0.4349390919158361,0.2444553992519103,0.20804035973999402,132774.9370992616,478.73878946515447,133253.67588872675,2261,0,269.13953488372096,36,7,19,33.533426209207455,0.6481481481481481,42.34234234234235,1030.630630630632,28.628628628628665,0
2784,4,0,0,42,0.0,0.0,1.0,42,800,500,300,0.625,11,5,6,317.2244255043948,0.4334228610143244,0.16192210760455827,0.1839113532706848,130935.05333371826,-62.392062717602386,130872.66127100066,2262,8,276.54761904761904,37,5,17,36.017070209270756,0.6278153153153153,44.13377192982457,1023.4649122807033,27.661213845424413,8
2785,4,0,0,42,0.0,0.0,1.0,42,850,700,150,0.8235294117647058,10,7,3,316.6231984551687,0.4331445993031359,0.1578723187185953,0.18369655423113765,130963.11034404839,-106.80822464602767,130856.30211940236,2263,9,277.54761904761904,37,5,17,36.00417336189964,0.6280968468468469,44.106359649122815,1023.5745614035105,27.664177335230015,0
2786,4,0,3,39,0.0,0.07142857142857142,0.9285714285714286,42,1550,1200,350,0.7741935483870968,19,12,7,315.1419833187369,0.4330962059620596,0.15371673294585553,0.18350536933896533,131103.44048168676,-136.7603493382447,130966.68013234851,2264,10,278.54761904761904,37,5,17,35.90069593147751,0.6295045045045045,43.96929824561404,1024.1228070175446,27.678994784257963,0
2787,4,1,0,40,0.025,0.0,1.0,40,950,500,450,0.5263157894736842,14,5,9,331.16347861865734,0.43004807692307695,0.16189210585840352,0.19188384521272384,130913.23329260963,670.7363468792777,131583.9696394889,2265,0,271.275,35,5,19,35.682443640202074,0.631547619047619,44.15509259259259,1023.3796296296288,29.239417989417966,0
2788,4,0,0,40,0.0,0.0,1.0,40,1400,1100,300,0.7857142857142857,17,11,6,330.2138447673148,0.42932692307692305,0.16436242369432508,0.1919232372412396,131031.70680084024,653.6967378257955,131685.40353866603,2266,1,272.275,35,5,20,35.587176878438456,0.6327380952380952,44.039351851851855,1023.842592592593,29.252645502645514,0
2789,4,0,1,39,0.0,0.025,0.975,40,1100,600,500,0.5454545454545454,16,6,10,330.8929933938535,0.42845886752136747,0.1696717143180022,0.19276314012786103,131120.59709630057,677.3773737568621,131797.97447005744,2267,2,273.275,35,5,21,35.48011545560705,0.6336309523809525,43.9525462962963,1024.1898148148148,29.262566137566136,0
2790,4,0,0,39,0.0,0.0,1.0,39,1000,600,400,0.6,14,6,8,340.1062506029708,0.4271817363922627,0.17704773322358758,0.19731670328504347,130962.30867346938,1108.2199546485203,132070.5286281179,2268,3,280.87179487179486,34,5,21,35.40406683724896,0.6341911764705883,44.107142857142854,1023.5714285714286,30.10504201680672,0
2791,4,0,0,39,0.0,0.0,1.0,39,1250,1000,250,0.8,15,10,5,335.85811493307494,0.4266756635177688,0.13315992919330966,0.1804870603661902,127950.3203509735,818.4543757773345,128768.77472675084,2269,4,281.87179487179486,37,2,19,38.571922076514596,0.5976914414414414,47.06688596491229,1011.7324561403518,27.344120436225726,8
2792,4,0,1,38,0.0,0.02564102564102564,0.9743589743589743,39,1200,900,300,0.75,15,9,6,339.28210582154657,0.4265350877192982,0.12972453466441158,0.18283205597423818,128061.27997316499,889.7801486996225,128951.0601218646,2270,5,282.87179487179486,37,2,19,38.37194868739393,0.5988175675675675,46.957236842105274,1012.1710526315802,27.355974395448115,0
2793,4,1,1,38,0.02564102564102564,0.02564102564102564,0.9743589743589743,39,950,800,150,0.8421052631578947,11,8,3,338.12389990215223,0.4273785425101215,0.1296953222722752,0.18363168227033605,128372.67324334473,881.200835173679,129253.8740785184,2271,0,283.71794871794873,36,3,14,38.08339815535059,0.6038773148148149,46.64977477477478,1013.4009009009012,28.150025025025034,0
2794,4,1,0,39,0.02564102564102564,0.0,1.0,39,500,300,200,0.6,7,3,4,338.097085362548,0.4271817363922627,0.13009380724079134,0.1838798710180239,128429.74044568223,884.3441837107457,129314.08462939298,2272,0,284.6923076923077,36,3,15,38.025867496204135,0.6044560185185186,46.59346846846847,1013.6261261261266,28.156281281281295,0
2795,4,1,0,40,0.025,0.0,1.0,40,1250,1100,150,0.88,14,11,3,332.7971861603125,0.4293402777777778,0.14201943844492515,0.18299892778173957,128867.17547706992,577.326677439221,129444.50215450914,2273,0,278.55,37,3,16,37.71463282937366,0.6069819819819819,46.16228070175439,1015.3508771929828,27.441915599810347,0
2796,4,4,2,42,0.09090909090909091,0.045454545454545456,0.9545454545454546,44,1300,900,400,0.6923076923076923,17,9,8,308.93160871800984,0.43570516208597604,0.14632647226986872,0.1741848432133459,129853.92011834319,-775.5054354457694,129078.41468289742,2274,0,254.13636363636363,38,6,15,37.32049266247381,0.6151315789473684,45.19230769230769,1019.230769230769,26.821862348178133,0
2797,4,1,0,43,0.023255813953488372,0.0,1.0,43,1300,1000,300,0.7692307692307693,16,10,6,316.44480814009523,0.43346253229974163,0.14829678371717736,0.17837201283579032,129843.17440221985,-382.3603175977279,129460.81408462212,2275,0,261.0232558139535,37,6,16,37.13992738031199,0.6168355855855856,45.20285087719298,1019.1885964912276,27.54563774300615,0
2798,4,0,0,43,0.0,0.0,1.0,43,750,500,250,0.6666666666666666,10,5,5,315.04207963509225,0.43346253229974163,0.14498183100458384,0.17808974459129018,129954.95158366038,-411.7443588411794,129543.2072248192,2276,1,262.0232558139535,37,6,17,37.062564971143864,0.6179617117117118,45.093201754385966,1019.6271929824563,27.55749170222855,0
2799,4,1,1,43,0.022727272727272728,0.022727272727272728,0.9772727272727273,44,1250,1000,250,0.8,15,10,5,311.3531461600876,0.43431774136715995,0.155852308394681,0.17777260280753376,130344.39718934898,-683.3723701512333,129661.02481919774,2277,0,257.04545454545456,38,6,18,36.76305189370161,0.6200657894736843,44.71153846153845,1021.153846153845,26.8724696356275,0
2800,4,0,1,42,0.0,0.023255813953488372,0.9767441860465116,43,1150,600,550,0.5217391304347826,17,6,11,314.76302479812375,0.43290882244370615,0.15311783711442173,0.17985906828035123,130374.54433094797,-392.58281394274803,129981.96151700523,2278,1,263.90697674418607,37,6,20,36.64555149953477,0.6221846846846847,44.68201754385965,1021.2719298245613,27.60194404931247,0
2801,4,0,0,42,0.0,0.0,1.0,42,1050,600,450,0.5714285714285714,15,6,9,320.84578823522736,0.43064024390243905,0.14835487815758963,0.1838934830485292,130492.6056757771,-26.39941461732184,130466.20626115978,2279,2,262.57142857142856,36,6,14,36.37096329769648,0.6252893518518519,44.56644144144144,1021.734234234234,28.3815065065065,0
2802,4,0,0,42,0.0,0.0,1.0,42,950,500,450,0.5263157894736842,14,5,9,323.4609007315173,0.42996273712737126,0.14471406540144183,0.18608225962235198,130636.47050766983,51.158083759437574,130687.62859142927,2280,3,263.57142857142856,36,6,15,36.15884556069621,0.6267361111111112,44.42567567567568,1022.2972972972973,28.397147147147148,0
2803,4,0,0,42,0.0,0.0,1.0,42,1050,600,450,0.5714285714285714,15,6,9,324.18038549863365,0.4290069686411149,0.14088328274169948,0.1871920178947294,130780.41459956596,79.28904411169978,130859.70364367767,2281,4,264.57142857142856,36,6,16,35.99512826158758,0.6281828703703703,44.28490990990992,1022.8603603603618,28.412787787787828,0
2804,4,0,0,42,0.0,0.0,1.0,42,950,700,250,0.7368421052631579,12,7,5,322.643476872184,0.4289706736353078,0.1369191744494409,0.1867222057873037,130866.81909950507,44.66510429350373,130911.48420379857,2282,5,265.57142857142856,36,6,17,35.94724484554993,0.6290509259259259,44.20045045045046,1023.1981981981995,28.42217217217221,0
2805,4,0,0,42,0.0,0.0,1.0,42,1050,300,750,0.2857142857142857,18,3,15,324.6267948945993,0.4283657568718544,0.13694404290532747,0.1887152697686509,131039.71370018687,107.80045247952637,131147.5141526664,2283,6,266.57142857142856,36,6,17,35.72210918023171,0.630787037037037,44.03153153153154,1023.8738738738754,28.440940940940983,0
2806,4,0,0,42,0.0,0.0,1.0,42,1200,700,500,0.5833333333333334,17,7,10,348.40978969392944,0.42841415021293067,0.1791159265015818,0.18687793082336696,127874.24123612013,510.52749926947183,128384.7687353896,2284,7,267.57142857142856,38,4,17,38.332277032498844,0.5951206140350878,47.14209401709401,1011.431623931623,26.616621682411132,8
2807,4,1,0,43,0.023255813953488372,0.0,1.0,43,1350,800,550,0.5925925925925926,19,8,11,344.0616173461265,0.42912513842746397,0.18430446537808964,0.18630956747031158,128255.5750327023,226.1348295935418,128481.70986229584,2285,0,262.3255813953488,37,6,19,38.05251858266581,0.6007882882882882,46.76535087719298,1012.9385964912275,27.37671882408723,0
2808,4,1,0,44,0.022727272727272728,0.0,1.0,44,1200,700,500,0.5833333333333334,17,7,10,342.8838924755245,0.43104739252995067,0.20038624637445301,0.18768693526455638,128685.96734832702,24.869078274513527,128710.83642660153,2286,0,257.34090909090907,38,6,18,37.64324699027762,0.6033442982456141,46.34081196581196,1014.6367521367513,26.700967161493455,0
2809,4,0,0,44,0.0,0.0,1.0,44,950,800,150,0.8421052631578947,11,8,3,345.21119824955207,0.43073907681465823,0.1973548238941356,0.18947727293870553,128794.39153928333,92.25324621959035,128886.64478550293,2287,1,258.34090909090907,38,6,19,37.473686980317865,0.6044407894736843,46.23397435897436,1015.0641025641023,26.712213225371112,0
2810,4,1,2,43,0.022222222222222223,0.044444444444444446,0.9555555555555556,45,700,300,400,0.42857142857142855,11,3,8,338.04865004481314,0.4323232323232323,0.2044207577465753,0.18708682237590693,129121.97401258671,-270.0981987847312,128851.87581380198,2288,0,253.57777777777778,39,6,20,37.32202948310616,0.6060363247863247,45.91145833333333,1016.3541666666658,26.060363247863226,0
2811,4,0,1,42,0.0,0.023255813953488372,0.9767441860465116,43,650,600,50,0.9230769230769231,7,6,1,350.31091249201154,0.43027870062753787,0.2109196845647694,0.19262939724917005,128867.17547706973,428.715566328082,129295.89104339782,2289,1,264.86046511627904,37,6,20,37.27006839452843,0.6069819819819819,46.162280701754376,1015.3508771929813,27.441915599810308,0
2812,4,2,0,44,0.045454545454545456,0.0,1.0,44,500,300,200,0.6,7,3,4,344.59740945045485,0.4325779598308668,0.21455090163699442,0.19070128889483276,129119.93805473363,98.87923241287609,129218.8172871465,2290,0,259.45454545454544,38,6,22,37.157705245453585,0.6077302631578947,45.91346153846153,1016.3461538461531,26.74595141700403,0
2813,4,0,0,44,0.0,0.0,1.0,44,1000,700,300,0.7,13,7,6,349.58844549022933,0.4326330162085976,0.21499500068618072,0.19413672116625064,129257.13320444747,237.3857352102834,129494.51893965775,2291,1,260.45454545454544,37,7,22,36.89121917906694,0.6109234234234234,45.77850877192982,1016.8859649122802,27.483404457088653,0
2814,4,0,0,44,0.0,0.0,1.0,44,1550,1200,350,0.7741935483870968,19,12,7,355.73071492271123,0.4319833509513742,0.22081700626959244,0.198388283322281,129424.43828870404,408.0495921821878,129832.48788088623,2292,2,261.45454545454544,37,7,22,36.564744971264346,0.6126126126126126,45.61403508771929,1017.5438596491214,27.5011853959222,0
2815,4,0,0,44,0.0,0.0,1.0,44,1050,700,350,0.6666666666666666,14,7,7,352.94880843866616,0.43121256166314303,0.21883498573432458,0.19721661571819182,129500.26167223672,341.3926099422755,129841.654282179,2293,3,262.45454545454544,38,6,16,36.55837794338896,0.6115679824561404,45.53952991452991,1017.8418803418795,26.785312640575775,0
2816,4,0,1,43,0.0,0.022727272727272728,0.9772727272727273,44,900,400,500,0.4444444444444444,14,4,10,352.18608251053774,0.4312676180408739,0.21431739491229607,0.1973360113114596,129609.02829141985,329.29918639050095,129938.32747781035,2294,4,263.45454545454544,38,6,16,36.46718602455145,0.6126644736842105,45.43269230769229,1018.2692307692286,26.796558704453382,0
2817,4,0,2,41,0.0,0.046511627906976744,0.9534883720930233,43,1350,1100,250,0.8148148148148148,16,11,5,355.7820675668826,0.43101698043558506,0.20690798617037354,0.20032168597715028,129799.47973738034,636.0654540141684,130435.54519139451,2295,5,267.1162790697674,38,5,17,36.18202628084154,0.6145833333333333,45.245726495726494,1019.0170940170938,26.816239316239308,0
2818,4,0,0,41,0.0,0.0,1.0,41,1100,800,300,0.7272727272727273,14,8,6,371.1794678518284,0.4286077235772358,0.2167440103604572,0.20763999934285474,129545.08562616685,1416.8951891080442,130961.9808152749,2296,8,280.9024390243902,36,5,18,36.04881084070798,0.6157407407407407,45.495495495495504,1018.0180180180192,28.27827827827831,0
2819,4,0,0,41,0.0,0.0,1.0,41,1450,1100,350,0.7586206896551724,18,11,7,368.03110222045694,0.42870934959349594,0.21119329308754264,0.20617950596514095,129602.412801315,1339.5437667397346,130941.95656805474,2297,9,281.9024390243902,36,5,18,36.07055961070561,0.6163194444444444,45.4391891891892,1018.2432432432446,28.284534534534572,0
2820,4,0,0,41,0.0,0.0,1.0,41,800,700,100,0.875,9,7,2,368.65478276477006,0.4280741869918699,0.21151690039884596,0.20691445783093343,129675.5988020352,1361.10594125115,131036.70474328635,2298,10,282.9024390243902,37,4,18,35.98016919654073,0.6151463963963963,45.36732456140351,1018.5307017543856,27.527856804172586,0
2821,4,0,1,40,0.0,0.024390243902439025,0.975609756097561,41,1200,800,400,0.6666666666666666,16,8,8,368.8497368502546,0.4279979674796748,0.2102788917989855,0.2073909841158035,129745.05077069181,1371.2855668785198,131116.33633757033,2299,11,283.9024390243902,38,3,18,35.90451097595081,0.6140350877192983,45.2991452991453,1018.8034188034189,26.810616284300497,0
2822,4,0,0,40,0.0,0.0,1.0,40,1700,1400,300,0.8235294117647058,20,14,6,371.68362962311323,0.4263755341880342,0.20673954073608058,0.20912960328705812,129772.26382725195,1646.8452087442618,131419.10903599623,2300,12,291.65,38,2,18,35.80462933836637,0.6143092105263157,45.272435897435905,1018.9102564102576,26.813427800269938,0
2823,4,0,1,39,0.0,0.025,0.975,40,1000,800,200,0.8,12,8,4,368.76112495550024,0.4264957264957265,0.20518867924528306,0.20791850662384584,129853.9201183432,1577.0155325443807,131430.93565088758,2301,13,292.65,38,2,18,35.79599056603774,0.6151315789473684,45.19230769230769,1019.2307692307693,26.82186234817814,0
2824,4,0,0,39,0.0,0.0,1.0,39,1100,700,400,0.6363636363636364,15,7,8,378.01778789611353,0.4268724696356276,0.21363475881548144,0.21323139297829313,129871.11418898121,2018.718259464446,131889.83244844567,2302,14,299.71794871794873,37,2,18,35.54261689615605,0.6171171171171171,45.175438596491226,1019.2982456140351,27.54860123281176,0
2825,4,0,0,39,0.0,0.0,1.0,39,1650,1400,250,0.8484848484848485,19,14,5,374.5591964349153,0.4268162393162393,0.20648440644140464,0.21218938156136308,130038.81602993228,1941.4468875038408,131980.2629174361,2303,15,300.71794871794873,37,2,18,35.460116104063616,0.6188063063063063,45.0109649122807,1019.9561403508771,27.56638217164533,0
2826,4,0,0,39,0.0,0.0,1.0,39,1300,900,400,0.6923076923076923,17,9,8,371.85579265500223,0.42664754835807467,0.20297905404288374,0.21126312615674314,130150.67737188369,1879.45665974146,132030.13403162514,2304,16,301.71794871794873,37,2,18,35.41532344723834,0.6199324324324325,44.901315789473685,1020.3947368421057,27.57823613086772,0
2827,4,0,0,39,0.0,0.0,1.0,39,1450,1200,250,0.8275862068965517,17,12,5,372.1516539491259,0.42670377867746284,0.20342418453646194,0.21237157258294392,130323.35778061197,1900.1549044132535,132223.51268502523,2305,17,302.71794871794873,34,5,18,35.2323073335665,0.6277573529411764,44.73214285714284,1021.0714285714263,30.03151260504195,0
2828,4,0,0,39,0.0,0.0,1.0,39,1100,900,200,0.8181818181818182,13,9,4,354.6699400223118,0.4262539361223572,0.08859616420197991,0.19849972230905116,129563.9418498959,1390.4870969913552,130954.42894688726,2306,18,303.71794871794873,37,2,13,36.4498070364387,0.6140202702702703,45.47697368421051,1018.0921052631561,27.516002844950165,8
2829,4,0,0,39,0.0,0.0,1.0,39,1250,800,450,0.64,17,8,9,355.1311612475808,0.4265350877192982,0.0852492325360541,0.1991822600040775,129647.68005540138,1408.3862342258806,131056.06628962726,2307,19,304.71794871794873,37,2,14,36.352910565604354,0.6148648648648649,45.394736842105246,1018.4210526315767,27.52489331436694,0
2830,4,1,0,40,0.025,0.0,1.0,40,1850,1400,450,0.7567567567567568,23,14,9,345.31323422615225,0.4311832264957265,0.08770424836601287,0.19567749939481965,130050.00000000001,981.5972222222226,131031.59722222223,2308,0,298.075,39,1,15,36.194512527233115,0.6153846153846154,45.0,1020.0000000000001,26.153846153846157,0
2831,4,0,1,39,0.0,0.025,0.975,40,1000,500,500,0.5,15,5,10,348.07083698965664,0.4308092948717949,0.09176194365046997,0.19777853359342656,130156.27170138876,1060.720486111102,131216.99218749985,2309,1,299.075,39,1,15,36.01640125221179,0.6164529914529915,44.89583333333333,1020.4166666666656,26.164529914529886,0
2832,4,0,0,39,0.0,0.0,1.0,39,1100,800,300,0.7272727272727273,14,8,6,352.62097625320143,0.4303025191183086,0.09400546056393622,0.20034996693600976,130153.5462437905,1378.9741078603095,131532.5203516508,2310,2,306.0,38,1,15,35.9030904268314,0.6181469298245614,44.898504273504265,1020.4059829059818,26.852789023841627,0
2833,4,0,0,39,0.0,0.0,1.0,39,1200,900,300,0.75,15,9,6,351.89720075672227,0.42990890688259115,0.08527776363646611,0.2006478001295876,130291.32806793276,1369.9220401901348,131661.25010812288,2311,3,307.0,36,3,16,35.781813000955935,0.6232638888888888,44.76351351351351,1020.9459459459456,28.3596096096096,0
2834,4,1,0,40,0.025,0.0,1.0,40,1450,1200,250,0.8275862068965517,17,12,5,346.85307859519475,0.43186431623931626,0.09652740534162829,0.19948866451221464,130626.62459843411,1061.6493776931297,131688.27397612724,2312,0,300.3,37,3,16,35.57096696342378,0.6247184684684685,44.435307017543856,1022.2587719298243,27.62861545756282,0
2835,4,0,0,40,0.0,0.0,1.0,40,1350,900,450,0.6666666666666666,18,9,9,346.5889162905951,0.4316372863247863,0.09224174882126013,0.2006431617136371,130878.9483302553,1072.2385734071834,131951.18690366248,2313,1,301.3,37,3,16,35.32245677953993,0.6272522522522522,44.18859649122806,1023.2456140350864,27.655286865813146,0
2836,4,0,0,40,0.0,0.0,1.0,40,700,500,200,0.7142857142857143,9,5,4,350.84057366697965,0.4313568376068376,0.09314287244296948,0.20384557786736673,131019.23338190574,1193.3726002231222,132212.60598212885,2314,2,302.3,37,3,17,35.07182446181857,0.6286599099099099,44.05153508771929,1023.7938596491209,27.670104314841105,0
2837,4,0,0,40,0.0,0.0,1.0,40,1200,900,300,0.75,15,9,6,354.5105443018956,0.4310096153846154,0.08629187627100543,0.2068826992762404,131187.67463306006,1301.482787973212,132489.15742103328,2315,3,303.3,37,3,18,34.80758767704877,0.6303490990990991,43.88706140350877,1024.451754385964,27.687885253674704,0
2838,4,0,0,40,0.0,0.0,1.0,40,950,600,350,0.631578947368421,13,6,7,357.5980213951001,0.43040865384615384,0.09474877514854585,0.2093006601124588,131300.7492900323,1390.5776307619449,132691.32692079426,2316,4,304.3,38,2,18,34.61421522638033,0.6296600877192983,43.77670940170941,1024.8931623931637,26.97087269455694,0
2839,4,0,1,39,0.0,0.025,0.975,40,950,700,250,0.7368421052631579,12,7,5,366.3473552686385,0.4304887820512821,-0.026020408163265007,0.2087327954437589,130262.58680555536,1803.2550085835155,132065.84181413887,2317,5,305.3,33,7,20,35.4421768707483,0.6294191919191919,44.79166666666666,1020.8333333333318,30.934343434343386,8
2840,4,0,2,37,0.0,0.05128205128205128,0.9487179487179487,39,1350,1100,250,0.8148148148148148,16,11,5,373.6776343190337,0.4294309491677913,-0.018001046572475143,0.21290934978642617,130262.5868055555,1935.24305555555,132197.82986111107,2318,6,313.38461538461536,33,6,20,35.255102040816325,0.6294191919191919,44.791666666666664,1020.8333333333329,30.934343434343422,0
2841,4,0,2,35,0.0,0.05405405405405406,0.9459459459459459,37,1150,700,450,0.6086956521739131,16,7,9,385.5168534956191,0.4232982982982983,-0.019661033307251552,0.21984273805521112,130295.81917656807,2646.246846516945,132942.066023085,2319,7,322.5135135135135,31,6,21,34.91914828040641,0.634744623655914,44.75911458333334,1020.9635416666678,32.93430779569896,0
2842,4,0,1,34,0.0,0.02857142857142857,0.9714285714285714,35,900,700,200,0.7777777777777778,11,7,4,391.73659259614715,0.42237394957983193,-0.031724040432600686,0.2230139869399474,130230.36552392607,3203.1999285787056,133433.5654525048,2320,8,316.14285714285717,32,3,21,34.82702457529274,0.6315104166666667,44.82323232323232,1020.7070707070702,31.897095959595944,0
2843,4,0,0,34,0.0,0.0,1.0,34,900,600,300,0.6666666666666666,12,6,6,398.41354818931035,0.4196375519904932,-0.03361505377958274,0.22642255091802957,130162.91512383365,3571.7337714301307,133734.6488952638,2321,9,314.5882352941176,31,3,21,34.72536791289183,0.6334005376344086,44.88932291666667,1020.4427083333342,32.91750672043013,0
2844,4,1,0,35,0.02857142857142857,0.0,1.0,35,750,400,350,0.5333333333333333,11,4,7,395.8285944196226,0.42023809523809524,-0.00015276893698268346,0.22845213880721074,130761.51741875558,3351.8676757812736,134113.38509453685,2322,0,306.57142857142856,31,4,17,34.182182261829,0.6394489247311828,44.30338541666668,1022.7864583333346,32.99311155913983,0
2845,4,1,0,36,0.027777777777777776,0.0,1.0,36,1100,800,300,0.7272727272727273,14,8,6,386.28521644892936,0.4229001322751323,-0.005187148198364744,0.22530064421640322,131166.40082963498,2933.5283070605346,134099.92913669551,2323,0,299.02777777777777,32,4,18,34.01536628456387,0.6409505208333333,43.9078282828283,1024.3686868686889,32.01152146464653,0
2846,4,0,0,36,0.0,0.0,1.0,36,850,500,350,0.5882352941176471,12,5,7,386.28521644892936,0.4229001322751323,-0.005187148198364744,0.22530064421640322,131166.40082963498,2933.5283070605346,134099.92913669551,2324,1,300.02777777777777,32,4,18,34.01536628456387,0.6409505208333333,43.9078282828283,1024.3686868686889,32.01152146464653,0
2847,4,0,0,36,0.0,0.0,1.0,36,1050,600,450,0.5714285714285714,15,6,9,389.7278665504326,0.42228835978835977,-0.0016571245429248815,0.22847459171254023,131362.56946251006,3039.3300663762884,134401.89952888634,2325,2,301.02777777777777,30,6,19,33.72831169966347,0.6482638888888889,43.71639784946236,1025.13440860215,34.171146953405,0
2848,4,0,0,36,0.0,0.0,1.0,36,850,500,350,0.5882352941176471,12,5,7,390.7866142704451,0.4223048941798942,0.0018790421255023837,0.2293015610503811,131397.0184414383,3069.6391923921783,134466.65763383047,2326,3,302.02777777777777,30,6,19,33.666262454116406,0.6486111111111111,43.68279569892473,1025.2688172043008,34.17562724014336,0
2849,4,0,0,36,0.0,0.0,1.0,36,1200,900,300,0.75,15,9,6,399.4987214008701,0.4219907407407408,0.018404206675811885,0.21572930955647016,128144.53125000022,3038.715277777805,131183.246527778,2327,4,303.02777777777777,32,4,20,36.76268861454048,0.6103515625,46.875000000000014,1012.5000000000017,31.640625000000053,7
2850,4,0,0,36,0.0,0.0,1.0,36,750,600,150,0.8,9,6,3,399.03480726307527,0.4220568783068783,0.02030155570301595,0.21584546107159194,128212.58463767503,3032.256799919088,131244.84143759412,2328,5,304.02777777777777,30,6,20,36.70454545454545,0.6163194444444444,46.80779569892474,1012.7688172043023,33.75896057347674,0
2851,4,1,1,36,0.02702702702702703,0.02702702702702703,0.972972972972973,37,1250,900,350,0.72,16,9,7,388.7338872164034,0.4247997997997998,0.026163022696596094,0.2121827783832212,128573.35620456276,2596.1641099717967,131169.52031453457,2329,0,296.7837837837838,31,6,16,36.59554606924296,0.617271505376344,46.45182291666667,1014.1927083333337,32.71589381720431,0
2852,4,1,0,37,0.02702702702702703,0.0,1.0,37,750,500,250,0.6666666666666666,10,5,5,376.72724238773424,0.4279592092092092,0.04449968924798009,0.20772931220077626,128976.8442792829,2317.8181754413054,131294.6624547242,2330,0,295.4864864864865,32,5,17,36.487466335197844,0.6188151041666667,46.05429292929294,1015.7828282828298,31.74321338383843,0
2853,4,0,0,37,0.0,0.0,1.0,37,900,400,500,0.4444444444444444,14,4,10,378.72253468748755,0.4278966466466467,0.04381944374490043,0.20950774444670728,129105.13157139593,2379.0045339761427,131484.13610537208,2331,1,296.4864864864865,32,5,17,36.30575226736239,0.6201171875,45.92803030303031,1016.2878787878801,31.758996212121254,0
2854,4,1,1,37,0.02631578947368421,0.02631578947368421,0.9736842105263158,38,500,300,200,0.6,7,3,4,368.152972746399,0.42995791844476056,0.04224284962496583,0.20496564901192907,129357.17520004348,1924.645719194569,131281.82091923806,2332,0,289.6578947368421,33,5,18,36.31728606995142,0.6202651515151515,45.68014705882354,1017.2794117647077,30.82664884135478,0
2855,4,1,1,37,0.02631578947368421,0.02631578947368421,0.9736842105263158,38,950,700,250,0.7368421052631579,12,7,5,366.8661188471845,0.4297356567093409,0.05017932502819766,0.20505989119412635,129513.05537533657,1902.7903931180547,131415.84576845463,2333,0,290.39473684210526,33,5,15,36.191207159483106,0.6218434343434344,45.52696078431374,1017.8921568627463,30.845216874628676,0
2856,4,0,0,37,0.0,0.0,1.0,37,1100,700,400,0.6363636363636364,15,7,8,378.46332407686754,0.4271146146146146,0.05733351217222182,0.21124753407614635,129458.25043362926,2399.0399576573873,131857.29039128666,2334,1,299.2162162162162,32,5,16,35.951974772539295,0.6236979166666667,45.58080808080808,1017.676767676768,31.802398989899,0
2857,4,0,0,37,0.0,0.0,1.0,37,1150,800,350,0.6956521739130435,15,8,7,384.2424565959608,0.42633258258258255,0.06398440091262736,0.21570521206399526,129683.2135273185,2565.959308999066,132249.17283631756,2335,2,300.2162162162162,32,5,16,35.57549274823354,0.6259765625,45.35984848484848,1018.5606060606049,31.830018939393902,0
2858,4,0,1,36,0.0,0.02702702702702703,0.972972972972973,37,650,300,350,0.46153846153846156,10,3,7,383.1197156401118,0.4261761761761762,0.06386135794984482,0.21542808261324475,129747.52456700844,2541.766943424136,132289.29151043258,2336,3,301.2162162162162,32,5,17,35.5385322427397,0.6266276041666667,45.29671717171717,1018.8131313131311,31.837910353535346,0
2859,4,0,0,36,0.0,0.0,1.0,36,850,700,150,0.8235294117647058,10,7,3,388.096888777495,0.42524801587301586,0.09317287314562539,0.1998734495528267,126223.21605725601,2597.3674886621034,128820.58354591811,2337,4,307.19444444444446,34,2,20,39.02998262449156,0.5860906862745099,48.77976190476189,1004.8809523809506,29.555322128851486,8
2860,4,3,0,39,0.07692307692307693,0.0,1.0,39,550,100,450,0.18181818181818182,10,1,9,371.0689661851236,0.43370445344129555,0.1322496034964784,0.1956139495665872,127174.94956380785,1638.1354118574666,128813.08497566532,2338,0,284.4871794871795,37,2,18,38.47734808131316,0.5898085585585586,47.83442982456139,1008.6622807017525,27.261142721668985,0
2861,4,1,0,40,0.025,0.0,1.0,40,1050,700,350,0.6666666666666666,14,7,7,372.76506780879896,0.4366987179487179,0.1618537900412309,0.19887110978022687,127658.21468195244,1517.3046104536243,129175.51929240605,2339,0,278.35,38,2,17,37.938074849349825,0.5929276315789473,47.35576923076922,1010.5769230769213,26.594129554655822,0
2862,4,2,0,42,0.047619047619047616,0.0,1.0,42,650,500,150,0.7692307692307693,8,5,3,365.28984402784147,0.44030681378242353,0.17313345091122878,0.19725651577503425,128144.53124999987,967.5265039447572,129112.05775394462,2340,0,266.04761904761904,34,8,19,37.62860082304526,0.6056985294117647,46.87499999999999,1012.499999999999,29.779411764705852,0
2863,4,1,2,41,0.023255813953488372,0.046511627906976744,0.9534883720930233,43,1650,1300,350,0.7878787878787878,20,13,7,347.6550744000402,0.440453119232189,0.08454160817536605,0.18760703217623984,128117.48940755313,347.20156238581814,128464.69096993895,2341,0,260.83720930232556,38,5,15,38.102618896862246,0.5975877192982456,46.90170940170938,1012.3931623931593,26.64192532613577,8
2864,4,1,0,42,0.023809523809523808,0.0,1.0,42,1500,1000,500,0.6666666666666666,20,10,10,355.22909810711076,0.43831058846302745,0.10286188517407391,0.19235676484838723,128255.5750327022,712.0224492151226,128967.59748191731,2342,0,267.92857142857144,37,5,18,37.76971927545644,0.6007882882882882,46.76535087719297,1012.9385964912267,27.37671882408721,0
2865,4,1,0,43,0.023255813953488372,0.0,1.0,43,1100,600,500,0.5454545454545454,16,6,10,347.28160196649753,0.43994555186415657,0.10842913003851473,0.1894481014865512,128550.5013149242,328.6448060486306,128879.14612097283,2343,0,262.6744186046512,38,5,15,37.669879898862206,0.6019736842105263,46.474358974358964,1014.1025641025625,26.686909581646383,0
2866,4,0,1,42,0.0,0.023255813953488372,0.9767441860465116,43,1350,1100,250,0.8148148148148148,16,11,5,347.9077289369065,0.43959948320413433,0.11242147029648408,0.19017754094737604,128631.77237426017,350.39755917157777,128982.16993343174,2344,1,263.6744186046512,38,5,15,37.57109004739336,0.602796052631579,46.39423076923076,1014.4230769230754,26.695344129554616,0
2867,4,2,1,43,0.045454545454545456,0.022727272727272728,0.9772727272727273,44,1300,900,400,0.6923076923076923,17,9,8,341.073890349472,0.4414530479210712,0.12439786819719156,0.1887610861111626,129121.97401258672,8.026801215268847,129130.00081380199,2345,0,258.5681818181818,39,5,17,37.24516159338595,0.6060363247863247,45.91145833333333,1016.354166666666,26.06036324786323,0
2868,4,0,0,43,0.0,0.0,1.0,43,1250,600,650,0.48,19,6,13,343.7769308083474,0.4402685492801772,0.12013792091556041,0.18985590081227527,129038.51290269548,272.0927843523878,129310.60568704786,2346,1,265.4651162790698,38,5,17,37.26143533123028,0.606907894736842,45.99358974358974,1016.0256410256401,26.737516869095792,0
2869,4,0,0,43,0.0,0.0,1.0,43,1850,1400,450,0.7567567567567568,23,14,9,343.659138273128,0.43943798449612403,0.10991169729814243,0.19083708740277877,129255.70371283496,283.9807509679126,129539.68446380287,2347,2,266.4651162790698,38,5,18,37.04340897947748,0.6091008771929824,45.77991452991452,1016.8803418803406,26.760008996851067,0
2870,4,0,0,43,0.0,0.0,1.0,43,650,300,350,0.46153846153846156,10,3,7,347.58229772541483,0.43895348837209297,0.10899605808824586,0.1935484584176256,129364.36760355024,392.9528270874365,129757.32043063769,2348,3,267.4651162790698,38,5,18,36.83312329342577,0.6101973684210527,45.67307692307692,1017.3076923076918,26.77125506072873,0
2871,4,0,1,42,0.0,0.023255813953488372,0.9767441860465116,43,1350,1100,250,0.8148148148148148,16,11,5,346.17713909344235,0.43816906607604283,0.058391013819366844,0.18571160334791845,127880.99500868045,289.0542175172528,128170.0492261977,2349,4,268.4651162790698,39,4,17,38.38182286302782,0.593482905982906,47.135416666666664,1011.4583333333325,25.93482905982904,8
2872,4,1,1,42,0.023255813953488372,0.023255813953488372,0.9767441860465116,43,600,400,200,0.6666666666666666,8,4,4,341.1121265023108,0.4386304909560723,0.08202331650971306,0.18408228625222212,128118.80845561504,140.5758394474147,128259.38429506245,2350,0,269.0,40,3,18,38.266872448638146,0.5942708333333333,46.90040650406504,1012.3983739837398,25.309959349593495,0
2873,4,0,0,42,0.0,0.0,1.0,42,1100,900,200,0.8181818181818182,13,9,4,345.6230219417117,0.43694347657762295,0.07084043992236655,0.1861459690235961,128039.08420138898,450.6510416666758,128489.73524305565,2351,1,276.2857142857143,39,3,18,38.23418416357896,0.5950854700854701,46.97916666666667,1012.0833333333342,25.950854700854723,0
2874,4,0,1,41,0.0,0.023809523809523808,0.9761904761904762,42,1650,1100,550,0.6666666666666666,22,11,11,345.6589266751213,0.4373790166473093,0.07016750570242891,0.18678194452832375,128171.575946015,460.77327712944196,128632.34922314444,2352,2,277.2857142857143,38,4,18,38.097875782513874,0.5981359649122807,46.848290598290596,1012.6068376068372,26.647548358074662,0
2875,4,1,2,40,0.023809523809523808,0.047619047619047616,0.9523809523809523,42,850,700,150,0.8235294117647058,10,7,3,344.9693444315217,0.43886711188540456,0.08100457721031096,0.18767598279623116,128442.17985243605,461.7229162100763,128903.90276864612,2353,0,273.3333333333333,38,4,16,37.839024732996066,0.6008771929824561,46.58119658119657,1013.6752136752119,26.675663517768736,0
2876,4,1,0,41,0.024390243902439025,0.0,1.0,41,1450,1100,350,0.7586206896551724,18,11,7,349.79675536341654,0.4400914634146342,0.05185635388314869,0.18836779766653053,128033.53555901808,759.3802610002406,128792.91582001833,2354,0,264.7073170731707,37,4,19,38.134254243409174,0.5985360360360361,46.984649122807014,1012.0614035087713,27.353010905642467,8
2877,4,1,1,41,0.023809523809523808,0.023809523809523808,0.9761904761904762,42,1200,800,400,0.6666666666666666,16,8,8,340.9977105381301,0.4420973674022455,0.05974343504905866,0.18506015678058468,128344.1443977761,353.10806356441907,128697.25246134051,2355,0,259.3809523809524,36,6,21,38.03970326739276,0.603587962962963,46.677927927927925,1013.2882882882878,28.146896896896884,0
2878,4,1,2,40,0.023809523809523808,0.047619047619047616,0.9523809523809523,42,1250,800,450,0.64,17,8,9,339.14174718406446,0.44242402245451024,0.07202070347401812,0.18524255408652912,128601.0181422976,322.79479648566735,128923.81293878327,2356,0,260.07142857142856,36,6,17,37.82474741867438,0.6061921296296297,46.424549549549546,1014.3018018018009,28.175050050050025,0
2879,4,1,0,41,0.024390243902439025,0.0,1.0,41,1700,1300,400,0.7647058823529411,21,13,8,344.38831685653014,0.44375000000000003,0.06416612935500332,0.1898462229103584,128966.15655006851,682.887517146766,129649.04406721528,2357,0,262.0731707317073,35,6,19,37.31958371315709,0.611904761904762,46.06481481481481,1015.7407407407401,29.021164021164,0
2880,4,0,0,41,0.0,0.0,1.0,41,1000,700,300,0.7,13,7,6,344.8517521978687,0.4434705284552845,0.0606171748662121,0.1903841937605591,129024.94454089504,698.8956404320961,129723.84018132713,2358,1,263.0731707317073,35,6,19,37.24794941900205,0.6125,46.00694444444444,1015.9722222222221,29.02777777777777,0
2881,4,1,0,42,0.023809523809523808,0.0,1.0,42,1050,700,350,0.6666666666666666,14,7,7,335.51151495739737,0.4452792295780101,0.06232524871578127,0.18661235401554466,129319.08543381326,277.72901663235035,129596.81445044561,2359,0,257.7857142857143,35,7,20,37.186125018965235,0.6154761904761905,45.71759259259258,1017.1296296296282,29.06084656084652,0
2882,4,0,1,41,0.0,0.023809523809523808,0.9761904761904762,42,900,600,300,0.6666666666666666,12,6,6,334.40575894885217,0.44503726287262874,0.06118966357874189,0.18627545127759237,129377.95380015418,252.94656635800982,129630.90036651219,2360,1,258.7857142857143,35,7,21,37.15443686006825,0.6160714285714286,45.659722222222214,1017.3611111111101,29.067460317460288,0
2883,4,1,1,41,0.023809523809523808,0.023809523809523808,0.9761904761904762,42,1250,1100,150,0.88,14,11,3,339.37056738950673,0.4449283778552071,0.08261236547794937,0.19060627719177048,129701.96926708231,403.4061803412035,130105.37544742352,2361,0,259.1190476190476,35,7,16,36.699073022005074,0.6193452380952381,45.341435185185176,1018.6342592592579,29.10383597883594,0
2884,4,0,0,41,0.0,0.0,1.0,41,1500,1100,400,0.7333333333333333,19,11,8,347.7302375167753,0.44273373983739833,0.08422817452397124,0.19492034414931156,129625.34722222218,814.9305555555522,130440.27777777772,2362,1,266.390243902439,34,7,17,36.564034369885434,0.6207107843137255,45.416666666666664,1018.3333333333329,29.95098039215685,0
2885,4,0,0,41,0.0,0.0,1.0,41,1500,1200,300,0.8,18,12,6,348.22899252930654,0.44250508130081306,0.08781855961600415,0.19565301963711573,129716.2857851472,834.1943027210682,130550.48008786827,2363,2,267.390243902439,34,7,17,36.458941996805734,0.6216299019607843,45.32738095238094,1018.6904761904747,29.96148459383749,0
2886,4,0,1,40,0.0,0.024390243902439025,0.975609756097561,41,800,500,300,0.625,11,5,6,348.22899252930654,0.4423272357723577,0.08781855961600415,0.19565301963711573,129716.2857851472,834.1943027210682,130550.48008786827,2364,3,268.390243902439,34,7,17,36.458941996805734,0.6216299019607843,45.32738095238094,1018.6904761904747,29.96148459383749,0
2887,4,1,2,39,0.024390243902439025,0.04878048780487805,0.9512195121951219,41,1100,600,500,0.5454545454545454,16,6,10,346.6579988333253,0.44059959349593497,0.09245855320563456,0.1952862239109039,129819.89354263114,800.6209008487635,130620.5144434799,2365,0,269.1219512195122,35,6,18,36.39373935264056,0.6205357142857143,45.22569444444444,1019.097222222222,29.117063492063483,0
2888,4,0,0,39,0.0,0.0,1.0,39,1000,600,400,0.6,14,6,8,360.7901101854342,0.43839968511021143,0.023959646910466592,0.20007451564828613,129201.3888888888,1548.2650945215953,130749.6539834104,2366,1,283.4102564102564,32,7,19,36.66325136612023,0.62109375,45.83333333333333,1016.666666666666,31.77083333333331,8
2889,4,2,1,40,0.04878048780487805,0.024390243902439025,0.975609756097561,41,1300,900,400,0.6923076923076923,17,9,8,347.18731467122757,0.4398882113821138,0.04954926738153653,0.1964337211013034,129989.2928004534,826.1267006802592,130815.41950113367,2367,0,270.5365853658537,34,7,19,36.20831387656628,0.6243872549019608,45.0595238095238,1019.7619047619038,29.99299719887952,0
2890,4,1,1,40,0.024390243902439025,0.024390243902439025,0.975609756097561,41,1450,1100,350,0.7586206896551724,18,11,7,347.99903540569596,0.4402184959349593,0.05168374942005882,0.19735299367249567,130080.35891439914,853.5678854875276,130933.92679988667,2368,0,271.5121951219512,34,7,20,36.095226980977934,0.6253063725490196,44.970238095238095,1020.119047619048,30.003501400560236,0
2891,4,0,0,40,0.0,0.0,1.0,40,1350,900,450,0.6666666666666666,18,9,9,351.8851573771182,0.4373130341880342,0.06262911361998591,0.19984964667952823,130137.5147178969,1158.6919694348323,131296.20668733172,2369,1,278.575,33,7,21,35.938125550484436,0.6281565656565656,44.91421568627451,1020.3431372549015,30.919489007724287,0
2892,4,0,0,40,0.0,0.0,1.0,40,1050,900,150,0.8571428571428571,12,9,3,352.6680073662317,0.43661858974358975,0.05619221995437651,0.20077729551287377,130231.31315179255,1185.6835411860782,131416.99669297863,2370,2,279.575,33,7,22,35.823002961540006,0.6291035353535354,44.822303921568626,1020.7107843137252,30.93062982768864,0
2893,4,0,0,40,0.0,0.0,1.0,40,1250,900,350,0.72,16,9,7,355.0183097940835,0.4361778846153846,0.05658610458647573,0.202950042962851,130391.51178770026,1258.2785798384862,131649.79036753875,2371,3,280.575,32,8,23,35.600558371450944,0.6331380208333333,44.66540404040404,1021.3383838383841,31.916824494949502,0
2894,4,0,0,40,0.0,0.0,1.0,40,1250,900,350,0.72,16,9,7,358.3578644038554,0.4355769230769231,0.05127872498146835,0.20571266343863867,130552.75769054187,1356.92148760332,131909.6791781452,2372,4,281.575,32,8,16,35.35180380528789,0.634765625,44.507575757575765,1021.9696969696976,31.93655303030305,0
2895,4,0,0,40,0.0,0.0,1.0,40,1100,900,200,0.8181818181818182,13,9,4,357.3591091682418,0.435309829059829,0.05258152173913033,0.20548148777173927,130617.2839506175,1335.4552469136058,131952.7391975311,2373,5,282.575,32,8,17,35.311933876811594,0.6354166666666667,44.44444444444446,1022.2222222222239,31.944444444444496,0
2896,4,0,0,40,0.0,0.0,1.0,40,1300,900,400,0.6923076923076923,17,9,8,357.7772539816681,0.4347889957264957,0.047607729349302685,0.20623757864751127,130714.10323245097,1353.3065822365338,132067.4098146875,2374,6,283.575,32,8,17,35.20316294192699,0.6363932291666667,44.34974747474749,1022.6010101010118,31.956281565656617,0
2897,4,0,0,40,0.0,0.0,1.0,40,1300,900,400,0.6923076923076923,17,9,8,357.3372466025609,0.4338942307692308,0.04968229487970399,0.20702061356066903,130907.84940631081,1355.6500931027754,132263.4994994136,2375,7,284.575,32,8,19,35.01825005140859,0.6383463541666667,44.16035353535355,1023.3585858585877,31.979955808080867,0
2898,4,0,1,39,0.0,0.025,0.975,40,1150,700,450,0.6086956521739131,16,7,9,358.51241742436304,0.43374732905982905,0.04646467759832329,0.20875048224903173,131101.7390604277,1400.320279818406,132502.0593402461,2376,8,285.575,32,8,21,34.79200057535036,0.6402994791666667,43.970959595959606,1024.116161616163,32.003630050505095,0
2899,4,0,0,39,0.0,0.0,1.0,39,1300,1100,200,0.8461538461538461,15,11,4,369.60032114160657,0.4310897435897436,0.04674104521432776,0.21423735429004626,130928.03955078125,1878.2090928819443,132806.2486436632,2377,10,293.6923076923077,31,8,21,34.68405428329093,0.6411290322580645,44.140625,1023.4375,33.01411290322581,0
2900,4,0,0,39,0.0,0.0,1.0,39,850,400,450,0.47058823529411764,13,4,9,375.2833831413071,0.43078047683310844,0.01677513724691493,0.2102649784572572,129606.62853529905,1944.2544822003738,131550.88301749944,2378,11,294.6923076923077,33,6,18,35.881649416295595,0.622790404040404,45.43504901960785,1018.2598039215696,30.85635769459302,8
2901,4,1,0,40,0.025,0.0,1.0,40,1100,1000,100,0.9090909090909091,12,10,2,396.2629557910383,0.4331063034188034,0.08896830864622807,0.20802013755178742,127004.50002411268,2187.7219156828037,129192.22193979549,2379,0,288.3,35,5,16,38.01778332759214,0.5919642857142857,48.00347222222222,1007.9861111111113,28.79960317460318,8
2902,4,2,1,41,0.047619047619047616,0.023809523809523808,0.9761904761904762,42,1050,700,350,0.6666666666666666,14,7,7,375.9751972495957,0.43831058846302745,0.0956050178838681,0.19976863962178684,127493.93449935105,1187.0319975757,128680.96649692675,2380,0,275.5238095238095,33,9,17,38.02569975326619,0.6013257575757576,47.51838235294117,1009.9264705882339,30.603832442067695,0
2903,4,0,0,41,0.0,0.0,1.0,41,800,400,400,0.5,12,4,8,383.4108325207946,0.43653455284552845,0.10111197547247541,0.20313913890018231,127378.63363751139,1567.6695936638985,128946.30323117529,2381,1,283.2439024390244,32,9,17,37.95653533458412,0.6025390625,47.63257575757575,1009.4696969696962,31.545928030303006,0
2904,4,0,0,41,0.0,0.0,1.0,41,1050,1000,50,0.9523809523809523,11,10,1,382.2487156534746,0.43630589430894307,0.0990678265962246,0.20268307230538324,127410.50020406066,1540.500012753778,128951.00021681444,2382,2,284.2439024390244,32,9,17,37.95309112889777,0.6028645833333333,47.60101010101009,1009.5959595959584,31.5498737373737,0
2905,4,0,2,39,0.0,0.04878048780487805,0.9512195121951219,41,1100,700,400,0.6363636363636364,15,7,8,381.86779223714444,0.4367378048780488,0.09908498485134842,0.20344248158998857,127601.78330017331,1545.4022548719317,129147.18555504525,2383,3,285.2439024390244,32,9,17,37.76607931350496,0.6048177083333333,47.41161616161615,1010.3535353535342,31.573547979797944,0
2906,4,3,1,41,0.07142857142857142,0.023809523809523808,0.9761904761904762,42,850,400,450,0.47058823529411764,13,4,9,366.79587019871633,0.4410448122338366,0.13020047182996253,0.2000235097536915,128536.57171201796,1029.3367346938542,129565.90844671182,2384,0,276.2142857142857,34,8,18,37.18938326680754,0.6096813725490196,46.48809523809523,1014.0476190476177,29.824929971988755,0
2907,4,0,0,41,0.0,0.0,1.0,41,900,600,300,0.6666666666666666,12,6,6,378.09625125527566,0.43874491869918697,0.1429455773890591,0.20608487370791484,128517.04422577845,1518.3625288350504,130035.40675461349,2385,1,283.9512195121951,33,8,19,36.92289098380469,0.6117424242424243,46.507352941176464,1013.9705882352932,30.72638146167555,0
2908,4,0,1,40,0.0,0.024390243902439025,0.975609756097561,41,1000,700,300,0.7,13,7,6,378.7781554084884,0.4381097560975609,0.13969359700846007,0.20694038233109274,128610.25694744797,1542.9511786332018,130153.20812608117,2386,2,284.9512195121951,33,8,19,36.81021203334541,0.6126893939393939,46.41544117647058,1014.3382352941165,30.737522281639894,0
2909,4,1,0,41,0.024390243902439025,0.0,1.0,41,1150,900,250,0.782608695652174,14,9,5,370.998969690322,0.43940548780487804,0.12353188339102439,0.2046369882590507,128989.67013888872,1371.006944444425,130360.67708333314,2387,0,270.9024390243902,34,7,20,36.61983866557288,0.6142769607843137,46.04166666666666,1015.8333333333319,29.877450980392116,0
2910,4,0,1,40,0.0,0.024390243902439025,0.975609756097561,41,1150,900,250,0.782608695652174,14,9,5,399.52548527791834,0.4399136178861789,0.20019645141091935,0.20875397097897067,126814.13286055834,1975.109483131478,128789.24234368982,2388,1,271.9024390243902,33,8,16,38.13204668045585,0.5943813131313131,48.19240196078431,1007.230392156862,30.522133095662483,8
2911,4,2,0,42,0.047619047619047616,0.0,1.0,42,950,700,250,0.7368421052631579,12,7,5,385.62030335238245,0.4446501161440186,0.2230778726006728,0.20544629720977184,127602.69451530596,1441.5420733244111,129044.23658863037,2389,0,263.6666666666667,34,8,16,37.670358587643854,0.6001838235294117,47.41071428571428,1010.3571428571415,29.71638655462181,0
2912,4,0,1,41,0.0,0.023809523809523808,0.9761904761904762,42,1500,1100,400,0.7333333333333333,19,11,8,388.74367670606483,0.4446380178087495,0.22596287513288105,0.20794096852587096,127763.95486379016,1533.4859128514888,129297.44077664166,2390,1,264.6666666666667,35,7,16,37.42570597214271,0.5997023809523809,47.2511574074074,1010.9953703703692,28.885582010581977,0
2913,4,0,0,41,0.0,0.0,1.0,41,1150,1000,150,0.8695652173913043,13,10,3,389.709878034054,0.443140243902439,0.23566068078263225,0.2086094053005817,127793.20987654307,1760.4552469135633,129553.66512345664,2391,2,271.4146341463415,35,6,16,37.37122252747251,0.6,47.222222222222214,1011.1111111111101,28.888888888888857,0
2914,4,1,1,41,0.023809523809523808,0.023809523809523808,0.9761904761904762,42,1200,800,400,0.6666666666666666,16,8,8,379.27916446527536,0.4449646728610143,0.23599766936808098,0.20466504733150206,128116.02776763243,1318.3479932635241,129434.37576089596,2392,0,265.92857142857144,36,6,17,37.30371709306635,0.6012731481481481,46.90315315315315,1012.3873873873869,28.121871871871857,0
2915,4,1,0,42,0.023809523809523808,0.0,1.0,42,1050,800,250,0.7619047619047619,13,8,5,371.75153422114965,0.44802555168408825,0.20909363854249174,0.19597377440116687,127174.94956380835,1055.499693368767,128230.44925717711,2393,0,260.95238095238096,37,5,18,38.46013606551437,0.5898085585585586,47.83442982456142,1008.6622807017565,27.261142721669092,8
2916,4,1,0,43,0.023255813953488372,0.0,1.0,43,1200,800,400,0.6666666666666666,16,8,8,362.1300596971764,0.44820505721668513,0.20774537896769263,0.19268090683381042,127550.2698905146,637.9573699686259,128188.22726048323,2394,0,255.86046511627907,38,5,17,38.31746871144017,0.5918311403508771,47.462606837606856,1010.1495726495752,26.582883490778297,0
2917,4,1,0,44,0.022727272727272728,0.0,1.0,44,1250,900,350,0.72,16,9,7,371.82246248465106,0.44964543692741366,0.2416921608801812,0.2003881790329099,128065.4418945317,723.5215928819888,128788.96348741368,2395,0,251.02272727272728,39,5,18,37.5442737813454,0.5953525641025641,46.95312500000002,1012.1875000000036,25.953525641025735,0
2918,4,1,0,45,0.022222222222222223,0.0,1.0,45,1500,1100,400,0.7333333333333333,19,11,8,361.16133918502015,0.4503367003367003,0.24387558114298047,0.19592952293657015,128329.16802300393,269.53125000005,128598.69927300398,2396,0,246.42222222222222,39,6,19,37.54422826496695,0.5980235042735043,46.69270833333336,1013.2291666666705,25.980235042735142,0
2919,4,1,1,45,0.021739130434782608,0.021739130434782608,0.9782608695652174,46,1600,1100,500,0.6875,21,11,10,354.8769937621578,0.450865539452496,0.23676672877017602,0.19475337437892512,128788.44024720755,-59.18909875072396,128729.25114845682,2397,0,242.04347826086956,40,6,17,37.23447303430784,0.6010416666666667,46.23983739837399,1015.0406504065056,25.37601626016264,0
2920,4,2,0,47,0.0425531914893617,0.0,1.0,47,950,600,350,0.631578947368421,13,6,7,349.8483351161549,0.45205057045945113,0.24719479143951917,0.19363566684305825,129125.75511975624,-365.11391014739223,128760.64120960885,2398,0,237.82978723404256,41,6,19,37.0183626159102,0.6028963414634146,45.907738095238095,1016.3690476190477,24.78948896631824,0
2921,4,1,2,46,0.020833333333333332,0.041666666666666664,0.9583333333333334,48,1050,800,250,0.7619047619047619,13,8,5,349.2298295808722,0.4522846483451537,0.2505757420675543,0.19497002485743528,129466.28146701369,-557.236084538001,128909.04538247568,2399,0,233.85416666666666,39,9,17,36.68756397134085,0.6095085470085471,45.57291666666666,1017.7083333333317,26.095085470085426,0
2922,4,1,0,47,0.02127659574468085,0.0,1.0,47,1100,600,500,0.5454545454545454,16,6,10,354.6245879783104,0.45004625346901017,0.24928478746853866,0.19815298825040226,129500.26167223658,-215.20461227996122,129285.05705995661,2400,0,239.5744680851064,38,9,18,36.51573597844722,0.6115679824561404,45.5395299145299,1017.8418803418783,26.785312640575746,0
2923,4,0,0,47,0.0,0.0,1.0,47,1450,1000,450,0.6896551724137931,19,10,9,356.204578291266,0.44941026827012026,0.25363148695075743,0.19958764466161366,129609.02829141982,-166.53414694283236,129442.49414447698,2401,1,240.5744680851064,38,9,19,36.364888259364186,0.6126644736842105,45.43269230769229,1018.2692307692283,26.79655870445338,0
2924,4,0,0,47,0.0,0.0,1.0,47,950,700,250,0.7368421052631579,12,7,5,360.8093084892559,0.4495259019426457,0.2568456007391242,0.2025886894662286,129690.6332182773,-41.28246219593984,129649.35075608136,2402,2,241.5744680851064,38,9,19,36.1646475770925,0.6134868421052632,45.352564102564095,1018.5897435897424,26.80499325236164,0
2925,4,0,1,46,0.0,0.02127659574468085,0.9787234042553191,47,1350,1000,350,0.7407407407407407,17,10,7,358.780649148963,0.4486971939562134,0.24942395812501705,0.2027566393689402,129943.77170138867,-75.73784722224133,129868.03385416642,2403,3,242.5744680851064,39,8,19,35.958997411796766,0.6143162393162394,45.10416666666666,1019.5833333333316,26.14316239316235,0
2926,4,0,1,45,0.0,0.021739130434782608,0.9782608695652174,46,1300,1000,300,0.7692307692307693,16,10,6,366.1942674823593,0.4465780998389694,0.26215423302598495,0.20704728014523904,129962.8351230915,318.32904156621976,130281.16416465772,2404,4,248.7173913043478,38,8,19,35.750646130203975,0.6162280701754386,45.085470085470085,1019.6581196581194,26.833108412055775,0
2927,4,0,0,45,0.0,0.0,1.0,45,1500,1000,500,0.6666666666666666,20,10,10,364.85269169741764,0.4451809764309764,0.26056307758435415,0.2072844413269946,130150.67737188378,497.164993074808,130647.84236495859,2405,5,254.04444444444445,37,8,19,35.593971631205676,0.6199324324324325,44.90131578947369,1020.3947368421063,27.57823613086774,0
2928,4,0,0,45,0.0,0.0,1.0,45,1600,1200,400,0.75,20,12,8,361.42358914809495,0.44450757575757577,0.2532112789970953,0.2062320756957697,130320.07250071033,420.1977599698748,130740.2702606802,2406,6,255.04444444444445,36,9,19,35.50949413624499,0.6235532407407407,44.73536036036037,1021.0585585585599,28.362737737737774,0
2929,4,0,0,45,0.0,0.0,1.0,45,1000,800,200,0.8,12,8,4,362.6302347659816,0.4442340067340067,0.25234840132304304,0.2073805945351485,130406.32482144317,457.8552369937655,130864.18005843693,2407,7,256.0444444444444,36,9,19,35.39117052554207,0.6244212962962963,44.65090090090091,1021.3963963963972,28.372122122122146,0
2930,4,0,0,45,0.0,0.0,1.0,45,1650,1300,350,0.7878787878787878,20,13,7,362.13029738979054,0.44377104377104376,0.26330737965819484,0.20801864424745187,130578.91506371237,457.3162689716743,131036.23133268404,2408,8,257.0444444444444,36,9,17,35.228900396650495,0.6261574074074074,44.48198198198198,1022.0720720720722,28.390890890890894,0
2931,4,0,0,45,0.0,0.0,1.0,45,1100,800,300,0.7272727272727273,14,8,6,378.6673999587727,0.44370791245791247,0.19294980259447247,0.2016148048429138,127577.25180802082,706.1565666197694,128283.4083746406,2409,9,258.0444444444444,38,7,14,37.872118231810475,0.5921052631578947,47.435897435897424,1010.2564102564086,26.585695006747596,8
2932,4,0,0,45,0.0,0.0,1.0,45,1300,800,500,0.6153846153846154,18,8,10,380.75238346392325,0.4436026936026936,0.19055203194738124,0.20326848462577374,127685.20801373351,723.2894568631607,128408.49747059667,2410,10,259.0444444444444,38,7,14,37.70855355884428,0.5932017543859649,47.32905982905982,1010.6837606837595,26.59694107062525,0
2933,4,1,0,46,0.021739130434782608,0.0,1.0,46,1050,900,150,0.8571428571428571,12,9,3,378.84313007316445,0.4446356682769726,0.19586696976748375,0.20403768579771947,128039.08420138867,501.3454861110903,128540.42968749977,2411,0,254.3913043478261,39,7,18,37.39364621929464,0.5950854700854701,46.97916666666666,1012.0833333333316,25.950854700854656,0
2934,4,0,0,46,0.0,0.0,1.0,46,800,400,400,0.5,12,4,8,376.63344840855615,0.444182769726248,0.19730524252817272,0.20325459233259163,128119.42087309434,450.81185830811097,128570.23273140244,2412,1,255.3913043478261,41,5,18,37.367201535195164,0.5927337398373984,46.899801587301575,1012.4007936507915,24.692702284165644,0
2935,4,4,2,48,0.08,0.04,0.96,50,1450,900,550,0.6206896551724138,20,9,11,351.0481053480246,0.44651360544217683,0.21049180327868866,0.19467213114754103,129201.38888888904,-919.7107662509277,128281.67812263811,2413,0,235.88,39,11,13,36.910860655737714,0.6068376068376069,45.83333333333334,1016.6666666666679,26.0683760683761,0
2936,4,0,2,46,0.0,0.041666666666666664,0.9583333333333334,48,2200,1700,500,0.7727272727272727,27,17,10,362.92452448492304,0.44511857269503546,0.21813361022801114,0.20004957819403557,128963.2175021703,-239.21712239581586,128724.00037977449,2414,1,246.70833333333334,39,9,15,36.85188271288415,0.6044337606837606,46.06770833333334,1015.729166666668,26.04433760683764,0
2937,4,0,2,44,0.0,0.043478260869565216,0.9565217391304348,46,1300,700,600,0.5384615384615384,19,7,12,384.35251089490123,0.4446356682769726,0.16701764298004562,0.20145783310992815,126942.00857426302,558.0959467120172,127500.10452097503,2415,2,256.39130434782606,41,5,15,38.38230950974602,0.5807926829268293,48.06547619047619,1007.7380952380952,24.57897793263647,8
2938,4,3,5,42,0.06382978723404255,0.10638297872340426,0.8936170212765957,47,1300,1100,200,0.8461538461538461,15,11,4,374.92725770953496,0.4480419364785692,0.20357783793982587,0.19956336691915832,127565.10959201369,165.79307504249684,127730.90266705619,2416,0,251.4255319148936,39,8,14,37.97905066336701,0.5902777777777778,47.44791666666666,1010.2083333333317,25.902777777777736,0
2939,4,1,0,43,0.023255813953488372,0.0,1.0,43,1150,700,450,0.6086956521739131,16,7,9,389.46962680799385,0.4434985234403839,0.22327552007301654,0.2070630161731415,127518.18700034499,1332.8921404512698,128851.07914079625,2417,0,271.0,36,7,16,37.6600419965065,0.5951967592592593,47.49436936936937,1010.0225225225229,28.05618118118119,0
2940,4,1,0,44,0.022727272727272728,0.0,1.0,44,1350,900,450,0.6666666666666666,18,9,9,379.2241243821651,0.4451198026779422,0.22210643015521025,0.20351032852969603,127894.85857427295,900.1631511619057,128795.02172543485,2418,0,265.8181818181818,37,7,17,37.53195573622402,0.5971283783783784,47.121710526315795,1011.5131578947376,27.33819345661453,0
2941,4,2,1,45,0.043478260869565216,0.021739130434782608,0.9782608695652174,46,1150,700,450,0.6086956521739131,16,7,9,367.6896087958862,0.447151771336554,0.23342468641298653,0.19990093516599244,128415.10662073547,243.6235277072155,128658.73014844269,2419,0,255.2173913043478,38,8,15,37.29094199079442,0.6006030701754386,46.607905982905976,1013.5683760683748,26.67285200179934,0
2942,4,1,1,45,0.021739130434782608,0.021739130434782608,0.9782608695652174,46,1100,600,500,0.5454545454545454,16,6,10,369.51945152420546,0.4479971819645732,0.2430164273584865,0.20254271610089,128740.17373666792,314.3996776608735,129054.57341432878,2420,0,255.6086956521739,38,8,18,36.91221883005228,0.6038925438596492,46.28739316239315,1014.8504273504257,26.706590193432255,0
2943,4,0,1,44,0.0,0.022222222222222223,0.9777777777777777,45,1550,900,650,0.5806451612903226,22,9,13,370.5198289715341,0.4476220538720539,0.25743546576879917,0.20378590593434334,128875.73964497013,550.203402366835,129425.94304733697,2421,1,261.1111111111111,38,7,18,36.74834280303029,0.6052631578947368,46.15384615384614,1015.3846153846131,26.720647773279293,0
2944,4,1,0,45,0.022222222222222223,0.0,1.0,45,1300,900,400,0.6923076923076923,17,9,8,366.8277181616331,0.44699074074074074,0.26307467740993773,0.2032828036288838,129174.23575726841,476.9380296223062,129651.17378689072,2422,0,262.02222222222224,38,7,19,36.53748467332281,0.6082785087719298,45.860042735042725,1016.5598290598275,26.75157444894283,0
2945,4,1,0,46,0.021739130434782608,0.0,1.0,46,1800,1100,700,0.6111111111111112,25,11,14,362.0030508662148,0.4477657004830918,0.27099622053604877,0.202802452659995,129602.41280131503,183.30232744541138,129785.71512876045,2423,0,257.30434782608694,36,10,17,36.2240101747401,0.6163194444444444,45.4391891891892,1018.2432432432448,28.28453453453458,0
2946,4,0,0,46,0.0,0.0,1.0,46,1350,1000,350,0.7407407407407407,17,10,7,365.02753530013047,0.4471014492753623,0.2717475406212,0.20524574964948977,129745.78622118775,272.15691197958984,130017.94313316734,2424,1,258.30434782608694,36,10,17,36.00111454994289,0.6177662037037037,45.29842342342344,1018.8063063063091,28.300175175175255,0
2947,4,0,0,46,0.0,0.0,1.0,46,1600,1200,400,0.75,20,12,8,366.6550267951568,0.44658816425120773,0.2769119958093238,0.20682191317280224,129871.11418898133,323.57937057557194,130194.69355955691,2425,2,259.30434782608694,37,9,17,35.83216795754446,0.6171171171171171,45.17543859649123,1019.298245614036,27.548601232811784,0
2948,4,0,0,46,0.0,0.0,1.0,46,1450,1000,450,0.6896551724137931,19,10,9,363.88555799391736,0.44632648953301124,0.27034991050105384,0.20629051468722814,130066.77685682141,265.8843346029645,130332.66119142437,2426,3,260.30434782608694,37,9,18,35.70387240675051,0.6190878378378378,44.98355263157895,1020.0657894736848,27.569345661450942,0
2949,4,0,1,45,0.0,0.021739130434782608,0.9782608695652174,46,1150,900,250,0.782608695652174,14,9,5,365.29297485142786,0.44553140096618354,0.27104150259704163,0.20754986334360448,130153.54624379076,308.83521897144993,130462.3814627622,2427,4,261.30434782608694,38,8,18,35.579825847206244,0.6181469298245614,44.89850427350428,1020.4059829059838,26.85278902384168,0
2950,4,3,2,46,0.0625,0.041666666666666664,0.9583333333333334,48,1850,1300,550,0.7027027027027027,24,13,11,351.39191879506836,0.4459219858156029,0.2832752768846021,0.20312804227744635,130822.85534972278,-405.8441959914457,130417.01115373134,2428,0,251.20833333333334,37,11,15,35.25634155055378,0.6266891891891893,44.24342105263157,1023.0263157894719,27.649359886201943,0
2951,4,1,0,47,0.02127659574468085,0.0,1.0,47,1500,1200,300,0.8,18,12,6,359.02728272418994,0.4455750847980265,0.28770136401648183,0.2073137195793906,130780.4145995656,-9.252622555009452,130771.16197701059,2429,0,257.3404255319149,36,11,16,35.10404051524825,0.6281828703703703,44.2849099099099,1022.860360360359,28.41278778778775,0
2952,4,1,0,48,0.020833333333333332,0.0,1.0,48,1600,1400,200,0.875,18,14,4,357.5851970230541,0.44543255023640665,0.2982548743613811,0.2089944926659418,131246.00643080182,-213.6741863905629,131032.33224441126,2430,0,252.95833333333334,38,10,18,34.669872797414236,0.6291118421052632,43.83012820512819,1024.6794871794848,26.96524966261802,0
2953,4,0,0,48,0.0,0.0,1.0,48,1550,900,650,0.5806451612903226,22,9,13,358.3387423967338,0.44519244976359335,0.2983393041742417,0.21034686629955135,131412.43128895407,-181.94124520678724,131230.4900437473,2431,1,253.95833333333334,37,11,18,34.48238601932057,0.6326013513513513,43.667763157894726,1025.3289473684194,27.711593172119443,0
2954,4,0,1,47,0.0,0.020833333333333332,0.9791666666666666,48,1500,1100,400,0.7333333333333333,19,11,8,372.56592367534427,0.44540484633569744,0.36418040583386224,0.19916490224949754,127739.20323800125,-62.04558019445972,127677.15765780679,2432,2,254.95833333333334,38,10,19,37.85999260198689,0.59375,47.27564102564102,1010.8974358974353,26.602564102564088,8
2955,4,0,1,46,0.0,0.02127659574468085,0.9787234042553191,47,1150,400,750,0.34782608695652173,19,4,15,342.87425086445205,0.4446692876965772,0.35289778499845026,0.1762737332355627,126151.14239763671,-656.800053875389,125494.34234376132,2433,3,261.1063829787234,38,9,18,40.24026020064517,0.5775767543859649,48.85149572649572,1004.5940170940164,26.436684660368854,8
2956,4,2,3,45,0.041666666666666664,0.0625,0.9375,48,1350,900,450,0.6666666666666666,18,9,9,337.4497312302001,0.4492279846335698,0.33824234925765095,0.17520135232879983,126554.60048788755,-1058.836815883398,125495.76367200416,2434,0,250.6875,40,8,16,39.96166212167122,0.5783854166666667,48.45020325203252,1006.1991869918703,25.154979674796756,0
2957,4,2,0,47,0.0425531914893617,0.0,1.0,47,1050,700,350,0.6666666666666666,14,7,7,346.3582933196009,0.4478492136910268,0.36048449778822933,0.18022941240427054,126646.00830078126,-627.0209418402769,126018.98735894098,2435,0,256.59574468085106,39,8,18,39.64359325951222,0.5809294871794872,48.359375,1006.5625000000001,25.809294871794876,0
2958,4,2,0,49,0.04081632653061224,0.0,1.0,49,1100,900,200,0.8181818181818182,13,9,4,339.1479819687394,0.4523809523809524,0.37252516171140715,0.17901477885583045,127226.7094587808,-1167.9117588854397,126058.79769989535,2436,0,247.08163265306123,38,11,20,39.22923505947969,0.5885416666666667,47.78311965811966,1008.8675213675216,26.549145299145305,0
2959,4,1,1,49,0.02,0.02,0.98,50,900,600,300,0.6666666666666666,12,6,6,335.11915488078125,0.45292517006802724,0.37234481336357983,0.17837461932128568,127565.10959201427,-1450.0976562499618,126115.01193576431,2437,0,243.12,39,11,16,38.98441259366193,0.5902777777777778,47.447916666666686,1010.2083333333364,25.902777777777857,0
2960,4,3,1,51,0.057692307692307696,0.019230769230769232,0.9807692307692307,52,950,700,250,0.7368421052631579,12,7,5,349.09976263924386,0.4572806686777275,0.380458218933718,0.18319425639449835,126989.5616448542,-1431.9997823406266,125557.56186251357,2438,0,234.44230769230768,40,12,17,39.221617261544665,0.5828125,48.01829268292683,1007.9268292682922,25.198170731707304,8
2961,4,1,1,51,0.019230769230769232,0.019230769230769232,0.9807692307692307,52,1750,1400,350,0.8,21,14,7,359.05259626972924,0.45651866515837103,0.37028137412449635,0.18704649624975417,126692.19655454773,-1291.7106347242898,125400.48591982343,2439,0,235.3653846153846,41,11,16,39.276622651425576,0.5782520325203252,48.31349206349206,1006.7460317460316,24.55478126209833,8
2962,4,4,1,54,0.07272727272727272,0.01818181818181818,0.9818181818181818,55,2100,1600,500,0.7619047619047619,26,16,10,336.6079458752558,0.4601851851851852,0.3812900337174143,0.18014590927987717,127784.64708713387,-2394.814959592037,125389.83212754183,2440,0,223.4,40,15,15,38.72227527054648,0.5908854166666666,47.230691056910565,1011.0772357723567,25.27693089430892,0
2963,4,0,0,54,0.0,0.0,1.0,54,1450,800,650,0.5517241379310345,21,8,13,342.62900216164286,0.45914861402282786,0.3878424976353787,0.18301761844788916,127707.59489225972,-2048.7348387203588,125658.86005353936,2441,1,228.53703703703704,40,14,15,38.64891246062067,0.5901041666666667,47.30691056910568,1010.7723577235759,25.269308943089396,0
2964,4,0,1,53,0.0,0.018518518518518517,0.9814814814814815,54,2250,1800,450,0.8,27,18,9,335.4050711842439,0.45848619846261357,0.37191420025891797,0.18030739139904564,127964.52591050269,-2216.0098155859882,125748.5160949167,2442,2,229.53703703703704,40,14,17,38.56886969331728,0.5927083333333334,47.05284552845527,1011.7886178861763,25.29471544715441,0
2965,4,3,1,55,0.05357142857142857,0.017857142857142856,0.9821428571428571,56,1450,1000,450,0.6896551724137931,19,10,9,346.6219627278325,0.46256764069264067,0.3775848418045764,0.1831007635488817,127257.9122903203,-2205.860599822577,125052.05169049771,2443,0,222.19642857142858,37,19,18,39.008729986234876,0.5906531531531531,47.75219298245615,1008.991228070177,27.270033191085865,8
2966,4,1,1,55,0.017857142857142856,0.017857142857142856,0.9821428571428571,56,1650,1200,450,0.7272727272727273,21,12,9,345.04171339285386,0.462790854978355,0.39490756124822535,0.1839574140512747,127631.22420374032,-2392.380743662785,125238.84346007754,2444,0,223.125,38,18,16,38.66612039190809,0.5926535087719298,47.38247863247864,1010.4700854700862,26.59131803868648,0
2967,4,0,0,55,0.0,0.0,1.0,55,1650,1100,550,0.6666666666666666,22,11,11,338.8174475620556,0.46115319865319865,0.28693164681905037,0.18109710644276034,127733.27637525626,-2281.9684572662914,125451.30791798997,2445,1,228.1090909090909,40,15,19,38.71896049060019,0.5903645833333333,47.28150406504066,1010.8739837398384,25.27184959349596,8
2968,4,0,0,55,0.0,0.0,1.0,55,2000,1300,700,0.65,27,13,14,339.2853980531675,0.4602413019079686,0.27349618738870296,0.18227663991469434,127938.82118985079,-2318.445225229677,125620.37596462111,2446,2,229.1090909090909,40,15,20,38.496986438975384,0.5924479166666667,47.07825203252033,1011.6869918699201,25.292174796748004,0
2969,4,0,1,54,0.0,0.01818181818181818,0.9818181818181818,55,2000,1400,600,0.7,26,14,12,343.0067354037029,0.45996071829405166,0.2724516523532685,0.18498592806476952,128093.08824319224,-2212.6415947848127,125880.44664840742,2447,3,230.1090909090909,40,15,22,38.24519793862733,0.5940104166666667,46.9258130081301,1012.2967479674825,25.30741869918706,0
2970,4,1,1,54,0.01818181818181818,0.01818181818181818,0.9818181818181818,55,1950,1600,350,0.8205128205128205,23,16,7,339.49513689773414,0.45998877665544335,0.28558835104289626,0.18409243338820813,128311.11495844887,-2287.7691087945495,126023.34584965432,2448,0,230.96363636363637,37,18,23,38.11147186147186,0.6013513513513513,46.71052631578948,1013.1578947368431,27.382645803698463,0
2971,4,1,1,54,0.01818181818181818,0.01818181818181818,0.9818181818181818,55,1700,1200,500,0.7058823529411765,22,12,10,344.60658855078043,0.4605780022446689,0.31054694791861204,0.18856562766767415,128672.41753472216,-2131.727430555559,126540.6901041666,2449,0,231.38181818181818,37,18,18,37.6133641341547,0.6050112612612613,46.354166666666664,1014.5833333333328,27.421171171171157,0
2972,4,0,1,53,0.0,0.018518518518518517,0.9814814814814815,54,950,500,450,0.5263157894736842,14,5,9,350.6512037396477,0.45920684835779174,0.31134722016552274,0.19111764155398245,128515.36502718946,-1787.1865108351517,126728.17851635431,2450,1,236.64814814814815,36,18,18,37.62031689619428,0.6053240740740741,46.50900900900901,1013.9639639639648,28.16566566566569,0
2973,4,0,0,53,0.0,0.0,1.0,53,1450,1000,450,0.6896551724137931,19,10,9,358.33700831229197,0.4571238509917755,0.32041886620221627,0.19578962224743923,128613.70991941007,-1382.5895919067343,127231.12032750333,2451,2,241.88679245283018,35,18,18,37.325041837821374,0.6083333333333334,46.41203703703703,1014.3518518518513,28.981481481481467,0
2974,4,1,3,51,0.018518518518518517,0.05555555555555555,0.9444444444444444,54,1600,1200,400,0.75,20,12,8,337.63283419876825,0.45859538784067083,0.3302808302808298,0.1807328700711053,127793.2098765432,-2158.7212791495203,125634.48859739368,2452,0,238.38888888888889,41,13,14,38.687614468864474,0.589430894308943,47.22222222222222,1011.1111111111111,24.661246612466122,8
2975,4,1,1,51,0.019230769230769232,0.019230769230769232,0.9807692307692307,52,1450,1000,450,0.6896551724137931,19,10,9,335.6066181891906,0.4569507290095525,0.3336897446190905,0.18134405334257553,128170.25662634663,-1796.560471151808,126373.69615519482,2453,0,245.3846153846154,40,12,17,38.35369831393016,0.5947916666666666,46.849593495934954,1012.6016260162592,25.31504065040648,0
2976,4,1,0,52,0.019230769230769232,0.0,1.0,52,1400,1000,400,0.7142857142857143,18,10,8,340.1103259401641,0.4573356586224233,0.3387912087912095,0.18508458817529358,128453.40617563933,-1662.3340314958173,126791.07214414352,2454,0,245.92307692307693,40,12,15,37.95071010860485,0.59765625,46.570121951219505,1013.7195121951206,25.342987804878014,0
2977,4,0,0,52,0.0,0.0,1.0,52,1450,900,550,0.6206896551724138,20,9,11,341.79067068427895,0.45679361488185016,0.34740044546176185,0.18672209546249535,128607.98306439628,-1608.598242613517,126999.38482178276,2455,1,246.92307692307693,40,12,16,37.750475904218,0.59921875,46.41768292682927,1014.3292682926837,25.358231707317092,0
2978,4,0,1,51,0.0,0.019230769230769232,0.9807692307692307,52,1700,1400,300,0.8235294117647058,20,14,6,344.9880880409244,0.4564243966817496,0.34929124455914606,0.18895809429997984,128711.08596280334,-1519.2417088042746,127191.84425399906,2456,2,247.92307692307693,40,12,17,37.56426306125854,0.6002604166666667,46.31605691056911,1014.7357723577244,25.36839430894311,0
2979,4,1,0,52,0.019230769230769232,0.0,1.0,52,1600,1200,400,0.75,20,12,8,403.4052184200709,0.457712732528909,0.4779821627647709,0.20951045214719835,126567.38281250015,-46.788271903282066,126520.59454059687,2457,0,248.65384615384616,35,17,17,38.28933747412008,0.5875,48.43750000000001,1006.2500000000011,28.750000000000032,7
2980,4,2,0,54,0.037037037037037035,0.0,1.0,54,1650,1000,650,0.6060606060606061,23,10,13,391.08444988435457,0.45992749825296997,0.47411186696900987,0.20637225586205182,127215.61418685125,-845.2500240292155,126370.36416282204,2458,0,240.40740740740742,33,21,20,37.93073777129899,0.5984848484848485,47.794117647058826,1008.8235294117651,30.5704099821747,0
2981,4,0,0,54,0.0,0.0,1.0,54,2050,1400,650,0.6829268292682927,27,14,13,363.02611781952845,0.46032058001397624,0.4316003373974384,0.1885393708675616,126567.38281250001,-1607.1677660034582,124960.21504649655,2459,1,241.40740740740742,37,17,17,39.305124223602476,0.5836148648648649,48.4375,1006.2500000000001,27.195945945945947,8
2982,4,2,0,56,0.03571428571428571,0.0,1.0,56,1450,800,650,0.5517241379310345,21,8,13,351.5482171685065,0.46357548701298706,0.4347404772538763,0.18520387252712608,127148.79575521464,-2256.9582990930135,124891.83745612163,2460,0,233.75,36,20,19,38.99643628107787,0.5914351851851851,47.86036036036036,1008.5585585585583,28.015515515515506,0
2983,4,0,0,56,0.0,0.0,1.0,56,2200,1800,400,0.8181818181818182,26,18,8,349.008077439555,0.4639339826839827,0.43230265607546214,0.18511903093683313,127423.91889812256,-2305.6046091104895,125118.31428901207,2461,1,234.75,37,19,16,38.77832681726034,0.5923423423423424,47.58771929824562,1009.649122807018,27.287814129919404,0
2984,4,2,2,56,0.034482758620689655,0.034482758620689655,0.9655172413793104,58,1650,1000,650,0.6060606060606061,23,10,13,331.85795671279277,0.46644358741681796,0.430750560054846,0.17874382860479732,128041.65556423091,-3101.6715620662303,124939.98400216468,2462,0,227.6206896551724,40,18,18,38.57984402717811,0.5934895833333333,46.97662601626016,1012.093495934959,25.302337398373975,0
2985,4,1,1,56,0.017543859649122806,0.017543859649122806,0.9824561403508771,57,2050,1400,650,0.6829268292682927,27,14,13,344.2903351453878,0.465499686716792,0.4493538372680672,0.1859167809785092,128144.53124999988,-2576.09134361162,125568.43990638826,2463,0,232.42105263157896,36,21,19,38.16015089163237,0.6015625,46.87499999999999,1012.4999999999991,28.124999999999975,0
2986,4,0,0,56,0.0,0.0,1.0,56,1750,1200,550,0.6857142857142857,23,12,11,347.31630115386986,0.4638866341991342,0.4494964722909012,0.18742421809419496,128117.48940755322,-2300.5414931697223,125816.9479143835,2464,1,237.48214285714286,38,18,20,38.11119318981289,0.5975877192982456,46.90170940170939,1012.3931623931601,26.64192532613579,0
2987,4,0,1,55,0.0,0.017857142857142856,0.9821428571428571,56,1600,1000,600,0.625,22,10,12,342.03116629867475,0.4638189935064935,0.4398408746481921,0.18521007703793405,128255.57503270221,-2426.516363882987,125829.05866881923,2465,2,238.48214285714286,37,19,20,38.103936638522036,0.6007882882882882,46.76535087719297,1012.9385964912268,27.37671882408721,0
2988,4,3,0,58,0.05172413793103448,0.0,1.0,58,2000,1500,500,0.75,25,15,10,332.29832847123237,0.4667712744504941,0.44176724579972415,0.18316794804539163,128963.21750216975,-3029.1476779514305,125934.06982421831,2466,0,229.74137931034483,39,19,20,37.62958072676305,0.6044337606837606,46.067708333333314,1015.7291666666636,26.044337606837527,0
2989,4,0,1,57,0.0,0.017241379310344827,0.9827586206896551,58,1700,1300,400,0.7647058823529411,21,13,8,332.3343072471245,0.46649400080661424,0.44299760030817925,0.18392432420931276,129121.9740125864,-3017.6676432292074,126104.3063693572,2467,1,230.74137931034483,39,19,21,37.46722438591096,0.6060363247863247,45.911458333333314,1016.3541666666634,26.060363247863165,0
2990,4,2,1,58,0.03389830508474576,0.01694915254237288,0.9830508474576272,59,1600,1000,600,0.625,22,10,12,325.34744027379804,0.468086401714397,0.43209750326787866,0.18195937563264653,129536.0351261923,-3371.0832675078336,126164.95185868448,2468,0,226.6271186440678,37,22,17,37.22443630618983,0.6137387387387387,45.50438596491226,1017.982456140348,27.51303935514454,0
2991,4,0,1,57,0.0,0.017241379310344827,0.9827586206896551,58,1850,1200,650,0.6486486486486487,25,12,13,329.239877913739,0.46740774349667275,0.4186478264992741,0.17506376860497683,127523.29082657606,-3188.5061037720816,124334.78472280398,2469,1,231.5344827586207,38,20,17,39.175657569988005,0.5915570175438596,47.48931623931624,1010.0427350427349,26.580071974808813,8
2992,4,1,1,57,0.017241379310344827,0.017241379310344827,0.9827586206896551,58,1950,1500,450,0.7692307692307693,24,15,9,327.464250956272,0.4674959669288163,0.42344586000838413,0.17521323152048401,127775.65646701407,-3231.608072916648,124544.04839409742,2470,0,232.41379310344828,39,19,18,38.9625832818188,0.5924145299145299,47.23958333333334,1011.0416666666681,25.924145299145337,0
2993,4,1,1,57,0.017241379310344827,0.017241379310344827,0.9827586206896551,58,1500,1000,500,0.6666666666666666,20,10,10,342.59682636454477,0.4664624924379915,0.4484887186036617,0.18500228623685416,128144.53124999999,-2818.0230034722226,125326.50824652777,2471,0,232.8448275862069,36,22,19,38.203017832647475,0.6015625,46.875,1012.4999999999999,28.124999999999996,0
2994,4,0,2,55,0.0,0.03508771929824561,0.9649122807017544,57,1600,1000,600,0.625,22,10,12,345.3064404138935,0.4669747284878864,0.4440112627247126,0.18646547782350237,128144.5312499999,-2550.173611111125,125594.35763888877,2472,1,225.68421052631578,35,22,19,38.134430727023314,0.6035714285714286,46.87499999999999,1012.4999999999992,28.928571428571406,0
2995,4,1,0,56,0.017857142857142856,0.0,1.0,56,1400,1000,400,0.7142857142857143,18,10,8,349.3367418993017,0.4679991883116883,0.4455433629762593,0.18961210014435104,128349.6914250041,-2232.5473947616783,126117.14403024242,2473,0,228.26785714285714,35,21,20,37.82279173805445,0.6056547619047619,46.672453703703695,1013.3101851851837,28.951719576719537,0
2996,4,2,1,57,0.034482758620689655,0.017241379310344827,0.9827586206896551,58,1400,1000,400,0.7142857142857143,18,10,8,332.123581301401,0.46899576527525716,0.43608400983093776,0.1826285251099151,128867.1754770697,-3040.034433671918,125827.14104339779,2474,0,221.36206896551724,37,21,18,37.73173146148308,0.6069819819819819,46.162280701754376,1015.3508771929811,27.4419155998103,0
2997,4,1,0,58,0.017241379310344827,0.0,1.0,58,1700,1100,600,0.6470588235294118,23,11,12,329.6542099648525,0.46934235733010693,0.4329468843480724,0.18229327076099333,129089.93632656173,-3088.9918051708555,126000.94452139088,2475,0,218.8793103448276,37,21,21,37.567885915695584,0.6092342342342343,45.942982456140335,1016.2280701754362,27.465623518255033,0
2998,4,2,4,56,0.03333333333333333,0.06666666666666667,0.9333333333333333,60,2100,1500,600,0.7142857142857143,27,15,12,320.6924207363427,0.4707744821092279,0.44287734723784267,0.18037335061657073,129757.97661675337,-3677.520073784729,126080.45654296863,2476,0,212.55,39,21,17,37.117988106192286,0.6124465811965811,45.28645833333333,1018.8541666666657,26.124465811965788,0
2999,4,0,0,56,0.0,0.0,1.0,56,2200,1500,700,0.6818181818181818,29,15,14,345.41643051180233,0.4701975108225109,0.4475983330896336,0.19284105863430312,129466.28146701373,-2256.043836805573,127210.23763020815,2477,1,224.67857142857142,35,21,17,36.78458717161377,0.6169642857142856,45.57291666666666,1017.708333333332,29.077380952380913,0
3000,4,0,0,56,0.0,0.0,1.0,56,1950,1300,650,0.6666666666666666,26,13,13,344.15218723449647,0.47029897186147185,0.4456266689841517,0.19266129565245071,129573.74762854057,-2281.3822690934358,127292.36535944714,2478,2,225.67857142857142,36,20,18,36.70754525679313,0.6160300925925926,45.467342342342334,1018.1306306306295,28.281406406406376,0
3001,4,1,3,54,0.017543859649122806,0.05263157894736842,0.9473684210526316,57,1850,1200,650,0.6486486486486487,25,12,13,336.13759784830347,0.4700031328320802,0.439581770856311,0.19005315366494122,129962.83512309153,-2662.9209584337773,127299.91416465775,2479,0,222.7017543859649,38,19,19,36.51683431126011,0.6162280701754386,45.085470085470085,1019.6581196581196,26.83310841205578,0
3002,4,0,0,54,0.0,0.0,1.0,54,2250,1700,550,0.7555555555555555,28,17,11,352.4355247344923,0.4682477288609364,0.44927100340866755,0.1987472856306477,129860.5420242881,-1646.5063458728632,128214.03567841522,2480,1,234.33333333333334,36,18,20,36.205253563142215,0.6189236111111112,45.18581081081083,1019.2567567567592,28.312687687687756,0
3003,4,1,2,53,0.01818181818181818,0.03636363636363636,0.9636363636363636,55,1700,1200,500,0.7058823529411765,22,12,10,349.3544356518115,0.4679012345679012,0.45150278293135404,0.1990507831039393,130262.58680555565,-1898.4374999999914,128364.14930555566,2481,0,231.05454545454546,37,18,21,35.87585034013605,0.6210585585585586,44.79166666666667,1020.8333333333342,27.59009009009011,0
3004,4,0,1,52,0.0,0.018867924528301886,0.9811320754716981,53,1400,1000,400,0.7142857142857143,18,10,8,360.0679957525895,0.46592283502660864,0.4526460695927328,0.2040694049239596,130055.90284475745,-1234.2063453789315,128821.69649937852,2482,1,239.79245283018867,35,18,21,35.81227069858922,0.6229166666666667,44.99421296296297,1020.0231481481487,29.143518518518533,0
3005,4,0,0,52,0.0,0.0,1.0,52,1600,1200,400,0.75,20,12,8,361.52475867187655,0.4658355329311212,0.44423142356112777,0.2055166858291383,130173.98787133486,-987.7760898919784,129186.21178144288,2483,2,239.21153846153845,35,17,21,35.65519734603607,0.6241071428571429,44.87847222222222,1020.486111111111,29.156746031746028,0
3006,4,0,1,51,0.0,0.019230769230769232,0.9807692307692307,52,1000,800,200,0.8,12,8,4,361.19519544393086,0.4654584590246355,0.4398087171927745,0.20564108641833595,130233.05047850215,-992.0895758316279,129240.96090267051,2484,3,240.21153846153845,35,17,21,35.60364459311335,0.624702380952381,44.82060185185185,1020.7175925925919,29.16335978835977,0
3007,4,0,0,51,0.0,0.0,1.0,51,650,300,350,0.46153846153846156,10,3,7,363.02119941080804,0.4651633986928105,0.4311654322033702,0.20700408023897612,130293.86421388402,-740.106329481845,129553.75788440218,2485,4,233.72549019607843,33,18,21,35.49531368783259,0.6297348484848485,44.7610294117647,1020.9558823529406,30.938057040998203,0
3008,4,0,0,51,0.0,0.0,1.0,51,1150,700,450,0.6086956521739131,16,7,9,366.9901283193407,0.4646078431372549,0.4359060487031312,0.21008287465698863,130444.94224773225,-625.5987811791629,129819.3434665531,2486,5,234.72549019607843,34,17,21,35.24064794313016,0.6289828431372548,44.61309523809523,1021.5476190476177,30.04551820728287,0
3009,4,0,0,51,0.0,0.0,1.0,51,1500,1000,500,0.6666666666666666,20,10,10,367.67753830573207,0.464297385620915,0.43481260164830204,0.21097219176580226,130536.16780045339,-600.9566326530714,129935.21116780031,2487,6,235.72549019607843,34,17,17,35.13052384280833,0.6299019607843137,44.52380952380952,1021.9047619047609,30.056022408963557,0
3010,4,0,0,51,0.0,0.0,1.0,51,1850,1500,350,0.8108108108108109,22,15,7,367.6432726063028,0.46452614379084967,0.4349899288856003,0.2112841458231402,130597.00255102034,-597.3781179138464,129999.6244331065,2488,7,236.72549019607843,34,17,17,35.06968708750677,0.6305147058823529,44.46428571428571,1022.1428571428567,30.06302521008402,0
3011,4,1,2,50,0.019230769230769232,0.038461538461538464,0.9615384615384616,52,1250,800,450,0.64,17,8,9,375.39840432815004,0.4653170563097034,0.4074490693851798,0.20729687809920389,129034.22807979389,-712.1513350261528,128322.07674476774,2489,0,233.15384615384616,37,15,18,36.46260522339735,0.6086711711711712,45.99780701754386,1016.0087719298253,27.45969653864393,8
3012,4,0,0,50,0.0,0.0,1.0,50,1700,1500,200,0.8823529411764706,19,15,4,390.6683755273167,0.4646003401360544,0.44600455580865606,0.21599926556233265,129083.74592764063,85.78746570645194,129169.53339334708,2490,1,243.12,35,15,18,36.024107820804865,0.6130952380952381,45.949074074074076,1016.2037037037039,29.034391534391542,0
3013,4,0,0,50,0.0,0.0,1.0,50,1350,900,450,0.6666666666666666,18,9,9,388.680890670919,0.46474489795918367,0.44652698701890237,0.2152204023878947,129142.56071030519,39.04910408092928,129181.60981438612,2491,2,244.12,35,15,18,36.01448037652774,0.6136904761904762,45.8912037037037,1016.435185185185,29.041005291005284,0
3014,4,0,1,49,0.0,0.02,0.98,50,2050,1400,650,0.6829268292682927,27,14,13,387.1082609371721,0.4643962585034014,0.4229883481836876,0.20995946197298637,128320.37278163561,10.998049554162321,128331.37083118978,2492,3,245.12,35,15,18,36.895990404386566,0.6053571428571429,46.70138888888888,1013.194444444443,28.948412698412657,8
3015,4,1,0,50,0.02,0.0,1.0,50,1300,800,500,0.6153846153846154,18,8,10,376.9982210293058,0.46392006802721086,0.43877094972067,0.19778042662440168,126978.48820103913,-419.8390042632446,126558.64919677589,2493,0,242.7,36,14,19,38.530027932960884,0.5896990740740741,48.029279279279294,1007.882882882885,27.99674674674681,8
3016,4,1,3,48,0.0196078431372549,0.058823529411764705,0.9411764705882353,51,1450,900,550,0.6206896551724138,20,9,11,364.1326855475948,0.46450980392156865,0.4279037214439596,0.19304846398191539,127404.47108848726,-921.5228319535589,126482.94825653371,2494,0,238.92156862745097,36,15,18,38.416527235545644,0.5940393518518519,47.60698198198199,1009.5720720720731,28.043668668668698,0
3017,4,0,2,46,0.0,0.041666666666666664,0.9583333333333334,48,2150,1700,450,0.7906976744186046,26,17,9,382.2822277419452,0.46349549349881797,0.4302540506528236,0.20200898767710257,127272.13718820854,130.77522675735725,127402.91241496589,2495,2,247.20833333333334,34,14,19,38.094570945414496,0.5968137254901961,47.738095238095234,1009.0476190476185,29.677871148459367,0
3018,4,1,0,47,0.02127659574468085,0.0,1.0,47,1250,900,350,0.72,16,9,7,380.97200198112955,0.46442337341967316,0.4118737939503301,0.20342467275596154,127692.9209183673,329.4855442176811,128022.40646258497,2496,0,244.6595744680851,34,13,19,37.69508244994113,0.6011029411764706,47.32142857142857,1010.7142857142852,29.726890756302506,0
3019,4,0,1,46,0.0,0.02127659574468085,0.9787234042553191,47,1550,1000,550,0.6451612903225806,21,10,11,382.4324872055397,0.4644426456984274,0.41666562308241284,0.20496933620259095,127843.36911848096,378.29152494333147,128221.66064342429,2497,1,245.6595744680851,34,13,19,37.50367863449086,0.6026348039215687,47.17261904761906,1011.3095238095257,29.744397759103695,0
3020,4,2,1,47,0.041666666666666664,0.020833333333333332,0.9791666666666666,48,1500,1200,300,0.8,18,12,6,365.83235991954564,0.46466829196217496,0.3998201644211008,0.19900371479350207,128437.66744898843,-202.31469452492064,128235.35275446351,2498,0,233.29166666666666,35,13,19,37.31493111060363,0.6065476190476191,46.58564814814815,1013.6574074074082,28.961640211640233,0
3021,4,2,0,49,0.04081632653061224,0.0,1.0,49,1700,900,800,0.5294117647058824,25,9,16,355.5745724839909,0.46595096371882083,0.37660774795398066,0.19632764950737847,129029.71172185692,-624.0630833536338,128405.64863850329,2499,0,222.75510204081633,36,13,21,36.97073819552205,0.6105324074074074,46.00225225225225,1015.9909909909904,28.221971971971957,0
3022,4,1,1,49,0.02,0.02,0.98,50,1750,1400,350,0.8,21,14,7,353.3114228802583,0.4661224489795918,0.3856705806312619,0.1974587560865404,129508.13140822173,-848.659563519546,128659.47184470219,2500,0,219.28,37,13,16,36.541146001651775,0.6134572072072072,45.531798245614034,1017.8728070175436,27.510075865339015,0
3023,4,1,2,48,0.02,0.04,0.96,50,1450,1000,450,0.6896551724137931,19,10,9,351.2702802219805,0.46598639455782315,0.39070167886353846,0.19757890095778718,129759.37307633122,-883.8777316097221,128875.4953447215,2501,0,219.76,37,13,17,36.337709857942315,0.615990990990991,45.28508771929825,1018.8596491228074,27.536747273589388,0
3024,4,0,1,47,0.0,0.020833333333333332,0.9791666666666666,48,1700,1500,200,0.8823529411764706,19,15,4,370.01371328029205,0.4639387559101655,0.4099701534963045,0.20688306473618387,129525.1833231526,-14.78119105793769,129510.40213209466,2502,1,229.83333333333334,35,13,19,36.09875402690922,0.6175595238095238,45.515046296296305,1017.9398148148161,29.083994708994748,0
3025,4,0,0,47,0.0,0.0,1.0,47,1050,900,150,0.8571428571428571,12,9,3,370.8264462809916,0.4630935861856306,0.40029013539651803,0.20811688311688314,129672.49657064478,217.1982167352637,129889.69478738005,2503,2,233.5531914893617,35,12,19,35.92803030303029,0.6190476190476191,45.370370370370374,1018.518518518519,29.100529100529116,0
3026,4,0,1,46,0.0,0.02127659574468085,0.9787234042553191,47,1550,1200,350,0.7741935483870968,19,12,7,344.13859071102144,0.4630550416281221,0.27558675148058787,0.1834145236207091,127617.73003472215,-605.8604466735346,127011.8695880486,2504,3,234.5531914893617,39,8,16,38.70274914089346,0.5908119658119658,47.39583333333333,1010.416666666666,25.908119658119638,8
3027,4,1,1,46,0.02127659574468085,0.02127659574468085,0.9787234042553191,47,1450,1100,350,0.7586206896551724,18,11,7,338.18875119201545,0.464172833795868,0.2855064557192222,0.1815451057393953,127907.33642578124,-748.635525173612,127158.70090060763,2505,0,235.40425531914894,39,8,17,38.55689853430817,0.59375,47.109375,1011.5624999999999,25.937499999999996,0
3028,4,0,0,46,0.0,0.0,1.0,46,2000,1600,400,0.8,24,16,8,340.2259140713642,0.4629730273752013,0.29370191447486094,0.18372199359853683,128144.53125000015,-480.1622178819306,127664.36903211822,2506,1,241.43478260869566,38,8,18,38.2630315500686,0.5978618421052632,46.87500000000001,1012.5000000000011,26.644736842105292,0
3029,4,0,1,45,0.0,0.021739130434782608,0.9782608695652174,46,1600,1000,600,0.625,22,10,12,343.8154020067199,0.46174516908212565,0.297029634892622,0.1866679500877926,128360.96871803999,-373.5043876470192,127987.46433039298,2507,2,242.43478260869566,38,8,19,37.95115094008083,0.6000548245614035,46.66132478632478,1013.3547008547005,26.66722896986054,0
3030,4,2,0,47,0.0425531914893617,0.0,1.0,47,1600,1400,200,0.875,18,14,4,329.631457973526,0.463768115942029,0.28522906120595737,0.18121363907884716,128857.4340820314,-904.9072265624866,127952.52685546891,2508,0,236.2340425531915,39,8,15,37.804901508156355,0.6033653846153846,46.17187500000001,1015.3125000000011,26.033653846153875,0
3031,4,0,2,45,0.0,0.0425531914893617,0.9574468085106383,47,1650,1200,450,0.7272727272727273,21,12,9,327.16637037725286,0.4636717545482578,0.27884535573437974,0.18060089479080058,129020.64252635677,-957.7569361821584,128062.88559017461,2509,1,237.2340425531915,40,7,18,37.70151878897004,0.6033854166666667,46.01117886178862,1015.9552845528463,25.398882113821156,0
3032,4,2,0,47,0.0425531914893617,0.0,1.0,47,1050,600,450,0.5714285714285714,15,6,9,317.2934486929537,0.46471245760098673,0.26565580178098,0.17734437400159742,129511.53413973171,-1181.2412213298899,128330.29291840181,2510,0,226.91489361702128,40,7,10,37.4542398828541,0.6083333333333334,45.52845528455285,1017.8861788617892,25.447154471544728,0
3033,4,0,0,47,0.0,0.0,1.0,47,1200,800,400,0.6666666666666666,16,8,8,318.65565815209595,0.4645968239284613,0.26558050342646844,0.17845785573090292,129589.1285465829,-1141.1381907264038,128447.9903558565,2511,1,227.91489361702128,40,7,10,37.34092723824733,0.6091145833333333,45.45223577235773,1018.1910569105705,25.45477642276426,0
3034,4,1,0,48,0.020833333333333332,0.0,1.0,48,1200,1000,200,0.8333333333333334,14,10,4,317.99181818856783,0.464345079787234,0.2786103542234333,0.1795430727310837,129908.37191358031,-1338.0401234567817,128570.33179012353,2512,0,224.14583333333334,41,7,12,37.03451407811081,0.6107723577235773,45.13888888888889,1019.4444444444449,24.864498644986462,0
3035,4,1,1,48,0.02040816326530612,0.02040816326530612,0.9795918367346939,49,1550,1100,450,0.7096774193548387,20,11,9,289.75670062564166,0.4635062358276644,0.17936444772895221,0.1640735891555292,130021.0243414258,-2257.391345589714,127763.63299583609,2513,0,220.55102040816325,43,6,14,37.6404363974002,0.6090116279069768,45.0284090909091,1019.8863636363651,23.718287526427094,8
3036,4,0,1,47,0.0,0.020833333333333332,0.9791666666666666,48,1450,1200,250,0.8275862068965517,17,12,5,295.8879302025871,0.4622395833333333,0.18609924026590718,0.16805285356166338,130138.96869929683,-1898.689982573165,128240.27871672367,2514,1,225.79166666666666,42,6,17,37.36506805951251,0.6116071428571428,44.91279069767442,1020.3488372093017,24.2940199335548,0
3037,4,0,2,45,0.0,0.0425531914893617,0.9574468085106383,47,1400,1000,400,0.7142857142857143,18,10,8,301.7882426678268,0.4611470860314524,0.18969993483590009,0.17139105885359474,130136.02612630712,-1545.2954735134692,128590.73065279365,2515,2,231.40425531914894,41,6,19,37.217529573813,0.6130589430894309,44.91567460317461,1020.3373015873025,24.886275648470793,0
3038,4,0,1,44,0.0,0.022222222222222223,0.9777777777777777,45,1300,900,400,0.6923076923076923,17,9,8,309.62187842084836,0.4602272727272727,0.2091770177528216,0.17581137965983853,130129.69970703153,-941.7995876735815,129187.90011935795,2516,3,241.3111111111111,39,6,19,37.024098179343206,0.6161858974358974,44.921875000000014,1020.3125000000022,26.16185897435903,0
3039,4,0,0,44,0.0,0.0,1.0,44,1100,800,300,0.7272727272727273,14,8,6,315.2719277531642,0.4597978329809725,0.20799583099342245,0.17912921962941555,130153.54624379077,-593.2481143618847,129560.29812942889,2517,4,246.04545454545453,38,6,19,36.85587024046349,0.6181469298245614,44.89850427350428,1020.4059829059839,26.852789023841684,0
3040,4,0,1,43,0.0,0.022727272727272728,0.9772727272727273,44,650,300,350,0.46153846153846156,10,3,7,316.23026823817,0.45978682170542634,0.20993616508007218,0.17993171708464545,130209.42382812525,-564.7677951388596,129644.65603298639,2518,5,247.04545454545453,39,5,19,36.77493706198547,0.6169871794871795,44.843750000000014,1020.6250000000019,26.169871794871845,0
3041,4,0,0,43,0.0,0.0,1.0,43,1550,1000,550,0.6451612903225806,21,10,11,328.9473654841918,0.4585179032853452,0.20790196492710789,0.17632025830539952,127847.22792935911,-73.52514735830493,127773.70278200081,2519,6,253.11627906976744,38,5,14,38.85198781604338,0.5948464912280702,47.16880341880341,1011.3247863247844,26.613810166441695,8
3042,4,1,0,44,0.022727272727272728,0.0,1.0,44,1350,900,450,0.6666666666666666,18,9,9,320.3811908095035,0.45901603241719524,0.21083858540143274,0.17323392308398147,128197.27105034703,-585.6011284722424,127611.66992187478,2520,0,248.3409090909091,39,5,16,38.71159912226565,0.5966880341880342,46.82291666666666,1012.7083333333318,25.9668803418803,0
3043,4,0,1,43,0.0,0.022727272727272728,0.9772727272727273,44,1150,700,450,0.6086956521739131,16,7,9,317.53167634539477,0.4592142353770261,0.20581184519192086,0.17226049167940088,128329.16802300356,-650.2848307291615,127678.8831922744,2521,1,249.3409090909091,39,5,16,38.64939943799047,0.5980235042735043,46.692708333333336,1013.2291666666674,25.980235042735064,0
3044,4,0,1,42,0.0,0.023255813953488372,0.9767441860465116,43,1400,1100,300,0.7857142857142857,17,11,6,324.42713211575943,0.45891011443337026,0.2207672187889922,0.17638052735714663,128415.10662073559,-267.73104773905993,128147.37557299653,2522,2,255.93023255813952,38,5,13,38.38717894662873,0.6006030701754386,46.60790598290598,1013.5683760683758,26.672852001799363,0
3045,4,0,0,42,0.0,0.0,1.0,42,1400,900,500,0.6428571428571429,19,9,10,334.3836264510667,0.4579461866047232,0.24255018901352554,0.18207956479190562,128477.80687326849,192.17499615264364,128669.98186942113,2523,3,262.6904761904762,37,5,14,38.07096762563993,0.6030405405405406,46.54605263157894,1013.8157894736825,27.40042674253196,0
3046,4,0,1,41,0.0,0.023809523809523808,0.9761904761904762,42,1450,1200,250,0.8275862068965517,17,12,5,336.5762220986411,0.45760743321718933,0.2447534629460919,0.18391415420168478,128616.79945992975,257.87129212832383,128874.67075205808,2524,4,263.6904761904762,37,5,15,37.873720859006234,0.6044481981981982,46.408991228070164,1014.3640350877175,27.415244191559932,0
3047,4,0,0,41,0.0,0.0,1.0,41,1300,1100,200,0.8461538461538461,15,11,4,343.6874665645896,0.45734247967479674,0.24045872826360637,0.18799516613724274,128658.13607103721,643.6377678354004,129301.77383887261,2525,5,269.390243902439,36,5,15,37.65123765123766,0.6067708333333333,46.36824324324324,1014.5270270270266,28.181306306306297,0
3048,4,1,0,42,0.023809523809523808,0.0,1.0,42,1300,800,500,0.6153846153846154,18,8,10,349.6509400689947,0.4581760549748355,0.2681183980116366,0.1940343008533684,129229.25954380186,637.0264167820787,129866.28596058395,2526,0,263.95238095238096,37,5,16,36.91800118623962,0.6106418918918919,45.805921052631575,1016.776315789473,27.48044096728305,0
3049,4,1,1,42,0.023255813953488372,0.023255813953488372,0.9767441860465116,43,1050,500,550,0.47619047619047616,16,5,11,341.6969266074682,0.4590254706533776,0.26993242171388654,0.191193776491049,129554.63927469129,253.68441358023887,129808.32368827153,2527,0,258.7906976744186,38,5,15,36.7894497498863,0.6121162280701755,45.48611111111111,1018.0555555555551,26.790935672514607,0
3050,4,0,0,42,0.0,0.0,1.0,42,1350,1100,250,0.8148148148148148,16,11,5,341.4700937619291,0.45863579171506,0.25716833790488147,0.19133165571104915,129609.02829142014,451.52140861275143,130060.54970003289,2528,1,256.9761904761905,38,4,16,36.739980065050865,0.6126644736842105,45.43269230769231,1018.269230769231,26.796558704453446,0
3051,4,1,2,41,0.023255813953488372,0.046511627906976744,0.9534883720930233,43,1300,1100,200,0.8461538461538461,15,11,4,338.5604192062699,0.4594176818014027,0.2628864387411596,0.19145973100001004,129970.32470703122,200.56152343749898,130170.88623046872,2529,0,251.97674418604652,39,4,18,36.447479313515174,0.6145833333333333,45.078125,1019.6874999999998,26.14583333333333,0
3052,4,0,0,41,0.0,0.0,1.0,41,1500,1100,400,0.7333333333333333,19,11,8,344.94279414057587,0.45978150406504065,0.250747657340334,0.19476000838398666,129908.37191358027,762.1913580246986,130670.56327160497,2530,1,253.4390243902439,38,3,18,36.34763851044505,0.6156798245614035,45.13888888888889,1019.4444444444446,26.82748538011696,0
3053,4,1,0,42,0.023809523809523808,0.0,1.0,42,1450,1200,250,0.8275862068965517,17,12,5,336.4118699597762,0.460075493612079,0.24315546032717772,0.19180760543779926,130289.17236328137,366.1648220486246,130655.33718532999,2531,0,248.38095238095238,39,3,19,36.179237662823546,0.6177884615384616,44.76562500000001,1020.9375000000009,26.177884615384638,0
3054,4,1,1,42,0.023255813953488372,0.023255813953488372,0.9767441860465116,43,1000,700,300,0.7,13,7,6,330.07096697081573,0.4591638981173865,0.23811252604341293,0.18957873871076492,130574.00238160152,19.73744546896137,130593.73982707047,2532,0,243.58139534883722,40,3,14,36.053039342414905,0.6190104166666667,44.48678861788618,1022.052845528455,25.551321138211375,0
3055,4,0,1,41,0.0,0.023809523809523808,0.9761904761904762,42,800,400,400,0.5,12,4,8,340.2259140713646,0.45853900503290745,0.19978444052518118,0.18372199359853664,128144.53124999975,486.2991812082454,128630.830431208,2533,2,250.38095238095238,37,5,17,38.26303155006856,0.5996621621621622,46.874999999999986,1012.4999999999981,27.364864864864813,8
3056,4,1,0,42,0.023809523809523808,0.0,1.0,42,1200,800,400,0.6666666666666666,16,8,8,340.71582969969575,0.45913182346109177,0.20990331616517643,0.1851105590224117,128388.03624260332,348.7672583826188,128736.80350098594,2534,0,251.21428571428572,38,4,16,38.00205566097408,0.600328947368421,46.63461538461537,1013.4615384615365,26.670040485829908,0
3057,4,0,1,41,0.0,0.023809523809523808,0.9761904761904762,42,850,500,350,0.5882352941176471,12,5,7,337.93695119957994,0.45875677506775064,0.20962465694316923,0.18422513520018438,128523.41666894939,286.562317371595,128809.97898632099,2535,1,252.21428571428572,38,4,16,37.93440276753415,0.6016995614035088,46.50106837606837,1013.9957264957254,26.684098065676984,0
3058,4,0,2,39,0.0,0.04878048780487805,0.9512195121951219,41,1200,1000,200,0.8333333333333334,14,10,4,340.9937536122494,0.45752032520325203,0.20177791138923418,0.18606791900647154,128561.19340806772,567.7127818174692,129128.90618988518,2536,2,250.14634146341464,37,4,16,37.81839027642631,0.6038851351351351,46.46381578947368,1014.1447368421041,27.409317211948757,0
3059,4,0,0,39,0.0,0.0,1.0,39,1350,1000,350,0.7407407407407407,17,10,7,357.095709019448,0.4566464237516869,0.21230019219050322,0.19339737904320578,128261.74554183792,1360.3437928669123,129622.08933470484,2537,3,262.9230769230769,35,4,19,37.71614107251675,0.6047619047619048,46.759259259259245,1012.9629629629612,28.941798941798893,0
3060,4,0,0,39,0.0,0.0,1.0,39,1800,1400,400,0.7777777777777778,22,14,8,355.4701438634614,0.4565620782726046,0.21566147693674997,0.19346688240984738,128458.27880245095,1332.6165692719633,129790.89537172292,2538,4,263.9230769230769,36,3,16,37.556468932829745,0.6047453703703703,46.56531531531531,1013.7387387387375,28.159409409409378,0
3061,4,1,0,40,0.025,0.0,1.0,40,800,400,400,0.5,12,4,8,350.3109124920116,0.45711805555555557,0.22133909287257048,0.1926293972491701,128867.1754770697,1028.7155663280805,129895.89104339779,2539,0,258.3,37,3,18,37.270068394528444,0.6069819819819819,46.162280701754376,1015.3508771929811,27.4419155998103,0
3062,4,1,0,41,0.024390243902439025,0.0,1.0,41,1300,1000,300,0.7692307692307693,16,10,6,342.29958560328356,0.4573932926829268,0.22226779283031983,0.1896901896922095,129174.23575726828,643.257474066734,129817.49323133501,2540,0,252.97560975609755,38,3,19,37.16084252933962,0.6082785087719298,45.86004273504272,1016.5598290598265,26.7515744489428,0
3063,4,2,2,41,0.046511627906976744,0.046511627906976744,0.9534883720930233,43,1200,900,300,0.75,15,9,6,328.8128265990638,0.45840254706533773,0.22487208676832982,0.18534355507812622,129843.17440222,-61.17120133648234,129782.00320088351,2541,0,242.1627906976744,37,6,16,36.82479379594764,0.6168355855855856,45.202850877192986,1019.1885964912287,27.545637743006182,0
3064,4,1,1,41,0.023809523809523808,0.023809523809523808,0.9761904761904762,42,1100,600,500,0.5454545454545454,16,6,10,336.20189417793307,0.45748644986449866,0.2350841729572659,0.18889952389649603,129717.10519641277,322.2272948624476,130039.33249127521,2542,0,248.88095238095238,36,6,17,36.7644078414032,0.6174768518518519,45.326576576576585,1018.6936936936949,28.29704704704708,0
3065,4,0,0,41,0.0,0.0,1.0,41,1400,1100,300,0.7857142857142857,17,11,6,334.31790638305955,0.456885162601626,0.2384946975321638,0.18819276520437683,129790.40745027432,478.2514574759872,130268.6589077503,2543,1,254.8780487804878,35,6,17,36.73803574132969,0.6202380952380953,45.254629629629626,1018.9814814814812,29.113756613756607,0
3066,4,0,1,40,0.0,0.024390243902439025,0.975609756097561,41,950,500,450,0.5263157894736842,14,5,9,392.0711133726876,0.4566565040650406,0.2755953388369654,0.2127682987633371,128342.36145019523,2275.9249798391265,130618.28643003435,2544,2,255.8780487804878,31,10,21,36.747729803820775,0.6149193548387097,46.67968749999999,1013.2812499999993,32.68649193548385,8
3067,4,0,1,39,0.0,0.025,0.975,40,1200,900,300,0.75,15,9,6,395.11473042621685,0.4559428418803419,0.29595862246209226,0.21442000224385066,128342.36145019528,2141.9915093315967,130484.35295952688,2545,4,263.225,31,9,21,36.67062880150777,0.6149193548387097,46.6796875,1013.2812499999998,32.686491935483865,0
3068,4,0,0,39,0.0,0.0,1.0,39,1050,700,350,0.6666666666666666,14,7,7,394.8081240829635,0.45591542959964015,0.2778914085272466,0.21478555178098316,128441.33377075185,2341.936408148858,130783.27017890071,2546,5,247.74358974358975,31,8,20,36.576883964889745,0.6159274193548387,46.58203124999999,1013.6718749999992,32.69909274193546,0
3069,4,1,0,40,0.025,0.0,1.0,40,1150,700,450,0.6086956521739131,16,7,9,387.1270762516965,0.4558092948717949,0.2894800596347371,0.21415710218212414,129105.13157139583,1996.0184228650173,131101.14999426084,2547,0,242.525,32,8,22,36.09221642440055,0.6201171875,45.928030303030305,1016.2878787878792,31.758996212121225,0
3070,4,0,1,39,0.0,0.025,0.975,40,1450,900,550,0.6206896551724138,20,9,11,390.0161246976616,0.4556490384615384,0.2893442622950819,0.21628166915052155,129201.38888888896,2078.1250000000045,131279.51388888896,2548,1,243.525,32,8,22,35.920423497267734,0.62109375,45.833333333333336,1016.6666666666673,31.770833333333353,0
3071,4,0,0,39,0.0,0.0,1.0,39,1200,900,300,0.75,15,9,6,397.78948841496407,0.4555218173639226,0.28585226432760047,0.22003876379013446,129102.12410820868,2471.093580457919,131573.2176886666,2549,2,247.94871794871796,31,8,22,35.82439141575914,0.6226478494623655,45.93098958333334,1016.2760416666678,32.783098118279604,0
3072,4,2,0,41,0.04878048780487805,0.0,1.0,41,800,400,400,0.5,12,4,8,380.25760247982475,0.45779979674796745,0.2920376822815849,0.2142426979825355,129825.09731833916,1673.3960495963206,131498.49336793547,2550,0,236.8048780487805,33,8,20,35.53240740740742,0.625,45.22058823529412,1019.117647058824,30.882352941176485,0
3073,4,0,0,41,0.0,0.0,1.0,41,1150,700,450,0.6086956521739131,16,7,9,376.85865194651115,0.45754573170731705,0.28609128601504796,0.2126669109152701,129887.55076172632,1589.8494569396473,131477.40021866598,2551,1,237.8048780487805,33,8,20,35.555421976436655,0.6256313131313131,45.1593137254902,1019.3627450980397,30.88978015448605,0
3074,4,0,1,40,0.0,0.024390243902439025,0.975609756097561,41,1300,1000,300,0.7692307692307693,16,10,6,388.6200975143156,0.4563262195121951,0.23053349434831572,0.2163605251151125,129357.17520004297,1862.6449262302667,131219.82012627323,2552,2,238.8048780487805,33,8,20,35.79676645384092,0.6202651515151515,45.680147058823515,1017.2794117647036,30.826648841354654,8
3075,4,0,2,38,0.0,0.05,0.95,40,1150,800,350,0.6956521739130435,15,8,7,390.002038724181,0.454553952991453,0.24466745253753586,0.21751047959018496,129426.12879106711,2095.2908185389088,131521.419609606,2553,3,245.5,32,8,17,35.69120445051082,0.6233723958333333,45.61237373737373,1017.5505050505041,31.798453282828252,0
3076,4,1,0,39,0.02564102564102564,0.0,1.0,39,900,600,300,0.6666666666666666,12,6,6,391.01688120659435,0.451698155645524,0.24848109113453165,0.2191487940883381,129618.91842987962,2336.6370459646987,131955.5554758443,888,0,187.23076923076923,32,7,18,35.46858855135359,0.6253255208333333,45.4229797979798,1018.308080808081,31.82212752525253,0
3077,4,1,1,39,0.025,0.025,0.975,40,1000,700,300,0.7,13,7,6,384.05190620918796,0.4518696581196581,0.25357743602066574,0.21759455516535525,130043.75007509121,1988.7100213859933,132032.4600964772,889,0,183.525,33,7,19,35.213039168569026,0.627209595959596,45.00612745098039,1019.9754901960777,30.90834818775993,0
3078,4,1,1,39,0.025,0.025,0.975,40,1350,900,450,0.6666666666666666,18,9,9,376.3760627233511,0.4502537393162393,0.22589843252198283,0.21573578993353826,130495.30241224515,1823.61354629888,132318.91595854404,890,0,178.85,31,9,18,34.94979503844357,0.636760752688172,44.56380208333334,1021.7447916666678,32.95950940860219,0
3079,4,0,0,39,0.0,0.0,1.0,39,950,600,350,0.631578947368421,13,6,7,387.5789620867655,0.44916779127305445,0.23392120733526367,0.2214154100703194,130365.51371545863,2305.386099549103,132670.89981500772,891,2,184.43589743589743,30,9,20,34.795615074142326,0.6381944444444445,44.690860215053775,1021.2365591397864,34.041218637992884,0
3080,4,0,0,39,0.0,0.0,1.0,39,1250,800,450,0.64,17,8,9,385.12574803010483,0.44793072424651376,0.2337750594631327,0.2209405607120078,130528.56445312513,2253.9822048611263,132782.54665798627,892,3,185.43589743589743,31,8,18,34.69249065579339,0.6370967741935484,44.53125000000001,1021.875000000001,32.96370967741939,0
3081,4,0,1,38,0.0,0.02564102564102564,0.9743589743589743,39,900,400,500,0.4444444444444444,14,4,10,387.75160126113036,0.44719973009446695,0.23041655237274217,0.223213018555894,130661.6550021701,2332.853190104162,132994.50819227425,893,4,186.43589743589743,31,8,19,34.49015112922398,0.6384408602150538,44.401041666666664,1022.3958333333329,32.98051075268816,0
3082,4,0,0,38,0.0,0.0,1.0,38,950,700,250,0.7368421052631579,12,7,5,384.8913850531563,0.4471757942152679,0.21047271947689983,0.22233137654247034,130794.8133680556,2468.359375000005,133263.17274305562,894,5,181.97368421052633,31,7,20,34.42803801765104,0.6397849462365591,44.270833333333336,1022.9166666666671,32.997311827957006,0
3083,4,0,0,38,0.0,0.0,1.0,38,750,400,350,0.5333333333333333,11,4,7,385.22868256854656,0.4472202465623518,0.20687218236503813,0.22271830455784197,130828.11355590832,2479.748365614164,133307.86192152248,895,6,182.97368421052633,31,7,20,34.385606253447044,0.6401209677419355,44.23828125000001,1023.0468750000009,33.00151209677422,0
3084,4,0,0,38,0.0,0.0,1.0,38,1000,400,600,0.4,16,4,12,382.2537901305112,0.4474425082977715,0.20366979625228843,0.2216415753074341,130940.15438475696,2410.4740587695496,133350.6284435265,896,7,183.97368421052633,32,6,20,34.34801381692573,0.638671875,44.1287878787879,1023.4848484848509,31.98390151515159,0
3085,4,0,0,38,0.0,0.0,1.0,38,1250,600,650,0.48,19,6,13,383.99804878289115,0.4467016358463727,0.206778043888856,0.22321434964734532,131037.09323347126,2463.597623966965,133500.69085743823,897,8,184.97368421052633,32,6,20,34.2050499445061,0.6396484375,44.03409090909092,1023.8636363636379,31.995738636363683,0
3086,4,0,0,38,0.0,0.0,1.0,38,1000,700,300,0.7,13,7,6,382.66779874654236,0.44680535798956855,0.20988399252569256,0.2230029585798818,131134.06795224987,2436.157024793399,133570.22497704325,898,9,185.97368421052633,32,6,20,34.140779092702175,0.640625,43.939393939393945,1024.242424242425,32.00757575757578,0
3087,4,0,1,37,0.0,0.02631578947368421,0.9736842105263158,38,1200,500,700,0.4166666666666667,19,5,14,382.18533336604423,0.4463311996206733,0.21059764986641039,0.22347378714688887,131263.42337516596,2433.391044281215,133696.81441944718,899,10,186.97368421052633,32,6,20,34.02204493182191,0.6419270833333333,43.81313131313132,1024.747474747476,32.023358585858624,0
3088,4,0,1,36,0.0,0.02702702702702703,0.972972972972973,37,1400,1300,100,0.9285714285714286,15,13,2,389.55969376245525,0.445289039039039,0.2159097722321779,0.22740196799917717,131198.73769258245,2821.9480155086294,134020.68570809107,900,11,191.8108108108108,32,5,20,33.89871415660174,0.6412760416666667,43.87626262626263,1024.49494949495,32.01546717171719,0
3089,4,0,0,36,0.0,0.0,1.0,36,950,600,350,0.631578947368421,13,6,7,388.15181422209247,0.4437169312169312,0.20047925577718484,0.22714817321502526,131294.76123385967,2992.4599541558214,134287.22118801548,901,12,186.72222222222223,31,5,20,33.83742535891246,0.6448252688172043,43.782552083333336,1024.8697916666672,33.06031586021507,0
3090,4,0,0,36,0.0,0.0,1.0,36,1000,700,300,0.7,13,7,6,388.9426325772111,0.44249338624338624,0.19543455787067399,0.22883741165741694,131500.3924767315,3029.226005519804,134529.6184822513,902,13,187.72222222222223,30,6,22,33.60879963307561,0.6496527777777779,43.58198924731183,1025.6720430107532,34.18906810035844,0
3091,4,0,0,36,0.0,0.0,1.0,36,1100,800,300,0.7272727272727273,14,8,6,390.6288980242572,0.44246031746031744,0.19777064500633257,0.23024481688178802,131569.33108235057,3078.956562897447,134648.28764524803,903,14,188.72222222222223,30,6,19,33.49573125463994,0.6503472222222222,43.51478494623656,1025.9408602150538,34.198028673835125,0
3092,4,0,0,36,0.0,0.0,1.0,36,1100,800,300,0.7272727272727273,14,8,6,391.9188723372317,0.4419146825396825,0.20409172923578356,0.23163254714915665,131672.77286391502,3121.008931668417,134793.78179558343,904,15,189.72222222222223,30,6,19,33.35788807403527,0.6513888888888889,43.41397849462366,1026.3440860215064,34.21146953405022,0
3093,4,0,0,36,0.0,0.0,1.0,36,900,600,300,0.6666666666666666,12,6,6,393.4915354457985,0.44098875661375664,0.20777690494893974,0.2329835928476751,131741.75663371483,3167.853220025432,134909.60985374026,905,16,190.72222222222223,30,6,19,33.247687003578605,0.6520833333333333,43.346774193548384,1026.6129032258061,34.22043010752687,0
3094,4,0,1,35,0.0,0.027777777777777776,0.9722222222222222,36,1050,700,350,0.6666666666666666,14,7,7,395.51346734016556,0.4402116402116402,0.21131095123900878,0.23567423677440116,131983.34209518437,3240.2378526419216,135223.5799478263,906,17,191.72222222222223,30,6,20,32.951275343361665,0.6545138888888888,43.111559139784944,1027.55376344086,34.251792114695334,0
3095,4,0,0,35,0.0,0.0,1.0,35,1300,1100,200,0.8461538461538461,15,11,4,421.2865574634799,0.44149159663865545,0.2379526551503519,0.23500031738594537,129433.15505981444,3905.6896633572046,133338.84472317164,907,18,195.94285714285715,31,4,17,34.888169119215185,0.626008064516129,45.60546875,1017.5781249999999,32.82510080645161,8
3096,4,2,0,37,0.05405405405405406,0.0,1.0,37,700,400,300,0.5714285714285714,10,4,6,402.24372836128657,0.4440690690690691,0.2289550697194005,0.22753705395610258,129981.25908604881,3056.829254373337,133038.08834042214,908,0,186.2972972972973,33,4,19,34.81289808917197,0.6265782828282829,45.06740196078432,1019.7303921568641,30.90092097445043,0
3097,4,0,0,37,0.0,0.0,1.0,37,1200,800,400,0.6666666666666666,16,8,8,401.9123665241456,0.44375625625625625,0.22624017243282202,0.2282620984774925,130137.51471789707,3060.775302768181,133198.29002066524,909,1,187.2972972972973,33,4,19,34.662002562254784,0.6281565656565656,44.91421568627452,1020.3431372549029,30.91948900772433,0
3098,4,0,1,36,0.0,0.02702702702702703,0.972972972972973,37,1550,1100,450,0.7096774193548387,20,11,9,401.5866658256785,0.443724974974975,0.22122988682474243,0.22900068969438905,130294.81207274768,3064.9919039844476,133359.80397673213,910,2,188.2972972972973,32,5,19,34.51000700799735,0.6321614583333333,44.76010101010101,1020.959595959596,31.904987373737374,0
3099,4,0,0,36,0.0,0.0,1.0,36,1100,900,200,0.8181818181818182,13,9,4,400.8933107132534,0.4421957671957672,0.20737903004338998,0.2297470729668305,130488.2473727171,3262.373099683711,133750.6204724008,864,3,169.25,32,4,16,34.33071758115011,0.6341145833333333,44.57070707070707,1021.7171717171719,31.928661616161623,0
3100,4,1,0,37,0.02702702702702703,0.0,1.0,37,1350,800,550,0.5925925925925926,19,8,11,390.52911766609094,0.440503003003003,0.20608350749600457,0.22687623428251197,131014.28086553246,2832.9783016147603,133847.25916714722,865,0,165.64864864864865,33,4,18,34.0610286489506,0.6369949494949495,44.056372549019606,1023.7745098039214,31.023469994058225,0
3101,4,0,1,36,0.0,0.02702702702702703,0.972972972972973,37,1200,700,500,0.5833333333333334,17,7,10,389.4092218582529,0.4404091591591592,0.20471709074009548,0.2275387082507798,131236.6230867348,2820.9502551020564,134057.57334183686,866,1,166.64864864864865,34,3,18,33.8641512722203,0.6369485294117647,43.83928571428572,1024.642857142858,30.136554621848767,0
3102,4,0,0,36,0.0,0.0,1.0,36,1200,700,500,0.5833333333333334,17,7,10,397.2277413940866,0.437119708994709,0.21141476963149053,0.23209092563214248,131233.93233672145,3225.9517072760505,134459.8840439975,867,2,172.13888888888889,33,3,19,33.6666018817526,0.6392045454545454,43.841911764705884,1024.6323529411764,31.04946524064171,0
3103,4,0,0,36,0.0,0.0,1.0,36,850,600,250,0.7058823529411765,11,6,5,398.2417872959216,0.43697089947089945,0.21205962059620553,0.23325590398761137,131328.12500000012,3260.1370266243903,134588.26202662452,868,3,173.13888888888889,31,5,19,33.545054200542,0.6451612903225806,43.75000000000001,1025.000000000001,33.064516129032285,0
3104,4,0,0,36,0.0,0.0,1.0,36,900,500,400,0.5555555555555556,13,5,8,400.0557949277628,0.4369212962962963,0.21317230478287286,0.2345226562521429,131361.49300469307,3310.3853013780626,134671.87830607113,869,4,174.13888888888889,31,5,19,33.464715906685306,0.645497311827957,43.71744791666668,1025.1302083333346,33.06871639784951,0
3105,4,0,0,36,0.0,0.0,1.0,36,1550,1100,450,0.7096774193548387,20,11,9,395.7233358528595,0.43617724867724866,0.20523809523809544,0.23238786501426328,131428.24172973644,3201.8444485134687,134630.0861782499,870,5,175.13888888888889,31,5,19,33.50806878306879,0.6461693548387097,43.65234375000001,1025.390625000001,33.0771169354839,0
3106,4,0,0,36,0.0,0.0,1.0,36,1250,1000,250,0.8,15,10,5,398.32435790981134,0.43546626984126985,0.20920568455779742,0.23514563780428638,131628.58963012695,3286.174689398872,134914.76431952583,871,6,176.13888888888889,31,5,17,33.23829991963795,0.6481854838709677,43.45703125,1026.171875,33.102318548387096,0
3107,4,0,0,36,0.0,0.0,1.0,36,1050,700,350,0.6666666666666666,14,7,7,367.96917252568915,0.43427579365079366,0.1528746770025835,0.21381992457573853,131023.24263038569,2442.50283446714,133465.74546485284,872,7,177.13888888888889,34,2,22,34.62936046511628,0.6348039215686274,44.04761904761906,1023.8095238095254,30.11204481792722,8
3108,4,0,0,36,0.0,0.0,1.0,36,1100,800,300,0.7272727272727273,14,8,6,367.4770570381235,0.43313492063492065,0.15541482686497843,0.21455275121235365,131206.12953514748,2443.0484693877715,133649.17800453526,873,8,178.13888888888889,34,2,22,34.45682275931523,0.6366421568627452,43.86904761904763,1024.5238095238103,30.133053221288538,0
3109,4,0,0,36,0.0,0.0,1.0,36,1150,800,350,0.6956521739130435,15,8,7,364.85741510413465,0.4328869047619048,0.15384538752739618,0.21387752469138654,131359.53006355735,2385.556406999088,133745.08647055645,874,9,179.13888888888889,33,3,22,34.36877366009165,0.6404671717171717,43.719362745098046,1025.1225490196084,31.06431966726086,0
3110,4,0,1,35,0.0,0.027777777777777776,0.9722222222222222,36,800,300,500,0.375,13,3,10,386.44831730769187,0.4322751322751323,0.13338675213675177,0.21842730978260877,129950.01922337581,2898.94782054981,132848.96704392563,875,10,180.13888888888889,33,3,20,35.247395833333336,0.6262626262626263,45.098039215686285,1019.6078431372565,30.89720736779565,8
3111,4,1,0,36,0.027777777777777776,0.0,1.0,36,1250,800,450,0.64,17,8,9,358.11168696615624,0.4329695767195767,0.05258110656004167,0.1993527273697592,129352.72285997722,2064.9198159655894,131417.6426759428,876,0,180.72222222222223,34,2,21,36.577189389506536,0.617953431372549,45.6845238095238,1017.2619047619039,29.919467787114822,8
3112,4,0,0,36,0.0,0.0,1.0,36,800,600,200,0.75,10,6,4,360.8634321165033,0.4330026455026455,0.04775229775229772,0.20119372174166694,129413.28125000001,2140.1041666666674,131553.3854166667,877,1,181.72222222222223,34,2,22,36.44553644553644,0.6185661764705883,45.625,1017.5000000000001,29.926470588235297,0
3113,4,0,0,36,0.0,0.0,1.0,36,1050,800,250,0.7619047619047619,13,8,5,359.2152419058361,0.43310185185185185,0.04792958240729939,0.2005833509505545,129473.8538123581,2101.7963435373995,131575.6501558955,878,2,182.72222222222223,34,2,15,36.425800288532784,0.6191789215686274,45.56547619047618,1017.7380952380937,29.933473389355697,0
3114,4,0,0,36,0.0,0.0,1.0,36,1000,800,200,0.8,12,8,4,358.51437877211424,0.4333829365079365,0.05069639330630937,0.2006554297944451,129564.73922902491,2090.1643990929683,131654.90362811787,879,3,183.72222222222223,34,2,16,36.35114593077644,0.6200980392156863,45.476190476190474,1018.0952380952378,29.943977591036408,0
3115,4,1,0,37,0.02702702702702703,0.0,1.0,37,1200,1000,200,0.8333333333333334,14,10,4,350.2667352502655,0.43440315315315314,0.05410926759241308,0.1982145282138786,129996.88042534732,1706.7165798611168,131703.59700520843,880,0,179.72972972972974,35,2,18,36.122105890364296,0.6223214285714286,45.052083333333336,1019.7916666666674,29.136904761904784,0
3116,4,1,0,38,0.02631578947368421,0.0,1.0,38,1200,700,500,0.5833333333333334,17,7,10,351.34973510785653,0.43638869132290187,0.061064956406628124,0.1884215091066782,127867.13219452118,1407.1892613592436,129274.32145588043,881,0,175.97368421052633,37,1,17,38.2652139346632,0.5968468468468469,47.149122807017534,1011.4035087719282,27.335229966808868,8
3117,4,0,1,37,0.0,0.02631578947368421,0.9736842105263158,38,1200,1000,200,0.8333333333333334,14,10,4,352.41445054016975,0.436284969179706,0.06073028098702071,0.1891229381171065,127894.85857427266,1414.3992622729877,129309.25783654564,882,1,176.97368421052633,37,1,17,38.209914182475174,0.5971283783783784,47.12171052631578,1011.5131578947353,27.338193456614466,0
3118,4,0,1,36,0.0,0.02702702702702703,0.972972972972973,37,1250,800,450,0.64,17,8,9,352.41030189261545,0.43465340340340336,0.07254923778791578,0.18976101756194924,128030.5363429307,1623.8559928171308,129654.39233574783,883,2,180.8918918918919,36,1,17,38.07119543043656,0.6004050925925926,46.98761261261261,1012.049549549549,28.112487487487474,0
3119,4,1,0,37,0.02702702702702703,0.0,1.0,37,1250,700,550,0.56,18,7,11,353.7687217221578,0.43634259259259256,0.09047139178143526,0.18315991035945473,126439.93391617977,1546.098759232213,127986.03267541199,884,0,181.78378378378378,36,1,14,39.669176650617686,0.5842013888888888,48.56418918918919,1005.7432432432439,27.93731231231233,8
3120,4,2,0,39,0.05128205128205128,0.0,1.0,39,1200,800,400,0.6666666666666666,16,8,8,341.4320539828252,0.44140800719748086,0.10471625308420562,0.17938490319498554,127038.15563591212,874.9796825918654,127913.13531850398,885,0,173.4102564102564,38,1,19,39.36497633177899,0.5866228070175439,47.97008547008547,1008.1196581196588,26.52946468735944,0
3121,4,2,1,40,0.04878048780487805,0.024390243902439025,0.975609756097561,41,1300,1000,300,0.7692307692307693,16,10,6,328.26233052236927,0.4454776422764228,0.11551749521519294,0.17467492320087538,127553.56021548029,174.2057885517903,127727.76600403208,886,0,165.90243902439025,40,1,13,39.169391348088496,0.5885416666666667,47.459349593495936,1010.162601626017,25.254065040650424,0
3122,4,2,2,40,0.047619047619047616,0.047619047619047616,0.9523809523809523,42,850,500,350,0.5882352941176471,12,5,7,324.73857245277736,0.4474206349206349,0.13308536124070103,0.1743738400895719,127918.62643494896,-91.97757227891447,127826.64886267004,887,0,162.9047619047619,41,1,16,38.88551779935274,0.5907012195121951,47.098214285714285,1011.6071428571427,24.67334494773519,0
3123,4,0,1,39,0.0,0.025,0.975,40,1400,1200,200,0.8571428571428571,16,12,4,340.17158945194404,0.4427083333333333,0.12973982483256052,0.18189340361603962,127749.32861328137,691.3384331597362,128440.6670464411,888,1,171.95,39,1,17,38.66831959471065,0.5921474358974359,47.26562500000001,1010.9375000000009,25.921474358974383,0
3124,4,0,0,39,0.0,0.0,1.0,39,1050,700,350,0.6666666666666666,14,7,7,342.639689202308,0.44258884390463343,0.11503386933829529,0.18378299930188394,127874.24123612026,962.9580548250414,128837.1992909453,889,2,172.92307692307693,38,1,17,38.478178585261084,0.5951206140350878,47.14209401709402,1011.4316239316241,26.61662168241116,0
3125,4,2,1,40,0.04878048780487805,0.024390243902439025,0.975609756097561,41,1300,1100,200,0.8461538461538461,15,11,4,331.1147532767053,0.44618902439024394,0.1285372023197473,0.18013857678264755,128442.17985243605,306.39085214403735,128748.57070458008,890,0,165.4390243902439,38,3,16,38.1901261242271,0.6008771929824561,46.58119658119657,1013.6752136752119,26.675663517768736,0
3126,4,1,0,41,0.024390243902439025,0.0,1.0,41,700,500,200,0.7142857142857143,9,5,4,330.47529231632626,0.44578252032520327,0.033539423200623864,0.17262915188582148,126803.3325195311,181.07367621526294,126984.40619574637,891,0,166.41463414634146,39,2,20,39.88186041300374,0.5825320512820513,48.20312499999999,1007.1874999999989,25.825320512820483,8
3127,4,1,0,42,0.023809523809523808,0.0,1.0,42,1300,1000,300,0.7692307692307693,16,10,6,326.4804316645038,0.44818283004258613,0.03955135773317586,0.17175709665828212,127092.01388888863,-100.73242187503402,126991.2814670136,892,0,163.42857142857142,38,4,22,39.686639118457286,0.587171052631579,47.91666666666665,1008.3333333333312,26.53508771929819,0
3128,4,0,0,42,0.0,0.0,1.0,42,1450,1100,350,0.7586206896551724,18,11,7,322.77670033544734,0.44795296167247384,0.03896975327758834,0.17058035439986227,127275.89111328113,-183.66156684029187,127092.22954644084,893,1,164.42857142857142,39,3,22,39.59182839544407,0.5873397435897436,47.73437499999999,1009.0624999999991,25.873397435897413,0
3129,4,2,1,43,0.045454545454545456,0.022727272727272728,0.9772727272727273,44,1300,1000,300,0.7692307692307693,16,10,6,311.9960187813848,0.4525854474982382,0.06699139506888452,0.1673224309035356,127868.4524301616,-821.1103828105565,127047.34204735105,894,0,157.9090909090909,41,3,19,39.258930031060984,0.5901930894308943,47.14781746031745,1011.4087301587278,24.66850561362751,0
3130,4,1,0,44,0.022727272727272728,0.0,1.0,44,1550,1300,250,0.8387096774193549,18,13,5,310.2610837091966,0.45293780831571534,0.07075422423023636,0.16692717656749803,127997.40780489435,-857.4771084971092,127139.93069639723,895,0,158.8409090909091,42,2,20,39.171374764595086,0.5900297619047619,47.02034883720929,1011.9186046511613,24.093300110741936,0
3131,4,4,1,47,0.08333333333333333,0.020833333333333332,0.9791666666666666,48,750,400,350,0.5333333333333333,11,4,7,289.92309570312455,0.4566341607565012,0.11554361979166639,0.15995757004310357,128999.74804736744,-2119.5762145472436,126880.1718328202,896,0,146.52083333333334,41,7,16,38.66861979166665,0.6016260162601625,46.031746031746046,1015.8730158730186,24.777390631049236,0
3132,4,0,2,45,0.0,0.0425531914893617,0.9574468085106383,47,1150,800,350,0.6956521739130435,15,8,7,295.6266455490664,0.45453669441874806,0.11024487032645158,0.16287170317626098,128943.2185289843,-1776.189767995214,127167.0287609891,897,1,150.61702127659575,40,7,17,38.581065305850196,0.6026041666666666,46.08739837398375,1015.650406504067,25.391260162601675,0
3133,4,3,2,46,0.0625,0.041666666666666664,0.9583333333333334,48,1050,700,350,0.6666666666666666,14,7,7,284.8236149555123,0.4546948877068558,0.12014622806182351,0.1590378749536285,129472.44498715551,-2224.6380363259163,127247.80695082959,898,0,143.70833333333334,42,6,13,38.32000380843571,0.6049107142857143,45.56686046511629,1017.7325581395372,24.231727574750884,0
3134,4,1,0,47,0.02127659574468085,0.0,1.0,47,1300,700,600,0.5384615384615384,19,7,12,292.25586041182527,0.4528985507246377,0.12842286041408268,0.16310993558784023,129453.66138353494,-1833.2817617787828,127620.37962175616,899,0,147.48936170212767,41,6,14,38.14989926561384,0.6061991869918699,45.58531746031746,1017.6587301587306,24.82094463801782,0
3135,4,0,0,47,0.0,0.0,1.0,47,1550,1200,350,0.7741935483870968,19,12,7,291.22129803513576,0.45205057045945113,0.12406025949899857,0.1629505430990491,129554.6392746913,-1854.1859567901313,127700.45331790118,900,1,148.48936170212767,41,6,14,38.07412460209186,0.6072154471544715,45.48611111111111,1018.0555555555552,24.830623306233054,0
3136,4,0,0,47,0.0,0.0,1.0,47,1250,1000,250,0.8,15,10,5,293.1084641009342,0.45203129818069687,0.12378884201278129,0.1646410125485988,129706.17992567373,-1796.4041635172848,127909.77576215644,901,2,149.48936170212767,41,6,15,37.872922347747036,0.608739837398374,45.337301587301575,1018.6507936507917,24.845141308555895,0
3137,4,0,1,46,0.0,0.02127659574468085,0.9787234042553191,47,1400,1200,200,0.8571428571428571,16,12,4,293.93640163636235,0.45172294172062905,0.13542814076178367,0.1659610144623768,129908.37191358021,-1763.040123456797,128145.33179012341,902,3,150.48936170212767,41,6,17,37.647593097184355,0.6107723577235773,45.138888888888886,1019.4444444444441,24.86449864498644,0
3138,4,0,0,46,0.0,0.0,1.0,46,1150,700,450,0.6086956521739131,16,7,9,296.2645073569689,0.4497685185185185,0.11143823577077017,0.16136468196126824,128488.14791967122,-1586.2221779874367,126901.92574168378,903,4,154.6304347826087,42,4,14,39.026609640319876,0.5949900793650793,46.53585271317829,1013.8565891472862,24.13944259874491,8
3139,4,1,0,47,0.02127659574468085,0.0,1.0,47,1300,1100,200,0.8461538461538461,15,11,4,289.21565572140497,0.45050878815911194,0.11886148971902522,0.15863937553848617,128768.51343692621,-1951.625990013762,126816.88744691244,904,0,152.31914893617022,43,4,16,38.92089631150089,0.5964147286821706,46.2594696969697,1014.9621212121222,23.603770260747027,0
3140,4,1,0,48,0.020833333333333332,0.0,1.0,48,1350,900,450,0.6666666666666666,18,9,9,285.24197569520874,0.45105644208037826,0.1409257909758912,0.1579912416338042,129154.32527434835,-2231.953017832654,126922.3722565157,905,0,150.125,44,4,17,38.631049978745374,0.5989583333333333,45.879629629629626,1016.4814814814808,23.101851851851837,0
3141,4,0,2,46,0.0,0.041666666666666664,0.9583333333333334,48,1650,1100,550,0.6666666666666666,22,11,11,286.66850090099234,0.45116725768321514,0.1376179172097065,0.15955404335121548,129345.84212149898,-2184.1156948624935,127161.72642663648,906,1,151.125,43,5,17,38.4010581518029,0.6022286821705427,45.691287878787875,1017.2348484848477,23.656624383368552,0
3142,4,0,0,46,0.0,0.0,1.0,46,1300,800,500,0.6153846153846154,18,8,10,297.96625817965526,0.44911433172302734,0.13027783669141102,0.16544713685490056,129251.82370401858,-1497.4635456034284,127754.36015841515,907,2,157.56521739130434,41,5,19,38.2089430894309,0.6041666666666667,45.78373015873016,1016.8650793650788,24.80158730158729,0
3143,4,1,1,46,0.02127659574468085,0.02127659574468085,0.9787234042553191,47,1350,900,450,0.6666666666666666,18,9,9,295.2428913102114,0.44993061979648474,0.1372954056648481,0.16516623088951451,129546.41867225531,-1750.4681584640314,127795.95051379128,908,0,155.19148936170214,42,5,14,37.98008280982296,0.6056547619047619,45.49418604651163,1018.0232558139538,24.238648947951283,0
3144,4,1,0,47,0.02127659574468085,0.0,1.0,47,1550,1100,450,0.7096774193548387,20,11,9,296.69078031892883,0.44871646623496764,0.15036729505259938,0.1664984939632814,129669.75509472087,-1705.6358354365734,127964.11925928429,909,0,156.17021276595744,42,5,15,37.81851552341992,0.6068948412698413,45.373062015503876,1018.5077519379845,24.25018456995201,0
3145,4,0,2,45,0.0,0.0425531914893617,0.9574468085106383,47,1350,1000,350,0.7407407407407407,17,10,7,293.5151837370096,0.4487550107924761,0.14532598885376768,0.1650277348561989,129743.78511657957,-1783.6458145544098,127960.13930202516,910,1,157.17021276595744,42,5,15,37.824567243675105,0.6076388888888888,45.30038759689923,1018.7984496124034,24.25710594315246,0
3146,4,0,1,44,0.0,0.022222222222222223,0.9777777777777777,45,1200,800,400,0.6666666666666666,16,8,8,306.0971920673036,0.4472643097643098,0.13939059371109996,0.17160500691266362,129630.39852804548,-1064.0998007999524,128566.29872724552,911,2,164.2,41,4,16,37.61883016723494,0.6079776422764227,45.41170634920635,1018.3531746031747,24.837882307394505,0
3147,4,0,0,44,0.0,0.0,1.0,44,1300,900,400,0.6923076923076923,17,9,8,313.9581117206709,0.4475643058491896,0.1356877154781353,0.175942968648832,129614.99851278974,-661.2639632494115,128953.73454954033,912,3,167.3409090909091,40,4,16,37.43429807052561,0.609375,45.42682926829267,1018.2926829268271,25.457317073170678,0
3148,4,1,1,44,0.022222222222222223,0.022222222222222223,0.9777777777777777,45,1500,1000,500,0.6666666666666666,20,10,10,306.966418935474,0.44880050505050506,0.14592794429306744,0.17331796269125957,129908.37191357987,-1024.4984567901593,128883.87345678972,913,0,164.6,41,4,17,37.31550862851952,0.6107723577235773,45.13888888888887,1019.4444444444414,24.864498644986377,0
3149,4,1,1,44,0.022222222222222223,0.022222222222222223,0.9777777777777777,45,1200,800,400,0.6666666666666666,16,8,8,305.322983364101,0.4478324915824916,0.1470909758679544,0.17351117165100216,130161.33334120666,-1051.7506771227222,129109.58266408394,914,0,165.37777777777777,41,4,18,37.101805042452504,0.6133130081300813,44.890873015873005,1020.4365079365064,24.888695315524544,0
3150,4,2,2,44,0.043478260869565216,0.043478260869565216,0.9565217391304348,46,1300,900,400,0.6923076923076923,17,9,8,293.79157547511284,0.4500503220611916,0.1413208356004021,0.1687861404200157,130584.26852352606,-1527.0490360427345,129057.21948748332,915,0,159.2391304347826,42,4,14,36.96968619643533,0.6160714285714286,44.4767441860465,1022.0930232558126,24.33554817275744,0
3151,4,0,1,43,0.0,0.022727272727272728,0.9772727272727273,44,1300,900,400,0.6923076923076923,17,9,8,306.5035023885551,0.4457474453840733,0.13974219810040767,0.17521957901052201,130392.29811124325,-806.8607888822797,129585.43732236097,916,2,167.47727272727272,40,4,20,36.83851575456055,0.6171875,44.66463414634146,1021.3414634146336,25.53353658536584,0
3152,4,0,1,42,0.0,0.023255813953488372,0.9767441860465116,43,950,400,550,0.42105263157894735,15,4,11,312.55422861067734,0.4454595791805094,0.1442287177298911,0.17930742588717805,130528.564453125,-440.549045138888,130088.01540798611,917,3,170.27906976744185,39,4,15,36.54646619096161,0.6201923076923077,44.53125,1021.875,26.201923076923077,0
3153,4,2,1,43,0.045454545454545456,0.022727272727272728,0.9772727272727273,44,1150,800,350,0.6956521739130435,15,8,7,306.31272496446735,0.44792767794221283,0.15492985654275993,0.17834553072804266,131099.43000637754,-768.5152706916117,130330.91473568593,918,0,166.1818181818182,41,3,18,36.130788046110624,0.6227134146341464,43.973214285714285,1024.1071428571427,24.978222996515676,0
3154,4,1,1,43,0.022727272727272728,0.022727272727272728,0.9772727272727273,44,1450,1000,450,0.6896551724137931,19,10,9,317.1880262539956,0.4473000352360817,0.1444916750414207,0.18024249980851006,130158.8642363178,-491.7914997770776,129667.07273654072,919,0,162.27272727272728,40,4,16,36.801613385121,0.61484375,44.893292682926834,1020.4268292682937,25.510670731707343,8
3155,4,0,3,40,0.0,0.06976744186046512,0.9302325581395349,43,800,600,200,0.75,10,6,4,318.1488368207576,0.44585179032853456,0.1503735125370611,0.1808998348423076,130182.84640842005,-316.49576822917203,129866.35064019088,920,1,166.5581395348837,39,4,16,36.75285376475792,0.6167200854700854,44.869791666666664,1020.5208333333326,26.167200854700834,0
3156,4,0,0,40,0.0,0.0,1.0,40,1200,900,300,0.75,15,9,6,342.07366555886426,0.4424011752136752,0.1570521316545177,0.19332927390574023,129946.64216581451,890.2648425452546,130836.90700835976,921,2,177.975,36,4,16,36.381939842426924,0.6197916666666667,45.101351351351354,1019.594594594595,28.322072072072086,0
3157,4,0,0,40,0.0,0.0,1.0,40,1250,700,550,0.56,18,7,11,340.9416053878343,0.4422943376068376,0.1469474497681611,0.1932571377724033,130061.48674011863,868.6744176609204,130930.16115777956,922,3,178.975,36,4,16,36.29434385809966,0.6209490740740741,44.988738738738746,1020.0450450450461,28.334584584584615,0
3158,4,0,0,40,0.0,0.0,1.0,40,1050,700,350,0.6666666666666666,14,7,7,337.8030523748355,0.44169337606837605,0.1497683142100621,0.19232706449280831,130233.84871357844,798.6783235938656,131032.5270371723,923,4,179.975,36,4,16,36.19975544277729,0.6226851851851851,44.81981981981982,1020.7207207207207,28.353353353353352,0
3159,4,0,0,40,0.0,0.0,1.0,40,1550,1000,550,0.6451612903225806,21,10,11,342.99342733048985,0.44155982905982905,0.15584895259095966,0.19615071789959285,130406.32482144304,945.7024592159717,131352.027280659,924,5,180.975,36,4,17,35.89259463432561,0.6244212962962963,44.6509009009009,1021.3963963963961,28.372122122122114,0
3160,4,1,0,41,0.024390243902439025,0.0,1.0,41,950,700,250,0.7368421052631579,12,7,5,337.21916248463674,0.44189532520325203,0.1677283432356349,0.1950769996989548,130850.90033712277,625.0862044090285,131475.9865415318,925,0,177.53658536585365,37,4,16,35.59048244203908,0.6269707207207207,44.216008771929815,1023.1359649122792,27.652323376007544,0
3161,4,0,1,40,0.0,0.024390243902439025,0.975609756097561,41,1450,1300,150,0.896551724137931,16,13,3,337.11342085256524,0.44138719512195124,0.1695558331199345,0.19544202920731907,130935.05333371779,627.9927477685153,131563.0460814863,926,1,178.53658536585365,37,4,17,35.50817798728662,0.6278153153153153,44.13377192982455,1023.4649122806995,27.66121384542431,0
3162,4,0,1,39,0.0,0.025,0.975,40,1000,600,400,0.6,14,6,8,341.2955261384117,0.44158653846153845,0.1615203426124201,0.19873442731501006,131103.4404816865,949.0035395506147,132052.4440212371,927,2,179.675,37,3,17,35.231084939329044,0.6295045045045045,43.96929824561403,1024.1228070175425,27.678994784257906,0
3163,4,0,1,38,0.0,0.02564102564102564,0.9743589743589743,39,1350,1100,250,0.8148148148148148,16,11,5,351.5745562432268,0.4395805218173639,0.16045937352005946,0.20499501048643526,131155.04017531034,1422.155009739456,132577.1951850498,928,3,184.25641025641025,36,3,17,34.91575967458224,0.6319444444444444,43.91891891891891,1024.3243243243235,28.45345345345343,0
3164,4,1,1,38,0.02564102564102564,0.02564102564102564,0.9743589743589743,39,750,300,450,0.4,12,3,9,352.0321992920704,0.43974921277552853,0.16974223784417108,0.2065013622651422,131385.84530476414,1450.409615696768,132836.2549204609,929,0,179.97435897435898,36,3,18,34.67088642355008,0.6342592592592593,43.69369369369369,1025.2252252252247,28.478478478478465,0
3165,4,0,0,38,0.0,0.0,1.0,38,950,400,550,0.42105263157894735,15,4,11,359.1728830501528,0.43923364153627314,0.17487017385414316,0.21069890053365922,131387.4488275892,1838.161758401929,133225.61058599112,930,1,184.92105263157896,35,3,19,34.48624595469256,0.6363095238095238,43.69212962962963,1025.2314814814818,29.29232804232805,0
3166,4,0,0,38,0.0,0.0,1.0,38,1100,800,300,0.7272727272727273,14,8,6,364.8587756568902,0.43843349928876246,0.18335530770053055,0.21469976559570786,131506.13667052463,1996.2336033950564,133502.3702739197,931,2,185.92105263157896,35,3,19,34.22054840893702,0.6375,43.576388888888886,1025.6944444444441,29.305555555555546,0
3167,4,0,0,38,0.0,0.0,1.0,38,1250,800,450,0.64,17,8,9,371.1266383835445,0.4371591986723566,0.18670294520832442,0.21958119785347943,131713.9693313829,2176.512533221886,133890.48186460478,932,3,186.92105263157896,35,3,17,33.84976228060287,0.6395833333333334,43.373842592592595,1026.5046296296298,29.32870370370371,0
3168,4,0,0,38,0.0,0.0,1.0,38,1250,900,350,0.72,16,9,7,352.37592947844877,0.4361071597913703,0.16747282218284565,0.19657926218112443,129436.83556241421,1615.484744727358,131052.32030714158,933,4,187.92105263157896,35,3,17,36.63747346072187,0.6166666666666667,45.60185185185185,1017.5925925925922,29.074074074074062,8
3169,4,0,0,38,0.0,0.0,1.0,38,1600,1400,200,0.875,18,14,4,353.385301511777,0.4352477477477477,0.1605927184407938,0.19803082055417895,129613.56122470829,1560.7054826817262,131174.26670739002,934,5,188.92105263157896,35,3,19,36.43204895051905,0.618452380952381,45.428240740740726,1018.2870370370354,29.093915343915295,0
3170,4,2,0,40,0.05,0.0,1.0,40,1050,600,450,0.5714285714285714,15,6,9,338.4096752131536,0.4383012820512821,0.16518154474164848,0.19267618755714042,130234.60493853866,814.5300717528401,131049.1350102915,935,0,180.425,37,3,21,36.18350968596701,0.620777027027027,44.81907894736842,1020.7236842105253,27.587126600284467,0
3171,4,0,0,40,0.0,0.0,1.0,40,850,500,350,0.5882352941176471,12,5,7,336.90675565985697,0.43772702991452994,0.16376020295609917,0.19210041803850716,130291.32806793279,779.2087317287906,131070.53679966158,936,1,181.425,36,4,22,36.16442385469518,0.6232638888888888,44.76351351351351,1020.9459459459458,28.359609609609606,0
3172,4,1,0,41,0.024390243902439025,0.0,1.0,41,1100,700,400,0.6363636363636364,15,7,8,327.8303447738727,0.4378302845528455,0.17456911928082874,0.18903566627563317,130726.51855504421,371.2239297976419,131097.74248484184,937,0,177.97560975609755,38,3,12,35.95621778799273,0.6239035087719298,44.337606837606835,1022.6495726495727,26.911830859199284,0
3173,4,0,1,40,0.0,0.024390243902439025,0.975609756097561,41,1500,1200,300,0.8,18,12,6,327.93215741959824,0.4380081300813008,0.17497116405551782,0.19003400701284517,130917.78897518071,386.43059664693385,131304.21957182765,938,1,178.97560975609755,38,3,16,35.76051779935276,0.6258223684210527,44.15064102564102,1023.3974358974351,26.931511470985136,0
3174,4,1,0,41,0.024390243902439025,0.0,1.0,41,1300,900,400,0.6923076923076923,17,9,8,327.0412516233523,0.4350863821138211,0.17860387932899457,0.1900567807341772,131027.14913662423,370.25657005623805,131397.40570668047,939,0,179.8780487804878,38,3,17,35.672979929736684,0.6269188596491229,44.043803418803414,1023.8247863247857,26.942757534862782,0
3175,4,0,0,41,0.0,0.0,1.0,41,1100,700,400,0.6363636363636364,15,7,8,328.53073929579904,0.4348069105691057,0.17644948280468675,0.19119411877050585,131081.84633875728,412.88317718604213,131494.72951594333,940,1,180.8780487804878,38,3,17,35.5796817944705,0.627467105263158,43.990384615384606,1024.0384615384605,26.948380566801593,0
3176,4,1,2,40,0.023809523809523808,0.047619047619047616,0.9523809523809523,42,1400,900,500,0.6428571428571429,19,9,10,320.7228548339798,0.43480207123499803,0.17716268833587345,0.18850844810988218,131461.6224500866,32.54937065970233,131494.1718207463,941,0,177.54761904761904,39,3,19,35.39709243270698,0.6295405982905983,43.61979166666666,1025.5208333333317,26.29540598290594,0
3177,4,0,0,40,0.0,0.0,1.0,40,850,600,250,0.7058823529411765,11,6,5,327.53020172535344,0.4338942307692308,0.1573246364414036,0.19240342000851113,131440.53939673706,610.1492767004881,132050.68867343754,942,1,175.0,37,3,19,35.243798118049625,0.6328828828828829,43.640350877192965,1025.438596491225,27.714556661925002,0
3178,4,0,0,40,0.0,0.0,1.0,40,1250,900,350,0.72,16,9,7,327.400998844619,0.43295940170940167,0.15489525438221508,0.19289444239233294,131553.00188519506,614.116843644156,132167.1187288392,943,2,176.0,37,3,20,35.133871312526715,0.634009009009009,43.530701754385944,1025.8771929824532,27.726410621147384,0
3179,4,0,0,40,0.0,0.0,1.0,40,1150,600,550,0.5217391304347826,17,6,11,328.7776682007455,0.43263888888888885,0.16403846153846224,0.19427771302771296,131665.51246537373,657.7360341643393,132323.24849953808,944,3,177.0,37,3,17,34.98530982905984,0.6351351351351351,43.42105263157894,1026.3157894736823,27.738264580369794,0
3180,4,0,0,40,0.0,0.0,1.0,40,1200,1000,200,0.8333333333333334,14,10,4,329.9231306737007,0.432545405982906,0.16343072321333185,0.1950985739884089,131693.64762474992,689.7561028393327,132383.40372758926,945,4,178.0,37,3,17,34.92760299825517,0.6354166666666667,43.39364035087719,1026.4254385964912,27.74122807017544,0
3181,4,0,1,39,0.0,0.025,0.975,40,1400,900,500,0.6428571428571429,19,9,10,363.1063822797365,0.43341346153846155,0.14299453676303187,0.20165946110681193,129260.23046339164,1457.0464419370242,130717.27690532866,946,5,179.0,35,5,20,36.54440776993702,0.6148809523809524,45.77546296296296,1016.8981481481482,29.054232804232804,8
3182,4,1,0,40,0.025,0.0,1.0,40,1200,900,300,0.75,15,9,6,362.5138680962026,0.4358573717948718,0.1534032753326513,0.20238631378856548,129466.28146701373,1386.6644965277592,130852.94596354148,947,0,179.8,35,5,16,36.3495820539065,0.6169642857142856,45.57291666666666,1017.708333333332,29.077380952380913,0
3183,4,0,1,39,0.0,0.025,0.975,40,1200,1000,200,0.8333333333333334,14,10,4,367.44954486287463,0.43472222222222223,0.1572914298704251,0.20591217170086418,129613.56122470838,1525.2888160150744,131138.85004072345,948,1,180.8,35,5,17,36.07401303326514,0.618452380952381,45.42824074074073,1018.287037037036,29.093915343915317,0
3184,4,1,1,39,0.025,0.025,0.975,40,1350,1000,350,0.7407407407407407,17,10,7,360.44391921060316,0.4342147435897436,0.15563839187099626,0.20371156332913878,129946.64216581453,1367.6953981008107,131314.33756391532,949,0,178.475,36,4,19,35.913684559310795,0.6197916666666667,45.101351351351354,1019.5945945945952,28.32207207207209,0
3185,4,0,0,39,0.0,0.0,1.0,39,1000,700,300,0.7,13,7,6,359.4814825062601,0.43080859199280247,0.15243829719155855,0.20404567084949674,130114.93866008663,1554.782209147811,131669.72086923444,950,1,180.76923076923077,35,4,19,35.767276422764226,0.6235119047619048,44.936342592592595,1020.25462962963,29.150132275132286,0
3186,4,1,0,40,0.025,0.0,1.0,40,1350,1100,250,0.8148148148148148,16,11,5,346.78914839065317,0.4317040598290598,0.15486333076160053,0.1987629781016044,130492.60567577723,1050.6839187160274,131543.28959449325,951,0,177.225,36,4,16,35.70828281714981,0.6252893518518519,44.56644144144145,1021.734234234235,28.38150650650653,0
3187,4,0,0,40,0.0,0.0,1.0,40,1200,700,500,0.5833333333333334,17,7,10,349.04344958561126,0.4315304487179487,0.15691782330909865,0.20079952061712167,130636.47050766987,1119.5608615372162,131756.03136920708,952,1,178.225,36,4,16,35.50502129690828,0.6267361111111112,44.42567567567568,1022.2972972972976,28.397147147147155,0
3188,4,0,0,40,0.0,0.0,1.0,40,1250,900,350,0.72,16,9,7,351.0092610423489,0.4314770299145299,0.1605153049988992,0.20253278963066149,130751.61944038629,1179.0058639720792,131930.62530435837,953,2,179.225,36,4,16,35.33821478382147,0.6278935185185186,44.31306306306306,1022.7477477477474,28.409659659659653,0
3189,4,0,0,40,0.0,0.0,1.0,40,1000,700,300,0.7,13,7,6,347.5345724731844,0.4321581196581197,0.15666061406404785,0.20127767113217515,130895.6269402849,1098.1511494602732,131993.77808974517,954,3,180.225,36,4,17,35.28140016873924,0.6293402777777778,44.1722972972973,1023.310810810811,28.425300300300304,0
3190,4,0,2,38,0.0,0.05,0.95,40,1050,900,150,0.8571428571428571,12,9,3,348.8808788397161,0.4315705128205128,0.15619511672735076,0.20285489704889598,131047.29940943373,1143.9793975069351,132191.27880694068,955,4,181.225,37,3,17,35.093613907332056,0.6289414414414414,44.02412280701755,1023.9035087719303,27.673067804646767,0
3191,4,1,0,39,0.02564102564102564,0.0,1.0,39,1100,800,300,0.7272727272727273,14,8,6,358.7423006819472,0.42965587044534415,0.16578677225399674,0.20854763413045177,131039.71370018671,1601.8976747017355,132641.61137488845,956,0,186.48717948717947,36,3,19,34.84885980349026,0.630787037037037,44.031531531531535,1023.8738738738741,28.440940940940948,0
3192,4,0,0,39,0.0,0.0,1.0,39,700,200,500,0.2857142857142857,12,2,10,363.22635572650904,0.4287843004948268,0.16810589081067384,0.211629961904715,131126.20380092936,1725.698629372622,132851.90243030197,957,1,187.48717948717947,36,3,20,34.646554883635694,0.6316550925925926,43.947072072072075,1024.211711711712,28.450325325325334,0
3193,4,0,0,39,0.0,0.0,1.0,39,900,600,300,0.6666666666666666,12,6,6,363.4879375201602,0.4287843004948268,0.17006066346435755,0.21194142818483186,131155.04017531045,1734.6550097394709,132889.69518504993,958,2,188.48717948717947,36,3,20,34.6106805189094,0.6319444444444444,43.91891891891892,1024.3243243243244,28.453453453453456,0
3194,4,0,0,39,0.0,0.0,1.0,39,1250,700,550,0.56,18,7,11,366.2011169439352,0.42872807017543857,0.169666432772269,0.21400539261868115,131241.56832085463,1812.161781714147,133053.73010256878,959,3,189.48717948717947,36,3,20,34.45364875261019,0.6328125,43.83445945945946,1024.662162162162,28.462837837837835,0
3195,4,1,0,40,0.025,0.0,1.0,40,1300,700,600,0.5384615384615384,19,7,12,357.08467463410193,0.43023504273504276,0.16856949458483772,0.21045203164605564,131565.50068587094,1396.061868299718,132961.56255417067,960,0,185.725,35,5,17,34.35995788206981,0.638095238095238,43.51851851851851,1025.925925925925,29.312169312169285,0
3196,4,0,1,39,0.0,0.025,0.975,40,1200,600,600,0.5,18,6,12,360.76464292280457,0.4292067307692307,0.16892759188151452,0.21339193512273602,131703.53366457665,1502.7956588345048,133206.32932341116,961,1,186.725,36,4,18,34.12621137319439,0.6374421296296297,43.384009009009006,1026.4639639639631,28.512887887887864,0
3197,4,0,0,39,0.0,0.0,1.0,39,1300,900,400,0.6923076923076923,17,9,8,382.8981439107014,0.4279689608636977,0.1812638048593107,0.21298709255032783,129322.44897959197,2161.245678421128,131483.6946580131,962,2,190.6153846153846,34,5,18,35.97773291198502,0.6176470588235294,45.71428571428572,1017.1428571428581,29.91596638655465,8
3198,4,0,0,39,0.0,0.0,1.0,39,1100,700,400,0.6363636363636364,15,7,8,384.0182194457394,0.4276596941070625,0.1868183290738279,0.214268129231213,129443.56575963726,2141.737528344684,131585.30328798195,963,3,191.6153846153846,34,5,18,35.82563172671972,0.6188725490196079,45.5952380952381,1017.6190476190483,29.929971988795536,0
3199,4,0,0,39,0.0,0.0,1.0,39,950,600,350,0.631578947368421,13,6,7,380.6641359734614,0.4272941970310391,0.18098665467086472,0.2127240759851699,129504.14540816352,2059.5167233560355,131563.66213151955,964,4,192.6153846153846,34,5,18,35.84917153996101,0.6194852941176471,45.5357142857143,1017.8571428571449,29.93697478991603,0
3200,4,0,0,39,0.0,0.0,1.0,39,1000,800,200,0.8,12,8,4,383.8801652892556,0.4265350877192982,0.1775990675990673,0.21544294990723578,129672.49657064503,2155.7398834019555,131828.236454047,965,5,193.6153846153846,35,4,18,35.59564393939394,0.6190476190476191,45.37037037037039,1018.518518518521,29.100529100529172,0
3201,4,1,0,40,0.025,0.0,1.0,40,1150,1000,150,0.8695652173913043,13,10,3,375.45248387779293,0.4286057692307692,0.1740643149064316,0.21208731440435716,129927.00277970143,1756.283183287164,131683.2859629886,966,0,189.75,37,3,19,35.55110418011042,0.6176801801801801,45.12061403508772,1019.5175438596491,27.554528212422948,0
3202,4,0,0,40,0.0,0.0,1.0,40,1350,1100,250,0.8148148148148148,16,11,5,352.94271346317123,0.42833867521367525,0.15699526474386616,0.19851959403751707,129759.37307633093,1167.472202985507,130926.84527931643,967,1,190.75,37,3,17,36.2951104893098,0.615990990990991,45.28508771929823,1018.8596491228051,27.536747273589327,7
3203,4,0,0,40,0.0,0.0,1.0,40,1200,700,500,0.5833333333333334,17,7,10,351.4005167489999,0.42764423076923075,0.16000752850075273,0.19850072932759422,129927.00277970142,1131.2831832871652,131058.28596298858,968,2,191.75,37,3,18,36.16413924141394,0.6176801801801801,45.12061403508772,1019.517543859649,27.554528212422944,0
3204,4,2,0,42,0.047619047619047616,0.0,1.0,42,1100,700,400,0.6363636363636364,15,7,8,341.1513826626965,0.4311967673248161,0.16543659923705945,0.19533470185752744,130453.51765103388,501.3124094573208,130954.8300604912,969,0,183.57142857142858,38,4,20,35.891854911803655,0.6211622807017544,44.604700854700866,1021.5811965811982,26.883715699505217,0
3205,4,0,1,41,0.0,0.023809523809523808,0.9761904761904762,42,1550,1100,450,0.7096774193548387,20,11,9,343.8330812106382,0.431003193960511,0.16304272074709059,0.1974254054538396,130562.68376981535,578.3539703411708,131141.03774015652,970,1,184.57142857142858,38,4,16,35.712854554324345,0.6222587719298245,44.49786324786326,1022.0085470085484,26.894961763382852,0
3206,4,0,2,39,0.0,0.04878048780487805,0.9512195121951219,41,600,400,200,0.6666666666666666,8,4,4,352.72443745536077,0.4280741869918699,0.16274996924059582,0.20198731307754156,130458.54403518414,1003.1833112111663,131461.72734639532,971,2,190.0487804878049,37,4,19,35.59119083395943,0.6230292792792793,44.5997807017544,1021.6008771929844,27.61083451872931,0
3207,4,0,2,37,0.0,0.05128205128205128,0.9487179487179487,39,950,700,250,0.7368421052631579,12,7,5,367.42603726906,0.4271536212325686,0.1656295365598972,0.20873023973009158,130147.65346004826,1763.9273141385083,131911.58077418676,972,3,194.53846153846155,36,3,19,35.53139830040834,0.6218171296296297,44.9042792792793,1020.382882882886,28.343968968969055,0
3208,4,1,0,38,0.02631578947368421,0.0,1.0,38,900,600,300,0.6666666666666666,12,6,6,368.5443320686592,0.42737968231389284,0.16591402731589966,0.2104775819231003,130353.74858276674,2008.277767218442,132362.0263499852,973,0,183.8421052631579,34,4,20,35.29353190331857,0.6280637254901961,44.70238095238097,1021.1904761904785,30.03501400560231,0
3209,4,0,1,37,0.0,0.02631578947368421,0.9736842105263158,38,1250,1000,250,0.8,15,10,5,370.9828728777628,0.427275960170697,0.16566281687203666,0.21236851448726396,130444.94224773259,2078.5678854875496,132523.51013322014,974,1,184.8421052631579,34,4,20,35.13867847570216,0.6289828431372548,44.61309523809525,1021.5476190476203,30.04551820728295,0
3210,4,1,1,37,0.02631578947368421,0.02631578947368421,0.9736842105263158,38,1250,900,350,0.72,16,9,7,377.75061290370667,0.42659435751541014,0.1807793640095583,0.21777703119750605,130718.714569161,2275.814909297052,132994.52947845805,975,0,185.44736842105263,34,4,20,34.687863795110594,0.6317401960784313,44.345238095238095,1022.6190476190477,30.07703081232493,0
3211,4,0,0,37,0.0,0.0,1.0,37,1250,900,350,0.72,16,9,7,387.37293016092843,0.4249874874874875,0.18462510692080847,0.20349094122845773,127032.00113378669,2441.751700680254,129473.75283446694,976,1,189.9189189189189,34,3,20,38.2134703196347,0.5943627450980392,47.97619047619047,1008.0952380952368,29.649859943977553,8
3212,4,1,2,36,0.02631578947368421,0.05263157894736842,0.9473684210526316,38,1100,800,300,0.7272727272727273,14,8,6,375.5912857695419,0.4278390232337601,0.18298797932220023,0.19921136301510226,127422.33737244898,1971.7580782312948,129394.09545068028,977,0,185.89473684210526,34,4,18,38.10895924222773,0.5983455882352942,47.589285714285715,1009.6428571428572,29.695378151260506,0
3213,4,0,0,36,0.0,0.0,1.0,36,1100,800,300,0.7272727272727273,14,8,6,388.5923772273071,0.4227678571428572,0.2061140791106797,0.20568424285630454,127339.27455786223,2696.6142829680757,130035.8888408303,978,3,195.88888888888889,33,3,18,37.86627812854137,0.5997474747474747,47.671568627450974,1009.313725490195,30.585264408793787,0
3214,4,3,0,39,0.07692307692307693,0.0,1.0,39,850,500,350,0.5882352941176471,12,5,7,372.0559608228364,0.4309772829509672,0.2268740773820599,0.20184768268262562,128330.7201557094,1756.8561370626753,130087.57629277206,979,0,181.74358974358975,33,6,22,37.26667069827449,0.6098484848484849,46.69117647058824,1013.2352941176474,30.70409982174689,0
3215,4,0,1,38,0.0,0.02564102564102564,0.9743589743589743,39,1100,800,300,0.7272727272727273,14,8,6,376.4970461567834,0.43080859199280247,0.22449302178541863,0.20505332869355308,128485.9808276866,1874.9184508362328,130360.89927852283,980,1,182.74358974358975,33,6,17,36.99522039566461,0.6114267676767677,46.53799019607844,1013.8480392156873,30.722667855020827,0
3216,4,2,0,40,0.05,0.0,1.0,40,1400,900,500,0.6428571428571429,19,9,10,366.5907190111773,0.43030181623931624,0.23443175161101393,0.20251467875471857,129050.14349489812,1461.7169784580733,130511.8604733562,981,0,179.1,34,6,20,36.67008396797501,0.6148897058823529,45.98214285714287,1016.0714285714298,29.88445378151264,0
3217,4,1,0,41,0.024390243902439025,0.0,1.0,41,1500,1100,400,0.7333333333333333,19,11,8,359.157355995108,0.4301321138211382,0.23808028859600583,0.2000885765537283,129383.00028344667,1093.8598356009081,130476.86011904757,982,0,175.70731707317074,34,7,21,36.51976558233873,0.6182598039215687,45.654761904761905,1017.3809523809521,29.92296918767506,0
3218,4,1,0,42,0.023809523809523808,0.0,1.0,42,1050,700,350,0.6666666666666666,14,7,7,351.0827814045002,0.4323582075106465,0.2402676102823813,0.1971844007109768,129701.96926708247,707.2256247856619,130409.19489186813,983,0,172.5,35,7,18,36.40081146081885,0.6193452380952381,45.34143518518518,1018.6342592592592,29.103835978835978,0
3219,4,0,0,42,0.0,0.0,1.0,42,1800,1200,600,0.6666666666666666,24,12,12,382.36094019290124,0.43278164924506385,0.24684056212718652,0.20235056497849033,127332.20663265295,1429.2517088818443,128761.45834153479,984,1,173.5,34,8,14,38.030785562632715,0.5974264705882353,47.67857142857142,1009.2857142857133,29.684873949579803,8
3220,4,1,1,42,0.023255813953488372,0.023255813953488372,0.9767441860465116,43,1000,700,300,0.7,13,7,6,373.57115478619835,0.4334856035437431,0.25146336723456675,0.19945277300452877,127688.85598013546,940.1746763655468,128629.03065650101,985,0,170.4418604651163,36,7,15,37.88625812441969,0.5969328703703703,47.32545045045045,1010.6981981981975,28.07494994994993,0
3221,4,1,1,42,0.023255813953488372,0.023255813953488372,0.9767441860465116,43,1150,900,250,0.782608695652174,14,9,5,370.953855608348,0.43512366186784796,0.25567153396187825,0.19889770610260127,127859.63909433075,886.0052197467662,128745.64431407751,986,0,171.34883720930233,36,7,16,37.777205582154906,0.5986689814814814,47.15653153153153,1011.3738738738733,28.093718718718705,0
3222,4,1,0,43,0.023255813953488372,0.0,1.0,43,1150,700,450,0.6086956521739131,16,7,9,369.46165575656687,0.4354466592838686,0.262398355033552,0.1988199195905162,128005.79415060394,858.6465306632704,128864.44068126721,987,0,172.2093023255814,37,6,17,37.66512713547875,0.5982545045045045,47.01206140350877,1011.9517543859641,27.35004741583687,0
3223,4,0,0,43,0.0,0.0,1.0,43,1100,900,200,0.8181818181818182,13,9,4,368.7804969662966,0.4353082318198597,0.26186600821386286,0.19859066435232878,128033.53555901808,843.2541743613331,128876.78973337942,988,1,173.2093023255814,37,6,17,37.6539364391477,0.5985360360360361,46.984649122807014,1012.0614035087714,27.35301090564247,0
3224,4,2,1,44,0.044444444444444446,0.022222222222222223,0.9777777777777777,45,1500,1000,500,0.6666666666666666,20,10,10,349.1275950371309,0.4384469696969697,0.25734540605039724,0.19123494219507864,128713.06911571303,-12.49505423611049,128700.57406147693,989,0,166.46666666666667,38,7,16,37.457227837439454,0.6036184210526316,46.31410256410255,1014.7435897435872,26.70377867746282,0
3225,4,2,1,45,0.043478260869565216,0.021739130434782608,0.9782608695652174,46,1650,1200,450,0.7272727272727273,21,12,9,345.52884036352435,0.44234098228663443,0.26018785032570846,0.19135473463491873,129148.44292534703,-275.09765625002046,128873.34526909702,990,0,163.80434782608697,39,7,18,37.10502493680399,0.6063034188034189,45.88541666666666,1016.4583333333318,26.06303418803415,0
3226,4,1,0,46,0.021739130434782608,0.0,1.0,46,950,800,150,0.8421052631578947,11,8,3,342.76729965157557,0.4433272946859903,0.25636430087575035,0.19102328969771576,129396.54659366334,-329.39732658126707,129067.14926708207,991,0,163.6304347826087,37,9,19,36.92286794554011,0.6123310810810811,45.64144736842105,1017.434210526315,27.498221906116623,0
3227,4,0,2,44,0.0,0.043478260869565216,0.9565217391304348,46,1500,1000,500,0.6666666666666666,20,10,10,345.1537148942633,0.44298510466988733,0.2631618562767717,0.19339565294869035,129609.02829142011,-252.9924802761373,129356.03581114397,992,1,164.6304347826087,38,8,16,36.646207113629195,0.6126644736842105,45.43269230769231,1018.2692307692307,26.79655870445344,0
3228,4,0,0,44,0.0,0.0,1.0,44,1000,800,200,0.8,12,8,4,361.12271989058104,0.4413319238900634,0.27152236252955664,0.20127968995752013,129401.82317029878,545.9876684116682,129947.81083871046,993,2,170.72727272727272,36,8,19,36.45060874377422,0.6142939814814814,45.63626126126127,1017.4549549549558,28.262637637637663,0
3229,4,0,1,43,0.0,0.022727272727272728,0.9772727272727273,44,1250,800,450,0.64,17,8,9,361.22102733505335,0.44067124735729385,0.27055462793457874,0.20177476174624323,129487.77113261925,554.7411431702113,130042.51227578946,994,3,171.72727272727272,36,8,17,36.36059784613115,0.615162037037037,45.55180180180181,1017.792792792794,28.272022022022057,0
3230,4,0,2,41,0.0,0.046511627906976744,0.9534883720930233,43,1300,1000,300,0.7692307692307693,16,10,6,362.0030508662145,0.44084533038021406,0.26426546915428184,0.20280245265999503,129602.41280131518,783.2937667397497,130385.70656805493,995,4,171.02325581395348,36,7,18,36.22401017474011,0.6163194444444444,45.43918918918921,1018.2432432432461,28.284534534534615,0
3231,4,0,0,41,0.0,0.0,1.0,41,1100,900,200,0.8181818181818182,13,9,4,372.60720282103307,0.43686483739837395,0.2610962631670526,0.2083822231080873,129534.4405470522,1453.093112244911,130987.53365929711,996,5,177.78048780487805,34,7,19,36.02332085915878,0.6197916666666667,45.50595238095239,1017.9761904761908,29.9404761904762,0
3232,4,0,0,41,0.0,0.0,1.0,41,1550,1300,250,0.8387096774193549,18,13,5,371.8809775168368,0.43630589430894307,0.2598261058022713,0.20829718406689637,129595.04145408174,1438.786139455793,131033.82759353754,997,6,178.78048780487805,34,7,19,35.980065474102645,0.6204044117647058,45.44642857142858,1018.2142857142867,29.947478991596668,0
3233,4,1,1,41,0.023809523809523808,0.023809523809523808,0.9761904761904762,42,900,600,300,0.6666666666666666,12,6,6,363.6625019104878,0.4374637049941928,0.25764359797973246,0.20501997386835835,129849.38298396787,1044.2702974965844,130893.65328146445,998,0,175.5,35,7,20,35.93052085699145,0.6208333333333333,45.19675925925927,1019.2129629629638,29.120370370370395,0
3234,4,0,1,40,0.0,0.024390243902439025,0.975609756097561,41,1400,1100,300,0.7857142857142857,17,11,6,369.8891520465662,0.4373221544715447,0.2550009968764537,0.20884510584783073,129908.37191358043,1410.339506172863,131318.7114197533,999,1,161.21951219512195,35,6,20,35.71185286103541,0.6214285714285714,45.1388888888889,1019.4444444444459,29.12698412698417,0
3235,4,1,0,41,0.024390243902439025,0.0,1.0,41,1100,700,400,0.6363636363636364,15,7,8,368.8604070413022,0.43709349593495933,0.257404329344348,0.21000516008374723,130233.05047850228,1407.5632019461655,131640.61368044844,1000,0,159.90243902439025,35,6,21,35.40804418490381,0.624702380952381,44.820601851851855,1020.717592592593,29.1633597883598,0
3236,4,0,1,40,0.0,0.024390243902439025,0.975609756097561,41,950,700,250,0.7368421052631579,12,7,5,368.54433206865934,0.43686483739837395,0.2522391369868462,0.21047758192309993,130353.74858276652,1408.230389796101,131761.97897256262,1001,1,160.90243902439025,34,7,21,35.293531903318566,0.6280637254901961,44.702380952380956,1021.1904761904768,30.03501400560226,0
3237,4,0,0,40,0.0,0.0,1.0,40,1100,700,400,0.6363636363636364,15,7,8,368.0100344905758,0.4366586538461539,0.23251397949673835,0.21116297700983294,130536.16780045342,1607.7239229024826,132143.8917233559,1002,2,159.975,34,6,17,35.122029356943145,0.6299019607843137,44.52380952380952,1021.9047619047611,30.056022408963564,0
3238,4,0,1,39,0.0,0.025,0.975,40,1100,500,600,0.45454545454545453,17,5,12,349.4409772951615,0.43651175213675214,0.13955746668185465,0.1930611919241175,129054.3435597782,1032.5590027356413,130086.90256251383,1003,3,160.975,35,5,17,37.101439989368586,0.612797619047619,45.978009259259274,1016.0879629629649,29.031084656084712,8
3239,4,1,1,39,0.025,0.025,0.975,40,950,700,250,0.7368421052631579,12,7,5,352.5107565599866,0.4337606837606838,0.15876418294537387,0.19683961187663787,129473.85381235827,1128.268956920474,130602.12276927874,1004,0,161.55,34,6,16,36.59638554216868,0.6191789215686274,45.56547619047619,1017.7380952380952,29.93347338935574,0
3240,4,1,0,40,0.025,0.0,1.0,40,1450,900,550,0.6206896551724138,20,9,11,354.37832896843435,0.4340811965811966,0.17134716540035067,0.19880043307048886,129655.65653344669,1189.430980725619,130845.08751417231,1005,0,162.375,34,6,17,36.363968439509044,0.6210171568627452,45.38690476190476,1018.4523809523807,29.95448179271708,0
3241,4,1,0,41,0.024390243902439025,0.0,1.0,41,1300,1100,200,0.8461538461538461,15,11,4,349.9368153548653,0.43526422764227646,0.17377011074399418,0.1984776763537826,130085.41907793209,904.3354552469158,130989.754533179,1006,0,159.390243902439,35,6,18,36.04067392784207,0.6232142857142857,44.96527777777778,1020.1388888888888,29.146825396825395,0
3242,4,0,0,41,0.0,0.0,1.0,41,1300,1100,200,0.8461538461538461,15,11,4,351.85554152536304,0.4348577235772358,0.17210101328641736,0.2000200070682865,130173.98787133476,960.487798996898,131134.47567033165,1007,1,160.390243902439,35,6,18,35.90187989111944,0.6241071428571429,44.878472222222214,1020.4861111111102,29.156746031746007,0
3243,4,1,1,41,0.023809523809523808,0.023809523809523808,0.9761904761904762,42,950,900,50,0.9473684210526315,10,9,1,344.8623451566623,0.43777826171118855,0.16513457087831163,0.1975405529330212,130469.43486636227,598.8291966735178,131068.26406303578,1008,0,157.54761904761904,35,7,20,35.78096087761034,0.6270833333333333,44.58912037037037,1021.6435185185182,29.189814814814806,0
3244,4,2,1,42,0.046511627906976744,0.023255813953488372,0.9767441860465116,43,1100,600,500,0.5454545454545454,16,6,10,338.5379720117705,0.4375,0.18397978289116956,0.19680225329482198,131039.71370018659,272.38378581283143,131312.09748599943,1009,0,154.41860465116278,36,7,18,35.366026910104125,0.630787037037037,44.03153153153153,1023.8738738738732,28.440940940940923,0
3245,4,0,1,41,0.0,0.023809523809523808,0.9761904761904762,42,1100,700,400,0.6363636363636364,15,7,8,347.4607213584089,0.43481416957026714,0.19019341703427273,0.2011722486921867,130883.62328800141,695.3836323302341,131579.00692033165,1010,1,159.07142857142858,35,7,18,35.29542755344417,0.63125,44.18402777777777,1023.2638888888879,29.236111111111082,0
3246,4,0,2,39,0.0,0.04878048780487805,0.9512195121951219,41,1200,800,400,0.6666666666666666,16,8,8,377.50061165343516,0.433739837398374,0.22148857362499164,0.20046821890908192,127471.58893014808,1424.1205579132095,128895.70948806129,1011,2,163.1951219512195,35,6,16,38.01014804202484,0.5967261904761905,47.540509259259245,1009.837962962961,28.85251322751317,8
3247,4,0,1,38,0.0,0.02564102564102564,0.9743589743589743,39,1050,700,350,0.6666666666666666,14,7,7,392.90738782922114,0.43052744039586144,0.2454665994360099,0.20828642605772973,127401.1272707611,2211.368824490566,129612.49609525167,1012,3,171.48717948717947,33,6,16,37.693716112325,0.6003787878787878,47.61029411764705,1009.5588235294106,30.592691622103352,0
3248,4,1,0,39,0.02564102564102564,0.0,1.0,39,950,600,350,0.631578947368421,13,6,7,390.47720267828726,0.4317926225820963,0.24002114723764256,0.20811147615271325,127617.73003472202,2166.3628472221994,129784.09288194422,1013,0,171.02564102564102,33,6,18,37.532216494845365,0.6025883838383839,47.39583333333332,1010.4166666666649,30.618686868686815,0
3249,4,1,1,39,0.025,0.025,0.975,40,1050,700,350,0.6666666666666666,14,7,7,378.82241969920346,0.4338141025641025,0.23979533501029104,0.20426515922868244,128085.94419795932,1704.3654621056028,129790.30966006493,1014,0,167.725,35,5,20,37.34612013110756,0.6029761904761906,46.93287037037036,1012.2685185185168,28.92195767195762,0
3250,4,2,0,41,0.04878048780487805,0.0,1.0,41,1300,900,400,0.6923076923076923,17,9,8,330.8956800809518,0.4374237804878049,0.18146015535879179,0.17729374744194223,127831.16731596482,300.29226000903327,128131.45957597386,1015,0,163.73170731707316,36,5,18,38.81913511507053,0.5983796296296297,47.1846846846847,1011.2612612612629,28.090590590590637,8
3251,4,0,0,41,0.0,0.0,1.0,41,1200,900,300,0.75,15,9,6,333.9014585343765,0.4371443089430895,0.17987533392698118,0.1794121234134477,127945.0734518305,344.20932757084927,128289.28277940134,1016,1,164.73170731707316,36,5,18,38.62677166815078,0.599537037037037,47.07207207207209,1011.7117117117141,28.10310310310317,0
3252,4,2,1,42,0.046511627906976744,0.023255813953488372,0.9767441860465116,43,1750,1400,350,0.8,21,14,7,320.07747227604744,0.44160668143226284,0.16852920603654575,0.17042796742882646,127579.22620670573,-426.81485751330194,127152.41134919242,1017,0,158.02325581395348,40,3,17,39.349872581564576,0.5888020833333334,47.4339430894309,1010.264227642277,25.256605691056926,8
3253,4,2,3,41,0.045454545454545456,0.06818181818181818,0.9318181818181819,44,1600,1300,300,0.8125,19,13,6,321.4971955141415,0.4420806906272023,0.18273850377487988,0.17284923020815654,127968.81028163587,-571.6772762345612,127397.13300540131,1018,0,155.3409090909091,41,3,19,38.91629489819263,0.5912093495934959,47.048611111111114,1011.8055555555561,24.67818428184283,0
3254,4,3,0,44,0.06818181818181818,0.0,1.0,44,700,500,200,0.7142857142857143,9,5,4,316.20780093540367,0.44386451726568005,0.20314124190754024,0.1715229475150154,128324.66310562534,-684.4275314471067,127640.23557417824,1019,0,154.0,40,4,22,38.68752089602139,0.5963541666666667,46.697154471544735,1013.2113821138242,25.330284552845605,0
3255,4,0,1,43,0.0,0.022727272727272728,0.9772727272727273,44,950,700,250,0.7368421052631579,12,7,5,318.4116014271319,0.44412878787878785,0.20833295351995829,0.17305280114620122,128401.90120174848,-623.0690024125638,127778.83219933591,1020,1,155.0,40,4,14,38.55305157257931,0.5971354166666667,46.620934959349604,1013.5162601626031,25.337906504065078,0
3256,4,1,3,41,0.022727272727272728,0.06818181818181818,0.9318181818181819,44,950,600,350,0.631578947368421,13,6,7,316.3763945389547,0.44535103946441157,0.22273819930069982,0.17317444753711217,128685.30636525892,-657.4013484037091,128027.9050168552,1021,0,155.1818181818182,40,4,15,38.3163060897436,0.6,46.341463414634156,1014.6341463414645,25.365853658536615,0
3257,4,0,0,41,0.0,0.0,1.0,41,1150,900,250,0.782608695652174,14,9,5,329.25048883849183,0.44098069105691057,0.21652541925678848,0.17903479522488355,128422.23087873199,256.61645891044054,128678.84733764244,1022,1,162.8780487804878,37,4,16,38.25769868743687,0.6024774774774775,46.60087719298246,1013.5964912280708,27.394499762920834,0
3258,4,1,2,40,0.023809523809523808,0.047619047619047616,0.9523809523809523,42,1250,900,350,0.72,16,9,7,328.06379171458775,0.4403794037940379,0.2262002421969611,0.18095464348420007,128989.6701388888,63.36805555554861,129053.03819444435,1023,0,159.97619047619048,39,3,17,37.710213289581645,0.6047008547008548,46.041666666666664,1015.8333333333326,26.047008547008527,0
3259,4,1,1,40,0.024390243902439025,0.024390243902439025,0.975609756097561,41,1150,700,450,0.6086956521739131,16,7,9,335.47120102133357,0.4432164634146341,0.22352207744229635,0.18488838887593112,128957.11343277417,452.2795447074,129409.39297748158,1024,0,159.17073170731706,38,3,18,37.55522246765542,0.6060855263157895,46.073717948717935,1015.7051282051257,26.72908232118752,0
3260,4,1,0,41,0.024390243902439025,0.0,1.0,41,1500,900,600,0.6,21,9,12,333.1685436480336,0.44115853658536586,0.21598172462330045,0.18437651865757687,129119.9380547338,403.7403435240002,129523.67839825779,1025,0,159.97560975609755,38,3,19,37.44809734048144,0.6077302631578947,45.91346153846154,1016.3461538461544,26.74595141700406,0
3261,4,1,0,42,0.023809523809523808,0.0,1.0,42,1050,700,350,0.6666666666666666,14,7,7,326.21572201106335,0.44168602400309714,0.21759995201103788,0.18215304618273068,129473.0771513622,47.25635090216113,129520.33350226436,1026,0,157.14285714285714,38,4,15,37.266210021694995,0.6112938596491229,45.566239316239304,1017.7350427350411,26.782501124606345,0
3262,4,0,0,42,0.0,0.0,1.0,42,1550,1000,550,0.6451612903225806,21,10,11,323.46729914182083,0.4418916957026713,0.21019466215102445,0.1814958071052959,129663.42872242312,-11.62418273796061,129651.80453968517,1027,1,158.14285714285714,38,4,15,37.14312563376343,0.6132127192982456,45.379273504273506,1018.482905982906,26.802181736392264,0
3263,4,0,1,41,0.0,0.023809523809523808,0.9761904761904762,42,1050,700,350,0.6666666666666666,14,7,7,323.17784861833,0.4415771389856756,0.2117536894149381,0.18158519661613276,129717.84056770014,-15.613471583041388,129702.2270961171,1028,2,159.14285714285714,38,4,15,37.09535046320573,0.6137609649122807,45.32585470085469,1018.6965811965795,26.80780476833104,0
3264,4,0,0,41,0.0,0.0,1.0,41,1050,900,150,0.8571428571428571,12,9,3,332.3864643152169,0.4399390243902439,0.11889184294686506,0.1816931190945876,128631.77237426046,378.49767605377446,129010.27005031423,1029,3,163.9512195121951,38,3,16,37.96471827277513,0.602796052631579,46.394230769230774,1014.4230769230777,26.695344129554677,8
3265,4,1,2,40,0.023809523809523808,0.047619047619047616,0.9523809523809523,42,1200,800,400,0.6666666666666666,16,8,8,327.9231576121329,0.4415892373209446,0.13107568942867887,0.18075628659558576,128963.21750217032,58.005099826407786,129021.22260199672,1030,0,161.02380952380952,39,3,17,37.740680443031486,0.6044337606837606,46.06770833333334,1015.7291666666681,26.044337606837644,0
3266,4,2,1,41,0.047619047619047616,0.023809523809523808,0.9761904761904762,42,650,300,350,0.46153846153846156,10,3,7,321.4126752135838,0.4421578590785908,0.15230893869835294,0.17897611072419534,129364.36760355011,-83.69105312091241,129280.6765504292,1031,0,160.78571428571428,38,4,19,37.49868725057761,0.6101973684210527,45.67307692307691,1017.3076923076908,26.771255060728706,0
3267,4,0,3,38,0.0,0.07317073170731707,0.926829268292683,41,1600,1300,300,0.8125,19,13,6,322.51317106137424,0.44115853658536586,0.03425177108913968,0.17510231411088334,128360.96871803995,79.62061235297884,128440.58933039293,1032,1,158.70731707317074,38,3,19,38.4908188367598,0.6000548245614035,46.66132478632478,1013.3547008547001,26.66722896986053,8
3268,4,0,1,37,0.0,0.02631578947368421,0.9736842105263158,38,1400,900,500,0.6428571428571429,19,9,10,364.1712282419463,0.4363442389758179,0.011829333458604818,0.19279779791686757,127347.6321549592,1675.268723115029,129022.90087807423,1033,3,172.02631578947367,36,2,15,38.47391126482948,0.5934606481481481,47.6632882882883,1009.3468468468484,28.037412412412454,7
3269,4,0,0,37,0.0,0.0,1.0,37,1400,1200,200,0.8571428571428571,16,12,4,368.52045404900787,0.43599849849849853,0.028653667997930565,0.1954166517124312,127413.15593117705,1990.8708151148758,129404.02674629193,1034,4,177.02702702702703,35,2,16,38.29686365547022,0.5961309523809524,47.598379629629626,1009.6064814814808,28.845899470899454,0
3270,4,0,2,35,0.0,0.05405405405405406,0.9459459459459459,37,1200,800,400,0.6666666666666666,16,8,8,368.7962333013221,0.435497997997998,0.03637860744721322,0.19669883402283692,127646.96830257616,2015.1442204646573,129662.11252304082,1035,5,178.02702702702703,35,2,17,38.04988451112891,0.5985119047619047,47.36689814814814,1010.5324074074063,28.872354497354465,0
3271,4,2,0,37,0.05405405405405406,0.0,1.0,37,1300,1100,200,0.8461538461538461,15,11,4,367.1069084318707,0.4361861861861862,0.06705298780770441,0.19780344511624795,128056.65569540884,2002.0965952931974,130058.75229070205,1036,0,178.24324324324326,35,2,20,37.67259862778731,0.6026785714285714,46.96180555555555,1012.1527777777769,28.91865079365077,0
3272,4,0,0,37,0.0,0.0,1.0,37,800,600,200,0.75,10,6,4,366.3059492963472,0.43596721721721726,0.059837615393171006,0.19780521262002745,128144.53124999997,1988.0208333333326,130132.5520833333,1037,1,179.24324324324326,35,2,21,37.60288065843622,0.6035714285714286,46.875,1012.4999999999998,28.928571428571423,0
3273,4,3,2,38,0.075,0.05,0.95,40,650,600,50,0.9230769230769231,7,6,1,342.10954766534246,0.4419337606837607,0.06603967168262681,0.18803163860403405,128848.62075617285,816.0686728395087,129664.68942901236,1038,0,166.725,38,2,16,37.49715002279982,0.6049890350877193,46.18055555555556,1015.2777777777778,26.717836257309944,0
3274,4,2,1,39,0.05,0.025,0.975,40,1100,900,200,0.8181818181818182,13,9,4,342.31389411448504,0.44184027777777773,0.07602459016393426,0.18982861400894188,129201.38888888908,845.4861111111303,130046.8750000002,1039,0,167.15,38,2,19,37.13285519125682,0.6085526315789473,45.83333333333334,1016.6666666666682,26.75438596491232,0
3275,4,0,1,38,0.0,0.02564102564102564,0.9743589743589743,39,1400,1000,400,0.7142857142857143,18,10,8,349.54009389938005,0.4400303643724696,0.07240843134076558,0.19413338635165822,129261.91184807247,1236.444160997721,130498.3560090702,1040,1,172.35897435897436,34,5,20,36.887584874736596,0.6170343137254901,45.77380952380952,1016.9047619047611,29.90896358543415,0
3276,4,1,1,38,0.02564102564102564,0.02564102564102564,0.9743589743589743,39,1250,900,350,0.72,16,9,7,347.47022457233953,0.43820287899235266,0.0826044178875247,0.19387568404989297,129443.56575963722,1195.5569727891143,130639.12273242633,1041,0,172.84615384615384,34,5,19,36.755430120106055,0.6188725490196079,45.595238095238095,1017.6190476190479,29.92997198879553,0
3277,4,0,0,38,0.0,0.0,1.0,38,1150,600,550,0.5217391304347826,17,6,11,356.11237489326385,0.43687766714082504,0.08446550215016879,0.19779253593469234,129263.69214965405,1606.4800797770108,130870.17222943106,1042,1,177.78947368421052,33,5,22,36.7186872338716,0.6193181818181819,45.77205882352941,1016.9117647058829,30.81550802139039,0
3278,4,1,0,39,0.02564102564102564,0.0,1.0,39,950,500,450,0.5263157894736842,14,5,9,347.56851036456067,0.43758434547908237,0.09179868109785216,0.19507938929162522,129675.59880203496,1214.2309412511204,130889.82974328609,1043,0,174.2051282051282,37,2,20,36.51709459216995,0.6151463963963963,45.36732456140349,1018.5307017543838,27.527856804172536,0
3279,4,0,0,39,0.0,0.0,1.0,39,1200,1000,200,0.8333333333333334,14,10,4,348.36061373845166,0.4371345029239766,0.08941938652473436,0.19608208258458074,129787.3038458947,1242.5569646429408,131029.86081053763,1044,1,175.2051282051282,37,2,21,36.38345618565945,0.6162725225225225,45.25767543859648,1018.9692982456125,27.539710763394933,0
3280,4,0,0,39,0.0,0.0,1.0,39,1150,800,350,0.6956521739130435,15,8,7,346.77048889262306,0.43660031488978857,0.0879499036290099,0.19602545752051637,129954.95158366005,1212.9084189365676,131167.86000259663,1045,2,176.2051282051282,37,2,21,36.2537862494175,0.6179617117117118,45.09320175438595,1019.6271929824536,27.557491702228475,0
3281,4,0,1,38,0.0,0.02564102564102564,0.9743589743589743,39,600,200,400,0.3333333333333333,10,2,8,346.86862555625663,0.4360098965362123,0.08791366272019796,0.19678449342532975,130094.7406894427,1225.156779008908,131319.8974684516,1046,3,177.2051282051282,37,2,22,36.10946904557181,0.6193693693693694,44.956140350877185,1020.1754385964896,27.572309151256476,0
3282,4,1,1,38,0.02564102564102564,0.02564102564102564,0.9743589743589743,39,1150,700,450,0.6086956521739131,16,7,9,346.07479531974883,0.4341824111560954,0.08955215658406179,0.1970403834637028,130234.60493853867,1214.182849530617,131448.78778806928,1047,0,177.97435897435898,37,2,23,35.987910445089,0.620777027027027,44.81907894736842,1020.7236842105254,27.58712660028447,0
3283,4,0,3,35,0.0,0.07894736842105263,0.9210526315789473,38,900,700,200,0.7777777777777778,11,7,4,353.9825271262188,0.43280286865813183,0.05520480802894134,0.19516640554269496,128972.51136271383,1530.8061061301994,130503.31746884403,1048,1,175.81578947368422,36,2,20,37.069475240206934,0.6099537037037037,46.058558558558545,1015.765765765764,28.215715715715664,8
3284,4,0,0,35,0.0,0.0,1.0,35,1150,800,350,0.6956521739130435,15,8,7,367.87943971624463,0.4301120448179272,0.07525694971373409,0.2020897399608332,128827.88470780448,2478.6260092271946,131306.51071703166,1049,6,187.8,33,2,20,36.86423627877033,0.6148989898989898,46.20098039215685,1015.1960784313708,30.763517528223357,0
3285,4,1,1,35,0.027777777777777776,0.027777777777777776,0.9722222222222222,36,950,700,250,0.7368421052631579,12,7,5,360.82606708354365,0.4317791005291005,0.08714001986097375,0.20074687820614817,129329.78777675741,2134.193050926231,131463.98082768364,1050,0,183.55555555555554,32,4,22,36.5315189506786,0.6223958333333333,45.707070707070706,1017.1717171717166,31.786616161616145,0
3286,4,1,1,35,0.027777777777777776,0.027777777777777776,0.9722222222222222,36,1200,800,400,0.6666666666666666,16,8,8,367.5643200669141,0.43029100529100534,0.11018228957848897,0.20676114729609776,129762.65889321413,2339.224697231832,132101.88359044597,1051,0,184.33333333333334,33,3,20,35.91933285221714,0.6243686868686869,45.28186274509804,1018.8725490196077,30.874925727866902,8
3287,4,0,2,33,0.0,0.05714285714285714,0.9428571428571428,35,750,400,350,0.5333333333333333,11,4,7,374.18222523182385,0.4271008403361345,0.12994158258098798,0.2105753526932231,129779.68606519741,2712.250344352617,132491.93640955002,1052,1,190.25714285714287,32,3,20,35.73342627013633,0.626953125,45.265151515151516,1018.9393939393938,31.841856060606055,0
3288,4,1,0,34,0.029411764705882353,0.0,1.0,34,1200,800,400,0.6666666666666666,16,8,8,364.6126646995363,0.4242238562091503,0.06060395569041788,0.20104927261876407,128976.8442792827,2614.5009118967405,131591.34519117943,1053,0,168.61764705882354,32,2,20,36.79511083488709,0.6188151041666667,46.05429292929293,1015.7828282828281,31.743213383838377,7
3289,4,0,0,34,0.0,0.0,1.0,34,750,500,250,0.6666666666666666,10,5,5,367.6285398227325,0.42388963161021986,0.06764815505031696,0.2033705922359567,129105.13157139556,2692.546200642765,131797.67777203833,1054,1,169.61764705882354,32,2,21,36.58761958007206,0.6201171875,45.92803030303029,1016.2878787878769,31.758996212121154,0
3290,4,1,1,34,0.02857142857142857,0.02857142857142857,0.9714285714285714,35,1300,1000,300,0.7692307692307693,16,10,6,360.9735169530856,0.4258053221288515,0.0726672171758882,0.20144651107381834,129450.69204152221,2345.6543156477937,131796.34635717,1055,0,165.74285714285713,33,2,17,36.404644348105336,0.6212121212121212,45.58823529411763,1017.6470588235271,30.837789661319004,0
3291,4,1,1,34,0.02857142857142857,0.02857142857142857,0.9714285714285714,35,1150,800,350,0.6956521739130435,15,8,7,363.897434281118,0.4257002801120448,0.08820040231762483,0.20388562248427575,129606.62853529886,2432.7039179642343,132039.3324532631,1056,0,166.71428571428572,33,2,18,36.17149576764151,0.622790404040404,45.43504901960784,1018.2598039215682,30.856357694592976,0
3292,4,0,0,34,0.0,0.0,1.0,34,850,600,250,0.7058823529411765,11,6,5,369.5164009232278,0.42505941770647654,0.09083849233259755,0.20743833028863432,129683.21352731848,2784.0148645546215,132467.2283918731,1057,1,169.23529411764707,32,2,18,35.95047725300608,0.6259765625,45.35984848484848,1018.5606060606048,31.8300189393939,0
3293,4,0,0,34,0.0,0.0,1.0,34,750,600,150,0.8,9,6,3,368.8312765163555,0.4250408496732026,0.09188716378744832,0.20756404473409965,129779.68606519741,2773.361455463728,132553.04752066114,1058,2,170.23529411764707,32,2,19,35.86973358116483,0.626953125,45.265151515151516,1018.9393939393938,31.841856060606055,0
3294,4,2,0,36,0.05555555555555555,0.0,1.0,36,1000,700,300,0.7,13,7,6,350.87647137246415,0.42958002645502646,0.08365621092837605,0.20024968412061522,130327.04132550255,1947.5319801550913,132274.57330565763,1059,0,161.72222222222223,32,4,22,35.771660277812124,0.6324869791666667,44.72853535353536,1021.085858585859,31.908933080808094,0
3295,4,0,0,36,0.0,0.0,1.0,36,1450,1100,350,0.7586206896551724,18,11,7,349.3239940421762,0.4276951058201058,0.09000799360511547,0.20064477343744846,130575.52984429077,1922.633121876214,132498.16296616697,1060,1,162.72222222222223,33,3,18,35.55955235811351,0.6325757575757576,44.485294117647065,1022.0588235294126,30.97147950089129,0
3296,4,1,2,35,0.02702702702702703,0.05405405405405406,0.9459459459459459,37,1150,900,250,0.782608695652174,14,9,5,344.6027152798822,0.4280217717717718,0.10607141622375948,0.2000836427205745,130992.77388038556,1628.093112244904,132620.86699263047,1061,0,159.2972972972973,34,3,19,35.258218009846104,0.6344975490196079,44.077380952380956,1023.6904761904768,30.108543417366967,0
3297,4,0,0,35,0.0,0.0,1.0,35,1300,1000,300,0.7692307692307693,16,10,6,361.08762866149726,0.4219887955182073,0.11255774588285039,0.20866847128498245,130810.95838434866,2446.8437531884642,133257.80213753713,1062,1,169.28571428571428,32,3,19,35.02041676952192,0.6373697916666667,44.25505050505051,1022.9797979797991,31.96811868686872,0
3298,4,0,0,35,0.0,0.0,1.0,35,1400,1000,400,0.7142857142857143,18,10,8,359.65811159134745,0.4219887955182073,0.11708469198907245,0.20836518902415122,130907.84940631078,2416.4139819916636,133324.26338830244,1063,2,170.28571428571428,32,3,19,34.95887312358627,0.6383463541666667,44.16035353535355,1023.3585858585875,31.97995580808086,0
3299,4,1,0,36,0.027777777777777776,0.0,1.0,36,1100,700,400,0.6363636363636364,15,7,8,351.6341325062143,0.42283399470899474,0.12361659160056937,0.20578840099016593,131296.7236910083,2033.6819071991679,133330.40559820746,1064,0,166.52777777777777,33,3,22,34.77108991988524,0.6398358585858586,43.78063725490197,1024.8774509803925,31.05689245395129,0
3300,4,2,0,38,0.05263157894736842,0.0,1.0,38,1100,900,200,0.8181818181818182,13,9,4,332.6381088799923,0.4263869132290185,0.08080747859680959,0.1906837159215954,130498.99798525359,1222.7268617898444,131721.72484704343,1065,0,158.71052631578948,35,3,17,36.063283491919655,0.6273809523809524,44.560185185185176,1021.7592592592578,29.19312169312165,8
3301,4,0,0,38,0.0,0.0,1.0,38,800,600,200,0.75,10,6,4,332.8341404873591,0.4253496917970602,0.07780307409901699,0.19123346093974414,130587.7074358067,1092.809472522284,131680.51690832898,1066,1,159.71052631578948,35,3,17,35.96858132336844,0.6282738095238095,44.473379629629626,1022.1064814814811,29.203042328042315,0
3302,4,1,0,39,0.02564102564102564,0.0,1.0,39,1100,500,600,0.45454545454545453,17,5,12,325.66584829442,0.42819388214125054,0.07768195423603097,0.18889450511474037,130953.2521330451,729.4003885642314,131682.65252160933,1067,0,156.5897435897436,36,3,19,35.782722705101406,0.6299189814814814,44.11599099099099,1023.5360360360352,28.431556556556533,0
3303,4,0,1,38,0.0,0.02564102564102564,0.9743589743589743,39,1350,1100,250,0.8148148148148148,16,11,5,328.52388578030843,0.4281095366621683,0.07621818838005368,0.1912673634626199,131097.37059694823,813.7235208181108,131911.09411776633,1068,1,157.5897435897436,36,3,20,35.564199838721514,0.6313657407407407,43.97522522522522,1024.0990990990986,28.447197197197184,0
3304,4,0,1,37,0.0,0.02631578947368421,0.9736842105263158,38,1150,700,450,0.6086956521739131,16,7,9,359.8979037927013,0.4274982219061167,0.1356236106422415,0.1944955120365659,128175.55334787109,1744.319733519128,129919.87308139021,1069,2,161.94736842105263,33,5,20,37.73334442696359,0.608270202020202,46.844362745098046,1012.6225490196084,30.685531788472982,8
3305,4,1,0,38,0.02631578947368421,0.0,1.0,38,1350,900,450,0.6666666666666666,18,9,9,359.1698891375634,0.4293504030346136,0.14299126095563053,0.19500826088499745,128361.76478097368,1620.7361651768624,129982.50094615054,1070,0,162.81578947368422,33,5,21,37.56134861127909,0.6101641414141414,46.66053921568628,1013.357843137255,30.707813428401668,0
3306,4,0,0,38,0.0,0.0,1.0,38,1150,1000,150,0.8695652173913043,13,10,3,364.387678437265,0.4301505452821242,0.060678555893866504,0.191699604743083,127092.01388888898,1664.8898560649845,128756.90374495396,1071,1,163.81578947368422,35,3,22,38.73106060606059,0.5928571428571429,47.91666666666667,1008.3333333333342,28.809523809523835,8
3307,4,1,0,39,0.02564102564102564,0.0,1.0,39,1200,1000,200,0.8333333333333334,14,10,4,351.0128623113547,0.43125843454790824,0.07225420425184725,0.18673003991923787,127542.56129535148,1153.8159013605436,128696.37719671203,1072,0,160.5897435897436,34,5,19,38.60611864073853,0.5995710784313726,47.470238095238095,1010.1190476190477,29.709383753501402,0
3308,4,2,2,39,0.04878048780487805,0.04878048780487805,0.9512195121951219,41,1500,1400,100,0.9333333333333333,16,14,2,337.13056759656325,0.43622967479674796,0.08273509608953522,0.18258457472803952,128261.74554183798,449.60824864924047,128711.35379048722,1073,0,153.70731707317074,35,6,22,38.22173979280927,0.6047619047619048,46.75925925925925,1012.9629629629617,28.941798941798904,0
3309,4,2,1,40,0.04878048780487805,0.024390243902439025,0.975609756097561,41,1250,800,450,0.64,17,8,9,351.21077504725923,0.439380081300813,0.1017285259809122,0.18527173913043482,127202.60080024622,838.7228002728323,128041.32360051906,1074,0,153.41463414634146,37,4,17,38.9497282608696,0.5900900900900901,47.80701754385965,1008.7719298245613,27.26410621147463,8
3310,4,3,1,42,0.06976744186046512,0.023255813953488372,0.9767441860465116,43,850,700,150,0.8235294117647058,10,7,3,339.5460706074802,0.44502122554448137,0.13859133612565966,0.18227373641068242,127907.33642578148,86.08669704864059,127993.42312283012,1075,0,147.1860465116279,39,4,17,38.522573198778026,0.59375,47.109375000000014,1011.5625000000018,25.937500000000046,0
3311,4,3,2,43,0.06666666666666667,0.044444444444444446,0.9555555555555556,45,1200,700,500,0.5833333333333334,17,7,10,327.59170849514334,0.44974747474747473,0.18522353374289557,0.16991840604973657,126514.97938368062,-644.0999348958287,125870.87944878479,1076,0,139.9111111111111,39,6,19,40.25031062331745,0.579594017094017,48.489583333333336,1006.0416666666672,25.795940170940185,8
3312,4,1,1,43,0.022727272727272728,0.022727272727272728,0.9772727272727273,44,1200,800,400,0.6666666666666666,16,8,8,333.86920332936995,0.4481258809020437,0.19915360501567392,0.17414041180848425,126742.13927469128,-336.9405864197605,126405.19868827151,1077,0,143.97727272727272,38,6,20,39.859195402298866,0.5836074561403508,48.263888888888886,1006.9444444444438,26.49853801169589,0
3313,4,3,2,44,0.06521739130434782,0.043478260869565216,0.9565217391304348,46,1250,900,350,0.72,16,9,7,320.2123428314959,0.4511775362318841,0.21380646467621411,0.1695833080197294,127361.47636788659,-1042.492146979331,126318.98422090725,1078,0,138.6086956521739,38,8,16,39.569000493931696,0.5899122807017544,47.64957264957265,1009.401709401709,26.563202878992342,0
3314,4,1,1,44,0.022222222222222223,0.022222222222222223,0.9777777777777777,45,1200,900,300,0.75,15,9,6,325.6648898986991,0.45018939393939394,0.21237651707592375,0.17247095738581353,127361.47636788675,-704.5677642632679,126656.90860362348,1079,0,142.66666666666666,38,7,18,39.43140523567597,0.5899122807017544,47.649572649572654,1009.4017094017104,26.563202878992378,0
3315,4,0,0,44,0.0,0.0,1.0,44,1300,1000,300,0.7692307692307693,16,10,6,324.428744685722,0.44949127906976744,0.20417031386770046,0.17216036305585403,127442.37075617291,-530.8063271604831,126911.56442901243,1080,1,145.54545454545453,38,6,19,39.37987161852361,0.590734649122807,47.56944444444445,1009.7222222222229,26.5716374269006,0
3316,4,2,1,45,0.043478260869565216,0.021739130434782608,0.9782608695652174,46,1000,900,100,0.9,11,9,2,312.70581269611125,0.44997987117552335,0.22091043251220333,0.16832024231502055,128015.94309769341,-1193.7340951153155,126822.20900257809,1081,0,140.17391304347825,40,6,21,39.0906390172056,0.5932291666666667,47.002032520325216,1011.991869918701,25.299796747967527,0
3317,4,0,0,45,0.0,0.0,1.0,45,1350,800,550,0.5925925925925926,19,8,11,321.6517837367146,0.44755892255892255,0.23323953972502443,0.17300805244841908,127986.37695312515,-766.5907118055414,127219.7862413196,1082,1,144.2,39,6,21,38.894465033285286,0.594551282051282,47.03125000000001,1011.8750000000011,25.94551282051285,0
3318,4,1,1,45,0.021739130434782608,0.021739130434782608,0.9782608695652174,46,1100,700,400,0.6363636363636364,15,7,8,318.5323422793275,0.44875201288244765,0.23867653329298633,0.17270681542795088,128306.84222961859,-1025.828890327099,127281.01333929149,1083,0,142.04347826086956,38,8,22,38.64678899082567,0.5995065789473684,46.714743589743584,1013.141025641025,26.66160593792171,0
3319,4,0,0,45,0.0,0.0,1.0,45,2100,1800,300,0.8571428571428571,24,18,6,317.18207950787274,0.4489057239057239,0.23298556222995037,0.172675889411945,128469.25593770528,-850.3708497699113,127618.88508793537,1084,1,143.66666666666666,38,7,17,38.5156496996522,0.6011513157894737,46.55448717948717,1013.7820512820499,26.678475033738156,0
3320,4,0,0,45,0.0,0.0,1.0,45,1900,1600,300,0.8421052631578947,22,16,6,343.85331183343936,0.449263468013468,0.2640162697631703,0.1806741134876632,127042.00227544707,-250.80721048556708,126791.1950649615,1085,2,144.66666666666666,41,4,18,39.300006560388375,0.5818089430894309,47.966269841269835,1008.1349206349194,24.588656600851692,8
3321,4,2,1,46,0.0425531914893617,0.02127659574468085,0.9787234042553191,47,1150,700,450,0.6086956521739131,16,7,9,341.66267561031043,0.45255164970706135,0.28610595459089017,0.18237163288718167,127678.93024006944,-675.3651731234388,127003.565066946,1086,0,139.46808510638297,42,5,17,38.702660594439116,0.5868055555555556,47.335271317829445,1010.65891472868,24.063307493539998,0
3322,4,0,0,46,0.0,0.0,1.0,46,1700,1100,600,0.6470588235294118,23,11,12,346.1236565632171,0.451580112721417,0.2801600573339702,0.1852779573367808,127793.20987654306,-353.5493827160656,127439.66049382699,1087,1,143.5,41,5,17,38.472985347985336,0.589430894308943,47.222222222222214,1011.11111111111,24.661246612466098,0
3323,4,1,3,44,0.02127659574468085,0.06382978723404255,0.9361702127659575,47,1250,800,450,0.64,17,8,9,344.69450753118565,0.45343817452975643,0.2800932951732986,0.1856799448769074,128046.43956380327,-572.6191146866172,127473.82044911665,1088,0,141.4255319148936,42,5,18,38.25015956598053,0.5905257936507937,46.9718992248062,1012.1124031007754,24.097914359542273,0
3324,4,0,0,44,0.0,0.0,1.0,44,1200,900,300,0.75,15,9,6,355.64071610728143,0.45077959830866804,0.288820790440661,0.19242597010078447,128223.64501953126,320.3473451654615,128543.99236469672,1089,1,145.4318181818182,39,5,18,37.79194093043984,0.5969551282051282,46.796875,1012.8125000000001,25.969551282051285,0
3325,4,1,2,43,0.022222222222222223,0.044444444444444446,0.9555555555555556,45,1650,1200,450,0.7272727272727273,21,12,9,356.84980584319516,0.4515993265993266,0.3025908119658123,0.19532831477732798,128685.30636525882,184.26531826294178,128869.57168352176,1090,0,143.17777777777778,40,5,19,37.28966346153847,0.6,46.34146341463415,1014.6341463414637,25.365853658536594,0
3326,4,0,1,42,0.0,0.023255813953488372,0.9767441860465116,43,1300,900,400,0.6923076923076923,17,9,8,357.7424653802653,0.4514811738648948,0.11285683292625759,0.19392793025426133,128298.9222375075,598.8095090554636,128897.73174656297,1091,1,144.32558139534885,40,3,15,37.661751429431256,0.59609375,46.72256097560976,1013.1097560975614,25.327743902439035,8
3327,4,1,2,41,0.023255813953488372,0.046511627906976744,0.9534883720930233,43,1200,700,500,0.5833333333333334,17,7,10,356.4416877181594,0.4507428940568476,0.13158954546385382,0.19430349280892278,128521.48216057237,562.0828018707316,129083.5649624431,1092,0,145.27906976744185,41,2,14,37.4672854906565,0.5967987804878049,46.50297619047618,1013.9880952380937,24.731416957026674,0
3328,4,0,0,41,0.0,0.0,1.0,41,1700,1200,500,0.7058823529411765,22,12,10,380.4569889603802,0.44789126016260167,0.12023984987442216,0.20162299992633953,127388.43831041352,1536.9878525799486,128925.42616299346,1093,1,153.0487804878049,38,3,14,38.02099869474724,0.5901864035087719,47.62286324786325,1009.5085470085475,26.566014394961776,8
3329,4,1,1,41,0.023809523809523808,0.023809523809523808,0.9761904761904762,42,1300,900,400,0.6923076923076923,17,9,8,391.0935043822577,0.4495499419279907,0.1820441153878556,0.19665188297274297,125234.48486328137,1494.5263258107711,126729.01118909214,1094,0,150.38095238095238,39,3,15,39.97912113643459,0.5665064102564102,49.76562500000001,1000.9375000000009,25.665064102564127,7
3330,4,3,0,44,0.06818181818181818,0.0,1.0,44,1650,1400,250,0.8484848484848485,19,14,5,394.1821526608795,0.45346634954193094,0.2345404569499574,0.20225173676442512,126069.98833550385,1144.1216362847617,127214.10997178861,1095,0,144.4318181818182,39,5,18,39.03565069321995,0.5750534188034189,48.932291666666686,1004.2708333333364,25.75053418803427,0
3331,4,4,4,44,0.08333333333333333,0.08333333333333333,0.9166666666666666,48,1850,1600,250,0.8648648648648649,21,16,5,371.68305626718717,0.4592106235224586,0.24713116037322314,0.1953078883030839,127044.27531709158,-155.9590937786727,126888.31622331291,1096,0,133.3125,43,5,17,38.59626463773563,0.5789728682170543,47.96401515151516,1008.1439393939411,23.44520789288235,0
3332,4,0,0,44,0.0,0.0,1.0,44,750,400,350,0.5333333333333333,11,4,7,390.3102618527712,0.45236522198731505,0.25131684146169375,0.20336111486830383,126698.4388563369,1090.3401692708435,127788.77902560774,1097,1,145.9318181818182,39,5,17,38.483466977065,0.5814636752136753,48.30729166666667,1006.7708333333342,25.814636752136774,0
3333,4,3,0,47,0.06382978723404255,0.0,1.0,47,1200,900,300,0.75,15,9,6,373.37101516914413,0.4557893925377737,0.26791583003934716,0.19826420423476163,127469.34125940558,121.11287604328652,127590.45413544888,1098,0,137.5531914893617,38,9,19,38.116712512343064,0.5910087719298245,47.54273504273505,1009.8290598290616,26.574448942870042,0
3334,4,1,0,48,0.020833333333333332,0.0,1.0,48,1550,1000,550,0.6451612903225806,21,10,11,370.00124775609663,0.4574837470449173,0.28156388107673735,0.19890563837255432,127964.52591050332,-130.59314891926095,127833.93276158406,1099,0,135.66666666666666,40,8,21,37.69376925137271,0.5927083333333334,47.0528455284553,1011.7886178861813,25.294715447154534,0
3335,4,0,0,48,0.0,0.0,1.0,48,1900,1600,300,0.8421052631578947,22,16,6,364.7242887517602,0.45683732269503546,0.27103256236331963,0.19723184177658304,128201.54772593534,-247.85027324481962,127953.69745269051,1100,1,136.66666666666666,36,12,21,37.584556506912776,0.6021412037037037,46.81869369369369,1012.7252252252248,28.131256256256243,0
3336,4,0,2,46,0.0,0.041666666666666664,0.9583333333333334,48,1700,1200,500,0.7058823529411765,22,12,10,365.81363063476994,0.4570035460992908,0.2760306651843618,0.19810316722214064,128258.5768834713,-216.25286604172146,128042.32401742958,1101,2,137.66666666666666,36,12,21,37.49861033907727,0.6027199074074074,46.762387387387385,1012.9504504504503,28.137512512512508,0
3337,4,1,2,45,0.02127659574468085,0.0425531914893617,0.9574468085106383,47,1450,1100,350,0.7586206896551724,18,11,7,359.38253975539874,0.4560977489978415,0.2690709265881517,0.19569204726610195,128477.80687326849,-165.4638927362439,128312.34298053225,1102,0,140.31914893617022,37,10,19,37.43736029994953,0.6030405405405406,46.54605263157894,1013.8157894736826,27.400426742531963,0
3338,4,0,1,44,0.0,0.022222222222222223,0.9777777777777777,45,1500,1300,200,0.8666666666666667,17,13,4,357.171468446551,0.4546085858585858,0.2650239561943881,0.19544101700389915,128672.41753472215,191.62326388888505,128864.04079861104,1103,1,144.9111111111111,39,6,19,37.2946611909651,0.6014957264957265,46.354166666666664,1014.5833333333327,26.01495726495725,0
3339,4,2,0,46,0.043478260869565216,0.0,1.0,46,1200,900,300,0.75,15,9,6,353.3979760612327,0.45484098228663444,0.27388173599968746,0.19533589622091016,129072.2714344139,-77.22410189042284,128995.04733252348,1104,0,142.2391304347826,40,6,21,36.982656598993216,0.60390625,45.96036585365853,1016.1585365853647,25.403963414634116,0
3340,4,0,2,44,0.0,0.043478260869565216,0.9565217391304348,46,1000,700,300,0.7,13,7,6,353.73555495834427,0.4546900161030596,0.27601568068424753,0.19616244411326386,129201.38888888907,-59.11680382045802,129142.2720850686,1105,1,143.2391304347826,36,10,21,36.84255464480874,0.6122685185185186,45.83333333333334,1016.6666666666681,28.24074074074078,0
3341,4,0,0,44,0.0,0.0,1.0,44,1350,900,450,0.6666666666666666,18,9,9,366.683046339365,0.4525854474982382,0.2846623185356625,0.2019518562283893,128929.98598327111,655.2880049674827,129585.2739882386,1106,2,150.4318181818182,38,6,21,36.79036047408654,0.6058114035087719,46.100427350427346,1015.5982905982895,26.726270805218146,0
3342,4,1,0,45,0.022222222222222223,0.0,1.0,45,1000,700,300,0.7,13,7,6,359.26218637247666,0.45355639730639735,0.28914968999114277,0.19980640808597347,129315.9037415794,292.5189327541202,129608.42267433352,1107,0,148.06666666666666,36,9,23,36.58542773841157,0.6134259259259259,45.72072072072072,1017.117117117117,28.25325325325325,0
3343,4,0,2,43,0.0,0.044444444444444446,0.9555555555555556,45,1550,1100,450,0.7096774193548387,20,11,9,360.02979890379726,0.4527146464646465,0.2874648477233295,0.2014994986631559,129563.941849896,329.37598588025855,129893.31783577625,1108,1,149.06666666666666,37,8,19,36.31338628612458,0.6140202702702703,45.47697368421052,1018.0921052631569,27.516002844950187,0
3344,4,1,0,44,0.022727272727272728,0.0,1.0,44,900,400,500,0.4444444444444444,14,4,10,355.38332171006937,0.4553162438336857,0.27018625945237384,0.20003496115394745,129787.3038458948,424.8486313096231,130212.15247720442,1109,0,143.13636363636363,37,7,20,36.204558090318876,0.6162725225225225,45.257675438596486,1018.9692982456133,27.539710763394954,0
3345,4,2,2,44,0.043478260869565216,0.043478260869565216,0.9565217391304348,46,1450,1200,250,0.8275862068965517,17,12,5,348.6387267527035,0.45630032206119164,0.2883070700099679,0.19967490714018504,130463.84222059917,-100.44446208274087,130363.39775851642,1110,0,137.8695652173913,36,10,22,35.69017305996472,0.625,44.594594594594604,1021.6216216216231,28.37837837837842,0
3346,4,1,1,44,0.022222222222222223,0.022222222222222223,0.9777777777777777,45,1300,900,400,0.6923076923076923,17,9,8,356.6956112590973,0.45610269360269357,0.3043379247015612,0.20474463454625605,130550.14209733385,313.3325470741062,130863.47464440796,1111,0,141.64444444444445,36,9,20,35.39692378328742,0.6258680555555556,44.51013513513514,1021.9594594594597,28.38776276276277,0
3347,4,0,1,43,0.0,0.022727272727272728,0.9772727272727273,44,1350,700,650,0.5185185185185185,20,7,13,362.5712889067187,0.45509601832276253,0.3041253037854763,0.20784281418626688,130498.99798525359,663.037980109721,131162.03596536332,1112,1,145.8409090909091,35,9,20,35.298670895635105,0.6273809523809524,44.560185185185176,1021.7592592592578,29.19312169312165,0
3348,4,0,0,43,0.0,0.0,1.0,43,1350,1000,350,0.7407407407407407,17,10,7,361.4175267967004,0.45508028792912514,0.2857270766564928,0.20765635518163045,130587.70743580669,839.3372503000614,131427.04468610676,1113,2,138.30232558139534,35,8,20,35.23819971313176,0.6282738095238095,44.473379629629626,1022.106481481481,29.20304232804231,0
3349,4,2,1,44,0.044444444444444446,0.022222222222222223,0.9777777777777777,45,1500,1000,500,0.6666666666666666,20,10,10,347.58695679355856,0.45654461279461284,0.2832435261511381,0.2025458367690973,131131.51552641194,115.92088431055885,131247.4364107225,1114,0,133.11111111111111,37,8,22,35.041639902936886,0.6297860360360361,43.94188596491228,1024.2324561403507,27.681958274063533,0
3350,4,1,1,44,0.022222222222222223,0.022222222222222223,0.9777777777777777,45,1250,900,350,0.72,16,9,7,337.8559831400281,0.4571969696969697,0.2658027674061061,0.1984849408047157,131443.5782911289,-118.05284490736022,131325.52544622155,1115,0,132.9111111111111,36,9,24,34.97602313492935,0.634837962962963,43.637387387387385,1025.45045045045,28.484734734734722,0
3351,4,0,0,44,0.0,0.0,1.0,44,1000,600,400,0.6,14,6,8,343.3164724727076,0.45574568357998596,0.26038609166854854,0.20139717305716826,131387.448827589,221.49509173523336,131608.94391932423,1116,1,136.75,35,9,24,34.89265823737488,0.6363095238095238,43.69212962962962,1025.2314814814802,29.292328042328005,0
3352,4,0,0,44,0.0,0.0,1.0,44,1250,900,350,0.72,16,9,7,342.16731430562305,0.4549528717406624,0.2585442031735612,0.2015035818399159,131535.8170037079,201.45144783091706,131737.2684515388,1117,2,137.75,35,9,24,34.77248580239948,0.6377976190476191,43.547453703703695,1025.8101851851843,29.30886243386241,0
3353,4,0,0,44,0.0,0.0,1.0,44,1350,1000,350,0.7407407407407407,17,10,7,344.3686955376572,0.4536645525017618,0.2621813793928762,0.20384837847540796,131732.43344696047,272.90525322620283,132005.33870018666,1118,3,138.75,36,8,19,34.51783494222613,0.6377314814814814,43.35585585585586,1026.5765765765766,28.516016016016017,0
3354,4,0,1,43,0.0,0.022727272727272728,0.9772727272727273,44,1150,700,450,0.6086956521739131,16,7,9,342.91181383421474,0.45323511275546163,0.26174371193013557,0.2034491106281201,131819.1518165125,240.46888949760927,132059.6207060101,1119,4,139.75,36,8,19,34.4678692839127,0.638599537037037,43.2713963963964,1026.9144144144148,28.52540040040041,0
3355,4,0,1,42,0.0,0.023255813953488372,0.9767441860465116,43,1550,1200,350,0.7741935483870968,19,12,7,349.72082664908265,0.4510889627168697,0.2628389288485333,0.2074012816865412,131803.09070644696,618.857167352512,132421.94787379948,1120,6,143.90697674418604,35,8,20,34.30925007514277,0.6404761904761904,43.287037037037024,1026.85185185185,29.33862433862428,0
3356,4,0,2,40,0.0,0.047619047619047616,0.9523809523809523,42,1400,1000,400,0.7142857142857143,18,10,8,353.85377415774093,0.4501669570267131,0.26360674738045664,0.21026060417542367,131876.97991488103,933.0334134810411,132810.01332836208,1121,7,146.02380952380952,36,6,21,34.12865913825239,0.6391782407407407,43.21509009009009,1027.139639639639,28.531656656656637,0
3357,4,0,0,40,0.0,0.0,1.0,40,1350,1100,250,0.8148148148148148,16,11,5,365.3439295645063,0.447008547008547,0.2661157504059386,0.216049064520245,131694.4515306122,1622.7536848072486,133317.20521541944,1122,8,153.85,34,6,21,34.01787095028222,0.6415441176470589,43.39285714285714,1026.4285714285709,30.189075630252084,0
3358,4,0,0,40,0.0,0.0,1.0,40,1200,800,400,0.6666666666666666,16,8,8,362.8486436891329,0.44588675213675216,0.2629310344827591,0.21552335101053302,131862.52170138882,1569.2274305555516,133431.74913194438,1123,9,154.85,35,5,21,33.91227180527384,0.6410714285714285,43.229166666666664,1027.0833333333328,29.34523809523808,0
3359,4,0,1,39,0.0,0.025,0.975,40,1400,1200,200,0.8571428571428571,16,12,4,363.30532160287885,0.4460470085470085,0.25728204550574474,0.21647145269733953,131981.42387902955,1589.910729595346,133571.3346086249,1124,10,155.85,35,5,21,33.78059998498161,0.6422619047619047,43.11342592592593,1027.5462962962968,29.35846560846562,0
3360,4,1,0,40,0.025,0.0,1.0,40,1500,800,700,0.5333333333333333,22,8,14,359.3218565376461,0.44505876068376066,0.24685355977955226,0.2162986206145032,132368.2260186257,1512.5593439214692,133880.78536254715,1125,0,155.05,35,5,22,33.49325628913132,0.6461309523809524,42.73726851851852,1029.050925925926,29.401455026455032,0
3361,4,0,1,39,0.0,0.025,0.975,40,1250,900,350,0.72,16,9,7,360.0972119198279,0.444417735042735,0.2469371353732588,0.2171181969070088,132429.53619100817,1537.5080496031214,133967.04424061129,1126,1,156.05,33,7,22,33.41159165773702,0.651199494949495,42.67769607843137,1029.2892156862738,31.19058229352345,0
3362,4,0,1,38,0.0,0.02564102564102564,0.9743589743589743,39,1250,1000,250,0.8,15,10,5,365.5938902751549,0.4450629779577148,0.23790921214866279,0.22043797289371764,132430.49178655236,1883.155736659522,134313.64752321187,1127,2,157.97435897435898,32,7,23,33.26918752044487,0.6536458333333333,42.676767676767675,1029.292929292929,32.165404040404034,0
3363,4,0,1,37,0.0,0.02631578947368421,0.9736842105263158,38,1150,1000,150,0.8695652173913043,13,10,3,368.6108383677707,0.4436936936936937,0.23207557218368513,0.2224608616897399,132465.01498752163,2165.6080457899266,134630.62303331157,1128,3,157.52631578947367,31,7,23,33.156779661016955,0.6565860215053764,42.643229166666664,1029.4270833333328,33.207325268817186,0
3364,4,0,1,36,0.0,0.02702702702702703,0.972972972972973,37,1000,800,200,0.8,12,8,4,369.87036677052595,0.44347472472472477,0.21236428284196474,0.22385045420187788,132570.97099375672,2406.814732917128,134977.78572667384,1129,4,152.02702702702703,30,7,24,33.01765204907335,0.6604166666666667,42.540322580645174,1029.838709677421,34.32795698924737,0
3365,4,0,0,36,0.0,0.0,1.0,36,1150,900,250,0.782608695652174,14,9,5,368.8690768498976,0.442526455026455,0.19911815428314728,0.22427590897765007,132744.05142574297,2593.0351413458407,135337.08656708882,1130,5,148.11111111111111,30,6,18,32.86922307725751,0.6621527777777778,42.372311827957,1030.510752688173,34.350358422939095,0
3366,4,1,1,36,0.02702702702702703,0.02702702702702703,0.972972972972973,37,1100,700,400,0.6363636363636364,15,7,8,360.25929206181775,0.44325575575575576,0.19562452041947354,0.22115064985204555,133102.46997409407,2190.280320909308,135292.75029500338,1131,0,145.0810810810811,31,6,19,32.7309411146162,0.6629704301075269,42.02473958333334,1031.9010416666677,33.287130376344116,0
3367,4,0,0,36,0.0,0.0,1.0,36,600,200,400,0.3333333333333333,10,2,8,370.6175766631095,0.4427910052910053,0.19986167238807062,0.2261740199349813,132882.5970668575,2649.7252211238383,135532.32228798134,1132,1,149.13888888888889,30,6,19,32.684786859601104,0.6635416666666667,42.237903225806456,1031.0483870967748,34.36827956989249,0
3368,4,0,1,35,0.0,0.027777777777777776,0.9722222222222222,36,1200,700,500,0.5833333333333334,17,7,10,370.1950971116889,0.4426256613756614,0.20192806744378533,0.22643361885881785,132968.14176771394,2644.8308308919522,135612.9725986059,1133,2,150.13888888888889,31,5,19,32.60965050709086,0.6616263440860215,42.15494791666668,1031.3802083333348,33.270329301075314,0
3369,4,1,1,35,0.027777777777777776,0.027777777777777776,0.9722222222222222,36,950,600,350,0.631578947368421,13,6,7,365.8557405906337,0.4427248677248677,0.20024959335913373,0.22438396969351249,133068.88156467024,2536.8028428819553,135605.6844075522,1134,0,150.88888888888889,31,5,20,32.620309607942104,0.6626344086021505,42.05729166666667,1031.7708333333342,33.28293010752691,0
3370,4,0,0,35,0.0,0.0,1.0,35,1200,900,300,0.75,15,9,6,363.65337250890747,0.4406862745098039,0.17866047048048728,0.2237437806166929,133187.44781153876,2686.8129145040284,135874.2607260428,1135,1,153.4,33,2,21,32.55805037793345,0.6587752525252526,41.94240196078431,1032.230392156862,31.279708853238244,0
3371,4,1,0,36,0.027777777777777776,0.0,1.0,36,1100,700,400,0.6363636363636364,15,7,8,352.800920767064,0.4403604497354497,0.17681528914186329,0.2189234852706878,133503.88259623686,2220.362660995752,135724.2452572326,1136,0,150.11111111111111,33,3,22,32.520924740108306,0.6619318181818181,41.636029411764696,1033.4558823529399,31.316844919786057,0
3372,4,0,0,36,0.0,0.0,1.0,36,750,600,150,0.8,9,6,3,355.2143209986085,0.43973214285714285,0.17551986619783233,0.22117662186459483,133630.56163795167,2293.497843377538,135924.0594813292,1137,1,151.11111111111111,33,3,23,32.331669037177505,0.6631944444444444,41.51348039215686,1033.946078431372,31.33169934640521,0
3373,4,0,3,33,0.0,0.08333333333333333,0.9166666666666666,36,1150,800,350,0.6956521739130435,15,8,7,352.3527933791494,0.4383763227513227,0.08649396094367323,0.20685840931384267,131417.1157648535,2061.037567515442,133478.15333236894,1138,2,152.11111111111111,35,1,18,34.63109549610565,0.6366071428571429,43.66319444444445,1025.347222222223,29.295634920634946,8
3374,4,2,1,34,0.05714285714285714,0.02857142857142857,0.9714285714285714,35,850,600,250,0.7058823529411765,11,6,5,359.1510058623712,0.4398109243697479,0.11680477295326486,0.21204668976257848,131633.36167800485,2455.2508503401727,134088.61252834502,1139,0,155.54285714285714,34,1,17,34.23844740912607,0.6409313725490196,43.45238095238097,1026.1904761904786,30.182072829131727,0
3375,4,0,0,34,0.0,0.0,1.0,34,1000,800,200,0.8,12,8,4,366.5233165222779,0.43943107546048726,0.10376324442820661,0.2160938877411629,131579.47063629385,2845.3887927720316,134424.85942906587,1140,1,154.02941176470588,33,1,18,34.103758560280305,0.6426767676767677,43.50490196078432,1025.9803921568637,31.090314913844352,0
3376,4,0,0,34,0.0,0.0,1.0,34,1100,900,200,0.8181818181818182,13,9,4,370.4748895882264,0.43842840166369573,0.11019757628522919,0.21950768210538607,131768.1375552671,2963.3572424067524,134731.49479767386,1141,2,155.02941176470588,33,1,18,33.81176891859632,0.6445707070707071,43.32107843137254,1026.715686274509,31.112596553773,0
3377,4,0,1,33,0.0,0.029411764705882353,0.9705882352941176,34,1150,900,250,0.782608695652174,14,9,5,370.33684565663725,0.4378527926322044,0.10589428469156448,0.21997116254062907,131862.52170138885,2966.7100694444403,134829.23177083328,1142,3,156.02941176470588,33,1,18,33.71999661933739,0.6455176767676767,43.229166666666664,1027.083333333333,31.123737373737363,0
3378,4,0,0,33,0.0,0.0,1.0,33,750,400,350,0.5333333333333333,11,4,7,371.29171784737485,0.4367897727272727,0.08185396852938331,0.22090407882998872,131925.46323829758,3196.566374711629,135122.02961300922,1143,4,143.27272727272728,33,0,19,33.631928704918685,0.6461489898989898,43.167892156862735,1027.3284313725476,31.131164587046896,0
3379,4,0,0,33,0.0,0.0,1.0,33,1200,900,300,0.75,15,9,6,371.66130802197296,0.4364346590909091,0.08477332350454247,0.2216750874162348,132019.90370290255,3213.338019031118,135233.24172193368,1144,5,144.27272727272728,33,0,19,33.52710867318546,0.6470959595959596,43.07598039215685,1027.696078431371,31.142305407011243,0
3380,4,0,0,33,0.0,0.0,1.0,33,1450,1100,350,0.7586206896551724,18,11,7,368.51906714007,0.4356455176767677,0.07636421411445271,0.22090085795996187,132208.88600538252,3144.2990676662816,135353.1850730488,1145,6,145.27272727272728,33,0,20,33.41724261201145,0.648989898989899,42.8921568627451,1028.4313725490194,31.16458704693998,0
3381,4,0,0,33,0.0,0.0,1.0,33,1100,700,400,0.6363636363636364,15,7,8,373.5583046560364,0.43501420454545453,0.07435555988610676,0.2248579988671497,132366.47450800176,3289.319162101122,135655.7936701029,1146,7,146.27272727272728,33,0,20,33.12877118812276,0.6505681818181819,42.7389705882353,1029.044117647059,31.183155080213908,0
3382,4,0,0,33,0.0,0.0,1.0,33,800,600,200,0.75,10,6,4,371.89593934077396,0.4351720328282828,0.07212979900204619,0.2242321604108512,132429.53619100814,3250.0013516435884,135679.53754265173,1147,8,147.27272727272728,33,0,20,33.107984085407004,0.651199494949495,42.67769607843137,1029.2892156862736,31.19058229352344,0
3383,4,0,1,32,0.0,0.030303030303030304,0.9696969696969697,33,950,700,250,0.7368421052631579,12,7,5,372.64728090089216,0.4343434343434343,0.07037053062755061,0.2256288003379754,132587.2561034218,3281.65609381007,135868.91219723187,1148,9,148.27272727272728,33,0,20,32.929755671902264,0.6527777777777778,42.52450980392157,1029.9019607843138,31.20915032679739,0
3384,4,0,1,31,0.0,0.03125,0.96875,32,850,600,250,0.7058823529411765,11,6,5,377.60391858730736,0.43350974462365593,0.07812116940426583,0.2288627613547737,132625.50536935008,3615.982106417712,136241.4874757678,1149,10,152.75,32,0,18,32.763596061126094,0.6555989583333333,42.48737373737374,1030.050505050505,32.189078282828284,0
3385,4,0,0,31,0.0,0.0,1.0,31,950,600,350,0.631578947368421,13,6,7,384.64566244871537,0.43194444444444446,0.06862585211520233,0.23338316574342285,132666.15125868045,4005.8919270833144,136672.04318576376,1150,11,154.0,31,0,18,32.54128749578698,0.6586021505376345,42.44791666666666,1030.2083333333323,33.232526881720396,0
3386,4,0,0,31,0.0,0.0,1.0,31,1100,600,500,0.5454545454545454,16,6,10,382.5692765446998,0.43163082437275985,0.0693735839214984,0.23295526100983383,132800.32687716995,3961.064995659698,136761.39187282964,1151,12,155.0,31,0,18,32.45957554320363,0.6599462365591398,42.31770833333332,1030.7291666666652,33.2493279569892,0
3387,4,0,0,31,0.0,0.0,1.0,31,1000,600,400,0.6,14,6,8,381.946032179501,0.4306451612903226,0.06906915467662533,0.23362119852461985,132968.1417677137,3957.3308308919227,136925.47259860564,1152,13,156.0,31,0,19,32.30665846063207,0.6616263440860215,42.154947916666664,1031.380208333333,33.27032930107526,0
3388,4,0,1,30,0.0,0.03225806451612903,0.967741935483871,31,900,800,100,0.8888888888888888,10,8,2,382.81646362299506,0.4299283154121864,0.06878246568204394,0.23478619642017115,133068.8815646701,3988.1917317708285,137057.07329644094,1153,14,157.0,31,0,19,32.18282012451623,0.6626344086021505,42.057291666666664,1031.770833333333,33.28293010752687,0
3389,4,0,0,30,0.0,0.0,1.0,30,850,600,250,0.7058823529411765,11,6,5,389.80776453861586,0.4277538314176245,0.07041476655808876,0.23876892201387673,133021.2149706613,4370.540488784826,137391.7554594461,1154,15,161.33333333333334,30,0,19,32.05048859934855,0.6649305555555556,42.10349462365591,1031.586021505376,34.38620071684587,0
3390,4,0,1,29,0.0,0.03333333333333333,0.9666666666666667,30,950,600,350,0.631578947368421,13,6,7,389.38123914930554,0.42701149425287355,0.06888888888888856,0.2396192240918804,133194.58896982315,4372.694820210434,137567.28379003357,1155,16,162.33333333333334,30,0,19,31.88693576388889,0.6666666666666667,41.935483870967744,1032.2580645161295,34.40860215053765,0
3391,4,0,0,29,0.0,0.0,1.0,29,700,400,300,0.5714285714285714,10,4,6,401.7200477538851,0.42420977011494254,0.08134346721886132,0.24596659477890376,133006.19454089497,4886.250964506163,137892.44550540112,1156,17,168.3793103448276,29,0,19,31.758420851846875,0.6677442528735632,42.11805555555555,1031.527777777777,35.56992337164748,0
3392,4,0,0,29,0.0,0.0,1.0,29,1200,1000,200,0.8333333333333334,14,10,4,398.56721289237964,0.4236966338259442,0.026359820902776887,0.23301338325831833,131256.95408950615,4662.943672839503,135919.89776234564,1157,18,169.3793103448276,29,0,20,33.608927441944516,0.6501436781609196,43.81944444444444,1024.7222222222222,35.33524904214559,8
3393,4,1,0,30,0.03333333333333333,0.0,1.0,30,450,400,50,0.8888888888888888,5,4,1,386.326784168172,0.42337164750957856,0.021121593291404173,0.22750355067681233,131534.85952133193,4163.087856977682,135697.94737830962,1158,0,164.7,30,0,21,33.640974406009796,0.65,43.54838709677419,1025.8064516129032,34.193548387096776,0
3394,4,0,1,29,0.0,0.03333333333333333,0.9666666666666667,30,650,400,250,0.6153846153846154,9,4,5,403.1177702541711,0.4234913793103448,0.04279917074676898,0.2221999263173431,128962.36423647254,4397.4041435426225,133359.76838001516,1159,1,165.7,30,0,19,35.83212032993694,0.6239583333333334,46.06854838709678,1015.7258064516137,33.85752688172046,8
3395,4,0,0,29,0.0,0.0,1.0,29,700,400,300,0.5714285714285714,10,4,6,410.3847157515716,0.423747947454844,0.060269372972157065,0.22595881337164855,128919.13580246917,4781.28858024692,133700.4243827161,1160,21,172.3793103448276,29,0,20,35.691899161196204,0.6264367816091954,46.111111111111114,1015.5555555555559,35.01915708812262,0
3396,4,0,0,29,0.0,0.0,1.0,29,550,300,250,0.5454545454545454,8,3,5,408.79997518323177,0.4232861247947455,0.058280718795532094,0.22528667810964387,128954.40055941361,4743.311149691366,133697.71170910497,1161,22,173.3793103448276,29,0,20,35.695992296823015,0.6267959770114943,46.07638888888889,1015.6944444444447,35.02394636015327,0
3397,4,0,0,29,0.0,0.0,1.0,29,1000,500,500,0.5,15,5,10,411.3169271279857,0.42410714285714285,0.059396139250948554,0.22707798656160136,129024.94454089513,4814.028742283961,133838.9732831791,1162,23,174.3793103448276,29,0,20,35.55978013214855,0.6275143678160919,46.00694444444445,1015.9722222222229,35.03352490421458,0
3398,4,1,0,30,0.03333333333333333,0.0,1.0,30,500,100,400,0.2,9,1,8,398.4127420897604,0.4274425287356322,0.05079281183932327,0.22170497295112554,129338.07376575332,4305.987325124299,133644.06109087763,1163,0,169.53333333333333,30,0,21,35.56724585976039,0.6277777777777778,45.6989247311828,1017.2043010752692,33.906810035842305,0
3399,4,0,0,30,0.0,0.0,1.0,30,600,500,100,0.8333333333333334,7,5,2,398.5455976906926,0.427514367816092,0.05172808523752925,0.2223573117255883,129440.63484579144,4317.599036015731,133758.2338818072,1164,1,170.53333333333333,30,0,17,35.45904327917934,0.6288194444444444,45.598118279569896,1017.6075268817206,33.920250896057354,0
3400,4,0,2,28,0.0,0.06666666666666667,0.9333333333333333,30,750,500,250,0.6666666666666666,10,5,5,397.90791784298216,0.427418582375479,0.0481667326906996,0.22238794552213315,129509.0314812406,4306.533811712337,133815.56529295293,1165,2,171.53333333333333,30,0,17,35.40538756107223,0.6295138888888889,45.530913978494624,1017.8763440860215,33.92921146953405,0
3401,4,0,0,28,0.0,0.0,1.0,28,850,600,250,0.7058823529411765,11,6,5,413.61344162064717,0.42055224867724866,0.059238001089434444,0.23043247679904041,129384.04439572601,5102.995978662971,134487.04037438898,1166,27,181.60714285714286,28,0,21,35.13363225533117,0.6343005952380952,45.65373563218391,1017.3850574712645,36.335180623973734,0
3402,4,0,0,28,0.0,0.0,1.0,28,700,300,400,0.42857142857142855,11,3,8,415.4629403199357,0.42041446208112876,0.060821166411228145,0.2321087909484564,129493.69963007013,5159.966640243109,134653.66627031323,1167,28,182.60714285714286,28,0,19,34.97435535479013,0.6354166666666667,45.54597701149426,1017.8160919540238,36.350574712643706,0
3403,4,1,0,29,0.034482758620689655,0.0,1.0,29,200,100,100,0.5,3,1,2,401.6715544739184,0.42395320197044334,0.05583415188957219,0.2261753027762963,129802.20148533964,4627.570408950635,134429.7718942903,1168,0,177.27586206896552,29,0,20,35.01019376675299,0.6354166666666667,45.243055555555564,1019.0277777777789,35.13888888888893,0
3404,4,1,0,30,0.03333333333333333,0.0,1.0,30,650,400,250,0.6153846153846154,9,4,5,390.9993160123073,0.42696360153256707,0.04927116262732678,0.22219062927885008,130159.70054341541,4178.470776968431,134338.17132038384,1169,0,172.33333333333334,30,0,21,34.91778626624516,0.6361111111111111,44.89247311827957,1020.4301075268816,34.014336917562716,0
3405,4,0,0,30,0.0,0.0,1.0,30,600,500,100,0.8333333333333334,7,5,2,391.6701374427322,0.4267480842911877,0.045034013605442125,0.22316089226388244,130262.58680555562,4203.993055555566,134466.57986111118,1170,1,173.33333333333334,30,0,21,34.795918367346935,0.6371527777777778,44.79166666666667,1020.8333333333339,34.0277777777778,0
3406,4,1,1,30,0.03225806451612903,0.03225806451612903,0.967741935483871,31,1050,1000,50,0.9523809523809523,11,10,1,379.49697394708636,0.4306451612903226,0.05073877663354476,0.2186492836688532,130694.93823581275,3719.6667141384596,134414.6049499512,1171,0,168.70967741935485,31,0,17,34.66735111846853,0.6387768817204301,44.368489583333336,1022.526041666667,32.98471102150538,0
3407,4,0,0,30,0.0,0.0,1.0,30,750,500,250,0.6666666666666666,10,5,5,385.333427871044,0.4277777777777778,0.06926919032597278,0.2220921757002198,130708.89698231005,4073.3014654873336,134782.1984477974,1172,1,174.26666666666668,30,0,18,34.50397607781283,0.6416666666666666,44.354838709677416,1022.5806451612899,34.08602150537633,0
3408,4,0,0,30,0.0,0.0,1.0,30,800,700,100,0.875,9,7,2,385.333427871044,0.4277777777777778,0.06926919032597278,0.2220921757002198,130708.89698231005,4073.3014654873336,134782.1984477974,1173,2,175.26666666666668,30,0,18,34.50397607781283,0.6416666666666666,44.354838709677416,1022.5806451612899,34.08602150537633,0
3409,4,0,0,30,0.0,0.0,1.0,30,700,500,200,0.7142857142857143,9,5,4,383.89006787873353,0.4276819923371647,0.07522558037669724,0.22165428046715946,130777.62783269743,4040.846485142795,134818.4743178402,1174,3,176.26666666666668,30,0,18,34.47109067017083,0.6423611111111112,44.28763440860215,1022.8494623655914,34.09498207885305,0
3410,4,0,1,29,0.0,0.03333333333333333,0.9666666666666667,30,900,700,200,0.7777777777777778,11,7,4,381.6449525515725,0.42765804597701146,0.06718770524103501,0.22094775846198642,130880.75798141405,3989.996133946123,134870.75411536018,1175,4,177.26666666666668,30,0,18,34.42384736634705,0.6434027777777778,44.18682795698925,1023.2526881720431,34.108422939068106,0
3411,4,0,0,29,0.0,0.0,1.0,29,950,700,250,0.7368421052631579,12,7,5,393.9301580482703,0.42431239737274223,0.07698214988106145,0.22734339215262245,130759.29783950612,4502.006172839494,135261.30401234562,1176,5,184.13793103448276,29,0,19,34.23298026434908,0.6451149425287357,44.30555555555555,1022.7777777777774,35.26819923371646,0
3412,4,1,0,30,0.03333333333333333,0.0,1.0,30,750,400,350,0.5333333333333333,11,4,7,382.9369897700458,0.42624521072796934,0.08703752295985279,0.22348742236043564,131190.39231414034,4047.5307839056504,135237.92309804598,1177,0,178.96666666666667,30,0,21,34.07679524184378,0.6465277777777778,43.884408602150536,1024.4623655913977,34.14874551971325,0
3413,4,0,0,30,0.0,0.0,1.0,30,900,700,200,0.7777777777777778,11,7,4,384.93101854340233,0.4258860153256705,0.08144699453551918,0.2252570235144621,131293.68505390786,4107.802383223476,135401.48743713135,1178,1,179.96666666666667,30,0,21,33.92103825136611,0.6475694444444444,43.783602150537625,1024.8655913978484,34.16218637992828,0
3414,4,0,0,30,0.0,0.0,1.0,30,1300,1000,300,0.7692307692307693,16,10,6,381.2663976261427,0.4247365900383142,0.08086249836151538,0.22391696285526097,131431.47193678448,4022.080768007847,135453.55270479232,1179,2,180.96666666666667,30,0,21,33.875398697950814,0.6489583333333333,43.64919354838709,1025.4032258064506,34.180107526881685,0
3415,4,0,0,30,0.0,0.0,1.0,30,650,500,150,0.7692307692307693,8,5,3,379.0408877321246,0.42516762452107276,0.07488315205521334,0.22301164335264778,131500.3924767314,3968.8051003006067,135469.197577032,1180,3,181.96666666666667,30,0,21,33.86269820469139,0.6496527777777779,43.581989247311824,1025.6720430107523,34.18906810035841,0
3416,4,0,1,29,0.0,0.03333333333333333,0.9666666666666667,30,700,500,200,0.7142857142857143,9,5,4,379.08742029318944,0.4247126436781609,0.07715483363898357,0.2236440005037255,131603.8071597872,3977.8695513932166,135581.6767111804,1181,4,182.96666666666667,30,0,19,33.75687712863505,0.6506944444444445,43.48118279569892,1026.0752688172038,34.20250896057346,0
3417,4,1,0,30,0.03333333333333333,0.0,1.0,30,700,500,200,0.7142857142857143,9,5,4,371.48799787617025,0.42365900383141764,0.08870278286661404,0.2207551539478766,131879.77837033186,3798.350965429528,135678.1293357614,1182,0,181.2,30,0,20,33.67301317281688,0.6534722222222222,43.21236559139785,1027.1505376344087,34.23835125448029,0
3418,4,1,0,31,0.03225806451612903,0.0,1.0,31,950,600,350,0.631578947368421,13,6,7,361.39942849642364,0.4236111111111111,0.08073088887255975,0.21733472480812335,132331.0089111328,3364.8701985677094,135695.87910970053,1183,0,176.32258064516128,31,0,21,33.47728423184004,0.655241935483871,42.7734375,1028.90625,33.190524193548384,0
3419,4,1,1,31,0.03125,0.03125,0.96875,32,850,500,350,0.5882352941176471,12,5,7,351.90051049728714,0.42605426747311825,0.06861521259649539,0.21383917097307242,132723.06596584545,2941.0629336292372,135664.1288994747,1184,0,171.78125,32,0,17,33.32746191234733,0.6565755208333333,42.392676767676775,1030.429292929294,32.20091540404044,0
3420,4,0,0,31,0.0,0.0,1.0,31,700,400,300,0.5714285714285714,10,4,6,362.6412285673184,0.42240143369175626,0.07594162476910471,0.21983561373149857,132632.61795043945,3419.611104329428,136052.2290547689,1185,2,178.32258064516128,31,0,18,33.141748830742,0.658266129032258,42.48046875,1030.078125,33.228326612903224,0
3421,4,0,0,31,0.0,0.0,1.0,31,700,400,300,0.5714285714285714,10,4,6,360.9986720085915,0.4221774193548387,0.08189212538101698,0.21982042212461606,132800.32687717007,3388.1483289930466,136188.4752061631,1186,3,179.32258064516128,31,0,20,33.01541182415361,0.6599462365591398,42.31770833333333,1030.729166666666,33.24932795698923,0
3422,4,0,0,31,0.0,0.0,1.0,31,900,700,200,0.7777777777777778,11,7,4,359.1062136516681,0.4206989247311828,0.08523949169110501,0.219453797231575,132934.5703125,3347.526041666668,136282.09635416666,1187,4,180.32258064516128,31,0,20,32.92929292929292,0.6612903225806452,42.1875,1031.25,33.266129032258064,0
3423,4,0,0,31,0.0,0.0,1.0,31,1000,700,300,0.7,13,7,6,362.26789533378815,0.4201164874551971,0.09431535067007579,0.2221834986551808,133068.8815646701,3441.316731770829,136510.19829644094,1188,5,181.32258064516128,31,0,20,32.71285546020528,0.6626344086021505,42.057291666666664,1031.770833333333,33.28293010752687,0
3424,4,0,1,30,0.0,0.03225806451612903,0.967741935483871,31,800,600,200,0.75,10,6,4,363.19406104150704,0.4197132616487455,0.0948244632135955,0.22295220245963926,133102.4699740939,3468.4053209092795,136570.87529500318,1189,6,182.32258064516128,31,0,20,32.65523133543638,0.6629704301075269,42.02473958333333,1031.901041666666,33.28713037634407,0
3425,4,0,0,30,0.0,0.0,1.0,30,950,700,250,0.7368421052631579,12,7,5,375.1249562329573,0.417073754789272,0.10865146579804508,0.22977526249704294,133021.21497066144,3979.915488784843,137001.13045944629,1190,7,189.16666666666666,30,0,21,32.42915309446253,0.6649305555555556,42.10349462365592,1031.5860215053772,34.386200716845906,0
3426,4,0,0,30,0.0,0.0,1.0,30,800,600,200,0.75,10,6,4,377.3275429407697,0.41609195402298854,0.10044783983140171,0.21442146003041346,130159.70054341538,3822.5679991906545,133982.26854260603,1191,8,190.16666666666666,30,0,20,35.26656348788199,0.6361111111111111,44.89247311827957,1020.4301075268813,34.01433691756271,8
3427,4,0,0,30,0.0,0.0,1.0,30,250,100,150,0.4,4,1,3,378.12159990081466,0.4160201149425287,0.101659423152904,0.21506197064021618,130193.99144771072,3845.832068736272,134039.82351644698,1192,9,191.16666666666666,30,0,20,35.21143377672417,0.6364583333333333,44.858870967741936,1020.5645161290323,34.01881720430108,0
3428,4,0,0,30,0.0,0.0,1.0,30,900,700,200,0.7777777777777778,11,7,4,377.51941633847457,0.4163074712643678,0.09181255758852158,0.21547821231580697,130331.20022907264,3840.511728234468,134171.7119573071,1193,10,192.16666666666666,30,0,22,35.08731516826817,0.6378472222222222,44.72446236559139,1021.1021505376337,34.036738351254456,0
3429,4,0,0,30,0.0,0.0,1.0,30,1000,800,200,0.8,12,8,4,375.70429362880895,0.41704980842911876,0.08810526315789469,0.21501149334178818,130434.154237484,3800.9343565730023,134235.08859405702,1194,11,193.16666666666666,30,0,23,35.029057017543856,0.6388888888888888,44.62365591397849,1021.5053763440852,34.050179211469505,0
3430,4,0,0,30,0.0,0.0,1.0,30,1050,800,250,0.7619047619047619,13,8,5,377.12231525753634,0.4164750957854406,0.09023321059091716,0.21658897924609571,130571.48947855247,3848.284483755353,134419.7739623078,1195,12,194.16666666666666,30,0,17,34.85336664913203,0.6402777777777777,44.48924731182796,1022.0430107526885,34.068100358422946,0
3431,4,0,0,30,0.0,0.0,1.0,30,500,200,300,0.4,8,2,6,364.0701460044934,0.4168103448275862,0.02562208739998284,0.20508022637489362,129817.03990345699,3452.50173430454,133269.54163776152,1196,13,195.16666666666666,30,0,21,35.95302470764091,0.6326388888888889,45.22849462365591,1019.0860215053758,33.96953405017919,8
3432,4,0,0,30,0.0,0.0,1.0,30,700,300,400,0.42857142857142855,11,3,8,366.1721560759388,0.41659482758620686,0.017841922586880887,0.2071698842765212,129988.31376821025,3519.620223436241,133507.93399164648,1197,14,196.16666666666666,30,0,21,35.725308641975296,0.634375,45.060483870967744,1019.7580645161295,33.99193548387098,0
3433,4,0,0,30,0.0,0.0,1.0,30,800,600,200,0.75,10,6,4,364.69489533589865,0.4169061302681993,0.01851559068950359,0.20687849443942244,130091.13228407915,3488.7143744941654,133579.8466585733,1198,15,197.16666666666666,30,0,21,35.65848704435661,0.6354166666666667,44.95967741935484,1020.1612903225812,34.00537634408604,0
3434,4,0,0,30,0.0,0.0,1.0,30,600,400,200,0.6666666666666666,8,4,4,363.98922774902553,0.4165708812260536,0.02096066034422228,0.20684178271486545,130159.70054341537,3475.3457769684323,133635.04632038382,1199,16,198.16666666666666,30,0,22,35.60683394801548,0.6361111111111111,44.89247311827957,1020.4301075268812,34.01433691756271,0
3435,4,0,1,29,0.0,0.03333333333333333,0.9666666666666667,30,1100,800,300,0.7272727272727273,14,8,6,365.1117200621932,0.4167145593869732,0.018228892399508645,0.20821235927870999,130296.89125910508,3514.5844172736747,133811.47567637876,1200,17,199.16666666666666,30,0,23,35.438882306477105,0.6375,44.75806451612903,1020.9677419354837,34.03225806451612,0
3436,4,0,0,29,0.0,0.0,1.0,29,800,600,200,0.75,10,6,4,370.32487093836426,0.41723111658456485,0.03010734534813375,0.21157721647317723,130368.94531249991,3855.7725694444316,134224.71788194435,1201,18,203.3793103448276,29,0,24,35.23264313885488,0.6411637931034483,44.68749999999999,1021.2499999999993,35.21551724137929,0
3437,4,0,0,29,0.0,0.0,1.0,29,1100,800,300,0.7272727272727273,14,8,6,371.1987950043779,0.416564039408867,0.03572031276368359,0.21265874891372297,130475.34722222213,3886.4583333333244,134361.80555555545,1202,19,204.3793103448276,29,0,24,35.10229744426319,0.6422413793103448,44.58333333333333,1021.6666666666658,35.229885057471236,0
3438,4,0,0,29,0.0,0.0,1.0,29,950,700,250,0.7368421052631579,12,7,5,370.30623333841345,0.4163074712643678,0.02558443566639057,0.21273095793422192,130581.79253472216,3871.0503472222176,134452.84288194438,1203,20,205.3793103448276,29,0,19,35.017070933550755,0.6433189655172413,44.479166666666664,1022.0833333333328,35.2442528735632,0
3439,4,0,0,29,0.0,0.0,1.0,29,800,400,400,0.5,12,4,8,370.9725950147755,0.41610221674876846,0.028665373914509518,0.21370111459301858,130688.28125000001,3896.354166666668,134584.6354166667,1204,21,206.3793103448276,29,0,19,34.8920130399348,0.6443965517241379,44.375,1022.5000000000001,35.258620689655174,0
3440,4,0,0,29,0.0,0.0,1.0,29,650,400,250,0.6153846153846154,9,4,5,370.2075236123957,0.41589696223316913,0.028091860383453904,0.2138492871690427,130794.81336805549,3884.2447916666574,134679.05815972216,1205,22,207.3793103448276,29,0,20,34.80354718262049,0.6454741379310345,44.27083333333333,1022.9166666666661,35.27298850574711,0
3441,4,0,0,29,0.0,0.0,1.0,29,950,800,150,0.8421052631578947,11,8,3,370.9986312852125,0.4150759441707717,0.028922834999438374,0.21489920717841537,130901.38888888876,3912.8472222222044,134814.23611111095,1206,23,208.3793103448276,29,0,20,34.67528501628663,0.646551724137931,44.16666666666666,1023.3333333333322,35.28735632183904,0
3442,4,0,0,29,0.0,0.0,1.0,29,1000,800,200,0.8,12,8,4,369.8784475208378,0.4141009852216749,0.022168489876856823,0.2152418148043517,131079.11120756168,3896.667631172829,134975.77883873452,1207,24,209.3793103448276,29,0,22,34.523910438989084,0.6483477011494253,43.99305555555555,1024.0277777777774,35.31130268199232,0
3443,4,0,0,29,0.0,0.0,1.0,29,900,700,200,0.7777777777777778,11,7,4,368.9584697449285,0.41374178981937604,0.020762604865183,0.21490519398887084,131114.67013888896,3875.173611111116,134989.8437500001,1208,25,210.3793103448276,29,0,22,34.51145918090587,0.6487068965517242,43.958333333333336,1024.1666666666672,35.31609195402301,0
3444,4,0,0,29,0.0,0.0,1.0,29,250,100,150,0.4,4,1,3,367.0857821109443,0.4135365353037767,0.016829979804024342,0.21421081715588017,131185.80246913576,3831.288580246908,135017.09104938267,1209,26,211.3793103448276,29,0,23,34.48741413593636,0.6494252873563218,43.888888888888886,1024.4444444444441,35.32567049808428,0
3445,4,0,0,29,0.0,0.0,1.0,29,600,500,100,0.8333333333333334,7,5,2,367.1756229757419,0.4129720853858785,0.016540510232688543,0.21506000774293452,131328.125,3844.0972222222217,135172.22222222222,1210,27,212.3793103448276,29,0,24,34.34112466124661,0.6508620689655172,43.75,1025.0,35.3448275862069,0
3446,4,0,0,29,0.0,0.0,1.0,29,450,300,150,0.6666666666666666,6,3,3,368.80368534297486,0.41276683087027916,0.016816300600715373,0.2164156442926741,131399.31520061725,3892.11033950616,135291.4255401234,1211,28,213.3793103448276,29,0,24,34.22739998193803,0.6515804597701149,43.68055555555555,1025.2777777777774,35.35440613026819,0
3447,4,0,0,29,0.0,0.0,1.0,29,850,600,250,0.7058823529411765,11,6,5,369.3418698536668,0.4117405582922824,0.014007891111992965,0.2173378254079146,131506.13667052463,3914.1444830246855,135420.28115354932,1212,29,214.3793103448276,29,0,24,34.10559128864815,0.6526580459770115,43.576388888888886,1025.6944444444441,35.36877394636014,0
3448,4,0,0,29,0.0,0.0,1.0,29,850,500,350,0.5882352941176471,12,5,7,369.93825233723203,0.4116379310344827,0.010084316087285439,0.21789186058714466,131541.75347222213,3932.4652777777737,135474.2187499999,1213,30,215.3793103448276,29,0,24,34.05429190360141,0.6530172413793103,43.541666666666664,1025.8333333333328,35.373563218390785,0
3449,4,0,0,29,0.0,0.0,1.0,29,650,500,150,0.7692307692307693,8,5,3,371.0959313292546,0.4111247947454844,0.006160969325840648,0.2189821677843873,131613.0015432097,3968.2098765431942,135581.21141975292,1214,31,216.3793103448276,29,0,18,33.952580761595385,0.6537356321839081,43.472222222222214,1026.11111111111,35.38314176245207,0
3450,4,0,0,29,0.0,0.0,1.0,29,650,400,250,0.6153846153846154,9,4,5,371.4268438646535,0.41014983579638753,0.016515893047928554,0.21979309871926767,131719.90981867278,3984.862075617272,135704.77189429005,1215,32,217.3793103448276,29,0,18,33.83605623957064,0.6548132183908046,43.36805555555555,1026.5277777777771,35.39750957854404,0
3451,4,0,0,29,0.0,0.0,1.0,29,950,800,150,0.8421052631578947,11,8,3,385.57632671776605,0.4097393267651888,0.013014141090264442,0.21248829519872076,128954.40055941363,4144.352816358033,133098.75337577166,1216,33,218.3793103448276,29,0,20,36.285695564975626,0.6267959770114943,46.07638888888889,1015.6944444444448,35.02394636015327,8
3452,4,0,0,29,0.0,0.0,1.0,29,650,300,350,0.46153846153846156,10,3,7,383.13084169421575,0.409688013136289,0.0056560019607470036,0.21170583367332946,129060.22376543209,4089.390432098764,133149.61419753084,1217,34,219.3793103448276,29,0,20,36.23963459085112,0.6278735632183908,45.97222222222222,1016.1111111111111,35.03831417624521,0
3453,4,0,0,29,0.0,0.0,1.0,29,700,300,400,0.42857142857142855,11,3,8,381.55682570450983,0.4088669950738916,0.0019790596639370772,0.2112127723529202,129130.79668209885,4054.147376543226,133184.94405864208,1218,35,220.3793103448276,29,0,20,36.207524824633325,0.6285919540229885,45.902777777777786,1016.3888888888896,35.047892720306535,0
3454,4,3,1,31,0.09375,0.03125,0.96875,32,550,300,250,0.5454545454545454,8,3,5,351.5304881147363,0.41901881720430106,0.009446954691755494,0.1991348725800027,130037.12153096622,2742.4025609631663,132779.5240919294,1219,0,200.625,32,0,21,36.0490426673269,0.6295572916666667,45.01262626262626,1019.9494949494949,31.873421717171716,0
3455,4,0,0,31,0.0,0.0,1.0,31,850,400,450,0.47058823529411764,13,4,9,372.3724159964794,0.41532258064516125,0.057488792610015826,0.1923135400607906,126338.1979200576,3208.971998426655,129547.16991848426,1220,1,208.09677419354838,31,0,18,39.30635604196344,0.5944220430107527,48.665364583333336,1005.3385416666674,32.43027553763444,8
3456,4,1,1,31,0.03125,0.03125,0.96875,32,450,200,250,0.4444444444444444,7,2,5,362.44958206708935,0.41889280913978494,0.051484884596086244,0.1886062707727701,126646.80262218145,2780.616136108568,129427.41875829002,1221,0,202.5625,32,0,20,39.23785331995318,0.5950520833333333,48.35858585858586,1006.5656565656569,31.45517676767678,0
3457,4,2,0,33,0.06060606060606061,0.0,1.0,33,1000,800,200,0.8,12,8,4,352.1889029153325,0.4244791666666667,0.060569253815944135,0.18598917496484493,127246.52364775569,2362.962712658597,129609.48636041429,1222,0,195.78787878787878,33,0,22,38.87999008057006,0.598800505050505,47.763480392156865,1008.9460784313726,30.574123588829472,0
3458,4,0,0,33,0.0,0.0,1.0,33,1000,800,200,0.8,12,8,4,353.10149637199504,0.42424242424242425,0.05128374923203127,0.18704160936438083,127370.19903702891,2394.9215746347413,129765.12061166366,1223,1,196.78787878787878,33,0,20,38.73009489700943,0.6000631313131313,47.64093137254901,1009.436274509803,30.588978015448575,0
3459,4,0,0,33,0.0,0.0,1.0,33,1050,500,550,0.47619047619047616,16,5,11,356.1348320323089,0.4242818813131313,0.05350275381821157,0.1893718248780833,127524.87775134569,2483.2101835832473,130008.08793492893,1224,2,197.78787878787878,33,0,21,38.49490414947829,0.6016414141414141,47.48774509803922,1010.0490196078435,30.607546048722533,0
3460,4,2,2,33,0.05714285714285714,0.05714285714285714,0.9428571428571428,35,1200,900,300,0.75,15,9,6,346.7334596484224,0.43214285714285716,0.0782353325066889,0.18833735562540882,128379.01341735259,1902.6598936899886,130281.67331104257,1225,0,187.42857142857142,35,0,17,37.85880158367592,0.605952380952381,46.64351851851852,1013.4259259259263,28.955026455026466,0
3461,4,1,0,34,0.029411764705882353,0.0,1.0,34,1000,600,400,0.6,14,6,8,358.9622232501485,0.4261177956030897,0.08527027307221857,0.1947181314265145,128325.3985969387,2412.7940759637154,130738.19267290241,1226,0,193.7941176470588,34,0,23,37.60378725570831,0.6075367647058824,46.69642857142857,1013.2142857142851,29.80042016806721,0
3462,4,1,1,34,0.02857142857142857,0.02857142857142857,0.9714285714285714,35,550,300,250,0.5454545454545454,8,3,5,356.3217151057034,0.4285014005602241,0.10418289364337108,0.19512007972090567,128701.77636584785,2171.8475383659115,130873.62390421376,1227,0,189.22857142857143,35,0,19,37.286248621725434,0.6092261904761904,46.32523148148148,1014.6990740740736,28.991402116402103,0
3463,4,2,0,36,0.05555555555555555,0.0,1.0,36,950,800,150,0.8421052631578947,11,8,3,350.0670296860069,0.43111772486772487,0.11503275216706088,0.19356647523814488,129086.9247626004,1837.815264588909,130924.74002718931,1228,0,184.88888888888889,36,0,22,37.05235113770685,0.6111111111111112,45.945945945945944,1016.2162162162159,28.228228228228218,0
3464,4,1,0,37,0.02702702702702703,0.0,1.0,37,950,600,350,0.631578947368421,13,6,7,341.9758753340026,0.4323385885885886,0.11615311228014535,0.190885483965002,129459.11864144556,1454.4298098774495,130913.548451323,1229,0,180.86486486486487,36,1,17,36.87940319427538,0.6148726851851851,45.57995495495496,1017.6801801801806,28.268893893893907,0
3465,4,0,0,37,0.0,0.0,1.0,37,700,400,300,0.5714285714285714,10,4,6,347.8368113523711,0.43205705705705705,0.11822418591581307,0.19472400070816034,129573.7476285408,1614.1038420177076,131187.85147055853,1230,1,181.86486486486487,36,1,17,36.61375953987392,0.6160300925925926,45.46734234234235,1018.1306306306315,28.28140640640643,0
3466,4,0,1,36,0.0,0.02702702702702703,0.972972972972973,37,900,700,200,0.7777777777777778,11,7,4,345.03800058328574,0.4306493993993994,0.11948759456771385,0.1942905331224737,129803.15778193738,1557.4044060952872,131360.56218803267,1231,2,182.86486486486487,36,1,18,36.45200206284304,0.6183449074074074,45.24211711711712,1019.0315315315318,28.306431431431438,0
3467,4,0,0,36,0.0,0.0,1.0,36,1450,800,650,0.5517241379310345,21,8,13,351.7509233539879,0.42810846560846566,0.11856353591160218,0.19821580674679892,129831.84831791249,1933.6945053161244,131765.5428232286,1232,3,188.86111111111111,36,0,20,36.251841620626145,0.6186342592592593,45.21396396396396,1019.1441441441441,28.30955955955956,0
3468,4,0,0,36,0.0,0.0,1.0,36,850,400,450,0.47058823529411764,13,4,9,349.067374938295,0.4275958994708995,0.12133566476470925,0.19742692567559406,129975.34855379029,1874.030745272301,131849.3792990626,1233,4,189.86111111111111,36,0,20,36.17453524756121,0.6200810185185186,45.0731981981982,1019.7072072072074,28.325200200200204,0
3469,4,0,0,36,0.0,0.0,1.0,36,1250,1100,150,0.88,14,11,3,349.3323733055313,0.4263888888888889,0.11863336521248691,0.19859786492438672,130176.3820408246,1894.964897329757,132071.34693815434,1234,5,190.86111111111111,36,0,20,35.96382329139999,0.6221064814814814,44.876126126126124,1020.4954954954953,28.34709709709709,0
3470,4,2,0,38,0.05263157894736842,0.0,1.0,38,950,700,250,0.7368421052631579,12,7,5,338.9390863907711,0.42800201517306785,0.12677577309672827,0.1961341166383331,130863.12601587031,1270.9256748118787,132134.0516906822,1235,0,181.76315789473685,38,0,16,35.53413560265915,0.6252741228070176,44.20405982905982,1023.1837606837598,26.92588843904631,0
3471,4,1,0,39,0.02564102564102564,0.0,1.0,39,1100,700,400,0.6363636363636364,15,7,8,332.69416921258994,0.4286999550157445,0.1259888508210658,0.19405186595709417,131168.01757812497,927.7669270833326,132095.7845052083,1236,0,178.07692307692307,39,0,19,35.386160260321326,0.6266025641025641,43.90625,1024.3749999999998,26.266025641025635,0
3472,4,1,0,40,0.025,0.0,1.0,40,950,800,150,0.8421052631578947,11,8,3,327.530201725353,0.430982905982906,0.1338751069289994,0.19240342000851127,131440.53939673738,610.4422454505162,132050.9816421879,1237,0,174.6,37,3,21,35.243798118049625,0.6328828828828829,43.64035087719298,1025.4385964912276,27.71455666192507,0
3473,4,0,1,39,0.0,0.025,0.975,40,800,500,300,0.625,11,5,6,323.3266429079714,0.43051549145299145,0.1312036755000512,0.19057116134055113,131568.46923828122,507.9182942708326,132076.38753255206,1238,1,175.6,39,1,14,35.22280180729008,0.6306089743589743,43.515625,1025.9374999999998,26.306089743589737,0
3474,4,0,0,39,0.0,0.0,1.0,39,1150,900,250,0.782608695652174,14,9,5,332.28320312500006,0.4277440395861449,0.13334935897435907,0.19546070772058813,131492.43918474676,938.5457758053794,132430.98496055213,1239,2,180.84615384615384,38,1,21,35.06966145833333,0.631578947368421,43.589743589743584,1025.6410256410247,26.990553306342758,0
3475,4,0,0,39,0.0,0.0,1.0,39,1000,800,200,0.8,12,8,4,332.3124250082528,0.42706927575348624,0.13080554042653203,0.196039835981527,131602.03904594926,946.5985462780328,132548.6375922273,1240,3,181.84615384615384,38,1,14,34.958524226016955,0.6326754385964912,43.48290598290598,1026.0683760683758,27.001799370220414,0
3476,4,0,1,38,0.0,0.02564102564102564,0.9743589743589743,39,1550,1000,550,0.6451612903225806,21,10,11,329.00500147334617,0.42670377867746284,0.12484979009629082,0.19514628787751168,131809.03320312497,873.1662326388883,132682.19943576385,1241,4,182.84615384615384,39,0,15,34.83507472780146,0.6330128205128205,43.28125,1026.8749999999998,26.3301282051282,0
3477,4,0,0,38,0.0,0.0,1.0,38,1150,900,250,0.782608695652174,14,9,5,335.0759701704389,0.42666844476055,0.12995799768905214,0.19866842376977695,131793.94866544285,1232.1970423332434,133026.1457077761,1242,5,186.97368421052633,38,0,15,34.69440398154895,0.6345942982456141,43.29594017094016,1026.8162393162377,27.021479982006255,0
3478,4,0,1,37,0.0,0.02631578947368421,0.9736842105263158,38,1100,600,500,0.5454545454545454,16,6,10,335.5637445201724,0.4266239924134661,0.13151872817054144,0.19938874164505138,131876.23844875416,1250.5768774197963,133126.81532617396,1243,6,187.97368421052633,38,0,15,34.59906559877955,0.6354166666666667,43.21581196581195,1027.1367521367497,27.029914529914464,0
3479,4,0,1,36,0.0,0.02702702702702703,0.972972972972973,37,1400,1100,300,0.7857142857142857,17,11,6,338.3625858684218,0.425269019019019,0.13138049955989128,0.20068179966166977,131806.21831957888,1519.658572830077,133325.87689240897,1244,7,193.86486486486487,37,0,15,34.59768197188112,0.6365427927927928,43.283991228070164,1026.8640350877174,27.753082029397767,0
3480,4,1,1,36,0.02702702702702703,0.02702702702702703,0.972972972972973,37,850,400,450,0.47058823529411764,13,4,9,339.3236724273615,0.4279592092092092,0.11234448734448721,0.19433992148112525,130463.84222059902,1455.2195403025944,131919.06176090162,1245,0,190.2972972972973,36,1,20,35.928084582598466,0.625,44.5945945945946,1021.6216216216219,28.378378378378386,8
3481,4,0,0,36,0.0,0.0,1.0,36,950,700,250,0.7368421052631579,12,7,5,345.00326621672616,0.42724867724867727,0.1204689959080898,0.19732040339355836,130410.31867551855,1798.3971782835936,132208.71585380213,1246,1,195.86111111111111,35,1,20,35.83722851746931,0.6264880952380952,44.64699074074073,1021.4120370370359,29.183201058201025,0
3482,4,1,0,37,0.02702702702702703,0.0,1.0,37,1200,900,300,0.75,15,9,6,334.9209227130036,0.42792792792792794,0.11516619535487504,0.1933256415264168,130766.77439212055,1359.3057479224265,132126.080140043,1247,0,191.54054054054055,37,0,14,35.73425886220699,0.6261261261261262,44.29824561403508,1022.8070175438588,27.64343290659078,0
3483,4,0,0,37,0.0,0.0,1.0,37,1250,900,350,0.72,16,9,7,336.83934510508504,0.42833458458458457,0.11111915343302536,0.1954254373247963,130963.11034404836,1422.7056642428606,132385.8160082912,1248,1,192.54054054054055,37,0,16,35.48685502588823,0.6280968468468469,44.106359649122815,1023.5745614035103,27.664177335230008,0
3484,4,0,0,37,0.0,0.0,1.0,37,1100,800,300,0.7272727272727273,14,8,6,337.65389359389957,0.4281468968968969,0.11875687250419564,0.19661392557151022,131103.4404816868,1453.5174284395323,132556.9579101263,1249,2,193.54054054054055,37,0,18,35.32432191291933,0.6295045045045045,43.96929824561404,1024.1228070175448,27.678994784257966,0
3485,4,1,0,38,0.02631578947368421,0.0,1.0,38,1000,600,400,0.6,14,6,8,335.36273010222754,0.427305595068753,0.12334506923431676,0.1978766978749461,131609.25116381966,1227.5599222837861,132836.81108610344,1250,0,189.42105263157896,37,1,13,34.87301417681842,0.634572072072072,43.47587719298246,1026.0964912280704,27.732337600758658,0
3486,4,0,2,36,0.0,0.05263157894736842,0.9473684210526316,38,900,600,300,0.6666666666666666,12,6,6,335.85545933260545,0.42761676149834044,0.12929624028022202,0.19860663012081617,131693.64762474992,1246.0061028393332,132939.65372758926,1251,1,190.42105263157896,37,1,16,34.77537567211479,0.6354166666666667,43.39364035087719,1026.4254385964912,27.74122807017544,0
3487,4,0,0,36,0.0,0.0,1.0,36,1350,900,450,0.6666666666666666,18,9,9,348.03047518980736,0.42311507936507936,0.14057202097816823,0.2050813472819627,131559.0823086599,1957.313986283571,133516.3962949435,1252,2,201.5,36,0,17,34.59865532381999,0.6359953703703703,43.52477477477477,1025.9009009009,28.497247247247223,0
3488,4,0,0,36,0.0,0.0,1.0,36,900,600,300,0.6666666666666666,12,6,6,345.3065490345103,0.42311507936507936,0.13828528924007433,0.2037845385234752,131616.85333982628,1889.632284311333,133506.48562413763,1253,3,202.5,36,0,17,34.610266681299386,0.6365740740740741,43.468468468468465,1026.1261261261259,28.503503503503495,0
3489,4,0,0,36,0.0,0.0,1.0,36,1400,900,500,0.6428571428571429,19,9,10,346.24884579870746,0.42291666666666666,0.12847222222222276,0.20558525219298254,131848.06428049668,1930.448015583149,133778.51229607983,1254,4,203.5,36,0,19,34.353070175438596,0.6388888888888888,43.24324324324324,1027.0270270270266,28.52852852852852,0
3490,4,0,0,36,0.0,0.0,1.0,36,1300,1000,300,0.7692307692307693,16,10,6,346.9913304559956,0.4221064814814815,0.12468493150684967,0.2068122723978419,131992.67415641993,1960.0627231961707,133952.7368796161,1255,5,204.5,36,0,19,34.188356164383556,0.6403356481481481,43.10247747747748,1027.5900900900901,28.54416916916917,0
3491,4,0,1,35,0.0,0.027777777777777776,0.9722222222222222,36,950,800,150,0.8421052631578947,11,8,3,344.3032619724846,0.4219576719576719,0.12272981789852988,0.20568063974377224,132079.4781267754,1895.079031734438,133974.55715850982,1256,6,205.5,36,0,19,34.17004455156298,0.6412037037037037,43.01801801801802,1027.9279279279276,28.553553553553545,0
3492,4,1,0,36,0.027777777777777776,0.0,1.0,36,1150,800,350,0.6956521739130435,15,8,7,343.85045337992506,0.4214781746031746,0.14074986316365634,0.2065137338346888,132282.13168827622,1897.05419101535,134179.18587929156,1257,0,205.88888888888889,36,0,20,33.977832512315274,0.6432291666666667,42.82094594594595,1028.716216216217,28.57545045045047,0
3493,4,0,0,36,0.0,0.0,1.0,36,1150,900,250,0.782608695652174,14,9,5,345.8766860267465,0.42076719576719573,0.14393386822270848,0.2085298753485794,132426.97934420907,1960.680951221491,134387.66029543057,1258,1,206.88888888888889,36,0,21,33.78008752735231,0.6446759259259259,42.68018018018018,1029.2792792792793,28.59109109109109,0
3494,4,1,0,37,0.02702702702702703,0.0,1.0,37,800,500,300,0.625,11,5,6,337.96706332830803,0.42336086086086083,0.14340777559168427,0.20513814774113553,132680.27181440423,1568.312365343163,134248.58417974738,1259,0,202.27027027027026,37,0,19,33.72933517808996,0.6452702702702703,42.43421052631578,1030.2631578947353,27.844950213371224,0
3495,4,0,0,37,0.0,0.0,1.0,37,1100,800,300,0.7272727272727273,14,8,6,335.42474753496384,0.42242242242242245,0.1356409578442752,0.20482690427394792,132906.30290089248,1516.0126192674506,134422.31552015993,1260,1,203.27027027027026,37,0,19,33.56816248404933,0.6475225225225225,42.214912280701746,1031.140350877192,27.868658131816,0
3496,4,0,0,37,0.0,0.0,1.0,37,1200,900,300,0.75,15,9,6,334.9471017296202,0.42235985985985985,0.1397612794593448,0.20484476195505882,132962.84072983987,1507.103628039384,134469.94435787926,1261,2,204.27027027027026,37,0,19,33.52381458643418,0.6480855855855856,42.16008771929824,1031.3596491228063,27.874585111427198,0
3497,4,0,0,37,0.0,0.0,1.0,37,1050,700,350,0.6666666666666666,14,7,7,336.5652152788826,0.42226601601601604,0.14905640872491688,0.20677231110997696,133132.52635426298,1561.5554786088167,134694.0818328718,1262,3,205.27027027027026,37,0,20,33.31208386457004,0.6497747747747749,41.995614035087726,1032.0175438596502,27.89236605026082,0
3498,4,0,0,37,0.0,0.0,1.0,37,650,300,350,0.46153846153846156,10,3,7,338.5539412188627,0.42139014014014015,0.14946112460452787,0.2083102485381944,133189.11227493078,1618.339777623888,134807.45205255467,1263,4,206.27027027027026,37,0,21,33.20409319453296,0.6503378378378378,41.94078947368421,1032.2368421052636,27.89829302987199,0
3499,4,0,0,37,0.0,0.0,1.0,37,1700,1500,200,0.8823529411764706,19,15,4,338.76605316420296,0.42073323323323325,0.14653124462041633,0.20939476514480296,133358.9421745155,1635.496498922777,134994.4386734383,1264,5,207.27027027027026,37,0,22,33.02857395612172,0.652027027027027,41.7763157894737,1032.8947368421075,27.916073968705607,0
3500,4,0,0,37,0.0,0.0,1.0,37,1150,700,450,0.6086956521739131,16,7,9,341.94660816184273,0.4203578578578579,0.15114166143914454,0.21217336194058375,133501.315399014,1730.112488887987,135231.427887902,1265,6,208.27027027027026,36,1,23,32.803930115142926,0.6553819444444444,41.63851351351352,1033.4459459459472,28.706831831831867,0
3501,4,0,0,37,0.0,0.0,1.0,37,1050,600,450,0.5714285714285714,15,6,9,342.4326351213445,0.4202327327327327,0.15208149325796372,0.21297639501449506,133588.61395178977,1749.020219543887,135337.63417133366,1266,7,209.27027027027026,36,1,23,32.70402142338418,0.65625,41.55405405405406,1033.7837837837849,28.716216216216246,0
3502,4,0,0,37,0.0,0.0,1.0,37,1250,900,350,0.72,16,9,7,345.10623493972645,0.41954454454454454,0.14720991402898687,0.21565618191539623,133763.2966581445,1832.5095365635802,135595.8061947081,1267,8,210.27027027027026,36,1,17,32.46017490383918,0.6579861111111112,41.38513513513513,1034.4594594594585,28.73498498498496,0
3503,4,0,0,37,0.0,0.0,1.0,37,1500,1100,400,0.7333333333333333,19,11,8,346.31879749573056,0.41963838838838835,0.14880306359248552,0.21692729585468767,133850.68081172393,1871.0013645402194,135721.68217626415,1268,9,211.27027027027026,36,1,17,32.34143178437987,0.6588541666666667,41.30067567567568,1034.7972972972975,28.744369369369377,0
3504,4,0,0,37,0.0,0.0,1.0,37,1200,700,500,0.5833333333333334,17,7,10,369.0824992070215,0.4204517017017017,0.16758711695420603,0.21484486532787667,131090.963648834,2288.4731562768966,133379.4368051109,1269,10,212.27027027027026,35,2,21,34.532286015672085,0.6333333333333333,43.98148148148148,1024.074074074074,29.259259259259256,8
3505,4,0,0,37,0.0,0.0,1.0,37,850,400,450,0.47058823529411764,13,4,9,370.3584619036264,0.4196696696696696,0.17040490168243472,0.21642135070843577,131239.1643759644,2321.1070119598653,133560.27138792427,1270,11,213.27027027027026,35,2,21,34.34958488647915,0.6348214285714286,43.83680555555555,1024.652777777777,29.275793650793627,0
3506,4,0,0,37,0.0,0.0,1.0,37,1250,900,350,0.72,16,9,7,372.3865585313569,0.41888763763763764,0.17607537544317853,0.21845034009740133,131387.44882758913,2385.383980624136,133772.83280821328,1271,12,214.27027027027026,35,2,21,34.14756905245729,0.6363095238095238,43.692129629629626,1025.2314814814813,29.292328042328037,0
3507,4,0,0,37,0.0,0.0,1.0,37,1300,700,600,0.5384615384615384,19,7,12,370.58608651808487,0.4187937937937938,0.1766264123853849,0.2185378533505677,131587.9662390431,2352.933888280172,133940.9001273233,1272,13,215.27027027027026,36,1,19,33.99096330443054,0.6362847222222222,43.49662162162162,1026.0135135135135,28.500375375375377,0
3508,4,0,0,37,0.0,0.0,1.0,37,700,400,300,0.5714285714285714,10,4,6,369.73840747146477,0.41823073073073075,0.17292435041447773,0.21886593003310859,131732.4334469605,2341.308031003981,134073.74147796448,1273,14,216.27027027027026,36,1,19,33.86673614158256,0.6377314814814814,43.35585585585586,1026.5765765765768,28.516016016016025,0
3509,4,2,0,39,0.05128205128205128,0.0,1.0,39,900,700,200,0.7777777777777778,11,7,4,356.185183788272,0.419899910031489,0.16303847085859768,0.2139555293011395,132288.0725970668,1623.810290196488,133911.8828872633,1274,0,206.12820512820514,38,1,24,33.65462837954788,0.6395285087719298,42.81517094017093,1028.7393162393148,27.072087269455654,0
3510,4,0,1,38,0.0,0.02564102564102564,0.9743589743589743,39,1100,700,400,0.6363636363636364,15,7,8,352.1636405397542,0.42029352226720645,0.15656677401643848,0.21231599831385162,132426.21678064385,1527.1853779725718,133953.40215861643,1275,1,207.12820512820514,37,2,24,33.61907869038741,0.6427364864864865,42.68092105263157,1029.2763157894722,27.81827880512087,0
3511,4,0,0,38,0.0,0.0,1.0,38,1650,1400,250,0.8484848484848485,19,14,5,365.301495597814,0.416459222380275,0.16241802589540932,0.22073237089211525,132510.87474030457,2081.2841451215613,134592.15888542612,1276,2,213.1578947368421,37,1,24,33.19577564785232,0.6435810810810811,42.59868421052631,1029.6052631578937,27.827169274537667,0
3512,4,1,0,39,0.02564102564102564,0.0,1.0,39,650,400,250,0.6153846153846154,9,4,5,358.4687702065521,0.4190002249212776,0.15958255580897118,0.2180195307321814,132755.5941358023,1717.746913580225,134473.34104938252,1277,0,208.66666666666666,38,1,19,33.125561545372854,0.6441885964912281,42.3611111111111,1030.555555555554,27.119883040935633,0
3513,4,1,0,40,0.025,0.0,1.0,40,950,800,150,0.8421052631578947,11,8,3,348.2259182371539,0.42119391025641023,0.15566747450267604,0.21326414769960006,133015.14892578113,1263.864474826375,134279.0134006075,1278,0,204.425,39,1,20,33.128955030462144,0.6450320512820513,42.10937499999999,1031.562499999999,26.45032051282049,0
3514,4,0,2,38,0.0,0.05,0.95,40,700,400,300,0.5714285714285714,10,4,6,346.43400554858187,0.42131410256410257,0.15222132471728655,0.2123194548857147,133042.01388888864,1218.0555555555325,134260.06944444418,1279,1,205.425,39,1,20,33.14822294022617,0.6452991452991452,42.08333333333332,1031.6666666666647,26.4529914529914,0
3515,4,0,0,38,0.0,0.0,1.0,38,350,200,150,0.5714285714285714,5,2,3,363.13368463113846,0.418859649122807,0.16081249089951966,0.2207458194154877,132736.76155163127,2040.23786164974,134776.999413281,1280,2,216.97368421052633,37,1,20,33.02431368376251,0.6458333333333333,42.37938596491228,1030.482456140351,27.850877192982455,0
3516,4,0,0,38,0.0,0.0,1.0,38,1250,900,350,0.72,16,9,7,362.7612833721849,0.4179261498340446,0.15818859602478486,0.2213526507169795,132878.03849501768,2040.6015552862384,134918.64005030392,1281,3,217.97368421052633,37,1,21,32.891874047289875,0.647240990990991,42.24232456140351,1031.0307017543857,27.865694642010425,0
3517,4,0,0,38,0.0,0.0,1.0,38,900,700,200,0.7777777777777778,11,7,4,361.782951970982,0.41762980085348506,0.16174685144880918,0.2214243480280435,132991.11415291246,2022.783572830106,135013.89772574257,1282,4,218.97368421052633,37,1,22,32.80347524892811,0.6483671171171171,42.13267543859649,1031.4692982456143,27.877548601232817,0
3518,4,0,1,37,0.0,0.02631578947368421,0.9736842105263158,38,1100,700,400,0.6363636363636364,15,7,8,360.0542315148557,0.4165333096254149,0.15974827645976752,0.22137103078049228,133160.81781173052,1989.0231850184696,135149.840996749,1283,5,219.97368421052633,37,1,22,32.67765767201389,0.6500563063063063,41.968201754385966,1032.127192982456,27.89532954006638,0
3519,4,0,0,37,0.0,0.0,1.0,37,1050,600,450,0.5714285714285714,15,6,9,362.6470781985944,0.41638513513513514,0.17278086982654695,0.22431299044610314,133384.96171424817,2274.3333282607036,135659.29504250886,1284,6,224.21621621621622,36,1,24,32.38580617028234,0.654224537037037,41.75112612612613,1032.9954954954965,28.694319319319348,0
3520,4,0,0,37,0.0,0.0,1.0,37,1400,1000,400,0.7142857142857143,18,10,8,368.2291018006504,0.41541541541541543,0.1790556101933347,0.22906171346968834,133595.26643990938,2438.7900603996236,136034.056500309,1285,7,225.21621621621622,34,3,25,32.03065023798557,0.6605392156862745,41.54761904761905,1033.8095238095243,30.40616246498601,0
3521,4,0,1,36,0.0,0.02702702702702703,0.972972972972973,37,1350,1200,150,0.8888888888888888,15,12,3,368.2291018006504,0.41519644644644643,0.1790556101933347,0.22906171346968834,133595.26643990938,2438.7329931972863,136033.99943310666,1286,8,226.21621621621622,34,3,25,32.03065023798557,0.6605392156862745,41.54761904761905,1033.8095238095243,30.40616246498601,0
3522,4,0,0,36,0.0,0.0,1.0,36,1000,700,300,0.7,13,7,6,371.84448055152546,0.41440145502645503,0.1856066592908696,0.23133333613072782,133598.88624567477,2735.6016916570607,136334.48793733184,1287,9,231.63888888888889,33,3,25,31.93357831515726,0.6628787878787878,41.544117647058826,1033.823529411765,31.327985739750456,0
3523,4,0,0,36,0.0,0.0,1.0,36,950,600,350,0.631578947368421,13,6,7,374.61282524306483,0.41367394179894185,0.18652297489341563,0.23466103088667944,133852.39451172625,2828.5647347174117,136680.95924644367,1288,10,232.63888888888889,33,3,20,31.60774909205748,0.6654040404040404,41.299019607843135,1034.8039215686274,31.357694592988707,0
3524,4,0,0,36,0.0,0.0,1.0,36,1150,900,250,0.782608695652174,14,9,5,374.76367257873216,0.41306216931216927,0.1862843729040915,0.23576904464763263,134010.9592013888,2844.487847222212,136855.447048611,1289,11,233.63888888888889,33,3,21,31.444919517102615,0.6669823232323233,41.14583333333333,1035.4166666666658,31.3762626262626,0
3525,4,0,0,36,0.0,0.0,1.0,36,1400,1100,300,0.7857142857142857,17,11,6,379.63023752911937,0.41091269841269845,0.1897217435701073,0.24034045219570793,134242.17864229027,2992.478032879825,137234.6566751701,1290,12,234.63888888888889,34,2,22,31.08725828068161,0.6669730392156863,40.92261904761905,1036.3095238095239,30.479691876750703,0
3526,4,0,2,34,0.0,0.05555555555555555,0.9444444444444444,36,900,600,300,0.6666666666666666,12,6,6,374.26937640158525,0.4104828042328042,0.18812913843916212,0.23774704588485848,134365.57716836742,2857.784155328802,137223.36132369624,1291,13,235.63888888888889,34,2,23,31.102642859876745,0.6681985294117647,40.80357142857143,1036.785714285715,30.493697478991614,0
3527,4,0,0,34,0.0,0.0,1.0,34,650,300,350,0.46153846153846156,10,3,7,384.2813158114275,0.4066770647653,0.18270988180821268,0.2431608912000295,134223.4868412661,3515.9156272319033,137739.402468498,1292,15,240.55882352941177,32,2,24,30.985490028837173,0.6715494791666667,40.94065656565656,1036.237373737373,32.382417929292906,0
3528,4,0,0,34,0.0,0.0,1.0,34,850,600,250,0.7058823529411765,11,6,5,384.91544406826034,0.4066213606654783,0.18311403508771917,0.24377978124323146,134256.19834710742,3535.456841138653,137791.65518824608,1293,16,241.55882352941177,32,2,24,30.936281676413245,0.671875,40.90909090909091,1036.363636363636,32.386363636363626,0
3529,4,0,0,34,0.0,0.0,1.0,34,950,700,250,0.7368421052631579,12,7,5,391.6451097983331,0.4059343434343434,0.1868855393648634,0.24960159635324314,134485.29048375157,3734.1012715539127,138219.3917553055,1294,17,242.55882352941177,32,2,24,30.53230878474336,0.6741536458333333,40.68813131313131,1037.247474747474,32.41398358585856,0
3530,4,0,0,34,0.0,0.0,1.0,34,1050,900,150,0.8571428571428571,12,9,3,387.57439396138795,0.40537730243612596,0.18107725017717935,0.24745134383688577,134550.78124999977,3629.6874999999704,138180.46874999974,1295,18,243.55882352941177,32,2,24,30.57228915662651,0.6748046875,40.624999999999986,1037.4999999999982,32.42187499999994,0
3531,4,0,1,33,0.0,0.029411764705882353,0.9705882352941176,34,950,500,450,0.5263157894736842,14,5,9,387.57439396138795,0.40547014260249553,0.18107725017717935,0.24745134383688577,134550.78124999977,3629.6874999999704,138180.46874999974,1296,19,244.55882352941177,32,2,24,30.57228915662651,0.6748046875,40.624999999999986,1037.4999999999982,32.42187499999994,0
3532,4,0,0,33,0.0,0.0,1.0,33,1300,1000,300,0.7692307692307693,16,10,6,392.86272651722084,0.4032118055555556,0.18276087518435724,0.2517605832632865,134685.9063042534,3982.614474826385,138668.5207790798,1297,20,246.45454545454547,31,2,24,30.299799297541387,0.678763440860215,40.494791666666664,1038.020833333333,33.48454301075268,0
3533,4,0,0,33,0.0,0.0,1.0,33,900,600,300,0.6666666666666666,12,6,6,397.0084777904426,0.40317234848484845,0.1844320841311815,0.2553660982948846,134821.09917534716,4105.023871527768,138926.12304687494,1298,21,247.45454545454547,31,2,21,30.05683717820127,0.6801075268817205,40.36458333333333,1038.541666666666,33.50134408602148,0
3534,4,0,1,32,0.0,0.030303030303030304,0.9696969696969697,33,600,400,200,0.6666666666666666,8,4,4,396.7635741332032,0.40258049242424243,0.18988582237516805,0.255684959162738,134888.72104220928,4103.786214192719,138992.507256402,1299,22,248.45454545454547,31,2,22,29.995508481657893,0.6807795698924731,40.29947916666667,1038.802083333334,33.50974462365593,0
3535,4,0,0,32,0.0,0.0,1.0,32,850,400,450,0.47058823529411764,13,4,9,399.44580150328164,0.4015456989247312,0.18994614439125357,0.2574909591175034,134899.6293827322,4377.01811625623,139276.64749898843,1300,23,251.4375,30,2,22,29.91493078017856,0.6836805555555556,40.28897849462366,1038.8440860215062,34.628136200716874,0
3536,4,0,0,32,0.0,0.0,1.0,32,600,400,200,0.6666666666666666,8,4,4,399.44580150328164,0.4015456989247312,0.18994614439125357,0.2574909591175034,134899.6293827322,4377.01811625623,139276.64749898843,1301,24,252.4375,30,2,22,29.91493078017856,0.6836805555555556,40.28897849462366,1038.8440860215062,34.628136200716874,0
3537,4,0,0,32,0.0,0.0,1.0,32,900,700,200,0.7777777777777778,11,7,4,399.8077174663733,0.4008736559139785,0.1490747734138973,0.2496912348705086,133741.455078125,4294.173177083334,138035.62825520834,1302,25,253.4375,31,1,17,31.067472306142996,0.6693548387096775,41.40625,1034.375,33.36693548387097,8
3538,4,0,1,31,0.0,0.03125,0.96875,32,1000,800,200,0.8,12,8,4,399.8077174663733,0.4008736559139785,0.1490747734138973,0.2496912348705086,133741.455078125,4294.173177083334,138035.62825520834,1303,26,254.4375,31,1,17,31.067472306142996,0.6693548387096775,41.40625,1034.375,33.36693548387097,0
3539,4,0,0,31,0.0,0.0,1.0,31,1050,600,450,0.5714285714285714,15,6,9,403.8530769696788,0.39843189964157705,0.12486749431220612,0.2529914434165629,133854.43990996078,4611.505484738135,138465.9453946989,1304,27,245.3548387096774,30,1,17,30.849244490626482,0.6732638888888889,41.297043010752695,1034.81182795699,34.49372759856634,0
3540,4,0,0,31,0.0,0.0,1.0,31,350,100,250,0.2857142857142857,6,1,5,402.7361690042363,0.3977598566308244,0.12873904101268785,0.25276864201317223,133923.99274843908,4587.207155451491,138511.19990389058,1305,28,246.3548387096774,30,1,18,30.80822836861013,0.6739583333333333,41.229838709677416,1035.08064516129,34.502688172043,0
3541,4,0,1,30,0.0,0.03225806451612903,0.967741935483871,31,1000,700,300,0.7,13,7,6,400.17242327487764,0.39771505376344085,0.11870666264697016,0.25187323112007004,134028.35587929236,4526.89039195282,138555.24627124518,1306,29,247.3548387096774,30,1,19,30.76973001038422,0.675,41.12903225806451,1035.4838709677415,34.51612903225805,0
3542,4,0,1,29,0.0,0.03333333333333333,0.9666666666666667,30,550,200,350,0.36363636363636365,9,2,7,409.32553741123434,0.39724616858237544,0.11063839305686018,0.25650837504214513,133867.18991126533,4959.0518904320825,138826.2418016974,1307,30,248.53333333333333,29,1,19,30.69484521093364,0.6763649425287357,41.284722222222214,1034.8611111111104,35.684865900383116,0
3543,4,0,0,29,0.0,0.0,1.0,29,750,600,150,0.8,9,6,3,415.08556512242023,0.39408866995073893,0.08497987687734021,0.24244546428409286,131221.37586805547,5093.6197916666615,136314.99565972213,1308,51,257.0689655172414,29,0,18,33.22192286837468,0.6497844827586207,43.854166666666664,1024.5833333333328,35.33045977011493,8
3544,4,0,0,29,0.0,0.0,1.0,29,450,200,250,0.4444444444444444,7,2,5,417.4185464326573,0.3937294745484401,0.08131183087139182,0.24426101935976008,131292.5371334875,5160.788001543192,136453.3251350307,1309,52,258.0689655172414,29,0,18,33.08982133983828,0.6505028735632183,43.784722222222214,1024.86111111111,35.340038314176205,0
3545,4,0,0,29,0.0,0.0,1.0,29,1000,700,300,0.7,13,7,6,418.40174499305954,0.3939347290640394,0.07821698906644214,0.24506387921022063,131328.125,5189.583333333331,136517.70833333334,1310,53,259.0689655172414,29,0,18,33.02845528455285,0.6508620689655172,43.75,1025.0,35.3448275862069,0
3546,4,0,0,29,0.0,0.0,1.0,29,950,800,150,0.8421052631578947,11,8,3,424.237818531194,0.3942939244663382,0.060217008464466204,0.22788704057383638,127933.6805555558,5054.861111111142,132988.54166666695,1311,54,260.0689655172414,29,0,17,36.35365183964855,0.6163793103448276,47.08333333333335,1011.6666666666686,34.88505747126443,8
3547,4,1,0,30,0.03333333333333333,0.0,1.0,30,750,400,350,0.5333333333333333,11,4,7,418.3473920128107,0.39870689655172414,0.07834924001413923,0.22803560154224328,128519.04844490706,4753.121748178999,133272.17019308606,1312,0,252.36666666666667,30,0,16,35.90049487451397,0.6194444444444445,46.50537634408603,1013.978494623657,33.7992831541219,0
3548,4,0,0,30,0.0,0.0,1.0,30,1100,900,200,0.8181818181818182,13,9,4,422.1977064719971,0.3987787356321839,0.08609970415507551,0.2311218626654901,128689.46419022439,4866.4793256445955,133555.94351586897,1313,1,253.36666666666667,30,0,17,35.6277873449022,0.6211805555555556,46.337365591397855,1014.6505376344093,33.82168458781364,0
3549,4,1,0,31,0.03225806451612903,0.0,1.0,31,450,300,150,0.6666666666666666,6,3,3,413.3642251565192,0.4019713261648745,0.09100378631305706,0.22846277713324906,129069.04432508687,4470.505099826399,133539.54942491328,1314,0,246.16129032258064,31,0,18,35.462583290620195,0.6223118279569892,45.96354166666667,1016.1458333333339,32.77889784946238,0
3550,4,0,0,31,0.0,0.0,1.0,31,700,600,100,0.8571428571428571,8,6,2,410.1084662008353,0.40174731182795703,0.08886464506211111,0.22704302745841987,129135.20812988281,4391.888427734376,133527.0965576172,1315,1,247.16129032258064,31,0,18,35.47751729438894,0.622983870967742,45.8984375,1016.40625,32.787298387096776,0
3551,4,0,1,30,0.0,0.03225806451612903,0.967741935483871,31,900,500,400,0.5555555555555556,13,5,8,409.5975439122235,0.40161290322580645,0.09485107562416073,0.22733715478326968,129235.55333347761,4386.930000515968,133622.4833339936,1316,2,248.16129032258064,30,1,18,35.38775060586031,0.6267361111111112,45.79973118279568,1016.8010752688152,33.89336917562717,0
3552,4,2,1,31,0.0625,0.03125,0.96875,32,1100,800,300,0.7272727272727273,14,8,6,397.73630761943866,0.40746807795698925,0.08899144098109346,0.22431410778421956,129864.12896050354,3930.335828993065,133794.46478949662,1317,0,238.40625,31,1,17,35.047266223811945,0.6303763440860215,45.18229166666667,1019.2708333333339,32.879704301075286,0
3553,4,0,0,31,0.0,0.0,1.0,31,600,300,300,0.5,9,3,6,407.03803231667837,0.4020161290322581,0.10221295429398247,0.22888340392881484,129748.56197248246,4362.519872239583,134111.08184472204,1318,1,247.09677419354838,30,1,17,34.928265171503966,0.6319444444444444,45.29569892473119,1018.8172043010761,33.960573476702535,0
3554,4,0,0,31,0.0,0.0,1.0,31,700,400,300,0.5714285714285714,10,4,6,408.4643448362475,0.4020609318996416,0.10050864364442735,0.2299742419200341,129797.77865939676,4403.552924262159,134201.33158365893,1319,2,248.09677419354838,31,0,17,34.84166027770678,0.6297043010752688,45.247395833333336,1019.0104166666672,32.87130376344088,0
3555,4,0,0,31,0.0,0.0,1.0,31,1000,700,300,0.7,13,7,6,406.9650005321687,0.4021505376344086,0.10070810385523243,0.23010418188934384,129963.68620130746,4378.134324815534,134341.820526123,1320,3,249.09677419354838,31,0,17,34.71047226833525,0.6313844086021505,45.084635416666664,1019.6614583333329,32.892305107526866,0
3556,4,0,1,30,0.0,0.03225806451612903,0.967741935483871,31,1000,800,200,0.8,12,8,4,403.9731393624653,0.40232974910394265,0.10724416905119716,0.2291911330126657,130096.4885287814,4311.097378200946,134407.58590698233,1321,4,250.09677419354838,31,0,17,34.65127100616889,0.632728494623656,44.95442708333333,1020.1822916666661,32.90910618279568,0
3557,4,0,0,30,0.0,0.0,1.0,30,1000,700,300,0.7,13,7,6,415.7620347195263,0.3997126436781609,0.11657002284308549,0.23543300891431085,130022.58209041515,4811.6906578795315,134834.2727482947,1322,5,256.3666666666667,30,0,18,34.42606747496046,0.6347222222222222,45.02688172043011,1019.8924731182801,33.99641577060934,0
3558,4,0,0,30,0.0,0.0,1.0,30,750,600,150,0.8,9,6,3,415.7620347195263,0.3997126436781609,0.11657002284308549,0.23543300891431085,130022.58209041515,4811.6906578795315,134834.2727482947,1323,6,257.3666666666667,30,0,18,34.42606747496046,0.6347222222222222,45.02688172043011,1019.8924731182801,33.99641577060934,0
3559,4,0,0,30,0.0,0.0,1.0,30,1150,500,650,0.43478260869565216,18,5,13,414.12556558215437,0.39897030651341,0.11690153211291099,0.23553973179515336,130193.99144771071,4783.332068736271,134977.32351644698,1324,7,258.3666666666667,30,0,19,34.292824531366605,0.6364583333333333,44.858870967741936,1020.5645161290322,34.01881720430107,0
3560,4,0,0,30,0.0,0.0,1.0,30,700,500,200,0.7142857142857143,9,5,4,414.12556558215437,0.39897030651341,0.11690153211291099,0.23553973179515336,130193.99144771071,4783.332068736271,134977.32351644698,1325,8,259.3666666666667,30,0,19,34.292824531366605,0.6364583333333333,44.858870967741936,1020.5645161290322,34.01881720430107,0
3561,4,0,0,30,0.0,0.0,1.0,30,1000,800,200,0.8,12,8,4,416.87692851660637,0.398227969348659,0.11777660787926614,0.23815269946384784,130365.51371545851,4869.274988437976,135234.78870389648,1326,9,260.3666666666667,30,0,19,34.04761121347723,0.6381944444444445,44.69086021505377,1021.2365591397855,34.04121863799285,0
3562,4,0,0,30,0.0,0.0,1.0,30,800,600,200,0.75,10,6,4,416.96606648199406,0.3971743295019157,0.11992105263157815,0.23862515852885227,130434.15423748424,4877.323245461919,135311.47748294615,1327,10,261.3666666666667,30,0,19,33.97532894736842,0.6388888888888888,44.6236559139785,1021.5053763440872,34.05017921146957,0
3563,4,0,0,30,0.0,0.0,1.0,30,1000,600,400,0.6,14,6,8,419.65314870792054,0.3960488505747126,0.11671707210168747,0.24122919092394063,130605.83457986468,4961.829944213199,135567.66452407787,1328,11,262.3666666666667,30,0,16,33.73164584703047,0.640625,44.45564516129032,1022.1774193548383,34.072580645161274,0
3564,4,0,0,30,0.0,0.0,1.0,30,600,400,200,0.6666666666666666,8,4,4,418.6282208387044,0.396168582375479,0.11738101498816733,0.24085372524199594,130640.18419759518,4937.933576135984,135578.11777373118,1329,12,263.3666666666667,30,0,16,33.72282846875274,0.6409722222222223,44.422043010752695,1022.31182795699,34.077060931899666,0
3565,4,0,0,30,0.0,0.0,1.0,30,1100,700,400,0.6363636363636364,15,7,8,420.53144843935394,0.3969348659003831,0.11626358219418154,0.24237903482777295,130708.89698231005,4993.440354376222,135702.33733668627,1330,13,264.3666666666667,30,0,16,33.60415571328426,0.6416666666666666,44.354838709677416,1022.5806451612899,34.08602150537633,0
3566,4,0,0,30,0.0,0.0,1.0,30,950,500,450,0.5263157894736842,14,5,9,419.80586139001184,0.39695881226053636,0.11692732290708374,0.24217610305660345,130743.2601492947,4977.35738958261,135720.6175388773,1331,14,265.3666666666667,30,0,16,33.58769220659746,0.6420138888888889,44.321236559139784,1022.7150537634407,34.09050179211469,0
3567,4,0,0,30,0.0,0.0,1.0,30,600,500,100,0.8333333333333334,7,5,2,420.39711908219533,0.3969348659003831,0.12084975908891771,0.24273308620754971,130777.62783269736,4995.707596253891,135773.33542895125,1332,15,266.3666666666667,30,0,16,33.53756022777046,0.6423611111111112,44.287634408602145,1022.8494623655909,34.09498207885303,0
3568,4,0,1,29,0.0,0.03333333333333333,0.9666666666666667,30,900,600,300,0.6666666666666666,12,6,6,421.3087983129756,0.3965277777777778,0.12477116454254777,0.24347617797722523,130812.00003251819,5022.449307723431,135834.4493402416,1333,16,267.3666666666667,30,0,16,33.47922962379012,0.6427083333333333,44.25403225806451,1022.9838709677417,34.09946236559139,0
3569,4,0,0,29,0.0,0.0,1.0,29,800,500,300,0.625,11,5,6,431.8867445067739,0.39306239737274223,0.13603848802402263,0.248562808937792,130652.78018904306,5485.440779320972,136138.22096836404,1334,17,276.9310344827586,29,0,17,33.37111692251959,0.6440373563218391,44.409722222222214,1022.36111111111,35.25383141762448,0
3570,4,0,0,29,0.0,0.0,1.0,29,700,300,400,0.42857142857142855,11,3,8,428.45075400947866,0.392190065681445,0.1309258461480829,0.24726577997851085,130759.29783950603,5404.7839506172595,136164.08179012328,1335,18,277.9310344827586,29,0,17,33.350307803729855,0.6451149425287357,44.30555555555554,1022.7777777777767,35.26819923371644,0
3571,4,0,0,29,0.0,0.0,1.0,29,750,500,250,0.6666666666666666,10,5,5,428.23398707957875,0.3913690476190476,0.1353660077793324,0.2478240206453462,130865.85889274691,5408.24170524691,136274.10059799382,1336,19,278.9310344827586,29,0,17,33.2472229763359,0.6461925287356323,44.201388888888886,1023.1944444444445,35.28256704980843,0
3572,4,0,0,29,0.0,0.0,1.0,29,950,700,250,0.7368421052631579,12,7,5,431.13545342297823,0.3906506568144499,0.1380619875875162,0.2508888475207274,131079.11120756165,5502.570408950607,136581.68161651227,1337,20,279.9310344827586,29,0,17,32.95568854830688,0.6483477011494253,43.99305555555555,1024.0277777777771,35.311302681992316,0
3573,4,0,0,29,0.0,0.0,1.0,29,1150,1000,150,0.8695652173913043,13,10,3,434.93932310775006,0.39008620689655177,0.13991242622353273,0.25451366100016554,131292.53713348755,5620.857445987639,136913.3945794752,1338,21,280.9310344827586,29,0,18,32.640912273569135,0.6505028735632183,43.784722222222214,1024.8611111111104,35.34003831417622,0
3574,4,0,0,29,0.0,0.0,1.0,29,1000,600,400,0.6,14,6,8,437.21469939671067,0.3901888341543514,0.1393138954164701,0.2563210243246325,131363.7176890433,5686.8296682098935,137050.54735725318,1339,22,281.9310344827586,29,0,18,32.51013299914196,0.6512212643678161,43.715277777777786,1025.1388888888896,35.349616858237574,0
3575,4,1,0,30,0.03333333333333333,0.0,1.0,30,800,500,300,0.625,11,5,6,423.08040907544785,0.39360632183908045,0.1351354889383427,0.2507301198547205,131776.255293242,5150.390399179097,136926.6456924211,1340,0,273.5,30,0,18,32.45325522537853,0.6524305555555556,43.31317204301075,1026.747311827957,34.22491039426523,0
3576,4,0,0,30,0.0,0.0,1.0,30,900,600,300,0.6666666666666666,12,6,6,420.11634452993064,0.39360632183908045,0.13378995433789953,0.2288693518707832,128496.3348765433,4798.145418224345,133294.48029476765,1341,1,274.5,29,1,18,35.87899543378997,0.6221264367816092,46.527777777777786,1013.8888888888896,34.96168582375481,8
3577,4,0,0,30,0.0,0.0,1.0,30,850,600,250,0.7058823529411765,11,6,5,421.9792947969841,0.39410919540229883,0.04417538066409832,0.22353830281227993,127372.26080246919,4780.555555555564,132152.81635802475,1342,2,275.5,29,1,17,36.98977251880389,0.610632183908046,47.63888888888889,1009.4444444444448,34.80842911877396,8
3578,4,1,0,31,0.03225806451612903,0.0,1.0,31,1000,700,300,0.7,13,7,6,407.3976769895457,0.40192652329749107,0.04492123417103788,0.21837527654781264,127848.07205200208,4217.001512315552,132065.07356431763,1343,0,267.5806451612903,31,0,19,36.86765053002017,0.6098790322580645,47.16796875000001,1011.328125000001,32.623487903225836,0
3579,4,0,0,31,0.0,0.0,1.0,31,900,700,200,0.7777777777777778,11,7,4,404.0183839529523,0.4013440860215054,0.03479820032208236,0.21745366205556413,128012.72922092018,4143.899197048616,132156.6284179688,1344,1,268.5806451612903,31,0,19,36.78375364556527,0.6115591397849462,47.005208333333336,1011.9791666666671,32.64448924731184,0
3580,4,0,0,31,0.0,0.0,1.0,31,1100,800,300,0.7272727272727273,14,8,6,403.01568428779666,0.40116487455197136,0.039829893164609054,0.21744947573474113,128111.57438490131,4126.194763183597,132237.76914808492,1345,2,269.5806451612903,31,0,19,36.70752947481243,0.6125672043010753,46.907552083333336,1012.3697916666671,32.657090053763454,0
3581,4,0,0,31,0.0,0.0,1.0,31,650,400,250,0.6153846153846154,9,4,5,401.3904761221363,0.4007168458781362,0.03769593549216688,0.21692937684515992,128177.49235365118,4089.8449367946996,132267.33729044587,1346,3,270.5806451612903,31,0,19,36.680944880202325,0.613239247311828,46.842447916666664,1012.6302083333327,32.66549059139783,0
3582,4,0,0,31,0.0,0.0,1.0,31,850,700,150,0.8235294117647058,10,7,3,401.9190991336296,0.40116487455197136,0.03476241811095471,0.2177528266893901,128276.40109592032,4111.347113715303,132387.7482096356,1347,4,271.5806451612903,31,0,19,36.56598114824335,0.614247311827957,46.74479166666668,1013.0208333333348,32.678091397849514,0
3583,4,0,0,31,0.0,0.0,1.0,31,500,400,100,0.8,6,4,2,401.0584969820521,0.40089605734767025,0.034492622641587145,0.2174659348444146,128309.37915378154,4091.913350423182,132401.29250420473,1348,5,272.5806451612903,31,0,19,36.55391873366746,0.6145833333333333,46.712239583333336,1013.1510416666673,32.682291666666686,0
3584,4,1,0,32,0.03125,0.0,1.0,32,400,100,300,0.25,7,1,6,389.7525456521705,0.40551495295698925,0.04478116834639767,0.21352700813950215,128720.4610020662,3633.8254706152534,132354.28647268144,1349,0,265.03125,32,0,19,36.419061838994644,0.6162109375,46.30681818181819,1014.7727272727279,31.711647727272748,0
3585,4,0,0,32,0.0,0.0,1.0,32,950,700,250,0.7368421052631579,12,7,5,387.6967069078766,0.405262936827957,0.044758891928864175,0.21308743815763764,128848.620756173,3590.837191358042,132439.45794753105,1350,1,266.03125,32,0,19,36.34005927952576,0.6175130208333333,46.180555555555564,1015.2777777777791,31.727430555555596,0
3586,4,0,0,32,0.0,0.0,1.0,32,1050,900,150,0.8571428571428571,12,9,3,387.5033990794541,0.40515793010752693,0.0384507829977625,0.21384446838088395,129008.91012396698,3598.278236914603,132607.18836088158,1351,2,267.03125,32,0,19,36.18102162565249,0.619140625,46.02272727272727,1015.9090909090912,31.7471590909091,0
3587,4,0,1,31,0.0,0.03125,0.96875,32,650,300,350,0.46153846153846156,10,3,7,389.1684683153564,0.40469590053763443,0.041516525844930596,0.21511180171716954,129073.05377002354,3646.2325272931444,132719.2862973167,1352,3,268.03125,32,0,19,36.07314446653414,0.6197916666666667,45.959595959595966,1016.1616161616167,31.755050505050523,0
3588,4,1,0,32,0.03125,0.0,1.0,32,900,800,100,0.8888888888888888,10,8,2,389.2063624954948,0.4020287298387097,0.052254032774292414,0.21637657633112536,129300.69181654195,3664.994155016622,132965.68597155856,1353,0,268.71875,31,1,20,35.83954785985575,0.6246639784946236,45.735677083333336,1017.0572916666672,32.808299731182814,0
3589,4,2,0,34,0.058823529411764705,0.0,1.0,34,1350,1000,350,0.7407407407407407,17,10,7,372.5090135180225,0.40561868686868685,0.07346758523229147,0.21139315184304955,130106.25608239608,2893.1506211553115,132999.4067035514,1354,0,253.85294117647058,33,1,21,35.44381881881882,0.6278409090909092,44.944852941176464,1020.2205882352932,30.915775401069492,0
3590,4,1,0,35,0.02857142857142857,0.0,1.0,35,1650,1300,350,0.7878787878787878,20,13,7,364.45095367244005,0.4100490196078432,0.07204304808193096,0.19202505433573497,127153.80652873886,2268.3590746347486,129422.1656033736,1355,0,247.57142857142858,33,2,19,38.66595787768329,0.5978535353535354,47.85539215686274,1008.5784313725483,30.562982768865098,8
3591,4,1,0,36,0.027777777777777776,0.0,1.0,36,750,500,250,0.6666666666666666,10,5,5,354.8140920748663,0.4138888888888889,0.06828185176452117,0.18833123460444395,127452.38803854863,1844.380668934227,129296.76870748286,1356,0,241.66666666666666,34,2,18,38.602579973276754,0.5986519607843137,47.5595238095238,1009.7619047619037,29.698879551820696,0
3592,4,1,1,36,0.02702702702702703,0.02702702702702703,0.972972972972973,37,900,800,100,0.8888888888888888,10,8,2,368.34859711469267,0.41801176176176175,0.08970054701091734,0.18789220963102746,125828.57442149664,1883.5489986435873,127712.12342014023,1357,0,236.1081081081081,33,4,18,39.93360917715077,0.584280303030303,49.172794117647065,1003.3088235294126,30.403297682709475,8
3593,4,1,1,36,0.02702702702702703,0.02702702702702703,0.972972972972973,37,850,500,350,0.5882352941176471,12,5,7,377.7049032885189,0.42214089089089085,0.17049395637094955,0.18630612645355038,124432.46384297525,2097.6468865479314,126530.11072952318,1358,0,237.0,32,5,17,41.1470197418375,0.572265625,50.56818181818182,997.7272727272731,31.178977272727284,8
3594,4,5,3,38,0.12195121951219512,0.07317073170731707,0.926829268292683,41,900,700,200,0.7777777777777778,11,7,4,350.30189244322384,0.4388465447154472,0.19203208204588762,0.17803013985813165,125676.58875091317,604.9493750507379,126281.53812596391,1359,0,214.65853658536585,36,5,17,40.54310796645703,0.5763888888888888,49.32432432432433,1002.7027027027035,27.852852852852877,0
3595,4,2,0,40,0.05,0.0,1.0,40,650,500,150,0.7692307692307693,8,5,3,361.7616553052338,0.4334001068376068,0.21995672244662456,0.18406721921431876,125724.42618580669,1096.455305855618,126820.88149166231,1360,0,220.975,35,5,19,40.206409886516646,0.5788690476190477,49.27662037037037,1002.893518518518,28.654100529100514,0
3596,4,4,2,42,0.09090909090909091,0.045454545454545456,0.9545454545454546,44,1700,1200,500,0.7058823529411765,22,12,10,349.94200792765514,0.44256518675123324,0.218728639781272,0.1751846003064079,125050.81817205358,-47.48789262331849,125003.33027943026,1361,0,201.79545454545453,40,4,17,41.19885863306917,0.5630208333333333,49.949186991869915,1000.2032520325196,25.00508130081299,8
3597,4,4,2,44,0.08695652173913043,0.043478260869565216,0.9565217391304348,46,1400,900,500,0.6428571428571429,19,9,10,335.14240246865677,0.4438204508856683,0.25307621285882065,0.17154522181696108,125970.87014001595,-756.3639880415556,125214.50615197439,1362,0,193.8695652173913,42,4,18,40.61997265122265,0.5694444444444444,49.031007751938,1003.8759689922507,23.901808785529777,0
3598,4,3,2,45,0.06382978723404255,0.0425531914893617,0.9574468085106383,47,1400,900,500,0.6428571428571429,19,9,10,328.8553198061934,0.44813829787234044,0.2555963410639137,0.16965183809961062,126293.0091017889,-1093.532167939984,125199.47693384893,1363,0,190.12765957446808,41,6,13,40.44652256875906,0.5741869918699187,48.71031746031746,1005.1587301587306,24.51606658923733,0
3599,4,3,5,43,0.0625,0.10416666666666667,0.8958333333333334,48,1450,1000,450,0.6896551724137931,19,10,9,326.50667819652136,0.44718713061465726,0.2615540455813661,0.1702670676441204,126734.19318361173,-1324.0879139405376,125410.10526967118,1364,0,187.10416666666666,43,5,16,40.052685820872135,0.5758236434108528,48.271780303030305,1006.9128787878792,23.416578576462307,0
3600,4,2,1,44,0.044444444444444446,0.022222222222222223,0.9777777777777777,45,1250,900,350,0.72,16,9,7,319.5015140948115,0.4439393939393939,0.22439628204262596,0.1631208867720873,125865.31351212898,-956.1595066134814,124909.1540055155,1365,0,200.2,40,5,16,41.12104179326177,0.5713541666666666,49.136178861788615,1003.4552845528451,25.086382113821127,8
3601,4,1,1,44,0.022222222222222223,0.022222222222222223,0.9777777777777777,45,800,600,200,0.75,10,6,4,317.5056139258141,0.44414983164983163,0.22935672514619898,0.1627051590034775,126018.32573203795,-997.6948245092049,125020.63090752874,1366,0,201.0888888888889,40,5,17,41.01383265856951,0.5729166666666667,48.98373983739838,1004.0650406504077,25.10162601626019,0
3602,4,4,3,45,0.08333333333333333,0.0625,0.9375,48,850,500,350,0.5882352941176471,12,5,7,304.2398130180414,0.44812906323877066,0.2411928356102877,0.15890797067887075,126799.06274412616,-1884.5327900110233,124914.52995411513,1367,0,189.33333333333334,42,6,15,40.54682990186646,0.5778769841269842,48.20736434108528,1007.1705426356606,23.980251015134776,0
3603,4,0,1,44,0.0,0.022222222222222223,0.9777777777777777,45,1200,700,500,0.5833333333333334,17,7,10,325.7513994252362,0.44396043771043775,0.2504029101625451,0.16831651537753659,126357.83420138898,-767.7517361111065,125590.08246527787,1368,1,202.82222222222222,39,6,15,40.457936179030234,0.5779914529914529,48.645833333333336,1005.4166666666674,25.77991452991455,0
3604,4,1,2,43,0.022222222222222223,0.044444444444444446,0.9555555555555556,45,1150,800,350,0.6956521739130435,15,8,7,330.93637022699653,0.4451388888888889,0.249496935619258,0.1722045312602835,126646.00830078113,-617.6459418402928,126028.36235894084,1369,0,203.37777777777777,39,6,18,40.03167149608471,0.5809294871794872,48.35937499999999,1006.5624999999991,25.809294871794847,0
3605,4,2,0,45,0.044444444444444446,0.0,1.0,45,900,600,300,0.6666666666666666,12,6,6,331.8054042268123,0.4460016835016835,0.2566578163971349,0.17310107083975151,126750.8802625869,-588.6745876736072,126162.20567491329,1370,0,204.13333333333333,39,6,20,39.90218009723801,0.5819978632478633,48.255208333333336,1006.9791666666674,25.81997863247865,0
3606,4,0,0,45,0.0,0.0,1.0,45,1350,900,450,0.6666666666666666,18,9,9,330.99523146994534,0.44608585858585864,0.2568769389865557,0.17301210207104717,126829.56271701398,-604.0039062499948,126225.55881076398,1371,1,205.13333333333333,39,6,20,39.841864874181304,0.5827991452991452,48.177083333333336,1007.2916666666674,25.827991452991473,0
3607,4,2,1,46,0.0425531914893617,0.02127659574468085,0.9787234042553191,47,1400,1000,400,0.7142857142857143,18,10,8,333.856219261241,0.44935245143385755,0.28613972593947556,0.17821793347037254,127681.9159912254,-874.2483844665128,126807.66760675889,1372,0,197.36170212765958,40,7,14,38.8968493380258,0.58984375,47.33231707317073,1010.6707317073165,25.26676829268291,0
3608,4,1,2,45,0.02127659574468085,0.0425531914893617,0.9574468085106383,47,1700,1500,200,0.8823529411764706,19,15,4,327.04305766225843,0.45006552574776443,0.2716733293977951,0.17684205040391007,128198.62349559847,-1012.1963699164198,127186.42712568205,1373,0,188.68085106382978,38,9,17,38.54155677462458,0.5984100877192983,46.821581196581185,1012.7136752136737,26.650359874044046,0
3609,4,1,1,45,0.021739130434782608,0.021739130434782608,0.9782608695652174,46,950,800,150,0.8421052631578947,11,8,3,333.4518789479925,0.44731280193236717,0.27437824297727675,0.1800640146319159,128144.53124999997,-653.993055555557,127490.53819444441,1374,0,193.6304347826087,37,9,18,38.43449931412896,0.5996621621621622,46.875,1012.4999999999998,27.36486486486486,0
3610,4,0,2,43,0.0,0.044444444444444446,0.9555555555555556,45,1050,700,350,0.6666666666666666,14,7,7,308.1849877305924,0.44473905723905727,0.20578350661987366,0.1620322829956549,127067.00685193048,-1150.6100993638358,125916.39675256664,1375,1,198.77777777777777,41,4,19,40.17340270261404,0.5820630081300813,47.941468253968246,1008.2341269841261,24.591076267905514,8
3611,4,1,2,42,0.022727272727272728,0.045454545454545456,0.9545454545454546,44,1100,800,300,0.7272727272727273,14,8,6,316.6609956488862,0.4407813601127555,0.23393514000450488,0.16745697193484754,127302.17013888876,-737.6711506361912,126564.49898825257,1376,0,204.02272727272728,39,5,20,39.719240297274986,0.5876068376068376,47.70833333333333,1009.1666666666656,25.87606837606835,0
3612,4,1,0,43,0.023255813953488372,0.0,1.0,43,1350,900,450,0.6666666666666666,18,9,9,321.3793093115186,0.4419758213362865,0.23494839555294278,0.17122727482586106,127604.23657909641,-398.1277165972695,127206.10886249914,1377,0,194.5581395348837,38,5,18,39.291441965387165,0.5923793859649122,47.409188034188034,1010.3632478632484,26.58850652271706,0
3613,4,2,0,45,0.044444444444444446,0.0,1.0,45,1200,700,500,0.5833333333333334,17,7,10,312.4523700655388,0.44396043771043775,0.24508459076360256,0.1687242798353907,128144.53124999978,-988.7632177295948,127155.76803227019,1378,0,186.86666666666667,37,8,20,38.966049382716044,0.5996621621621622,46.874999999999986,1012.4999999999983,27.36486486486482,0
3614,4,0,1,44,0.0,0.022222222222222223,0.9777777777777777,45,1400,1000,400,0.7142857142857143,18,10,8,346.42533501963584,0.44396043771043775,0.2224162603992339,0.17811161164140868,126153.96684556782,-242.05284318251887,125911.9140023853,1379,1,187.86666666666667,37,8,19,40.14816633922725,0.5793918918918919,48.848684210526315,1004.6052631578943,27.15149359886201,8
3615,4,3,3,44,0.06382978723404255,0.06382978723404255,0.9361702127659575,47,1200,700,500,0.5833333333333334,17,7,10,346.7927274669658,0.4471168670983657,0.2539336961900054,0.18185472293999427,126960.75439453124,-594.1867404513895,126366.56765407984,1380,0,180.7872340425532,39,8,18,39.309323858742445,0.5841346153846154,48.046875,1007.8124999999999,25.84134615384615,0
3616,4,3,1,46,0.06382978723404255,0.02127659574468085,0.9787234042553191,47,1600,900,700,0.5625,23,9,14,342.4482827316172,0.44896700585877275,0.27509244730229376,0.1819197863607141,127486.1992730036,-668.5139973958255,126817.68527560777,1381,0,180.91489361702128,39,8,18,38.88011432009627,0.5894764957264957,47.52604166666667,1009.8958333333344,25.894764957264986,0
3617,4,2,1,47,0.041666666666666664,0.020833333333333332,0.9791666666666666,48,1350,900,450,0.6666666666666666,18,9,9,337.440140394352,0.45114878841607564,0.2901474822552559,0.1814014059268993,127964.52591050332,-963.9264822525945,127000.59942825073,1382,0,178.02083333333334,40,8,21,38.51739319673228,0.5927083333333334,47.0528455284553,1011.7886178861813,25.294715447154534,0
3618,4,1,0,48,0.020833333333333332,0.0,1.0,48,700,400,300,0.5714285714285714,10,4,6,337.70133058853673,0.4525801566193854,0.30000947277254486,0.18273855832725905,128227.80957842791,-939.0800689983823,127288.72950942953,1383,0,176.39583333333334,37,11,22,38.24192107827216,0.6005067567567568,46.79276315789473,1012.8289473684206,27.373755334281636,0
3619,4,4,1,51,0.07692307692307693,0.019230769230769232,0.9807692307692307,52,1450,1000,450,0.6896551724137931,19,10,9,313.1537738215245,0.4575477626948215,0.30955411251999765,0.17377453020306421,129227.86593967007,-2298.9971749119977,126928.86876475807,1384,0,163.75,39,13,22,37.847151077416946,0.6071047008547008,45.807291666666664,1016.7708333333327,26.07104700854699,0
3620,4,1,1,51,0.019230769230769232,0.019230769230769232,0.9807692307692307,52,1450,1200,250,0.8275862068965517,17,12,5,312.65984637968194,0.4564401080945199,0.30912009137815577,0.17396714529331017,129333.80126953128,-2312.502712673611,127021.29855685767,1385,0,164.69230769230768,39,13,23,37.752282812766694,0.6081730769230769,45.703125,1017.1875000000002,26.081730769230774,0
3621,4,0,3,48,0.0,0.058823529411764705,0.9411764705882353,51,1900,1500,400,0.7894736842105263,23,15,8,333.1278724520837,0.4549509803921568,0.23332279957263036,0.17716963992043472,127532.07439456761,-1703.1022775073677,125828.97211706024,1386,1,168.84313725490196,42,9,14,39.068495778971595,0.5853174603174602,47.48062015503876,1010.0775193798447,24.04946474713916,8
3622,4,0,2,46,0.0,0.041666666666666664,0.9583333333333334,48,1050,500,550,0.47619047619047616,16,5,11,348.7168027524095,0.45173057033096925,0.2665587263907523,0.18452851457499173,127328.45187717023,-719.6858723958248,126608.7660047744,1387,3,180.29166666666666,39,9,14,38.883549213885146,0.5878739316239316,47.68229166666667,1009.2708333333342,25.878739316239336,0
3623,4,1,1,46,0.02127659574468085,0.02127659574468085,0.9787234042553191,47,800,600,200,0.75,10,6,4,355.12933534277954,0.4505858772741289,0.29774502766857425,0.18841098234688353,127433.60595703124,-348.91764322916754,127084.68831380206,1388,0,184.91489361702128,39,8,15,38.6138837305272,0.5889423076923077,47.578125,1009.6874999999999,25.889423076923073,0
3624,4,1,0,47,0.02127659574468085,0.0,1.0,47,1050,700,350,0.6666666666666666,14,7,7,351.87245283953644,0.45149167437557813,0.31106832258271555,0.18783529487327913,127681.91599122554,-414.45020738316356,127267.46578384237,1389,0,185.7872340425532,40,7,16,38.44163733869616,0.58984375,47.332317073170735,1010.6707317073177,25.266768292682944,0
3625,4,1,1,47,0.020833333333333332,0.020833333333333332,0.9791666666666666,48,1550,1000,550,0.6451612903225806,21,10,11,348.91746551818414,0.45224770981087475,0.31832128379456726,0.18772514644030902,127997.40780489455,-667.8937751637477,127329.51402973081,1390,0,182.89583333333334,42,6,17,38.1934469660698,0.5900297619047619,47.020348837209305,1011.9186046511629,24.093300110741975,0
3626,4,2,1,48,0.04081632653061224,0.02040816326530612,0.9795918367346939,49,1250,800,450,0.64,17,8,9,343.15494218599713,0.4546308106575964,0.3291222581707087,0.18690134595950264,128487.53390842018,-981.4355254552916,127506.09838296489,1391,0,179.44897959183675,39,10,16,37.83873163464502,0.5996260683760684,46.536458333333336,1013.8541666666671,25.996260683760696,0
3627,4,3,2,49,0.058823529411764705,0.0392156862745098,0.9607843137254902,51,1750,1200,550,0.6857142857142857,23,12,11,340.18642838177664,0.45668300653594773,0.3596645904426041,0.1889155051983588,129257.13320444734,-1397.785346212317,127859.34785823502,1392,0,173.35294117647058,37,14,19,37.13023866005319,0.6109234234234234,45.778508771929815,1016.8859649122792,27.483404457088625,0
3628,4,1,0,50,0.02,0.0,1.0,50,1500,800,700,0.5333333333333333,22,8,14,346.7810632455613,0.45591836734693875,0.35458693244739736,0.19258505541866067,129258.63997443409,-1035.1102791980943,128223.529695236,1393,0,177.38,36,14,20,36.96105574012551,0.6128472222222222,45.77702702702704,1016.8918918918935,28.24699699699704,0
3629,4,0,0,50,0.0,0.0,1.0,50,2350,1900,450,0.8085106382978723,28,19,9,346.56406844489004,0.45594387755102045,0.3556326794567797,0.19300248661654795,129368.6579043552,-1033.094317482301,128335.5635868729,1394,1,178.38,37,13,20,36.8546561759,0.6120495495495495,45.66885964912281,1017.3245614035088,27.49525841631105,0
3630,4,1,2,49,0.0196078431372549,0.0392156862745098,0.9607843137254902,51,1100,900,200,0.8181818181818182,13,9,4,337.9663162775539,0.45687908496732027,0.35529042940013933,0.19021786569775778,129784.51063368047,-1427.4414062500055,128357.06922743047,1395,0,175.86274509803923,39,12,18,36.651076807742115,0.6127136752136753,45.260416666666664,1018.9583333333327,26.127136752136735,0
3631,4,1,1,49,0.02,0.02,0.98,50,1750,1100,650,0.6285714285714286,24,11,13,356.40223837615366,0.45590986394557825,0.3544338807260152,0.19543004255981525,128755.86718990472,-812.2198056132505,127943.64738429147,1396,0,179.64,37,13,12,37.22900460962258,0.6058558558558558,46.27192982456141,1014.9122807017555,27.430061640587986,8
3632,4,0,0,49,0.0,0.0,1.0,49,1750,1200,550,0.6857142857142857,23,12,11,351.1121436327362,0.454453656462585,0.30458004307250497,0.18802830081516314,127810.33631601585,-740.0139725186773,127070.32234349717,1397,1,183.81632653061226,40,9,17,38.329355108877714,0.5911458333333333,47.20528455284554,1011.1788617886199,25.2794715447155,8
3633,4,0,1,48,0.0,0.02040816326530612,0.9795918367346939,49,1150,800,350,0.6956521739130435,15,8,7,350.73679798558095,0.45376275510204084,0.30856767570547006,0.188473644249483,127948.38543544573,-824.7585969893535,127123.62683845637,1398,2,184.81632653061226,42,7,17,38.19757047536952,0.5895337301587302,47.06879844961241,1011.7248062015516,24.088685861941705,0
3634,4,1,0,49,0.02040816326530612,0.0,1.0,49,1000,600,400,0.6,14,6,8,356.1448966112885,0.45370960884353745,0.3209876543209873,0.19231824417009605,128144.53125000016,-672.3958333333204,127472.13541666685,1399,0,185.6122448979592,42,7,20,37.86008230452676,0.5915178571428572,46.87500000000001,1012.5000000000013,24.107142857142886,0
3635,4,0,0,49,0.0,0.0,1.0,49,1700,1100,600,0.6470588235294118,23,11,12,353.03586086457005,0.45310728458049887,0.3080102537607059,0.1918348302158272,128394.44739006224,-734.431147083729,127660.01624297851,1400,1,186.6122448979592,37,12,15,37.683359479245546,0.6021959459459459,46.628289473684205,1013.4868421052626,27.391536273115204,0
3636,4,0,2,47,0.0,0.04081632653061224,0.9591836734693877,49,1500,1100,400,0.7333333333333333,19,11,8,356.6476161229868,0.45303642290249435,0.2749278513767046,0.19019423846318803,127641.65200477795,-681.8890855581873,126959.76291921976,1401,2,187.6122448979592,43,6,17,38.36224736825664,0.5850290697674418,47.37215909090909,1010.5113636363641,23.50026427061312,8
3637,4,0,0,47,0.0,0.0,1.0,47,1750,1400,350,0.8,21,14,7,361.8890650817632,0.4521276595744681,0.2801293135854446,0.19323510456252635,127692.92091836732,-157.865646258509,127535.05527210882,1402,3,192.87234042553192,41,6,18,38.17726737338045,0.5884146341463414,47.32142857142857,1010.7142857142854,24.651567944250864,0
3638,4,0,2,45,0.0,0.0425531914893617,0.9574468085106383,47,1850,1400,450,0.7567567567567568,23,14,9,361.8115920504211,0.4518578476719087,0.2844586529552684,0.19415952592347882,127893.5382023181,-145.32706601157548,127748.21113630652,1403,4,193.87234042553192,41,6,19,37.973633451026565,0.5904471544715447,47.12301587301588,1011.5079365079376,24.670925280681406,0
3639,4,0,0,45,0.0,0.0,1.0,45,1700,1300,400,0.7647058823529411,21,13,8,372.61144511650053,0.449810606060606,0.2880110787237129,0.19941426936331724,127784.64708713404,522.8044029678167,128307.45149010186,1404,5,202.22222222222223,40,5,19,37.812217308272174,0.5908854166666666,47.23069105691057,1011.0772357723583,25.276930894308958,0
3640,4,1,0,46,0.021739130434782608,0.0,1.0,46,1200,800,400,0.6666666666666666,16,8,8,366.22244481308854,0.45009057971014493,0.302394299457303,0.1985440077063606,128302.78320312545,198.48391721821645,128501.26712034366,1405,0,198.80434782608697,39,7,20,37.44302213996846,0.5977564102564102,46.71875000000002,1013.1250000000036,25.977564102564195,0
3641,4,1,4,43,0.02127659574468085,0.0851063829787234,0.9148936170212766,47,1300,1000,300,0.7692307692307693,16,10,6,383.2839096644139,0.45023897625655257,0.3394163148246325,0.2110278848086223,128917.41569378368,482.3942221891946,129399.80991597287,1406,0,195.5531914893617,40,7,16,36.38171720204142,0.60234375,46.11280487804879,1015.5487804878067,25.388719512195166,0
3642,4,0,0,43,0.0,0.0,1.0,43,800,500,300,0.625,11,5,6,398.34829338456524,0.446359357696567,0.34291142485210657,0.21812515425921686,128700.2310807171,1653.5034818405632,130353.73456255767,1407,1,202.8139534883721,37,6,16,36.221723939197474,0.6052927927927928,46.32675438596491,1014.6929824561399,27.424134660976755,0
3643,4,0,0,43,0.0,0.0,1.0,43,850,500,350,0.5882352941176471,12,5,7,402.6647793192579,0.44615171650055374,0.3449507726396872,0.22095245181733056,128783.68975309699,1771.331202870102,130555.02095596709,1408,2,203.8139534883721,37,6,16,36.0266780094343,0.6061373873873874,46.244517543859644,1015.0219298245604,27.433025130393524,0
3644,4,1,1,43,0.022727272727272728,0.022727272727272728,0.9772727272727273,44,1100,900,200,0.8181818181818182,13,9,4,397.37187800869214,0.44694767441860467,0.3462988446432156,0.21990684557863216,129119.93805473365,1461.7264546350966,130581.66450936874,1409,0,200.1590909090909,38,6,17,35.816777041942586,0.6077302631578947,45.91346153846153,1016.3461538461532,26.745951417004033,0
3645,4,0,0,43,0.0,0.0,1.0,43,1000,600,400,0.6,14,6,8,396.7892754700884,0.44665928386858617,0.3402156762899069,0.21988244906653806,129173.52123970813,1650.9335805247495,130824.45482023289,1410,1,204.72093023255815,37,6,17,35.77677255240354,0.6100788288288288,45.860745614035075,1016.5570175438577,27.47451398767183,0
3646,4,0,1,42,0.0,0.023255813953488372,0.9767441860465116,43,1150,800,350,0.6956521739130435,15,8,7,392.00696762955465,0.44631321520856404,0.3344802465676662,0.21807358118802278,129326.01042868115,1539.3514596852108,130865.36188836636,1411,2,205.72093023255815,33,10,18,35.74246987951807,0.619949494949495,45.71078431372548,1017.156862745097,30.82293523469991,0
3647,4,0,1,41,0.0,0.023809523809523808,0.9761904761904762,42,1100,800,300,0.7272727272727273,14,8,6,392.3425751197564,0.44696089818041035,0.3274928284566845,0.21826027972479722,129326.01042868115,1748.019992310634,131074.0304209918,1412,3,209.38095238095238,33,9,18,35.73393574297188,0.619949494949495,45.71078431372548,1017.156862745097,30.82293523469991,0
3648,4,2,1,42,0.046511627906976744,0.023255813953488372,0.9767441860465116,43,950,600,350,0.631578947368421,13,6,7,382.17901839975104,0.4458287190845331,0.31901140374473247,0.21506050088648687,129776.9292091835,1319.6038832199308,131096.53309240344,1413,0,204.32558139534885,34,9,16,35.53252911165633,0.6222426470588236,45.26785714285713,1018.92857142857,29.96848739495794,0
3649,4,0,0,42,0.0,0.0,1.0,42,1450,1000,450,0.6896551724137931,19,10,9,388.3807229138787,0.44480739450251644,0.3267416818310829,0.21821233394445533,129716.28578514719,1675.8609693877343,131392.14675453492,1414,1,210.1904761904762,34,8,16,35.43638736317246,0.6216299019607843,45.32738095238094,1018.6904761904746,29.961484593837486,0
3650,4,0,0,42,0.0,0.0,1.0,42,1500,1000,500,0.6666666666666666,20,10,10,368.87050449206345,0.44434765776229196,0.2545897240883934,0.20278880905490504,128858.1486892297,1106.394062981893,129964.5427522116,1415,2,211.1904761904762,36,6,16,36.8081743566992,0.6087962962962963,46.17117117117117,1015.3153153153148,28.203203203203188,7
3651,4,1,0,43,0.023255813953488372,0.0,1.0,43,1800,1600,200,0.8888888888888888,20,16,4,359.66619465580226,0.44539036544850497,0.255255030946794,0.19959594785170473,129230.01284646119,696.389928780117,129926.40277524131,1416,0,207.25581395348837,36,7,19,36.662651825598985,0.6125578703703703,45.80518018018017,1016.7792792792782,28.243868868868837,0
3652,4,2,2,43,0.044444444444444446,0.044444444444444446,0.9555555555555556,45,1700,1300,400,0.7647058823529411,21,13,8,346.8986897380735,0.4484638047138047,0.2522232712099495,0.19464303762643023,129663.42872242288,-3.98529384910114,129659.44342857378,1417,0,199.0,38,7,16,36.54651386412112,0.6132127192982456,45.37927350427349,1018.4829059829041,26.802181736392214,0
3653,4,0,1,42,0.0,0.023255813953488372,0.9767441860465116,43,1700,1200,500,0.7058823529411765,22,12,10,361.12271989058104,0.44405223329641935,0.2579992535488602,0.20127968995752002,129401.82317029868,745.9876684116542,130147.81083871034,1418,2,209.25581395348837,36,7,19,36.4506087437742,0.6142939814814814,45.63626126126126,1017.454954954955,28.26263763763764,0
3654,4,1,0,43,0.023255813953488372,0.0,1.0,43,1300,900,400,0.6923076923076923,17,9,8,361.98533199880717,0.4431755260243632,0.2864833472211703,0.19226556561182293,127479.27847991674,629.1257887041962,128108.40426862094,1419,0,209.72093023255815,37,6,14,38.3939558450959,0.5929054054054055,47.532894736842096,1009.8684210526302,27.293741109530547,8
3655,4,0,1,42,0.0,0.023255813953488372,0.9767441860465116,43,1750,1200,550,0.6857142857142857,23,12,11,360.77612688190493,0.4431755260243632,0.28636986664445385,0.19201793512206736,127562.34039560235,604.289420783306,128166.62981638566,1420,1,210.72093023255815,37,6,14,38.339280545605845,0.59375,47.450657894736835,1010.1973684210515,27.302631578947338,0
3656,4,2,0,44,0.045454545454545456,0.0,1.0,44,1200,800,400,0.6666666666666666,16,8,8,359.4292092572403,0.44434901338971106,0.3214496633725743,0.19436113446720546,128200.04712988604,417.09384137425934,128617.14097126029,1421,0,206.79545454545453,37,7,16,37.72015302439728,0.6002252252252251,46.820175438596486,1012.7192982456133,27.370791844476038,0
3657,4,1,0,45,0.022222222222222223,0.0,1.0,45,1450,1200,250,0.8275862068965517,17,12,5,368.7947317499454,0.4473905723905724,0.3065822470515207,0.19347672034947322,126978.48820103897,386.1543195372278,127364.64252057619,1422,0,203.17777777777778,36,9,17,38.73673184357544,0.5896990740740741,48.02927927927929,1007.8828828828837,27.99674674674677,8
3658,4,1,0,46,0.021739130434782608,0.0,1.0,46,1250,900,350,0.72,16,9,7,362.992915982044,0.4494162640901771,0.3080662993867118,0.19174861153081343,127257.91229032015,38.744132810102485,127296.65642313025,1423,0,199.7391304347826,37,9,19,38.59577628051872,0.5906531531531531,47.752192982456144,1008.9912280701758,27.270033191085833,0
3659,4,1,0,47,0.02127659574468085,0.0,1.0,47,1100,800,300,0.7272727272727273,14,8,6,356.8083713019862,0.4518385753931545,0.3102007930899451,0.18972251643920005,127523.29082657608,-299.72445941997296,127223.5663671561,1424,0,196.46808510638297,38,9,16,38.479523658416184,0.5915570175438596,47.48931623931624,1010.042735042735,26.580071974808817,0
3660,4,1,0,48,0.020833333333333332,0.0,1.0,48,700,400,300,0.5714285714285714,10,4,6,387.7105806453273,0.4527279107565012,0.34902083787911886,0.19987374478037515,126264.14497730063,249.73801205255614,126513.8829893532,1425,0,193.35416666666666,37,11,19,38.997381627754756,0.5805180180180181,48.739035087719294,1005.0438596491222,27.163347558084382,8
3661,4,1,0,49,0.02040816326530612,0.0,1.0,49,1300,900,400,0.6923076923076923,17,9,8,378.4365532079702,0.45459537981859416,0.35181828223170863,0.19712590607400235,126688.35521449693,-211.29910420777014,126477.05611028915,1426,0,190.3877551020408,38,11,16,38.792714634405186,0.5830592105263157,48.317307692307686,1006.7307692307683,26.49291497975706,0
3662,4,3,2,50,0.057692307692307696,0.038461538461538464,0.9615384615384616,52,1300,700,600,0.5384615384615384,19,7,12,360.83295801909134,0.4587496857717446,0.3632541589229874,0.19195408456376084,127542.56129535129,-1195.688066893437,126346.87322845786,1427,0,180.34615384615384,41,11,17,38.3581319976429,0.586890243902439,47.47023809523809,1010.1190476190461,24.637049941927955,0
3663,4,0,0,50,0.0,0.0,1.0,50,1750,1000,750,0.5714285714285714,25,10,15,366.90302693635675,0.4564965986394558,0.36504950495049493,0.19503792484511617,127512.50000000013,-643.0555555555416,126869.44444444458,1428,1,187.76,39,11,19,38.23569856985699,0.5897435897435898,47.50000000000001,1010.000000000001,25.897435897435923,0
3664,4,0,0,50,0.0,0.0,1.0,50,900,400,500,0.4444444444444444,14,4,10,373.39329524579665,0.4557312925170068,0.3726950427702771,0.19939654065877654,127696.68104383699,-463.7830946180351,127232.89794921895,1429,2,188.76,39,11,19,37.8827209797657,0.5916132478632479,47.31770833333334,1010.7291666666681,25.916132478632516,0
3665,4,0,1,49,0.0,0.02,0.98,50,1600,1200,400,0.75,20,12,8,370.603554092631,0.45545068027210883,0.3709993818256745,0.19829537464294816,127775.65646701407,-529.1775173610934,127246.47894965297,1430,3,189.76,39,11,19,37.87219245827323,0.5924145299145299,47.23958333333334,1011.0416666666681,25.924145299145337,0
3666,4,1,1,49,0.02,0.02,0.98,50,1150,500,650,0.43478260869565216,18,5,13,364.59451214331904,0.4559013605442177,0.37105528672912547,0.19597711657155834,127960.02739800357,-669.2952473958242,127290.73215060774,1431,0,190.12,39,11,20,37.83513933216649,0.594284188034188,47.05729166666667,1011.7708333333342,25.942841880341902,0
3667,4,1,2,48,0.02,0.04,0.96,50,1250,800,450,0.64,17,8,9,397.9158220975672,0.45621598639455785,0.39952161913523465,0.20695430555983496,126625.62157064464,206.1033816658031,126831.72495231044,1432,0,190.86,35,15,17,38.36725697638762,0.5880952380952381,48.379629629629626,1006.4814814814808,28.75661375661374,8
3668,4,2,1,49,0.04,0.02,0.98,50,1600,900,700,0.5625,23,9,14,361.43695635910996,0.4588945578231292,0.30660795627087745,0.18510293892543528,125992.81724048183,-839.5815852495739,125153.23565523226,1433,0,185.78,40,10,18,39.937409319431794,0.57265625,49.00914634146341,1003.9634146341461,25.099085365853654,8
3669,4,4,1,52,0.07547169811320754,0.018867924528301886,0.9811320754716981,53,1250,1000,250,0.8,15,10,5,343.22793534992024,0.46312590711175616,0.32336204566821847,0.17966007133363815,126887.15071220817,-1889.7260641813955,124997.42464802678,1434,0,176.0754716981132,40,13,18,39.47469067312218,0.5817708333333333,48.11991869918698,1007.5203252032506,25.188008130081265,0
3670,4,1,0,53,0.018867924528301886,0.0,1.0,53,1700,1400,300,0.8235294117647058,20,14,6,342.60975954133016,0.46295960328979197,0.33352238288185565,0.18035916705381266,127118.2739257811,-1889.4425018409538,125228.83142394015,1435,0,177.0566037735849,39,14,19,39.25311176531349,0.5857371794871795,47.89062499999999,1008.4374999999989,25.857371794871767,0
3671,4,0,0,53,0.0,0.0,1.0,53,1650,900,750,0.5454545454545454,24,9,15,342.74042662042893,0.46285377358490565,0.33519940607834453,0.1806617066393907,127170.8021375866,-1882.685004340298,125288.1171332463,1436,1,178.0566037735849,39,14,21,39.19594908602707,0.5862713675213675,47.83854166666666,1008.6458333333317,25.862713675213634,0
3672,4,2,0,55,0.03636363636363636,0.0,1.0,55,1850,1200,650,0.6486486486486487,25,12,13,333.5827985889505,0.46433782267115603,0.34638341625785296,0.17838387174159492,127752.38985224729,-2476.800053332154,125275.58979891513,1437,0,172.54545454545453,42,13,19,38.83171187577875,0.5875496031746033,47.262596899224796,1010.9496124030994,24.07022886674046,0
3673,4,5,3,57,0.08333333333333333,0.05,0.95,60,1550,1000,550,0.6451612903225806,21,10,11,305.1957071705696,0.466713747645951,0.3551245347838534,0.1678816701018587,128881.41605259635,-4130.184390210892,124751.23166238546,1438,0,159.08333333333334,42,18,17,38.40080955561918,0.5989583333333333,46.148255813953504,1015.4069767441889,24.176356589147353,0
3674,4,0,1,56,0.0,0.017543859649122806,0.9824561403508771,57,1800,1300,500,0.7222222222222222,23,13,10,326.6316778364717,0.46557800751879697,0.36095651577575816,0.17797947841477252,128504.9214773782,-3005.244377519956,125499.67709985825,1439,1,168.3684210526316,40,17,17,38.23982660118275,0.5981770833333333,46.51930894308945,1013.9227642276448,25.34806910569112,0
3675,4,0,1,55,0.0,0.017857142857142856,0.9821428571428571,56,1300,1100,200,0.8461538461538461,15,11,4,326.5351115787206,0.46520562770562773,0.3569699615787636,0.17845117669120386,128622.09590143955,-2800.073912666891,125822.02198877266,1440,2,171.33928571428572,41,15,18,38.12296251018746,0.5978150406504066,46.403769841269856,1014.3849206349228,24.741095625242018,0
3676,4,1,0,56,0.017857142857142856,0.0,1.0,56,1200,700,500,0.5833333333333334,17,7,10,329.23349472398735,0.46497564935064933,0.3654482614160035,0.18049617636797405,128747.91843820877,-2722.3745748299148,126025.54386337886,1441,0,172.26785714285714,41,15,19,37.92644183773217,0.5990853658536586,46.27976190476191,1014.8809523809537,24.753193960511066,0
3677,4,1,1,56,0.017543859649122806,0.017543859649122806,0.9824561403508771,57,1600,1100,500,0.6875,21,11,10,323.6672695220949,0.46596961152882205,0.3629489476528167,0.17892981842267852,129078.27546609288,-3044.317405053772,126033.9580610391,1442,0,170.2280701754386,42,15,20,37.731834652426805,0.6009424603174602,45.95445736434109,1016.1821705426364,24.194813584348488,0
3678,4,2,0,58,0.034482758620689655,0.0,1.0,58,2350,1700,650,0.723404255319149,30,17,13,318.11615289331303,0.46748336358136716,0.36765931141989494,0.17822839483062008,129605.14298311899,-3353.9847355573947,126251.1582475616,1443,0,167.1206896551724,41,17,14,37.33843206027539,0.6077235772357723,45.43650793650793,1018.2539682539667,24.83546264034065,0
3679,4,0,2,56,0.0,0.034482758620689655,0.9655172413793104,58,1600,700,900,0.4375,25,7,18,321.8884811993317,0.46746445856019364,0.30007487832272584,0.17299077128438906,127952.84162649201,-3359.36426663566,124593.47735985635,1444,1,168.1206896551724,43,15,16,38.92268813178583,0.5881782945736433,47.06439393939393,1011.7424242424228,23.52889358703309,8
3680,4,2,4,54,0.034482758620689655,0.06896551724137931,0.9310344827586207,58,1100,400,700,0.36363636363636365,18,4,14,321.9448725588329,0.466304950594878,0.3142276379540727,0.17488563177693384,128381.94580078124,-3333.044243034035,125048.9015577472,1445,0,168.20689655172413,39,19,14,38.483849830403955,0.5985576923076923,46.640625,1013.4374999999999,25.98557692307692,0
3681,4,0,2,52,0.0,0.037037037037037035,0.962962962962963,54,1600,1000,600,0.625,22,10,12,336.95055685972943,0.4647027137200093,0.33214933923203516,0.1818419120904153,128120.00480740298,-2165.9786070549067,125954.02620034807,1446,1,180.11111111111111,42,12,18,38.3709800918836,0.5912698412698413,46.89922480620153,1012.4031007751903,24.104835732742625,0
3682,4,0,0,52,0.0,0.0,1.0,52,1950,1300,650,0.6666666666666666,26,13,13,348.9269524670404,0.46276395173453994,0.35010179989050094,0.18855475700622765,128173.03790276762,-1455.3851097691963,126717.65279299843,1447,2,187.55769230769232,36,16,19,38.013651023131665,0.6018518518518519,46.846846846846844,1012.6126126126126,28.128128128128125,0
3683,4,3,3,52,0.05454545454545454,0.05454545454545454,0.9454545454545454,55,2150,1400,750,0.6511627906976745,29,14,15,324.3664540961721,0.46475869809203146,0.33918652147412254,0.1785891997676611,128917.41569378354,-2636.7030000330415,126280.7126937505,1448,0,178.27272727272728,40,15,17,37.87755595583574,0.60234375,46.112804878048784,1015.5487804878055,25.388719512195138,0
3684,4,0,1,51,0.0,0.019230769230769232,0.9807692307692307,52,1050,700,350,0.6666666666666666,14,7,7,341.50187527687683,0.46184483408748117,0.34933124833643925,0.18621517350003258,128533.39489073533,-1621.1209218221306,126912.2739689132,1449,1,189.34615384615384,37,15,17,37.833855968858146,0.6036036036036037,46.491228070175424,1014.035087719296,27.406353722143137,0
3685,4,0,0,51,0.0,0.0,1.0,51,1000,700,300,0.7,13,7,6,342.9957013825068,0.4602941176470588,0.3528279496140492,0.18707912119621264,128543.91289515857,-1381.9980876146524,127161.91480754392,1450,2,193.62745098039215,36,15,18,37.7852581898945,0.6056134259259259,46.48085585585585,1014.0765765765758,28.16879379379377,0
3686,4,1,1,51,0.019230769230769232,0.019230769230769232,0.9807692307692307,52,1750,1300,450,0.7428571428571429,22,13,9,333.5388448653119,0.4596138134741076,0.3564690463091811,0.18394938149532383,128984.24373584616,-1795.748867704015,127188.49486814215,1451,0,190.8846153846154,38,14,19,37.57668980507642,0.606359649122807,46.04700854700854,1015.8119658119647,26.731893837156964,0
3687,4,1,1,51,0.019230769230769232,0.019230769230769232,0.9807692307692307,52,1350,1000,350,0.7407407407407407,17,10,7,334.07406223436374,0.4588989441930618,0.362618702052665,0.18565230241004888,129285.00987082534,-1761.663684900982,127523.34618592435,1452,0,191.34615384615384,37,15,21,37.25730008984725,0.611204954954955,45.751096491228054,1016.9956140350853,27.486367946894198,0
3688,4,0,2,49,0.0,0.0392156862745098,0.9607843137254902,51,1350,800,550,0.5925925925925926,19,8,11,343.1517678310993,0.45733660130718956,0.3663575261814205,0.19084647580360142,129315.9037415794,-1325.0038044801552,127990.89993709924,1453,1,195.52941176470588,36,15,22,36.99508229997047,0.6134259259259259,45.72072072072072,1017.117117117117,28.25325325325325,0
3689,4,0,0,49,0.0,0.0,1.0,49,1450,1000,450,0.6896551724137931,19,10,9,345.11433154358394,0.4570578231292517,0.3558642986043854,0.19181022335695588,129289.65627411267,-876.0573398919742,128413.59893422069,1454,2,196.69387755102042,35,14,22,36.97187606691703,0.6151785714285714,45.74652777777778,1017.013888888889,29.057539682539687,0
3690,4,0,0,49,0.0,0.0,1.0,49,1800,1200,600,0.6666666666666666,24,12,12,343.4049672665784,0.4567389455782313,0.3509702755206481,0.19171808743968421,129466.28146701398,-908.1271701388781,128558.1542968751,1455,3,197.69387755102042,35,14,17,36.83576424428522,0.6169642857142856,45.57291666666667,1017.708333333334,29.077380952380974,0
3691,4,0,0,49,0.0,0.0,1.0,49,1550,1200,350,0.7741935483870968,19,12,7,360.3083125400923,0.45629606009070295,0.31717347178702204,0.1947129927869138,128174.66695011326,-497.8737067743914,127676.79324333886,1456,4,198.69387755102042,34,15,19,37.723861587898746,0.6060049019607843,46.84523809523809,1012.6190476190466,29.782913165266077,8
3692,4,0,1,48,0.0,0.02040816326530612,0.9795918367346939,49,1300,800,500,0.6153846153846154,18,8,10,360.3151207514171,0.4561189058956916,0.3149010044624123,0.19545200718389472,128325.39859693861,-552.4837018140782,127772.91489512453,1457,5,199.69387755102042,34,15,19,37.56951787882349,0.6075367647058824,46.69642857142856,1013.2142857142844,29.800420168067188,0
3693,4,1,2,47,0.02040816326530612,0.04081632653061224,0.9591836734693877,49,1150,600,550,0.5217391304347826,17,6,11,360.0740498357186,0.4545599489795918,0.32046688317135397,0.19591249420774073,128446.04768990926,-549.9822845805074,127896.06540532876,1458,0,200.48979591836735,34,15,16,37.452290076335856,0.6087622549019608,46.57738095238095,1013.6904761904759,29.814425770308116,0
3694,4,2,1,48,0.04081632653061224,0.02040816326530612,0.9795918367346939,49,1000,600,400,0.6,14,6,8,358.90935751337133,0.45565830498866217,0.33165600473260537,0.1961684820635943,128627.12762188195,-566.9040532879949,128060.22356859397,1459,0,201.0408163265306,34,15,17,37.296825489965975,0.6106004901960784,46.39880952380952,1014.4047619047609,29.835434173669437,0
3695,4,2,0,50,0.04,0.0,1.0,50,1800,1300,500,0.7222222222222222,23,13,10,353.5979076505033,0.4560459183673469,0.33272727272727276,0.1952127316576174,129024.94454089503,-875.4099151234606,128149.53462577157,1460,0,197.98,35,15,19,37.02580314422419,0.6125,46.00694444444444,1015.972222222222,29.02777777777777,0
3696,4,0,0,50,0.0,0.0,1.0,50,2050,1800,250,0.8780487804878049,23,18,5,349.12337894087517,0.45532312925170065,0.3291581781992743,0.19375326702625162,129231.64859693867,-976.3214718757963,128255.32712506287,1461,1,198.98,34,16,22,36.92897982281545,0.6167279411764706,45.80357142857142,1016.7857142857134,29.905462184873926,0
3697,4,0,1,49,0.0,0.02,0.98,50,2000,1500,500,0.75,25,15,10,356.8945273683049,0.45511054421768704,0.25852340688801867,0.1899650453577289,127565.1095920138,-856.2201052295962,126708.8894867842,1462,2,199.98,39,11,15,38.434471024953616,0.5902777777777778,47.447916666666664,1010.2083333333326,25.902777777777757,8
3698,4,1,2,48,0.02,0.04,0.96,50,1550,1100,450,0.7096774193548387,20,11,9,359.25215723161483,0.4550765306122449,0.27368215058193446,0.1925996242165513,127854.65630425328,-813.5877821180813,127041.0685221352,1463,0,200.92,39,11,16,38.078179180828776,0.593215811965812,47.16145833333332,1011.354166666665,25.932158119658077,0
3699,4,1,0,49,0.02040816326530612,0.0,1.0,49,1250,900,350,0.72,16,9,7,361.4983393013235,0.45328443877551017,0.29377496061261166,0.19415926119366012,127928.27641034761,-550.8281055957441,127377.44830475186,1464,0,205.71428571428572,38,11,18,37.94597282359983,0.5956688596491229,47.08867521367521,1011.6452991452982,26.62224471434995,0
3700,4,0,0,49,0.0,0.0,1.0,49,1400,900,500,0.6428571428571429,19,9,10,369.9213502878763,0.4528061224489796,0.2633853541416564,0.19251009045593526,126650.14716066464,-378.6255111824468,126271.5216494822,1465,1,206.71428571428572,37,12,17,39.04638707334784,0.5844594594594594,48.355263157894726,1006.5789473684196,27.204836415362692,8
3701,4,6,4,51,0.10909090909090909,0.07272727272727272,0.9272727272727272,55,1050,700,350,0.6666666666666666,14,7,7,337.5163000220155,0.4603956228956229,0.29554807332585153,0.18225880201188854,128144.53125000012,-2338.7532702369836,125805.77797976314,1466,0,185.05454545454546,39,16,17,38.33161865569275,0.5961538461538461,46.87500000000001,1012.5000000000009,25.961538461538485,0
3702,4,0,1,50,0.0,0.0196078431372549,0.9803921568627451,51,1500,900,600,0.6,21,9,12,356.3226386544841,0.45859477124183007,0.3137339950076752,0.19082505073586853,127811.68845221624,-1091.560383964279,126720.12806825197,1467,1,199.84313725490196,37,14,20,38.19625171690883,0.5962837837837838,47.20394736842106,1011.1842105263172,27.329302987197764,0
3703,4,1,2,49,0.0196078431372549,0.0392156862745098,0.9607843137254902,51,1150,1000,150,0.8695652173913043,13,10,3,348.2126230317237,0.4602941176470588,0.29503045808210304,0.1875280374064538,128036.38100162554,-1283.2231855869509,126753.1578160386,1468,0,193.11764705882354,38,13,21,38.171425806678634,0.596765350877193,46.981837606837615,1012.0726495726508,26.633490778227653,0
3704,4,1,0,50,0.02,0.0,1.0,50,1450,700,750,0.4827586206896552,22,7,15,348.1908028074494,0.46022959183673473,0.30317714533059137,0.18893900227502292,128338.88942992066,-1062.6701544989528,127276.21927542171,1469,0,187.92,37,13,22,37.8628530462071,0.6016328828828829,46.68311403508771,1013.2675438596484,27.38560929350401,0
3705,4,2,3,49,0.038461538461538464,0.057692307692307696,0.9423076923076923,52,1300,800,500,0.6153846153846154,18,8,10,340.17716481118987,0.46101998491704377,0.32297911276582414,0.1876361827623711,128989.67013888877,-1624.1319444444512,127365.53819444432,1470,0,181.65384615384616,39,13,17,37.402584085315866,0.6047008547008548,46.041666666666664,1015.8333333333323,26.04700854700852,0
3706,4,0,2,47,0.0,0.04081632653061224,0.9591836734693877,49,1300,700,600,0.5384615384615384,19,7,12,355.05438800003316,0.46008715986394555,0.33926222735350375,0.19505273051921396,128829.56594685909,-651.6994612856023,128177.86648557348,1471,1,191.89795918367346,36,13,17,37.18801996672214,0.6085069444444444,46.19932432432433,1015.2027027027033,28.20007507507509,0
3707,4,0,1,46,0.0,0.02127659574468085,0.9787234042553191,47,1250,900,350,0.72,16,9,7,362.10848757255013,0.45802497687326554,0.33918292083469503,0.19882157588738797,128808.3351048753,-71.48171768707618,128736.85338718822,1472,2,197.27659574468086,34,13,18,37.03065751925256,0.6124387254901961,46.220238095238095,1015.1190476190477,29.856442577030815,0
3708,4,0,0,46,0.0,0.0,1.0,46,1500,1000,500,0.6666666666666666,20,10,10,371.99263375584076,0.45743760064412237,0.34650531876918644,0.2040932558173937,128778.125,380.9027777777773,129159.02777777778,1473,3,202.43478260869566,34,12,19,36.810686918445526,0.6121323529411764,46.25,1015.0,29.852941176470587,0
3709,4,0,1,45,0.0,0.021739130434782608,0.9782608695652174,46,2150,1500,650,0.6976744186046512,28,15,13,367.3899220181197,0.4579106280193237,0.33660732859817566,0.20282696449528617,129024.94454089488,280.4928626543048,129305.4374035492,1474,4,203.43478260869566,35,11,21,36.6754955570745,0.6125,46.006944444444436,1015.9722222222207,29.027777777777732,0
3710,4,0,0,45,0.0,0.0,1.0,45,1200,700,500,0.5833333333333334,17,7,10,368.9471871729028,0.457807239057239,0.3282175899558295,0.20383809667658323,129054.3435597777,522.8474097650603,129577.19096954276,1475,5,203.35555555555555,35,10,21,36.605939362873535,0.612797619047619,45.978009259259245,1016.0879629629609,29.031084656084598,0
3711,4,0,0,45,0.0,0.0,1.0,45,800,500,300,0.625,11,5,6,370.03301833086664,0.4573442760942761,0.32841221045707036,0.20504731861198738,129171.97312510703,559.5790198473798,129731.55214495442,1476,6,204.35555555555555,35,10,21,36.458333333333336,0.6139880952380952,45.86226851851851,1016.5509259259248,29.04431216931214,0
3712,4,1,0,46,0.021739130434782608,0.0,1.0,46,1400,1000,400,0.7142857142857143,18,10,8,365.88413937822526,0.4571759259259259,0.333616341969333,0.2047801806258232,129564.73922902481,281.1433192747082,129845.88254829952,1477,0,200.8913043478261,34,12,16,36.16356797630184,0.6200980392156863,45.47619047619047,1018.095238095237,29.943977591036383,0
3713,4,1,1,46,0.02127659574468085,0.02127659574468085,0.9787234042553191,47,1350,900,450,0.6666666666666666,18,9,9,360.12599267245963,0.45709990749306195,0.33794257806933437,0.20348620073455395,129937.87140185611,-41.19901513203342,129896.67238672408,1478,0,197.59574468085106,35,12,17,35.93070060922542,0.6217261904761905,45.1099537037037,1019.560185185185,29.130291005291,0
3714,4,0,1,45,0.0,0.021739130434782608,0.9782608695652174,46,650,400,250,0.6153846153846154,9,4,5,374.6197602709527,0.4568538647342995,0.31024910812505735,0.1953473447824734,126732.14994331071,318.7498742423966,127050.8998175531,1479,1,201.8913043478261,34,12,16,38.84364901079843,0.5912990196078431,48.273809523809526,1006.9047619047623,29.61484593837536,8
3715,4,2,1,46,0.0425531914893617,0.02127659574468085,0.9787234042553191,47,1050,600,450,0.5714285714285714,15,6,9,364.223294188372,0.4602027443724946,0.30935432747838254,0.1917509101065428,127121.19187510716,-139.900146819275,126981.29172828789,1480,0,189.4468085106383,35,12,18,38.70521538696967,0.5931547619047619,47.88773148148148,1008.449074074074,28.812830687830687,0
3716,4,1,1,46,0.02127659574468085,0.02127659574468085,0.9787234042553191,47,650,400,250,0.6153846153846154,9,4,5,362.989704596064,0.46118563058896084,0.31496001484186564,0.191514422836519,127208.74592764067,-164.90697873798595,127043.83894890269,1481,0,190.38297872340425,35,12,19,38.64635918617102,0.594047619047619,47.80092592592593,1008.7962962962969,28.82275132275134,0
3717,4,1,2,45,0.02127659574468085,0.0425531914893617,0.9574468085106383,47,1300,900,400,0.6923076923076923,17,9,8,380.4970547967074,0.4606267345050879,0.29386262780377503,0.19380774261026057,125768.72210680209,170.9256694367469,125939.64777623884,1482,0,182.70212765957447,37,10,16,39.690824952630805,0.5754504504504505,49.23245614035088,1003.0701754385965,27.11000474158369,8
3718,4,1,1,45,0.021739130434782608,0.021739130434782608,0.9782608695652174,46,1700,1100,600,0.6470588235294118,23,11,12,389.4251462323749,0.4585547504025765,0.3276712635945733,0.19995871498253046,126100.38406227181,621.3321006817724,126721.71616295358,1483,0,187.58695652173913,36,10,18,39.12364054266173,0.5807291666666667,48.90202702702703,1004.3918918918926,27.899774774774794,0
3719,4,2,1,46,0.0425531914893617,0.02127659574468085,0.9787234042553191,47,1350,900,450,0.6666666666666666,18,9,9,373.1425246761728,0.4607423681776133,0.31715043164978596,0.19021760622743034,125802.5661571336,-11.542570677171625,125791.02358645642,1484,0,183.06382978723406,38,9,15,39.8402555910543,0.5740131578947368,49.198717948717956,1003.2051282051293,26.40013495276656,8
3720,4,6,3,49,0.11538461538461539,0.057692307692307696,0.9423076923076923,52,1200,800,400,0.6666666666666666,16,8,8,344.92179495936114,0.46650326797385616,0.33900190718372625,0.18145885734818548,127092.01388888877,-1619.027366863911,125472.98652202486,1485,0,166.05769230769232,39,13,18,39.22176308539947,0.5854700854700854,47.916666666666664,1008.3333333333323,25.85470085470083,0
3721,4,2,2,49,0.0392156862745098,0.0392156862745098,0.9607843137254902,51,1000,500,500,0.5,15,5,10,352.0881736089474,0.465702614379085,0.36861250218003394,0.1859687198860681,127253.65713346476,-1239.0984549638429,126014.55867850092,1486,0,170.23529411764707,38,13,20,38.87521177467176,0.5888157894736843,47.756410256410255,1008.9743589743584,26.551956815114696,0
3722,4,1,1,49,0.02,0.02,0.98,50,2200,1800,400,0.8181818181818182,26,18,8,351.7853247219765,0.46687074829931974,0.37235326027991666,0.18774784817385412,127673.1316967722,-1017.2931815558545,126655.83851521634,1487,0,173.24,37,13,19,38.45283624462043,0.5948761261261262,47.34100877192983,1010.6359649122817,27.314485538169777,0
3723,4,1,0,50,0.02,0.0,1.0,50,1700,1000,700,0.5882352941176471,24,10,14,354.5193078615279,0.4658248299319728,0.3806675821273895,0.19015491714023175,127874.24123612048,-933.2225007304841,126941.01873539,1488,0,174.18,38,12,20,38.1777930354565,0.5951206140350878,47.14209401709403,1011.4316239316258,26.616621682411207,0
3724,4,0,1,49,0.0,0.02,0.98,50,1350,900,450,0.6666666666666666,18,9,9,356.6873193325404,0.4650255102040816,0.38919244167634304,0.1920920395700489,128036.38100162556,-866.2092966980615,127170.1717049275,1489,1,175.18,38,12,20,37.95700059819136,0.596765350877193,46.981837606837615,1012.0726495726509,26.633490778227657,0
3725,4,0,1,48,0.0,0.02040816326530612,0.9795918367346939,49,1200,800,400,0.6666666666666666,16,8,8,368.7835180509138,0.4633822278911565,0.3964698676089786,0.19845499055929355,128005.79415060407,-358.71458044782474,127647.07957015625,1490,2,179.6530612244898,37,12,21,37.68228320150252,0.5982545045045045,47.012061403508774,1011.9517543859652,27.350047415836897,0
3726,4,2,2,48,0.04,0.04,0.96,50,2100,1400,700,0.6666666666666666,28,14,14,353.0213479392854,0.4640051020408163,0.37695322376738294,0.19257923187584455,128550.50131492433,-923.710606193584,127626.79070873075,1491,0,174.82,38,12,18,37.52436262115465,0.6019736842105263,46.47435897435897,1014.1025641025636,26.68690958164641,0
3727,4,0,0,48,0.0,0.0,1.0,48,1150,800,350,0.6956521739130435,15,8,7,362.2839506172842,0.4636432476359338,0.39148148148148176,0.19689345142243697,128401.20525931334,-296.46081892703467,128104.7444403863,1492,1,182.66666666666666,36,12,18,37.44212962962963,0.6041666666666667,46.62162162162162,1013.5135135135133,28.15315315315315,0
3728,4,1,1,48,0.02040816326530612,0.02040816326530612,0.9795918367346939,49,1350,600,750,0.4444444444444444,21,6,15,355.2730866291005,0.4638251133786848,0.38929034648879046,0.19426634736952922,128644.60699445974,-659.206678978152,127985.40031548159,1493,0,179.91836734693877,37,12,19,37.37119902003171,0.6047297297297297,46.38157894736842,1014.4736842105256,27.418207681365555,0
3729,4,0,0,48,0.0,0.0,1.0,48,1450,1000,450,0.6896551724137931,19,10,9,358.1223144061405,0.4640311022458629,0.3793294849023088,0.1957503524375313,128629.57552146747,-386.97574263452253,128242.59977883296,1494,1,182.91666666666666,36,12,19,37.31428544997038,0.6064814814814814,46.3963963963964,1014.4144144144149,28.17817817817819,0
3730,4,0,2,46,0.0,0.041666666666666664,0.9583333333333334,48,1000,600,400,0.6,14,6,8,363.02847451359133,0.4638002364066194,0.3834179521325787,0.1988601570724603,128715.26668137732,-254.53861800989844,128460.72806336742,1495,2,183.91666666666666,36,12,19,37.10233788332778,0.607349537037037,46.31193693693694,1014.7522522522523,28.187562562562565,0
3731,4,0,1,45,0.0,0.021739130434782608,0.9782608695652174,46,1150,800,350,0.6956521739130435,15,8,7,369.8206763953133,0.46193639291465377,0.379028658155522,0.20236254989271626,128672.41753472218,317.1440972222199,128989.5616319444,1496,3,189.95652173913044,35,11,20,36.973819301848046,0.6089285714285715,46.354166666666664,1014.5833333333329,28.988095238095227,0
3732,4,0,0,45,0.0,0.0,1.0,45,1850,1700,150,0.918918918918919,20,17,3,372.17177260418583,0.4621843434343434,0.3713268190056147,0.2037994959663272,128701.7763658479,579.8336494770248,129281.61001532491,1497,4,194.04444444444445,35,10,20,36.88417265503214,0.6092261904761904,46.32523148148148,1014.6990740740739,28.99140211640211,0
3733,4,0,0,45,0.0,0.0,1.0,45,1450,900,550,0.6206896551724138,20,9,11,369.7154530449713,0.46134259259259264,0.3667506780922205,0.2030145708357262,128811.51532202211,524.7215489381279,129336.23687096025,1498,5,195.04444444444445,37,8,20,36.8343594728883,0.6064189189189189,46.21710526315789,1015.131578947368,27.435988620199133,0
3734,4,0,1,44,0.0,0.022222222222222223,0.9777777777777777,45,1450,1100,350,0.7586206896551724,18,11,7,352.61881986431064,0.4607744107744108,0.29080694459912615,0.1887993073083868,127802.69870799866,29.97148389313213,127832.67019189178,1499,6,196.04444444444445,36,9,18,38.29908675799088,0.5980902777777778,47.212837837837846,1011.1486486486496,28.087462462462486,8
3735,4,1,0,45,0.022222222222222223,0.0,1.0,45,1550,1200,350,0.7741935483870968,19,12,7,347.3298285714287,0.46142676767676766,0.2657625396825394,0.1878328800988875,128203.13169795947,-93.33257376809428,128109.79912419137,743,0,163.7111111111111,35,10,20,38.02333333333333,0.6041666666666667,46.817129629629626,1012.731481481481,28.93518518518517,0
3736,4,1,3,43,0.021739130434782608,0.06521739130434782,0.9347826086956522,46,1250,600,650,0.48,19,6,13,340.969804855776,0.4618961352657005,0.2612823793544645,0.18597414250310512,128543.91289515882,-434.0814209479576,128109.83147421086,744,0,161.1304347826087,36,10,15,37.836618545252634,0.6056134259259259,46.480855855855864,1014.0765765765777,28.168793793793824,0
3737,4,1,0,44,0.022727272727272728,0.0,1.0,44,1350,700,650,0.5185185185185185,20,7,13,350.5494954370523,0.4598528893587033,0.28718160047273944,0.1922431848334904,128760.50407503854,227.38594714505382,128987.8900221836,745,0,166.29545454545453,35,9,17,37.37277625726992,0.6098214285714285,46.26736111111111,1014.9305555555552,28.998015873015863,0
3738,4,0,0,44,0.0,0.0,1.0,44,1100,700,400,0.6363636363636364,15,7,8,349.94652590914933,0.4596546863988724,0.28515552147874934,0.19262426714723166,128907.38195516104,222.13809585046127,129129.5200510115,746,1,167.29545454545453,35,9,19,37.23833675252641,0.6113095238095239,46.122685185185176,1015.509259259258,29.014550264550227,0
3739,4,0,3,41,0.0,0.06818181818181818,0.9318181818181819,44,1600,1300,300,0.8125,19,13,6,395.8027277485453,0.45944547216349546,0.29356798203465617,0.21312636993865638,128030.5363429307,1342.0535451147996,129372.5898880455,747,2,168.29545454545453,36,8,17,36.97331330440265,0.6004050925925926,46.98761261261261,1012.049549549549,28.112487487487474,7
3740,4,0,0,41,0.0,0.0,1.0,41,1150,700,450,0.6086956521739131,16,7,9,412.6577105225216,0.45670731707317075,0.34733716446794993,0.22163236176730092,127927.48169273832,2358.0523416474366,130285.53403438575,748,3,180.7560975609756,33,8,17,36.65291237633756,0.6057449494949495,47.08946078431372,1011.6421568627447,30.65582293523469,0
3741,4,0,0,41,0.0,0.0,1.0,41,900,500,400,0.5555555555555556,13,5,8,363.3656239580774,0.45678353658536586,0.290493428775793,0.18851965647162944,126524.89271365938,994.9593174255111,127519.8520310849,749,4,181.7560975609756,36,5,18,39.34034773524364,0.5850694444444444,48.47972972972972,1006.0810810810792,27.946696696696645,8
3742,4,3,2,42,0.06818181818181818,0.045454545454545456,0.9545454545454546,44,1000,600,400,0.6,14,6,8,344.6752363221545,0.45973176532769555,0.3018483007305659,0.18277216330931012,127413.15593117707,-11.695433566238819,127401.46049761082,750,0,170.29545454545453,35,9,16,38.89872081470443,0.5961309523809524,47.598379629629626,1009.606481481481,28.845899470899457,0
3743,4,1,1,42,0.023255813953488372,0.023255813953488372,0.9767441860465116,43,1200,700,500,0.5833333333333334,17,7,10,352.0624339661689,0.4591177556293835,0.297375086345844,0.18714897805570047,127512.50000000009,378.4722222222367,127890.97222222232,751,0,173.34883720930233,34,9,17,38.61042354235426,0.5992647058823529,47.50000000000001,1010.0000000000007,29.705882352941195,0
3744,4,1,1,42,0.023255813953488372,0.023255813953488372,0.9767441860465116,43,1250,800,450,0.64,17,8,9,353.307005388331,0.45879475821336285,0.3070304514976394,0.18823079439615598,127602.6945153061,416.58517573695843,128019.27969104305,752,0,174.32558139534885,34,9,18,38.4865578728251,0.6001838235294117,47.410714285714285,1010.3571428571427,29.71638655462184,0
3745,4,1,0,43,0.023255813953488372,0.0,1.0,43,1150,700,450,0.6086956521739131,16,7,9,350.1850579103834,0.45937153931339975,0.3040334551723034,0.18827292596879286,127968.81028163577,362.55304783949856,128331.36332947527,753,0,171.8139534883721,35,8,19,38.19063143445435,0.6017857142857144,47.04861111111111,1011.8055555555553,28.90873015873015,0
3746,4,1,1,43,0.022727272727272728,0.022727272727272728,0.9772727272727273,44,1050,700,350,0.6666666666666666,14,7,7,341.32359104728425,0.459830866807611,0.289929167142694,0.18499104597132368,128291.05748724702,-42.126548568253156,128248.93093867876,754,0,168.88636363636363,35,9,20,38.085632545032176,0.6050595238095238,46.73032407407407,1013.0787037037031,28.945105820105805,0
3747,4,1,1,43,0.022727272727272728,0.022727272727272728,0.9772727272727273,44,1900,1600,300,0.8421052631578947,22,16,6,332.04037055504836,0.4589609760394644,0.18815940523697594,0.18104365122394983,128530.68300119015,-264.52487771824707,128266.1581234719,755,0,168.20454545454547,40,4,16,38.07647658181334,0.5984375,46.49390243902441,1014.0243902439055,25.350609756097636,8
3748,4,1,0,44,0.022727272727272728,0.0,1.0,44,1150,600,550,0.5217391304347826,17,6,11,336.22060531959676,0.46060165609584214,0.1933331815905679,0.18415593769150712,128711.0859628033,-144.93615324871786,128566.14980955458,756,0,169.1590909090909,40,4,17,37.78668002003005,0.6002604166666667,46.31605691056911,1014.7357723577242,25.368394308943103,0
3749,4,1,1,44,0.022222222222222223,0.022222222222222223,0.9777777777777777,45,1300,700,600,0.5384615384615384,19,7,12,339.1708728510645,0.4599326599326599,0.2240700024429787,0.18833206180620166,129253.0539444115,-231.29368679356128,129021.76025761793,757,0,166.37777777777777,40,5,18,37.160203877673396,0.6057291666666667,45.78252032520326,1016.8699186991878,25.421747967479696,0
3750,4,0,1,43,0.0,0.022727272727272728,0.9772727272727273,44,1700,1300,400,0.7647058823529411,21,13,8,343.5485207316546,0.4586306377730796,0.21764812626210928,0.19166907475885409,129439.78000217021,93.76898871528385,129533.5489908855,758,1,170.0681818181818,39,5,14,36.85904817961577,0.6092414529914529,45.598958333333336,1017.6041666666673,26.092414529914546,0
3751,4,1,1,43,0.022727272727272728,0.022727272727272728,0.9772727272727273,44,1300,1000,300,0.7692307692307693,16,10,6,340.94211402609784,0.4572432170542636,0.21440361314663003,0.19156971698417072,129718.50419723717,45.300209861861134,129763.80440709903,759,0,170.9318181818182,40,4,16,36.64226689279064,0.6104166666666666,45.32520325203252,1018.6991869918704,25.46747967479676,0
3752,4,1,0,44,0.022727272727272728,0.0,1.0,44,1600,1200,400,0.75,20,12,8,345.3524113290874,0.4573753523608175,0.23584811640422587,0.19533630751274308,129977.44914568044,177.60509617291243,130155.05424185334,760,0,171.8181818181818,40,4,17,36.26710849777424,0.6130208333333333,45.07113821138211,1019.7154471544712,25.49288617886178,0
3753,4,0,1,43,0.0,0.022727272727272728,0.9772727272727273,44,1300,1000,300,0.7692307692307693,16,10,6,349.5336484223074,0.4561420894996477,0.24467184543372222,0.19862294079277787,130158.86423631747,298.980538204753,130457.84477452222,761,1,172.8181818181818,40,4,18,35.976454868373004,0.61484375,44.89329268292682,1020.426829268291,25.510670731707275,0
3754,4,1,2,42,0.022727272727272728,0.045454545454545456,0.9545454545454546,44,1350,1100,250,0.8148148148148148,16,11,5,350.1404424474672,0.45504096194503174,0.2562376150639871,0.1999299779591209,130346.55044100108,328.04370274881273,130674.59414374988,762,0,173.6818181818182,37,7,19,35.77067450517199,0.6219031531531531,44.709429824561404,1021.1622807017543,27.598980559506874,0
3755,4,0,0,42,0.0,0.0,1.0,42,900,600,300,0.6666666666666666,12,6,6,353.9729508378755,0.4531794425087108,0.16744794718543732,0.19524571360695478,128989.67013888883,731.7708333333296,129721.44097222216,763,1,181.88095238095238,39,3,17,37.052228602679804,0.6047008547008548,46.041666666666664,1015.8333333333328,26.047008547008534,8
3756,4,0,0,42,0.0,0.0,1.0,42,1450,1100,350,0.7586206896551724,18,11,7,351.9893476224073,0.45274390243902435,0.17283923508946564,0.19506326197882307,129174.91455078128,693.6387803819454,129868.55333116323,764,2,182.88095238095238,39,3,18,36.9138957201899,0.6065705128205128,45.859375,1016.5625000000002,26.065705128205135,0
3757,4,0,0,42,0.0,0.0,1.0,42,1300,1100,200,0.8461538461538461,15,11,4,356.26361819396556,0.45234465737514523,0.1739821696806536,0.19809555626684996,129307.31336805578,813.4982638889145,130120.8116319447,765,3,183.88095238095238,39,3,18,36.67042195821386,0.607905982905983,45.72916666666668,1017.0833333333352,26.079059829059876,0
3758,4,0,1,41,0.0,0.023809523809523808,0.9761904761904762,42,1250,800,450,0.64,17,8,9,351.7824488983034,0.4516671506000774,0.12863039952823252,0.1862716901543476,127354.736328125,596.7339409722213,127951.47026909722,766,4,184.88095238095238,39,3,14,38.77923976608187,0.5881410256410257,47.65625,1009.375,25.881410256410255,8
3759,4,2,1,42,0.046511627906976744,0.023255813953488372,0.9767441860465116,43,1200,1000,200,0.8333333333333334,14,10,4,349.6505556550064,0.4530038759689923,0.1681818606519847,0.18796549309401983,127964.52591050319,348.5735177473898,128313.09942825057,767,0,181.4418604651163,40,3,16,38.20853421722245,0.5927083333333334,47.05284552845529,1011.7886178861803,25.29471544715451,0
3760,4,0,2,40,0.0,0.047619047619047616,0.9523809523809523,42,1150,700,450,0.6086956521739131,16,7,9,365.2951548126891,0.45236885404568333,0.14771906428849246,0.19078323680992906,126795.93474915992,863.7146388907672,127659.64938805069,768,1,186.23809523809524,38,4,13,39.01272055443584,0.5841557017543859,48.210470085470085,1007.1581196581197,26.50416104363473,8
3761,4,1,1,40,0.024390243902439025,0.024390243902439025,0.975609756097561,41,1050,800,250,0.7619047619047619,13,8,5,381.49643353585174,0.4529217479674797,0.198899189644425,0.20056373392579482,127064.37467538069,1494.9211536241705,128559.29582900486,769,0,191.5121951219512,37,4,15,38.32823545405111,0.5886824324324325,47.94407894736841,1008.2236842105248,27.249288762446614,0
3762,4,4,0,44,0.09090909090909091,0.0,1.0,44,1400,1000,400,0.7142857142857143,18,10,8,353.68968840902346,0.4599079457364341,0.19377244377244396,0.1790786738155159,125521.37586805537,189.23526950598176,125710.61113756135,770,0,177.0681818181818,39,5,13,40.61850311850313,0.5694444444444444,49.47916666666666,1002.0833333333318,25.694444444444404,8
3763,4,3,1,46,0.06382978723404255,0.02127659574468085,0.9787234042553191,47,1600,1100,500,0.6875,21,11,10,353.5880157856589,0.4634983040394696,0.24619115863741614,0.18246654290543354,126305.47417534716,-402.87543402778306,125902.59874131938,771,0,166.70212765957447,39,8,15,39.812176165803116,0.5774572649572649,48.697916666666664,1005.2083333333328,25.774572649572637,8
3764,4,1,0,47,0.02127659574468085,0.0,1.0,47,1850,1500,350,0.8108108108108109,22,15,7,354.2406095669322,0.4622841504779525,0.26687011874643596,0.1843310183223083,126646.00830078125,-427.3681640625002,126218.64013671875,772,0,167.6595744680851,39,8,20,39.44524216081962,0.5809294871794872,48.359375,1006.5625,25.809294871794872,0
3765,4,1,0,48,0.020833333333333332,0.0,1.0,48,1300,1000,300,0.7692307692307693,16,10,6,352.6621303242606,0.4635601359338062,0.27390091863517085,0.18507475434372345,126992.0005039052,-642.9461136306454,126349.05439027456,773,0,165.14583333333334,41,7,21,39.129347112860884,0.5813008130081301,48.01587301587301,1007.9365079365074,24.58381726674408,0
3766,4,1,1,48,0.02040816326530612,0.02040816326530612,0.9795918367346939,49,1050,600,450,0.5714285714285714,15,6,9,349.3223852040816,0.4639314058956916,0.2787581997084547,0.18454767520215654,127262.39753266798,-908.6429438263183,126353.75458884166,774,0,162.75510204081633,36,13,22,38.93601190476192,0.5925925925925926,47.74774774774776,1009.0090090090105,28.028028028028068,0
3767,4,2,1,49,0.04,0.02,0.98,50,1700,1200,500,0.7058823529411765,22,12,10,335.81344221495186,0.4658333333333333,0.2795201318092888,0.18027000206464333,127907.33642578125,-1409.3994140625005,126497.93701171875,775,0,159.16,39,11,17,38.61696787148593,0.59375,47.109375,1011.5625,25.9375,0
3768,4,0,2,47,0.0,0.04081632653061224,0.9591836734693877,49,1300,800,500,0.6153846153846154,18,8,10,343.01710787443545,0.46605725623582767,0.27235621521335784,0.18428145217970876,127938.8211898505,-1022.9591141185947,126915.8620757319,776,1,162.89795918367346,40,9,18,38.402603381885136,0.5924479166666667,47.07825203252032,1011.6869918699177,25.292174796747943,0
3769,4,0,3,44,0.0,0.06382978723404255,0.9361702127659575,47,1450,900,550,0.6206896551724138,20,9,11,340.03445472716845,0.4655411655874191,0.20657689371161436,0.17996109209005934,127334.5172789283,-733.845588442354,126600.67169048593,777,2,169.53191489361703,38,9,12,39.096406266539645,0.5896381578947368,47.67628205128205,1009.2948717948715,26.560391363022934,7
3770,4,0,1,43,0.0,0.022727272727272728,0.9772727272727273,44,1300,900,400,0.6923076923076923,17,9,8,358.62972366283464,0.4643675123326286,0.23606798900468684,0.18841381024892004,127036.73846760546,311.83008233303156,127348.5685499385,778,3,181.8409090909091,37,7,19,38.932999782466815,0.5884009009009009,47.97149122807018,1008.1140350877197,27.246325272641073,0
3771,4,1,1,43,0.022727272727272728,0.022727272727272728,0.9772727272727273,44,650,200,450,0.3076923076923077,11,2,9,354.84498655822136,0.4630351479915433,0.23918063069006523,0.18707160356692104,127177.19144397779,225.64978062026293,127402.84122459806,779,0,182.6590909090909,36,8,20,38.88415950280974,0.591724537037037,47.83220720720721,1008.6711711711714,28.01864364364365,0
3772,4,1,1,43,0.022727272727272728,0.022727272727272728,0.9772727272727273,44,1300,1000,300,0.7692307692307693,16,10,6,359.36331690850795,0.46212121212121215,0.24907214926735288,0.19051993708366502,127404.47108848723,356.8986638665817,127761.36975235381,780,0,183.4318181818182,36,8,15,38.53690277003162,0.5940393518518519,47.60698198198199,1009.5720720720728,28.04366866866869,0
3773,4,2,1,44,0.044444444444444446,0.022222222222222223,0.9777777777777777,45,1100,700,400,0.6363636363636364,15,7,8,351.4620444293139,0.46247895622895624,0.2541382175499445,0.188872468488601,127950.32035097339,-6.063764812250383,127944.25658616114,781,0,179.15555555555557,37,8,17,38.17724702864782,0.5976914414414414,47.06688596491228,1011.7324561403509,27.3441204362257,0
3774,4,0,0,44,0.0,0.0,1.0,44,1400,1000,400,0.7142857142857143,18,10,8,356.0050653770492,0.46114120859760394,0.25334507398635653,0.19101777163779307,127888.11404309714,305.7632801720648,128193.8773232692,782,1,184.1818181818182,36,8,18,38.126020559637794,0.5989583333333333,47.12837837837838,1011.4864864864865,28.096846846846844,0
3775,4,1,1,44,0.022222222222222223,0.022222222222222223,0.9777777777777777,45,900,400,500,0.4444444444444444,14,4,10,348.9876470396838,0.4618265993265993,0.2527534139445349,0.1885840210890273,128172.28768707666,-53.89098087874453,128118.39670619792,783,0,181.06666666666666,37,8,19,38.01288124887205,0.5999436936936937,46.84758771929824,1012.609649122806,27.367828354670433,0
3776,4,0,1,43,0.0,0.022727272727272728,0.9772727272727273,44,1250,500,750,0.4,20,5,15,358.2749835746305,0.46002906976744184,0.26244817473960946,0.19333085848354906,128116.02776763245,380.1535488190793,128496.18131645153,784,1,185.9090909090909,36,8,19,37.83532628846865,0.6012731481481481,46.90315315315315,1012.387387387387,28.12187187187186,0
3777,4,1,2,42,0.022727272727272728,0.045454545454545456,0.9545454545454546,44,1450,1100,350,0.7586206896551724,18,11,7,359.91777777777776,0.45832232205778717,0.276,0.19560748792270533,128401.20525931337,442.7752921840754,128843.98055149744,785,0,186.5681818181818,36,8,17,37.50208333333333,0.6041666666666667,46.62162162162162,1013.5135135135135,28.153153153153156,0
3778,4,1,1,42,0.023255813953488372,0.023255813953488372,0.9767441860465116,43,1650,1200,450,0.7272727272727273,21,12,9,363.9331957215239,0.45844868955334067,0.2812997769990444,0.1982621140870987,128496.3348765431,752.8163580246799,129249.15123456778,786,0,191.11627906976744,35,8,18,37.30308219178081,0.6071428571428572,46.52777777777777,1013.888888888888,28.968253968253943,0
3779,4,1,0,43,0.023255813953488372,0.0,1.0,43,1350,1000,350,0.7407407407407407,17,10,7,364.47201208828966,0.4586794019933555,0.2784869537410961,0.2006598659958606,128915.32368517165,797.2054825095333,129712.52916768119,787,0,177.95348837209303,36,7,19,36.86146226066384,0.609375,46.11486486486486,1015.5405405405405,28.20945945945946,0
3780,4,0,1,42,0.0,0.023255813953488372,0.9767441860465116,43,1450,1100,350,0.7586206896551724,18,11,7,364.44496282256864,0.4579180509413068,0.27140114668556303,0.20166252541224322,129115.53603857252,811.1013462787303,129926.63738485124,788,1,178.95348837209303,36,7,19,36.6578947368421,0.611400462962963,45.9177927927928,1016.3288288288302,28.231356356356393,0
3781,4,0,1,41,0.0,0.023809523809523808,0.9761904761904762,42,1500,1100,400,0.7333333333333333,19,11,8,371.97401284358614,0.45626451800232287,0.2762138002484278,0.20551037500024186,129054.34355977799,1200.9724097650897,130255.31596954308,789,2,184.04761904761904,35,7,19,36.52905133462427,0.612797619047619,45.97800925925926,1016.0879629629633,29.031084656084666,0
3782,4,1,0,42,0.023809523809523808,0.0,1.0,42,1300,600,700,0.46153846153846156,20,6,14,373.77281761097225,0.45626451800232287,0.28936645208834566,0.20789338741552055,129319.08543381348,1267.1917866941058,130586.27722050759,790,0,184.5,35,7,20,36.213207404035806,0.6154761904761905,45.717592592592595,1017.12962962963,29.06084656084657,0
3783,4,0,0,42,0.0,0.0,1.0,42,650,300,350,0.46153846153846156,10,3,7,373.3205977938006,0.4559620596205962,0.29148382902649117,0.2079523482007294,129377.95380015441,1259.8910108024802,130637.8448109569,791,1,185.5,35,7,20,36.16467576791809,0.6160714285714286,45.65972222222223,1017.3611111111119,29.06746031746034,0
3784,4,0,0,42,0.0,0.0,1.0,42,1200,800,400,0.6666666666666666,16,8,8,376.8542996735387,0.45591366627951996,0.29827982148273313,0.21023496210214193,129436.83556241445,1355.7656035665495,130792.601165981,792,2,186.5,35,7,18,36.014748255990305,0.6166666666666667,45.60185185185186,1017.592592592594,29.074074074074115,0
3785,4,0,0,42,0.0,0.0,1.0,42,1450,900,550,0.6206896551724138,20,9,11,374.5082644628096,0.45526035617499033,0.29601731601731585,0.21018320964749565,129672.49657064503,1312.6843278464016,130985.18089849144,793,3,187.5,35,7,18,35.834280303030305,0.6190476190476191,45.37037037037039,1018.518518518521,29.100529100529172,0
3786,4,0,1,41,0.0,0.023809523809523808,0.9761904761904762,42,850,700,150,0.8235294117647058,10,7,3,377.12195996986986,0.45494579945799457,0.299852880725211,0.21228783475541813,129790.4074502746,1389.3625685871293,131179.77001886172,794,4,188.5,35,7,19,35.64762229289716,0.6202380952380953,45.25462962962964,1018.9814814814835,29.11375661375667,0
3787,4,0,0,41,0.0,0.0,1.0,41,1350,700,650,0.5185185185185185,20,7,13,385.70394088824,0.4533790650406504,0.30301251008302965,0.21670837965729947,129716.28578514747,1806.4165249433186,131522.7023100908,795,5,193.90243902439025,34,7,19,35.50455767208134,0.6216299019607843,45.327380952380956,1018.6904761904768,29.961484593837554,0
3788,4,0,0,41,0.0,0.0,1.0,41,1400,1100,300,0.7857142857142857,17,11,6,383.7084472548499,0.4520579268292683,0.3015583209668369,0.21659165681234557,129898.25857426316,1768.6118197279088,131666.87039399106,796,6,194.90243902439025,34,7,20,35.36995406594263,0.623468137254902,45.14880952380953,1019.4047619047628,29.982492997198907,0
3789,4,0,0,41,0.0,0.0,1.0,41,750,600,150,0.8,9,6,3,380.4044524985045,0.45172764227642276,0.2975342138153496,0.21539490710870376,130019.64462868478,1692.0103458049898,131711.65497448976,797,7,195.90243902439025,34,7,20,35.330580522158684,0.6246936274509804,45.029761904761905,1019.8809523809522,29.99649859943977,0
3790,4,0,0,41,0.0,0.0,1.0,41,1600,1000,600,0.625,22,10,12,384.0066638900458,0.4507876016260162,0.29845694375311105,0.2187944945420029,130262.58680555552,1804.5670351473887,132067.1538407029,798,8,196.90243902439025,33,8,21,34.99149659863945,0.6294191919191919,44.791666666666664,1020.833333333333,30.934343434343425,0
3791,4,0,0,41,0.0,0.0,1.0,41,950,600,350,0.631578947368421,13,6,7,381.3337930516316,0.4505081300813008,0.2946383616500594,0.21762144956891727,130325.145376778,1739.4764033063993,132064.62178008442,799,9,197.90243902439025,33,8,21,34.99609937590013,0.630050505050505,44.730392156862735,1021.0784313725477,30.94177064765296,0
3792,4,0,1,40,0.0,0.024390243902439025,0.975609756097561,41,1300,1200,100,0.9230769230769231,14,12,2,378.623129876032,0.4504319105691057,0.2894285530328311,0.216422850780991,130387.71896626288,1673.5612504805758,132061.28021674347,800,10,198.90243902439025,33,8,21,35.00169986401089,0.6306818181818181,44.66911764705882,1021.323529411764,30.949197860962546,0
3793,4,1,1,40,0.024390243902439025,0.024390243902439025,0.975609756097561,41,900,600,300,0.6666666666666666,12,6,6,381.2340056012745,0.4511686991869919,0.2873603556179447,0.21897325115114505,130575.52984429055,1755.9664552095182,132331.49629950005,801,0,190.46341463414635,33,8,19,34.74420463629096,0.6325757575757576,44.48529411764705,1022.0588235294108,30.971479500891235,0
3794,4,1,0,41,0.024390243902439025,0.0,1.0,41,1450,1100,350,0.7586206896551724,18,11,7,383.0085697043848,0.4502794715447154,0.30646200767925014,0.2139592571300795,129490.37606175392,1819.626882818427,131310.00294457236,802,0,190.3658536585366,32,9,20,35.80356035231359,0.6240234375,45.54924242424242,1017.8030303030305,31.806344696969703,8
3795,4,0,0,41,0.0,0.0,1.0,41,1450,800,650,0.5517241379310345,21,8,13,382.5266607376382,0.4498729674796748,0.3044449729437704,0.2139830956732364,129544.24267409166,1710.8253135813075,131255.06798767296,803,1,191.3658536585366,33,8,20,35.76087937883711,0.6221590909090908,45.49632352941176,1018.0147058823527,30.848930481283414,0
3796,4,0,0,41,0.0,0.0,1.0,41,950,700,250,0.7368421052631579,12,7,5,378.5930335290984,0.45005081300813005,0.295374957413417,0.20236423224254224,127734.70320001691,1475.8660846403802,129210.5692846573,804,2,192.3658536585366,35,6,17,37.71229295473627,0.5994047619047619,47.28009259259258,1010.8796296296277,28.88227513227508,8
3797,4,3,2,42,0.06818181818181818,0.045454545454545456,0.9545454545454546,44,1450,1200,250,0.8275862068965517,17,12,5,358.0663744494656,0.45142926356589147,0.2993092314788375,0.19577763855301727,128641.3353638026,415.7093117824102,129057.04467558501,805,0,180.1818181818182,33,11,16,37.30369654505919,0.6130050505050505,46.38480392156864,1014.4607843137273,30.741235888294767,0
3798,4,1,3,40,0.023255813953488372,0.06976744186046512,0.9302325581395349,43,1250,1000,250,0.8,15,10,5,366.29078318112465,0.4524270948689553,0.2865032583468472,0.18947080499271013,126402.72285997716,670.1828157733507,127072.90567575052,806,0,183.37209302325581,34,9,16,39.39268379306262,0.5879289215686274,48.60119047619047,1005.5952380952368,29.576330532212847,8
3799,4,1,0,41,0.024390243902439025,0.0,1.0,41,1000,700,300,0.7,13,7,6,379.7243989399551,0.45274390243902435,0.3107506540790477,0.1975095939514787,126629.04779712118,1416.8278126201287,128045.87560974131,807,0,181.1951219512195,33,8,18,38.82145683672225,0.5924873737373737,48.37622549019607,1006.4950980392148,30.499851455733783,0
3800,4,1,0,42,0.023809523809523808,0.0,1.0,42,1450,1000,450,0.6896551724137931,19,10,9,372.92534662932877,0.45273180410375535,0.31247540338449453,0.196191160618038,127092.01388888872,1079.1666666666463,128171.18055555536,808,0,177.85714285714286,34,8,19,38.51584022038566,0.5949754901960784,47.91666666666666,1008.3333333333319,29.656862745097996,0
3801,4,2,0,44,0.045454545454545456,0.0,1.0,44,1650,1000,650,0.6060606060606061,23,10,13,364.164726828506,0.455822762508809,0.3362376127380027,0.1952575171132424,127859.63909433072,512.3941086356546,128372.03320296637,809,0,170.72727272727272,36,8,16,37.948864269012375,0.5986689814814814,47.15653153153153,1011.3738738738731,28.093718718718698,0
3802,4,2,1,45,0.043478260869565216,0.021739130434782608,0.9782608695652174,46,1050,700,350,0.6666666666666666,14,7,7,355.9500674159912,0.4568538647342995,0.34616108215905017,0.19355308371726013,128422.23087873185,-57.30261218769928,128364.92826654414,810,0,164.2608695652174,37,9,14,37.58113370835135,0.6024774774774775,46.60087719298245,1013.5964912280697,27.394499762920802,0
3803,4,2,0,47,0.0425531914893617,0.0,1.0,47,1600,1100,500,0.6875,21,11,10,350.2660896845419,0.45814061054579097,0.3481380459391734,0.19225176880952227,128794.39153928321,-377.538420447092,128416.85311883612,811,0,161.72340425531914,38,9,17,37.34541100936742,0.6044407894736843,46.23397435897435,1015.0641025641014,26.71221322537109,0
3804,4,0,1,46,0.0,0.02127659574468085,0.9787234042553191,47,1250,1000,250,0.8,15,10,5,348.84656627261364,0.45810206598828246,0.3502634106586726,0.19173446612427092,128848.62075617274,-410.32021604939496,128438.30054012334,812,1,162.72340425531914,38,9,18,37.32615139078887,0.6049890350877193,46.18055555555555,1015.2777777777769,26.71783625730992,0
3805,4,0,0,46,0.0,0.0,1.0,46,1250,1000,250,0.8,15,10,5,350.0297046196132,0.4575583735909823,0.35312413440186274,0.19260992837089927,128895.0100631924,-176.58354012774964,128718.42652306466,813,2,166.56521739130434,37,9,18,37.248834719072796,0.6072635135135135,46.13486842105262,1015.4605263157885,27.444879089615903,0
3806,4,0,0,46,0.0,0.0,1.0,46,1100,700,400,0.6363636363636364,15,7,8,350.8337728611503,0.45729669887278585,0.3581993946361959,0.1935958847860959,129006.37846500822,-148.04110399356034,128858.33736101467,814,3,167.56521739130434,37,9,18,37.11492624572766,0.6083896396396397,46.0252192982456,1015.8991228070156,27.45673304883826,0
3807,4,1,1,46,0.02127659574468085,0.02127659574468085,0.9787234042553191,47,1000,800,200,0.8,12,8,4,342.14486667226305,0.4574468085106383,0.3572687183159644,0.19028648003595314,129315.9037415794,-550.750909358581,128765.15283222082,815,0,164.9787234042553,36,11,19,37.0206857100679,0.6134259259259259,45.72072072072072,1017.117117117117,28.25325325325325,0
3808,4,1,0,47,0.02127659574468085,0.0,1.0,47,1200,800,400,0.6666666666666666,16,8,8,340.74677614242705,0.4568108233117483,0.3556795618583384,0.19117331534938642,129659.75265806343,-563.7714572680835,129095.98120079534,816,0,163.2127659574468,36,11,16,36.70688670204925,0.6168981481481481,45.38288288288288,1018.4684684684681,28.29079079079078,0
3809,4,0,0,47,0.0,0.0,1.0,47,1900,1300,600,0.6842105263157895,25,13,12,338.37892616220506,0.4560013876040703,0.35829787234042576,0.19068052813000977,129831.84831791258,-613.5277169060856,129218.32060100649,817,1,164.2127659574468,36,11,17,36.59254143646409,0.6186342592592593,45.21396396396397,1019.1441441441448,28.309559559559577,0
3810,4,0,0,47,0.0,0.0,1.0,47,1300,900,400,0.6923076923076923,17,9,8,336.12302000231244,0.4551919518963922,0.35472889498970495,0.1901425843078773,129982.9033933517,-661.9507925515657,129320.95260080014,818,2,165.2127659574468,37,10,17,36.49686379928315,0.6182432432432432,45.065789473684205,1019.7368421052624,27.56045519203412,0
3811,4,0,2,45,0.0,0.0425531914893617,0.9574468085106383,47,1000,600,400,0.6,14,6,8,313.4296340540856,0.4548065063213074,0.26022335838261235,0.16903995697081833,128094.31295666391,-1370.289273116676,126724.02368354723,819,3,166.2127659574468,41,6,17,38.9924702730955,0.592479674796748,46.92460317460316,1012.3015873015854,24.69028261711184,8
3812,4,3,4,44,0.0625,0.08333333333333333,0.9166666666666666,48,1750,1300,450,0.7428571428571429,22,13,9,307.727109884279,0.4556645242316785,0.2642438364401687,0.1677869454877233,128530.68300118984,-1689.5051939188345,126841.177807271,820,0,162.4375,40,8,15,38.69283256497627,0.5984375,46.493902439024396,1014.0243902439031,25.350609756097576,0
3813,4,0,2,42,0.0,0.045454545454545456,0.9545454545454546,44,1050,500,550,0.47619047619047616,16,5,11,337.1576333422173,0.4519578047921071,0.28404531055006355,0.181207876716844,127955.29827781398,-171.77889181097134,127783.51938600301,821,5,178.0,38,6,19,38.5339669130588,0.5959429824561404,47.0619658119658,1011.7521367521341,26.62505623031932,0
3814,4,2,0,44,0.045454545454545456,0.0,1.0,44,1100,600,500,0.5454545454545454,16,6,10,339.332954629241,0.45167151162790703,0.29461550903227796,0.18350097781002783,128201.54772593528,-99.11835470460187,128102.42937123068,822,0,177.54545454545453,36,8,21,38.227417621112714,0.6021412037037037,46.81869369369369,1012.7252252252243,28.131256256256233,0
3815,4,1,2,43,0.022222222222222223,0.044444444444444446,0.9555555555555556,45,1100,700,400,0.6363636363636364,15,7,8,338.8365721338781,0.45229377104377105,0.3123653083429856,0.18547152308676865,128685.96734832699,-279.2975883921554,128406.66975993483,823,0,174.57777777777778,38,7,19,37.745910989435245,0.6033442982456141,46.34081196581196,1014.636752136751,26.70096716149345,0
3816,4,1,0,44,0.022727272727272728,0.0,1.0,44,1700,1100,600,0.6470588235294118,23,11,12,345.5956784796309,0.44935914376321356,0.32763597094050656,0.19003657854640027,128867.17547706972,107.1877885503028,128974.36326562002,824,0,179.1818181818182,37,7,20,37.38975881929446,0.6069819819819819,46.162280701754376,1015.3508771929812,27.441915599810304,0
3817,4,1,0,45,0.022222222222222223,0.0,1.0,45,900,600,300,0.6666666666666666,12,6,6,334.21068644996984,0.45157828282828283,0.3190386097680611,0.18508035336932532,129147.08547921677,-367.53278179561914,128779.55269742115,825,0,176.17777777777778,38,7,21,37.3940158363114,0.6080043859649122,45.88675213675213,1016.4529914529904,26.74876293297343,0
3818,4,0,0,45,0.0,0.0,1.0,45,1100,900,200,0.8181818181818182,13,9,4,335.90834164963235,0.4511784511784512,0.3187798770771686,0.1865544051664772,129260.23046339168,-316.04782593585685,128944.18263745583,826,1,177.17777777777778,35,10,21,37.23584869868733,0.6148809523809524,45.77546296296297,1016.8981481481485,29.054232804232814,0
3819,4,1,0,46,0.021739130434782608,0.0,1.0,46,1350,1100,250,0.8148148148148148,16,11,5,326.9541957083561,0.4515096618357488,0.3122354751827625,0.18290011938140738,129545.08562616685,-728.9381442252891,128816.14748194156,827,0,174.30434782608697,36,10,19,37.17436393805312,0.6157407407407407,45.495495495495504,1018.0180180180192,28.27827827827831,0
3820,4,0,0,46,0.0,0.0,1.0,46,1150,700,450,0.6086956521739131,16,7,9,327.9399765082228,0.45066425120772946,0.31411516955223506,0.18385376364314085,129631.08114448929,-697.7572589481192,128933.32388554118,828,1,175.30434782608697,36,10,19,37.062046149876494,0.6166087962962963,45.411036036036045,1018.3558558558575,28.287662662662708,0
3821,4,0,1,45,0.0,0.021739130434782608,0.9782608695652174,46,1600,1300,300,0.8125,19,13,6,326.85275490059973,0.45035225442834137,0.312433322727357,0.1838447819937274,129759.37307633135,-717.5582871652656,129041.81478916609,829,2,176.30434782608697,37,9,19,36.95966063997706,0.615990990990991,45.285087719298254,1018.8596491228084,27.536747273589416,0
3822,4,0,0,45,0.0,0.0,1.0,45,1250,800,450,0.64,17,8,9,333.91701949153173,0.44793771043771047,0.31445169055426536,0.1877530935574827,129745.78622118778,-335.1347546870769,129410.6514665007,830,3,181.13333333333333,36,9,19,36.793504292398936,0.6177662037037037,45.29842342342344,1018.8063063063094,28.30017517517526,0
3823,4,2,0,47,0.0425531914893617,0.0,1.0,47,1300,1000,300,0.7692307692307693,16,10,6,329.0105765671607,0.4491982732038236,0.33596476415625287,0.1884333302157378,130463.84222059928,-813.1487906825403,129650.69342991675,831,0,174.38297872340425,36,11,22,36.19148662551441,0.625,44.59459459459461,1021.6216216216241,28.378378378378446,0
3824,4,0,0,47,0.0,0.0,1.0,47,1500,1000,500,0.6666666666666666,20,10,10,328.5591764058503,0.4492560900400864,0.330420186978986,0.18873437247212022,130578.91506371247,-819.4198421394232,129759.49522157304,832,1,175.38297872340425,36,11,20,36.08670302629645,0.6261574074074074,44.48198198198199,1022.072072072073,28.390890890890915,0
3825,4,0,0,47,0.0,0.0,1.0,47,1100,800,300,0.7272727272727273,14,8,6,328.7767550388614,0.44873573851372184,0.33016457838215363,0.18914039177710945,130636.47050766999,-809.9530273516558,129826.51748031833,833,2,176.38297872340425,36,11,20,36.022985973415594,0.6267361111111112,44.425675675675684,1022.2972972972985,28.39714714714718,0
3826,4,1,0,48,0.020833333333333332,0.0,1.0,48,1550,1100,450,0.7096774193548387,20,11,9,323.30278018252596,0.4493295656028369,0.33474364467295104,0.18770862909104852,130991.17036011071,-1130.0380886426692,129861.13227146804,834,0,173.6875,37,11,21,35.80494858611824,0.6283783783783784,44.07894736842105,1023.684210526315,27.667140825035542,0
3827,4,0,0,48,0.0,0.0,1.0,48,1350,900,450,0.6666666666666666,18,9,9,324.41159343203947,0.4491633421985815,0.33777658815132083,0.18890301014060135,131103.4404816865,-1093.7047937827185,130009.73568790378,835,1,174.6875,37,11,21,35.66336545324768,0.6295045045045045,43.96929824561403,1024.1228070175425,27.678994784257906,0
3828,4,0,0,48,0.0,0.0,1.0,48,1700,1300,400,0.7647058823529411,21,13,8,323.79227158087065,0.44862773345153667,0.33779808461083927,0.18897407743085615,131191.2749858462,-1104.2558121484499,130087.01917369774,836,2,175.6875,38,10,22,35.59069419821325,0.6285635964912281,43.883547008547005,1024.465811965811,26.95962663067924,0
3829,4,0,0,48,0.0,0.0,1.0,48,1150,800,350,0.6956521739130435,15,8,7,321.5669796580297,0.44842457151300236,0.33100741860384275,0.18821183867354965,131300.74929003208,-1155.6029247936422,130145.14636523844,837,3,176.6875,38,10,22,35.537414434136,0.6296600877192983,43.7767094017094,1024.893162393162,26.970872694556892,0
3830,4,0,1,47,0.0,0.020833333333333332,0.9791666666666666,48,1300,700,600,0.5384615384615384,19,7,12,324.1399005621464,0.4477596778959811,0.333939685154677,0.19028328785418058,131414.71021274637,-1080.6440727103113,130334.06614003606,838,4,177.6875,36,12,22,35.356717920556484,0.6345486111111112,43.66554054054053,1025.3378378378366,28.481606606606572,0
3831,4,1,0,48,0.020833333333333332,0.0,1.0,48,1200,800,400,0.6666666666666666,16,8,8,321.79225399160384,0.4478520242316785,0.32466688043323333,0.18958994510991467,131553.00188519535,-1133.4526008002608,130419.54928439509,839,0,178.1875,37,11,23,35.277718398175864,0.634009009009009,43.53070175438596,1025.8771929824554,27.726410621147444,0
3832,4,0,1,47,0.0,0.020833333333333332,0.9791666666666666,48,1300,700,600,0.5384615384615384,19,7,12,324.9795234579467,0.44697473404255317,0.32435325641847323,0.19217519387806944,131693.64762474995,-1040.452230494003,130653.19539425595,840,1,179.1875,37,11,16,35.05445910337214,0.6354166666666667,43.39364035087719,1026.4254385964914,27.741228070175442,0
3833,4,0,1,46,0.0,0.02127659574468085,0.9787234042553191,47,1150,600,550,0.5217391304347826,17,6,11,332.5670444877638,0.44624961455442497,0.3298012502452834,0.19567316803582377,131501.32395909424,-653.3986689392091,130847.92529015504,841,7,183.9787234042553,36,11,22,35.05343287951982,0.6354166666666667,43.58108108108108,1025.6756756756758,28.490990990990994,0
3834,4,0,0,46,0.0,0.0,1.0,46,1450,1200,250,0.8275862068965517,17,12,5,340.0302912694701,0.44436392914653783,0.3401343665305192,0.20067072629840751,131616.85333982634,-249.2566045775426,131367.5967352488,842,8,188.2826086956522,36,10,16,34.745619329821494,0.6365740740740741,43.46846846846847,1026.1261261261263,28.50350350350351,0
3835,4,0,1,45,0.0,0.021739130434782608,0.9782608695652174,46,850,700,150,0.8235294117647058,10,7,3,330.16061867935764,0.44389090177133655,0.22357723577235733,0.19337979094076654,131328.125,-452.4507193003807,130875.67428069962,843,9,189.2826086956522,38,8,17,35.28963414634147,0.6299342105263157,43.75,1025.0,26.973684210526315,8
3836,4,0,1,44,0.0,0.022222222222222223,0.9777777777777777,45,1450,1300,150,0.896551724137931,16,13,3,333.72885007598245,0.44370791245791247,0.21705470579146913,0.19561323005394096,131356.22409058549,-232.52767678517657,131123.6964138003,844,10,194.0222222222222,37,8,17,35.16987110920953,0.6320382882882882,43.72258771929824,1025.1096491228063,27.70566619250828,0
3837,4,0,0,44,0.0,0.0,1.0,44,1500,1000,500,0.6666666666666666,20,10,10,342.1218217296093,0.442135747004933,0.2237378175427387,0.20068795522077082,131385.84530476423,189.99294903011608,131575.83825379435,845,14,199.20454545454547,36,8,17,34.92489565026362,0.6342592592592593,43.693693693693696,1025.2252252252254,28.478478478478483,0
3838,4,1,0,45,0.022222222222222223,0.0,1.0,45,1300,900,400,0.6923076923076923,17,9,8,334.6837344565777,0.4415193602693603,0.22881150751263957,0.19805999506842492,131721.78578985843,-182.97216451215883,131538.8136253463,846,0,195.75555555555556,37,8,16,34.777113152460295,0.6356981981981982,43.36622807017544,1026.5350877192984,27.74419155998104,0
3839,4,0,0,45,0.0,0.0,1.0,45,1750,1400,350,0.8,21,14,7,333.8330380698534,0.4413930976430977,0.22455290920526383,0.1977026398132853,131749.9269606995,-203.50432344567332,131546.42263725383,847,1,196.75555555555556,37,8,16,34.770617501513044,0.6359797297297297,43.338815789473685,1026.6447368421057,27.747155049786638,0
3840,4,0,0,45,0.0,0.0,1.0,45,1450,1100,350,0.7586206896551724,18,11,7,333.5602965480559,0.4406986531986532,0.22162457014111214,0.1985679783135503,131946.99931709745,-197.54395583257707,131749.45536126487,848,2,197.75555555555556,37,8,18,34.57933119886162,0.6379504504504505,43.1469298245614,1027.4122807017536,27.76789947842577,0
3841,4,0,1,44,0.0,0.022222222222222223,0.9777777777777777,45,1350,1100,250,0.8148148148148148,16,11,5,334.34195883926276,0.44042508417508414,0.22555128752311826,0.19932906095684297,132003.33275623273,-173.14943059402293,131830.1833256387,849,3,198.75555555555556,37,8,18,34.50259638639921,0.6385135135135135,43.0921052631579,1027.6315789473688,27.773826458036993,0
3842,4,0,0,44,0.0,0.0,1.0,44,1050,800,250,0.7619047619047619,13,8,5,339.2739681535195,0.4389424770965469,0.2256334148139525,0.2022694420823655,132003.33275623273,157.0589027393109,132160.39165897205,850,4,203.86363636363637,37,7,19,34.37588917342439,0.6385135135135135,43.0921052631579,1027.6315789473688,27.773826458036993,0
3843,4,0,1,43,0.0,0.022727272727272728,0.9772727272727273,44,1400,1200,200,0.8571428571428571,16,12,4,337.7800749064046,0.43825977801268495,0.2208183466315068,0.2021291488447578,132144.21895438983,127.13683537242423,132271.35578976225,851,5,204.86363636363637,37,7,19,34.272577405709015,0.6399211711711712,42.95504385964912,1028.1798245614036,27.788643907064962,0
3844,4,0,0,43,0.0,0.0,1.0,43,1450,900,550,0.6206896551724138,20,9,11,340.81584178627764,0.4377076411960133,0.20576760484470613,0.20422114614122644,132195.26113951803,410.8478410843387,132606.10898060238,852,6,201.7674418604651,36,7,19,34.14321433785953,0.6423611111111112,42.90540540540541,1028.3783783783795,28.566066066066096,0
3845,4,0,0,43,0.0,0.0,1.0,43,1650,1500,150,0.9090909090909091,18,15,3,337.8447802576973,0.4374307862679956,0.19530199975563023,0.20306249423910042,132311.09487866252,340.1225549874254,132651.21743364996,853,7,202.7674418604651,36,7,20,34.10318155283127,0.6435185185185186,42.792792792792795,1028.8288288288295,28.578578578578597,0
3846,4,1,0,44,0.022727272727272728,0.0,1.0,44,850,500,350,0.5882352941176471,12,5,7,332.0520996261006,0.4387993305144468,0.19675518222463118,0.20124499508952173,132623.79410010765,7.601858264073655,132631.39595837172,854,0,199.13636363636363,37,7,21,33.9383294301327,0.6447072072072072,42.489035087719294,1030.0438596491222,27.83902323376006,0
3847,4,0,1,43,0.0,0.022727272727272728,0.9772727272727273,44,1100,700,400,0.6363636363636364,15,7,8,331.26131911550755,0.4377973044397463,0.1969850145597727,0.2012193028913008,132708.51518015156,-7.76044071252943,132700.75473943903,855,1,200.13636363636363,37,7,16,33.87373186477955,0.6455518018018018,42.406798245614034,1030.3728070175437,27.847913703176857,0
3848,4,0,0,43,0.0,0.0,1.0,43,1400,900,500,0.6428571428571429,19,9,10,332.80582835881205,0.436969361387966,0.18979671171480184,0.20267277092270183,132803.95418645005,239.58599646944987,133043.5401829195,856,2,201.48837209302326,36,7,17,33.73825521686877,0.6484375,42.31418918918919,1030.7432432432438,28.631756756756772,0
3849,4,0,1,42,0.0,0.023255813953488372,0.9767441860465116,43,1250,800,450,0.64,17,8,9,331.9940887726187,0.4367155777039498,0.19406260477308068,0.2026491917868066,132891.02447041654,223.8069150231529,133114.8313854397,857,3,202.48837209302326,36,7,18,33.671909130624734,0.6493055555555556,42.22972972972974,1031.0810810810824,28.641141141141176,0
3850,4,0,0,42,0.0,0.0,1.0,42,1700,1400,300,0.8235294117647058,20,14,6,340.24283720495475,0.4362538714672861,0.20979738394460123,0.20825852782764795,132994.25582990394,650.0685871056169,133644.32441700954,858,4,207.52380952380952,35,7,18,33.355774985038906,0.6523809523809524,42.129629629629626,1031.481481481481,29.470899470899457,0
3851,4,0,0,42,0.0,0.0,1.0,42,1300,1000,300,0.7692307692307693,16,10,6,339.7122886462129,0.43572154471544716,0.2160003204871408,0.20843324523613116,133083.8092233581,642.0410826045857,133725.8503059627,859,5,208.52380952380952,35,7,18,33.279701813423074,0.6532738095238095,42.04282407407407,1031.828703703703,29.480820105820086,0
3852,4,0,1,41,0.0,0.023809523809523808,0.9761904761904762,42,700,500,200,0.7142857142857143,9,5,4,340.1589754899643,0.4357941347270615,0.21677447847660636,0.209091684129143,133152.4065239226,658.5972374401485,133811.00376136275,860,6,209.52380952380952,36,6,19,33.19944535370068,0.6519097222222222,41.976351351351354,1032.0945945945948,28.6692942942943,0
3853,4,0,0,41,0.0,0.0,1.0,41,1100,900,200,0.8181818181818182,13,9,4,344.93038729019565,0.43544207317073175,0.2136382911782011,0.21163485221556033,133083.80922335808,980.9299714934746,134064.73919485154,861,7,213.4878048780488,35,6,19,33.14509721443261,0.6532738095238095,42.04282407407407,1031.8287037037028,29.48082010582008,0
3854,4,0,0,41,0.0,0.0,1.0,41,1050,500,550,0.47619047619047616,16,5,11,344.93038729019565,0.43544207317073175,0.2136382911782011,0.21163485221556033,133083.80922335808,980.9299714934746,134064.73919485154,862,8,214.4878048780488,35,6,19,33.14509721443261,0.6532738095238095,42.04282407407407,1031.8287037037028,29.48082010582008,0
3855,4,0,0,41,0.0,0.0,1.0,41,1100,700,400,0.6363636363636364,15,7,8,345.17519430678334,0.435010162601626,0.21559892692771543,0.21246497984970314,133203.26063368036,995.6922743055329,134198.9529079859,863,9,215.4878048780488,35,6,19,33.019046417759846,0.6544642857142857,41.92708333333332,1032.2916666666652,29.494047619047574,0
3856,4,0,0,41,0.0,0.0,1.0,41,1350,1000,350,0.7407407407407407,17,10,7,344.28642045053346,0.43409552845528454,0.21283049805287968,0.21294222470693042,133382.53821855682,984.3593267746612,134366.89754533148,864,10,216.4878048780488,35,6,21,32.862394957983184,0.65625,41.75347222222221,1032.986111111109,29.51388888888883,0
3857,4,0,2,39,0.0,0.04878048780487805,0.9512195121951219,41,1300,900,400,0.6923076923076923,17,9,8,343.2921729163875,0.43356199186991873,0.21085406822713249,0.21318491683889673,133532.02830289755,968.1000300068326,134500.1283329044,865,11,217.4878048780488,35,6,22,32.73842851810377,0.6577380952380952,41.60879629629628,1033.564814814813,29.53042328042323,0
3858,4,0,0,39,0.0,0.0,1.0,39,1100,700,400,0.6363636363636364,15,7,8,343.6915683718358,0.43229869545659017,0.16756919633248724,0.21429756897434393,133681.60211173247,1389.0478984481952,135070.65001018066,714,12,194.02564102564102,35,4,22,32.57846017534044,0.6592261904761905,41.46412037037036,1034.1435185185169,29.546957671957625,0
3859,4,0,0,39,0.0,0.0,1.0,39,1200,700,500,0.5833333333333334,17,7,10,339.64882386905015,0.4315677013045434,0.16993452806001796,0.21281010050547813,133861.20119866656,1293.1599097650603,135154.36110843162,715,13,195.02564102564102,35,4,17,32.50347183387392,0.6610119047619047,41.290509259259245,1034.8379629629608,29.56679894179888,0
3860,4,0,0,39,0.0,0.0,1.0,39,1100,800,300,0.7272727272727273,14,8,6,340.4646532592382,0.43063990103463784,0.16961422393410763,0.21436574614429313,134040.9208488727,1327.2391278720934,135368.1599767448,716,14,196.02564102564102,35,4,18,32.30284359748146,0.662797619047619,41.11689814814815,1035.532407407408,29.58664021164023,0
3861,4,0,0,39,0.0,0.0,1.0,39,1100,700,400,0.6363636363636364,15,7,8,337.7667769376179,0.4305555555555556,0.1575863991081381,0.21342406235069272,134171.3334956579,1263.7237744501313,135435.05727010802,717,15,197.02564102564102,36,3,18,32.242527173913025,0.662037037037037,40.990990990990994,1036.0360360360366,28.778778778778797,0
3862,4,0,0,39,0.0,0.0,1.0,39,950,600,350,0.631578947368421,13,6,7,338.0101591930653,0.4302462887989204,0.1519346407414217,0.21391812138202126,134229.6751988476,1274.198776479192,135503.8739753268,718,16,198.02564102564102,36,3,18,32.17801383757156,0.6626157407407407,40.93468468468469,1036.261261261262,28.785035035035055,0
3863,4,0,0,39,0.0,0.0,1.0,39,850,600,250,0.7058823529411765,11,6,5,335.80405415259435,0.42985267656320286,0.15156224758657966,0.21320083603646803,134346.3966500285,1222.812931174423,135569.20958120291,719,17,199.02564102564102,36,3,18,32.11877217756535,0.6637731481481481,40.822072072072075,1036.7117117117123,28.797547547547563,0
3864,4,0,0,39,0.0,0.0,1.0,39,950,800,150,0.8421052631578947,11,8,3,335.59316324417085,0.4287561853351327,0.15392966603475777,0.21392032018284146,134492.36979800757,1226.9439625436353,135719.31376055122,720,18,200.02564102564102,36,3,18,31.97874823580503,0.6652199074074074,40.68130630630631,1037.2747747747756,28.81318818818821,0
3865,4,0,0,39,0.0,0.0,1.0,39,1200,700,500,0.5833333333333334,17,7,10,334.7938069228933,0.427266081871345,0.15518133417894764,0.21461260863805504,134696.86536198366,1219.1352670237852,135916.00062900744,721,19,201.02564102564102,36,3,18,31.79580711651116,0.6672453703703703,40.484234234234236,1038.0630630630635,28.835085085085097,0
3866,4,0,0,39,0.0,0.0,1.0,39,1100,1000,100,0.9090909090909091,12,10,2,331.70375443745945,0.4268162393162393,0.14842989729131584,0.21331743538509434,134813.78971877295,1143.6480399318384,135957.4377587048,722,20,202.02564102564102,36,3,18,31.759650834959878,0.6684027777777778,40.37162162162163,1038.5135135135145,28.847597597597623,0
3867,4,0,1,38,0.0,0.02564102564102564,0.9743589743589743,39,1250,1000,250,0.8,15,10,5,328.2104887023442,0.4264226270805218,0.14421444311982978,0.21192429525937945,134960.01649876242,1059.0585940670585,136019.07509282947,723,21,203.02564102564102,36,3,18,31.70496008092194,0.669849537037037,40.230855855855864,1039.0765765765777,28.86323823823827,0
3868,4,0,0,38,0.0,0.0,1.0,38,1250,1000,250,0.8,15,10,5,339.53594938961464,0.42453473210052156,0.14311592078882884,0.21930602544028477,134971.3930148318,1565.5280135459334,136536.92102837772,724,22,206.73684210526315,35,3,18,31.39943937031261,0.6720238095238096,40.2199074074074,1039.120370370369,29.6891534391534,0
3869,4,0,0,38,0.0,0.0,1.0,38,850,600,250,0.7058823529411765,11,6,5,340.0387950249195,0.4240309388335704,0.14697816686003562,0.2203628035291362,135091.6883680555,1587.2829861111065,136678.9713541666,725,23,207.73684210526315,35,3,18,31.266700066800258,0.6732142857142858,40.104166666666664,1039.583333333333,29.702380952380945,0
3870,4,0,0,38,0.0,0.0,1.0,38,1200,800,400,0.6666666666666666,16,8,8,342.64096748365733,0.4226825509720247,0.1459873253130599,0.22279100823503237,135212.0373049555,1665.8366555212722,136877.87396047678,726,24,208.73684210526315,35,3,18,31.079364196156988,0.674404761904762,39.98842592592593,1040.046296296297,29.715608465608486,0
3871,4,0,0,38,0.0,0.0,1.0,38,1300,900,400,0.6923076923076923,17,9,8,342.0738055372687,0.4223713845424372,0.14095674621990373,0.22335407302727556,135362.54882812503,1660.7964409722217,137023.34526909725,727,25,209.73684210526315,35,3,19,30.944486152819483,0.6758928571428571,39.84375,1040.6250000000002,29.732142857142865,0
3872,4,0,1,37,0.0,0.02631578947368421,0.9736842105263158,38,1100,500,600,0.45454545454545453,17,5,12,340.6629547561394,0.4217786865813182,0.13347494821108796,0.22299291230543794,135452.8959297839,1628.756751543207,137081.6526813271,728,26,210.73684210526315,35,3,19,30.891427618412283,0.6767857142857143,39.75694444444444,1040.972222222222,29.742063492063483,0
3873,4,0,0,37,0.0,0.0,1.0,37,1000,700,300,0.7,13,7,6,341.7765598267954,0.42057682682682684,0.12447155326532777,0.22390969815309708,135483.01832829634,1860.9839838391488,137344.00231213548,729,27,212.40540540540542,35,2,19,30.83252269779508,0.6770833333333333,39.72800925925925,1041.087962962962,29.745370370370342,0
3874,4,0,0,37,0.0,0.0,1.0,37,1100,500,600,0.45454545454545453,17,5,12,338.65667019136066,0.42051426426426425,0.12520500051062422,0.22242574586728922,135573.4056177126,1782.5676225994482,137355.97324031204,730,28,213.40540540540542,35,2,19,30.82397940283026,0.6779761904761905,39.6412037037037,1041.435185185185,29.755291005291,0
3875,4,0,0,37,0.0,0.0,1.0,37,950,600,350,0.631578947368421,13,6,7,340.3460022535172,0.4198886386386386,0.12538955307229083,0.2242895104162634,135693.9688893174,1836.5799682784468,137530.54885759583,731,29,214.40540540540542,35,2,19,30.660316226023856,0.6791666666666667,39.525462962962955,1041.8981481481467,29.768518518518476,0
3876,4,0,0,37,0.0,0.0,1.0,37,750,500,250,0.6666666666666666,10,5,5,342.7937036645383,0.4190753253253254,0.12482554736857931,0.22647522388108332,135784.42650730864,1909.2092924811172,137693.63579978977,732,30,215.40540540540542,35,2,19,30.506778641495455,0.6800595238095238,39.4386574074074,1042.245370370369,29.778439153439116,0
3877,4,0,0,37,0.0,0.0,1.0,37,1300,900,400,0.6923076923076923,17,9,8,345.19346490088094,0.4181994494494494,0.11690314065452823,0.22902747560802172,135935.2561835561,1984.7924168381173,137920.04860039422,733,31,216.40540540540542,35,2,16,30.294580096189414,0.6815476190476191,39.293981481481474,1042.824074074073,29.794973544973516,0
3878,4,0,1,36,0.0,0.02702702702702703,0.972972972972973,37,1050,600,450,0.5714285714285714,15,6,9,344.2239927388188,0.4176051051051051,0.12238778221247948,0.2289661141368985,136025.7941770619,1964.6683974194052,137990.46257448132,734,32,217.40540540540542,35,2,16,30.230061207884905,0.6824404761904762,39.207175925925924,1043.1712962962963,29.80489417989418,0
3879,4,0,0,36,0.0,0.0,1.0,36,900,700,200,0.7777777777777778,11,7,4,344.34125760455146,0.41524470899470894,0.11393878908848976,0.23001996007984005,136176.75781249977,2178.255208333303,138355.01302083308,735,33,219.63888888888889,35,1,16,30.077345309381222,0.6839285714285714,39.062499999999986,1043.7499999999982,29.82142857142852,0
3880,4,0,0,36,0.0,0.0,1.0,36,950,700,250,0.7368421052631579,12,7,5,342.1056860392156,0.41431878306878306,0.10998423606492813,0.22930739223222854,136297.589002486,2125.636038237282,138423.22504072328,736,34,220.63888888888889,35,1,17,30.01597945762211,0.6851190476190476,38.946759259259245,1044.2129629629608,29.83465608465602,0
3881,4,0,0,36,0.0,0.0,1.0,36,800,500,300,0.625,11,5,6,342.91020023450517,0.4136243386243386,0.10913533742029258,0.23063393944237257,136418.47377614866,2155.8572316529353,138574.3310078016,737,35,221.63888888888889,35,1,17,29.875267745032875,0.6863095238095238,38.83101851851851,1044.6759259259247,29.847883597883563,0
3882,4,0,0,36,0.0,0.0,1.0,36,850,500,350,0.5882352941176471,12,5,7,345.6428855319215,0.41301256613756615,0.11447988580007684,0.23307017277578146,136509.172520683,2236.6848583247283,138745.85737900774,738,36,222.63888888888889,35,1,17,29.71409255362351,0.687202380952381,38.74421296296295,1045.0231481481458,29.857804232804163,0
3883,4,0,0,36,0.0,0.0,1.0,36,1100,700,400,0.6363636363636364,15,7,8,349.2434340335829,0.4122519841269841,0.11273496703080421,0.23610529163108676,136599.9014060355,2341.3237311385255,138941.225137174,739,37,223.63888888888889,35,1,17,29.53018895777974,0.6880952380952381,38.6574074074074,1045.370370370369,29.86772486772483,0
3884,4,0,0,36,0.0,0.0,1.0,36,950,700,250,0.7368421052631579,12,7,5,347.04207856736207,0.4115410052910053,0.11032712291705105,0.23522319428778046,136690.66043220577,2287.4821834276177,138978.14261563338,740,38,224.63888888888889,35,1,17,29.497901678657065,0.6889880952380952,38.57060185185184,1045.7175925925912,29.877645502645464,0
3885,4,0,0,36,0.0,0.0,1.0,36,800,500,300,0.625,11,5,6,345.8675259122873,0.41119378306878307,0.10856573705179273,0.23462905136211884,136720.92013888864,2257.4652777777437,138978.3854166664,741,39,225.63888888888889,35,1,17,29.49867197875165,0.6892857142857143,38.54166666666665,1045.8333333333312,29.88095238095232,0
3886,4,0,0,36,0.0,0.0,1.0,36,1200,900,300,0.75,15,9,6,344.4447213875709,0.4106646825396825,0.10526542253694315,0.23406702194743312,136781.44959919385,2222.7296596364613,139004.17925883032,742,40,226.63888888888889,35,1,18,29.476008703990566,0.6898809523809524,38.48379629629628,1046.064814814813,29.887566137566086,0
3887,4,0,0,36,0.0,0.0,1.0,36,650,300,350,0.46153846153846156,10,3,7,345.8414911112852,0.41021825396825395,0.10749754178957716,0.23542221985286257,136841.99245541822,2265.1277434842054,139107.12019890244,743,41,227.63888888888889,35,1,18,29.379609144542762,0.6904761904761905,38.42592592592592,1046.2962962962952,29.89417989417986,0
3888,4,0,0,36,0.0,0.0,1.0,36,950,700,250,0.7368421052631579,12,7,5,344.4223395699452,0.4095899470899471,0.11396688530228194,0.23567658727304996,137023.70139960546,2238.804762517121,139262.5061621226,744,42,228.63888888888889,35,1,16,29.23713980396491,0.6922619047619047,38.2523148148148,1046.9907407407393,29.914021164021122,0
3889,4,0,0,36,0.0,0.0,1.0,36,1000,800,200,0.8,12,8,4,342.1891380365722,0.40902777777777777,0.10646920129678716,0.2345551000723413,137084.29783950618,2181.751543209874,139266.04938271607,745,43,229.63888888888889,35,1,16,29.23574270557029,0.6928571428571428,38.19444444444444,1047.2222222222224,29.920634920634924,0
3890,4,0,0,36,0.0,0.0,1.0,36,1050,700,350,0.6666666666666666,14,7,7,343.08647477183234,0.4087301587301588,0.10582565991405724,0.2355791044525859,137144.90767532572,2210.5125814471785,139355.4202567729,746,44,230.63888888888889,35,1,17,29.152394106813997,0.6934523809523809,38.13657407407407,1047.4537037037032,29.927248677248663,0
3891,4,0,1,35,0.0,0.027777777777777776,0.9722222222222222,36,850,700,150,0.8235294117647058,10,7,3,347.2998984225857,0.4084325396825397,0.10542301745085036,0.23930390261172696,137266.16753472228,2334.5052083333385,139600.67274305562,747,45,231.63888888888889,35,1,17,28.922299536116636,0.6946428571428571,38.020833333333336,1047.916666666667,29.9404761904762,0
3892,4,0,0,35,0.0,0.0,1.0,35,900,700,200,0.7777777777777778,11,7,4,352.0427904809496,0.40780812324929977,0.10694239290989649,0.24224617662414685,137219.389526644,2661.41935941043,139880.80888605444,748,46,236.62857142857143,34,1,17,28.844260121955838,0.6963848039215687,38.06547619047619,1047.7380952380954,30.815826330532218,0
3893,4,0,0,35,0.0,0.0,1.0,35,1200,900,300,0.75,15,9,6,351.7747046696938,0.4076680672268908,0.10196523912302613,0.24249590643753463,137281.76197562367,2658.4502551020532,139940.2122307257,749,47,237.62857142857143,34,1,17,28.789664508311557,0.6969975490196079,38.00595238095239,1047.9761904761913,30.822829131652686,0
3894,4,0,0,35,0.0,0.0,1.0,35,850,700,150,0.8235294117647058,10,7,3,350.2056191938335,0.40710784313725495,0.10335036910846185,0.24184788054915324,137344.14859693873,2619.7385204081593,139963.8871173469,750,48,238.62857142857143,34,1,17,28.769165247018748,0.6976102941176471,37.94642857142857,1048.2142857142853,30.829831932773097,0
3895,4,0,0,35,0.0,0.0,1.0,35,1050,800,250,0.7619047619047619,13,8,5,349.5484053278891,0.40658263305322134,0.10314522538889537,0.24182818583839125,137406.54939058967,2606.048044217697,140012.59743480737,751,49,239.62857142857143,34,1,17,28.724783316301426,0.6982230392156863,37.886904761904766,1048.4523809523816,30.83683473389358,0
3896,4,0,0,35,0.0,0.0,1.0,35,1350,1100,250,0.8148148148148148,16,11,5,348.6518905227137,0.40598739495798314,0.10601589103291698,0.2418600909846541,137500.17715419497,2587.939342403621,140088.11649659858,752,50,240.62857142857143,34,1,17,28.655883465758617,0.6991421568627452,37.797619047619044,1048.8095238095234,30.847338935574218,0
3897,4,0,0,35,0.0,0.0,1.0,35,1350,1100,250,0.8148148148148148,16,11,5,347.04220162881273,0.4052521008403361,0.10479972767502543,0.2413956529561742,137593.8368055556,2550.1736111111163,140144.01041666672,753,51,241.62857142857143,34,1,17,28.60570558644428,0.7000612745098039,37.708333333333336,1049.166666666667,30.85784313725491,0
3898,4,0,0,35,0.0,0.0,1.0,35,1050,800,250,0.7619047619047619,13,8,5,346.23921672212805,0.40486694677871143,0.10255246738513923,0.24127262414273193,137656.2942885488,2532.401502267578,140188.69579081636,754,52,242.62857142857143,34,1,18,28.56518245415012,0.7006740196078431,37.648809523809526,1049.4047619047622,30.864845938375357,0
3899,4,0,2,33,0.0,0.05714285714285714,0.9428571428571428,35,950,800,150,0.8421052631578947,11,8,3,346.0301880811179,0.4047619047619047,0.10030622660768973,0.24156359210698472,137718.76594387757,2530.970096371884,140249.73604024947,755,53,243.62857142857143,34,1,19,28.509082832407096,0.7012867647058824,37.589285714285715,1049.6428571428573,30.871848739495803,0
3900,4,0,0,33,0.0,0.0,1.0,33,1000,700,300,0.7,13,7,6,351.8384307905024,0.4034090909090909,0.07576641871027312,0.24605712951691694,137780.33275963564,3095.283214388683,140875.61597402432,756,54,231.4848484848485,33,0,20,28.295956383020116,0.704229797979798,37.530637254901954,1049.8774509803914,31.81446821152701,0
3901,4,0,0,33,0.0,0.0,1.0,33,1050,800,250,0.7619047619047619,13,8,5,353.0486268581508,0.4032118055555556,0.07575757575757547,0.24713403880070545,137812.5,3130.902777777778,140943.40277777778,757,55,232.4848484848485,33,0,20,28.232473544973544,0.7045454545454546,37.5,1050.0,31.818181818181817,0
3902,4,0,1,32,0.0,0.030303030303030304,0.9696969696969697,33,650,400,250,0.6153846153846154,9,4,5,352.6055587249764,0.4026594065656566,0.07477811958558767,0.24728556778011815,137876.84574442508,3123.2284457900632,141000.07419021515,758,56,233.4848484848485,33,0,20,28.180669000388967,0.7051767676767677,37.43872549019607,1050.2450980392146,31.82560903149135,0
3903,4,0,0,32,0.0,0.0,1.0,32,1200,1000,200,0.8333333333333334,14,10,4,358.2685885424767,0.40013860887096775,0.07327987856198126,0.25102947353898736,137845.64593217534,3477.1530009692947,141322.79893314463,759,57,235.5,32,0,20,28.062752995871914,0.7073567708333333,37.468434343434346,1050.126262626263,32.81644570707072,0
3904,4,0,0,32,0.0,0.0,1.0,32,700,300,400,0.42857142857142855,11,3,8,357.35811059662404,0.399424563172043,-0.015448027036901513,0.2269348372860694,134354.35677800718,3202.523817722661,137556.88059572983,760,58,236.5,32,0,18,31.552186091828045,0.6728515625,40.81439393939393,1036.7424242424229,32.398200757575715,8
3905,4,0,0,32,0.0,0.0,1.0,32,850,700,150,0.8235294117647058,10,7,3,356.3429564661175,0.3989415322580645,-0.013562469556746004,0.22649290700462524,134387.08422609937,3177.57818079788,137564.66240689726,761,59,237.5,32,0,18,31.545806949180054,0.6731770833333333,40.782828282828284,1036.8686868686868,32.402146464646464,0
3906,4,0,0,32,0.0,0.0,1.0,32,1000,700,300,0.7,13,7,6,361.2436558844099,0.3986055107526882,-0.08976161369193125,0.22318527984399375,133341.78272625266,3233.7746148352508,136575.5573410879,762,60,238.5,32,0,21,32.46536267318665,0.6627604166666667,41.79292929292931,1032.8282828282847,32.2758838383839,8
3907,4,0,0,32,0.0,0.0,1.0,32,550,200,350,0.36363636363636365,9,2,7,361.2436558844099,0.3986055107526882,-0.08976161369193125,0.22318527984399375,133341.78272625266,3233.7746148352508,136575.5573410879,763,61,239.5,32,0,21,32.46536267318665,0.6627604166666667,41.79292929292931,1032.8282828282847,32.2758838383839,0
3908,4,0,0,32,0.0,0.0,1.0,32,550,400,150,0.7272727272727273,7,4,3,361.2436558844099,0.3986055107526882,-0.08976161369193125,0.22318527984399375,133341.78272625266,3233.7746148352508,136575.5573410879,764,62,240.5,32,0,21,32.46536267318665,0.6627604166666667,41.79292929292931,1032.8282828282847,32.2758838383839,0
3909,4,0,0,32,0.0,0.0,1.0,32,1000,700,300,0.7,13,7,6,362.3412555834893,0.39816448252688175,-0.0926272455089816,0.22445408739134695,133439.60636988582,3270.13490332621,136709.74127321204,765,63,241.5,32,0,21,32.33889364128885,0.6637369791666667,41.69823232323233,1033.2070707070716,32.28772095959599,0
3910,4,0,0,32,0.0,0.0,1.0,32,600,500,100,0.8333333333333334,7,5,2,362.1543498712014,0.39774445564516125,-0.09260461209529647,0.22473338542045387,133504.84206012153,3269.8718561881587,136774.7139163097,766,64,242.5,32,0,22,32.278303807778464,0.6643880208333333,41.63510101010102,1033.459595959597,32.295612373737406,0
3911,4,0,0,32,0.0,0.0,1.0,32,850,500,350,0.5882352941176471,12,5,7,362.37075103764175,0.3973034274193548,-0.09070364036159284,0.2250657790587358,133537.46588358347,3278.014360779533,136815.48024436302,767,65,243.5,32,0,22,32.24000325759426,0.6647135416666667,41.603535353535364,1033.5858585858598,32.29955808080812,0
3912,4,0,0,32,0.0,0.0,1.0,32,550,300,250,0.5454545454545454,8,3,5,362.12304684563446,0.39675739247311825,-0.09093337811431368,0.2253087771711289,133602.72548719533,3276.1252040608288,136878.85069125617,768,66,244.5,32,0,23,32.18098640286599,0.6653645833333333,41.54040404040405,1033.838383838385,32.30744949494953,0
3913,4,0,0,32,0.0,0.0,1.0,32,700,300,400,0.42857142857142855,11,3,8,360.53616712957376,0.39621135752688175,-0.0956959706959708,0.22471774800541927,133668.00103305784,3238.4297520661135,136906.43078512396,769,67,245.5,32,0,24,32.156593406593416,0.666015625,41.47727272727273,1034.090909090909,32.31534090909091,0
3914,4,0,0,32,0.0,0.0,1.0,32,950,700,250,0.7368421052631579,12,7,5,363.971604903867,0.395497311827957,-0.10644674231332363,0.22806661114618443,133863.92332415053,3344.5334022038455,137208.45672635437,770,68,246.5,32,0,21,31.871492191312843,0.66796875,41.28787878787878,1034.848484848484,32.33901515151513,0
3915,4,0,1,31,0.0,0.03125,0.96875,32,450,200,250,0.4444444444444444,7,2,5,366.99290225840264,0.39560231854838707,-0.10957896181529858,0.23016379646611532,133896.59098880214,3427.8197058973487,137324.4106946995,771,69,247.5,32,0,21,31.76060347281525,0.6682942708333333,41.25631313131313,1034.9747474747471,32.34296085858585,0
3916,4,0,0,31,0.0,0.0,1.0,31,900,700,200,0.7777777777777778,11,7,4,379.5079168080454,0.39336917562724016,-0.10677187983292535,0.2376634684691519,133842.48733520508,3958.8567097981786,137801.34404500326,772,70,253.38709677419354,31,0,21,31.491050081791876,0.6703629032258065,41.30859375,1034.765625,33.379536290322584,0
3917,4,0,0,31,0.0,0.0,1.0,31,1050,700,350,0.6666666666666666,14,7,7,381.50326332028,0.39242831541218637,-0.10205721241631172,0.23956958478643167,133943.5577392578,4019.980875651041,137963.53861490884,773,71,254.38709677419354,31,0,21,31.338050314465402,0.6713709677419355,41.2109375,1035.15625,33.39213709677419,0
3918,4,0,0,31,0.0,0.0,1.0,31,1100,900,200,0.8181818181818182,13,9,4,380.7757062247984,0.3914426523297491,-0.10148677476132917,0.23999128108653267,134078.3776177299,4010.757785373244,138089.13540310314,774,72,255.38709677419354,31,0,21,31.221712345989435,0.6727150537634409,41.08072916666666,1035.6770833333321,33.40893817204297,0
3919,4,0,0,31,0.0,0.0,1.0,31,750,700,50,0.9333333333333333,8,7,1,380.7757062247984,0.3914426523297491,-0.10148677476132917,0.23999128108653267,134078.3776177299,4010.757785373244,138089.13540310314,775,73,256.38709677419354,31,0,21,31.221712345989435,0.6727150537634409,41.08072916666666,1035.6770833333321,33.40893817204297,0
3920,4,0,0,31,0.0,0.0,1.0,31,1100,800,300,0.7272727272727273,14,8,6,380.93008687562195,0.39086021505376345,-0.09496203383508961,0.2407514456925592,134179.5370313855,4022.60453965927,138202.14157104478,776,74,257.38709677419354,31,0,21,31.11633886305558,0.6737231182795699,40.98307291666666,1036.0677083333321,33.42153897849458,0
3921,4,0,0,31,0.0,0.0,1.0,31,850,600,250,0.7058823529411765,11,6,5,389.4310556124775,0.3904569892473118,-0.07795083782387247,0.2269084950702037,131128.00598144543,4013.063557942722,135141.06953938815,777,75,258.38709677419354,31,0,20,33.97374777523519,0.6431451612903225,43.94531250000001,1024.218750000001,33.03931451612906,8
3922,4,0,0,31,0.0,0.0,1.0,31,850,500,350,0.5882352941176471,12,5,7,389.1435394981787,0.39063620071684585,-0.07134396990176273,0.22772853527064424,131294.76123385967,4018.501620822489,135313.26285468217,778,76,259.38709677419354,31,0,20,33.81201562698513,0.6448252688172043,43.782552083333336,1024.8697916666672,33.06031586021507,0
3923,4,0,0,31,0.0,0.0,1.0,31,950,700,250,0.7368421052631579,12,7,5,386.8068732678256,0.39077060931899643,-0.07628878648233484,0.22715168732170976,131428.24172973633,3967.469448513455,135395.7111782498,779,77,260.38709677419354,31,0,20,33.736640211640214,0.6461693548387097,43.65234375,1025.390625,33.07711693548387,0
3924,4,0,0,31,0.0,0.0,1.0,31,650,500,150,0.7692307692307693,8,5,3,390.36246141219505,0.39094982078853047,-0.0786282644039199,0.2296404113923721,131495.00740898988,4066.1429511176257,135561.1503601075,780,78,261.38709677419354,31,0,20,33.57784795395878,0.6468413978494624,43.587239583333336,1025.6510416666672,33.085517473118294,0
3925,4,0,0,31,0.0,0.0,1.0,31,900,600,300,0.6666666666666666,12,6,6,387.6036848164896,0.3904569892473118,-0.08096655462253677,0.22841656190494547,131561.7900424533,3998.766920301644,135560.55696275496,781,79,262.38709677419354,31,0,19,33.58095887803021,0.647513440860215,43.522135416666664,1025.911458333333,33.09391801075268,0
3926,4,0,1,30,0.0,0.03225806451612903,0.967741935483871,31,500,300,200,0.6,7,3,4,389.01285784225297,0.39018817204301076,-0.08462420173571306,0.22944770357761637,131595.18771701393,4038.4440104166724,135633.63172743062,782,80,263.38709677419354,31,0,19,33.510998307952626,0.6478494623655914,43.489583333333336,1026.041666666667,33.0981182795699,0
3927,4,0,1,29,0.0,0.03333333333333333,0.9666666666666667,30,700,600,100,0.8571428571428571,8,6,2,391.28997592159885,0.39013409961685824,-0.06199458562570992,0.23084294251819842,131603.8071597873,4299.050106948787,135902.8572667361,783,81,270.23333333333335,30,0,19,33.44385861496813,0.6506944444444445,43.48118279569893,1026.0752688172047,34.20250896057349,0
3928,4,0,0,29,0.0,0.0,1.0,29,450,300,150,0.6666666666666666,6,3,3,394.932950254939,0.3875205254515599,-0.05713672201397613,0.23283078240488717,131577.3750964507,4592.848186728407,136170.2232831791,784,82,274.86206896551727,29,0,19,33.377188529398495,0.6533764367816092,43.50694444444445,1025.9722222222229,35.37835249042148,0
3929,4,0,1,28,0.0,0.034482758620689655,0.9655172413793104,29,700,600,100,0.8571428571428571,8,6,2,395.2787019726396,0.3875205254515599,-0.05907330502543051,0.23368876860622473,131684.2689043211,4610.3973765432265,136294.66628086433,785,83,275.86206896551727,29,0,19,33.26003608479928,0.6544540229885057,43.402777777777786,1026.3888888888898,35.39272030651344,0
3930,4,0,0,28,0.0,0.0,1.0,28,600,500,100,0.8333333333333334,7,5,2,402.74762193402364,0.3859953703703704,-0.08250334993300112,0.2379508902791343,131659.69177318682,5005.125553243517,136664.81732643035,786,84,265.32142857142856,28,0,19,33.093296467404,0.6573660714285714,43.426724137931046,1026.293103448277,36.65332512315275,0
3931,4,0,0,28,0.0,0.0,1.0,28,650,400,250,0.6153846153846154,9,4,5,402.74762193402364,0.3859953703703704,-0.08250334993300112,0.2379508902791343,131659.69177318682,5005.125553243517,136664.81732643035,787,85,266.32142857142856,28,0,19,33.093296467404,0.6573660714285714,43.426724137931046,1026.293103448277,36.65332512315275,0
3932,4,0,0,28,0.0,0.0,1.0,28,550,400,150,0.7272727272727273,7,4,3,404.1767091061624,0.3862433862433863,-0.08495640697488394,0.23902635843165773,131696.55833003044,5045.736309287898,136742.29463931834,788,86,267.32142857142856,28,0,19,33.01925858529304,0.6577380952380952,43.390804597701155,1026.4367816091958,36.65845648604271,0
3933,4,0,0,28,0.0,0.0,1.0,28,950,800,150,0.8421052631578947,11,8,3,404.50030986083976,0.384700176366843,-0.08403949156607216,0.24014686170143568,131844.07616594015,5066.193932487804,136910.27009842795,789,87,268.32142857142856,28,0,19,32.86146474538332,0.6592261904761905,43.24712643678162,1027.0114942528746,36.678981937602664,0
3934,4,1,0,29,0.034482758620689655,0.0,1.0,29,900,800,100,0.8888888888888888,10,8,2,391.91359656008285,0.38993226600985226,-0.07793187245988187,0.23543422625470684,132290.82031250012,4569.314236111126,136860.13454861124,790,0,260.0344827586207,29,0,20,32.73297218847036,0.6605603448275862,42.81250000000001,1028.750000000001,35.47413793103451,0
3935,4,1,0,30,0.03333333333333333,0.0,1.0,30,350,300,50,0.8571428571428571,4,3,1,379.00501964100465,0.39226532567049804,-0.06779270466501452,0.23043865865087904,132744.051425743,4062.1323635680633,136806.18378931106,791,0,252.33333333333334,30,0,19,32.60809312638582,0.6621527777777778,42.372311827957,1030.5107526881732,34.3503584229391,0
3936,4,0,0,30,0.0,0.0,1.0,30,950,600,350,0.631578947368421,13,6,7,378.31210684186635,0.3924808429118774,-0.06495392105720743,0.23022993930662167,132778.68106139443,4046.35651520408,136825.0375765985,792,1,253.33333333333334,30,0,19,32.59107111806644,0.6625,42.33870967741936,1030.6451612903231,34.35483870967744,0
3937,4,0,0,30,0.0,0.0,1.0,30,800,600,200,0.75,10,6,4,378.528240371654,0.3918103448275862,-0.06709256844850076,0.2307878858227812,132847.95388195172,4057.3404439819665,136905.29432593368,793,2,254.33333333333334,30,0,19,32.51575401999132,0.6631944444444444,42.27150537634409,1030.913978494624,34.36379928315413,0
3938,4,0,0,30,0.0,0.0,1.0,30,1350,900,450,0.6666666666666666,18,9,9,381.7665925016211,0.390948275862069,-0.06436452089305889,0.23362654153568105,132986.5537200832,4153.9646924499875,137140.5184125332,794,3,255.33333333333334,30,0,19,32.29275258448441,0.6645833333333333,42.137096774193544,1031.4516129032254,34.381720430107514,0
3939,4,0,0,30,0.0,0.0,1.0,30,950,700,250,0.7368421052631579,12,7,5,380.9980795552207,0.39102011494252875,-0.062336590662323665,0.23337272630377637,133021.21497066133,4136.165488784827,137157.38045944617,795,4,256.3333333333333,30,0,19,32.277687296416936,0.6649305555555556,42.10349462365591,1031.5860215053763,34.38620071684588,0
3940,4,0,1,29,0.0,0.03333333333333333,0.9666666666666667,30,750,500,250,0.6666666666666666,10,5,5,377.9776672707093,0.3917624521072797,-0.058140140661630646,0.23216900234436044,133125.22582090413,4063.6724621343456,137188.89828303846,796,5,257.3333333333333,30,0,19,32.2509659633585,0.6659722222222222,42.00268817204301,1031.9892473118277,34.399641577060926,0
3941,4,0,0,29,0.0,0.0,1.0,29,750,400,350,0.5333333333333333,11,4,7,383.5738974162293,0.3908559113300492,-0.0464904791952786,0.23598685476799805,133185.33950617284,4417.283950617281,137602.6234567901,797,6,262.13793103448273,29,0,19,32.04610692500898,0.6695402298850575,41.94444444444444,1032.2222222222222,35.593869731800766,0
3942,4,0,0,29,0.0,0.0,1.0,29,700,500,200,0.7142857142857143,9,5,4,383.09537102382063,0.3903940886699508,-0.04924121239098078,0.23683127799702036,133364.60503472228,4418.272569444451,137782.87760416672,798,7,263.13793103448273,29,0,20,31.878193491999475,0.6713362068965517,41.770833333333336,1032.916666666667,35.61781609195403,0
3943,4,0,0,29,0.0,0.0,1.0,29,600,400,200,0.6666666666666666,8,4,4,382.4141519250782,0.39008620689655177,-0.05088987764182429,0.23709677419354835,133472.22222222216,4408.33333333333,137880.5555555555,799,8,264.13793103448273,29,0,21,31.787634408602155,0.6724137931034483,41.666666666666664,1033.333333333333,35.63218390804597,0
3944,4,0,0,29,0.0,0.0,1.0,29,900,500,400,0.5555555555555556,13,5,8,380.33350115452185,0.3892138752052545,-0.05198126450680385,0.23649308680811257,133579.88281250003,4360.980902777778,137940.8637152778,800,9,265.13793103448273,29,0,22,31.73325607953782,0.6734913793103448,41.5625,1033.7500000000002,35.646551724137936,0
3945,4,0,0,29,0.0,0.0,1.0,29,650,400,250,0.6153846153846154,9,4,5,381.1654844277782,0.38854679802955666,-0.05252310043769237,0.23747088130249439,133651.6806520061,4388.68152006172,138040.3621720678,801,10,266.13793103448273,29,0,23,31.63966308484442,0.6742097701149425,41.49305555555555,1034.0277777777771,35.65613026819921,0
3946,4,0,0,29,0.0,0.0,1.0,29,650,400,250,0.6153846153846154,9,4,5,380.7461418272526,0.3879310344827586,-0.05332814865221436,0.23813417384309027,133795.33420138885,4388.41145833333,138183.7456597222,802,11,267.13793103448273,29,0,18,31.50632635253055,0.6756465517241379,41.354166666666664,1034.583333333333,35.67528735632183,0
3947,4,0,0,29,0.0,0.0,1.0,29,900,700,200,0.7777777777777778,11,7,4,380.4729414937843,0.3866995073891626,-0.05385473102708016,0.23889341473910491,133939.06491126554,4392.038001543227,138331.10291280877,803,12,268.13793103448273,29,0,20,31.369219330023707,0.6770833333333333,41.215277777777786,1035.1388888888896,35.69444444444447,0
3948,4,0,0,29,0.0,0.0,1.0,29,750,500,250,0.6666666666666666,10,5,5,379.32422428106287,0.38582717569786534,-0.0465933253212536,0.23981006043531614,134190.77932098764,4380.362654320987,138571.14197530862,804,13,269.13793103448273,29,0,21,31.14667113494191,0.6795977011494253,40.97222222222222,1036.111111111111,35.727969348659,0
3949,4,0,0,29,0.0,0.0,1.0,29,700,500,200,0.7142857142857143,9,5,4,400.8459837782058,0.38500615763546797,-0.013239125842116506,0.227352413193121,130085.41907793187,4628.843557098739,134714.2626350306,805,14,270.13793103448273,29,0,21,34.742313365100976,0.6382902298850575,44.965277777777764,1020.1388888888871,35.17720306513404,8
3950,4,1,0,30,0.03333333333333333,0.0,1.0,30,650,400,250,0.6153846153846154,9,4,5,384.5048420705274,0.39068486590038315,-0.012126155519304405,0.22028174597124572,130475.34722222199,4033.801118827122,134509.14834104912,806,0,262.1,29,1,22,34.762438825448605,0.6422413793103448,44.583333333333314,1021.6666666666647,35.22988505747119,0
3951,4,0,1,29,0.0,0.03333333333333333,0.9666666666666667,30,950,600,350,0.631578947368421,13,6,7,382.69481414943624,0.3903496168582376,-0.008235933677630092,0.21964652437687604,130546.3059413579,3991.8788580246705,134538.18479938258,807,1,263.1,29,1,20,34.73656790794599,0.6429597701149425,44.51388888888888,1021.9444444444434,35.239463601532535,0
3952,4,0,0,29,0.0,0.0,1.0,29,600,400,200,0.6666666666666666,8,4,4,394.7904876174753,0.38459564860426926,-0.005259506169245753,0.22536353377489116,130335.93285523169,4491.077297199074,134827.01015243077,808,17,273.13793103448273,28,1,21,34.64160921157543,0.6439732142857143,44.71982758620688,1021.120689655171,36.468596059113246,0
3953,4,2,1,30,0.06451612903225806,0.03225806451612903,0.967741935483871,31,650,300,350,0.46153846153846156,10,3,7,379.95249010813706,0.3922939068100359,0.021253915410729185,0.2217704890334436,131194.69536675335,3769.5502387152674,134964.24560546863,809,0,256.4516129032258,31,0,22,34.148873072360644,0.6438172043010753,43.88020833333333,1024.4791666666656,33.047715053763405,0
3954,4,0,0,30,0.0,0.0,1.0,30,600,300,300,0.5,9,3,6,384.6401581692053,0.3911877394636016,0.018985126859142554,0.22407935819949104,131121.55306971897,4086.922982425703,135208.47605214466,810,1,260.06666666666666,30,0,22,34.102963692038486,0.6458333333333333,43.9516129032258,1024.1935483870961,34.13978494623654,0
3955,4,0,0,30,0.0,0.0,1.0,30,1100,1000,100,0.9090909090909091,12,10,2,385.25285634445896,0.3910919540229885,0.02169159450712832,0.22483899472109206,131190.39231414013,4108.294672794511,135298.68698693466,811,2,261.06666666666666,30,0,22,34.01748228811335,0.6465277777777778,43.88440860215052,1024.462365591396,34.1487455197132,0
3956,4,0,0,30,0.0,0.0,1.0,30,850,500,350,0.5882352941176471,12,5,7,391.54257457672725,0.3900622605363984,0.03076284153005493,0.22912602694915885,131293.68505390768,4281.4134943345725,135575.09854824227,812,3,262.06666666666666,30,0,22,33.75163934426231,0.6475694444444444,43.78360215053762,1024.865591397847,34.16218637992824,0
3957,4,0,0,30,0.0,0.0,1.0,30,1000,700,300,0.7,13,7,6,389.2726907387142,0.38977490421455935,0.03128030402306381,0.22903160393424252,131500.39247673136,4237.902322522828,135738.2947992542,813,4,263.06666666666666,30,0,22,33.60033634735509,0.6496527777777779,43.581989247311824,1025.672043010752,34.189068100358405,0
3958,4,0,0,30,0.0,0.0,1.0,30,750,400,350,0.5333333333333333,11,4,7,390.28644425545787,0.38946360153256704,0.033036338225017614,0.22983535050599158,131534.8595213318,4267.254523644335,135802.11404497613,814,5,264.06666666666666,30,0,22,33.5394282844165,0.65,43.548387096774185,1025.806451612902,34.19354838709673,0
3959,4,0,0,30,0.0,0.0,1.0,30,600,400,200,0.6666666666666666,8,4,4,389.3111831169923,0.38874521072796936,0.03411055802986662,0.22967554651585134,131603.80715978716,4246.966773615438,135850.7739334026,815,6,265.06666666666666,30,0,17,33.494618373941144,0.6506944444444445,43.48118279569892,1026.0752688172036,34.202508960573454,0
3960,4,0,0,30,0.0,0.0,1.0,30,1100,1000,100,0.9090909090909091,12,10,2,391.22797431009633,0.3888170498084291,0.0312557286892754,0.231433620434253,131707.2624906059,4305.513101225581,136012.77559183148,816,7,266.06666666666666,30,0,17,33.34069879097376,0.6517361111111111,43.380376344086024,1026.4784946236564,34.215949820788545,0
3961,4,0,0,30,0.0,0.0,1.0,30,300,100,200,0.3333333333333333,5,1,4,388.49685184409884,0.38867337164750954,0.024484007505345184,0.2302348682107892,131776.2552932421,4238.932065845775,136015.1873590879,817,8,267.06666666666666,30,0,18,33.340969585896936,0.6524305555555556,43.31317204301076,1026.747311827958,34.224910394265265,0
3962,4,0,1,29,0.0,0.03333333333333333,0.9666666666666667,30,650,400,250,0.6153846153846154,9,4,5,390.57630043641655,0.3880268199233716,0.022716566343888855,0.23209829610692811,131879.77837033183,4301.823187651748,136181.60155798358,818,9,268.06666666666666,30,0,18,33.18284916688475,0.6534722222222222,43.21236559139785,1027.1505376344085,34.238351254480285,0
3963,4,0,1,28,0.0,0.034482758620689655,0.9655172413793104,29,350,200,150,0.5714285714285714,5,2,3,401.4496075293878,0.3867508210180624,0.01875026236374544,0.23800456683759136,131791.2061149692,4781.505594135809,136572.711709105,819,10,269.9310344827586,29,0,18,32.99334392894179,0.6555316091954023,43.298611111111114,1026.8055555555559,35.40708812260537,0
3964,4,0,0,28,0.0,0.0,1.0,28,700,600,100,0.8571428571428571,8,6,2,411.6484098989447,0.38252314814814814,0.018704625907481676,0.24320964366486036,131659.69177318664,5239.500553243488,136899.19232643011,820,11,279.5357142857143,28,0,19,32.86492603481265,0.6573660714285714,43.42672413793103,1026.2931034482756,36.6533251231527,0
3965,4,0,0,28,0.0,0.0,1.0,28,700,400,300,0.5714285714285714,10,4,6,413.5848292802101,0.3830467372134039,0.017682219823277334,0.24506444361827392,131770.30692627828,5299.639978861148,137069.94690513943,821,12,280.5357142857143,28,0,19,32.70302733463941,0.6584821428571428,43.31896551724138,1026.7241379310349,36.668719211822676,0
3966,4,0,0,28,0.0,0.0,1.0,28,350,300,50,0.8571428571428571,4,3,1,408.002230978501,0.38315696649029984,-0.007335087009307628,0.22294858751611574,128617.75829039494,4895.266465186939,133513.02475558186,822,13,281.5357142857143,28,0,20,36.06143767705384,0.6264880952380952,46.40804597701149,1014.3678160919533,36.22742200328405,8
3967,4,0,0,28,0.0,0.0,1.0,28,550,400,150,0.7272727272727273,7,4,3,417.8471759575651,0.38401124338624343,0.014407613038044609,0.2112870455367729,125467.39011510754,4885.238926872749,130352.62904198028,823,14,282.5357142857143,28,0,18,39.067355036091584,0.5941220238095238,49.53304597701148,1001.8678160919529,35.780993431855464,8
3968,4,5,3,30,0.15151515151515152,0.09090909090909091,0.9090909090909091,33,650,400,250,0.6153846153846154,9,4,5,364.2149647545756,0.41157670454545453,0.01352859906051429,0.1911721815639045,126999.3530883554,2651.012981785851,129650.36607014126,824,0,240.57575757575756,33,0,17,38.83067375886526,0.5962752525252526,48.00857843137255,1007.9656862745095,30.544414735591197,0
3969,4,1,0,31,0.03225806451612903,0.0,1.0,31,950,700,250,0.7368421052631579,12,7,5,379.41397445529657,0.40676523297491035,0.04212210077312695,0.19960474308300405,127092.01388888896,3444.0972222222317,130536.1111111112,825,0,252.6451612903226,31,0,19,38.35227272727271,0.6021505376344086,47.91666666666667,1008.333333333334,32.52688172043013,0
3970,4,1,1,31,0.03125,0.03125,0.96875,32,1200,1000,200,0.8333333333333334,14,10,4,386.7253299924639,0.41040826612903225,0.11455427339589175,0.1884867708479954,123929.07133200674,3185.302201305965,127114.37353331271,826,0,245.71875,32,0,18,41.446603685856786,0.5670572916666667,51.07323232323231,995.7070707070691,31.11584595959591,8
3971,4,7,4,34,0.18421052631578946,0.10526315789473684,0.8947368421052632,38,800,400,400,0.5,12,4,8,346.4728410874812,0.4311581318160265,0.12660912991830098,0.17866806128287901,126276.38996056223,1378.6047908943287,127654.99475145656,827,0,207.68421052631578,35,3,15,40.0209196990634,0.5845238095238094,48.72685185185184,1005.0925925925911,28.716931216931176,8
3972,4,4,1,37,0.10526315789473684,0.02631578947368421,0.9736842105263158,38,1150,800,350,0.6956521739130435,15,8,7,349.19944142001935,0.4346995021337126,0.16046914043356453,0.18200634756816955,126713.00482521007,1249.6221011231178,127962.62692633319,828,0,208.57894736842104,35,3,19,39.503223550599685,0.5889880952380953,48.292824074074076,1006.8287037037039,28.766534391534396,0
3973,4,2,0,39,0.05128205128205128,0.0,1.0,39,1750,1400,350,0.8,21,14,7,344.5652638635596,0.43814664867296443,0.17126181146373898,0.18179363437256585,127208.74592764069,966.9089988426033,128175.65492648329,829,0,204.17948717948718,35,4,22,39.11102187547803,0.594047619047619,47.80092592592593,1008.796296296297,28.822751322751344,0
3974,4,1,0,40,0.025,0.0,1.0,40,900,700,200,0.7777777777777778,11,7,4,337.1582967627752,0.4415464743589744,0.17153846153846164,0.17937781269051586,127546.62390430988,600.6804946838907,128147.30439899377,830,0,200.05,36,4,18,38.951830174656266,0.5954861111111112,47.466216216216225,1010.1351351351365,28.059309309309345,0
3975,4,1,3,38,0.024390243902439025,0.07317073170731707,0.926829268292683,41,1200,700,500,0.5833333333333334,17,7,10,350.39181125103516,0.44275914634146346,0.18466898954703836,0.18017777971913435,126160.0865912209,743.7054202601053,126903.792011481,831,0,196.14634146341464,35,6,20,40.04224270353303,0.5833333333333333,48.842592592592595,1004.62962962963,28.703703703703713,8
3976,4,2,1,39,0.05,0.025,0.975,40,900,700,200,0.7777777777777778,11,7,4,360.01094715888775,0.4428418803418803,0.19653855264716347,0.18567943963729344,126283.03748582787,1092.6551870748583,127375.69267290272,832,0,201.6,34,6,21,39.67389158671879,0.586703431372549,48.72023809523811,1005.1190476190493,29.56232492997204,0
3977,4,0,2,37,0.0,0.05128205128205128,0.9487179487179487,39,1300,900,400,0.6923076923076923,17,9,8,354.7464126858336,0.4384840305892937,0.08950598617003247,0.1801658478118639,125648.36109335687,1147.9979479617532,126796.35904131862,833,1,207.69230769230768,36,3,16,40.46084653113185,0.576099537037037,49.35247747747748,1002.59009009009,27.849724724724723,8
3978,4,5,2,40,0.11904761904761904,0.047619047619047616,0.9523809523809523,42,950,600,350,0.631578947368421,13,6,7,340.29739131595994,0.444190379403794,0.1643287806078504,0.17844863203154,126960.75439453124,240.88270399305475,127201.63709852428,834,0,193.5952380952381,39,3,18,39.47297588285959,0.5841346153846154,48.046875,1007.8124999999999,25.84134615384615,0
3979,4,2,0,42,0.047619047619047616,0.0,1.0,42,550,300,250,0.5454545454545454,8,3,5,342.18816288815077,0.4451703445605885,0.18527545771623188,0.18075863805377518,127257.91229032012,309.3658776017685,127567.27816792189,835,0,194.3095238095238,37,5,20,39.12057161486635,0.5906531531531531,47.752192982456144,1008.9912280701756,27.270033191085826,0
3980,4,0,0,42,0.0,0.0,1.0,42,900,400,500,0.4444444444444444,14,4,10,339.9778259501091,0.44432346109175375,0.18961937018668618,0.18005103697178415,127361.47636788659,260.015569070051,127621.49193695663,836,1,195.3095238095238,38,4,15,39.07021768275472,0.5899122807017544,47.64957264957265,1009.401709401709,26.563202878992342,0
3981,4,2,2,42,0.045454545454545456,0.045454545454545456,0.9545454545454546,44,1200,800,400,0.6666666666666666,16,8,8,330.39551944576584,0.4487425123326286,0.2028145922197968,0.1772736714309275,127887.41949443113,-349.3139211117807,127538.10557331935,837,0,187.38636363636363,40,4,18,38.774322649787344,0.5919270833333333,47.1290650406504,1011.4837398373976,25.28709349593494,0
3982,4,1,2,41,0.023255813953488372,0.046511627906976744,0.9534883720930233,43,1000,600,400,0.6,14,6,8,334.2660721022449,0.44772056109265407,0.2070418757901995,0.17955708474872809,127933.68055555571,-47.22222222220387,127886.4583333335,838,0,192.53488372093022,39,4,20,38.62918725974741,0.594017094017094,47.08333333333334,1011.6666666666679,25.940170940170972,0
3983,4,1,0,42,0.023809523809523808,0.0,1.0,42,1150,600,550,0.5217391304347826,17,6,11,343.4489991711519,0.44321041424699964,0.22171424651358795,0.18521850021893774,128091.80230034738,398.6002604166853,128490.40256076407,839,0,197.5952380952381,39,3,21,38.235319338684235,0.5956196581196581,46.92708333333334,1012.291666666668,25.956196581196615,0
3984,4,0,1,41,0.0,0.023809523809523808,0.9761904761904762,42,1500,800,700,0.5333333333333333,22,8,14,347.99336266128114,0.4426417924893535,0.22099516879099212,0.18855274655738716,128279.78326576116,528.1134787169806,128807.89674447814,840,1,198.5952380952381,38,4,21,37.92822365183156,0.5992324561403508,46.74145299145301,1013.0341880341907,26.658794421952386,0
3985,4,2,2,41,0.046511627906976744,0.046511627906976744,0.9534883720930233,43,1000,800,200,0.8,12,8,4,340.9027875774331,0.44419066076042824,0.21668485828451,0.18616771972189977,128593.16541883716,167.55371093753854,128760.7191297747,841,0,194.74418604651163,39,4,14,37.78809780562118,0.6006944444444444,46.432291666666686,1014.2708333333362,26.006944444444517,0
3986,4,0,0,41,0.0,0.0,1.0,41,850,600,250,0.7058823529411765,11,6,5,357.3219009898122,0.4400914634146342,0.22461933958155678,0.19389381603328587,128338.889429921,971.6591884041541,129310.54861832515,842,3,205.2439024390244,37,4,21,37.631546910507524,0.6016328828828829,46.68311403508773,1013.2675438596511,27.385609293504086,0
3987,4,0,0,41,0.0,0.0,1.0,41,1300,900,400,0.6923076923076923,17,9,8,360.005699604978,0.43973577235772354,0.2265622526411324,0.19575839336167183,128422.23087873214,1046.54701446601,129468.77789319814,843,4,206.2439024390244,37,4,16,37.478364344439626,0.6024774774774775,46.600877192982466,1013.596491228072,27.394499762920862,0
3988,4,0,2,39,0.0,0.04878048780487805,0.9512195121951219,41,1000,700,300,0.7,13,7,6,357.50229393287276,0.4391006097560976,0.06466778350855384,0.19453259019478564,128450.01737313403,984.235173322554,129434.25254645658,844,5,207.2439024390244,37,4,13,37.51340814854874,0.602759009009009,46.5734649122807,1013.7061403508771,27.39746325272641,8
3989,4,1,2,38,0.025,0.05,0.95,40,850,600,250,0.7058823529411765,11,6,5,367.90762661332815,0.43647168803418807,0.0882992895204262,0.20109902309058625,128629.57552146743,1464.7603684765877,130094.33588994402,845,0,212.975,36,4,14,37.06612640615751,0.6064814814814814,46.3963963963964,1014.4144144144145,28.178178178178182,0
3990,4,1,1,38,0.02564102564102564,0.02564102564102564,0.9743589743589743,39,750,500,250,0.6666666666666666,10,5,5,373.7646285338593,0.4382309941520468,0.12065746219592399,0.20588729537882083,128936.767578125,1838.4006076388891,130775.16818576389,846,0,218.7948717948718,35,4,16,36.60363247863248,0.6116071428571428,46.09375,1015.625,29.017857142857142,0
3991,4,1,0,39,0.02564102564102564,0.0,1.0,39,1150,800,350,0.6956521739130435,15,8,7,374.04773413043864,0.43865272154745844,0.12989584154599498,0.20696365175799536,129113.15164448322,1858.8963638117514,130972.04800829498,847,0,219.56410256410257,35,4,17,36.416339255210104,0.6133928571428571,45.9201388888889,1016.3194444444462,29.03769841269846,0
3992,4,1,2,38,0.025,0.05,0.95,40,1150,600,550,0.5217391304347826,17,6,11,368.5482578318729,0.4405715811965812,0.13636131013306052,0.20575522737242288,129466.28146701399,1542.944637345689,131009.22610435968,848,0,215.05,35,5,15,36.19605083589219,0.6169642857142856,45.57291666666667,1017.7083333333342,29.077380952380977,0
3993,4,0,1,37,0.0,0.02631578947368421,0.9736842105263158,38,750,500,250,0.6666666666666666,10,5,5,382.28970706799225,0.4347735893788525,0.15034512510785114,0.2119970193740686,129201.38888888905,2278.4722222222413,131479.8611111113,849,2,226.8421052631579,34,4,17,36.116803278688515,0.616421568627451,45.83333333333334,1016.666666666668,29.901960784313765,0
3994,4,0,0,37,0.0,0.0,1.0,37,1650,1300,350,0.7878787878787878,20,13,7,386.4415970069566,0.43293293293293295,0.1416151818236706,0.21534898953541187,129394.01113406788,2600.6456611570175,131994.6567952249,673,3,211.02702702702703,32,5,18,35.814563167038976,0.623046875,45.64393939393939,1017.4242424242418,31.794507575757557,0
3995,4,0,0,37,0.0,0.0,1.0,37,800,500,300,0.625,11,5,6,385.01965867166496,0.43218218218218213,0.13943008881602137,0.21508270745338098,129490.37606175375,2571.2680785123785,132061.64414026611,674,4,212.02702702702703,32,5,15,35.752388041185974,0.6240234375,45.549242424242415,1017.803030303029,31.806344696969656,0
3996,4,0,2,35,0.0,0.05405405405405406,0.9459459459459459,37,1400,900,500,0.6428571428571429,19,9,10,378.16104317658534,0.43140015015015015,0.038222586647324475,0.21462517483598278,130110.72137188219,2453.510317694586,132564.2316895768,675,5,213.02702702702703,34,3,18,35.295118630882925,0.6256127450980392,44.9404761904762,1020.2380952380961,30.007002801120475,8
3997,4,0,0,35,0.0,0.0,1.0,35,600,400,200,0.6666666666666666,8,4,4,397.174231006244,0.4254201680672269,0.06508369015181015,0.22425068119891017,129908.37191358031,3319.251543209885,133227.6234567902,676,7,225.85714285714286,32,3,18,35.016462306993645,0.6282552083333333,45.13888888888889,1019.4444444444449,31.857638888888903,0
3998,4,0,0,35,0.0,0.0,1.0,35,1000,600,400,0.6,14,6,8,398.2585978833139,0.42531512605042016,0.06654405262971741,0.22560539647274971,130037.12153096627,3357.6803387409454,133394.8018697072,677,8,226.85714285714286,32,3,18,34.85753486836674,0.6295572916666667,45.01262626262626,1019.9494949494953,31.873421717171727,0
3999,4,0,1,34,0.0,0.02857142857142857,0.9714285714285714,35,1400,1200,200,0.8571428571428571,16,12,4,396.66805497709265,0.4245798319327731,0.07043731778425655,0.22600854295206466,130262.58680555565,3334.2013888889,133596.78819444455,678,9,227.85714285714286,32,3,18,34.66836734693877,0.6318359375,44.79166666666667,1020.8333333333342,31.901041666666693,0
4000,4,1,0,35,0.02857142857142857,0.0,1.0,35,700,400,300,0.5714285714285714,10,4,6,399.83467816483585,0.4214985994397759,0.07674377538407207,0.2287597274648885,130423.75299714321,3429.587860932566,133853.34085807577,679,0,228.31428571428572,32,3,19,34.42341367943964,0.6334635416666667,44.63383838383839,1021.464646464647,31.92077020202022,0
4001,4,0,0,35,0.0,0.0,1.0,35,750,500,250,0.6666666666666666,10,5,5,399.83467816483585,0.4213235294117647,0.07674377538407207,0.2287597274648885,130423.75299714321,3429.587860932566,133853.34085807577,680,1,229.31428571428572,32,3,19,34.42341367943964,0.6334635416666667,44.63383838383839,1021.464646464647,31.92077020202022,0
4002,4,0,0,35,0.0,0.0,1.0,35,900,500,400,0.5555555555555556,13,5,8,403.2216387470925,0.42142857142857143,0.07991667255137358,0.2310814094009543,130488.2473727172,3523.1369885726126,134011.38436128982,681,2,230.31428571428572,32,3,18,34.27124526281101,0.6341145833333333,44.57070707070708,1021.7171717171727,31.928661616161648,0
4003,4,0,0,35,0.0,0.0,1.0,35,600,200,400,0.3333333333333333,10,2,8,405.3927248268992,0.42100840336134454,0.0830424424247771,0.2329066080534954,130585.01882779822,3587.6433208346143,134172.66214863284,682,3,231.31428571428572,32,3,18,34.11725344863084,0.6350911458333333,44.476010101010104,1022.0959595959599,31.940498737373748,0
4004,4,0,0,35,0.0,0.0,1.0,35,850,400,450,0.47058823529411764,13,4,9,409.11048248762074,0.42065826330532213,0.11931162371536064,0.21770805081636257,127555.82475790556,3436.885002162623,130992.70976006819,683,4,232.31428571428572,33,2,14,37.12531339722592,0.6019570707070707,47.45710784313725,1010.1715686274505,30.61125965537729,8
4005,4,1,1,35,0.027777777777777776,0.027777777777777776,0.9722222222222222,36,1100,700,400,0.6363636363636364,15,7,8,401.3038439512661,0.42347883597883595,0.12040087863811144,0.21556764006939685,127933.68055555547,3068.0555555555466,131001.73611111102,684,0,226.83333333333334,34,2,16,36.933690280065896,0.6035539215686274,47.08333333333333,1011.666666666666,29.75490196078429,0
4006,4,0,0,35,0.0,0.0,1.0,35,800,500,300,0.625,11,5,6,408.488568868871,0.4207983193277311,0.12471182803143033,0.21922396927462054,127896.48963139187,3448.850802575942,131345.34043396782,685,1,233.54285714285714,33,2,17,36.79024311444955,0.6054292929292929,47.12009803921569,1011.519607843138,30.65210932857994,0
4007,4,0,0,35,0.0,0.0,1.0,35,1050,700,350,0.6666666666666666,14,7,7,404.5792477433993,0.4200280112044818,0.12815990593768345,0.21847279378143578,128144.53125000004,3369.1639033064225,131513.69515330647,686,2,234.54285714285714,32,3,17,36.63408779149519,0.6103515625,46.875,1012.5000000000003,31.64062500000001,0
4008,4,1,0,36,0.027777777777777776,0.0,1.0,36,1250,800,450,0.64,17,8,9,392.95593180369536,0.42347883597883595,0.12701769935272456,0.214184280615532,128517.04422577856,2900.3069732795097,131417.35119905806,687,0,229.0,33,3,17,36.546209008137936,0.6117424242424243,46.50735294117647,1013.9705882352943,30.726381461675583,0
4009,4,0,0,36,0.0,0.0,1.0,36,750,400,350,0.5333333333333333,11,4,7,396.4683333667889,0.42278439153439157,0.15896143873497603,0.2066433811838045,126713.00482521007,2847.538767789784,129560.54359299985,688,1,230.0,35,1,18,38.313431620492786,0.5889880952380953,48.292824074074076,1006.8287037037039,28.766534391534396,8
4010,4,2,0,38,0.05263157894736842,0.0,1.0,38,950,700,250,0.7368421052631579,12,7,5,377.65856160560827,0.42918741109530584,0.15636760887221346,0.19949564201462727,127257.91229032012,2012.0080216989911,129269.92031201911,689,0,218.8421052631579,37,1,20,38.22583858581471,0.5906531531531531,47.752192982456144,1008.9912280701756,27.270033191085826,0
4011,4,1,2,37,0.02564102564102564,0.05128205128205128,0.9487179487179487,39,900,500,400,0.5555555555555556,13,5,8,368.9356552972538,0.4315958164642375,0.15679670232816711,0.19630200454898936,127550.26989051446,1611.5684810797218,129161.83837159419,690,0,214.2051282051282,38,1,16,38.14560197426406,0.5918311403508771,47.46260683760685,1010.1495726495741,26.582883490778265,0
4012,4,0,0,37,0.0,0.0,1.0,37,800,600,200,0.75,10,6,4,382.92544733859586,0.4255505505505506,0.1569986457833792,0.20244217897351985,127290.80590303159,2348.5777585017636,129639.38366153336,691,1,226.72972972972974,36,1,19,38.059135885131866,0.5928819444444444,47.719594594594604,1009.1216216216231,28.0311561561562,0
4013,4,0,0,37,0.0,0.0,1.0,37,850,400,450,0.47058823529411764,13,4,9,381.8474833499174,0.4251438938938939,0.15484843460303588,0.20244013531827418,127404.47108848738,2329.815330533264,129734.28641902065,692,2,227.72972972972974,36,1,16,37.96941810745493,0.5940393518518519,47.606981981981995,1009.572072072074,28.043668668668722,0
4014,4,1,0,38,0.02631578947368421,0.0,1.0,38,1150,800,350,0.6956521739130435,15,8,7,372.96224444379556,0.4263869132290185,0.16061705989110742,0.1997362263798306,127811.68845221608,1933.786838257931,129745.47529047402,693,0,222.71052631578948,37,1,17,37.77560905082051,0.5962837837837838,47.203947368421055,1011.1842105263158,27.329302987197725,0
4015,4,2,2,38,0.05,0.05,0.95,40,1200,1000,200,0.8333333333333334,14,10,4,352.57037392516867,0.4327724358974359,0.15125486802250143,0.19171532568025038,128422.23087873183,1056.4404432132894,129478.67132194512,694,0,212.525,37,3,18,37.66677484494448,0.6024774774774775,46.60087719298245,1013.5964912280696,27.3944997629208,0
4016,4,0,0,38,0.0,0.0,1.0,38,1100,800,300,0.7272727272727273,14,8,6,364.2583554207986,0.4275871266002845,0.15513851339489526,0.19712031580352937,128230.06071950313,1741.7742066390579,129971.8349261422,695,1,224.26315789473685,36,2,20,37.567174412571354,0.6024305555555556,46.79054054054053,1012.8378378378366,28.134384384384347,0
4017,4,0,1,37,0.0,0.02631578947368421,0.9736842105263158,38,700,500,200,0.7142857142857143,9,5,4,360.77590928541025,0.4276612138454244,0.14599895871723323,0.19565406002657237,128315.61872260773,1658.636804033764,129974.2555266415,696,2,225.26315789473685,36,2,20,37.567846689637285,0.6032986111111112,46.70608108108108,1013.1756756756756,28.143768768768766,0
4018,4,0,0,37,0.0,0.0,1.0,37,700,300,400,0.42857142857142855,11,3,8,368.1669540903504,0.4260197697697698,0.1585313895115137,0.19968609145643867,128320.3727816355,2048.664158950582,130369.03694058608,697,3,231.2972972972973,35,2,20,37.3757710760795,0.6053571428571429,46.70138888888887,1013.1944444444418,28.948412698412625,0
4019,4,1,0,38,0.02631578947368421,0.0,1.0,38,1200,700,500,0.5833333333333334,17,7,10,360.3734252638247,0.42806128496917967,0.17494218235335346,0.19754776815557076,128743.83674214738,1679.1714856748463,130423.00822782223,698,0,226.18421052631578,36,2,19,37.140525595502304,0.6076388888888888,46.283783783783775,1014.8648648648635,28.190690690690655,0
4020,4,3,3,38,0.07317073170731707,0.07317073170731707,0.926829268292683,41,950,700,250,0.7368421052631579,12,7,5,337.278189190956,0.4324695121951219,0.17097238366882972,0.1883301307287833,129473.0771513622,534.5006245517097,130007.57777591392,699,0,210.5609756097561,38,3,18,36.98474350899292,0.6112938596491229,45.566239316239304,1017.7350427350411,26.782501124606345,0
4021,4,1,0,39,0.02564102564102564,0.0,1.0,39,1250,800,450,0.64,17,8,9,352.15358182212856,0.43016194331983804,0.17060510548882624,0.19556868658387588,129258.63997443396,1303.7786096907798,130562.41858412474,700,0,222.33333333333334,36,3,21,36.82447397563676,0.6128472222222222,45.77702702702703,1016.8918918918924,28.246996996997012,0
4022,4,2,1,40,0.04878048780487805,0.024390243902439025,0.975609756097561,41,1000,800,200,0.8,12,8,4,344.94279414057587,0.4313770325203252,0.19193194656742207,0.19476000838398655,129908.37191358018,762.1913580246842,130670.56327160487,701,0,212.4390243902439,38,3,20,36.347638510445044,0.6156798245614035,45.138888888888886,1019.4444444444439,26.827485380116944,0
4023,4,0,0,40,0.0,0.0,1.0,40,1350,1200,150,0.8888888888888888,15,12,3,351.0359310609726,0.4285790598290598,0.19088292262993645,0.1975879410871968,129787.30384589492,1112.0014090874151,130899.30525498233,702,1,218.725,37,3,21,36.31530453029162,0.6162725225225225,45.25767543859649,1018.9692982456143,27.53971076339498,0
4024,4,0,0,40,0.0,0.0,1.0,40,1050,700,350,0.6666666666666666,14,7,7,354.4070126400989,0.42903311965811963,0.1968434071843408,0.20019905246218958,129927.00277970156,1209.4081832871793,131136.41096298874,703,2,219.725,37,3,21,36.087509858751,0.6176801801801801,45.120614035087726,1019.5175438596501,27.554528212422976,0
4025,4,0,1,39,0.0,0.025,0.975,40,800,600,200,0.75,10,6,4,357.87902797234193,0.4281650641025641,0.1950365473503166,0.20288535022709947,130066.77685682157,1309.6343346029796,131376.41119142456,704,3,220.725,37,3,22,35.8570488014619,0.6190878378378378,44.98355263157896,1020.0657894736861,27.569345661450974,0
4026,4,1,0,40,0.025,0.0,1.0,40,1050,700,350,0.6666666666666666,14,7,7,357.2100814641352,0.4305021367521367,0.20353581142339094,0.2041464869714721,130380.76560356662,1314.959342309515,131695.72494587614,705,0,219.9,35,5,23,35.55549259595045,0.6261904761904762,44.67592592592593,1021.296296296297,29.179894179894198,0
4027,4,0,0,40,0.0,0.0,1.0,40,1050,900,150,0.8571428571428571,12,9,3,363.69526824156816,0.4303952991452991,0.20745753114382803,0.2088055408695088,130558.13426997591,1496.6751328875068,132054.8094028634,706,1,220.9,35,5,18,35.20998489996226,0.6279761904761905,44.50231481481481,1021.9907407407401,29.19973544973543,0
4028,4,1,0,41,0.024390243902439025,0.0,1.0,41,1600,1200,400,0.75,20,12,8,355.48269898496983,0.4318089430894309,0.20423408194477966,0.2063434057326548,130982.0694850255,1112.3719158347412,132094.44140086023,707,0,216.4878048780488,36,5,21,34.990603226989336,0.6302083333333333,44.08783783783783,1023.6486486486481,28.43468468468467,0
4029,4,0,1,40,0.0,0.024390243902439025,0.975609756097561,41,1050,600,450,0.5714285714285714,15,6,9,354.86015379974265,0.43201219512195127,0.20440377227415074,0.20648217921095285,131075.36844269378,1102.6850809864397,132178.05352368022,708,1,217.4878048780488,37,4,21,34.912173858728615,0.629222972972973,43.99671052631578,1024.0131578947357,27.67603129445232,0
4030,4,1,0,41,0.024390243902439025,0.0,1.0,41,1050,800,250,0.7619047619047619,13,8,5,356.8449903912969,0.4326727642276423,0.21175807133793878,0.2080927528236888,131159.59357686972,1160.728781932891,132320.3223588026,709,0,218.29268292682926,37,4,22,34.77618996645972,0.6300675675675675,43.91447368421052,1024.3421052631572,27.684921763869113,0
4031,4,1,0,42,0.023809523809523808,0.0,1.0,42,1100,800,300,0.7272727272727273,14,8,6,353.3605613716744,0.4336527293844367,0.21744881527490212,0.20790749308612452,131501.3239590941,893.6927438031584,132395.01670289726,710,0,214.07142857142858,36,6,23,34.52024776753037,0.6354166666666667,43.581081081081074,1025.6756756756747,28.490990990990966,0
4032,4,0,0,42,0.0,0.0,1.0,42,1650,1400,250,0.8484848484848485,19,14,5,354.298782655217,0.43355594270228415,0.22146777481574498,0.20877502651934174,131559.08230865985,922.2445418391264,132481.32685049897,711,1,215.07142857142858,36,6,19,34.43788876692282,0.6359953703703703,43.52477477477477,1025.9009009008996,28.497247247247213,0
4033,4,0,0,42,0.0,0.0,1.0,42,1100,700,400,0.6363636363636364,15,7,8,351.14331456450964,0.4324912891986063,0.20948673361218595,0.20833284876472102,131819.15181651237,857.4827783864835,132676.63459489885,712,2,216.07142857142858,36,6,21,34.25654311510763,0.638599537037037,43.27139639639639,1026.9144144144136,28.52540040040038,0
4034,4,0,1,41,0.0,0.023809523809523808,0.9761904761904762,42,950,600,350,0.631578947368421,13,6,7,352.23300836462744,0.43204365079365076,0.21232290328979753,0.20945694278371096,131905.8987196653,892.3223054134951,132798.2210250788,713,3,217.07142857142858,36,6,21,34.14113315793322,0.6394675925925926,43.186936936936924,1027.25225225225,28.53478478478472,0
4035,4,0,0,41,0.0,0.0,1.0,41,850,400,450,0.47058823529411764,13,4,9,360.917031810395,0.429979674796748,0.2179067056675983,0.21404117020199323,131803.09070644685,1313.9960562413855,133117.08676268824,714,4,223.26829268292684,35,6,21,34.02182897505261,0.6404761904761904,43.28703703703702,1026.851851851849,29.338624338624257,0
4036,4,0,0,41,0.0,0.0,1.0,41,1100,800,300,0.7272727272727273,14,8,6,381.6727219397452,0.4297256097560975,0.2543469355682255,0.2047193007707405,127874.24123612029,1561.2219437139315,129435.46317983422,715,5,224.26829268292684,38,3,15,37.491197493046016,0.5951206140350878,47.14209401709402,1011.4316239316244,26.616621682411168,8
4037,4,2,1,42,0.046511627906976744,0.023255813953488372,0.9767441860465116,43,950,800,150,0.8421052631578947,11,8,3,365.61180367035115,0.4333010335917313,0.2468461896436791,0.19894532813021745,128450.01737313397,793.4245772234972,129243.44195035748,716,0,214.7906976744186,37,6,16,37.30789165314585,0.602759009009009,46.5734649122807,1013.7061403508767,27.397463252726396,0
4038,4,0,1,41,0.0,0.023809523809523808,0.9761904761904762,42,600,500,100,0.8333333333333334,7,5,2,374.81520800280583,0.4302893921796361,0.24853671186189552,0.20341298200297023,128344.14439777611,1221.0674356789182,129565.21183345503,717,1,220.9047619047619,36,6,16,37.183031414388374,0.603587962962963,46.677927927927925,1013.288288288288,28.146896896896887,0
4039,4,0,0,41,0.0,0.0,1.0,41,1250,600,650,0.48,19,6,13,378.063599802508,0.4298526422764228,0.24001514818207847,0.2058085189975243,128466.99948827579,1513.739256472892,129980.73874474868,718,2,213.6829268292683,35,6,16,36.97494481866269,0.606845238095238,46.556712962962955,1013.7731481481474,28.964947089947067,0
4040,4,1,0,42,0.023809523809523808,0.0,1.0,42,1450,900,550,0.6206896551724138,20,9,11,375.89258074276955,0.4305192605497484,0.24517816883932841,0.2070968348026292,128943.91593874284,1293.8122666585568,130237.72820540139,719,0,209.57142857142858,36,6,17,36.54229958975496,0.6096643518518519,46.086711711711715,1015.6531531531534,28.212587587587596,0
4041,4,1,0,43,0.023255813953488372,0.0,1.0,43,1300,1000,300,0.7692307692307693,16,10,6,372.76460961413255,0.4328626799557032,0.24698709841930566,0.20686488384794124,129230.01284646131,1034.7318602386165,130264.74470669993,720,0,205.67441860465115,36,7,18,36.32969690257319,0.6125578703703703,45.80518018018018,1016.7792792792791,28.243868868868862,0
4042,4,0,1,42,0.0,0.023255813953488372,0.9767441860465116,43,1250,800,450,0.64,17,8,9,374.544722906056,0.43219361387966043,0.24713518133767898,0.20845733099263147,129344.54038075259,1089.063007264045,130433.60338801664,721,1,206.67441860465115,36,7,18,36.167616886231954,0.6137152777777778,45.69256756756758,1017.2297297297315,28.25638138138143,0
4043,4,0,0,42,0.0,0.0,1.0,42,1650,1100,550,0.6666666666666666,22,11,11,379.9057284758372,0.4315960123886953,0.2592905895064168,0.21174881287965402,129401.82317029881,1432.0987795227802,130833.9219498216,722,2,212.33333333333334,36,6,18,35.97283711492345,0.6142939814814814,45.63626126126127,1017.4549549549561,28.262637637637667,0
4044,4,0,1,41,0.0,0.023809523809523808,0.9761904761904762,42,1000,600,400,0.6,14,6,8,384.4697219352392,0.4315234223770809,0.2649550361133499,0.21491786125990295,129516.42679419304,1559.0289191218494,131075.4557133149,723,3,213.33333333333334,36,6,17,35.73980344433381,0.6154513888888888,45.52364864864866,1017.905405405407,28.275150150150196,0
4045,4,0,0,41,0.0,0.0,1.0,41,950,700,250,0.7368421052631579,12,7,5,394.8104784587086,0.43066565040650406,0.27497330800482533,0.2207474989220816,129525.18332315247,2027.579920053159,131552.7632432056,724,4,218.8048780487805,35,6,17,35.46771366306613,0.6175595238095238,45.5150462962963,1017.9398148148151,29.08399470899472,0
4046,4,0,2,39,0.0,0.04878048780487805,0.9512195121951219,41,1350,900,450,0.6666666666666666,18,9,9,396.9304697745038,0.43005589430894314,0.2702136329239191,0.22259982176837842,129643.02722318663,2091.853539737643,131734.88076292427,725,5,219.8048780487805,35,6,17,35.29342823048074,0.61875,45.39930555555555,1018.4027777777769,29.097222222222197,0
4047,4,0,0,39,0.0,0.0,1.0,39,1150,900,250,0.782608695652174,14,9,5,367.99945807719007,0.4265350877192982,0.19647567795715948,0.19871970736168265,128144.53125000001,1653.1852816358032,129797.71653163582,726,7,223.10256410256412,35,4,19,37.56001371742113,0.6035714285714286,46.875,1012.5000000000001,28.92857142857143,8
4048,4,0,1,38,0.0,0.02564102564102564,0.9743589743589743,39,600,300,300,0.5,9,3,6,370.1962196068168,0.4262539361223572,0.19892090231557602,0.20005229927980483,128173.8297994899,1689.8934488597442,129863.72324834965,727,8,224.10256410256412,35,4,19,37.47440183640036,0.6038690476190476,46.84606481481482,1012.6157407407409,28.93187830687831,0
4049,4,1,0,39,0.02564102564102564,0.0,1.0,39,1150,800,350,0.6956521739130435,15,8,7,392.29364940134195,0.42841880341880345,0.20096790626591954,0.20426324503311255,126672.22222222226,2176.884136016808,128849.10635823908,728,0,224.51282051282053,34,5,15,38.46060982339956,0.5906862745098039,48.333333333333336,1006.666666666667,29.60784313725491,8
4050,4,0,0,39,0.0,0.0,1.0,39,600,400,200,0.6666666666666666,8,4,4,389.57046010728516,0.42855937921727394,0.2020727430350322,0.20329281443846525,126762.11911848062,2076.5554138321877,128838.67453231281,729,1,225.51282051282053,34,5,15,38.43637939866809,0.5916053921568627,48.24404761904761,1007.0238095238087,29.61834733893555,0
4051,4,3,2,40,0.07142857142857142,0.047619047619047616,0.9523809523809523,42,1050,800,250,0.7619047619047619,13,8,5,370.846957963433,0.4366168215253581,0.19920369485586886,0.19730113955705791,127546.62390430985,1060.4842078358179,128607.10811214567,730,0,210.33333333333334,36,6,16,38.101077666295055,0.5954861111111112,47.466216216216225,1010.1351351351362,28.05930930930934,0
4052,4,2,0,42,0.047619047619047616,0.0,1.0,42,1150,900,250,0.782608695652174,14,9,5,374.0089635592768,0.43643534649632215,0.21465156600442192,0.20053579114781292,127859.63909433088,1164.1302197467803,129023.76931407765,731,0,211.28571428571428,36,6,18,37.699959173069054,0.5986689814814814,47.156531531531535,1011.3738738738743,28.093718718718733,0
4053,4,1,0,43,0.023255813953488372,0.0,1.0,43,1750,1200,550,0.6857142857142857,23,12,11,364.50376807854485,0.439922480620155,0.20742468757758803,0.19697222851936755,128173.03790276762,744.2280963395776,128917.2659991072,732,0,207.34883720930233,36,7,19,37.61931902431791,0.6018518518518519,46.846846846846844,1012.6126126126126,28.128128128128125,0
4054,4,1,1,43,0.022727272727272728,0.022727272727272728,0.9772727272727273,44,1500,1200,300,0.8,18,12,6,359.22437156054906,0.4416072057787174,0.20442750567628898,0.1960157057559598,128561.1934080679,436.4627818174838,128997.65618988538,733,0,203.61363636363637,37,7,14,37.35617814538507,0.6038851351351351,46.463815789473685,1014.1447368421057,27.409317211948803,0
4055,4,0,2,41,0.0,0.046511627906976744,0.9534883720930233,43,900,600,300,0.6666666666666666,12,6,6,368.8883226981796,0.4382844222960502,0.2139772504210009,0.20105753375147764,128515.36502718946,881.5634891648483,129396.92851635431,734,2,209.34883720930233,36,7,15,37.15802236043238,0.6053240740740741,46.50900900900901,1013.9639639639648,28.16566566566569,0
4056,4,1,0,42,0.023809523809523808,0.0,1.0,42,1300,1000,300,0.7692307692307693,16,10,6,375.2176717867851,0.43458430120015484,0.23266842671360166,0.20531573725861152,128672.41753472216,1256.0329861111054,129928.45052083327,735,0,214.83333333333334,35,7,16,36.836926762491444,0.6089285714285715,46.354166666666664,1014.5833333333328,28.988095238095223,0
4057,4,1,1,42,0.023255813953488372,0.023255813953488372,0.9767441860465116,43,950,700,250,0.7368421052631579,12,7,5,368.9674357754989,0.43486987818383166,0.24679050179257644,0.2038697595224941,129058.31665702877,923.6632324892611,129981.97988951803,736,0,210.8139534883721,36,7,17,36.60137057150248,0.6108217592592593,45.97409909909911,1016.1036036036046,28.22510010010013,0
4058,4,1,1,42,0.023255813953488372,0.023255813953488372,0.9767441860465116,43,1400,1000,400,0.7142857142857143,18,10,8,366.47533956870114,0.43558508674787744,0.2525669364576415,0.20403164277396288,129357.17520004313,881.4807214264873,130238.65592146962,737,0,210.72093023255815,33,10,18,36.359951612255564,0.6202651515151515,45.68014705882352,1017.279411764705,30.826648841354697,0
4059,4,2,2,42,0.045454545454545456,0.045454545454545456,0.9545454545454546,44,1450,1300,150,0.896551724137931,16,13,3,359.4247048135783,0.4372137068357999,0.24129429016967352,0.20217352565328603,129760.9247068971,527.856411822677,130288.78111871978,738,0,206.72727272727272,35,9,17,36.1284268620546,0.6199404761904762,45.2835648148148,1018.8657407407393,29.110449735449695,0
4060,4,0,0,42,0.0,0.0,1.0,42,1350,1200,150,0.8888888888888888,15,12,3,378.4671059938678,0.4325880758807588,0.25618107052528316,0.2110417985941627,129419.51600646375,1396.2059364186675,130815.72194288242,739,2,217.57142857142858,33,9,18,35.99138363643661,0.6208964646464646,45.6188725490196,1017.5245098039206,30.834076054664262,0
4061,4,0,0,42,0.0,0.0,1.0,42,1150,800,350,0.6956521739130435,15,8,7,376.5846800525226,0.4324186991869919,0.25339685597330663,0.21049208294187424,129513.05537533638,1354.526504229136,130867.58187956552,740,3,218.57142857142858,33,9,17,35.94389597881049,0.6218434343434344,45.52696078431372,1017.8921568627449,30.845216874628633,0
4062,4,1,0,43,0.023255813953488372,0.0,1.0,43,800,300,500,0.375,13,3,10,369.5923526253755,0.4324935400516796,0.258989522523722,0.20830020611098332,129837.58680555537,997.3958333333089,130834.98263888869,741,0,214.46511627906978,34,9,18,35.79142818206594,0.6228553921568627,45.20833333333332,1019.1666666666652,29.975490196078386,0
4063,4,0,1,42,0.0,0.023255813953488372,0.9767441860465116,43,1100,700,400,0.6363636363636364,15,7,8,370.29018730249436,0.43247046880767814,0.2602475303735665,0.20891388081826182,129878.87577428416,1018.5746474194136,130897.45042170357,742,1,215.46511627906978,35,8,18,35.73163865864276,0.6211309523809524,45.167824074074076,1019.3287037037039,29.123677248677254,0
4064,4,1,0,43,0.023255813953488372,0.0,1.0,43,1100,700,400,0.6363636363636364,15,7,8,370.0127799315551,0.431063122923588,0.2722323049001816,0.21018251726008946,130144.4615912208,1031.0228052126145,131175.4843964334,743,0,216.27906976744185,35,8,19,35.46865547489415,0.6238095238095238,44.907407407407405,1020.3703703703699,29.153439153439137,0
4065,4,0,0,43,0.0,0.0,1.0,43,1200,700,500,0.5833333333333334,17,7,10,367.86059683294945,0.43087855297157623,0.2756521991366421,0.20943593308391076,130233.05047850206,981.5215352794696,131214.57201378152,744,1,217.27906976744185,35,8,19,35.43355728162678,0.624702380952381,44.82060185185184,1020.7175925925912,29.16335978835975,0
4066,4,0,0,43,0.0,0.0,1.0,43,1200,900,300,0.75,15,9,6,370.0166042891004,0.4308324104835733,0.27628945407039573,0.21099304109051967,130293.86421388389,1042.1853371848106,131336.0495510687,745,2,218.27906976744185,33,10,19,35.31676369383427,0.6297348484848485,44.761029411764696,1020.9558823529396,30.93805704099817,0
4067,4,1,0,44,0.022727272727272728,0.0,1.0,44,1100,600,500,0.5454545454545454,16,6,10,359.6670813743513,0.43090424594785065,0.272256104017111,0.20670023833200632,130597.00255102015,594.2885487528072,131191.29109977296,746,0,214.29545454545453,34,10,19,35.273507259880425,0.6305147058823529,44.4642857142857,1022.1428571428551,30.06302521008397,0
4068,4,0,0,44,0.0,0.0,1.0,44,1000,600,400,0.6,14,6,8,362.57092717220263,0.4305518851303735,0.2790511304127037,0.20952064406124643,130810.03578514728,685.5831916099604,131495.61897675725,747,1,215.29545454545453,34,10,20,34.98341673455136,0.6326593137254901,44.25595238095237,1022.9761904761896,30.087535014005574,0
4069,4,0,0,44,0.0,0.0,1.0,44,1150,700,450,0.6086956521739131,16,7,9,362.7683734794422,0.42943974630021137,0.2785934529009715,0.21068196082899943,131002.08340031271,704.6825435099179,131706.76594382263,748,2,216.29545454545453,35,9,20,34.783893913698876,0.6324404761904762,44.068287037037024,1023.72685185185,29.249338624338574,0
4070,4,0,0,44,0.0,0.0,1.0,44,850,700,150,0.8235294117647058,10,7,3,365.3184687871185,0.4298801973220578,0.2781901396151596,0.21281784926248892,131120.59709630033,780.1551515346105,131900.75224783496,749,3,217.29545454545453,35,9,20,34.598659923908535,0.6336309523809525,43.95254629629628,1024.189814814813,29.262566137566086,0
4071,4,0,0,44,0.0,0.0,1.0,44,1350,900,450,0.6666666666666666,18,9,9,370.12400259632034,0.42935165609584214,0.2770580356703205,0.19945211138158986,128061.2799731649,679.8748042637367,128741.15477742863,750,4,218.29545454545453,37,7,17,37.591516809302,0.5988175675675675,46.95723684210527,1012.1710526315795,27.355974395448094,8
4072,4,0,0,44,0.0,0.0,1.0,44,1000,700,300,0.7,13,7,6,339.1405198967964,0.4292195207892882,0.18234549114409315,0.1785358263974266,127118.94729573003,-172.6831370976222,126946.2641586324,751,5,219.29545454545453,38,6,16,39.33988416852067,0.5874451754385965,47.88995726495726,1008.4401709401701,26.537899235267634,7
4073,4,2,1,45,0.043478260869565216,0.021739130434782608,0.9782608695652174,46,1050,600,450,0.5714285714285714,15,6,9,330.851359730339,0.43397745571658614,0.19656598691804605,0.17650139062009051,127656.23967215265,-752.9519052812605,126903.28776687139,752,0,210.7173913043478,40,6,14,38.99901950925183,0.5895833333333333,47.35772357723577,1010.5691056910555,25.26422764227639,0
4074,4,1,0,46,0.021739130434782608,0.0,1.0,46,1350,900,450,0.6666666666666666,18,9,9,332.28113896322,0.4357085346215781,0.2001363612524254,0.1777168156132318,127758.9604402142,-709.6214224337336,127049.33901778047,753,0,211.69565217391303,40,6,16,38.85789438413082,0.590625,47.25609756097561,1010.9756097560978,25.274390243902445,0
4075,4,1,0,47,0.02127659574468085,0.0,1.0,47,950,400,550,0.42105263157894735,15,4,11,325.22154613640413,0.4373650940487203,0.20299732634819256,0.17518005352078087,128044.10450522784,-1071.4596718317116,126972.64483339613,754,0,208.17021276595744,41,6,17,38.74526236685617,0.5919715447154472,46.97420634920634,1012.1031746031731,24.685443283004222,0
4076,4,2,1,48,0.04081632653061224,0.02040816326530612,0.9795918367346939,49,900,500,400,0.5555555555555556,13,5,8,313.1046990724815,0.4421060090702948,0.21006742713123794,0.1704984977045345,128479.16253552768,-1754.3959926491684,126724.76654287851,755,0,200.6326530612245,40,9,12,38.608911387329606,0.5979166666666667,46.544715447154466,1013.8211382113811,25.34552845528453,0
4077,4,0,1,47,0.0,0.020833333333333332,0.9791666666666666,48,1350,900,450,0.6666666666666666,18,9,9,321.8736947620336,0.43887596040189125,0.21075850200349322,0.17531039010178368,128487.5339084202,-1328.6485460069398,127158.88536241326,756,1,205.8125,39,9,13,38.378133668961254,0.5996260683760684,46.536458333333336,1013.8541666666672,25.9962606837607,0
4078,4,0,0,47,0.0,0.0,1.0,47,1400,1000,400,0.7142857142857143,18,10,8,325.33551442348414,0.438868331791551,0.2158727170024477,0.1774761323510178,128550.50131492435,-1035.591305062466,127514.91000986188,757,2,209.95744680851064,38,9,13,38.22626949009692,0.6019736842105263,46.47435897435897,1014.1025641025637,26.686909581646415,0
4079,4,0,2,45,0.0,0.0425531914893617,0.9574468085106383,47,2000,1300,700,0.65,27,13,14,325.13635956764597,0.4387912426765341,0.21447367559033048,0.1782669415457275,128751.69406467024,-1027.6285807291576,127724.06548394109,758,3,210.95744680851064,39,8,14,38.02655325190734,0.6022970085470085,46.27604166666667,1014.8958333333343,26.02297008547011,0
4080,4,1,1,45,0.021739130434782608,0.021739130434782608,0.9782608695652174,46,1300,800,500,0.6153846153846154,18,8,10,349.0501967821492,0.44173711755233497,0.19261507214887885,0.184761763161569,127340.90206842491,-258.6284812394197,127082.2735871855,759,0,209.8695652173913,37,9,15,38.86237099402497,0.5914977477477478,47.66995614035088,1009.3201754385966,27.27892366050261,8
4081,4,0,0,45,0.0,0.0,1.0,45,1450,1200,250,0.8275862068965517,17,12,5,360.9916782337438,0.43952020202020203,0.2099798024856574,0.19165259791130745,127461.32270361592,202.49535853422924,127663.81806215015,760,1,215.37777777777777,36,9,15,38.43746514999442,0.5946180555555556,47.550675675675684,1009.7972972972984,28.049924924924955,0
4082,4,2,1,46,0.0425531914893617,0.02127659574468085,0.9787234042553191,47,1100,700,400,0.6363636363636364,15,7,8,350.6734706664529,0.4409497378970089,0.22387245270308154,0.1891082034470486,128090.45041867568,-416.4154384907486,127674.03498018494,761,0,207.17021276595744,38,9,18,38.053869832893575,0.5973135964912281,46.92841880341881,1012.2863247863256,26.639113810166464,0
4083,4,0,1,45,0.0,0.021739130434782608,0.9782608695652174,46,1400,1100,300,0.7857142857142857,17,11,6,347.3345633184456,0.44055958132045087,0.23479904477380997,0.18796191711709395,128230.06071950334,-292.24215686447144,127937.81856263886,762,1,212.1304347826087,36,10,18,37.995700837595415,0.6024305555555556,46.79054054054054,1012.8378378378383,28.134384384384397,0
4084,4,1,0,46,0.021739130434782608,0.0,1.0,46,1300,800,500,0.6153846153846154,18,8,10,346.8837746317637,0.44130434782608696,0.23822715350468293,0.18865866196135972,128429.74044568211,-289.9613718448237,128139.77907383729,763,0,212.95652173913044,36,10,18,37.803207051068405,0.6044560185185186,46.593468468468465,1013.6261261261257,28.156281281281267,0
4085,4,1,1,46,0.02127659574468085,0.02127659574468085,0.9787234042553191,47,1700,1300,400,0.7647058823529411,21,13,8,341.42539870948036,0.4407570151094666,0.2509288131857028,0.18853681432908487,129034.22807979377,-588.8874461372786,128445.3406336565,764,0,209.40425531914894,37,10,20,37.32552701633211,0.6086711711711712,45.997807017543856,1016.0087719298244,27.459696538643904,0
4086,4,2,1,47,0.041666666666666664,0.020833333333333332,0.9791666666666666,48,900,600,300,0.6666666666666666,12,6,6,329.0596622225376,0.4451832151300236,0.24501125665165713,0.183957152130357,129519.29253472235,-1076.0850694444382,128443.20746527791,765,0,196.75,39,9,17,37.14695047073269,0.6100427350427351,45.520833333333336,1017.9166666666677,26.100427350427374,0
4087,4,0,1,46,0.0,0.02127659574468085,0.9787234042553191,47,1300,900,400,0.6923076923076923,17,9,8,335.46606246786195,0.4435322232500771,0.25969328798156344,0.18817278787999348,129651.86767578126,-701.2396918402762,128950.62798394098,766,1,201.3404255319149,39,8,17,36.84934455013467,0.6113782051282051,45.390625,1018.4375000000001,26.113782051282055,0
4088,4,1,1,46,0.02127659574468085,0.02127659574468085,0.9787234042553191,47,1100,700,400,0.6363636363636364,15,7,8,350.51324581015274,0.4441296638914585,0.2735449758608468,0.18952668385797014,128197.27105034718,-411.5966796875037,127785.67437065968,767,0,199.85106382978722,39,8,16,37.94872454227525,0.5966880341880342,46.822916666666664,1012.7083333333329,25.96688034188033,8
4089,4,0,1,45,0.0,0.021739130434782608,0.9782608695652174,46,1350,1000,350,0.7407407407407407,17,10,7,355.79928085149004,0.4411634460547504,0.28355796260713606,0.19265179792992462,128252.72715547167,-73.55438216814986,128179.17277330352,768,1,205.1086956521739,38,8,19,37.75819182224097,0.5989583333333333,46.7681623931624,1012.9273504273515,26.655982905982935,0
4090,4,0,0,45,0.0,0.0,1.0,45,1650,1100,550,0.6666666666666666,22,11,11,355.78268386942636,0.44084595959595957,0.2807710324152146,0.19355883627024775,128442.17985243637,139.5006939878839,128581.68054642425,769,2,209.0222222222222,38,7,12,37.56499437886454,0.6008771929824561,46.581196581196586,1013.6752136752145,26.675663517768804,0
4091,4,0,0,45,0.0,0.0,1.0,45,1450,1100,350,0.7586206896551724,18,11,7,362.6044558113056,0.44002525252525254,0.29070953851914205,0.19834630831706002,128658.86843450966,330.4557947987608,128989.32422930842,770,3,210.0222222222222,38,7,13,37.17069467846112,0.6030701754385965,46.36752136752138,1014.529914529916,26.698155645524107,0
4092,4,0,0,45,0.0,0.0,1.0,45,1450,1000,450,0.6896551724137931,19,10,9,359.027901505191,0.43937289562289567,0.28446128477704113,0.19706089498560495,128794.39153928346,248.15602399738165,129042.54756328084,771,4,211.0222222222222,38,7,13,37.123065993053366,0.6044407894736843,46.233974358974365,1015.0641025641033,26.71221322537114,0
4093,4,0,1,44,0.0,0.022222222222222223,0.9777777777777777,45,1300,900,400,0.6923076923076923,17,9,8,361.1978634130651,0.43956228956228954,0.28030627155298316,0.19879477080145855,128902.86138733679,311.887624187325,129214.74901152411,772,5,212.0222222222222,38,7,13,36.95730317376818,0.6055372807017544,46.127136752136764,1015.4914529914549,26.723459289248815,0
4094,4,1,1,44,0.022222222222222223,0.022222222222222223,0.9777777777777777,45,1250,800,450,0.64,17,8,9,359.0996763966729,0.442550505050505,0.28186605943831355,0.19900019923787693,129174.23575726882,277.2852518445706,129451.52100911339,773,0,211.55555555555554,38,7,16,36.73388509371169,0.6082785087719298,45.86004273504275,1016.5598290598308,26.751574448942915,0
4095,4,0,0,44,0.0,0.0,1.0,44,1900,1400,500,0.7368421052631579,24,14,10,368.2289631421072,0.44068225863284005,0.28910532354066,0.2040556316372072,129173.52123970838,713.0863583025564,129886.60759801093,774,1,217.1818181818182,37,7,17,36.50260220040989,0.6100788288288288,45.86074561403509,1016.5570175438597,27.474513987671884,0
4096,4,1,1,44,0.022222222222222223,0.022222222222222223,0.9777777777777777,45,1200,900,300,0.75,15,9,6,360.0141337148339,0.44242424242424244,0.2871294002178415,0.20120476840907897,129508.13140822176,324.95455332409745,129833.08596154586,775,0,213.33333333333334,37,8,13,36.370583324356346,0.6134572072072072,45.531798245614034,1017.8728070175438,27.510075865339022,0
4097,4,0,0,44,0.0,0.0,1.0,44,1250,800,450,0.64,17,8,9,365.10898251173,0.4406602360817477,0.2853194443047271,0.2037980157479004,129459.11864144563,653.3374168087189,130112.45605825435,776,3,219.1818181818182,36,8,14,36.29085057725647,0.6148726851851851,45.579954954954964,1017.6801801801812,28.26889389389392,0
4098,4,0,0,44,0.0,0.0,1.0,44,800,500,300,0.625,11,5,6,364.8137089826921,0.4399665257223397,0.28467417538213957,0.20407895601507062,129545.08562616688,651.9646335524887,130197.05025971937,777,4,220.1818181818182,36,8,15,36.21082227138643,0.6157407407407407,45.495495495495504,1018.0180180180195,28.278278278278318,0
4099,4,1,0,45,0.022222222222222223,0.0,1.0,45,1350,1100,250,0.8148148148148148,16,11,5,355.478637500003,0.44313973063973067,0.21691921867825203,0.18688868535306555,127065.08333561607,47.95305777416186,127113.03639339024,778,0,216.26666666666668,38,7,14,38.98330154356964,0.5868969298245614,47.94337606837606,1008.2264957264948,26.53227620332881,8
4100,4,0,0,45,0.0,0.0,1.0,45,1300,900,400,0.6923076923076923,17,9,8,357.5918637337158,0.44219276094276094,0.21590933163859738,0.18849942967671732,127172.8226701182,95.19333497697113,127268.01600509517,779,1,217.26666666666668,38,7,15,38.8193782438301,0.5879934210526316,47.83653846153845,1008.6538461538449,26.543522267206445,0
4101,4,1,1,45,0.021739130434782608,0.021739130434782608,0.9782608695652174,46,1250,900,350,0.72,16,9,7,359.87428208309206,0.4440720611916264,0.23485836729021825,0.19167603854606854,127591.41845703126,-16.625976562499545,127574.79248046876,780,0,213.52173913043478,39,7,14,38.33223785957315,0.5905448717948718,47.421875,1010.3125000000001,25.905448717948723,0
4102,4,0,2,43,0.0,0.044444444444444446,0.9555555555555556,45,1300,1100,200,0.8461538461538461,15,11,4,362.7366143861549,0.4433922558922559,0.24992248062015565,0.19365058533256344,127685.20801373365,263.22001241873215,127948.42802615238,781,1,218.84444444444443,38,7,14,38.1637596899225,0.5932017543859649,47.32905982905983,1010.6837606837605,26.596941070625277,0
4103,4,1,1,43,0.022727272727272728,0.022727272727272728,0.9772727272727273,44,1200,700,500,0.5833333333333334,17,7,10,364.2483238792579,0.4430386715997181,0.26686312386659305,0.19533875229431805,127867.13219452123,515.077716220357,128382.20991074159,782,0,223.20454545454547,37,7,15,37.93907198612316,0.5968468468468469,47.149122807017534,1011.4035087719285,27.33522996680888,0
4104,4,0,0,43,0.0,0.0,1.0,43,1300,800,500,0.6153846153846154,18,8,10,372.3116813643164,0.4398532668881506,0.2721352312245746,0.19962574390047308,127859.63909433076,920.7274419689895,128780.36653629976,783,1,229.1860465116279,36,7,15,37.742873844783425,0.5986689814814814,47.15653153153153,1011.3738738738734,28.093718718718705,0
4105,4,0,1,42,0.0,0.023255813953488372,0.9767441860465116,43,1700,1100,600,0.6470588235294118,23,11,12,370.64402143074034,0.4397609819121447,0.2657134577369311,0.19972113097239155,128059.03031409776,892.8627952276458,128951.8931093254,784,2,230.1860465116279,36,7,16,37.58066310636404,0.6006944444444444,46.95945945945945,1012.1621621621612,28.11561561561559,0
4106,4,0,1,41,0.0,0.023809523809523808,0.9761904761904762,42,1050,600,450,0.5714285714285714,15,6,9,379.91328341508535,0.4379718350754936,0.2716377183379355,0.20440503611680538,127998.08873724696,1325.6348326045763,129323.72356985153,785,3,236.07142857142858,35,7,16,37.408617370086546,0.6020833333333333,47.01967592592592,1011.9212962962953,28.91203703703701,0
4107,4,1,0,42,0.023809523809523808,0.0,1.0,42,900,600,300,0.6666666666666666,12,6,6,381.5475283239343,0.4362780681378242,0.2852243778169705,0.20603566529492462,128144.53125,1378.7295578275043,129523.26080782751,786,0,236.57142857142858,34,8,18,37.217078189300416,0.6056985294117647,46.875,1012.5,29.779411764705884,0
4108,4,3,2,43,0.06666666666666667,0.044444444444444446,0.9555555555555556,45,1450,1000,450,0.6896551724137931,19,10,9,360.91013629001213,0.43970959595959597,0.2881596622529268,0.1990161608684924,128978.5318559556,309.9319021237188,129288.46375807932,787,0,221.73333333333332,37,8,18,36.88741364421415,0.6081081081081081,46.05263157894736,1015.78947368421,27.4537695590327,0
4109,4,0,1,42,0.0,0.023255813953488372,0.9767441860465116,43,1250,800,450,0.64,17,8,9,360.07495338433546,0.43844592100406055,0.27928106680409726,0.19924441779850582,129115.53603857242,698.2541240564947,129813.79016262891,788,1,229.2325581395349,36,7,18,36.76892890120038,0.611400462962963,45.917792792792795,1016.3288288288294,28.231356356356372,0
4110,4,1,0,43,0.023255813953488372,0.0,1.0,43,1350,1000,350,0.7407407407407407,17,10,7,358.25528521364055,0.43971483942414175,0.2657682246070814,0.19924641231832518,129315.90374157943,665.6211955198455,129981.52493709928,789,0,222.97674418604652,36,7,19,36.61103114850899,0.6134259259259259,45.72072072072072,1017.1171171171172,28.253253253253256,0
4111,4,1,1,43,0.022727272727272728,0.022727272727272728,0.9772727272727273,44,1250,800,450,0.64,17,8,9,351.6047668702189,0.44168428470754056,0.27449810198411195,0.19776703957373304,129759.37307633105,324.80282394581866,130084.17590027687,790,0,218.88636363636363,37,7,14,36.32918998421582,0.615990990990991,45.28508771929824,1018.859649122806,27.536747273589352,0
4112,4,0,0,43,0.0,0.0,1.0,43,1100,900,200,0.8181818181818182,13,9,4,361.0869267771222,0.4402685492801772,0.28029903638687514,0.20243701666742195,129631.0811444891,761.617741051868,130392.69888554097,791,1,224.95348837209303,36,7,14,36.21816137712412,0.6166087962962963,45.41103603603604,1018.3558558558559,28.287662662662665,0
4113,4,0,1,42,0.0,0.023255813953488372,0.9767441860465116,43,800,400,400,0.5,12,4,8,362.57469485689904,0.440014765596161,0.283075578181444,0.20356847392803562,129688.42734203805,804.3483940021188,130492.77573604017,792,2,225.95348837209303,36,7,14,36.12193661323015,0.6171875,45.35472972972973,1018.5810810810816,28.293918918918934,0
4114,4,0,4,38,0.0,0.09523809523809523,0.9047619047619048,42,1150,1000,150,0.8695652173913043,13,10,3,361.77992124782475,0.4386009485094851,0.2670402525651141,0.20386726570939107,129831.84831791275,994.1111719828209,130825.95948989557,793,3,224.45238095238096,36,6,15,35.9963167587477,0.6186342592592593,45.21396396396398,1019.1441441441461,28.309559559559617,0
4115,4,1,0,39,0.02564102564102564,0.0,1.0,39,1050,600,450,0.5714285714285714,15,6,9,390.4785306707359,0.43575686009896536,0.2966009584506699,0.21791221227753943,129450.69204152234,2309.5432045367006,131760.23524605905,794,0,241.56410256410257,33,6,16,35.65400208734745,0.6212121212121212,45.58823529411764,1017.6470588235281,30.837789661319036,0
4116,4,1,1,39,0.025,0.025,0.975,40,1350,1000,350,0.7407407407407407,17,10,7,382.74327461883655,0.4370860042735043,0.3026999416228846,0.21638258396767882,129958.9445153061,1948.1823979591875,131907.1269132653,795,0,236.5,34,6,18,35.33274956217164,0.6240808823529411,45.089285714285715,1019.642857142857,29.989495798319325,0
4117,4,0,0,39,0.0,0.0,1.0,39,1150,1000,150,0.8695652173913043,13,10,3,391.22738423455104,0.43539136302294196,0.3110954926295151,0.2207753990544772,129887.55076172625,2363.1133458285226,132250.66410755477,796,1,243.33333333333334,33,6,19,35.18924821671875,0.6256313131313131,45.15931372549019,1019.3627450980391,30.889780154486033,0
4118,4,0,0,39,0.0,0.0,1.0,39,1250,1000,250,0.8,15,10,5,391.72827580259343,0.43488529014844807,0.31428509813707417,0.22194380119162596,130043.75007509127,2388.3627991637736,132432.11287425505,797,2,244.33333333333334,33,6,19,35.01729644759501,0.627209595959596,45.00612745098039,1019.9754901960781,30.90834818775994,0
4119,4,0,0,39,0.0,0.0,1.0,39,900,500,400,0.5555555555555556,13,5,8,395.0678058700269,0.43426675663517766,0.31489524629981913,0.22457037346935485,130171.45691609979,2485.3103741496593,132656.76729024944,798,3,245.33333333333334,34,5,19,34.802020143101565,0.6262254901960784,44.88095238095238,1020.4761904761906,30.0140056022409,0
4120,4,0,0,39,0.0,0.0,1.0,39,1400,1100,300,0.7857142857142857,17,11,6,390.3047757575731,0.43260796221322534,0.31249249969998805,0.2229204726790853,130356.43029423764,2375.7793466651146,132732.20964090276,799,4,246.33333333333334,33,6,19,34.73526441057641,0.6303661616161615,44.69975490196077,1021.2009803921557,30.945484254307747,0
4121,4,0,0,39,0.0,0.0,1.0,39,1050,700,350,0.6666666666666666,14,7,7,389.8998484646204,0.4322143499775079,0.31067017365757654,0.22304840335982212,130419.01139285353,2370.070555795824,132789.08194864934,800,5,247.33333333333334,33,6,19,34.68193861227754,0.6309974747474747,44.63848039215685,1021.4460784313711,30.952911467617305,0
4122,4,0,0,39,0.0,0.0,1.0,39,1400,1200,200,0.8571428571428571,16,12,4,388.33456408404055,0.4325236167341431,0.3078521414651838,0.22341289197165967,130638.1635068243,2346.2628556324444,132984.42636245675,801,6,248.33333333333334,33,6,16,34.49912091424917,0.6332070707070707,44.424019607843135,1022.3039215686275,30.978906714200832,0
4123,4,1,0,40,0.025,0.0,1.0,40,1400,1100,300,0.7857142857142857,17,11,6,381.7013882569214,0.4327724358974359,0.3092493609109923,0.2228576762102487,131206.12953514743,2016.312358276647,133222.44189342408,802,0,243.1,34,6,18,34.09249360910994,0.6366421568627452,43.86904761904762,1024.5238095238096,30.13305322128852,0
4124,4,0,1,39,0.0,0.025,0.975,40,1400,1000,400,0.7142857142857143,18,10,8,379.4461252283299,0.4321981837606838,0.3078552066862441,0.22190330203247208,131268.81456832966,1961.8886102537504,133230.7031785834,803,1,244.1,35,5,18,34.08675928017469,0.6351190476190476,43.80787037037036,1024.7685185185167,29.279100529100475,0
4125,4,0,0,39,0.0,0.0,1.0,39,1150,700,450,0.6086956521739131,16,7,9,387.7576537223017,0.4291216824111561,0.31808103565425716,0.22603433960885408,131145.15306122453,2370.507369614517,133515.66043083905,804,2,251.12820512820514,34,5,18,33.999205795753916,0.6360294117647058,43.92857142857143,1024.2857142857147,30.126050420168077,0
4126,4,0,0,39,0.0,0.0,1.0,39,1150,800,350,0.6956521739130435,15,8,7,385.2005374960269,0.42881241565452094,0.3146983128395766,0.22525857518789397,131267.12018140592,2312.8330498866226,133579.95323129254,805,3,252.12820512820514,34,5,20,33.94105289653036,0.6372549019607843,43.80952380952381,1024.7619047619048,30.140056022408967,0
4127,4,1,1,39,0.025,0.025,0.975,40,1250,900,350,0.72,16,9,7,376.0049626548695,0.4293669871794872,0.30630076583894184,0.22164232340353393,131572.28599773248,1894.380668934248,133466.66666666674,806,0,246.8,34,6,17,33.86782509476291,0.6403186274509804,43.511904761904766,1025.9523809523814,30.17507002801122,0
4128,4,0,0,39,0.0,0.0,1.0,39,1100,900,200,0.8181818181818182,13,9,4,383.26227451101215,0.42881241565452094,0.30281878715389987,0.2259202655086116,131572.28599773237,2285.3387188208562,133857.62471655323,807,5,254.12820512820514,34,5,18,33.681683685309814,0.6403186274509804,43.51190476190476,1025.9523809523805,30.17507002801119,0
4129,4,0,0,39,0.0,0.0,1.0,39,1150,900,250,0.782608695652174,14,9,5,384.1295223102893,0.4286437246963563,0.3027794134265953,0.22715807553904768,131694.45153061225,2317.5453514739293,134011.99688208618,808,6,255.12820512820514,34,5,18,33.53581922214491,0.6415441176470589,43.392857142857146,1026.4285714285716,30.189075630252105,0
4130,4,0,0,39,0.0,0.0,1.0,39,1000,700,300,0.7,13,7,6,383.85237605760983,0.4286999550157445,0.3050289226964402,0.22772425006003724,131816.67375283447,2319.6286848072596,134136.30243764172,809,7,256.12820512820514,34,5,18,33.419313702759105,0.6427696078431373,43.273809523809526,1026.904761904762,30.203081232493,0
4131,4,0,0,39,0.0,0.0,1.0,39,1200,1000,200,0.8333333333333334,14,10,4,383.09193857424196,0.42872807017543857,0.3002050093591222,0.22800575378591123,131938.9526643993,2308.9498299319894,134247.90249433127,810,8,257.12820512820514,34,5,18,33.31522788721512,0.6439950980392157,43.15476190476191,1027.3809523809539,30.217086834733937,0
4132,4,0,0,39,0.0,0.0,1.0,39,1350,800,550,0.5925925925925926,19,8,11,383.14226282431787,0.4274910031488979,0.30108312252823577,0.22914242255892037,132122.47732426305,2324.3409863945553,134446.8183106576,811,9,258.12820512820514,34,5,19,33.12852207812259,0.6458333333333333,42.976190476190474,1028.095238095238,30.238095238095237,0
4133,4,0,0,39,0.0,0.0,1.0,39,1000,800,200,0.8,12,8,4,382.32622813785997,0.4268724696356276,0.29605887939221276,0.22939573688271592,132244.89795918367,2312.138605442172,134557.03656462583,812,10,259.12820512820514,34,5,19,33.02589699074073,0.6470588235294117,42.857142857142854,1028.5714285714284,30.25210084033613,0
4134,4,0,0,39,0.0,0.0,1.0,39,1050,600,450,0.5714285714285714,15,6,9,382.7304168237476,0.4260571300044984,0.29710370601058944,0.23057173891576976,132398.00347222213,2334.7257653061133,134732.72923752826,813,11,260.12820512820514,32,7,19,32.860998650472354,0.6533203125,42.70833333333333,1029.1666666666658,32.16145833333331,0
4135,4,0,0,39,0.0,0.0,1.0,39,1500,1200,300,0.8,18,12,6,387.9094022361455,0.4252699055330634,0.3032611462566115,0.23531247679142836,132658.02158261914,2491.8587707887013,135149.88035340785,814,12,261.12820512820514,32,7,17,32.46542672713159,0.6559244791666667,42.45580808080808,1030.176767676768,32.193023989899,0
4136,4,0,0,39,0.0,0.0,1.0,39,800,500,300,0.625,11,5,6,390.61762120298454,0.42487629329734594,0.30499688990255036,0.23757235650214314,132755.59413580253,2571.3348765432156,135326.92901234573,815,13,262.12820512820514,32,7,17,32.297282120395344,0.6569010416666667,42.361111111111114,1030.5555555555559,32.20486111111112,0
4137,4,0,0,39,0.0,0.0,1.0,39,1100,700,400,0.6363636363636364,15,7,8,389.1648533057435,0.42377980206927574,0.3123105558652661,0.23822549601995963,132997.76715986652,2551.611309352186,135549.3784692187,816,14,263.12820512820514,33,6,19,32.090684527345445,0.6568813131313131,42.126225490196084,1031.4950980392166,31.257427213309594,0
4138,4,0,0,39,0.0,0.0,1.0,39,1000,600,400,0.6,14,6,8,391.53322579065326,0.4236111111111111,0.30808205371796404,0.24048878879526545,133124.20590938575,2624.509954104184,135748.71586348992,817,15,264.12820512820514,33,6,19,31.90226319122828,0.6581439393939394,42.00367647058823,1031.9852941176466,31.272281639928686,0
4139,4,0,0,39,0.0,0.0,1.0,39,900,600,300,0.6666666666666666,12,6,6,399.9278676399373,0.4228520017993702,0.31710264018869383,0.24648078162885642,133250.70473195385,2858.134040993822,136108.83877294767,818,16,265.12820512820514,33,6,19,31.558234421364975,0.6594065656565656,41.88112745098038,1032.4754901960769,31.287136066547784,0
4140,4,0,0,39,0.0,0.0,1.0,39,1450,1200,250,0.8275862068965517,17,12,5,413.9799950105684,0.4225708502024292,0.3142607639152555,0.23963527711183186,130875.54841342718,3080.5797691590747,133956.12818258625,819,17,266.12820512820514,32,7,16,33.601976390259956,0.6380208333333333,44.19191919191919,1023.2323232323231,31.976010101010097,8
4141,4,0,0,39,0.0,0.0,1.0,39,1150,900,250,0.782608695652174,14,9,5,383.0769672995409,0.42240215924426455,0.23002065351696044,0.2106552839521461,128868.76594387762,2082.1353154821895,130950.9012593598,820,18,267.12820512820514,34,5,18,36.436715910423274,0.6130514705882353,46.16071428571429,1015.3571428571433,29.863445378151276,8
4142,4,0,0,39,0.0,0.0,1.0,39,1500,1000,500,0.6666666666666666,20,10,10,386.31569102855184,0.422008547008547,0.2288097899912247,0.21292283435759712,128959.43877551016,2163.8109410430793,131123.24971655325,821,19,268.12820512820514,34,5,18,36.261769417096424,0.6139705882352942,46.07142857142857,1015.7142857142853,29.873949579831923,0
4143,4,1,1,39,0.025,0.025,0.975,40,900,600,300,0.6666666666666666,12,6,6,389.6079851364338,0.42401175213675213,0.25200114025085574,0.21382115329452567,128789.8729531034,2035.5125814471699,130825.38553455057,822,0,262.4,35,5,16,36.35167236792094,0.6101190476190477,46.23842592592592,1015.046296296295,29.001322751322714,8
4144,4,1,0,40,0.025,0.0,1.0,40,1200,1000,200,0.8333333333333334,14,10,4,385.1533648948103,0.4263488247863248,0.2348770351816014,0.21342599393508613,129171.973125107,1950.2040198473787,131122.1771449544,823,0,250.275,35,5,17,36.074068275835906,0.6139880952380952,45.86226851851851,1016.5509259259246,29.044312169312132,0
4145,4,1,0,41,0.024390243902439025,0.0,1.0,41,600,200,400,0.3333333333333333,10,2,8,384.84096271213775,0.42878556910569104,0.25356730481390155,0.21588947121326796,129655.65653344667,1779.368234240707,131435.02476768737,824,0,245.14634146341464,34,7,13,35.588349892850175,0.6210171568627452,45.38690476190476,1018.4523809523806,29.954481792717075,0
4146,4,2,2,41,0.046511627906976744,0.046511627906976744,0.9534883720930233,43,1250,900,350,0.72,16,9,7,367.905006270608,0.4327473237356958,0.2481749202610155,0.20931092729632883,130205.11379200137,980.6226412222953,131185.73643322368,825,0,234.69767441860466,36,7,16,35.4608021626393,0.6223958333333333,44.84797297297297,1020.6081081081074,28.350225225225206,0
4147,4,1,0,42,0.023809523809523808,0.0,1.0,42,1000,700,300,0.7,13,7,6,378.0167061373318,0.4310999806426636,0.25771324863883893,0.21472907740378325,130144.46159122078,1439.3561385459486,131583.81772976674,826,0,241.14285714285714,35,7,17,35.264481246219006,0.6238095238095238,44.907407407407405,1020.3703703703698,29.153439153439137,0
4148,4,0,0,42,0.0,0.0,1.0,42,800,500,300,0.625,11,5,6,376.67638483965027,0.4307854239256678,0.25102040816326543,0.2146179401993355,130262.5868055555,1413.3680555555507,131675.95486111107,827,1,242.14285714285714,35,7,17,35.17857142857142,0.625,44.791666666666664,1020.8333333333329,29.166666666666654,0
4149,4,0,0,42,0.0,0.0,1.0,42,800,500,300,0.625,11,5,6,376.4052432741339,0.4309668989547038,0.2548452907174428,0.2149529748483937,130351.21588059409,1412.9762249228302,131764.1921055169,828,2,243.14285714285714,35,7,19,35.095418225093496,0.6258928571428571,44.70486111111111,1021.1805555555552,29.17658730158729,0
4150,4,0,0,42,0.0,0.0,1.0,42,1100,700,400,0.6363636363636364,15,7,8,377.46363776269664,0.43062814556716994,0.25456796517179425,0.2162148949079379,130469.43486636237,1449.493500300075,131918.92836666244,829,3,244.14285714285714,35,7,19,34.948288395453346,0.6270833333333333,44.589120370370374,1021.643518518519,29.18981481481483,0
4151,4,0,0,42,0.0,0.0,1.0,42,1400,1100,300,0.7857142857142857,17,11,6,378.368139608054,0.4304708672086721,0.2540967694970644,0.21739551339484212,130587.70743580667,1482.0455836333954,132069.75301944008,830,4,245.14285714285714,35,7,15,34.805066432642576,0.6282738095238095,44.473379629629626,1022.1064814814808,29.20304232804231,0
4152,4,0,0,42,0.0,0.0,1.0,42,1200,1000,200,0.8333333333333334,14,10,4,377.1267810250748,0.43043457220286485,0.2559544021343685,0.2173460606886195,130706.03358892753,1458.5491415895149,132164.58273051705,831,5,246.14285714285714,35,7,15,34.71668081494058,0.6294642857142857,44.35763888888889,1022.5694444444449,29.216269841269856,0
4153,4,0,0,42,0.0,0.0,1.0,42,850,600,250,0.7058823529411765,11,6,5,379.10534099601705,0.430458768873403,0.2561066295931065,0.21882128663499698,130765.21675936645,1514.7584179955434,132279.97517736198,832,6,247.14285714285714,35,7,15,34.606036173663746,0.6300595238095238,44.29976851851852,1022.8009259259262,29.222883597883605,0
4154,4,1,3,40,0.023255813953488372,0.06976744186046512,0.9302325581395349,43,1250,900,350,0.72,16,9,7,370.10648267401217,0.43157069029162054,0.2504806610623631,0.21580054912838553,131155.04017531045,1108.2661208505813,132263.30629616103,833,0,242.37209302325581,36,7,16,34.44119209909117,0.6319444444444444,43.91891891891892,1024.3243243243244,28.453453453453456,0
4155,4,0,0,40,0.0,0.0,1.0,40,1400,1100,300,0.7857142857142857,17,11,6,395.1887583147168,0.4235844017094017,0.2683237444564308,0.22754035960108215,130669.4859699394,2327.822382016527,132997.30835195593,834,1,260.975,33,7,16,34.2920961684446,0.6335227272727273,44.393382352941174,1022.4264705882349,30.982620320855602,0
4156,4,0,0,40,0.0,0.0,1.0,40,1000,700,300,0.7,13,7,6,402.0553916147349,0.4223290598290598,0.27315524676569236,0.23243479288087307,130826.15460399851,2519.8721645520986,133346.0267685506,835,2,261.975,33,7,16,33.95723526593195,0.6351010101010102,44.240196078431374,1023.0392156862749,31.001188354129543,0
4157,4,0,0,40,0.0,0.0,1.0,40,850,600,250,0.7058823529411765,11,6,5,400.34995876510436,0.4223023504273504,0.2710958083832331,0.23182539221141618,130888.84833958096,2480.26900711265,133369.11734669362,836,3,262.975,33,7,17,33.93712574850299,0.6357323232323233,44.17892156862745,1023.2843137254905,31.008615567439108,0
4158,4,1,0,41,0.024390243902439025,0.0,1.0,41,1400,1000,400,0.7142857142857143,18,10,8,388.1763398101191,0.4247459349593496,0.26991341010064396,0.22699877262809115,131267.12018140577,1990.9580498866076,133258.07823129237,837,0,257.5365853658537,34,7,18,33.864815675340765,0.6372549019607843,43.8095238095238,1024.7619047619037,30.14005602240893,0
4159,4,0,0,41,0.0,0.0,1.0,41,1150,700,450,0.6086956521739131,16,7,9,388.97749817876763,0.4244918699186992,0.27052323123350797,0.22801659231011862,131359.53006355738,2019.1944455478397,133378.72450910523,838,1,258.5365853658537,33,8,18,33.75062263399084,0.6404671717171717,43.719362745098046,1025.1225490196086,31.064319667260868,0
4160,4,0,1,40,0.0,0.024390243902439025,0.975609756097561,41,1000,500,500,0.5,15,5,10,388.6266195109482,0.4245426829268293,0.26977953738418603,0.22799791716890544,131390.9388816801,2012.4032823913853,133403.34216407148,839,2,259.5365853658537,33,8,19,33.727787074667305,0.6407828282828283,43.68872549019608,1025.2450980392155,31.06803327391562,0
4161,4,0,1,39,0.0,0.025,0.975,40,1150,600,550,0.5217391304347826,17,6,11,378.57997279844665,0.423571047008547,0.18369708994708933,0.2168230753300198,130463.8422205992,1878.199567811073,132342.04178841028,840,3,262.225,36,4,19,34.925457451499106,0.625,44.594594594594604,1021.6216216216234,28.37837837837843,8
4162,4,0,0,39,0.0,0.0,1.0,39,500,200,300,0.4,8,2,6,384.3674281058545,0.42411718398560505,0.18466419146228819,0.22000174581467383,130439.87509645053,2227.3678626543106,132667.24295910483,841,4,261.28205128205127,35,4,19,34.802005438477224,0.6267857142857143,44.61805555555555,1021.527777777777,29.186507936507915,0
4163,4,0,0,39,0.0,0.0,1.0,39,1500,1000,500,0.6666666666666666,20,10,10,381.02705926473686,0.4243421052631579,0.18223101022331045,0.21892322448711057,130587.70743580669,2151.490028077841,132739.19746388454,842,5,262.28205128205127,35,4,16,34.73712395727173,0.6282738095238095,44.473379629629626,1022.106481481481,29.20304232804231,0
4164,4,0,0,39,0.0,0.0,1.0,39,1100,700,400,0.6363636363636364,15,7,8,381.7729068764945,0.4238922627080522,0.1921277756497315,0.22019225882250035,130735.62349965706,2182.263803155006,132917.88730281207,843,6,263.28205128205127,35,4,16,34.56786630451185,0.6297619047619047,44.3287037037037,1022.6851851851851,29.219576719576718,0
4165,4,0,0,39,0.0,0.0,1.0,39,1200,800,400,0.6666666666666666,16,8,8,380.9962111035353,0.42459514170040485,0.19288486234000835,0.2203278534612107,130838.01442912518,2169.757553161282,133007.77198228647,844,7,264.28205128205127,36,3,17,34.48381031003486,0.6287615740740741,44.22860360360361,1023.0855855855864,28.419044044044067,0
4166,4,0,0,39,0.0,0.0,1.0,39,850,500,350,0.5882352941176471,12,5,7,380.0036549309498,0.42437022042285205,0.18675354714958736,0.22057683418405705,130982.06948502558,2154.7330269458666,133136.80251197144,845,8,265.28205128205127,36,3,18,34.36308214154748,0.6302083333333333,44.08783783783784,1023.6486486486488,28.434684684684687,0
4167,4,0,0,39,0.0,0.0,1.0,39,1650,1400,250,0.8484848484848485,19,14,5,377.1915921140142,0.4250168690958165,0.19024095909954708,0.21960181425639233,131097.3705969484,2089.7651874847943,133187.1357844332,846,9,266.28205128205127,36,3,18,34.31818598343228,0.6313657407407407,43.97522522522523,1024.0990990991,28.44719719719722,0
4168,4,0,1,38,0.0,0.02564102564102564,0.9743589743589743,39,1000,600,400,0.6,14,6,8,375.79168014475204,0.42448268106162845,0.19308405262905715,0.21961005122910107,131241.5683208548,2063.8978928252727,133305.46621368008,847,10,267.28205128205127,36,3,19,34.20797157196761,0.6328125,43.83445945945947,1024.6621621621634,28.462837837837874,0
4169,4,0,0,38,0.0,0.0,1.0,38,900,600,300,0.6666666666666666,12,6,6,379.92552705439044,0.42170459933617827,0.2119320039228505,0.2223556207578737,131298.46810967516,2376.727939600491,133675.19604927566,848,11,273.5,35,3,19,34.04444287596463,0.6354166666666667,43.77893518518519,1024.88425925926,29.28240740740743,0
4170,4,1,0,39,0.02564102564102564,0.0,1.0,39,1300,1000,300,0.7692307692307693,16,10,6,373.8603713488097,0.4229363472784526,0.21817619544628708,0.2212627304146044,131725.001771542,2049.3583136057987,133774.3600851478,849,0,267.46153846153845,34,5,14,33.76845838648575,0.6418504901960784,43.36309523809524,1026.5476190476195,30.192577030812338,0
4171,4,0,0,39,0.0,0.0,1.0,39,800,500,300,0.625,11,5,6,375.09894900732877,0.42217723796671164,0.2155831342201302,0.2228893754845203,131877.8061224491,2093.4452947845966,133971.2514172337,850,1,268.46153846153845,34,5,15,33.58228055941894,0.6433823529411764,43.21428571428572,1027.1428571428582,30.210084033613477,0
4172,4,0,0,39,0.0,0.0,1.0,39,1500,1300,200,0.8666666666666667,17,13,4,377.0790869540183,0.4216992802519118,0.22068568135983857,0.2249705430320693,132030.6990504536,2157.2030895691737,134187.90214002278,851,2,269.46153846153845,34,5,16,33.37701262597011,0.6449142156862745,43.0654761904762,1027.738095238096,30.22759103641459,0
4173,4,0,0,39,0.0,0.0,1.0,39,1200,800,400,0.6666666666666666,16,8,8,380.9820371437645,0.4212494376968061,0.2219372229792509,0.22803477857316012,132153.0771683676,2269.5897108843783,134422.66687925198,852,3,270.46153846153845,34,5,17,33.15314924163483,0.6461397058823529,42.946428571428584,1028.2142857142876,30.24159663865552,0
4174,4,0,0,39,0.0,0.0,1.0,39,700,400,300,0.5714285714285714,10,4,6,378.9335454273222,0.4209682860998651,0.21923833777057555,0.22717605128012758,132214.28748582772,2220.085742630394,134434.3732284581,853,4,271.46153846153845,34,5,18,33.144027086468355,0.6467524509803921,42.886904761904766,1028.4523809523814,30.248599439775923,0
4175,4,0,0,39,0.0,0.0,1.0,39,850,500,350,0.5882352941176471,12,5,7,378.53777832285664,0.42102451641925326,0.21880572724596958,0.22696941283244998,132219.38898533976,2210.006751543236,134429.395736883,854,5,272.46153846153845,35,4,18,33.149054692775145,0.6446428571428571,42.88194444444446,1028.4722222222242,29.384920634920693,0
4176,4,0,0,39,0.0,0.0,1.0,39,1350,1100,250,0.8148148148148148,16,11,5,400.333194502291,0.4205184435447593,0.18001046572475188,0.22809682012339813,130262.58680555539,2650.1832561728206,132912.7700617282,855,6,273.46153846153845,33,6,15,34.574829931972786,0.6294191919191919,44.79166666666666,1020.833333333332,30.934343434343393,8
4177,4,0,1,38,0.0,0.02564102564102564,0.9743589743589743,39,1350,1000,350,0.7407407407407407,17,10,7,398.21728596358764,0.42029352226720645,0.1668056464652805,0.22760200508205317,130384.14292800448,2584.2439058956847,132968.38683390018,856,7,274.46153846153845,34,5,16,34.505041380114235,0.6283700980392157,44.672619047619044,1021.3095238095234,30.038515406162453,0
4178,4,0,0,38,0.0,0.0,1.0,38,900,600,300,0.6666666666666666,12,6,6,404.95477973445105,0.42093409198672355,0.16574241917045107,0.23128774362763418,130356.43029423784,2957.6919033544855,133314.12219759234,857,8,277.4736842105263,33,5,18,34.36124944997801,0.6303661616161615,44.69975490196079,1021.2009803921572,30.945484254307797,0
4179,4,1,0,39,0.02564102564102564,0.0,1.0,39,1250,1000,250,0.8,15,10,5,395.6029921490306,0.4243139901034638,0.17155699614086317,0.22824884523521305,130749.15143140589,2544.9511054421755,133294.10253684808,858,0,271.3333333333333,34,5,16,34.20051992395142,0.632046568627451,44.31547619047619,1022.7380952380952,30.080532212885153,0
4180,4,0,1,38,0.0,0.02564102564102564,0.9743589743589743,39,1150,800,350,0.6956521739130435,15,8,7,391.9514760492273,0.4236673414304993,0.16902139386727066,0.2272155657178158,130931.84700963726,2463.786139455791,133395.63314909305,859,1,272.3333333333333,34,5,16,34.108312977395215,0.6338848039215687,44.136904761904766,1023.4523809523815,30.101540616246517,0
4181,4,0,0,38,0.0,0.0,1.0,38,1050,800,250,0.7619047619047619,13,8,5,387.8447809626822,0.4219268610715979,0.16052631578947296,0.22536926461345066,131023.24263038569,2563.3361678004753,133586.57879818618,860,2,275.1842105263158,34,4,16,34.12063953488372,0.6348039215686274,44.04761904761906,1023.8095238095254,30.11204481792722,0
4182,4,0,0,38,0.0,0.0,1.0,38,550,300,250,0.5454545454545454,8,3,5,386.76479710279295,0.42148233760075865,0.16080036213266768,0.22545557684772566,131145.15306122453,2544.4657029478503,133689.61876417237,861,3,276.1842105263158,34,4,18,34.02463001704633,0.6360294117647058,43.92857142857143,1024.2857142857147,30.126050420168077,0
4183,4,0,0,38,0.0,0.0,1.0,38,1400,1100,300,0.7857142857142857,17,11,6,391.3014739903491,0.42086000474158364,0.16923406076166003,0.22919086333720484,131328.12500000026,2677.7777777778056,134005.90277777807,862,4,277.1842105263158,34,4,19,33.722899728997284,0.6378676470588236,43.750000000000014,1025.000000000002,30.147058823529473,0
4184,4,0,0,38,0.0,0.0,1.0,38,1300,1000,300,0.7692307692307693,16,10,6,378.25908272926745,0.4208896396396396,0.1968742710520177,0.21535148574506885,130232.2066326529,2252.3030045351297,132484.50963718802,863,5,278.1842105263158,34,4,15,35.16906733535496,0.6268382352941176,44.82142857142856,1020.7142857142844,30.021008403361307,7
4185,4,0,0,38,0.0,0.0,1.0,38,900,600,300,0.6666666666666666,12,6,6,382.284751993059,0.42056365576102417,0.19783890972932738,0.21851585206516808,130387.71896626288,2369.0509046755883,132756.76987093847,864,6,279.1842105263158,33,5,16,34.908207343412535,0.6306818181818181,44.66911764705882,1021.323529411764,30.949197860962546,0
4186,4,0,1,37,0.0,0.02631578947368421,0.9736842105263158,38,1400,1200,200,0.8571428571428571,16,12,4,383.18271679875676,0.4191411806543386,0.19702522491603958,0.2205612045487749,130657.85147392281,2413.166099773229,133071.01757369604,865,7,280.1842105263158,34,4,13,34.61079413134606,0.6311274509803921,44.4047619047619,1022.3809523809516,30.07002801120446,0
4187,4,0,0,37,0.0,0.0,1.0,37,1150,800,350,0.6956521739130435,15,8,7,389.7427400310155,0.41844969969969975,0.19613381358347826,0.22458656234936408,130700.81218762007,2787.9385332564334,133488.7507208765,866,8,287.05405405405406,33,4,14,34.399468680089484,0.6338383838383839,44.36274509803921,1022.5490196078426,30.986333927510383,0
4188,4,0,0,37,0.0,0.0,1.0,37,1400,1100,300,0.7857142857142857,17,11,6,396.4154855542409,0.4176363863863864,0.2056618189823749,0.2291742710115516,130826.1546039985,2972.302720107655,133798.45732410616,867,9,288.05405405405406,33,4,14,34.10148139274875,0.6351010101010102,44.240196078431374,1023.0392156862748,31.00118835412954,0
4189,4,0,0,37,0.0,0.0,1.0,37,1100,800,300,0.7272727272727273,14,8,6,394.2972339660309,0.4173861361361361,0.20791912602257434,0.2286923957002981,130951.55709342571,2926.7673490965153,133878.32444252222,868,10,289.05405405405406,33,4,15,34.02827666028098,0.6363636363636364,44.117647058823536,1023.5294117647068,31.01604278074869,0
4190,4,0,0,37,0.0,0.0,1.0,37,900,700,200,0.7777777777777778,11,7,4,392.3535737700108,0.41801176176176175,0.20819479124888396,0.22830824947229894,131077.01965590165,2885.7074202230006,133962.72707612466,869,11,290.05405405405406,33,4,17,33.950654220520185,0.6376262626262627,43.99509803921569,1024.019607843138,31.030897207367815,0
4191,4,0,0,37,0.0,0.0,1.0,37,1200,700,500,0.5833333333333334,17,7,10,393.52277459405155,0.41751126126126126,0.20944571799937228,0.22955037493591612,131171.1560006969,2923.7674512206904,134094.9234519176,870,12,291.05405405405406,33,4,18,33.8251934043147,0.6385732323232323,43.90318627450981,1024.3872549019613,31.04203802733216,0
4192,4,0,1,36,0.0,0.02702702702702703,0.972972972972973,37,1200,800,400,0.6666666666666666,16,8,8,395.92834952739764,0.4165415415415415,0.21335970116457958,0.23190089043747592,131328.12500000012,2999.30555555557,134327.43055555568,871,13,292.05405405405406,33,4,18,33.60433604336043,0.6401515151515151,43.75000000000001,1025.000000000001,31.060606060606087,0
4193,4,0,0,36,0.0,0.0,1.0,36,850,600,250,0.7058823529411765,11,6,5,390.30477575757254,0.41486441798941803,0.14436244116431318,0.22292047267908544,130356.43029423799,2975.7474589100557,133332.17775314805,872,14,300.1111111111111,33,3,18,34.73526441057641,0.6303661616161615,44.699754901960794,1021.2009803921585,30.945484254307832,8
4194,4,0,0,36,0.0,0.0,1.0,36,1200,1100,100,0.9166666666666666,13,11,2,389.38386396158313,0.41491402116402115,0.14162069241224917,0.22329316765554902,130512.91120001934,2963.9243319877114,133476.83553200704,873,15,301.1111111111111,33,3,16,34.59962421044216,0.6319444444444444,44.54656862745099,1021.813725490197,30.96405228758173,0
4195,4,0,0,36,0.0,0.0,1.0,36,850,600,250,0.7058823529411765,11,6,5,387.5495287223456,0.41435185185185186,0.14201971755928589,0.22260076236531443,130575.52984429078,2920.8970107651035,133496.42685505588,874,16,302.1111111111111,33,3,16,34.58283373301359,0.6325757575757576,44.485294117647065,1022.0588235294127,30.971479500891295,0
4196,4,0,0,36,0.0,0.0,1.0,36,800,600,200,0.75,10,6,4,391.2015035203871,0.41451719576719576,0.0643699318127191,0.21677746406432558,129171.97312510718,2906.454019847395,132078.42714495456,875,17,303.1111111111111,35,1,18,35.92036225283692,0.6139880952380952,45.86226851851852,1016.5509259259261,29.044312169312175,8
4197,4,0,0,36,0.0,0.0,1.0,36,950,800,150,0.8421052631578947,11,8,3,394.50914691605897,0.41479828042328043,0.020155707082582186,0.21319534966124518,128174.6669501134,2917.8038052283673,131092.47075534178,876,18,304.1111111111111,34,2,16,36.85805117955952,0.6060049019607843,46.845238095238095,1012.6190476190478,29.782913165266113,8
4198,4,1,1,36,0.02702702702702703,0.02702702702702703,0.972972972972973,37,850,600,250,0.7058823529411765,11,6,5,387.1855922571302,0.41954454454454454,0.023068164636836475,0.21077430718335627,128466.99948827577,2548.114256472891,131015.11374474867,877,0,296.86486486486484,35,2,15,36.743754043460044,0.606845238095238,46.556712962962955,1013.7731481481472,28.964947089947064,0
4199,4,1,0,37,0.02702702702702703,0.0,1.0,37,1050,700,350,0.6666666666666666,14,7,7,379.2537131886143,0.418262012012012,0.045983247990776244,0.2076775330121536,128701.77636584779,2362.1253161436753,131063.90168199147,878,0,297.3243243243243,35,2,16,36.70452169119045,0.6092261904761904,46.325231481481474,1014.6990740740731,28.99140211640209,0
4200,4,0,0,37,0.0,0.0,1.0,37,1250,1100,150,0.88,14,11,3,376.41523464034236,0.41779279279279274,0.0485506598834613,0.20673375222482407,128819.2451801483,2297.90528013546,131117.15046028377,879,1,298.3243243243243,35,2,16,36.65642933150915,0.6104166666666666,46.20949074074074,1015.1620370370368,29.004629629629623,0
4201,4,0,0,37,0.0,0.0,1.0,37,1000,700,300,0.7,13,7,6,378.8139381985536,0.41769894894894893,0.04978516978516967,0.20866869477038963,128936.76757812501,2368.608940972224,131305.37651909725,880,2,299.3243243243243,35,2,17,36.475427350427346,0.6116071428571428,46.09375,1015.6250000000001,29.017857142857146,0
4202,4,0,0,37,0.0,0.0,1.0,37,1300,900,400,0.6923076923076923,17,9,8,381.92620420192895,0.4171671671671671,0.046173736378747554,0.21116574766328317,129083.74592764067,2460.0930212620074,131543.83894890267,881,3,300.3243243243243,35,2,18,36.246203492786634,0.6130952380952381,45.949074074074076,1016.2037037037043,29.03439153439155,0
4203,4,0,0,37,0.0,0.0,1.0,37,1150,800,350,0.6956521739130435,15,8,7,383.7890328949341,0.4165728228228229,0.0424547703873388,0.21315513127363625,129261.9118480725,2521.914411340658,131783.82625941315,882,4,301.3243243243243,34,3,19,36.016887145867464,0.6170343137254901,45.77380952380952,1016.9047619047614,29.908963585434158,0
4204,4,0,1,36,0.0,0.02702702702702703,0.972972972972973,37,1200,800,400,0.6666666666666666,16,8,8,382.27043624414995,0.4157282282282282,0.045767241788307045,0.21280136011115702,129352.72285997724,2489.54435941042,131842.26721938766,883,5,302.3243243243243,34,3,20,35.962795006826596,0.617953431372549,45.6845238095238,1017.261904761904,29.919467787114826,0
4205,4,0,0,36,0.0,0.0,1.0,36,1050,700,350,0.6666666666666666,14,7,7,391.3570349168616,0.41569113756613757,0.045182819884591385,0.21753998879939948,129294.84941188474,2920.0897791714606,132214.9391910562,884,6,300.9166666666667,33,3,21,35.79083323291964,0.6196338383838385,45.741421568627445,1017.0343137254894,30.81922162804513,0
4206,4,0,0,36,0.0,0.0,1.0,36,1400,1200,200,0.8571428571428571,16,12,4,367.1221786995774,0.41603835978835974,-0.006445357061373613,0.20088595620976832,128672.41753472194,2247.6996527777437,130920.11718749968,885,7,301.9166666666667,35,1,18,37.04226557152635,0.6089285714285715,46.35416666666665,1014.5833333333311,28.988095238095173,8
4207,4,0,0,36,0.0,0.0,1.0,36,1450,1200,250,0.8275862068965517,17,12,5,367.74064953021013,0.4159556878306878,-0.01156536283118581,0.2016709040481809,128760.50407503855,2270.0942804783867,131030.59835551694,886,8,302.9166666666667,35,1,18,36.93658056790967,0.6098214285714285,46.26736111111111,1014.9305555555553,28.998015873015866,0
4208,4,1,0,37,0.02702702702702703,0.0,1.0,37,800,600,200,0.75,10,6,4,366.8144761550709,0.4199512012012012,-0.0035951727128198385,0.195983734402852,127717.31190650097,1969.7117725833818,129687.02367908435,887,0,295.7027027027027,36,1,17,38.02779634581105,0.5972222222222222,47.29729729729729,1010.8108108108098,28.07807807807805,8
4209,4,2,0,39,0.05128205128205128,0.0,1.0,39,1250,1000,250,0.8,15,10,5,354.010906207865,0.42622582096266304,0.01647842728202842,0.19198529976806278,128315.61872260773,1286.4523729810878,129602.07109558882,888,0,281.4871794871795,36,3,19,37.73920010373828,0.6032986111111112,46.70608108108108,1013.1756756756756,28.143768768768766,0
4210,4,1,1,39,0.025,0.025,0.975,40,1300,1000,300,0.7692307692307693,16,10,6,346.0927439323932,0.4293803418803419,0.029658875552748043,0.18957259987715497,128713.06911571317,909.3318540433738,129622.40096975653,889,0,275.425,38,2,17,37.53421773004844,0.6036184210526316,46.314102564102555,1014.7435897435882,26.70377867746285,0
4211,4,0,0,39,0.0,0.0,1.0,39,1050,900,150,0.8571428571428571,12,9,3,356.075203757658,0.4257759784075574,0.03201179381877517,0.1948411508202017,128672.41753472229,1363.411458333344,130035.82899305563,890,1,283.46153846153845,37,2,17,37.32246748802191,0.6050112612612613,46.35416666666667,1014.5833333333339,27.42117117117119,0
4212,4,1,1,39,0.025,0.025,0.975,40,1400,1200,200,0.8571428571428571,16,12,4,350.8086667212649,0.42922008547008544,0.03747051584452854,0.19337113110226437,128963.21750217021,1048.282877604172,130011.50037977438,891,0,277.35,39,1,18,37.15954346562746,0.6044337606837606,46.067708333333336,1015.7291666666673,26.044337606837622,0
4213,4,2,2,39,0.04878048780487805,0.04878048780487805,0.9512195121951219,41,900,700,200,0.7777777777777778,11,7,4,339.7976314588261,0.43579776422764227,0.056344943495890476,0.19022355331388519,129573.74762854066,606.6494149343584,130180.39704347502,892,0,267.6341463414634,36,5,15,36.818382922243124,0.6160300925925926,45.46734234234234,1018.1306306306302,28.281406406406393,0
4214,4,0,0,39,0.0,0.0,1.0,39,800,400,400,0.5,12,4,8,360.4604542570723,0.4292060278902384,0.06397503413302141,0.20066023333072838,129352.7228599772,1525.3082482993063,130878.03110827651,893,1,271.2307692307692,34,5,19,36.517456602301536,0.617953431372549,45.6845238095238,1017.2619047619038,29.91946778711482,0
4215,4,0,1,38,0.0,0.02564102564102564,0.9743589743589743,39,1550,1300,250,0.8387096774193549,18,13,5,355.47374673792035,0.42884053081421497,0.058263128887489524,0.19845591460739875,129466.28146701379,1404.3728298611054,130870.6542968749,894,2,272.2307692307692,35,4,16,36.528701808256585,0.6169642857142856,45.572916666666664,1017.7083333333325,29.077380952380928,0
4216,4,0,1,37,0.0,0.02631578947368421,0.9736842105263158,38,1150,900,250,0.782608695652174,14,9,5,353.29586557675424,0.4285798956851588,0.05884818216742871,0.19792448677478391,129602.4128013149,1557.599322295276,131160.01212361018,895,3,276.6842105263158,36,2,16,36.44566098945662,0.6163194444444444,45.43918918918919,1018.2432432432438,28.28453453453455,0
4217,4,0,1,36,0.0,0.02702702702702703,0.972972972972973,37,800,500,300,0.625,11,5,6,353.27720011140906,0.42770895895895894,0.046200742283394325,0.19870773265346325,129759.3730763312,1768.2056017236098,131527.57867805482,896,4,270.6216216216216,37,0,17,36.286590615583314,0.615990990990991,45.28508771929825,1018.8596491228072,27.536747273589384,0
4218,4,0,0,36,0.0,0.0,1.0,36,1300,1000,300,0.7692307692307693,16,10,6,362.90936448523286,0.4232638888888889,0.04533812419384575,0.20375637503221203,129688.42734203818,2213.0289495576876,131901.45629159588,897,5,279.0,36,0,17,36.11341440943431,0.6171875,45.35472972972974,1018.5810810810826,28.293918918918962,0
4219,4,1,0,37,0.02702702702702703,0.0,1.0,37,1000,600,400,0.6,14,6,8,357.1594403977338,0.4270833333333333,0.03843068875326949,0.202042749130105,129982.90339335184,1884.92420744845,131867.8276008003,898,0,272.43243243243245,37,0,18,35.96057347670252,0.6182432432432432,45.06578947368421,1019.7368421052635,27.560455192034148,0
4220,4,0,0,37,0.0,0.0,1.0,37,650,500,150,0.7692307692307693,8,5,3,390.3967213252999,0.42639514514514515,0.1111049447805097,0.21362157672519216,128672.41753472216,2653.883767120648,131326.30130184282,899,1,273.43243243243245,35,2,15,36.451916495550996,0.6089285714285715,46.354166666666664,1014.5833333333328,28.988095238095223,7
4221,4,1,1,37,0.02631578947368421,0.02631578947368421,0.9736842105263158,38,1150,800,350,0.6956521739130435,15,8,7,386.2950100137351,0.4276315789473684,0.12868056568012798,0.21375306348092957,129115.5360385724,2375.3374573898277,131490.87349596224,900,0,267.2105263157895,36,2,17,36.10272391505078,0.611400462962963,45.917792792792795,1016.3288288288293,28.23135635635637,0
4222,4,0,0,37,0.0,0.0,1.0,37,850,600,250,0.7058823529411765,11,6,5,389.61379803295904,0.4269894894894895,0.12656689969492652,0.21623431533834717,129233.48263251198,2670.315201099391,131903.79783361137,901,1,273.72972972972974,32,5,18,35.89785380189577,0.6214192708333333,45.801767676767675,1016.7929292929292,31.774779040404038,0
4223,4,0,0,37,0.0,0.0,1.0,37,1050,800,250,0.7619047619047619,13,8,5,386.9019205781557,0.4268330830830831,0.12689876096284225,0.21557447950602981,129388.34372597064,2612.119737600907,132000.46346357153,902,2,274.72972972972974,33,4,19,35.80864048823576,0.6205808080808081,45.64950980392156,1017.4019607843126,30.83036244800947,0
4224,4,0,1,36,0.0,0.02702702702702703,0.972972972972973,37,1150,900,250,0.782608695652174,14,9,5,384.201871340667,0.42648898898898896,0.12649702790547912,0.21492019833177886,129544.24267409151,2554.228091359071,132098.4707654506,903,3,275.72972972972974,33,4,15,35.7182446531038,0.6221590909090908,45.496323529411754,1018.0147058823514,30.84893048128338,0
4225,4,1,0,37,0.02702702702702703,0.0,1.0,37,1150,800,350,0.6956521739130435,15,8,7,384.11515508884634,0.4250813313313313,0.13375338528712755,0.2158992078602824,129731.44531249988,2566.3628472222076,132297.8081597221,904,0,276.56756756756755,33,4,16,35.52956714383094,0.6240530303030303,45.31249999999999,1018.7499999999991,30.871212121212093,0
4226,4,2,1,38,0.05128205128205128,0.02564102564102564,0.9743589743589743,39,1100,800,300,0.7272727272727273,14,8,6,369.2747926400148,0.42853126405757985,0.13544778249205613,0.2105751744208156,130294.81207274793,1826.1731503800925,132120.98522312802,905,0,263.3333333333333,32,7,18,35.33473493280567,0.6321614583333333,44.760101010101025,1020.959595959598,31.904987373737438,0
4227,4,0,1,37,0.0,0.02631578947368421,0.9736842105263158,38,950,700,250,0.7368421052631579,12,7,5,366.5933185370758,0.428520625889047,0.11326617628112734,0.209527253812763,130384.14292800445,1959.5911281179058,132343.73405612237,906,1,251.76315789473685,34,4,18,35.3124878579477,0.6283700980392157,44.672619047619044,1021.3095238095232,30.038515406162446,0
4228,4,1,0,38,0.02631578947368421,0.0,1.0,38,950,700,250,0.7368421052631579,12,7,5,360.6688067198624,0.42972083926031296,0.11717754581985695,0.20825714968663026,130779.59183673466,1833.6238662131489,132613.2157029478,907,0,247.3421052631579,34,4,15,35.062897656734954,0.6323529411764706,44.285714285714285,1022.8571428571425,30.08403361344537,0
4229,4,0,2,36,0.0,0.05263157894736842,0.9473684210526316,38,1050,900,150,0.8571428571428571,12,9,3,361.14517551225714,0.4291577761972499,0.11839961784843744,0.20886148306543312,130840.48327664386,1850.4818594104127,132690.96513605426,908,1,248.3421052631579,34,4,15,34.989042742998976,0.6329656862745099,44.22619047619047,1023.0952380952372,30.0910364145658,0
4230,4,0,0,36,0.0,0.0,1.0,36,950,800,150,0.8421052631578947,11,8,3,382.126698817814,0.42417328042328045,0.1324445817033837,0.2195397889943368,130585.0188277982,2780.0044319457256,133365.02325974393,909,2,262.97222222222223,32,4,15,34.71175622812437,0.6350911458333333,44.476010101010104,1022.0959595959597,31.94049873737374,0
4231,4,0,0,36,0.0,0.0,1.0,36,800,500,300,0.625,11,5,6,381.6162570888467,0.4243551587301588,0.13118961352657,0.219429347826087,130617.28395061738,2769.1358024691467,133386.41975308652,910,3,263.97222222222223,32,4,15,34.692028985507235,0.6354166666666667,44.44444444444445,1022.222222222223,31.944444444444468,0
4232,4,1,0,37,0.02702702702702703,0.0,1.0,37,1150,900,250,0.782608695652174,14,9,5,374.6275432761084,0.4258008008008008,0.1424014390258106,0.21763828209517444,131014.28086553246,2416.3116349480943,133430.59250048056,911,0,257.81081081081084,33,4,16,34.468019312105966,0.6369949494949495,44.056372549019606,1023.7745098039214,31.023469994058225,0
4233,4,0,0,37,0.0,0.0,1.0,37,800,500,300,0.625,11,5,6,415.2578815440269,0.4257695195195195,0.1479699741788041,0.2342185758748326,129867.92091836737,3385.7355442176918,133253.65646258506,912,1,258.81081081081084,34,3,16,34.596910768512025,0.6231617647058824,45.17857142857143,1019.2857142857144,29.97899159663866,8
4234,4,0,1,36,0.0,0.02702702702702703,0.972972972972973,37,950,700,250,0.7368421052631579,12,7,5,384.8961615022056,0.42486236236236236,0.16427285634602784,0.2114944887429644,128838.54875283431,2542.899659863929,131381.44841269823,913,2,259.81081081081084,34,3,21,36.42144504377737,0.6127450980392157,46.19047619047618,1015.2380952380939,29.859943977590998,8
4235,4,1,0,37,0.02702702702702703,0.0,1.0,37,1200,800,400,0.6666666666666666,16,8,8,376.7907066514741,0.42661411411411415,0.16355154179217957,0.20864496430896978,129144.15048494453,2332.0631442253216,131476.21362916986,914,0,256.6756756756757,36,1,22,36.31499741487556,0.6116898148148149,45.88963963963965,1016.4414414414425,28.234484484484515,0
4236,4,0,0,37,0.0,0.0,1.0,37,1250,700,550,0.56,18,7,11,373.5723778292123,0.42670795795795796,0.16239666998886104,0.20749020021598394,129263.69214965377,2257.9070134674303,131521.5991631212,915,1,257.6756756756757,33,4,22,36.2748051739375,0.6193181818181819,45.7720588235294,1016.9117647058806,30.815508021390322,0
4237,4,1,1,37,0.02631578947368421,0.02631578947368421,0.9736842105263158,38,1450,1000,450,0.6896551724137931,19,10,9,363.45178703512454,0.429068871503082,0.1612772982575772,0.20382487406769018,129643.02722318663,1823.797984182088,131466.8252073687,916,0,251.8684210526316,35,3,20,36.14579781793386,0.61875,45.39930555555555,1018.4027777777769,29.097222222222197,0
4238,4,0,1,36,0.0,0.02702702702702703,0.972972972972973,37,700,300,400,0.42857142857142855,11,3,8,367.5545298290687,0.4261761761761762,0.14359252919664267,0.20667093733752728,129746.6057256234,2137.7905328797965,131884.3962585032,917,1,247.13513513513513,34,3,20,35.93591765988939,0.6219362745098039,45.29761904761904,1018.8095238095224,29.96498599439772,0
4239,4,1,0,37,0.02702702702702703,0.0,1.0,37,1450,1300,150,0.896551724137931,16,13,3,371.8788713742584,0.425487987987988,0.16591591591591692,0.21073136044541255,130049.99999999959,2272.5694444444002,132322.569444444,918,0,248.02702702702703,34,3,21,35.51708877995643,0.625,44.99999999999998,1019.9999999999967,29.999999999999904,0
4240,4,0,0,37,0.0,0.0,1.0,37,900,600,300,0.6666666666666666,12,6,6,370.48937815157444,0.4254567067067067,0.165424414772118,0.21029387433394214,130114.93866008629,2241.2405424811004,132356.17920256738,919,1,249.02702702702703,35,2,21,35.48650501039893,0.6235119047619048,44.936342592592574,1020.2546296296273,29.150132275132208,0
4241,4,0,0,37,0.0,0.0,1.0,37,1350,900,450,0.6666666666666666,18,9,9,370.34568929612715,0.4248936436436436,0.16966354109211323,0.21101091599430483,130262.58680555545,2248.7723979766743,132511.3592035321,920,2,250.02702702702703,31,6,23,35.34013605442179,0.6344086021505376,44.791666666666664,1020.8333333333325,32.93010752688169,0
4242,4,1,0,38,0.02631578947368421,0.0,1.0,38,1000,600,400,0.6,14,6,8,346.42624995319136,0.4252311522048364,0.15588028394193176,0.19564546730045207,129917.93894823907,1405.73715607502,131323.6761043141,921,0,244.42105263157896,36,2,21,36.30012150668285,0.6195023148148149,45.12950450450452,1019.4819819819843,28.318943943944006,8
4243,4,0,0,38,0.0,0.0,1.0,38,1300,900,400,0.6923076923076923,17,9,8,350.57859773258656,0.4246088193456614,0.07548428988853217,0.19014653311964452,128320.37278163576,1397.7318076804224,129718.10458931618,922,1,245.42105263157896,35,3,19,37.82128169979438,0.6053571428571429,46.701388888888886,1013.1944444444441,28.94841269841269,8
4244,4,0,1,37,0.0,0.02631578947368421,0.9736842105263158,38,700,400,300,0.5714285714285714,10,4,6,354.4328997719209,0.42478662873399714,0.06567348537342221,0.1895879595534431,127763.95486379013,1459.7638835305006,129223.71874732063,923,2,246.42105263157896,35,3,18,38.29290688799848,0.5997023809523809,47.2511574074074,1010.995370370369,28.88558201058197,8
4245,4,2,0,39,0.05128205128205128,0.0,1.0,39,1150,400,750,0.34782608695652173,19,4,15,343.5251514376698,0.4305555555555556,0.08251753433480657,0.18629872136737288,128315.61872260776,1015.9284707004282,129331.54719330819,924,0,240.64102564102564,36,3,21,38.00479789559481,0.6032986111111112,46.70608108108108,1013.1756756756758,28.143768768768773,0
4246,4,1,1,39,0.025,0.025,0.975,40,1000,700,300,0.7,13,7,6,341.5701203228029,0.43195779914529914,0.08894770959377674,0.1872969806698972,128755.86718990473,795.8314096645285,129551.69859956927,925,0,235.6,37,3,15,37.60533707865168,0.6058558558558558,46.27192982456141,1014.9122807017557,27.43006164058799,0
4247,4,0,0,39,0.0,0.0,1.0,39,1150,800,350,0.6956521739130435,15,8,7,347.93573133000206,0.42929037336932074,0.08743495862102302,0.19086699613373778,128772.40997331799,1160.9045278386568,129933.31450115665,926,1,242.6153846153846,36,3,17,37.426957357890444,0.6079282407407407,46.255630630630634,1014.9774774774781,28.193818818818837,0
4248,4,0,0,39,0.0,0.0,1.0,39,750,300,450,0.4,12,3,9,350.008247193789,0.4294309491677913,0.08469842786612958,0.1924191680914148,128858.14868922981,1220.2829518707965,130078.43164110061,927,2,243.6153846153846,36,3,17,37.2869528246081,0.6087962962962963,46.171171171171174,1015.3153153153157,28.203203203203216,0
4249,4,0,0,39,0.0,0.0,1.0,39,1250,900,350,0.72,16,9,7,349.9441988977437,0.42903733693207374,0.08098243220194434,0.19293989450230145,128972.51136271421,1226.6364337310442,130199.14779644526,928,3,244.6153846153846,36,3,18,37.1720251293422,0.6099537037037037,46.058558558558566,1015.7657657657669,28.215715715715746,0
4250,4,0,1,38,0.0,0.02564102564102564,0.9743589743589743,39,800,300,500,0.375,13,3,10,348.5106309997372,0.42872807017543857,0.08091332298825127,0.1924273508494265,129029.711721857,1193.6452499797156,130223.35697183672,929,4,245.6153846153846,36,3,19,37.15016071824431,0.6105324074074074,46.002252252252255,1015.9909909909911,28.221971971971975,0
4251,4,0,0,38,0.0,0.0,1.0,38,750,600,150,0.8,9,6,3,347.5517387811724,0.42840208629682314,0.07789193791036397,0.19245411007600402,129144.15048494456,1376.854810891988,130521.00529583656,930,5,248.18421052631578,36,2,19,37.05798988108426,0.6116898148148149,45.88963963963965,1016.4414414414427,28.234484484484522,0
4252,4,0,0,38,0.0,0.0,1.0,38,1450,1200,250,0.8275862068965517,17,12,5,348.99917373886075,0.4282390943575154,0.07675608576307291,0.19395763310988648,129287.27027280678,1424.2301000324837,130711.50037283926,931,6,249.18421052631578,36,2,20,36.87553057985457,0.6131365740740741,45.74887387387388,1017.004504504506,28.250125125125166,0
4253,4,1,0,39,0.02564102564102564,0.0,1.0,39,900,500,400,0.5555555555555556,13,5,8,343.93659084730064,0.42979644624381463,0.08269624205879222,0.19276639222684852,129619.76431450053,1116.1959689519767,130735.9602834525,932,0,243.76923076923077,37,2,18,36.6662853092136,0.6145833333333333,45.422149122807014,1018.3114035087713,27.521929824561386,0
4254,4,1,0,40,0.025,0.0,1.0,40,1250,900,350,0.72,16,9,7,339.263043010194,0.43211805555555555,0.09298365122615837,0.19155313351498632,129908.37191358018,814.6219135802402,130722.99382716042,933,0,238.65,38,2,19,36.49239327883741,0.6156798245614035,45.138888888888886,1019.4444444444439,26.827485380116944,0
4255,4,1,0,41,0.024390243902439025,0.0,1.0,41,1200,900,300,0.75,15,9,6,332.3001119314215,0.434375,0.09827782327216017,0.18920446233678112,130236.00396050366,455.4877387152967,130691.49169921895,934,0,233.8048780487805,39,2,20,36.33799792495833,0.6172542735042735,44.81770833333334,1020.7291666666681,26.17254273504277,0
4256,4,1,3,39,0.023809523809523808,0.07142857142857142,0.9285714285714286,42,1350,900,450,0.6666666666666666,18,9,9,332.0991509518781,0.4344754161827333,0.1106225612952072,0.19078201809952175,130581.79253472244,273.22319878474684,130855.01573350719,935,0,229.21428571428572,39,3,15,35.993341486615044,0.6207264957264957,44.47916666666668,1022.0833333333351,26.207264957265004,0
4257,4,0,1,38,0.0,0.02564102564102564,0.9743589743589743,39,900,400,500,0.4444444444444444,14,4,10,356.7609237794461,0.43002136752136755,0.12332691388608463,0.20357151012638375,130320.07250071019,1498.6218904715536,131818.69439118175,936,2,246.07692307692307,36,3,21,35.62851549575384,0.6235532407407407,44.73536036036036,1021.0585585585586,28.36273773773774,0
4258,4,1,0,39,0.02564102564102564,0.0,1.0,39,1350,1000,350,0.7407407407407407,17,10,7,348.743401891894,0.4315395861448493,0.11044307538357079,0.20115829990387726,130738.7384219183,1318.8544792628516,132057.59290118114,937,0,235.3846153846154,37,2,16,35.409183910510706,0.6258445945945945,44.32565789473684,1022.6973684210528,27.640469416785212,0
4259,4,0,2,37,0.0,0.05128205128205128,0.9487179487179487,39,850,400,450,0.47058823529411764,13,4,9,355.1894383443552,0.43114597390913184,0.057094459944200926,0.19586160457274432,128978.53185595559,1362.3624576792743,130340.89431363487,938,1,236.3846153846154,37,2,17,37.03268926309729,0.6081081081081081,46.05263157894736,1015.7894736842098,27.453769559032697,7
4260,4,0,0,37,0.0,0.0,1.0,37,850,800,50,0.9411764705882353,9,8,1,367.3181855281445,0.42454954954954954,0.07473646260557665,0.20173749563352283,128819.24518014856,2063.530280135488,130882.77546028404,939,2,249.9189189189189,35,2,17,36.88730380420325,0.6104166666666666,46.209490740740755,1015.162037037039,29.004629629629687,0
4261,4,1,0,38,0.02631578947368421,0.0,1.0,38,900,600,300,0.6666666666666666,12,6,6,360.55984552830836,0.4246236367946894,0.07083360068129951,0.19922421838346172,129058.31665702879,1706.649343600373,130764.96600062915,940,0,244.31578947368422,36,2,18,36.81494514019729,0.6108217592592593,45.97409909909911,1016.1036036036047,28.225100100100132,0
4262,4,0,0,38,0.0,0.0,1.0,38,1200,900,300,0.75,15,9,6,360.5611657328889,0.4245791844476055,0.06947286794587026,0.1998026791326452,129172.76810171663,1714.9367695398196,130887.70487125646,941,1,245.31578947368422,36,2,19,36.698238617480904,0.6119791666666667,45.86148648648649,1016.5540540540544,28.237612612612622,0
4263,4,0,0,38,0.0,0.0,1.0,38,950,600,350,0.631578947368421,13,6,7,364.8224506544881,0.4237494073020389,0.07109420713867753,0.20308845868681408,129352.72285997709,1838.1618113217744,131190.88467129887,942,2,246.31578947368422,34,4,20,36.40652428320656,0.617953431372549,45.684523809523796,1017.2619047619029,29.91946778711479,0
4264,4,1,1,38,0.02564102564102564,0.02564102564102564,0.9743589743589743,39,1250,900,350,0.72,16,9,7,356.72754330160564,0.4243421052631579,0.07401374075471301,0.1900569785333733,127603.5072234397,1303.9371296972708,128907.44435313696,943,0,240.97435897435898,36,3,15,38.399325679892996,0.5960648148148149,47.40990990990991,1010.3603603603607,28.065565565565574,8
4265,4,3,1,40,0.07317073170731707,0.024390243902439025,0.975609756097561,41,1300,900,400,0.6923076923076923,17,9,8,347.58378380974534,0.429979674796748,0.10996183559473738,0.18858607583819362,128333.90404704504,721.3567919497387,129055.26083899479,944,0,229.3658536585366,38,3,19,37.8833210319134,0.5997807017543859,46.68803418803419,1013.2478632478629,26.66441745389113,0
4266,4,1,3,38,0.024390243902439025,0.07317073170731707,0.926829268292683,41,1700,1100,600,0.6470588235294118,23,11,12,362.9189317346612,0.4327235772357723,0.061628023687644085,0.19597622313671675,128144.53124999977,1138.6655115420845,129283.19676154185,945,0,230.2439024390244,37,4,18,37.68861454046637,0.5996621621621622,46.874999999999986,1012.4999999999982,27.364864864864817,8
4267,4,0,0,38,0.0,0.0,1.0,38,1500,1100,400,0.7333333333333333,19,11,8,377.5852789095786,0.42514224751066854,0.09889350740588987,0.2037509998437639,128116.02776763226,2074.9452154857313,130190.97298311799,946,1,248.8421052631579,36,2,18,37.346588802373006,0.6012731481481481,46.90315315315314,1012.3873873873855,28.121871871871818,0
4268,4,1,1,38,0.02564102564102564,0.02564102564102564,0.9743589743589743,39,1150,700,450,0.6086956521739131,16,7,9,372.4207512653924,0.4271817363922627,0.09457649913750266,0.20438861004990558,128789.87295310352,1797.3854763014974,130587.25842940502,947,0,243.43589743589743,35,4,20,36.78781832003041,0.6101190476190477,46.238425925925924,1015.046296296296,29.001322751322743,8
4269,4,0,0,38,0.0,0.0,1.0,38,1250,900,350,0.72,16,9,7,372.6506986849716,0.426683262209578,0.09392324861401091,0.20481779002910827,128848.62075617275,2003.1057098765318,130851.72646604928,948,1,248.26315789473685,35,3,20,36.721956224350194,0.6107142857142858,46.18055555555555,1015.277777777777,29.00793650793649,0
4270,4,0,0,38,0.0,0.0,1.0,38,1000,700,300,0.7,13,7,6,371.42660915010435,0.4259127548601233,0.10337446487030921,0.20505552044777456,129024.94454089506,1984.6595293209841,131009.60407021604,949,2,249.26315789473685,35,3,20,36.57296650717703,0.6125,46.00694444444444,1015.9722222222222,29.027777777777775,0
4271,4,2,1,39,0.05,0.025,0.975,40,1200,700,500,0.5833333333333334,17,7,10,363.2909377507082,0.4312900641025641,0.11759195599862471,0.19320170711459056,127530.03532503861,1367.7360628858094,128897.77138792443,950,0,237.75,35,5,21,38.308911997249915,0.5973214285714286,47.48263888888889,1010.0694444444447,28.85912698412699,8
4272,4,0,0,39,0.0,0.0,1.0,39,1550,1200,350,0.7741935483870968,19,12,7,371.45894824338757,0.42985267656320286,0.127120959709478,0.19754553572943567,127530.0353250384,1674.4345582561511,129204.46988329456,951,1,244.76923076923077,35,4,21,38.10265555173599,0.5973214285714286,47.48263888888888,1010.0694444444431,28.859126984126945,0
4273,4,3,1,41,0.07142857142857142,0.023809523809523808,0.9761904761904762,42,900,600,300,0.6666666666666666,12,6,6,350.96349582264304,0.43683459156020127,0.14473297882752112,0.1909154221375594,128437.66744898829,619.8172528720788,129057.48470186036,952,0,228.21428571428572,35,7,19,37.69172946639262,0.6065476190476191,46.585648148148145,1013.657407407407,28.9616402116402,0
4274,4,0,0,41,0.0,0.0,1.0,41,1500,1200,300,0.8,18,12,6,363.7357167590028,0.43544207317073175,0.14690308087291415,0.1974565319548873,128355.55555555562,1137.5000000000107,129493.05555555563,953,1,234.78048780487805,34,7,23,37.45202850877194,0.607843137254902,46.66666666666667,1013.3333333333339,29.80392156862747,0
4275,4,0,2,39,0.0,0.04878048780487805,0.9512195121951219,41,1650,1000,650,0.6060606060606061,23,10,13,362.77608352393185,0.4354928861788618,0.14811144588665193,0.19753204138681643,128476.21882086188,1121.6198979592054,129597.83871882108,954,2,235.78048780487805,34,7,19,37.352972835447005,0.6090686274509804,46.54761904761906,1013.8095238095254,29.817927170868394,0
4276,4,0,0,39,0.0,0.0,1.0,39,1650,1000,650,0.6060606060606061,23,10,13,368.6400909062809,0.43415429599640126,0.12043906460150122,0.20093070567579516,128517.04422577868,1675.3069732795227,130192.3511990582,955,3,231.66666666666666,33,6,19,37.16259769559261,0.6117424242424243,46.50735294117648,1013.9705882352952,30.72638146167561,0
4277,4,3,0,42,0.07142857142857142,0.0,1.0,42,1450,1000,450,0.6896551724137931,19,10,9,371.35486935506674,0.4399801587301588,0.2070060740946822,0.19359464509017946,126721.57343329494,1048.8748317954735,127770.44826509041,956,0,216.04761904761904,33,9,21,38.936729146381055,0.5934343434343434,48.2843137254902,1006.8627450980396,30.510992275698168,8
4278,4,4,1,45,0.08695652173913043,0.021739130434782608,0.9782608695652174,46,1100,800,300,0.7272727272727273,14,8,6,360.73721306610514,0.44789653784219,0.23833664959146494,0.18805945066948732,126721.57343329485,258.0660082660463,126979.6394415609,957,0,198.17391304347825,33,13,17,39.203992210321324,0.5934343434343434,48.28431372549019,1006.8627450980389,30.510992275698147,8
4279,4,2,2,45,0.0425531914893617,0.0425531914893617,0.9574468085106383,47,1650,1000,650,0.6060606060606061,23,10,13,344.05353084757206,0.44742522355843356,0.25660745656841755,0.18204774205041407,127325.53155006841,-638.6402606310193,126686.8912894374,958,0,194.80851063829786,35,12,12,39.00420489296637,0.5952380952380952,47.685185185185176,1009.2592592592578,28.835978835978793,0
4280,4,1,1,45,0.021739130434782608,0.021739130434782608,0.9782608695652174,46,1350,900,450,0.6666666666666666,18,9,9,351.73632742969056,0.44565217391304346,0.2645611156685812,0.1864202535377357,127392.29024943287,-238.30073696147832,127153.9895124714,959,0,199.97826086956522,34,12,14,38.741892688679236,0.5980392156862745,47.619047619047606,1009.5238095238076,29.691876750700224,0
4281,4,2,2,45,0.0425531914893617,0.0425531914893617,0.9574468085106383,47,1600,1300,300,0.8125,19,13,6,334.44312556164425,0.4495451742213999,0.2610910795498933,0.18008630134346895,128030.53634293073,-836.2134516273126,127194.32289130343,960,0,184.6595744680851,36,11,16,38.525787248247454,0.6004050925925926,46.98761261261261,1012.0495495495493,28.11248748748748,0
4282,4,1,1,45,0.021739130434782608,0.021739130434782608,0.9782608695652174,46,1350,1100,250,0.8148148148148148,16,11,5,341.7882605375206,0.4476046698872786,0.19397960489823807,0.18272940057068882,127743.06047650517,-429.20688401908774,127313.85359248608,961,0,189.52173913043478,41,5,17,38.633873078181225,0.5889227642276422,47.271825396825385,1010.9126984126964,24.656407278358447,8
4283,4,1,0,46,0.021739130434782608,0.0,1.0,46,1550,1200,350,0.7741935483870968,19,12,7,344.66302261313524,0.4475342190016103,0.20591846653649104,0.18518827737664617,127943.71712805456,-380.50634605697576,127563.21078199758,962,0,190.47826086956522,41,5,18,38.35596849055371,0.5909552845528455,47.07341269841268,1011.7063492063462,24.675764614788932,0
4284,4,0,1,45,0.0,0.021739130434782608,0.9782608695652174,46,1100,800,300,0.7272727272727273,14,8,6,342.81382628518645,0.44703099838969407,0.20655608708142315,0.18444125646039133,127997.40780489432,-424.14377516377704,127573.26402973055,963,1,191.47826086956522,42,4,18,38.3478566184685,0.5900297619047619,47.02034883720929,1011.918604651161,24.09330011074193,0
4285,4,1,0,46,0.021739130434782608,0.0,1.0,46,1300,900,400,0.6923076923076923,17,9,8,340.2259140713646,0.4480575684380032,0.2060297011987835,0.18372199359853686,128144.53124999997,-479.87491361697175,127664.65633638299,964,0,191.43478260869566,36,10,20,38.2630315500686,0.6015625,46.875,1012.4999999999998,28.124999999999993,0
4286,4,1,2,45,0.02127659574468085,0.0425531914893617,0.9574468085106383,47,1150,700,450,0.6086956521739131,16,7,9,336.2148308719927,0.4494488128276288,0.20796520258218942,0.1829491531142773,128450.01737313399,-762.6398266774468,127687.37754645654,965,0,188.3404255319149,37,10,14,38.05288894898142,0.602759009009009,46.5734649122807,1013.7061403508768,27.3974632527264,0
4287,4,0,0,45,0.0,0.0,1.0,45,1300,800,500,0.6153846153846154,18,8,10,341.5069654674781,0.4474116161616162,0.2066111638037027,0.18591850805053917,128469.25593770537,-225.3708497698979,128243.88508793547,966,2,197.37777777777777,38,7,15,37.899146380018955,0.6011513157894737,46.554487179487175,1013.7820512820506,26.678475033738174,0
4288,4,0,3,42,0.0,0.06666666666666667,0.9333333333333333,45,800,400,400,0.5,12,4,8,339.8023169305982,0.44690656565656567,0.14570446735395182,0.1811034326498244,127617.73003472228,-324.9596790762604,127292.77035564602,967,3,198.37777777777777,41,4,17,38.8122852233677,0.5876524390243902,47.395833333333336,1010.4166666666672,24.644308943089445,8
4289,4,2,1,43,0.045454545454545456,0.022727272727272728,0.9772727272727273,44,1250,800,450,0.64,17,8,9,350.27313228781793,0.4440076638477801,0.1920985056528406,0.18796762404245218,127893.53820231797,159.53404509952097,128053.0722474175,968,0,203.52272727272728,41,3,20,38.26541454165032,0.5904471544715447,47.12301587301587,1011.5079365079365,24.670925280681377,0
4290,4,1,0,44,0.022727272727272728,0.0,1.0,44,1050,600,450,0.5714285714285714,15,6,9,349.3262754480627,0.4426202431289641,0.20204508539646593,0.18876700724182904,128172.28768707682,155.7737646491115,128328.06145172594,969,0,204.22727272727272,37,7,21,38.00430878902724,0.5999436936936937,46.84758771929825,1012.6096491228072,27.367828354670465,0
4291,4,0,0,44,0.0,0.0,1.0,44,1250,800,450,0.64,17,8,9,347.33888029307457,0.4426752995066949,0.2037879586925042,0.18807081233915726,128252.72715547169,109.43172894295941,128362.15888441465,970,1,205.22727272727272,38,6,21,37.9724361002707,0.5989583333333333,46.7681623931624,1012.9273504273516,26.65598290598294,0
4292,4,0,0,44,0.0,0.0,1.0,44,1050,600,450,0.5714285714285714,15,6,9,346.97832872515755,0.44248810782241016,0.20107476366704335,0.18800277216982547,128279.78326576094,102.06096135583977,128381.84422711677,971,2,206.22727272727272,38,6,21,37.95393025381422,0.5992324561403508,46.741452991452995,1013.0341880341889,26.65879442195234,0
4293,4,1,2,43,0.022222222222222223,0.044444444444444446,0.9555555555555556,45,1200,1000,200,0.8333333333333334,14,10,4,343.7841089316406,0.44269781144781145,0.21149179634453064,0.18793280259340858,128633.75491605539,-155.55183753055996,128478.20307852484,972,0,202.62222222222223,40,5,17,37.673645895946045,0.5994791666666667,46.39227642276423,1014.4308943089442,25.360772357723604,0
4294,4,1,1,43,0.022727272727272728,0.022727272727272728,0.9772727272727273,44,1150,700,450,0.6086956521739131,16,7,9,345.7011005121152,0.44289552501761803,0.22785046218793226,0.19021175089851616,128891.61544054454,111.59466091611267,129003.21010146066,973,0,207.29545454545453,40,4,19,37.3621814117961,0.6020833333333333,46.138211382113816,1015.4471544715439,25.386178861788597,0
4295,4,2,2,43,0.044444444444444446,0.044444444444444446,0.9555555555555556,45,1500,1100,400,0.7333333333333333,19,11,8,330.98046996094024,0.4455176767676768,0.23064916885389364,0.1846859388622115,129445.89548405622,-430.0719281389469,129015.82355591728,974,0,202.73333333333332,38,7,16,37.17257217847769,0.6110197368421053,45.5929487179487,1017.6282051282026,26.77968960863691,0
4296,4,0,0,43,0.0,0.0,1.0,43,1150,900,250,0.782608695652174,14,9,5,349.92634763550507,0.44257567368032485,0.2475485966407982,0.1941908415980928,129230.01284646099,444.19728005027764,129674.21012651127,975,1,212.88372093023256,36,7,23,36.91023369143867,0.6125578703703703,45.80518018018016,1016.7792792792766,28.243868868868795,0
4297,4,3,1,45,0.06521739130434782,0.021739130434782608,0.9782608695652174,46,1350,800,550,0.5925925925925926,19,8,11,348.5253839788607,0.4474033816425121,0.288905806500122,0.19057664613312134,128644.60699445955,-121.37188472447028,128523.23510973508,976,0,199.93478260869566,37,9,19,37.54233318922033,0.6047297297297297,46.3815789473684,1014.4736842105241,27.418207681365516,8
4298,4,0,1,44,0.0,0.022222222222222223,0.9777777777777777,45,1150,600,550,0.5217391304347826,17,6,11,354.81343112176864,0.4449915824915825,0.29861928558208395,0.19352483023934133,128543.91289515859,121.82135682979276,128665.73425198838,977,1,205.3111111111111,36,9,19,37.48565611697205,0.6056134259259259,46.48085585585585,1014.0765765765759,28.168793793793775,0
4299,4,2,1,45,0.043478260869565216,0.021739130434782608,0.9782608695652174,46,900,600,300,0.6666666666666666,12,6,6,346.1036239600764,0.44844001610305956,0.28958286400840993,0.19085142692655632,128978.53185595562,-272.01254232072483,128706.5193136349,978,0,199.65217391304347,37,9,21,37.263421128382255,0.6081081081081081,46.05263157894736,1015.7894736842101,27.453769559032704,0
4300,4,1,4,42,0.021739130434782608,0.08695652173913043,0.9130434782608696,46,1100,700,400,0.6363636363636364,15,7,8,319.18834710232636,0.4500402576489533,0.1830912643299356,0.17248123964247997,128172.28768707669,-983.4664271699112,127188.82125990678,979,0,188.06521739130434,37,9,19,38.76725771521385,0.5999436936936937,46.84758771929824,1012.6096491228062,27.36782835467044,8
4301,4,2,1,43,0.045454545454545456,0.022727272727272728,0.9772727272727273,44,1550,1000,550,0.6451612903225806,21,10,11,314.9764411571191,0.4457144115574348,0.21225541722518515,0.16450320835391477,126795.9347491599,-812.4535439038655,125983.48120525604,980,0,197.29545454545453,38,6,16,40.27969308015982,0.5841557017543859,48.210470085470085,1007.1581196581196,26.504161043634728,8
4302,4,1,1,43,0.022727272727272728,0.022727272727272728,0.9772727272727273,44,1050,700,350,0.6666666666666666,14,7,7,315.27040416237594,0.4444260923185342,0.2158211501209486,0.16531104627369037,126957.38965821086,-794.8184902111299,126162.57116799973,981,0,198.25,38,6,18,40.106982578889706,0.5858004385964912,48.05021367521367,1007.7991452991445,26.52103013945117,0
4303,4,1,1,43,0.022727272727272728,0.022727272727272728,0.9772727272727273,44,1250,800,450,0.64,17,8,9,344.149073087731,0.4436663143058492,0.1579296072417593,0.17658607061123377,126071.36480695962,-80.0588173283046,125991.30598963132,982,0,199.11363636363637,37,7,20,40.29040197255887,0.5785472972972974,48.93092105263157,1004.2763157894719,27.142603129445188,8
4304,4,2,1,44,0.044444444444444446,0.022222222222222223,0.9777777777777777,45,1350,900,450,0.6666666666666666,18,9,9,340.2903447477256,0.4460016835016835,0.17006123677038,0.17655725490299304,126527.0715195591,-388.81184253784807,126138.25967702125,983,0,195.62222222222223,38,7,16,39.91849846023148,0.5814144736842105,48.47756410256408,1006.0897435897404,26.476045883940536,0
4305,4,0,0,44,0.0,0.0,1.0,44,1850,1200,650,0.6486486486486487,25,12,13,340.5041091684706,0.44317080690627203,0.17354582134790286,0.17678432746133668,126553.94500146058,-181.57233910443875,126372.37266235614,984,1,201.0681818181818,38,6,16,39.88550293763712,0.5816885964912281,48.45085470085468,1006.1965811965775,26.478857399909934,0
4306,4,1,0,45,0.022222222222222223,0.0,1.0,45,950,400,550,0.42105263157894735,15,4,11,338.439121939908,0.445496632996633,0.18719207405913085,0.1771534031104669,126887.15071220815,-411.2848255007136,126475.86588670744,985,0,197.57777777777778,40,5,17,39.59531134422703,0.5817708333333333,48.11991869918698,1007.5203252032505,25.188008130081265,0
4307,4,3,3,45,0.0625,0.0625,0.9375,48,1150,700,450,0.6086956521739131,16,7,9,318.1722261665736,0.45054853723404253,0.1884109346533298,0.1692438879395094,127538.80343966975,-1483.4780151762952,126055.32542449345,986,0,186.16666666666666,39,9,15,39.439281049121725,0.5900106837606838,47.473958333333314,1010.1041666666634,25.900106837606756,0
4308,4,2,0,47,0.0425531914893617,0.0,1.0,47,1200,1000,200,0.8333333333333334,14,10,4,330.8610464788205,0.45156876349059516,0.22770736241237066,0.17703072310492976,127775.65646701366,-944.8025173611359,126830.85394965252,987,0,190.95744680851064,39,8,17,38.87672573665773,0.5924145299145299,47.23958333333332,1011.0416666666648,25.924145299145252,0
4309,4,0,0,47,0.0,0.0,1.0,47,1100,700,400,0.6363636363636364,15,7,8,328.3604174080855,0.45129895158803573,0.2242139887754948,0.17603817187272763,127854.65630425325,-1003.5183376736372,126851.13796657961,988,1,191.95744680851064,39,8,17,38.85924142548153,0.593215811965812,47.16145833333332,1011.3541666666648,25.932158119658073,0
4310,4,0,1,46,0.0,0.02127659574468085,0.9787234042553191,47,1400,1000,400,0.7142857142857143,18,10,8,330.60416271287585,0.4514338575393155,0.2260868078266416,0.17749912813613594,127913.11905115981,-942.2780752197972,126970.84097594001,989,2,192.95744680851064,40,7,17,38.7428002143192,0.5921875,47.10365853658536,1011.5853658536569,25.28963414634142,0
4311,4,4,0,50,0.08,0.0,1.0,50,1550,1100,450,0.7096774193548387,20,11,9,312.2420985064403,0.45625,0.24522571819425454,0.1716157699309834,128848.62075617288,-1953.1889752755908,126895.43178089728,990,0,180.94,41,9,15,38.255243958048325,0.6001016260162602,46.18055555555556,1015.277777777778,24.762872628726296,0
4312,4,0,1,49,0.0,0.02,0.98,50,2350,2000,350,0.851063829787234,27,20,7,316.16537050388234,0.45645408163265305,0.2502294249731525,0.17476966487162823,129075.34490937597,-1838.1691507621367,127237.17575861383,991,1,181.94,41,9,17,37.92539213772008,0.6023882113821138,45.95734126984128,1016.1706349206363,24.78464963221064,0
4313,4,1,1,49,0.02,0.02,0.98,50,1350,800,550,0.5925925925925926,19,8,11,302.89845266343167,0.4561394557823129,0.17795558818131774,0.16008667978302998,127278.81087105622,-2247.264815777136,125031.54605527909,992,0,182.8,44,6,18,40.09030708998592,0.5800189393939394,47.73148148148148,1009.0740740740739,22.933501683501678,7
4314,4,1,3,47,0.02,0.06,0.94,50,1250,800,450,0.64,17,8,9,305.2821766393882,0.45579081632653057,0.20581443298969093,0.1627053359012121,127617.7300347221,-2208.1163194444553,125409.61371527765,993,0,183.74,45,5,16,39.68427835051546,0.5821759259259259,47.39583333333333,1010.4166666666656,22.45370370370368,0
4315,4,2,0,49,0.04081632653061224,0.0,1.0,49,1100,500,600,0.45454545454545453,17,5,12,315.07231024183466,0.45452451814058953,0.22333985999667316,0.1686883548791174,127800.84216977781,-1746.698681343212,126054.1434884346,994,0,188.26530612244898,45,4,20,39.25010824449821,0.5840277777777778,47.21467391304348,1011.1413043478254,22.46980676328501,0
4316,4,3,3,49,0.057692307692307696,0.057692307692307696,0.9423076923076923,52,1450,1100,350,0.7586206896551724,18,11,7,302.9239072294403,0.45805052790346906,0.24382402067595588,0.16480415390397,128442.76843264261,-2616.9384057971206,125825.83002684549,995,0,178.34615384615384,45,7,14,38.90393694337713,0.5905092592592592,46.58061594202898,1013.6775362318823,22.52616747181961,0
4317,4,1,0,50,0.02,0.0,1.0,50,1350,1000,350,0.7407407407407407,17,10,7,313.4884997851943,0.45590986394557825,0.2415721095429475,0.16999561374565605,128312.3773692178,-1955.1090629304372,126357.26830628735,996,0,186.22,43,7,22,38.76890753029877,0.591812015503876,46.709280303030305,1013.1628787878792,23.561927413671608,0
4318,4,1,1,50,0.0196078431372549,0.0196078431372549,0.9803921568627451,51,1700,1500,200,0.8823529411764706,19,15,4,306.23889054328424,0.45586601307189545,0.242772807498022,0.16722536425778356,128590.23062414277,-2324.1340877914845,126266.09653635128,997,0,183.54901960784315,44,7,17,38.67004442821494,0.5932765151515151,46.43518518518519,1014.2592592592601,23.05134680134682,0
4319,4,0,0,50,0.0,0.0,1.0,50,1500,1000,500,0.6666666666666666,20,10,10,310.62675195680265,0.455578231292517,0.24083257257622792,0.16962140782327126,128590.2306241429,-2011.2868655692466,126578.94375857366,998,1,187.88,44,6,18,38.55878370153977,0.5932765151515151,46.4351851851852,1014.2592592592612,23.051346801346845,0
4320,4,0,3,47,0.0,0.06,0.94,50,1400,1100,300,0.7857142857142857,17,11,6,299.01000793776814,0.45561224489795915,0.1246253946990723,0.16166340367085402,128193.59117728766,-2141.6284538838304,126051.96272340382,999,2,188.88,42,8,16,39.25641086977323,0.5920138888888888,46.82655038759688,1012.6937984496094,24.11175710594308,7
4321,4,0,1,46,0.0,0.02127659574468085,0.9787234042553191,47,1100,700,400,0.6363636363636364,15,7,8,305.3168665259233,0.4517036694418748,0.13063300584977977,0.16477675601932595,128121.60428645488,-1576.4626489970697,126545.14163745781,1000,3,200.5744680851064,45,2,16,39.17000313143065,0.5872685185185185,46.89764492753623,1012.4094202898536,22.497987117552302,0
4322,4,0,1,45,0.0,0.021739130434782608,0.9782608695652174,46,1400,1100,300,0.7857142857142857,17,11,6,305.3702910198055,0.45109702093397747,0.13020111591087313,0.16559334737054726,128312.37736921762,-1363.4382939218417,126948.93907529577,1001,4,203.84782608695653,43,3,16,38.97453422438233,0.591812015503876,46.7092803030303,1013.1628787878778,23.56192741367158,0
4323,4,2,2,45,0.0425531914893617,0.0425531914893617,0.9574468085106383,47,1100,700,400,0.6363636363636364,15,7,8,294.7648754192914,0.4516265803268578,0.1303849043125822,0.16162670332520515,128754.63070130307,-1809.531464334712,126945.09923696837,1002,0,195.80851063829786,44,3,15,38.79417176048415,0.5949337121212122,46.273148148148145,1014.9074074074068,23.06607744107743,0
4324,4,0,0,45,0.0,0.0,1.0,45,1450,1100,350,0.7586206896551724,18,11,7,303.49078403342935,0.44989478114478115,0.1241058833291846,0.16586700400847407,128624.3830348942,-1192.7370293847762,127431.64600550942,1003,1,204.37777777777777,43,2,15,38.70503485187951,0.5949612403100775,46.40151515151514,1014.3939393939377,23.590556730091574,0
4325,4,1,0,46,0.021739130434782608,0.0,1.0,46,1450,900,550,0.6206896551724138,20,9,11,300.9189534826638,0.450432769726248,0.1353563744209043,0.1660012820122022,128994.27087435657,-1436.6358006458831,127557.6350737107,1004,0,200.91304347826087,45,1,17,38.3949138059147,0.5960648148148149,46.037137681159415,1015.8514492753609,22.574476650563575,0
4326,4,0,2,44,0.0,0.043478260869565216,0.9565217391304348,46,850,500,350,0.5882352941176471,12,5,7,299.9161128627522,0.4499899355877617,0.1462145898799998,0.16602657634104262,129132.33109017235,-1454.2266429059423,127678.1044472664,1005,1,201.91304347826087,45,1,17,38.28043772093989,0.5974537037037038,45.90126811594201,1016.3949275362286,22.586553945249523,0
4327,4,0,0,44,0.0,0.0,1.0,44,1550,1100,450,0.7096774193548387,20,11,9,309.0171445347076,0.4476193622269204,0.14324747945437633,0.17073913289688003,129057.01636392329,-823.8338642102831,128233.182499713,1006,2,211.36363636363637,43,1,17,38.125582479030776,0.5993217054263567,45.97537878787879,1016.0984848484845,23.63019732205778,0
4328,4,1,0,45,0.022222222222222223,0.0,1.0,45,2000,1600,400,0.8,24,16,8,301.7125742980301,0.4476641414141414,0.15033003300330083,0.16857387661843082,129497.10053482327,-1185.6578714122993,128311.44266341097,1007,0,207.64444444444445,42,3,17,37.86533701447066,0.6051587301587302,45.54263565891471,1017.8294573643383,24.23403469915091,0
4329,4,0,0,45,0.0,0.0,1.0,45,1300,800,500,0.6153846153846154,18,8,10,298.69738637669565,0.44755892255892255,0.1486162664044075,0.16720369944911756,129571.08126201824,-1259.4913354065557,128311.58992661169,1008,1,208.64444444444445,42,3,17,37.867215507122225,0.6059027777777778,45.46996124031006,1018.1201550387575,24.24095607235137,0
4330,4,0,0,45,0.0,0.0,1.0,45,1000,700,300,0.7,13,7,6,297.7833282357038,0.4471380471380471,0.14849255057549682,0.16696360332881918,129634.99070965304,-1279.3722021350177,128355.61850751803,1009,2,209.64444444444445,43,2,17,37.825847746574915,0.6051356589147288,45.407196969696955,1018.3712121212095,23.68305144467929,0
4331,4,0,0,45,0.0,0.0,1.0,45,1450,1100,350,0.7586206896551724,18,11,7,299.644128415163,0.4467382154882155,0.1574908861831441,0.16852436892936412,129755.56456790905,-1223.901389606305,128531.66317830274,1010,3,210.64444444444445,43,2,17,37.65655497722837,0.6063468992248062,45.28882575757575,1018.8446969696957,23.69406272022548,0
4332,4,1,0,46,0.021739130434782608,0.0,1.0,46,1450,1200,250,0.8275862068965517,17,12,5,293.9689252323891,0.4483393719806763,0.1663574423066294,0.1663809734074785,130002.78206447176,-1556.6443758573503,128446.13768861441,1011,0,207.04347826086956,44,2,18,37.55144967011681,0.6074810606060606,45.04629629629629,1019.8148148148139,23.177609427609408,0
4333,4,0,0,46,0.0,0.0,1.0,46,1550,1000,550,0.6451612903225806,21,10,11,292.7826541819322,0.4484299516908212,0.16278009919624958,0.16621185298458066,130120.84297839509,-1580.5748456790093,128540.26813271608,1012,1,208.04347826086956,44,2,19,37.46256466104003,0.6086647727272727,44.93055555555556,1020.2777777777779,23.18813131313132,0
4334,4,0,2,44,0.0,0.043478260869565216,0.9565217391304348,46,1400,800,600,0.5714285714285714,20,8,12,295.12324719375573,0.44810789049919486,0.169125740187704,0.16774385287892637,130168.08234739375,-1516.8745713305887,128651.20777606317,1013,2,209.04347826086956,44,2,19,37.35520067749448,0.6091382575757576,44.88425925925926,1020.4629629629635,23.19234006734008,0
4335,4,0,0,44,0.0,0.0,1.0,44,1300,900,400,0.6923076923076923,17,9,8,303.4931073318182,0.44651823467230445,0.17089683621865048,0.1728106158180204,130237.85848957415,-894.7415269514918,129343.11696262266,1014,3,213.27272727272728,42,2,19,37.071229669008254,0.6125992063492063,44.81589147286822,1020.7364341085288,24.303248431155446,0
4336,4,0,1,43,0.0,0.022727272727272728,0.9772727272727273,44,1100,600,500,0.5454545454545454,16,6,10,305.41861138191206,0.44629800916138124,0.162985120755883,0.17458548607311408,130389.20899667733,-835.3394224448401,129553.86957423249,1015,4,214.27272727272728,41,3,20,36.86933381900599,0.615599593495935,44.66765873015873,1021.3293650793648,24.9104723190089,0
4337,4,0,0,43,0.0,0.0,1.0,43,1650,1200,450,0.7272727272727273,21,12,9,304.8435240998485,0.445921004060539,0.15947811596068262,0.17471249052333537,130490.55103812345,-644.1601119614683,129846.39092616198,1016,5,218.90697674418604,41,2,14,36.78178706670549,0.6166158536585367,44.56845238095237,1021.7261904761895,24.920150987224133,0
4338,4,0,0,43,0.0,0.0,1.0,43,1150,800,350,0.6956521739130435,15,8,7,307.5600304257274,0.4457133628645256,0.16447649030161493,0.17696293207912425,130642.6379145406,-563.9092616213368,130078.72865291926,1017,6,219.90697674418604,41,2,16,36.559012615235325,0.618140243902439,44.41964285714285,1022.3214285714267,24.934668989546992,0
4339,4,0,1,42,0.0,0.023255813953488372,0.9767441860465116,43,1750,1500,250,0.8571428571428571,20,15,5,305.00122365512044,0.4449981543004799,0.1611329512622559,0.17618305978195747,130794.8133680553,-621.4843750000264,130173.32899305527,1018,7,220.90697674418604,41,2,16,36.47106245756957,0.6196646341463414,44.27083333333332,1022.9166666666646,24.94918699186987,0
4340,4,1,0,43,0.023255813953488372,0.0,1.0,43,1100,700,400,0.6363636363636364,15,7,8,306.9995245476829,0.44469822812846066,0.17157332263582403,0.17827395012985583,130997.85175933794,-556.7443586230839,130441.10740071486,1019,0,220.46511627906978,41,2,18,36.21545611654878,0.6216971544715447,44.07242063492063,1023.710317460317,24.968544328300414,0
4341,4,0,0,43,0.0,0.0,1.0,43,1200,900,300,0.75,15,9,6,306.0825266751617,0.44382152085640453,0.16961738981538654,0.17809379032362008,131074.03175390523,-576.1058358528583,130497.92591805238,1020,1,221.46511627906978,41,2,18,36.16224245947168,0.6224593495934959,43.99801587301587,1024.0079365079364,24.975803329461865,0
4342,4,0,1,42,0.0,0.023255813953488372,0.9767441860465116,43,1450,1200,250,0.8275862068965517,17,12,5,307.4827405484875,0.4430140273163529,0.1657294831115541,0.17950108884365354,131201.04762101604,-531.5884629314698,130669.45915808457,1021,2,222.46511627906978,41,2,19,35.99857573996963,0.623729674796748,43.87400793650794,1024.5039682539687,24.98790166473094,0
4343,4,0,0,42,0.0,0.0,1.0,42,950,600,350,0.631578947368421,13,6,7,315.279288598118,0.439665602013163,0.16544022721404605,0.1841744622534708,131226.45817586302,-125.4031242126365,131101.0550516504,1022,3,228.52380952380952,41,1,19,35.77330234959978,0.6239837398373984,43.849206349206355,1024.6031746031754,24.990321331784767,0
4344,4,0,0,42,0.0,0.0,1.0,42,550,200,350,0.36363636363636365,9,2,7,316.7817716668512,0.43953252032520324,0.1684093329460743,0.18517481151934972,131251.87119118503,-84.35994189339999,131167.51124929162,1023,4,229.52380952380952,41,1,19,35.70922887017137,0.6242378048780488,43.82440476190477,1024.7023809523826,24.9927409988386,0
4345,4,1,1,42,0.023255813953488372,0.023255813953488372,0.9767441860465116,43,1350,900,450,0.6666666666666666,18,9,9,312.9122447106725,0.4403608342561831,0.173794818179422,0.18447187344079072,131576.54663181308,-365.6174884321739,131210.9291433809,1024,0,225.1627906976744,42,1,16,35.48179542878731,0.6259920634920635,43.5077519379845,1025.9689922480627,24.427833148763398,0
4346,4,1,0,43,0.023255813953488372,0.0,1.0,43,1000,800,200,0.8,12,8,4,312.4317661179238,0.44119139904023624,0.17210048337162132,0.18551620667136567,131850.08154745813,-361.1692318670714,131488.91231559106,1025,0,224.5581395348837,42,1,17,35.21932100512627,0.6287202380952381,43.241279069767444,1027.0348837209306,24.453211517165013,0
4347,4,0,0,43,0.0,0.0,1.0,43,1200,400,800,0.3333333333333333,20,4,16,308.2233688745597,0.4402685492801772,0.170988569473564,0.18361801143515902,131974.50949462163,-464.4744156000368,131510.0350790216,1026,1,225.5581395348837,42,1,17,35.202517917766876,0.6299603174603174,43.120155038759684,1027.5193798449604,24.464747139165723,0
4348,4,0,0,43,0.0,0.0,1.0,43,1400,1000,400,0.7142857142857143,18,10,8,305.0937132735377,0.4396917681801403,0.17097516603467544,0.182471493677127,132123.90049426112,-537.9657172044979,131585.93477705662,1027,2,226.5581395348837,42,1,17,35.13312912346842,0.6314484126984127,42.974806201550386,1028.1007751937982,24.478589885566624,0
4349,4,0,1,42,0.0,0.023255813953488372,0.9767441860465116,43,1300,900,400,0.6923076923076923,17,9,8,307.36311297058506,0.4393918420081211,0.17514048790106118,0.18443524274634024,132248.45754649656,-470.3404805901126,131778.11706590644,1028,3,227.5581395348837,42,1,19,34.94995289684409,0.6326884920634921,42.85368217054263,1028.5852713178292,24.490125507567363,0
4350,4,0,1,41,0.0,0.023809523809523808,0.9761904761904762,42,900,600,300,0.6666666666666666,12,6,6,310.4501657197379,0.4392058652729385,0.16595943035329697,0.18639593331487891,132270.40939350254,-187.32589679392493,132083.08349670863,1029,4,231.95238095238096,41,1,20,34.8485670427878,0.634400406504065,42.83234126984126,1028.6706349206331,25.08952768099105,0
4351,4,0,0,41,0.0,0.0,1.0,41,1400,1100,300,0.7857142857142857,17,11,6,314.1026541181518,0.43871951219512195,0.1632505547617955,0.18870392686279241,132293.43401951558,110.74374958689279,132404.17776910248,1030,5,236.53658536585365,40,1,21,34.73155191148867,0.6361979166666667,42.8099593495935,1028.7601626016267,25.719004065040668,0
4352,4,1,1,41,0.023809523809523808,0.023809523809523808,0.9761904761904762,42,550,400,150,0.7272727272727273,7,4,3,309.7195730612911,0.43958091366627955,0.1740400295122495,0.18736647366149606,132554.935110136,-188.9871067155949,132365.9480034204,1031,0,231.88095238095238,40,2,22,34.582346458765095,0.6388020833333333,42.55589430894308,1029.7764227642263,25.744410569105657,0
4353,4,0,1,40,0.0,0.024390243902439025,0.975609756097561,41,1350,800,550,0.5925925925925926,19,8,11,315.29244966963563,0.4394563008130081,0.1688001243317785,0.1908938426138203,132585.67843967007,160.65266927083053,132746.3311089409,1032,1,237.09756097560975,39,2,22,34.40808216176125,0.6407585470085471,42.526041666666664,1029.8958333333328,26.407585470085458,0
4354,4,0,0,40,0.0,0.0,1.0,40,900,500,400,0.5555555555555556,13,5,8,316.41526300462255,0.4388221153846154,0.16301051354629958,0.1922592003465437,132719.81336805577,398.9149305555763,133118.72829861133,1033,2,240.4,39,1,17,34.24484431864133,0.642094017094017,42.39583333333334,1030.4166666666686,26.42094017094022,0
4355,4,0,0,40,0.0,0.0,1.0,40,950,600,350,0.631578947368421,13,6,7,313.91510813005954,0.4380876068376069,0.15814805457301606,0.19115015353519663,132800.32687717036,337.605794270855,133137.9326714412,1034,3,241.4,39,1,17,34.228671888159,0.6428952991452992,42.31770833333334,1030.7291666666686,26.42895299145304,0
4356,4,0,0,40,0.0,0.0,1.0,40,1400,1100,300,0.7857142857142857,17,11,6,313.6290016727907,0.43745993589743587,0.1615730450596078,0.19138716760525815,132880.86480034742,335.058593750021,133215.92339409745,1035,4,242.4,39,1,17,34.155469118340406,0.6436965811965811,42.23958333333334,1031.0416666666683,26.436965811965855,0
4357,4,0,1,39,0.0,0.025,0.975,40,1050,700,350,0.6666666666666666,14,7,7,314.6270182585139,0.43664529914529915,0.16376829883897015,0.19296474401551605,133068.88156467036,373.41308593752586,133442.2946506079,1036,5,243.4,39,1,17,33.94171714622245,0.6455662393162394,42.05729166666668,1031.770833333335,26.455662393162438,0
4358,4,0,2,37,0.0,0.05128205128205128,0.9487179487179487,39,1100,800,300,0.7272727272727273,14,8,6,317.6497820300143,0.4349134053081421,0.1573976747889796,0.19519700346119206,133141.2310979619,658.4566074950744,133799.68770545698,1037,6,246.94871794871796,38,1,17,33.79140786749485,0.6480263157894737,41.98717948717949,1032.0512820512822,27.159244264507425,0
4359,4,1,0,38,0.02631578947368421,0.0,1.0,38,600,300,300,0.5,9,3,6,324.05244542763205,0.43281768610715976,0.15793668995530608,0.19863253804746514,133047.67001625494,1022.8845654432084,134070.55458169815,1038,0,252.44736842105263,37,1,19,33.719820561873384,0.6489301801801801,42.07785087719298,1031.6885964912276,27.88347558084399,0
4360,4,0,0,38,0.0,0.0,1.0,38,1100,800,300,0.7272727272727273,14,8,6,324.10271931300616,0.43271396396396394,0.15665864981262922,0.19881398883542298,133075.95245652506,1026.055613265617,134102.00806979067,1039,1,253.44736842105263,37,1,20,33.69022316684379,0.6492117117117118,42.050438596491226,1031.7982456140348,27.88643907064959,0
4361,4,0,0,38,0.0,0.0,1.0,38,1050,800,250,0.7619047619047619,13,8,5,325.3534198740974,0.4323287102892366,0.1543244170656386,0.20037540447695365,133223.94035585134,1068.972920775797,134292.91327662714,1040,2,254.44736842105263,38,0,21,33.50990893097381,0.6488486842105263,41.90705128205128,1032.3717948717942,27.167678812415637,0
4362,4,0,0,38,0.0,0.0,1.0,38,1300,1000,300,0.7692307692307693,16,10,6,322.921019211423,0.4312470365101944,0.14819371556736272,0.19961639474015558,133361.8461903717,1013.0686591423607,134374.91484951405,1041,3,255.44736842105263,38,0,22,33.434827954764856,0.6502192982456141,41.773504273504265,1032.9059829059818,27.18173639226268,0
4363,4,0,0,38,0.0,0.0,1.0,38,1300,800,500,0.6153846153846154,18,8,10,323.23100936524463,0.4309506875296349,0.1489813242784379,0.20040322580645126,133472.22222222196,1028.517879319128,134500.74010154107,1042,4,256.44736842105266,37,1,22,33.316532258064505,0.6531531531531531,41.66666666666665,1033.3333333333312,27.927927927927872,0
4364,4,0,0,38,0.0,0.0,1.0,38,1200,800,400,0.6666666666666666,16,8,8,324.47692346739245,0.4307136083451873,0.15058169394636423,0.20179211309040684,133585.5503616494,1069.0856802092546,134654.63604185864,1043,5,257.44736842105266,37,1,22,33.17113915994909,0.6542792792792793,41.55701754385963,1033.7719298245586,27.939781887150232,0
4365,4,0,0,38,0.0,0.0,1.0,38,1300,900,400,0.6923076923076923,17,9,8,323.89263862464475,0.4296171171171171,0.14776742517313735,0.20231796949443914,133748.36205164716,1064.0219793264475,134812.3840309736,1044,6,258.44736842105266,38,0,17,33.02369517317358,0.6540570175438596,41.39957264957264,1034.401709401708,27.221097615834424,0
4366,4,0,0,38,0.0,0.0,1.0,38,1100,800,300,0.7272727272727273,14,8,6,326.3169702518252,0.4292022285443338,0.15321625351837165,0.2044441250879155,133858.89788333682,1136.085999707772,134994.9838830446,1045,7,259.44736842105266,38,0,17,32.85067795443595,0.6551535087719298,41.29273504273503,1034.8290598290585,27.232343679712063,0
4367,4,0,0,38,0.0,0.0,1.0,38,1450,1100,350,0.7586206896551724,18,11,7,367.2975261310784,0.4274241346609768,0.22488089472557937,0.21481618768592345,131271.93583602642,2044.9549369512124,133316.89077297764,1046,8,260.44736842105266,37,1,19,34.394839146872094,0.6311936936936937,43.80482456140351,1024.7807017543855,27.696775723091502,8
4368,4,0,0,38,0.0,0.0,1.0,38,800,500,300,0.625,11,5,6,370.48053407363335,0.4270092460881934,0.22999572100984156,0.21699574138598537,131328.12500000012,2130.9268236380562,133459.05182363818,1047,9,261.44736842105266,35,3,19,34.256436314363135,0.6357142857142857,43.75000000000001,1025.000000000001,29.285714285714313,0
4369,4,0,0,38,0.0,0.0,1.0,38,950,700,250,0.7368421052631579,12,7,5,382.75289040443477,0.4268610715979137,0.18934933081976735,0.21180516663634022,129117.79495854468,2323.104344606002,131440.89930315068,1048,10,262.44736842105266,37,1,18,36.19041518322723,0.6095157657657657,45.91557017543858,1016.3377192982434,27.468587008060634,8
4370,4,0,0,38,0.0,0.0,1.0,38,950,500,450,0.5263157894736842,14,5,9,381.95776044223516,0.42671289710763394,0.18641117192305967,0.21231530166846002,129294.84941188476,2277.142429987095,131571.99184187184,1049,11,263.44736842105266,33,5,20,36.0298178495401,0.6196338383838385,45.741421568627445,1017.0343137254895,30.819221628045135,0
4371,4,0,1,37,0.0,0.02631578947368421,0.9736842105263158,38,1650,1200,450,0.7272727272727273,21,12,9,382.0064032141765,0.4268462541488857,0.17646479324187903,0.21314560931297488,129443.56575963696,2289.654195011308,131733.21995464826,1050,12,264.44736842105266,34,4,17,35.876813289658394,0.6188725490196079,45.59523809523808,1017.6190476190457,29.92997198879546,0
4372,4,0,0,37,0.0,0.0,1.0,37,950,700,250,0.7368421052631579,12,7,5,380.92356886023543,0.4273961461461462,0.17317141764704047,0.2133621011435226,129595.0414540815,2473.1611394557626,132068.20259353725,1051,13,268.5405405405405,34,3,17,35.74988308195953,0.6204044117647058,45.44642857142856,1018.2142857142845,29.947478991596604,0
4373,4,0,0,37,0.0,0.0,1.0,37,1200,1000,200,0.8333333333333334,14,10,4,375.8143545938569,0.4267705205205205,0.1652262281593193,0.21139257274694695,129760.92470689717,2353.203634044913,132114.1283409421,1052,14,269.5405405405405,35,2,17,35.71095554545799,0.6199404761904762,45.28356481481481,1018.8657407407399,29.11044973544971,0
4374,4,0,0,37,0.0,0.0,1.0,37,1500,1300,200,0.8666666666666667,17,13,4,375.7380234255523,0.4260197697697698,0.16335245574746127,0.2124680350692628,129967.3742391118,2366.73686128258,132334.11110039437,1053,15,270.5405405405405,35,2,20,35.50274309496784,0.6220238095238095,45.08101851851852,1019.675925925926,29.133597883597886,0
4375,4,1,1,37,0.02631578947368421,0.02631578947368421,0.9736842105263158,38,1400,900,500,0.6428571428571429,19,9,10,367.34504212088814,0.4285650782361308,0.17202138617746598,0.21078140652177163,130536.16780045355,1991.032607744748,132527.2004081983,1054,0,264.39473684210526,34,4,15,35.13901832867351,0.6299019607843137,44.523809523809526,1021.9047619047622,30.056022408963592,0
4376,4,0,0,37,0.0,0.0,1.0,37,1000,700,300,0.7,13,7,6,374.04839077644556,0.4290853353353354,0.1638209775347157,0.2151939086798007,130638.16350682435,2372.9989667435702,133011.1624735679,1055,1,262.4054054054054,33,4,17,34.864241189163295,0.6332070707070707,44.42401960784314,1022.3039215686279,30.978906714200843,0
4377,4,0,0,37,0.0,0.0,1.0,37,1300,1000,300,0.7692307692307693,16,10,6,372.41833172547854,0.42824074074074076,0.15897603679026906,0.21529140837943148,130824.41332572456,2344.281951946168,133168.69527767072,1056,2,263.4054054054054,35,2,17,34.71699758645398,0.6306547619047619,44.24189814814815,1023.0324074074082,29.229497354497376,0
4378,4,1,1,37,0.02631578947368421,0.02631578947368421,0.9736842105263158,38,1450,900,550,0.6206896551724138,20,9,11,366.53182601982525,0.43040244191559984,0.17039755670085155,0.21419865670869562,131241.56832085465,2020.8423372697025,133262.41065812437,1057,0,257.44736842105266,36,2,18,34.44517712569147,0.6328125,43.83445945945946,1024.6621621621623,28.462837837837842,0
4379,4,0,0,37,0.0,0.0,1.0,37,1500,1100,400,0.7333333333333333,19,11,8,373.64864560406227,0.42977352352352355,0.170925868813113,0.2180068663310187,131179.87403817297,2403.0364529749622,133582.91049114792,1058,1,263.97297297297297,35,2,19,34.325335178699206,0.6342261904761906,43.894675925925924,1024.421296296296,29.26917989417989,0
4380,4,1,0,38,0.02631578947368421,0.0,1.0,38,550,200,350,0.36363636363636365,9,2,7,365.0684149846182,0.43050616405879566,0.16754854398592234,0.2145088217378923,131450.17715419497,1997.829013614188,133448.00616780916,1059,0,258.0,34,4,21,34.2717281944122,0.639093137254902,43.63095238095238,1025.4761904761904,30.161064425770306,0
4381,4,0,0,38,0.0,0.0,1.0,38,1000,800,200,0.8,12,8,4,363.79948362408464,0.43020981507823614,0.16500958825469336,0.21444760259044862,131572.28599773225,1973.1859410430636,133545.47193877533,1060,1,259.0,34,4,17,34.180881101570364,0.6403186274509804,43.51190476190475,1025.9523809523796,30.175070028011163,0
4382,4,0,0,38,0.0,0.0,1.0,38,1150,900,250,0.782608695652174,14,9,5,368.1981573621188,0.4291281412991939,0.16921565276828465,0.21808660089910092,131755.55555555542,2102.4305555555457,133857.98611111095,1061,2,260.0,34,4,18,33.882913961038966,0.642156862745098,43.33333333333333,1026.6666666666656,30.196078431372516,0
4383,4,0,1,37,0.0,0.02631578947368421,0.9736842105263158,38,800,600,200,0.75,10,6,4,368.37686376103545,0.4288910621147463,0.16549111010775275,0.21854324806070755,131816.67375283423,2111.642573696119,133928.31632653036,1062,3,261.0,34,4,19,33.81661063451579,0.6427696078431373,43.27380952380951,1026.90476190476,30.203081232492945,0
4384,4,1,0,38,0.02631578947368421,0.0,1.0,38,1050,700,350,0.6666666666666666,14,7,7,367.88542738340243,0.42957266477003314,0.1727278265107215,0.2207312564300411,132244.89795918346,2130.194160997712,134375.0921201812,1063,0,260.13157894736844,34,4,22,33.39723186728397,0.6470588235294117,42.85714285714285,1028.5714285714268,30.252100840336084,0
4385,4,0,0,38,0.0,0.0,1.0,38,900,700,200,0.7777777777777778,11,7,4,369.80688286247306,0.4291429587482219,0.1806847037761008,0.22242455731248098,132336.75063775497,2187.808248299298,134524.55888605426,1064,1,261.13157894736844,34,4,22,33.2552354506537,0.6479779411764706,42.76785714285713,1028.9285714285702,30.26260504201677,0
4386,4,0,0,38,0.0,0.0,1.0,38,1450,900,550,0.6206896551724138,20,9,11,369.28977691816,0.4288021574205785,0.18144044321329678,0.22247457292386694,132398.0034722221,2178.6458333333253,134576.64930555542,1065,2,262.13157894736844,34,4,22,33.20681511470986,0.6485906862745099,42.70833333333333,1029.1666666666656,30.269607843137223,0
4387,4,0,0,38,0.0,0.0,1.0,38,1150,600,550,0.5217391304347826,17,6,11,369.28977691816,0.4289206970128023,0.18144044321329678,0.22247457292386694,132398.0034722221,2178.6458333333253,134576.64930555542,1066,3,263.13157894736844,34,4,22,33.20681511470986,0.6485906862745099,42.70833333333333,1029.1666666666656,30.269607843137223,0
4388,4,1,1,38,0.02564102564102564,0.02564102564102564,0.9743589743589743,39,1250,900,350,0.72,16,9,7,360.33459529323636,0.4289529914529915,0.1820150057293557,0.21950341352131073,132815.23946544924,1771.5851123113853,134586.82457776062,1067,0,257.35897435897436,35,4,17,33.01753499513436,0.6505952380952381,42.30324074074074,1030.787037037037,29.4510582010582,0
4389,4,0,0,38,0.0,0.0,1.0,38,1200,1000,200,0.8333333333333334,14,10,4,366.9637973172275,0.4276908487434803,0.18974845290634734,0.2234298563412488,132796.49234693887,2146.3010204081734,134942.79336734704,1068,1,264.0,34,4,19,32.86555786555786,0.6525735294117647,42.32142857142858,1030.7142857142865,30.31512605042019,0
4390,4,1,0,39,0.02564102564102564,0.0,1.0,39,1300,1000,300,0.7692307692307693,16,10,6,351.1406431023364,0.4273785425101215,0.12014652014652039,0.20521634207575554,131243.84576263835,1418.7245334710333,132662.5702961094,1069,0,258.20512820512823,37,2,20,34.83714553237025,0.6309121621621622,43.83223684210525,1024.6710526315776,27.693812233285882,7
4391,4,1,1,39,0.025,0.025,0.975,40,1300,900,400,0.6923076923076923,17,9,8,346.5280402455397,0.429286858974359,0.12402978339350224,0.2042303556340732,131565.50068587094,1118.3081780979976,132683.80886396894,1070,0,252.725,35,5,18,34.630716004813486,0.638095238095238,43.51851851851851,1025.925925925925,29.312169312169285,0
4392,4,0,1,38,0.0,0.02564102564102564,0.9743589743589743,39,1050,800,250,0.7619047619047619,13,8,5,353.5418692645911,0.4285874943769681,0.1348869741208687,0.20790192516822192,131480.69905045338,1496.786422902478,132977.48547335586,1071,1,259.38461538461536,34,5,21,34.53641903656413,0.6393995098039216,43.60119047619047,1025.595238095237,30.1645658263305,0
4393,4,0,0,38,0.0,0.0,1.0,38,1000,700,300,0.7,13,7,6,360.85480346028083,0.427868658131816,0.14356840469765286,0.2118787467054153,131422.3514543684,1884.8773608708025,133307.2288152392,1072,2,267.10526315789474,33,5,21,34.40786721644555,0.6410984848484849,43.65808823529411,1025.3676470588227,31.071746880570387,0
4394,4,0,0,38,0.0,0.0,1.0,38,900,800,100,0.8888888888888888,10,8,2,358.8517851521848,0.427305595068753,0.1325195604771472,0.21136198446044951,131541.75347222216,1840.7986111111072,133382.55208333326,1073,3,268.10526315789474,34,4,22,34.33861359328459,0.6400122549019608,43.541666666666664,1025.833333333333,30.17156862745097,0
4395,4,0,1,37,0.0,0.02631578947368421,0.9736842105263158,38,850,800,50,0.9411764705882353,9,8,1,358.8411461840631,0.42703888098624937,0.12778072923345674,0.21169417104451993,131602.82206632633,1844.9015022675535,133447.72356859388,1074,4,269.10526315789474,34,4,18,34.27722666976063,0.640625,43.48214285714285,1026.0714285714268,30.178571428571377,0
4396,4,0,0,37,0.0,0.0,1.0,37,800,600,200,0.75,10,6,4,363.9589671100434,0.4260197697697698,0.132716876475089,0.214405384495297,131548.03929077747,2175.6177011245454,133723.656991902,1075,5,275.02702702702703,33,4,22,34.20128519093696,0.6423611111111112,43.53553921568626,1025.857843137254,31.08660130718951,0
4397,4,0,1,36,0.0,0.02702702702702703,0.972972972972973,37,1050,800,250,0.7619047619047619,13,8,5,363.40680367916,0.42558183183183185,0.12888076569784057,0.21473132656052343,131663.90483276636,2169.5117630385416,133833.4165958049,1076,6,276.02702702702703,34,3,19,34.09842245679155,0.6412377450980392,43.422619047619044,1026.3095238095232,30.18557422969186,0
4398,4,0,0,36,0.0,0.0,1.0,36,750,500,250,0.6666666666666666,10,5,5,367.33223360328793,0.42528108465608466,0.13466947960618847,0.21692807645937448,131642.34459102253,2471.2952950787903,134113.63988610133,1077,7,282.6388888888889,33,3,19,34.01948491362153,0.6433080808080809,43.44362745098038,1026.225490196077,31.09774212715385,0
4399,4,0,1,35,0.0,0.027777777777777776,0.9722222222222222,36,1300,900,400,0.6923076923076923,17,9,8,364.8049778828673,0.4247850529100529,0.13400721638544,0.21579141912054325,131705.23356401364,2409.3449634755584,134114.5785274892,1078,8,283.6388888888889,33,3,19,34.020813435211714,0.6439393939393939,43.38235294117646,1026.4705882352926,31.105169340463412,0
4400,4,0,0,35,0.0,0.0,1.0,35,900,500,400,0.5555555555555556,13,5,8,373.0057213278516,0.4248249299719888,0.13428255022939384,0.22014651396016333,131619.47959710742,2818.963785583095,134438.44338269052,1079,9,292.2,32,3,19,33.897040728436075,0.6455078125,43.465909090909086,1026.1363636363633,32.06676136363635,0
4401,4,0,0,35,0.0,0.0,1.0,35,900,700,200,0.7777777777777778,11,7,4,371.7923230892824,0.4247549019607843,0.12934106483921992,0.2199906540550121,131716.66953627177,2794.2493112947586,134510.91884756653,1080,10,293.2,32,3,19,33.82995079950799,0.646484375,43.37121212121212,1026.5151515151513,32.07859848484848,0
4402,4,0,1,34,0.0,0.02857142857142857,0.9714285714285714,35,1100,700,400,0.6363636363636364,15,7,8,373.76170634719585,0.4237394957983193,0.12887164451623145,0.22247981013512289,131943.58555568295,2863.0919357718476,134806.6774914548,1081,11,294.2,32,3,20,33.550192536151734,0.6487630208333333,43.15025252525252,1027.398989898989,32.106218434343404,0
4403,4,0,0,34,0.0,0.0,1.0,34,1150,1100,50,0.9565217391304348,12,11,1,375.457796364881,0.4228312537136067,0.140755786217166,0.22368049391049777,131976.01807213546,3110.2849836751284,135086.3030558106,1082,12,301.29411764705884,32,2,20,33.473877693126894,0.6490885416666667,43.118686868686865,1027.525252525252,32.110164141414124,0
4404,4,0,0,34,0.0,0.0,1.0,34,800,500,300,0.625,11,5,6,375.22141727546403,0.4222556446821153,0.14400962448608,0.22411427425088432,132073.33953486886,3111.3491289154117,135184.68866378427,1083,13,302.29411764705884,32,2,20,33.38169962740039,0.6500651041666667,43.023989898989896,1027.9040404040402,32.122001262626256,0
4405,4,1,0,35,0.02857142857142857,0.0,1.0,35,1050,800,250,0.7619047619047619,13,8,5,365.6688923644599,0.4244747899159664,0.13901471964604784,0.2197416142734175,132303.42784325735,2675.8495830930356,134979.2774263504,1084,0,294.62857142857143,33,2,21,33.39525014889815,0.6499368686868687,42.80024509803921,1028.7990196078429,31.175727866904328,0
4406,4,0,0,35,0.0,0.0,1.0,35,550,400,150,0.7272727272727273,7,4,3,367.3282318158934,0.4235644257703081,0.14173089028394537,0.22110789695756675,132366.47450800167,2724.3886065455513,135090.86311454722,1085,1,295.62857142857143,33,2,21,33.2890466833393,0.6505681818181819,42.73897058823529,1029.0441176470583,31.18315508021389,0
4407,4,1,0,36,0.027777777777777776,0.0,1.0,36,1200,900,300,0.75,15,9,6,356.5857716949376,0.4244212962962963,0.13781847975473083,0.216631009278254,132713.4996155325,2264.752889513642,134978.25250504614,1086,0,288.3888888888889,33,3,21,33.21638122423089,0.654040404040404,42.40196078431372,1030.392156862745,31.224004753416516,0
4408,4,0,0,36,0.0,0.0,1.0,36,1450,1100,350,0.7586206896551724,18,11,7,386.89713358110134,0.4230489417989418,0.08805374001452448,0.21924170902929058,130049.9999999999,2863.19444444443,132913.19444444432,1087,1,289.3888888888889,34,2,16,35.134123093681914,0.625,44.99999999999999,1019.9999999999992,29.999999999999975,8
4409,4,0,1,35,0.0,0.027777777777777776,0.9722222222222222,36,1450,1100,350,0.7586206896551724,18,11,7,382.3406913785923,0.4223048941798942,0.07721088435374157,0.21784527764594222,130262.58680555562,2761.111111111121,133023.69791666674,1088,2,290.3888888888889,33,3,19,35.03401360544218,0.6294191919191919,44.79166666666667,1020.8333333333339,30.934343434343454,0
4410,4,0,0,35,0.0,0.0,1.0,35,1050,800,250,0.7619047619047619,13,8,5,393.2588634582395,0.42265406162464986,0.07585597682060707,0.2242518455517155,130294.81207274768,3247.9179420467303,133542.73001479442,1089,3,295.37142857142857,32,3,20,34.72256575150465,0.6321614583333333,44.76010101010101,1020.959595959596,31.904987373737374,0
4411,4,0,0,35,0.0,0.0,1.0,35,1050,800,250,0.7619047619047619,13,8,5,397.5671278077687,0.4209733893557423,0.07478285431819831,0.2278408780609394,130488.24737271709,3375.5675441281537,133863.81491684524,1090,4,296.37142857142857,32,3,16,34.41567803592026,0.6341145833333333,44.57070707070707,1021.7171717171718,31.92866161616162,0
4412,4,0,0,35,0.0,0.0,1.0,35,800,500,300,0.625,11,5,6,400.8890595463139,0.42023809523809524,0.07430124223602519,0.23051120923913052,130617.28395061735,3472.6080246913684,134089.8919753087,1091,5,297.37142857142857,32,3,16,34.19950181159422,0.6354166666666667,44.44444444444445,1022.2222222222227,31.94444444444446,0
4413,4,0,0,35,0.0,0.0,1.0,35,1100,600,500,0.5454545454545454,16,6,10,396.9205370808981,0.41894257703081234,0.07785859761419833,0.22927998083143641,130794.8133680556,3383.029513888893,134177.8428819445,1092,6,298.37142857142857,33,2,16,34.120417515274944,0.6347853535353536,44.270833333333336,1022.9166666666671,30.99747474747476,0
4414,4,0,0,35,0.0,0.0,1.0,35,650,400,250,0.6153846153846154,9,4,5,396.2323021006529,0.4186624649859944,0.07595092654381186,0.22925457312809103,130857.49959450706,3369.9936622933665,134227.49325680043,1093,7,299.37142857142857,33,2,17,34.07431528725995,0.6354166666666667,44.20955882352942,1023.1617647058835,31.00490196078435,0
4415,4,1,2,34,0.027777777777777776,0.05555555555555555,0.9444444444444444,36,1450,900,550,0.6206896551724138,20,9,11,383.6286264832563,0.4215773809523809,0.0711626076070262,0.22451793646460616,131297.62081916112,2873.9051870748453,134171.52600623597,1094,0,292.02777777777777,34,2,19,33.95042010299299,0.6375612745098039,43.77976190476191,1024.8809523809534,30.14355742296922,0
4416,4,0,1,33,0.0,0.029411764705882353,0.9705882352941176,34,750,600,150,0.8,9,6,3,401.8454661440543,0.416388146167558,0.08703807167371713,0.23319693586469945,130972.46334876555,3726.138117283965,134698.60146604953,1095,1,309.20588235294116,32,2,19,33.81388511985526,0.6389973958333333,44.09722222222223,1023.6111111111121,31.987847222222253,0
4417,4,0,0,33,0.0,0.0,1.0,33,750,500,250,0.6666666666666666,10,5,5,405.73393158906816,0.4145754419191919,0.08349140257537235,0.23518205769100867,130928.03955078135,4024.3896484375155,134952.42919921887,1096,2,313.3030303030303,31,2,19,33.759541984732834,0.6411290322580645,44.14062500000001,1023.4375000000008,33.01411290322583,0
4418,4,0,0,33,0.0,0.0,1.0,33,850,700,150,0.8235294117647058,10,7,3,404.3128603360912,0.4144570707070707,0.07950787447098828,0.23476423249352663,130994.67807345925,3992.566596137158,134987.2446695964,1097,3,314.3030303030303,31,2,20,33.72816501314338,0.6418010752688172,44.075520833333336,1023.6979166666671,33.02251344086023,0
4419,4,0,1,32,0.0,0.030303030303030304,0.9696969696969697,33,750,600,150,0.8,9,6,3,403.0970820776056,0.4137468434343434,0.07957772255292905,0.2346675463020258,131094.66764662004,3968.7756008572096,135063.44324747726,1098,4,315.3030303030303,31,2,20,33.65768700995973,0.6428091397849462,43.977864583333336,1024.088541666667,33.03511424731184,0
4420,4,0,0,32,0.0,0.0,1.0,32,800,500,300,0.625,11,5,6,419.33697337330705,0.41248739919354843,0.029812458691341748,0.23274278822957212,129235.55333347792,4438.856846490402,133674.4101799683,1099,5,304.5625,30,2,17,35.14017404714694,0.6267361111111112,45.7997311827957,1016.8010752688177,33.89336917562726,7
4421,4,0,0,32,0.0,0.0,1.0,32,850,600,250,0.7058823529411765,11,6,5,424.002833963588,0.4116473454301075,0.021094782034345894,0.23635504072933403,129406.44330269378,4573.739738698088,133980.18304139187,1100,6,305.5625,30,2,18,34.84643328929985,0.6284722222222222,45.631720430107514,1017.4731182795684,33.91577060931895,0
4422,4,1,0,33,0.030303030303030304,0.0,1.0,33,900,600,300,0.6666666666666666,12,6,6,413.4527357317923,0.4149305555555556,0.02234281973512431,0.23219244448168047,129698.28499688026,4124.822150336349,133823.10714721662,1101,0,297.27272727272725,31,2,17,34.816273594955035,0.6286962365591398,45.34505208333332,1018.6197916666653,32.858702956989205,0
4423,4,0,0,33,0.0,0.0,1.0,33,550,200,350,0.36363636363636365,9,2,7,410.13708417968985,0.41453598484848486,0.02227514764256,0.23072053800906323,129764.60986667195,4044.2557440863557,133808.8656107583,1102,1,298.27272727272725,31,2,17,34.83293397231096,0.6293682795698925,45.27994791666666,1018.8802083333321,32.86710349462361,0
4424,4,0,0,33,0.0,0.0,1.0,33,950,700,250,0.7368421052631579,12,7,5,407.09437891676686,0.4151278409090909,0.025146714978089513,0.22959184424787096,129864.12896050332,3973.391384548592,133837.52034505192,1103,2,299.27272727272725,31,2,17,34.80880599557145,0.6303763440860215,45.18229166666666,1019.2708333333321,32.87970430107523,0
4425,4,0,0,33,0.0,0.0,1.0,33,1050,900,150,0.8571428571428571,12,9,3,406.29707891427086,0.414654356060606,0.02430124253646171,0.2297265288792529,129963.68620130736,3960.7732137044077,133924.45941501175,1104,3,300.27272727272725,31,2,17,34.7274986166092,0.6313844086021505,45.08463541666666,1019.6614583333321,32.892305107526845,0
4426,4,1,0,34,0.029411764705882353,0.0,1.0,34,650,300,350,0.46153846153846156,10,3,7,406.68866637858025,0.419674688057041,0.08291478675406427,0.22481749477407942,129076.82742214546,3698.8165609381103,132775.64398308357,1105,0,292.4117647058824,33,1,19,35.6241960122206,0.6174242424242424,45.95588235294118,1016.1764705882364,30.793226381461707,8
4427,4,1,1,34,0.02857142857142857,0.02857142857142857,0.9714285714285714,35,800,400,400,0.5,12,4,8,395.0322569092403,0.4219187675070028,0.0814351302004861,0.22031591407830925,129426.12879106733,3225.6192979699294,132651.74808903725,1106,0,285.0285714285714,32,3,17,35.56324192414278,0.6233723958333333,45.612373737373744,1017.5505050505058,31.798453282828305,0
4428,4,0,0,34,0.0,0.0,1.0,34,1400,1200,200,0.8571428571428571,16,12,4,402.92781302953983,0.4193218954248366,0.08782873190233453,0.2243816823378329,129366.9149610732,3625.105624728743,132992.02058580195,1107,2,294.4117647058824,31,3,20,35.42293293229233,0.6253360215053764,45.67057291666667,1017.3177083333339,32.81670026881722,0
4429,4,1,0,35,0.02857142857142857,0.0,1.0,35,600,200,400,0.3333333333333333,10,2,8,392.8207142507286,0.4230392156862745,0.09272878565231979,0.22088295075185585,129747.52456700859,3193.503054535263,132941.02762154385,1108,0,286.9714285714286,32,3,18,35.29144462345602,0.6266276041666667,45.29671717171718,1018.8131313131322,31.83791035353538,0
4430,4,0,0,35,0.0,0.0,1.0,35,1250,800,450,0.64,17,8,9,388.5261432583459,0.4221638655462185,0.09299955771782376,0.21954853791540557,129940.55333958284,3097.0604083767103,133037.61374795955,1109,1,287.9714285714286,32,3,20,35.20407636738905,0.6285807291666667,45.10732323232324,1019.5707070707082,31.86158459595963,0
4431,4,1,0,36,0.027777777777777776,0.0,1.0,36,1050,800,250,0.7619047619047619,13,8,5,378.2520280586955,0.4229497354497354,0.10554222488835596,0.21638508262657696,130419.01139285372,2666.2511113514074,133085.26250420514,1110,0,280.94444444444446,33,3,21,34.979379124175175,0.6309974747474747,44.638480392156865,1021.4460784313726,30.95291146761735,0
4432,4,0,0,36,0.0,0.0,1.0,36,550,300,250,0.5454545454545454,8,3,5,379.80855893719837,0.42255291005291,0.11210733943731466,0.21762638871886067,130481.60750973182,2711.6062632160724,133193.2137729479,1111,1,281.94444444444446,33,3,21,34.876029546999334,0.6316287878787878,44.57720588235294,1021.6911764705881,30.96033868092691,0
4433,4,1,0,37,0.02702702702702703,0.0,1.0,37,1400,1100,300,0.7857142857142857,17,11,6,373.5185519209751,0.4263013013013013,0.11352231710537874,0.21635885932026305,130901.38888888899,2378.819444444454,133280.20833333346,1112,0,275.2972972972973,34,3,19,34.610817046688375,0.633578431372549,44.16666666666667,1023.3333333333342,30.0980392156863,0
4434,4,0,0,37,0.0,0.0,1.0,37,1000,600,400,0.6,14,6,8,372.76876696105336,0.42567567567567566,0.11732136740856669,0.2167805385146735,131053.71492346942,2370.546343537421,133424.26126700683,1113,1,276.2972972972973,34,3,19,34.47564236716661,0.6351102941176471,44.017857142857146,1023.9285714285717,30.115546218487403,0
4435,4,0,0,37,0.0,0.0,1.0,37,950,500,450,0.5263157894736842,14,5,9,370.0839688541292,0.42551926926926925,0.11598091174982961,0.2155607572140878,131114.67013888902,2304.687500000019,133419.35763888905,1114,2,277.2972972972973,34,3,19,34.48264171413073,0.6357230392156863,43.95833333333334,1024.1666666666679,30.122549019607877,0
4436,4,0,0,37,0.0,0.0,1.0,37,1300,900,400,0.6923076923076923,17,9,8,373.7115897143516,0.4247372372372373,0.11833624773571327,0.21871400923527232,131297.62081916112,2413.4885204081793,133711.1093395693,1115,3,278.2972972972973,34,3,20,34.2045146552058,0.6375612745098039,43.77976190476191,1024.8809523809534,30.14355742296922,0
4437,4,0,1,36,0.0,0.02702702702702703,0.972972972972973,37,1150,1000,150,0.8695652173913043,13,10,3,382.38883986046056,0.4247997997997998,0.18718824421041913,0.20931920887159308,128687.51594387746,2481.544075963707,131169.06001984116,1116,4,279.2972972972973,34,3,17,36.63958308889671,0.6112132352941176,46.33928571428571,1014.6428571428564,29.842436974789894,8
4438,4,0,0,36,0.0,0.0,1.0,36,800,500,300,0.625,11,5,6,384.4255408527622,0.4238921957671958,0.17218196457326895,0.21051874856222672,128703.50346020746,2695.382785467107,131398.88624567457,1117,5,260.9166666666667,33,3,17,36.571557971014485,0.6136363636363636,46.323529411764696,1014.70588235294,30.74866310160424,0
4439,4,0,0,36,0.0,0.0,1.0,36,1000,500,500,0.5,15,5,10,383.17395996356436,0.4233465608465608,0.16867498155971328,0.2106566860184557,128858.98940611765,2675.081849529002,131534.07125564665,1118,6,261.9166666666667,33,3,18,36.44425165962582,0.6152146464646464,46.17034313725489,1015.3186274509789,30.76723113487815,0
4440,4,0,0,36,0.0,0.0,1.0,36,1750,1500,250,0.8571428571428571,20,15,5,379.1381874152147,0.4227513227513227,0.1679402616902621,0.208929341575618,128952.32602845038,2578.1502306804787,131530.47625913087,1119,7,262.9166666666667,33,3,18,36.451295045045036,0.6161616161616161,46.078431372549005,1015.6862745098022,30.77837195484249,0
4441,4,2,3,35,0.05263157894736842,0.07894736842105263,0.9210526315789473,38,950,500,450,0.5263157894736842,14,5,9,358.8261854799594,0.4256608582266477,0.15743683671820308,0.20032753326509706,129466.28146701363,1691.1783854166333,131157.45985243027,1120,0,250.02631578947367,35,3,15,36.4434066871375,0.6169642857142856,45.57291666666665,1017.7083333333312,29.077380952380892,0
4442,4,2,0,37,0.05405405405405406,0.0,1.0,37,600,400,200,0.6666666666666666,8,4,4,368.25899229849415,0.42501876876876876,0.17902717879320607,0.20547505653835016,129443.56575963704,2133.751417233544,131577.3171768706,1121,0,257.5135135135135,34,3,17,36.22655396973951,0.6188725490196079,45.59523809523809,1017.6190476190463,29.92997198879548,0
4443,4,0,0,37,0.0,0.0,1.0,37,1350,800,550,0.5925925925925926,19,8,11,367.7684976469853,0.42389264264264265,0.1867092106718058,0.20631209818819396,129655.65653344667,2136.6532029478412,131792.30973639453,1122,1,258.5135135135135,34,3,17,36.02303721020845,0.6210171568627452,45.38690476190476,1018.4523809523806,29.954481792717075,0
4444,4,0,0,37,0.0,0.0,1.0,37,1000,800,200,0.8,12,8,4,370.5652058911927,0.423267017017017,0.19028189208137802,0.20836379973829358,129746.60572562362,2215.915532879826,131962.52125850346,1123,2,259.5135135135135,34,3,18,35.85923502375946,0.6219362745098039,45.29761904761905,1018.8095238095241,29.964985994397768,0
4445,4,1,0,38,0.02631578947368421,0.0,1.0,38,1400,1000,400,0.7142857142857143,18,10,8,358.8450445880241,0.4266388098624941,0.18186922139665973,0.2032225278219581,130026.38996056237,1731.8651406035615,131758.25510116594,1124,0,253.6578947368421,35,3,19,35.87343017097896,0.6226190476190476,45.023148148148145,1019.9074074074072,29.140211640211632,0
4446,4,0,1,37,0.0,0.02631578947368421,0.9736842105263158,38,1100,800,300,0.7272727272727273,14,8,6,356.145756553135,0.42589793741109533,0.17791145475714276,0.20215227585421006,130114.93866008648,1667.9766535922413,131782.91531367874,1125,1,254.6578947368421,35,3,19,35.85235866893553,0.6235119047619048,44.93634259259259,1020.2546296296288,29.15013227513225,0
4447,4,0,0,37,0.0,0.0,1.0,37,750,500,250,0.6666666666666666,10,5,5,363.0137925627337,0.42282907907907913,0.18437295972597623,0.20586798070615933,130080.35891439911,2044.1928854875296,132124.55179988663,1126,2,262.0810810810811,34,3,19,35.71230598669622,0.6253063725490196,44.970238095238095,1020.1190476190478,30.00350140056023,0
4448,4,0,0,37,0.0,0.0,1.0,37,1100,700,400,0.6363636363636364,15,7,8,361.9287435136384,0.42267267267267267,0.17354793561931459,0.20605425278127043,130232.20663265292,2026.9557823129066,132259.16241496583,1127,3,263.0810810810811,34,3,19,35.58578259855378,0.6268382352941176,44.82142857142856,1020.7142857142845,30.02100840336131,0
4449,4,0,1,36,0.0,0.02702702702702703,0.972972972972973,37,650,400,250,0.6153846153846154,9,4,5,361.0879439662744,0.42226601601601604,0.08993079719126729,0.2033282392626525,129803.15778193777,1974.0710727619974,131777.22885469976,1128,4,264.0810810810811,36,1,16,36.043117103178986,0.6183449074074074,45.24211711711714,1019.031531531535,28.30643143143153,8
4450,4,0,1,35,0.0,0.027777777777777776,0.9722222222222222,36,1050,800,250,0.7619047619047619,13,8,5,368.1212536765827,0.41810515873015874,0.10474017695987481,0.20706526492747368,129760.92470689755,2353.5508562671794,132114.47556316474,1129,8,272.30555555555554,35,1,17,35.90691146957476,0.6199404761904762,45.28356481481483,1018.8657407407429,29.110449735449798,0
4451,4,1,0,36,0.027777777777777776,0.0,1.0,36,950,600,350,0.631578947368421,13,6,7,369.8891520465667,0.41790674603174605,0.11020284589766938,0.2088451058478307,129908.37191358028,2410.339506172847,132318.71141975312,1130,0,273.05555555555554,35,1,18,35.71185286103542,0.6214285714285714,45.13888888888889,1019.4444444444447,29.126984126984134,0
4452,4,0,0,36,0.0,0.0,1.0,36,1300,1100,200,0.8461538461538461,15,11,4,369.48866036563686,0.4179398148148148,0.12006365412491404,0.20972585583535644,130114.93866008648,2415.198875814463,132530.13753590095,1131,1,274.05555555555554,35,1,18,35.51202968425034,0.6235119047619048,44.93634259259259,1020.2546296296288,29.15013227513225,0
4453,4,0,0,36,0.0,0.0,1.0,36,850,400,450,0.47058823529411764,13,4,9,366.5275165551458,0.41750992063492065,0.11639326706227737,0.20867696375079592,130233.05047850216,2346.7993130572613,132579.84979155942,1132,2,275.05555555555554,35,1,18,35.467574743924104,0.624702380952381,44.82060185185185,1020.717592592592,29.163359788359774,0
4454,4,1,1,36,0.02702702702702703,0.02702702702702703,0.972972972972973,37,850,500,350,0.5882352941176471,12,5,7,355.8084239130434,0.4196071071071071,0.11141304347826053,0.20458984374999994,130617.28395061729,1894.949336634085,132512.23328725138,1133,0,268.5945945945946,35,2,15,35.351562499999986,0.6285714285714286,44.44444444444444,1022.2222222222223,29.20634920634921,0
4455,4,0,0,36,0.0,0.0,1.0,36,1200,1000,200,0.8333333333333334,14,10,4,362.83702075393666,0.4165674603174603,0.1250157220838677,0.20895060243417693,130676.44702717758,2282.850544410141,132959.29757158773,1134,4,277.05555555555554,35,1,15,35.111972681307066,0.6291666666666667,44.38657407407407,1022.4537037037032,29.21296296296295,0
4456,4,0,0,36,0.0,0.0,1.0,36,1000,800,200,0.8,12,8,4,363.48779041069207,0.41623677248677243,0.11999321113374095,0.20996765304899956,130794.81336805537,2308.463541666644,133103.27690972202,1135,5,278.05555555555554,35,1,15,34.97539035980989,0.6303571428571428,44.27083333333332,1022.9166666666652,29.226190476190432,0
4457,4,0,0,36,0.0,0.0,1.0,36,1250,800,450,0.64,17,8,9,364.09362806016946,0.415162037037037,0.11330632497958626,0.2114516178721075,131002.08340031285,2339.4047657321557,133341.48816604502,1136,6,279.05555555555554,35,1,15,34.74997644620312,0.6324404761904762,44.06828703703703,1023.7268518518513,29.24933862433861,0
4458,4,1,1,36,0.02702702702702703,0.02702702702702703,0.972972972972973,37,1300,800,500,0.6153846153846154,18,8,10,350.58399398737,0.4175425425425425,0.11220884465409209,0.20566046481722663,131387.44882758908,1812.8725405092523,133200.32136809832,1137,0,272.4864864864865,35,2,16,34.706385941145484,0.6363095238095238,43.692129629629626,1025.2314814814808,29.292328042328023,0
4459,4,1,2,35,0.02702702702702703,0.05405405405405406,0.9459459459459459,37,1400,1200,200,0.8571428571428571,16,12,4,359.99980383449474,0.4173235735735736,0.060811579410146255,0.20068219882745994,129407.39300679442,1917.3272194358738,131324.7202262303,1138,0,273.27027027027026,35,2,17,36.473500360216896,0.6163690476190475,45.63078703703704,1017.476851851852,29.0707671957672,7
4460,4,1,0,36,0.027777777777777776,0.0,1.0,36,1000,700,300,0.7,13,7,6,363.853791288444,0.41593915343915344,0.07767766596458392,0.20270498698507444,129383.0002834467,2215.2990362811797,131598.29931972787,1139,0,281.3333333333333,34,2,18,36.40031398705048,0.6182598039215687,45.654761904761905,1017.3809523809523,29.92296918767507,0
4461,4,0,2,34,0.0,0.05555555555555555,0.9444444444444444,36,1350,1100,250,0.8148148148148148,16,11,5,366.7113974043764,0.4162698412698413,0.07961952402607264,0.20519042312779232,129554.6392746914,2301.832561728401,131856.4718364198,1140,1,282.3333333333333,35,1,16,36.152796725784434,0.6178571428571429,45.486111111111114,1018.055555555556,29.0873015873016,0
4462,4,0,0,34,0.0,0.0,1.0,34,850,600,250,0.7058823529411765,11,6,5,382.63814858441566,0.412191770647653,0.07774375115194276,0.2125255259005008,129263.69214965402,3092.243968665899,132355.93611831992,1141,3,290.61764705882354,33,1,17,36.04432795051017,0.6193181818181819,45.77205882352941,1016.9117647058827,30.815508021390382,0
4463,4,1,0,35,0.02857142857142857,0.0,1.0,35,850,600,250,0.7058823529411765,11,6,5,371.8809775168372,0.4134103641456583,0.07880944029663772,0.20829718406689632,129595.04145408161,2638.7861394557776,132233.8275935374,1142,0,283.2857142857143,34,1,17,35.98006547410265,0.6204044117647058,45.44642857142857,1018.2142857142854,29.94747899159663,0
4464,4,1,0,36,0.027777777777777776,0.0,1.0,36,900,700,200,0.7777777777777778,11,7,4,363.6066096199761,0.41506283068783073,0.07609161904040995,0.20514307565170586,129878.87577428416,2244.963536308302,132123.83931059245,1143,0,276.3888888888889,35,1,18,35.90195772302335,0.6211309523809524,45.167824074074076,1019.3287037037039,29.123677248677254,0
4465,4,1,0,37,0.02702702702702703,0.0,1.0,37,1100,800,300,0.7272727272727273,14,8,6,357.7991339802707,0.4164476976976977,0.07353116576417551,0.2037117682410288,130233.84871357858,1919.5116569272122,132153.3603705058,1144,0,269.8918918918919,36,1,20,35.68949507208003,0.6226851851851851,44.81981981981983,1020.7207207207218,28.353353353353384,0
4466,4,0,0,37,0.0,0.0,1.0,37,1300,1100,200,0.8461538461538461,15,11,4,358.22252601597955,0.4163538538538538,0.07466617935258624,0.20458274488449207,130353.7485827664,1939.1361593943566,132292.88474216076,1145,1,270.8918918918919,34,3,20,35.55704515427062,0.6280637254901961,44.70238095238095,1021.1904761904759,30.035014005602232,0
4467,4,0,0,37,0.0,0.0,1.0,37,1300,1000,300,0.7692307692307693,16,10,6,370.18431176642696,0.4163538538538538,0.1099678586589583,0.20037911936506603,128240.42986685042,2101.775290005824,130342.20515685625,1146,2,271.8918918918919,32,5,20,37.40650710545999,0.611328125,46.78030303030304,1012.8787878787887,31.652462121212146,8
4468,4,2,1,38,0.05128205128205128,0.02564102564102564,0.9743589743589743,39,1150,800,350,0.6956521739130435,15,8,7,354.3423517519548,0.4213337831758885,0.11471744383136806,0.19530031945398452,128959.4387755103,1339.1581632653158,130298.5969387756,1147,0,258.8974358974359,34,5,15,37.07366385372715,0.6139705882352942,46.07142857142858,1015.7142857142865,29.873949579831955,0
4469,4,0,1,37,0.0,0.02631578947368421,0.9736842105263158,38,950,600,350,0.631578947368421,13,6,7,364.64864955425816,0.4189485538169749,0.11664390305879335,0.20047206778746055,128858.98940611786,1797.651293973474,130656.64070009133,1148,1,266.57894736842104,33,5,16,36.91447897807283,0.6152146464646464,46.1703431372549,1015.3186274509807,30.7672311348782,0
4470,4,0,1,36,0.0,0.02702702702702703,0.972972972972973,37,950,500,450,0.5263157894736842,14,5,9,371.4635776342172,0.4164164164164164,0.1146631706333201,0.20400048935649606,128816.57483930197,2170.133149678586,130986.70798898056,1149,2,273.6216216216216,32,5,17,36.78482587064678,0.6171875,46.212121212121204,1015.151515151514,31.723484848484812,0
4471,4,0,0,36,0.0,0.0,1.0,36,1100,800,300,0.7272727272727273,14,8,6,383.84693090656475,0.41425264550264546,0.11360266335885538,0.21021216672908344,128705.44645521366,2680.638122558585,131386.08457777224,1150,3,282.05555555555554,31,5,17,36.58424761538132,0.6186155913978495,46.32161458333333,1014.7135416666658,32.73269489247309,0
4472,4,1,2,35,0.02702702702702703,0.05405405405405406,0.9459459459459459,37,900,600,300,0.6666666666666666,12,6,6,373.007446423826,0.4171984484484485,0.11401114121948996,0.20634618118662357,129105.13157139569,2231.4350895316693,131336.56666092735,1151,0,275.4054054054054,32,5,21,36.45095664057647,0.6201171875,45.9280303030303,1016.2878787878781,31.75899621212119,0
4473,4,0,0,35,0.0,0.0,1.0,35,850,500,350,0.5882352941176471,12,5,7,382.0905889841877,0.4183823529411765,0.09413487588782377,0.21117811306179884,129069.04432508672,2863.2134331597176,131932.25775824644,1152,1,275.3142857142857,31,4,21,36.25704766786264,0.6223118279569892,45.963541666666664,1016.1458333333327,32.778897849462346,0
4474,4,0,0,35,0.0,0.0,1.0,35,700,300,400,0.42857142857142855,11,3,8,385.3679285672951,0.4180672268907563,0.09074294231417612,0.21353043309671663,129169.29913082847,2955.541048107336,132124.84017893582,1153,2,276.3142857142857,32,3,21,36.071347244648706,0.6207682291666667,45.86489898989899,1016.5404040404039,31.766887626262623,0
4475,4,0,0,35,0.0,0.0,1.0,35,850,800,50,0.9411764705882353,9,8,1,388.5350160832211,0.4174719887955182,0.09473818973242887,0.21600334595203136,129300.69181654193,3047.5732604650457,132348.26507700697,1154,3,277.3142857142857,31,4,21,35.85661780395169,0.6246639784946236,45.735677083333336,1017.0572916666671,32.80829973118281,0
4476,4,0,0,35,0.0,0.0,1.0,35,800,700,100,0.875,9,7,2,390.3129380832795,0.41782212885154063,0.0965007861347762,0.21753960757366256,129400.0328911676,3101.3014051649347,132501.33429633253,1155,4,278.3142857142857,31,4,21,35.70994369081136,0.6256720430107527,45.638020833333336,1017.4479166666672,32.82090053763442,0
4477,4,0,1,34,0.0,0.02857142857142857,0.9714285714285714,35,900,400,500,0.4444444444444444,14,4,10,375.52202568715865,0.41740196078431374,0.07444097138735284,0.2119126329488322,129887.55076172632,2755.1272347174254,132642.67799644376,1156,5,279.3142857142857,33,2,16,35.58948465175924,0.6256313131313131,45.1593137254902,1019.3627450980397,30.88978015448605,8
4478,4,1,0,35,0.02857142857142857,0.0,1.0,35,1150,900,250,0.782608695652174,14,9,5,365.64034988156124,0.41638655462184876,0.10174282969672022,0.20799541214574052,130200.04325259512,2521.277873894653,132721.32112648978,1157,0,280.14285714285717,33,2,18,35.52373519052193,0.6287878787878788,44.85294117647059,1020.5882352941173,30.92691622103386,0
4479,4,1,0,36,0.027777777777777776,0.0,1.0,36,1050,700,350,0.6666666666666666,14,7,7,358.64036472866024,0.41785714285714287,0.10204378712006568,0.2062722579989953,130627.42524092947,2169.653486394531,132797.078727324,1158,0,273.3333333333333,34,2,15,35.268914250223204,0.6308210784313726,44.434523809523796,1022.2619047619029,30.066526610644203,0
4480,4,1,1,36,0.02702702702702703,0.02702702702702703,0.972972972972973,37,1600,1300,300,0.8125,19,13,6,347.84120607502666,0.42017017017017017,0.10353388073419723,0.2029494077106169,131179.87403817283,1725.9531196416137,132905.82715781443,1159,0,266.9189189189189,35,2,17,34.98627744510979,0.6342261904761906,43.89467592592592,1024.421296296295,29.269179894179857,0
4481,4,0,0,36,0.0,0.0,1.0,36,1250,1000,250,0.8,15,10,5,355.1876571147105,0.41653439153439153,0.11199258656541033,0.2068841851156297,131114.6701388888,2114.0624999999914,133228.7326388888,1160,1,275.27777777777777,34,2,17,34.864049362625444,0.6357230392156863,43.95833333333333,1024.1666666666658,30.122549019607817,0
4482,4,0,0,36,0.0,0.0,1.0,36,800,400,400,0.5,12,4,8,355.1203457579257,0.41603835978835974,0.10786687326489797,0.20717359832182694,131175.6395266438,2116.6276927437398,133292.26721938752,1161,2,276.27777777777777,34,2,17,34.804135192717396,0.6363357843137255,43.89880952380951,1024.4047619047603,30.129551820728246,0
4483,4,0,0,36,0.0,0.0,1.0,36,950,800,150,0.8421052631578947,11,8,3,354.6834604093721,0.4161541005291005,0.10396899164762541,0.20724783053248222,131236.6230867346,2109.491921768696,133346.1150085033,1162,3,277.27777777777777,34,2,17,34.75368885790636,0.6369485294117647,43.83928571428571,1024.6428571428564,30.136554621848717,0
4484,4,0,0,36,0.0,0.0,1.0,36,1250,900,350,0.72,16,9,7,350.540308111228,0.416005291005291,0.10783479090885661,0.2059723201957788,131450.17715419497,2015.7171201814033,133465.89427437636,1163,4,278.27777777777777,34,2,19,34.64418388669607,0.639093137254902,43.63095238095238,1025.4761904761904,30.161064425770306,0
4485,4,0,0,36,0.0,0.0,1.0,36,1100,900,200,0.8181818181818182,13,9,4,349.9317091821998,0.41583994708994704,0.10597209326317958,0.2059434157318193,131511.22448979592,2003.9895124716516,133515.21400226757,1164,5,279.27777777777777,34,2,19,34.59817974311357,0.6397058823529411,43.57142857142857,1025.7142857142856,30.168067226890752,0
4486,4,0,0,36,0.0,0.0,1.0,36,950,600,350,0.631578947368421,13,6,7,350.5781622622618,0.41554232804232805,0.10427945346738854,0.20698518895210252,131633.36167800458,2029.5564058956995,133662.9180839003,1165,6,280.27777777777777,34,2,17,34.458381670533655,0.6409313725490196,43.452380952380956,1026.1904761904766,30.182072829131666,0
4487,4,0,0,36,0.0,0.0,1.0,36,850,500,350,0.5882352941176471,12,5,7,375.6842554972753,0.4156746031746032,0.16544501933730538,0.2027169358343159,128114.39909297007,2426.112528344614,130540.51162131468,1166,7,281.27777777777777,34,2,17,37.3963722953904,0.6053921568627452,46.90476190476188,1012.3809523809487,29.77591036414555,8
4488,4,1,1,36,0.02702702702702703,0.02702702702702703,0.972972972972973,37,1350,1000,350,0.7407407407407407,17,10,7,364.36051362253505,0.4185122622622623,0.15453709815727668,0.19878747324786086,128555.01570001683,1968.074309842215,130523.09000985904,1167,0,274.64864864864865,35,2,17,37.23227193182684,0.6077380952380953,46.46990740740739,1014.1203703703678,28.974867724867654,0
4489,4,0,0,36,0.0,0.0,1.0,36,800,400,400,0.5,12,4,8,370.88024648868384,0.41534391534391535,0.15892125388249445,0.20163949033235298,128415.88010204052,2325.382653061189,130741.2627551017,1168,9,283.27777777777777,34,2,17,37.20930232558139,0.6084558823529411,46.60714285714284,1013.5714285714262,29.810924369747827,0
4490,4,1,0,37,0.02702702702702703,0.0,1.0,37,1500,1000,500,0.6666666666666666,20,10,10,365.51051315453185,0.41726101101101104,0.17199577327241755,0.2010422402448092,128877.99968117705,2021.2527595593206,130899.25244073638,1169,0,276.5945945945946,35,2,18,36.873195220183135,0.6110119047619047,46.15162037037037,1015.393518518518,29.011243386243372,0
4491,4,0,0,37,0.0,0.0,1.0,37,800,500,300,0.625,11,5,6,366.9367604862522,0.4171984484484485,0.1748749661238267,0.2022761940971952,128966.1565500686,2064.4847393690025,131030.6412894376,1170,1,277.5945945945946,35,2,18,36.74699939228198,0.611904761904762,46.06481481481482,1015.7407407407408,29.021164021164022,0
4492,4,2,2,37,0.05128205128205128,0.05128205128205128,0.9487179487179487,39,900,600,300,0.6666666666666666,12,6,6,353.2566002647809,0.42302069275753484,0.17208026323423375,0.1971481964556481,129452.33298947735,1345.9782096414083,130798.31119911876,1171,0,264.3076923076923,37,2,17,36.59930233811012,0.6128941441441442,45.586622807017534,1017.6535087719284,27.504148885727794,0
4493,4,1,0,38,0.02631578947368421,0.0,1.0,38,950,500,450,0.5263157894736842,14,5,9,363.4705959637382,0.41930417259364633,0.18392508665132645,0.2025883303227869,129401.82317029877,1806.7515573005567,131208.57472759933,1172,0,272.2368421052632,36,2,19,36.39088729016789,0.6142939814814814,45.63626126126127,1017.4549549549557,28.26263763763766,0
4494,4,0,1,37,0.0,0.02631578947368421,0.9736842105263158,38,900,600,300,0.6666666666666666,12,6,6,366.248850896862,0.41955606922712185,0.1900513620852302,0.20458325799788885,129487.77113261924,1884.9494765035429,131372.72060912277,1173,1,273.2368421052632,36,2,18,36.23266578151508,0.615162037037037,45.55180180180181,1017.7927927927939,28.272022022022053,0
4495,4,1,0,38,0.02631578947368421,0.0,1.0,38,950,700,250,0.7368421052631579,12,7,5,365.311714821472,0.4186966571834993,0.19424113013021116,0.20525526535869823,129717.10519641291,1877.4356281957953,131594.5408246087,1174,0,271.07894736842104,36,2,19,36.023058073550004,0.6174768518518519,45.32657657657659,1018.693693693696,28.297047047047112,0
4496,4,1,0,39,0.02564102564102564,0.0,1.0,39,1250,900,350,0.72,16,9,7,354.4876671966154,0.4204903283850652,0.1869395244274361,0.20154042263890695,130178.65022170315,1429.3452071791655,131607.9954288823,1175,0,265.1025641025641,37,2,20,35.82999803015653,0.6202139639639639,44.873903508771946,1020.5043859649148,27.581199620673374,0
4497,4,2,1,40,0.04878048780487805,0.024390243902439025,0.975609756097561,41,1200,800,400,0.6666666666666666,16,8,8,347.5979969911063,0.42510162601626017,0.19677293607784052,0.20057598705219218,130753.83434007262,889.9812346960526,131643.81557476867,1176,0,253.1219512195122,38,3,17,35.423195445523874,0.6241776315789473,44.31089743589745,1022.7564102564127,26.914642375168754,0
4498,4,0,1,39,0.0,0.025,0.975,40,1150,700,450,0.6086956521739131,16,7,9,355.25768561729666,0.4220886752136752,0.19273536349989273,0.2047671925875717,130710.70545744857,1287.196541243473,131997.90199869205,1177,1,260.45,37,3,18,35.271016512974484,0.6255630630630631,44.3530701754386,1022.5877192982466,27.63750592697964,0
4499,4,0,0,39,0.0,0.0,1.0,39,1100,700,400,0.6363636363636364,15,7,8,358.44455145943675,0.41945006747638325,0.18806351825118583,0.20645432009630946,130682.67549871125,1568.4986005309443,132251.1740992422,1178,2,268.0769230769231,37,2,18,35.21794012511171,0.6252815315315315,44.380482456140356,1022.4780701754395,27.63454243717404,0
4500,4,0,0,39,0.0,0.0,1.0,39,950,500,450,0.5263157894736842,14,5,9,361.8436826472121,0.41869095816464236,0.19163177157176325,0.20947427087244289,130878.94833025528,1671.54412896274,132550.49245921802,1179,3,269.0769230769231,37,2,20,34.93222246035147,0.6272522522522522,44.18859649122806,1023.2456140350863,27.655286865813142,0
4501,4,2,1,40,0.04878048780487805,0.024390243902439025,0.975609756097561,41,1200,700,500,0.5833333333333334,17,7,10,348.5977686485284,0.42291666666666666,0.19271658113949863,0.20432856044483322,131356.22409058546,959.6362582717634,132315.8603488572,1180,0,256.9024390243902,37,4,22,34.7888143116911,0.6320382882882882,43.72258771929824,1025.109649122806,27.70566619250827,0
4502,4,0,2,38,0.0,0.05,0.95,40,1000,800,200,0.8,12,8,4,357.14135401642085,0.4220619658119658,0.12920964007577385,0.19615937259329633,128821.50472094363,1201.4973244940977,130023.00204543772,1181,1,264.175,38,2,18,37.14327685399565,0.6047149122807017,46.20726495726495,1015.1709401709386,26.71502474134049,8
4503,4,0,0,38,0.0,0.0,1.0,38,850,600,250,0.7058823529411765,11,6,5,374.25773092174893,0.4171260075865339,0.15514785299354839,0.2056022817952205,128829.56594685913,2043.0922053810673,130872.6581522402,1182,6,279.0263157894737,36,2,18,36.70063782584582,0.6085069444444444,46.19932432432433,1015.2027027027036,28.2000750750751,0
4504,4,0,0,38,0.0,0.0,1.0,38,650,500,150,0.7692307692307693,8,5,3,372.56859675393633,0.4172149122807018,0.14794569322274298,0.20496955685968543,128886.73460200062,2003.8299701728774,130890.5645721735,1183,7,280.0263157894737,36,2,18,36.68510406269639,0.6090856481481481,46.14301801801802,1015.4279279279277,28.206331331331327,0
4505,4,1,0,39,0.02564102564102564,0.0,1.0,39,1000,800,200,0.8,12,8,4,367.5115672846939,0.419646873594242,0.1564718135431531,0.20456359498829466,129348.51794249393,1708.182547831079,131056.700490325,1184,0,273.8205128205128,35,4,19,36.342421397959576,0.6157738095238094,45.688657407407405,1017.2453703703698,29.064153439153422,0
4506,4,3,0,42,0.07142857142857142,0.0,1.0,42,1250,1100,150,0.88,14,11,3,347.0045614493886,0.4274099883855981,0.17429827578471957,0.1974350551236457,130208.06081753607,636.5582082328917,130844.61902576896,1185,0,255.1904761904762,38,4,20,35.99109354827451,0.6186951754385965,44.84508547008547,1020.6196581196589,26.858412055780498,0
4507,4,0,0,42,0.0,0.0,1.0,42,1250,800,450,0.64,17,8,9,347.10254551581625,0.42663569492837783,0.16952895639341015,0.198060338589799,130320.07250071016,646.9086079089122,130966.98110861907,1186,1,256.1904761904762,36,6,20,35.87505974045071,0.6235532407407407,44.73536036036036,1021.0585585585584,28.36273773773773,0
4508,4,0,1,41,0.0,0.023809523809523808,0.9761904761904762,42,900,400,500,0.4444444444444444,14,4,10,345.6304948019075,0.42664779326364694,0.1681422899993701,0.19736633040703372,130348.82010388763,610.5054378702982,130959.32554175792,1187,2,257.1904761904762,36,6,20,35.88350977797383,0.6238425925925926,44.707207207207205,1021.1711711711708,28.365865865865857,0
4509,4,0,0,41,0.0,0.0,1.0,41,750,500,250,0.6666666666666666,10,5,5,356.30046501191015,0.42367886178861786,0.1783678276592333,0.20331712175517921,130321.6695066014,1086.734289266107,131408.40379586752,1188,3,264.1951219512195,35,6,20,35.63864958815083,0.6255952380952381,44.73379629629629,1021.0648148148141,29.173280423280403,0
4510,4,0,0,41,0.0,0.0,1.0,41,850,400,450,0.47058823529411764,13,4,9,358.41358029541027,0.42367886178861786,0.1785080665218619,0.20514645004457108,130439.87509645039,1150.284529320962,131590.15962577134,1189,4,265.1951219512195,35,6,20,35.46481985044187,0.6267857142857143,44.61805555555554,1021.5277777777759,29.186507936507883,0
4511,4,1,1,41,0.023809523809523808,0.023809523809523808,0.9761904761904762,42,1250,900,350,0.72,16,9,7,355.16697649585905,0.42517179636082075,0.20134871730382287,0.20585188025474263,130924.43795146485,900.0073553282838,131824.44530679312,1190,0,259.85714285714283,36,6,18,35.05698906983567,0.6296296296296297,44.144144144144136,1023.4234234234224,28.4284284284284,0
4512,4,0,1,40,0.0,0.024390243902439025,0.975609756097561,41,1100,800,300,0.7272727272727273,14,8,6,334.7797870415297,0.4251270325203252,0.14590030316317293,0.19102884387070765,130320.07250070992,558.5030131482548,130878.57551385817,1191,1,260.5609756097561,36,5,19,36.189616190581226,0.6235532407407407,44.735360360360346,1021.0585585585566,28.36273773773768,8
4513,4,1,0,41,0.024390243902439025,0.0,1.0,41,1600,1100,500,0.6875,21,11,10,329.6695480937218,0.4254065040650406,0.16477454407682757,0.18951301380916463,130607.69120049085,411.47570712602493,131019.16690761688,1192,0,261.390243902439,36,5,14,36.02924975212075,0.6264467592592593,44.45382882882882,1022.1846846846832,28.39401901901898,0
4514,4,0,0,41,0.0,0.0,1.0,41,1000,800,200,0.8,12,8,4,330.5324688415955,0.42525406504065044,0.16293832725748802,0.19029196478204435,130665.25298524849,437.82173220514784,131103.07471745362,1193,1,262.390243902439,36,5,15,35.94903073025665,0.627025462962963,44.39752252252251,1022.4099099099077,28.400275275275213,0
4515,4,0,1,40,0.0,0.024390243902439025,0.975609756097561,41,800,500,300,0.625,11,5,6,331.52972569148164,0.4243140243902439,0.16222573057963086,0.19157862774690937,130809.21292914513,473.4284960636049,131282.64142520874,1194,2,263.390243902439,36,5,15,35.77810802876854,0.6284722222222222,44.256756756756744,1022.9729729729711,28.415915915915864,0
4516,4,0,0,40,0.0,0.0,1.0,40,1200,900,300,0.75,15,9,6,341.5204472890868,0.42151442307692305,0.17070170610897084,0.19749925293579593,130838.01442912506,936.7714420501565,131774.7858711752,1195,3,270.75,36,4,15,35.493487433498444,0.6287615740740741,44.2286036036036,1023.0855855855855,28.419044044044043,0
4517,4,0,0,40,0.0,0.0,1.0,40,750,200,550,0.26666666666666666,13,2,11,341.5204472890868,0.42151442307692305,0.17070170610897084,0.19749925293579593,130838.01442912506,936.7714420501565,131774.7858711752,1196,4,271.75,36,4,15,35.493487433498444,0.6287615740740741,44.2286036036036,1023.0855855855855,28.419044044044043,0
4518,4,0,0,40,0.0,0.0,1.0,40,1050,600,450,0.5714285714285714,15,6,9,339.5862102325462,0.42084668803418807,0.16508141709759094,0.19696867037674598,130953.2521330451,893.9837218975656,131847.23585494267,1197,5,272.75,36,4,15,35.42652290314301,0.6299189814814814,44.11599099099099,1023.5360360360352,28.431556556556533,0
4519,4,0,0,40,0.0,0.0,1.0,40,1450,1000,450,0.6896551724137931,19,10,9,338.8327580070637,0.42080662393162394,0.1661800285934234,0.19712132236457025,131068.54056336755,882.063017409317,131950.60358077686,1198,6,273.75,36,4,16,35.3293742439239,0.6310763888888888,44.003378378378386,1023.9864864864876,28.4440690690691,0
4520,4,0,1,39,0.0,0.025,0.975,40,1000,700,300,0.7,13,7,6,340.442507739583,0.42077991452991453,0.16996371233780527,0.19820641263660504,131097.3705969484,926.2235208181268,132023.59411776654,1199,7,274.75,36,4,16,35.25905358844658,0.6313657407407407,43.97522522522523,1024.0990990991,28.44719719719722,0
4521,4,0,0,39,0.0,0.0,1.0,39,850,600,250,0.7058823529411765,11,6,5,350.31962487413176,0.41877530364372473,0.17278347288520224,0.20376579363980582,131061.33355034741,1382.6714409722463,132444.00499131964,1200,8,282.1025641025641,35,4,18,35.042599186164814,0.6330357142857144,44.01041666666668,1023.9583333333348,29.255952380952426,0
4522,4,0,1,38,0.0,0.02564102564102564,0.9743589743589743,39,950,600,350,0.631578947368421,13,6,7,353.93507612754956,0.41810053981106615,0.17995654063450695,0.2063455483352316,131150.23389274706,1483.7336033950828,132633.96749614214,1201,9,283.1025641025641,35,4,19,34.86016949152543,0.6339285714285714,43.92361111111112,1024.3055555555568,29.26587301587305,0
4523,4,0,0,38,0.0,0.0,1.0,38,1150,800,350,0.6956521739130435,15,8,7,355.46366088187204,0.4175705310573732,0.16415049481411015,0.20803904276992594,131298.46810967516,1734.3668284893806,133032.83493816454,1202,10,285.89473684210526,35,3,19,34.67120741577264,0.6354166666666667,43.77893518518519,1024.88425925926,29.28240740740743,0
4524,4,0,0,38,0.0,0.0,1.0,38,650,300,350,0.46153846153846156,10,3,7,353.80259528199446,0.41691856330014226,0.16427737752601557,0.2077233642238462,131419.65880102068,1699.3266199548507,133118.9854209755,1203,11,286.89473684210526,34,4,20,34.59136382986957,0.6387867647058824,43.6607142857143,1025.357142857145,30.157563025210145,0
4525,4,0,0,38,0.0,0.0,1.0,38,650,300,350,0.46153846153846156,10,3,7,355.2226605213705,0.41631104788999523,0.16706770407103844,0.20939185282990244,131572.2859977325,1747.4914965986495,133319.77749433115,1204,12,287.89473684210526,34,4,18,34.400866403651264,0.6403186274509804,43.511904761904766,1025.9523809523816,30.175070028011223,0
4526,4,1,0,39,0.02564102564102564,0.0,1.0,39,1000,600,400,0.6,14,6,8,348.7651129124084,0.4197593342330184,0.16464085525916827,0.2079708151477015,132011.15779588916,1408.177270876215,133419.33506676537,1205,0,281.4871794871795,35,4,19,34.1241740811653,0.6425595238095239,43.08449074074075,1027.6620370370379,29.36177248677251,0
4527,4,0,0,39,0.0,0.0,1.0,39,600,400,200,0.6666666666666666,8,4,4,347.840112002136,0.41978744939271256,0.15866142414217133,0.20790820153452028,132100.3796403464,1389.9621699245517,133490.34181027094,1206,1,282.4871794871795,35,4,20,34.05811378818583,0.6434523809523809,42.99768518518518,1028.0092592592594,29.371693121693124,0
4528,4,2,0,41,0.04878048780487805,0.0,1.0,41,700,400,300,0.5714285714285714,10,4,6,333.53253826101303,0.42560975609756097,0.16252163177584533,0.20217509128386288,132629.89921932088,647.6122851611863,133277.51150448207,1207,0,269.6585365853659,36,5,18,33.89408184832916,0.6467013888888888,42.48310810810812,1030.0675675675693,28.612987987988035,0
4529,4,0,0,41,0.0,0.0,1.0,41,1300,900,400,0.6923076923076923,17,9,8,335.6736003288669,0.4245426829268293,0.16724586389220542,0.20426095679586376,132774.93709926153,713.8082339095988,133488.74533317113,1208,1,270.6585365853659,36,5,18,33.69345498251749,0.6481481481481481,42.34234234234235,1030.6306306306315,28.62862862862865,0
4530,4,0,2,39,0.0,0.04878048780487805,0.9512195121951219,41,1100,900,200,0.8181818181818182,13,9,4,340.54909751836215,0.4242632113821138,0.16723216806310948,0.20819416789540485,132949.08717839478,855.1383308984937,133804.22550929326,1209,2,271.6585365853659,36,5,19,33.39316262648324,0.6498842592592593,42.173423423423436,1031.3063063063078,28.647397397397437,0
4531,4,0,0,39,0.0,0.0,1.0,39,1150,800,350,0.6956521739130435,15,8,7,350.45403530252014,0.4218679712100765,0.17218337218337232,0.21416635490709565,132934.5703125,1517.4913194444448,134452.06163194444,1210,3,280.05128205128204,35,4,19,33.1523569023569,0.6517857142857143,42.1875,1031.25,29.464285714285715,0
4532,4,0,0,39,0.0,0.0,1.0,39,1350,900,450,0.6666666666666666,18,9,9,352.13510693049915,0.4202654071075124,0.17538714555983037,0.21657523335215106,133173.3927576303,1579.0053798010993,134752.3981374314,1211,4,281.05128205128204,35,4,20,32.869384017343194,0.6541666666666667,41.95601851851852,1032.1759259259259,29.49074074074074,0
4533,4,0,1,38,0.0,0.02564102564102564,0.9743589743589743,39,650,300,350,0.46153846153846156,10,3,7,344.7565678601344,0.4202372919478183,0.14192981009701344,0.1992923654358764,130822.85534972264,1227.4941627931687,132050.3495125158,1212,5,282.05128205128204,37,2,19,35.426045016077175,0.6266891891891893,44.24342105263156,1023.0263157894708,27.649359886201914,8
4534,4,0,0,38,0.0,0.0,1.0,38,750,500,250,0.6666666666666666,10,5,5,354.17244609824445,0.4174964438122333,0.1775157524091917,0.2052754585549007,130924.43795146485,1673.9656886616172,132598.40364012646,1213,6,290.3421052631579,36,2,19,35.082434712441305,0.6296296296296297,44.144144144144136,1023.4234234234224,28.4284284284284,0
4535,4,0,0,38,0.0,0.0,1.0,38,1050,700,350,0.6666666666666666,14,7,7,352.4793813771247,0.41733345187292553,0.1734132658673413,0.2047533582172165,131010.89000740601,1635.7274926953942,132646.6175001014,1214,7,291.3421052631579,36,2,19,35.03831628350384,0.6304976851851851,44.05968468468468,1023.7612612612609,28.4378128128128,0
4536,4,0,1,37,0.0,0.02631578947368421,0.9736842105263158,38,650,300,350,0.46153846153846156,10,3,7,353.4428046373108,0.4171111901375059,0.17704401787574975,0.20546687850143408,131039.71370018658,1663.00878581283,132702.7224859994,1215,8,292.3421052631579,36,2,19,34.98451019211028,0.630787037037037,44.03153153153153,1023.8738738738731,28.44094094094092,0
4537,4,0,0,37,0.0,0.0,1.0,37,1000,600,400,0.6,14,6,8,360.5323573326166,0.4157282282282282,0.1888591440830245,0.20922232075128994,130972.4633487653,2043.9621913580077,133016.4255401233,1216,9,300.4054054054054,35,2,20,34.87109905020351,0.6321428571428571,44.097222222222214,1023.6111111111102,29.24603174603172,0
4538,4,1,0,38,0.02631578947368421,0.0,1.0,38,1100,700,400,0.6363636363636364,15,7,8,354.2177547447011,0.41638513513513514,0.19318249337500437,0.20779211069725567,131387.4488275891,1708.4356781550005,133095.8845057441,1217,0,293.4736842105263,35,3,21,34.61324979303079,0.6363095238095238,43.692129629629626,1025.231481481481,29.29232804232803,0
4539,4,0,1,37,0.0,0.02631578947368421,0.9736842105263158,38,1150,900,250,0.782608695652174,14,9,5,355.49485943982086,0.41607396870554764,0.19623296820732028,0.20967810571749898,131595.18771701382,1756.2825520833235,133351.47026909713,1218,1,294.4736842105263,35,3,20,34.37076988155669,0.6383928571428572,43.48958333333333,1026.041666666666,29.315476190476172,0
4540,4,0,0,37,0.0,0.0,1.0,37,1200,1000,200,0.8333333333333334,14,10,4,357.92434277385405,0.41554054054054057,0.1939801777420176,0.21160487144790255,131684.268904321,2026.6010802469157,133710.86998456792,1219,2,298.3783783783784,35,2,20,34.21853856562923,0.6392857142857142,43.40277777777778,1026.3888888888891,29.325396825396833,0
4541,4,0,0,37,0.0,0.0,1.0,37,1650,1100,550,0.6666666666666666,22,11,11,358.5696711362727,0.41516516516516516,0.19702867167370197,0.21298174442190693,131862.5217013891,2056.380208333358,133918.90190972248,1220,3,299.3783783783784,35,2,21,34.02214334009467,0.6410714285714285,43.22916666666668,1027.083333333335,29.345238095238145,0
4542,4,0,0,37,0.0,0.0,1.0,37,950,600,350,0.631578947368421,13,6,7,354.4887028204886,0.4154466966966967,0.1950439794305967,0.21105273071344616,131951.69331114984,1955.0769193673054,133906.77023051714,1221,4,300.3783783783784,35,2,21,34.03704798918555,0.6419642857142858,43.14236111111112,1027.4305555555568,29.355158730158767,0
4543,4,0,0,37,0.0,0.0,1.0,37,450,200,250,0.4444444444444444,7,2,5,354.5543554137735,0.41500875875875876,0.18938171047760055,0.21131995383087443,131992.67415642022,1959.7155009739781,133952.3896573942,1222,5,301.3783783783784,36,1,21,33.994063926940655,0.6403356481481481,43.10247747747749,1027.5900900900922,28.544169169169226,0
4544,4,0,0,37,0.0,0.0,1.0,37,800,600,200,0.75,10,6,4,354.1220452586934,0.41491491491491495,0.1900151877148264,0.21170793393363552,132108.4191243609,1956.5007152422809,134064.9198396032,1223,6,302.3783783783784,36,1,21,33.88856939423816,0.6414930555555556,42.98986486486487,1028.040540540541,28.556681681681695,0
4545,4,0,0,37,0.0,0.0,1.0,37,1050,500,550,0.47619047619047616,16,5,11,353.49241602810145,0.4136011011011011,0.1900563819335801,0.21216329844911205,132256.98201610122,1950.368021891362,134207.35003799258,1224,7,303.3783783783784,37,0,21,33.75517446611947,0.6410472972972974,42.84539473684211,1028.6184210526324,27.800497866287362,0
4546,4,0,0,37,0.0,0.0,1.0,37,1250,800,450,0.64,17,8,9,355.98312122209757,0.4138513513513513,0.19371673463745043,0.2141375390736004,132341.58587257625,2022.2741612803966,134363.86003385665,1225,8,304.3783783783784,37,0,21,33.60596050014209,0.6418918918918919,42.76315789473684,1028.9473684210532,27.80938833570414,0
4547,4,0,0,37,0.0,0.0,1.0,37,900,600,300,0.6666666666666666,12,6,6,357.0400766419479,0.4128503503503504,0.19726595989995688,0.2155918349181432,132484.9405993832,2060.498692031672,134545.43929141486,1226,9,305.3783783783784,36,1,21,33.434514694085905,0.6452546296296297,42.623873873873876,1029.504504504505,28.59734734734736,0
4548,4,1,0,38,0.02631578947368421,0.0,1.0,38,1100,800,300,0.7272727272727273,14,8,6,350.1963936397017,0.4159850640113798,0.1969050458895405,0.21304180607246315,132765.01092884352,1698.7656057633155,134463.77653460685,1227,0,298.3157894736842,37,1,19,33.3292327197929,0.6461148648648649,42.35197368421053,1030.5921052631581,27.853840682788057,0
4549,4,0,0,38,0.0,0.0,1.0,38,750,400,350,0.5333333333333333,11,4,7,348.85366573667136,0.4159109767662399,0.19458189892685507,0.2123275276568875,132783.12108490395,1664.3757076850059,134447.49679258897,1228,1,299.3157894736842,38,0,19,33.34564285961095,0.6444627192982456,42.33440170940171,1030.6623931623933,27.12269455690509,0
4550,4,0,0,38,0.0,0.0,1.0,38,1050,700,350,0.6666666666666666,14,7,7,347.25325931597126,0.4156146277856804,0.19454156689266955,0.21166435244092283,132838.18354381263,1625.698439440436,134463.88198325306,1229,2,300.3157894736842,38,0,20,33.33160603862232,0.6450109649122807,42.28098290598291,1030.876068376069,27.128317588843924,0
4551,4,1,0,39,0.02564102564102564,0.0,1.0,39,1100,1000,100,0.9090909090909091,12,10,2,338.53804618965967,0.41832546108861896,0.19005620943448887,0.20807909191359544,133149.50086805594,1215.23437500004,134364.73524305597,1230,0,293.5897435897436,39,0,21,33.2441797873772,0.6463675213675213,41.979166666666686,1032.0833333333364,26.463675213675295,0
4552,4,0,0,39,0.0,0.0,1.0,39,1150,700,450,0.6086956521739131,16,7,9,338.1045276494016,0.4184098065677013,0.18540792070500478,0.20856441708702678,133283.92062717033,1212.7794053819641,134496.7000325523,1231,1,294.5897435897436,39,0,21,33.12075473284239,0.6477029914529915,41.84895833333334,1032.6041666666683,26.477029914529957,0
4553,4,0,0,39,0.0,0.0,1.0,39,550,100,450,0.18181818181818182,10,1,9,337.6125203412056,0.4182411156095367,0.18185344660382485,0.2085625008836797,133337.7075195315,1203.2958984375298,134541.00341796904,1232,2,295.5897435897436,39,0,22,33.07961422087747,0.6482371794871795,41.796875000000014,1032.812500000002,26.48237179487185,0
4554,4,0,0,39,0.0,0.0,1.0,39,1100,800,300,0.7272727272727273,14,8,6,323.30370225215415,0.41821300044984255,0.11294065642612439,0.18205197272431506,129803.15778193738,598.7970927272316,130401.9548746646,1233,3,296.5897435897436,36,3,18,37.00570044572142,0.6183449074074074,45.24211711711712,1019.0315315315318,28.306431431431438,8
4555,4,0,0,39,0.0,0.0,1.0,39,1250,700,550,0.56,18,7,11,323.6886308317077,0.41734143049932526,0.1138908946749917,0.18307311381518543,129975.34855379055,614.3085230501082,130589.65707684065,1234,4,297.5897435897436,36,3,19,36.82150745444505,0.6200810185185186,45.07319819819821,1019.7072072072094,28.32520020020026,0
4556,4,0,1,38,0.0,0.02564102564102564,0.9743589743589743,39,950,600,350,0.631578947368421,13,6,7,323.6312696218881,0.4168353576248313,0.11728001857183701,0.1833100943693212,130032.77084094257,616.5341439412745,130649.30498488384,1235,5,298.5897435897436,36,3,19,36.764841190975694,0.6206597222222222,45.01689189189191,1019.9324324324347,28.331456456456518,0
4557,4,0,1,37,0.0,0.02631578947368421,0.9736842105263158,38,1500,1200,300,0.8,18,12,6,327.69679300291534,0.41567389758179235,0.13157894736842057,0.1867109634551497,130262.58680555577,937.3263888889137,131199.91319444467,1236,6,303.07894736842104,36,2,20,36.42857142857143,0.622974537037037,44.79166666666668,1020.8333333333351,28.35648148148153,0
4558,4,0,0,37,0.0,0.0,1.0,37,1000,600,400,0.6,14,6,8,340.85263925519257,0.412474974974975,0.14126886328315424,0.19376516571973124,130173.98787133484,1474.0294656635797,131648.01733699843,1237,7,311.4864864864865,35,2,20,36.18258761483499,0.6241071428571429,44.87847222222222,1020.4861111111109,29.156746031746025,0
4559,4,0,0,37,0.0,0.0,1.0,37,1050,600,450,0.5714285714285714,15,6,9,341.6465534294973,0.4118180680680681,0.14476094775346682,0.1949551031277503,130321.66950660126,1504.7898448216474,131826.4593514229,1238,8,312.4864864864865,35,2,20,36.012714426056064,0.6255952380952381,44.73379629629628,1021.0648148148128,29.173280423280367,0
4560,4,0,0,37,0.0,0.0,1.0,37,750,500,250,0.6666666666666666,10,5,5,340.1127901726606,0.41188063063063063,0.13511676190126254,0.19467156200154986,130439.87509645041,1472.8539737654066,131912.72907021584,1239,9,313.4864864864865,35,2,20,35.932188987083606,0.6267857142857143,44.61805555555554,1021.5277777777761,29.18650793650789,0
4561,4,0,0,37,0.0,0.0,1.0,37,1450,1100,350,0.7586206896551724,18,11,7,344.4669139853469,0.4123185685685686,0.13860877070026656,0.19791719696841867,130587.70743580659,1596.6289169667152,132184.3363527733,1240,10,314.4864864864865,35,2,14,35.67133299362096,0.6282738095238095,44.47337962962962,1022.1064814814802,29.20304232804229,0
4562,4,0,1,36,0.0,0.02702702702702703,0.972972972972973,37,1150,900,250,0.782608695652174,14,9,5,345.51299113449784,0.41213088088088085,0.13885288002935114,0.19989102366681655,130854.01663237283,1642.352537722877,132496.3691700957,1241,11,315.4864864864865,35,2,15,35.37518853695325,0.6309523809523809,44.21296296296295,1023.1481481481459,29.232804232804167,0
4563,4,0,0,36,0.0,0.0,1.0,36,950,600,350,0.631578947368421,13,6,7,344.7565573635037,0.4115740740740741,0.14214355726457062,0.19975999214994067,130913.23329260954,1826.639124657041,132739.87241726657,1242,12,321.3611111111111,35,1,15,35.33467164291638,0.631547619047619,44.15509259259258,1023.3796296296281,29.239417989417944,0
4564,4,0,0,36,0.0,0.0,1.0,36,1300,800,500,0.6153846153846154,18,8,10,344.5819122393391,0.4119708994708995,0.13893911995177843,0.20058294470353075,131090.96364883377,1834.3149862825492,132925.27863511632,1243,13,322.3611111111111,35,1,15,35.159546413502106,0.6333333333333333,43.98148148148147,1024.074074074072,29.259259259259203,0
4565,4,0,0,36,0.0,0.0,1.0,36,1050,1000,50,0.9523809523809523,11,10,1,346.0291573000661,0.411739417989418,0.1361010148382642,0.19028257141278307,128868.76594387765,1763.5339681140067,130632.29991199165,1244,14,323.3611111111111,34,2,17,37.37713487317778,0.6130514705882353,46.16071428571429,1015.3571428571436,29.863445378151283,8
4566,4,2,0,38,0.05263157894736842,0.0,1.0,38,1000,800,200,0.8,12,8,4,331.52169782254504,0.4169037458511143,0.14518082461380732,0.18532001401471812,129516.42679419319,987.5011413440836,130503.92793553727,1245,0,307.2894736842105,36,2,18,37.087205443079974,0.6154513888888888,45.52364864864867,1017.9054054054083,28.27515015015023,0
4567,4,2,0,40,0.05,0.0,1.0,40,2050,1500,550,0.7317073170731707,26,15,11,314.5587017899727,0.4210603632478633,0.1392513089005234,0.17859902509478248,130126.29323727085,186.47157389144718,130312.7648111623,1246,0,292.875,38,2,21,36.90161431064571,0.6178728070175439,44.925213675213676,1020.2991452991457,26.849977507872257,0
4568,4,0,0,40,0.0,0.0,1.0,40,1200,800,400,0.6666666666666666,16,8,8,312.36984589754286,0.42031250000000003,0.13989795918367376,0.17797816801139046,130262.58680555537,138.0208333333137,130400.60763888869,1247,1,293.875,38,2,21,36.81972789115646,0.6192434210526316,44.79166666666666,1020.8333333333319,26.86403508771926,0
4569,4,0,0,40,0.0,0.0,1.0,40,1150,700,450,0.6086956521739131,16,7,9,314.0170291478452,0.4195779914529914,0.14048964218455762,0.17929359406183407,130344.39718934895,186.0720742932097,130530.46926364215,1248,2,294.875,38,2,22,36.69504603473529,0.6200657894736843,44.71153846153845,1021.1538461538448,26.872469635627496,0
4570,4,0,0,40,0.0,0.0,1.0,40,850,400,450,0.47058823529411764,13,4,9,315.2920992279545,0.4197916666666666,0.13789225941422556,0.18027466917579216,130398.95171305424,222.75184454670463,130621.70355760094,1249,3,295.875,38,2,22,36.607391910739175,0.6206140350877193,44.65811965811965,1021.367521367521,26.878092667566342,0
4571,4,0,0,40,0.0,0.0,1.0,40,1200,900,300,0.75,15,9,6,315.8064951722928,0.4194043803418803,0.13481386594165,0.18095012063107463,130480.80490037616,241.33713656949834,130722.14203694565,1250,4,296.875,38,2,22,36.51159852208163,0.6214364035087719,44.57799145299145,1021.6880341880337,26.886527215474572,0
4572,4,0,0,40,0.0,0.0,1.0,40,650,300,350,0.46153846153846156,10,3,7,316.4796753027937,0.41860309829059833,0.13614769520225845,0.1818475107280377,130589.98243343191,265.81504766601086,130855.79748109792,1251,5,297.875,38,2,13,36.38418522002718,0.622532894736842,44.47115384615385,1022.1153846153843,26.89777327935222,0
4573,4,0,0,40,0.0,0.0,1.0,40,1350,1200,150,0.8888888888888888,15,12,3,316.72732804510036,0.41861645299145295,0.13122062049514271,0.18276255041445122,130753.83434007231,282.66251643655846,131036.49685650886,1252,6,298.875,38,2,14,36.21252480935968,0.6241776315789473,44.31089743589744,1022.7564102564102,26.91464237516869,0
4574,4,1,2,39,0.024390243902439025,0.04878048780487805,0.9512195121951219,41,700,500,200,0.7142857142857143,9,5,4,308.90616354184965,0.42141768292682924,0.13376047485167053,0.17955284928757206,131034.6693250869,-104.51660156249585,130930.1527235244,1253,0,292.5609756097561,39,2,15,36.12958676704989,0.625267094017094,44.036458333333336,1023.8541666666674,26.252670940170958,0
4575,4,1,0,40,0.025,0.0,1.0,40,1350,1100,250,0.8148148148148148,16,11,5,335.07623082542034,0.42021901709401704,0.11996216216216271,0.18296665496665493,128588.99493113252,664.3035747778046,129253.29850591032,1254,0,300.5,37,3,13,37.94009009009011,0.6041666666666667,46.436403508771924,1014.2543859649112,27.412280701754355,8
4576,4,0,0,40,0.0,0.0,1.0,40,700,400,300,0.5714285714285714,10,4,6,335.5638478685242,0.4204727564102564,0.11849259539509283,0.1833609661330015,128616.79945992987,631.8296254616707,129248.62908539154,1255,1,301.5,37,3,13,37.89939375923325,0.6044481981981982,46.40899122807017,1014.3640350877184,27.415244191559957,0
4577,4,0,0,40,0.0,0.0,1.0,40,850,600,250,0.7058823529411765,11,6,5,334.27282352308714,0.4201923076923077,0.123735681867301,0.18303909520015643,128700.23108071696,604.1979262849925,129304.42900700195,1256,2,302.5,37,3,14,37.84714717959801,0.6052927927927928,46.326754385964904,1014.6929824561388,27.424134660976723,0
4578,4,0,0,40,0.0,0.0,1.0,40,1050,600,450,0.5714285714285714,15,6,9,331.7181249149284,0.41991185897435895,0.11454530726860357,0.18227763315058265,128839.34389667955,547.6691145352193,129387.01301121477,1257,3,303.5,37,3,15,37.77034506966196,0.6067004504504505,46.18969298245613,1015.2412280701739,27.4389521100047,0
4579,4,0,1,39,0.0,0.025,0.975,40,1400,1100,300,0.7857142857142857,17,11,6,333.4517958118454,0.4203525641025641,0.11676396339539297,0.18377543320482378,128957.11343277435,600.1962113740801,129557.30964414842,1258,4,304.5,38,2,16,37.606500473335444,0.6060855263157895,46.07371794871794,1015.7051282051272,26.72908232118756,0
4580,4,1,1,39,0.025,0.025,0.975,40,800,400,400,0.5,12,4,8,329.16959965927,0.4194043803418803,0.11346962371242397,0.18228868283808458,129147.08547921687,502.2588848710627,129649.34436408793,1259,0,305.35,38,2,17,37.522116530025926,0.6080043859649122,45.886752136752136,1016.4529914529913,26.748762932973456,0
4581,4,0,0,39,0.0,0.0,1.0,39,1250,1100,150,0.88,14,11,3,332.2359580757863,0.4163855150697256,0.12757461118116886,0.1842399403874813,129201.38888888877,785.0694444444345,129986.45833333321,1260,1,313.35897435897436,37,2,18,37.38900273224046,0.6103603603603603,45.83333333333333,1016.6666666666657,27.477477477477454,0
4582,4,0,1,38,0.0,0.02564102564102564,0.9743589743589743,39,1250,900,350,0.72,16,9,7,336.4991628145324,0.4166666666666667,0.1271273097097625,0.18739731288074604,129368.65790435513,906.489015851019,130275.14692020616,1261,2,314.35897435897436,37,2,19,37.11063806854925,0.6120495495495495,45.6688596491228,1017.3245614035083,27.495258416311035,0
4583,4,0,0,38,0.0,0.0,1.0,38,650,400,250,0.6153846153846154,9,4,5,341.50131383229433,0.41697783309625414,0.1207601691854161,0.19020486246368362,129373.18019032551,1236.222201931665,130609.40239225718,1262,3,316.94736842105266,36,2,19,36.97882075123607,0.6140046296296297,45.664414414414416,1017.3423423423427,28.25950950950952,0
4584,4,0,0,38,0.0,0.0,1.0,38,1150,800,350,0.6956521739130435,15,8,7,340.8210647646001,0.4163555002370792,0.12082081032594782,0.1901024161242548,129430.46932067207,1222.5260733706768,130652.99539404275,1263,4,317.94736842105266,36,2,14,36.937896561900544,0.6145833333333333,45.60810810810811,1017.567567567568,28.265765765765778,0
4585,4,1,0,39,0.02564102564102564,0.0,1.0,39,1150,800,350,0.6956521739130435,15,8,7,333.0724811919497,0.4197593342330184,0.12183211666749472,0.18761064486048334,129815.2376211909,847.5766582025005,130662.8142793934,1264,0,310.7692307692308,37,2,16,36.744584319632736,0.6165540540540541,45.230263157894726,1019.0789473684192,27.54267425320052,0
4586,4,0,2,37,0.0,0.05128205128205128,0.9487179487179487,39,950,600,350,0.631578947368421,13,6,7,330.89574921273515,0.41992802519118305,0.1191579504832525,0.18665090319669794,129871.11418898102,794.7599261310986,130665.87411511212,1265,1,311.7692307692308,37,2,16,36.74340218014917,0.6171171171171171,45.17543859649122,1019.2982456140335,27.548601232811716,0
4587,4,0,0,37,0.0,0.0,1.0,37,800,500,300,0.625,11,5,6,343.7126504502993,0.4169169169169169,0.14522687825440195,0.18186737329651714,127325.53155006828,1352.6791838134106,128678.21073388169,1266,2,328.1621621621622,35,2,16,39.012805810397566,0.5952380952380952,47.68518518518517,1009.2592592592567,28.835978835978764,8
4588,4,2,0,39,0.05128205128205128,0.0,1.0,39,550,200,350,0.36363636363636365,9,2,7,328.88624010358177,0.4222896986054881,0.15391843690661888,0.17625321281088502,127839.40882050227,608.9245008079189,128448.33332131019,1267,0,312.28205128205127,37,2,18,38.8615192092233,0.5965653153153153,47.17653508771929,1011.2938596491213,27.332266477003277,0
4589,4,1,0,40,0.025,0.0,1.0,40,900,500,400,0.5555555555555556,13,5,8,322.21051092654636,0.4258814102564103,0.1576807387862802,0.17375894086676286,128090.45041867548,254.41789484256844,128344.86831351805,1268,0,305.45,38,2,20,38.7741864555849,0.5973135964912281,46.9284188034188,1012.2863247863239,26.639113810166418,0
4590,4,0,0,40,0.0,0.0,1.0,40,1000,600,400,0.6,14,6,8,322.91325959449597,0.4254273504273504,0.1553952355170547,0.17449408732329824,128172.28768707659,277.7176556176979,128450.00534269429,1269,1,306.45,37,3,20,38.67296065692111,0.5999436936936937,46.84758771929823,1012.6096491228054,27.367828354670415,0
4591,4,0,0,40,0.0,0.0,1.0,40,1050,700,350,0.6666666666666666,14,7,7,324.85577411918916,0.425267094017094,0.16101341846120554,0.17627670044835153,128338.88942992066,338.32585507077624,128677.21528499144,1270,2,307.45,37,3,20,38.45396872632831,0.6016328828828829,46.68311403508771,1013.2675438596484,27.38560929350401,0
4592,4,0,0,40,0.0,0.0,1.0,40,1050,1000,50,0.9523809523809523,11,10,1,323.9389922744299,0.4249599358974359,0.1605991147644641,0.1763543945893322,128469.25593770527,323.24026134119913,128792.49619904647,1271,3,308.45,38,2,18,38.34439877753185,0.6011513157894737,46.55448717948717,1013.7820512820498,26.678475033738152,0
4593,4,0,0,40,0.0,0.0,1.0,40,1050,800,250,0.7619047619047619,13,8,5,323.9389922744299,0.4249599358974359,0.1605991147644641,0.1763543945893322,128469.25593770527,323.24026134119913,128792.49619904647,1272,4,309.45,38,2,18,38.34439877753185,0.6011513157894737,46.55448717948717,1013.7820512820498,26.678475033738152,0
4594,4,0,0,40,0.0,0.0,1.0,40,1050,800,250,0.7619047619047619,13,8,5,325.67314653953076,0.4248931623931624,0.1655815423514546,0.1776603164915645,128550.50131492417,373.08925049307425,128923.59056541724,1273,5,310.45,38,2,18,38.217709650231775,0.6019736842105263,46.474358974358964,1014.1025641025623,26.686909581646375,0
4595,4,0,1,39,0.0,0.025,0.975,40,1300,1000,300,0.7692307692307693,16,10,6,328.5323346361773,0.4248931623931624,0.17304128053917434,0.17970870101988104,128658.86843450925,453.71968368760713,129112.58811819686,1274,6,311.45,38,2,18,38.0348743330525,0.6030701754385965,46.367521367521356,1014.5299145299128,26.69815564552402,0
4596,4,1,0,40,0.025,0.0,1.0,40,900,400,500,0.4444444444444444,14,4,10,331.91889196675925,0.42554754273504275,0.18295789473684265,0.1820571289656009,128767.28121119122,548.0586602381206,129315.33987142934,1275,0,312.275,38,2,19,37.83859649122805,0.6041666666666667,46.26068376068375,1014.957264957263,26.709401709401657,0
4597,4,0,1,39,0.0,0.025,0.975,40,950,600,350,0.631578947368421,13,6,7,330.0465239445821,0.4256677350427351,0.17948373855383637,0.18115378532625484,128794.39153928323,501.6282462195752,129296.01978550281,1276,1,313.275,38,2,19,37.858514893169115,0.6044407894736843,46.23397435897435,1015.0641025641015,26.71221322537109,0
4598,4,3,0,42,0.07142857142857142,0.0,1.0,42,1250,800,450,0.64,17,8,9,320.7351848952565,0.4344754161827333,0.1957373979696322,0.1785803771771425,129360.29188368077,-101.27851999093957,129259.01336368982,1277,0,299.07142857142856,39,3,22,37.520052563314906,0.608440170940171,45.67708333333334,1017.2916666666683,26.084401709401753,0
4599,4,0,1,41,0.0,0.023809523809523808,0.9761904761904762,42,1150,900,250,0.782608695652174,14,9,5,324.99856640343404,0.4343423344947735,0.20053548893209228,0.18180944415917344,129545.80213758674,20.43999565971717,129566.24213324646,1278,1,300.07142857142856,39,3,18,37.22340888161261,0.610309829059829,45.494791666666664,1018.0208333333328,26.103098290598275,0
4600,4,1,0,42,0.023809523809523808,0.0,1.0,42,1150,900,250,0.782608695652174,14,9,5,325.81830955875887,0.43379790940766555,0.2086376472879543,0.1831323602002679,129731.4453125,53.7760416666666,129785.22135416667,1279,0,301.0238095238095,39,3,20,37.01431492842535,0.6121794871794872,45.3125,1018.75,26.121794871794872,0
4601,4,0,0,42,0.0,0.0,1.0,42,950,500,450,0.5263157894736842,14,5,9,325.5245833451919,0.43381000774293454,0.21861693067620513,0.18358836011715876,129864.12896050356,54.793294270843944,129918.9222547744,1280,1,302.0238095238095,39,3,20,36.88734883324816,0.6135149572649572,45.18229166666667,1019.270833333334,26.135149572649592,0
4602,4,1,1,42,0.023255813953488372,0.023255813953488372,0.9767441860465116,43,1150,800,350,0.6956521739130435,15,8,7,320.31073725930764,0.4337855297157623,0.22119373684039623,0.18263400334485097,130290.57167830497,-251.47513086958304,130039.09654743539,1281,0,295.9767441860465,37,6,21,36.58877940070884,0.6213400900900901,44.76425438596492,1020.9429824561413,27.59305357989571,0
4603,4,1,0,43,0.023255813953488372,0.0,1.0,43,1450,1100,350,0.7586206896551724,18,11,7,318.8002305366494,0.43193983019564414,0.22184339350549198,0.1826654646268414,130480.80490037639,-280.53786343047256,130200.26703694591,1282,0,296.8139534883721,38,5,22,36.43513193209942,0.6214364035087719,44.57799145299146,1021.6880341880355,26.88652721547462,0
4604,4,1,0,44,0.022727272727272728,0.0,1.0,44,950,500,450,0.5263157894736842,14,5,9,310.3462561387719,0.43374515503875966,0.21445024570024507,0.1790897202855853,130755.83316808812,-684.0833415955766,130071.74982649255,1283,0,291.04545454545456,40,4,20,36.37366686539482,0.6208333333333333,44.30894308943091,1022.7642276422791,25.56910569105698,0
4605,4,0,0,44,0.0,0.0,1.0,44,1700,1400,300,0.8235294117647058,20,14,6,308.77277191496364,0.43360200845665964,0.2058407132959812,0.17910855517505592,130955.93268320749,-712.8747333393075,130243.05794986818,1284,1,292.04545454545456,42,2,20,36.212289753542244,0.6197916666666667,44.11337209302327,1023.5465116279097,24.370155038759755,0
4606,4,0,0,44,0.0,0.0,1.0,44,1000,800,200,0.8,12,8,4,302.3594867189311,0.4333927942212826,0.1155450374480893,0.17011538798226733,129770.27253123143,-869.9322394470842,128900.34029178435,1285,2,293.04545454545456,40,4,16,37.57251978190036,0.6109375,45.27439024390244,1018.9024390243904,25.47256097560976,8
4607,4,0,1,43,0.0,0.022727272727272728,0.9772727272727273,44,750,300,450,0.4,12,3,9,303.2245651545439,0.43315054615926707,0.11852268194509974,0.17082786176234646,129822.05119307293,-926.9529959019039,128895.09819717103,1286,3,294.04545454545456,40,4,17,37.49813023534106,0.6114583333333333,45.22357723577236,1019.1056910569107,25.477642276422767,0
4608,4,0,1,42,0.0,0.023255813953488372,0.9767441860465116,43,650,500,150,0.7692307692307693,8,5,3,309.15587108099385,0.4302556293835364,0.11906308580337455,0.17370955446837907,129718.50419723714,-579.3525679159179,129139.15162932122,1287,4,301.6744186046512,40,3,17,37.45178238893323,0.6104166666666666,45.32520325203252,1018.6991869918702,25.467479674796756,0
4609,4,0,1,41,0.0,0.023809523809523808,0.9761904761904762,42,1150,800,350,0.6956521739130435,15,8,7,312.33016453648486,0.42603077816492446,0.13944674076562436,0.17567000226172252,129757.97661675327,-294.5339626736356,129463.44265407963,1288,5,309.6190476190476,39,3,17,37.330986095491255,0.6124465811965811,45.28645833333332,1018.8541666666649,26.124465811965766,0
4610,4,0,1,40,0.0,0.024390243902439025,0.975609756097561,41,1050,400,650,0.38095238095238093,17,4,13,320.2419575617822,0.42385670731707314,0.1400880661842807,0.1802420499924827,129784.51063368037,112.48914930553548,129896.9997829859,1289,6,317.1219512195122,39,2,17,37.10258638315271,0.6127136752136753,45.26041666666666,1018.9583333333319,26.127136752136714,0
4611,4,0,0,40,0.0,0.0,1.0,40,1700,1500,200,0.8823529411764706,19,15,4,328.7069082614523,0.4203392094017094,0.14136954697986592,0.18482011068285412,129745.05077069158,529.6189002118242,130274.6696709034,1290,8,325.9,38,2,17,36.926952251118564,0.6140350877192983,45.29914529914529,1018.8034188034171,26.81061628430045,0
4612,4,0,0,40,0.0,0.0,1.0,40,1150,800,350,0.6956521739130435,15,8,7,330.8519169394156,0.4202457264957265,0.14899098437991443,0.1864144380203828,129826.69850107728,590.6824137993783,130417.38091487666,1291,9,326.9,38,2,17,36.789539434601814,0.6148574561403508,45.21901709401708,1019.1239316239298,26.819050832208678,0
4613,4,1,1,40,0.024390243902439025,0.024390243902439025,0.975609756097561,41,850,400,450,0.47058823529411764,13,4,9,338.1102623048501,0.42009654471544716,0.18468474527030487,0.19292924784884052,130320.07250071019,614.7023200135197,130934.7748207237,1292,0,319.9024390243902,36,5,19,36.10460093378919,0.6235532407407407,44.73536036036036,1021.0585585585586,28.36273773773774,0
4614,4,0,1,39,0.0,0.025,0.975,40,1000,700,300,0.7,13,7,6,344.1498443932644,0.41793536324786323,0.20169533575917997,0.19666634775063102,130377.57087746532,973.8841459702999,131351.4550234356,1293,1,328.65,36,4,19,35.89218767229022,0.6241319444444444,44.679054054054056,1021.283783783784,28.368993993994,0
4615,4,0,0,39,0.0,0.0,1.0,39,1300,1100,200,0.8461538461538461,15,11,4,323.80549768537173,0.41686347278452546,0.12635641918867968,0.1743837111752998,128036.38100162528,495.22938015443697,128531.61038177973,1294,2,305.53846153846155,38,1,18,38.788970407122,0.596765350877193,46.9818376068376,1012.0726495726486,26.633490778227596,8
4616,4,1,0,40,0.025,0.0,1.0,40,1300,1000,300,0.7692307692307693,16,10,6,317.1954916194346,0.4197516025641026,0.12809320727571638,0.17253378026543995,128434.73442925359,147.78374565973184,128582.51817491332,1295,0,298.875,39,1,14,38.5504444558627,0.5990918803418803,46.58854166666667,1013.6458333333343,25.99091880341883,0
4617,4,0,0,40,0.0,0.0,1.0,40,1050,600,450,0.5714285714285714,15,6,9,316.72131199435233,0.4195379273504274,0.1318310220852592,0.1727328836002816,128540.34423828153,142.2932942708623,128682.63753255238,1296,1,299.875,39,1,14,38.45499486389317,0.6001602564102564,46.484375000000014,1014.0625000000022,26.00160256410262,0
4618,4,0,0,40,0.0,0.0,1.0,40,1050,800,250,0.7619047619047619,13,8,5,318.04325185837916,0.41861645299145295,0.14183778234086208,0.1740304086011583,128672.41753472247,184.67881944446836,128857.09635416693,1297,2,300.875,39,1,16,38.287132101300486,0.6014957264957265,46.35416666666668,1014.5833333333353,26.014957264957314,0
4619,4,2,0,42,0.047619047619047616,0.0,1.0,42,1600,1200,400,0.75,20,12,8,331.5010590539257,0.42514759969028265,0.21043495398796308,0.17267741732808936,126688.3552144968,37.4422152366605,126725.79742973346,1298,0,287.5,38,4,18,39.973999787753385,0.5830592105263157,48.31730769230768,1006.7307692307672,26.492914979757032,7
4620,4,3,2,43,0.06666666666666667,0.044444444444444446,0.9555555555555556,45,1300,1000,300,0.7692307692307693,16,10,6,320.41767482365856,0.43411195286195287,0.23832165331008515,0.17060911116347016,127579.22620670559,-823.6301436834608,126755.59606302212,1299,0,269.26666666666665,40,5,16,39.34128021996446,0.5888020833333334,47.43394308943089,1010.2642276422758,25.256605691056897,0
4621,4,0,0,43,0.0,0.0,1.0,43,1250,700,550,0.56,18,7,11,335.82370854419264,0.4273255813953489,0.2326172081701765,0.1779696142475647,127388.43831041352,-43.98844418875876,127344.44986622476,1300,1,282.7906976744186,38,5,16,39.14744064627651,0.5901864035087719,47.62286324786325,1009.5085470085475,26.566014394961776,0
4622,4,0,1,42,0.0,0.023255813953488372,0.9767441860465116,43,1050,600,450,0.5714285714285714,15,6,9,339.20329369476127,0.4272332964193429,0.23202691535828102,0.18060283475099478,127577.25180802122,54.924802761358364,127632.17661078258,1301,2,283.7906976744186,38,5,19,38.86883989001691,0.5921052631578947,47.435897435897445,1010.2564102564118,26.585695006747677,0
4623,4,0,0,42,0.0,0.0,1.0,42,1750,1200,550,0.6857142857142857,23,12,11,338.16140522583623,0.4262485481997677,0.21759115793822925,0.18084966103145103,127756.25673284115,240.44706063407028,127996.70379347523,1302,3,287.6666666666667,37,5,19,38.712039045553134,0.5957207207207207,47.258771929824576,1010.964912280704,27.323376007586592,0
4624,4,0,0,42,0.0,0.0,1.0,42,900,500,400,0.5555555555555556,13,5,8,337.09511091080475,0.42612756484707703,0.21425050053826689,0.1806875605822019,127847.22792935965,219.3350956973079,128066.56302505695,1303,4,288.6666666666667,38,4,20,38.6459873934784,0.5948464912280702,47.168803418803435,1011.3247863247889,26.613810166441812,0
4625,4,2,1,43,0.045454545454545456,0.022727272727272728,0.9772727272727273,44,950,500,450,0.5263157894736842,14,5,9,325.16509899138276,0.4319613284002819,0.22244264274624803,0.17666186306026682,128388.03624260359,-449.8477335817032,127938.18850902189,1304,0,276.5,38,6,16,38.396057347670244,0.600328947368421,46.63461538461539,1013.4615384615388,26.67004048582997,0
4626,4,0,0,43,0.0,0.0,1.0,43,1400,1100,300,0.7857142857142857,17,11,6,330.7003242068177,0.4287559985234404,0.22203765227021055,0.17932341523890818,128311.11495844873,-113.49453678055045,128197.62042166818,1305,1,283.93023255813955,37,6,21,38.334235209235196,0.6013513513513513,46.71052631578947,1013.157894736842,27.38264580369843,0
4627,4,0,0,43,0.0,0.0,1.0,43,1150,800,350,0.6956521739130435,15,8,7,334.5253496766853,0.42905592469545956,0.22691838454475755,0.18202983271106238,128450.01737313381,-6.042604455239086,128443.97476867857,1306,2,284.93023255813955,37,6,16,38.09570488552371,0.602759009009009,46.57346491228069,1013.7061403508753,27.39746325272636,0
4628,4,0,1,42,0.0,0.023255813953488372,0.9767441860465116,43,1250,800,450,0.64,17,8,9,335.0860113025469,0.42887135474344773,0.22835358493602675,0.18271671182346402,128533.39489073533,13.948522622314215,128547.34341335765,1307,3,285.93023255813955,37,6,17,37.996503748558254,0.6036036036036037,46.491228070175424,1014.035087719296,27.406353722143137,0
4629,4,0,0,42,0.0,0.0,1.0,42,1100,900,200,0.8181818181818182,13,9,4,333.77742170681995,0.42899487030584593,0.2184524436288151,0.18270225786453403,128685.96734832702,190.4940782745128,128876.46142660153,1308,4,286.26190476190476,38,4,17,37.87424098838228,0.6033442982456141,46.34081196581196,1014.6367521367513,26.700967161493455,0
4630,4,0,0,42,0.0,0.0,1.0,42,1000,700,300,0.7,13,7,6,336.63778393351794,0.428837591947348,0.21548872180451117,0.18464543576030146,128767.28121119148,269.58643801592615,129036.86764920742,1309,5,287.26190476190476,38,4,17,37.71885964912281,0.6041666666666667,46.26068376068376,1014.9572649572651,26.709401709401714,0
4631,4,2,0,44,0.045454545454545456,0.0,1.0,44,1350,1100,250,0.8148148148148148,16,11,5,318.4041758980333,0.43274312896405914,0.2135544635544635,0.17752123231575284,129413.28125000001,-558.1236531156396,128855.15759688437,1310,0,275.15909090909093,39,5,19,37.525593775593784,0.608974358974359,45.625,1017.5000000000001,26.08974358974359,0
4632,4,0,2,42,0.0,0.045454545454545456,0.9545454545454546,44,1300,900,400,0.6923076923076923,17,9,8,315.68471157032633,0.43330470401691334,0.20992780119276855,0.17636108157539498,129492.78564453126,-624.2214626736093,128868.56418185766,1311,1,276.15909090909093,39,5,16,37.51417886262068,0.609775641025641,45.546875,1017.8125000000001,26.097756410256412,0
4633,4,1,0,43,0.023255813953488372,0.0,1.0,43,1050,700,350,0.6666666666666666,14,7,7,321.2609973403513,0.434546880767811,0.2121260192264982,0.1797590160690668,129554.6392746914,-275.8294753086364,129278.80979938277,1312,0,278.30232558139534,38,5,18,37.30957253296953,0.6121162280701755,45.486111111111114,1018.055555555556,26.79093567251463,0
4634,4,0,0,43,0.0,0.0,1.0,43,1000,600,400,0.6,14,6,8,323.9337019512779,0.4344084533038022,0.20908762650167367,0.181631532176446,129636.22708013741,-201.29141098691747,129434.9356691505,1313,1,279.30232558139534,38,5,19,37.15882466079172,0.6129385964912281,45.40598290598291,1018.3760683760689,26.799370220422865,0
4635,4,0,0,43,0.0,0.0,1.0,43,1050,600,450,0.5714285714285714,15,6,9,323.3545311162787,0.4346391657438169,0.20789273450913104,0.18181066089179443,129745.05077069181,-209.26998867703577,129535.78078201477,1314,2,280.30232558139534,38,5,19,37.06327775447429,0.6140350877192983,45.2991452991453,1018.8034188034189,26.810616284300497,0
4636,4,0,0,43,0.0,0.0,1.0,43,950,600,350,0.631578947368421,13,6,7,324.3067916617224,0.43415466961978594,0.20879040514845704,0.18285382934118383,129853.92011834319,-177.49835634450736,129676.42176199867,1315,3,281.30232558139534,38,5,19,36.92872117400421,0.6151315789473684,45.19230769230769,1019.2307692307692,26.821862348178136,0
4637,4,0,0,43,0.0,0.0,1.0,43,1350,1100,250,0.8148148148148148,16,11,5,328.1817707150447,0.43380860095976376,0.21109235838648632,0.18620366776933844,130099.04308431971,-60.77313445099733,130038.26994986871,1316,4,282.30232558139534,38,5,20,36.58171012671484,0.6175986842105263,44.95192307692309,1020.1923076923092,26.847165991902873,0
4638,4,0,0,43,0.0,0.0,1.0,43,1050,700,350,0.6666666666666666,14,7,7,329.3122332769369,0.4331164636397195,0.21261832417903404,0.18723752692031595,130180.80210387928,-25.973865877689633,130154.82823800159,1317,5,283.30232558139534,38,5,20,36.4701109715243,0.618421052631579,44.87179487179488,1020.5128205128226,26.85560053981112,0
4639,4,0,0,43,0.0,0.0,1.0,43,1550,1200,350,0.7741935483870968,19,12,7,331.011646522393,0.4329549649317091,0.2218302094818081,0.18929858978298245,130406.32482144295,33.25382345001458,130439.57864489296,1318,6,284.30232558139534,36,7,21,36.19854832782064,0.6244212962962963,44.65090090090089,1021.3963963963954,28.372122122122093,0
4640,4,0,0,43,0.0,0.0,1.0,43,1250,900,350,0.72,16,9,7,329.4338425578094,0.433139534883721,0.2169927605868407,0.18909627585149386,130550.14209733364,1.5269915185191962,130551.66908885216,1319,7,285.30232558139534,36,7,18,36.09343434343433,0.6258680555555556,44.51013513513512,1021.959459459458,28.387762762762723,0
4641,4,1,0,44,0.022727272727272728,0.0,1.0,44,900,500,400,0.5555555555555556,13,5,8,320.8797369363258,0.43555100422832976,0.21703406242879963,0.18555219570665787,130835.79881656799,-403.48865877712996,130432.31015779085,1320,0,279.79545454545456,38,6,19,36.02365288220551,0.625,44.230769230769226,1023.0769230769225,26.92307692307691,0
4642,4,0,0,44,0.0,0.0,1.0,44,1150,700,450,0.6086956521739131,16,7,9,318.7027658004827,0.43516560958421424,0.2152591454952535,0.18486265506231092,130954.69292534732,-452.8754340277733,130501.81749131955,1321,1,280.79545454545456,39,5,19,35.95944433136576,0.624465811965812,44.114583333333336,1023.5416666666674,26.24465811965814,0
4643,4,0,1,43,0.0,0.022727272727272728,0.9772727272727273,44,1700,1200,500,0.7058823529411765,22,12,10,319.2378914502456,0.4346590909090909,0.2168984392336717,0.18594472445135146,131114.67013888876,-428.64583333334394,130686.02430555542,1322,2,281.79545454545456,39,5,20,35.78451315432601,0.6260683760683761,43.95833333333333,1024.1666666666656,26.260683760683733,0
4644,4,0,0,43,0.0,0.0,1.0,43,1050,700,350,0.6666666666666666,14,7,7,327.38827163491294,0.4322166851236619,0.21458509182990348,0.19093666353014235,131163.91354372096,-11.694608810024704,131152.21893491092,1323,3,289.1162790697674,38,5,20,35.526178556528976,0.6282894736842105,43.910256410256395,1024.3589743589723,26.956815114709798,0
4645,4,0,0,43,0.0,0.0,1.0,43,950,500,450,0.5263157894736842,14,5,9,325.1768035191739,0.4319859726836471,0.2109972285063766,0.19005306048460635,131246.00643080182,-64.36863083500657,131181.63779996682,1324,4,290.1162790697674,38,5,20,35.500078198310916,0.6291118421052632,43.83012820512819,1024.6794871794848,26.96524966261802,0
4646,4,1,0,44,0.022727272727272728,0.0,1.0,44,1000,700,300,0.7,13,7,6,322.84407188253334,0.4335139182522903,0.22307692307692273,0.19077149702149696,131665.51246537396,-298.46260160158926,131367.04986377238,1325,0,284.5,37,7,18,35.137553418803414,0.6351351351351351,43.421052631578945,1026.3157894736842,27.738264580369844,0
4647,4,0,0,44,0.0,0.0,1.0,44,1350,800,550,0.5925925925925926,19,8,11,323.6612282004124,0.43306245595489784,0.22572617533091832,0.19139562584864564,131693.64762474992,-275.17445271622387,131418.4731720337,1326,1,285.5,37,7,18,35.08828739807,0.6354166666666667,43.39364035087719,1026.4254385964912,27.74122807017544,0
4648,4,1,0,45,0.022222222222222223,0.0,1.0,45,1150,700,450,0.6086956521739131,16,7,9,332.35869906019565,0.43444865319865317,0.13325647893850512,0.19345283424871457,131088.00048828154,-272.5442038054676,130815.45628447608,1327,0,280.1333333333333,39,6,16,35.47547299359171,0.625801282051282,43.984375000000014,1024.0625000000023,26.258012820512878,8
4649,4,0,1,44,0.0,0.022222222222222223,0.9777777777777777,45,950,600,350,0.631578947368421,13,6,7,372.74194030663114,0.43436447811447815,0.038715816769558486,0.2172041462510441,131131.51552641173,827.2978374355297,131958.81336384726,1328,1,281.1333333333333,37,8,15,34.39752613924276,0.6297860360360361,43.94188596491227,1024.232456140349,27.68195827406349,8
4650,4,0,0,44,0.0,0.0,1.0,44,1300,900,400,0.6923076923076923,17,9,8,385.2457547518136,0.4318071705426357,0.0429387310501963,0.2247967050017476,131183.87972009153,1307.6065508075471,132491.48627089907,1329,4,288.5,36,8,15,34.024266241618115,0.6322337962962963,43.89076576576576,1024.4369369369356,28.456581581581545,0
4651,4,0,1,43,0.0,0.022727272727272728,0.9772727272727273,44,800,600,200,0.75,10,6,4,385.1532186516852,0.43158694503171247,0.04591918303723097,0.22491168057079783,131212.72243527306,1307.4004747991148,132520.12291007218,1330,5,289.5,36,8,16,33.997398695684026,0.6325231481481481,43.86261261261261,1024.549549549549,28.459709709709696,0
4652,4,0,1,42,0.0,0.023255813953488372,0.9767441860465116,43,1550,1200,350,0.7741935483870968,19,12,7,389.3653382387858,0.42930970837947585,0.06288052699870228,0.22770414166223282,131268.81456832972,1622.305276920417,132891.11984525013,1331,11,297.1162790697674,35,8,17,33.83263684963482,0.6351190476190476,43.80787037037036,1024.768518518517,29.27910052910049,0
4653,4,0,0,42,0.0,0.0,1.0,42,1250,800,450,0.64,17,8,9,389.97950955119325,0.4284020518776616,0.062137049941928035,0.2284165698799844,131328.12499999988,1843.0689514746086,133171.1939514745,1332,12,300.8095238095238,34,8,17,33.75677506775068,0.6378676470588236,43.74999999999999,1024.999999999999,30.147058823529385,0
4654,4,1,1,42,0.023255813953488372,0.023255813953488372,0.9767441860465116,43,1050,800,250,0.7619047619047619,13,8,5,385.94011217294354,0.4293558508674788,0.07319759574535056,0.2281677943166441,131684.26890432087,1564.4483024691228,133248.71720679,1333,0,294.7906976744186,35,8,15,33.499661705006766,0.6392857142857142,43.40277777777777,1026.388888888888,29.3253968253968,0
4655,4,0,1,41,0.0,0.023809523809523808,0.9761904761904762,42,1450,1300,150,0.896551724137931,16,13,3,395.66453539980523,0.4266719899341851,0.07321801371905745,0.2339793980944525,131694.4515306122,2021.3647959183595,133715.81632653056,1334,1,302.5,34,8,15,33.23982254697287,0.6415441176470589,43.39285714285714,1026.4285714285709,30.189075630252084,0
4656,4,0,0,41,0.0,0.0,1.0,41,1100,800,300,0.7272727272727273,14,8,6,395.5083398009348,0.42527947154471546,0.08669628353003489,0.23434008987639543,131768.13755526723,2223.079464628987,133991.2170198962,1335,2,308.9268292682927,33,8,15,33.16921301822232,0.6445707070707071,43.32107843137255,1026.7156862745098,31.112596553773024,0
4657,4,1,0,42,0.023809523809523808,0.0,1.0,42,1500,1000,500,0.6666666666666666,20,10,10,390.24887534445634,0.42623644986449866,-0.04347685977045679,0.2303835554814688,131629.4461451711,1873.6486640733233,133503.09480924442,1336,0,302.54761904761904,38,4,15,33.44460350511886,0.6329495614035088,43.45619658119657,1026.175213675212,27.00461088618979,8
4658,4,0,1,41,0.0,0.023809523809523808,0.9761904761904762,42,1150,800,350,0.6956521739130435,15,8,7,388.24628456295255,0.42583720480061943,-0.03631282283301296,0.2302136419732436,131797.29327781074,1833.9618861127553,133631.2551639235,1337,1,303.54761904761904,40,2,16,33.32611671945104,0.63125,43.292682926829265,1026.8292682926822,25.670731707317053,0
4659,4,1,0,42,0.023809523809523808,0.0,1.0,42,900,500,400,0.5555555555555556,13,5,8,386.59961886388203,0.42870451025938827,-0.03224333813383029,0.23145650554229316,132162.78029777235,1818.8160982219435,133981.5963959943,1338,0,289.8095238095238,40,2,17,32.99894577320947,0.6348958333333333,42.93699186991869,1028.252032520324,25.706300813008102,0
4660,4,0,1,41,0.0,0.023809523809523808,0.9761904761904762,42,1350,800,550,0.5925925925925926,19,8,11,386.16353320940783,0.4286319202477739,-0.03483689464720885,0.23183554467055895,132267.29811124317,1815.3614333399287,134082.6595445831,1339,1,290.8095238095238,40,2,17,32.904605479812936,0.6359375,42.83536585365853,1028.6585365853648,25.71646341463412,0
4661,4,0,1,40,0.0,0.024390243902439025,0.975609756097561,41,1350,1000,350,0.7407407407407407,17,10,7,389.0427816055122,0.4264735772357724,-0.020104970669959643,0.23354391904890154,132264.03130425338,2091.2733289930507,134355.30463324644,1340,2,298.1951219512195,39,2,17,32.833860759493675,0.6375534188034189,42.838541666666664,1028.6458333333328,26.375534188034173,0
4662,4,0,1,39,0.0,0.025,0.975,40,1200,900,300,0.75,15,9,6,385.9349707246387,0.42570779914529916,-0.0036798947155292083,0.2321720853116919,132344.40646701382,2215.266927083328,134559.67339409713,1341,3,305.525,39,1,17,32.83264156036986,0.6383547008547008,42.760416666666664,1028.9583333333328,26.383547008546994,0
4663,4,0,0,39,0.0,0.0,1.0,39,1400,1100,300,0.7857142857142857,17,11,6,382.4460566834456,0.4236954565901934,0.006499695497458768,0.23091871551131016,132482.65241468544,2333.504449686453,134816.15686437188,1342,4,313.4102564102564,37,2,18,32.78293304221252,0.6432995495495495,42.626096491228076,1029.4956140350887,27.824205784732126,0
4664,4,0,0,39,0.0,0.0,1.0,39,1350,1000,350,0.7407407407407407,17,10,7,379.6764383577938,0.42327372919478184,0.006833967877076352,0.23028148085032124,132652.0314543899,2272.9701687057645,134925.00162309565,1343,5,314.4102564102564,37,2,16,32.68349742770979,0.6449887387387387,42.46162280701755,1030.1535087719303,27.841986723565686,0
4665,4,1,0,40,0.025,0.0,1.0,40,700,500,200,0.7142857142857143,9,5,4,373.4625114093696,0.4243189102564102,0.017495338719702325,0.22847953644778565,132975.88962853397,1932.3019395134936,134908.19156804748,1344,0,307.525,38,2,18,32.517609281127015,0.6463815789473684,42.147435897435905,1031.4102564102573,27.14237516869098,0
4666,4,0,0,40,0.0,0.0,1.0,40,1050,700,350,0.6666666666666666,14,7,7,370.9509670576324,0.42394497863247865,0.014925450403810325,0.2276140050725934,133086.10586054518,1873.6839341807563,134959.78979472595,1345,1,308.525,38,2,18,32.4715693380272,0.6474780701754386,42.040598290598304,1031.8376068376087,27.15362123256865,0
4667,4,0,0,40,0.0,0.0,1.0,40,1100,700,400,0.6363636363636364,15,7,8,368.2466287189545,0.4236111111111111,0.010425939343753132,0.22645644048719454,133168.79799702344,1807.7921825918904,134976.59017961533,1346,2,309.525,38,2,18,32.45825138874512,0.6483004385964912,41.9604700854701,1032.158119658122,27.16205578047689,0
4668,4,0,0,40,0.0,0.0,1.0,40,1700,1300,400,0.7647058823529411,21,13,8,362.62690333950695,0.4220486111111111,0.019213465715171907,0.22432754500254004,133389.43591798196,1674.1196170283083,135063.55553501027,1347,3,310.525,38,2,19,32.3818388664805,0.6504934210526316,41.74679487179489,1033.0128205128235,27.184547908232197,0
4669,4,0,0,40,0.0,0.0,1.0,40,1000,600,400,0.6,14,6,8,364.0147523211057,0.4215277777777778,0.022231063017186692,0.22603445687606988,133528.88028047085,1721.3221387190586,135250.2024191899,1348,4,311.525,37,3,19,32.20613197538722,0.6537162162162162,41.61184210526316,1033.552631578947,27.93385490753911,0
4670,4,0,1,39,0.0,0.025,0.975,40,1550,1300,250,0.8387096774193549,18,13,5,367.7534638779464,0.42064636752136747,0.02939024390243916,0.2290564837760261,133642.23246575872,1829.478781932909,135471.71124769162,1349,5,312.525,37,3,19,31.995846588900665,0.6548423423423424,41.502192982456144,1033.9912280701758,27.945708866761507,0
4671,4,0,0,39,0.0,0.0,1.0,39,650,400,250,0.6153846153846154,9,4,5,376.8719058671639,0.41877530364372473,0.03610971454108691,0.234395941453968,133588.6139517898,2269.159108432775,135857.77306022256,1350,6,320.2307692307692,36,3,19,31.813952432824983,0.65625,41.55405405405406,1033.783783783785,28.716216216216253,0
4672,4,0,1,38,0.0,0.02564102564102564,0.9743589743589743,39,1450,1000,450,0.6896551724137931,19,10,9,378.5523603104085,0.41869095816464236,0.035483627773729154,0.2359977138309899,133675.94103816655,2320.668599342589,135996.60963750913,1351,7,321.2307692307692,36,3,19,31.682865076772305,0.6571180555555556,41.4695945945946,1034.1216216216217,28.7256006006006,0
4673,4,0,2,36,0.0,0.05263157894736842,0.9473684210526316,38,800,500,300,0.625,11,5,6,386.0406005347862,0.4189781887150308,0.0298277040563788,0.24011940417665129,133591.8477794926,2714.3754286694198,136306.223208162,1352,8,314.7631578947368,35,3,20,31.5737423496044,0.6583333333333333,41.55092592592593,1033.7962962962972,29.537037037037063,0
4674,4,0,0,36,0.0,0.0,1.0,36,750,500,250,0.6666666666666666,10,5,5,376.58046224890586,0.4193287037037037,0.046829203304023403,0.216300348151231,130575.52984429065,2774.399239846022,133349.92908413667,1353,9,323.3888888888889,33,3,21,34.86310951239009,0.6325757575757576,44.48529411764706,1022.0588235294117,30.971479500891263,8
4675,4,0,1,35,0.0,0.027777777777777776,0.9722222222222222,36,1200,800,400,0.6666666666666666,16,8,8,371.8613288641175,0.4185681216931217,0.05096848856304237,0.21488933415799316,130810.03578514728,2528.6387471655175,133338.67453231278,1354,10,324.3888888888889,34,2,22,34.74582024128165,0.6326593137254901,44.25595238095237,1022.9761904761896,30.087535014005574,0
4676,4,1,1,35,0.027777777777777776,0.027777777777777776,0.9722222222222222,36,1200,900,300,0.75,15,9,6,369.131049040309,0.41977513227513225,0.0646319105533606,0.2155184401655971,131206.12953514748,2486.451247165538,133692.58078231302,1355,0,322.94444444444446,34,2,23,34.41445890464016,0.6366421568627452,43.86904761904762,1024.52380952381,30.13305322128853,0
4677,4,0,0,35,0.0,0.0,1.0,35,800,400,400,0.5,12,4,8,370.4427671149304,0.41834733893557424,0.07895929154939285,0.21005215214337064,130075.00120146098,2656.470602947064,132731.47180440804,1356,1,327.57142857142856,33,2,22,35.52829168668909,0.6275252525252526,44.97549019607843,1020.0980392156863,30.912061794414736,8
4678,4,0,0,35,0.0,0.0,1.0,35,800,500,300,0.625,11,5,6,371.89604103592865,0.4176470588235294,0.08436223877011706,0.21121462739871388,130137.51471789712,2679.5253027681806,132817.0400206653,1357,2,328.57142857142856,33,2,22,35.42767635519255,0.6281565656565656,44.91421568627452,1020.3431372549034,30.919489007724344,0
4679,4,0,0,35,0.0,0.0,1.0,35,900,600,300,0.6666666666666666,12,6,6,372.0116618075798,0.4180672268907563,0.08373177842565571,0.21196013289036544,130262.58680555568,2691.9003508266146,132954.4871563823,1358,3,329.57142857142856,32,3,22,35.297619047619044,0.6318359375,44.79166666666667,1020.8333333333344,31.9010416666667,0
4680,4,0,0,35,0.0,0.0,1.0,35,1050,700,350,0.6666666666666666,14,7,7,374.09526367230484,0.4184173669467787,0.08666807969478563,0.213678142131469,130359.27456382003,2753.3574380165255,133112.63200183655,1359,4,330.57142857142856,32,3,22,35.14620425321463,0.6328125,44.696969696969695,1021.2121212121212,31.91287878787879,0
4681,4,0,0,35,0.0,0.0,1.0,35,1350,1100,250,0.8148148148148148,16,11,5,375.41653574933486,0.4183823529411765,0.07222012815680334,0.21528356774951554,130512.91120001925,2799.340998654364,133312.2521986736,1360,5,331.57142857142856,33,2,19,34.95642440233469,0.6319444444444444,44.54656862745098,1021.8137254901964,30.96405228758171,0
4682,4,0,0,35,0.0,0.0,1.0,35,800,700,100,0.875,9,7,2,376.814582232829,0.4184173669467787,0.07402332711048709,0.21660995385279316,130606.8447982748,2842.91273188198,133449.75753015678,1361,6,332.57142857142856,33,2,19,34.82533569116412,0.6328914141414141,44.454656862745104,1022.1813725490205,30.975193107546076,0
4683,4,0,0,35,0.0,0.0,1.0,35,1350,1000,350,0.7407407407407407,17,10,7,361.9540731386786,0.41768207282913167,0.0533770706905039,0.1901459576018024,127033.66796339129,2196.0707090191627,129229.73867241044,1362,7,333.57142857142856,35,0,20,38.852372751626476,0.5922619047619048,47.97453703703702,1008.101851851849,28.802910052909972,8
4684,4,0,0,35,0.0,0.0,1.0,35,900,600,300,0.6666666666666666,12,6,6,362.17472413624034,0.4171218487394958,0.05335869226607248,0.1906724091479792,127121.1918751069,2208.016519847363,129329.20839495427,1363,8,334.57142857142856,35,0,20,38.75686235127587,0.5931547619047619,47.88773148148147,1008.4490740740719,28.812830687830626,0
4685,4,1,0,36,0.027777777777777776,0.0,1.0,36,900,700,200,0.7777777777777778,11,7,4,368.0217317753132,0.4197916666666666,0.08602040689971169,0.19621265592512657,127631.95363860458,2194.26652158913,129826.22016019371,1364,0,326.25,36,0,19,38.08485642111519,0.5963541666666667,47.381756756756744,1010.472972972971,28.06869369369364,0
4686,4,1,0,37,0.02702702702702703,0.0,1.0,37,1350,1100,250,0.8148148148148148,16,11,5,359.96661693638805,0.42279779779779775,0.09235454305876845,0.19384433339106535,128033.53555901808,1817.5597299168894,129851.09528893497,1365,0,318.4054054054054,37,0,21,37.87694113398338,0.5985360360360361,46.984649122807014,1012.0614035087714,27.35301090564247,0
4687,4,2,0,39,0.05128205128205128,0.0,1.0,39,1100,800,300,0.7272727272727273,14,8,6,346.312454845742,0.4289529914529915,0.10154506535501229,0.18929506027005116,128629.57552146731,1109.349088082605,129738.92460954991,1366,0,303.02564102564105,36,3,19,37.61378774422735,0.6064814814814814,46.39639639639639,1014.4144144144136,28.178178178178158,0
4688,4,1,0,40,0.025,0.0,1.0,40,1000,600,400,0.6,14,6,8,336.7222331680716,0.4308760683760684,0.10908899642331171,0.18545084290241506,128929.98598327102,682.7185605230235,129612.70454379404,1367,0,296.425,38,2,20,37.55106424012904,0.6058114035087719,46.10042735042734,1015.5982905982888,26.726270805218128,0
4689,4,0,0,40,0.0,0.0,1.0,40,1450,1200,250,0.8275862068965517,17,12,5,340.7637604151734,0.4301415598290598,0.11214373590321891,0.18821119587143845,129042.5835503473,794.6072048611165,129837.19075520842,1368,1,297.425,39,1,20,37.33382885653749,0.6052350427350428,45.989583333333336,1016.0416666666673,26.052350427350444,0
4690,4,0,0,40,0.0,0.0,1.0,40,1150,700,450,0.6086956521739131,16,7,9,341.2923550580879,0.4301682692307693,0.11429892989298907,0.18864467983558997,129072.27143441408,810.2758981095925,129882.54733252368,1369,2,298.425,40,0,20,37.29018735206852,0.60390625,45.96036585365854,1016.1585365853663,25.403963414634156,0
4691,4,0,0,40,0.0,0.0,1.0,40,900,600,300,0.6666666666666666,12,6,6,341.97796291319503,0.4301014957264957,0.11926229508196706,0.1896423248882266,129201.3888888891,836.8701046004559,130038.25899348955,1370,3,299.425,39,1,20,37.141393442622956,0.6068376068376069,45.83333333333334,1016.6666666666683,26.06837606837611,0
4692,4,1,1,40,0.024390243902439025,0.024390243902439025,0.975609756097561,41,850,400,450,0.47058823529411764,13,4,9,334.01410221821646,0.43173272357723574,0.12087386549366474,0.1865414498669967,129480.23069598335,449.6446021852846,129929.87529816864,1371,0,293.0975609756098,37,4,16,37.060529339941105,0.6131756756756757,45.55921052631579,1017.7631578947365,27.50711237553342,0
4693,4,0,0,40,0.0,0.0,1.0,40,1250,700,550,0.56,18,7,11,339.9918352321674,0.429553952991453,0.12307415605976724,0.18950192667011925,129401.8231702987,799.1126684116548,130200.93583871036,1372,5,301.425,36,4,21,36.9881018262313,0.6142939814814814,45.63626126126126,1017.4549549549552,28.262637637637642,0
4694,4,0,0,40,0.0,0.0,1.0,40,600,500,100,0.8333333333333334,7,5,2,343.12086251254266,0.42873931623931627,0.12850741314450076,0.19166417524031887,129487.7711326191,885.9911431701967,130373.7622757893,1373,6,302.425,36,4,19,36.82115327874898,0.615162037037037,45.5518018018018,1017.7927927927927,28.27202202202202,0
4695,4,0,0,40,0.0,0.0,1.0,40,1100,600,500,0.5454545454545454,16,6,10,343.9365908473007,0.4277911324786325,0.12731506406805249,0.19276639222684855,129619.76431450053,916.1959689519772,130535.9602834525,1374,7,303.425,37,3,19,36.6662853092136,0.6145833333333333,45.422149122807014,1018.3114035087713,27.521929824561386,0
4696,4,0,0,40,0.0,0.0,1.0,40,900,600,300,0.6666666666666666,12,6,6,344.89088847247046,0.4277377136752137,0.12441866724082251,0.19357652344536416,129675.5988020352,944.7864968067062,130620.3852988419,1375,8,304.425,37,3,19,36.58527559478956,0.6151463963963963,45.36732456140351,1018.5307017543856,27.527856804172586,0
4697,4,0,1,39,0.0,0.025,0.975,40,850,700,150,0.8235294117647058,10,7,3,342.42237469595983,0.4272702991452992,0.12442848154362474,0.19253182577244526,129745.0507706918,885.5216779896318,130630.57244868143,1376,9,305.425,38,2,19,36.57761814876961,0.6140350877192983,45.2991452991453,1018.8034188034188,26.810616284300494,0
4698,4,0,2,37,0.0,0.05128205128205128,0.9487179487179487,39,1050,800,250,0.7619047619047619,13,8,5,349.4816143219596,0.42676000899685107,0.058077446017033685,0.20000932009555195,130435.08193582106,1320.0230145786381,131755.1049503997,1377,10,311.7692307692308,36,3,20,35.69778230992541,0.6247106481481481,44.62274774774775,1021.5090090090098,28.37525025025027,8
4699,4,0,0,37,0.0,0.0,1.0,37,1000,500,500,0.5,15,5,10,365.4908713362584,0.42001376376376376,0.08721628238941981,0.20857053915176918,130323.35778061232,2126.399518140599,132449.75729875293,1378,12,329.05405405405406,34,3,21,35.402335704014625,0.6277573529411764,44.73214285714286,1021.0714285714292,30.031512605042035,0
4700,4,0,0,37,0.0,0.0,1.0,37,1400,1000,400,0.7142857142857143,18,10,8,389.13265226794203,0.4198886386386386,0.015374364141652164,0.21906824668977232,129793.87622849383,2776.59838751677,132570.4746160106,1379,13,330.05405405405406,33,4,19,35.33811886149529,0.6246843434343434,45.25122549019608,1018.9950980392155,30.87863933452168,8
4701,4,0,1,36,0.0,0.02702702702702703,0.972972972972973,37,1150,600,550,0.5217391304347826,17,6,11,385.7803254437871,0.4191691691691692,0.02423336798336817,0.2180497491638797,129950.01922337565,2626.432141484052,132576.4513648597,1380,14,331.05405405405406,33,4,20,35.26442307692309,0.6262626262626263,45.09803921568628,1019.6078431372551,30.89720736779561,0
4702,4,0,0,36,0.0,0.0,1.0,36,1400,1200,200,0.8571428571428571,16,12,4,394.204487726327,0.41673280423280423,0.038730650154798596,0.22275725950945355,129940.55333958272,3044.6298528211396,132985.18319240387,1381,15,340.8333333333333,32,4,20,35.05933952528379,0.6285807291666667,45.10732323232323,1019.5707070707073,31.861584595959602,0
4703,4,0,0,36,0.0,0.0,1.0,36,1250,1000,250,0.8,15,10,5,390.539507324988,0.4165674603174603,0.04132120612135415,0.22178143068821013,130133.7255924141,2964.472215845324,133098.19780825943,1382,16,341.8333333333333,32,4,20,34.955966670791554,0.6305338541666667,44.917929292929294,1020.3282828282834,31.885258838383855,0
4704,4,1,0,37,0.02702702702702703,0.0,1.0,37,600,400,200,0.6666666666666666,8,4,4,381.8043702368656,0.4201076076076076,0.04457498160268969,0.21876996801819576,130481.60750973182,2563.689596549406,133045.29710628124,1383,0,333.56756756756755,33,4,21,34.825051977130066,0.6316287878787878,44.57720588235294,1021.6911764705881,30.96033868092691,0
4705,4,0,0,37,0.0,0.0,1.0,37,1000,800,200,0.8,12,8,4,386.88483459151473,0.4194507007007007,0.0516309189448354,0.22275915631449283,130669.48596993914,2710.808493127609,133380.29446306673,1384,1,334.56756756756755,33,4,18,34.504349954053296,0.6335227272727273,44.39338235294116,1022.4264705882329,30.982620320855542,0
4706,4,0,0,37,0.0,0.0,1.0,37,900,500,400,0.5555555555555556,13,5,8,387.96089281195935,0.4192317317317317,0.04678813232784673,0.22410446867137893,130794.8133680556,2748.654513888894,133543.4678819445,1385,2,335.56756756756755,33,4,18,34.34954175152749,0.6347853535353536,44.270833333333336,1022.9166666666671,30.99747474747476,0
4707,4,1,0,38,0.02631578947368421,0.0,1.0,38,1350,1000,350,0.7407407407407407,17,10,7,374.61990704592245,0.42260846372688476,0.0663519859127375,0.21907120651163733,131267.12018140592,2235.055272108846,133502.17545351476,1386,0,327.7105263157895,34,4,19,34.21211857187112,0.6372549019607843,43.80952380952381,1024.7619047619048,30.140056022408967,0
4708,4,0,0,38,0.0,0.0,1.0,38,850,600,250,0.7058823529411765,11,6,5,378.0738989806458,0.422475106685633,0.0646081731525463,0.2216249590030205,131359.5300635573,2332.736112214493,133692.26617577177,1387,1,328.7105263157895,33,5,19,34.030060769077494,0.6404671717171717,43.71936274509804,1025.1225490196077,31.06431966726084,0
4709,4,0,0,38,0.0,0.0,1.0,38,1350,1100,250,0.8148148148148148,16,11,5,376.6494011410271,0.42203058321479375,0.05823685737850126,0.2214904157563104,131480.6990504535,2304.4253117913804,133785.12436224488,1388,2,329.7105263157895,34,4,20,33.94394467014897,0.6393995098039216,43.601190476190474,1025.5952380952378,30.164565826330524,0
4710,4,0,0,38,0.0,0.0,1.0,38,1200,1000,200,0.8333333333333334,14,10,4,379.2888248885969,0.42225284495021337,0.0592540348434607,0.22375704186959722,131602.8220663265,2383.095946712012,133985.91801303852,1389,3,330.7105263157895,34,4,15,33.752707197277324,0.640625,43.482142857142854,1026.0714285714282,30.178571428571416,0
4711,4,0,0,38,0.0,0.0,1.0,38,1000,500,500,0.5,15,5,10,377.01995379122,0.4215712422949265,0.061525553012966805,0.22349120972159964,131786.11288265313,2337.198837868485,134123.31172052163,1390,4,331.7105263157895,34,4,16,33.62560386473428,0.6424632352941176,43.30357142857143,1026.785714285715,30.19957983193279,0
4712,4,0,0,38,0.0,0.0,1.0,38,1050,600,450,0.5714285714285714,15,6,9,377.82856160769313,0.42111190137505927,0.06327376959199826,0.22487313701202707,131938.95266439908,2370.0609410430843,134309.01360544216,1391,5,332.7105263157895,34,4,17,33.45041521823099,0.6439950980392157,43.154761904761905,1027.3809523809523,30.21708683473389,0
4713,4,0,0,38,0.0,0.0,1.0,38,750,400,350,0.5333333333333333,11,4,7,375.4364165444829,0.42068219535324797,0.07269984457379697,0.22435248836412527,132091.8810232426,2318.4204931972763,134410.30151643988,1392,6,333.7105263157895,34,4,19,33.35745994981664,0.6455269607843137,43.00595238095238,1027.9761904761904,30.234593837535012,0
4714,4,0,1,37,0.0,0.02631578947368421,0.9736842105263158,38,1200,1000,200,0.8333333333333334,14,10,4,369.1982274519888,0.42094890943575153,0.06761695906432696,0.22151893647119328,132244.89795918367,2164.916383219949,134409.8143424036,1393,7,334.7105263157895,34,4,19,33.36347415123455,0.6470588235294117,42.857142857142854,1028.5714285714284,30.25210084033613,0
4715,4,1,0,38,0.02631578947368421,0.0,1.0,38,800,500,300,0.625,11,5,6,355.20605958812064,0.4205192034139402,0.07692733104745031,0.19884941081957916,129573.74762854095,1605.0760642399434,131178.8236927809,1394,0,335.42105263157896,36,2,15,36.426188106035454,0.6160300925925926,45.467342342342356,1018.1306306306327,28.281406406406465,8
4716,4,1,1,38,0.02564102564102564,0.02564102564102564,0.9743589743589743,39,1100,800,300,0.7272727272727273,14,8,6,346.3896902638345,0.4236673414304993,0.07746910005460217,0.1956701907699353,129927.00277970156,1201.0748499538463,131128.07762965542,1395,0,327.79487179487177,37,2,16,36.29185487918549,0.6176801801801801,45.120614035087726,1019.5175438596501,27.554528212422976,0
4717,4,2,1,39,0.05,0.025,0.975,40,1400,900,500,0.6428571428571429,19,9,10,331.8768469173845,0.42831196581196584,0.08617432374409684,0.1899118369706606,130430.54112803943,657.8081717451603,131088.3492997846,1396,0,318.125,37,3,18,36.15196078431374,0.6227477477477478,44.627192982456144,1021.4912280701757,27.607871028923668,0
4718,4,0,2,37,0.0,0.05128205128205128,0.9487179487179487,39,950,600,350,0.631578947368421,13,6,7,332.2790837665742,0.4271255060728745,0.07712442515080986,0.1887922384922397,130153.54624379062,849.4602189714354,131003.00646276206,1397,1,322.0,38,1,18,36.422015146756024,0.6181469298245614,44.89850427350427,1020.4059829059828,26.852789023841652,8
4719,4,0,0,37,0.0,0.0,1.0,37,850,600,250,0.7058823529411765,11,6,5,346.22413289699716,0.4215778278278279,0.10118651602259066,0.19639601877983087,130090.20580969493,1608.0737409707122,131698.27955066564,1398,2,337.2432432432432,36,1,18,36.13050557456673,0.6212384259259259,44.96058558558559,1020.1576576576584,28.337712712712733,0
4720,4,0,0,37,0.0,0.0,1.0,37,1400,1200,200,0.8571428571428571,16,12,4,345.998221818346,0.42170295295295296,0.09758599915298127,0.19670237679534844,130176.38204082476,1608.1593417742172,131784.54138259898,1399,3,338.2432432432432,36,1,19,36.04888545574927,0.6221064814814814,44.87612612612613,1020.4954954954967,28.34709709709713,0
4721,4,1,1,37,0.02631578947368421,0.02631578947368421,0.9736842105263158,38,1100,800,300,0.7272727272727273,14,8,6,341.1348263054963,0.4244310099573258,0.09671552959329865,0.19552219071824176,130492.605675777,1303.1430078727217,131795.74868364973,1400,0,330.3157894736842,36,2,16,35.85271317829458,0.6252893518518519,44.566441441441434,1021.7342342342332,28.38150650650648,0
4722,4,0,1,36,0.0,0.02702702702702703,0.972972972972973,37,1100,700,400,0.6363636363636364,15,7,8,351.6328513572785,0.42057682682682684,0.0986820153486827,0.2013897239591683,130463.84222059873,1775.0745678110286,132238.91678840976,1401,5,340.2432432432432,36,1,19,35.613701499118164,0.625,44.59459459459458,1021.6216216216196,28.378378378378322,0
4723,4,0,1,35,0.0,0.027777777777777776,0.9722222222222222,36,950,700,250,0.7368421052631579,12,7,5,359.20743640725993,0.42096560846560843,0.09093885363150989,0.20528798049596217,130380.76560356628,2166.748113854562,132547.51371742084,1402,6,333.8611111111111,35,1,19,35.50449531580536,0.6261904761904762,44.67592592592591,1021.2962962962944,29.179894179894124,0
4724,4,0,0,35,0.0,0.0,1.0,35,1150,700,450,0.6086956521739131,16,7,9,360.1649927064341,0.421218487394958,0.08599588923594848,0.20630606039063498,130469.43486636187,2398.104611411128,132867.539477773,1403,7,337.0285714285714,35,0,19,35.39011461047543,0.6270833333333333,44.589120370370345,1021.6435185185151,29.189814814814717,0
4725,4,0,0,35,0.0,0.0,1.0,35,1150,900,250,0.782608695652174,14,9,5,355.9427986819647,0.4206932773109244,-0.0072723718293339346,0.19520090066555013,128760.50407503854,2166.274836033941,130926.77891107248,1404,8,338.0285714285714,35,0,17,37.23593055080395,0.6098214285714285,46.26736111111111,1014.9305555555552,28.998015873015863,8
4726,4,0,0,35,0.0,0.0,1.0,35,850,600,250,0.7058823529411765,11,6,5,353.5673898750822,0.4197478991596639,-0.006329670329670467,0.19476169781254504,128936.7675781249,2117.56727430554,131054.33485243045,1405,9,339.0285714285714,35,0,18,37.116452991452995,0.6116071428571428,46.09374999999999,1015.6249999999992,29.01785714285712,0
4727,4,0,0,35,0.0,0.0,1.0,35,750,500,250,0.6666666666666666,10,5,5,353.373043305659,0.41946778711484595,-0.0030469245918716137,0.19494375871111042,128995.54887099187,2116.7099354852453,131112.25880647713,1406,10,340.0285714285714,35,0,18,37.061472219057386,0.6122023809523809,46.035879629629626,1015.8564814814808,29.02447089947088,0
4728,4,0,0,35,0.0,0.0,1.0,35,600,300,300,0.5,9,3,6,356.8751209777898,0.4201330532212885,-0.056729206677500144,0.18653959026244443,126829.56271701364,2052.4631076388664,128882.0258246525,1407,11,341.0285714285714,35,0,18,39.1901499482937,0.5901785714285714,48.17708333333332,1007.2916666666647,28.77976190476185,8
4729,4,1,0,36,0.027777777777777776,0.0,1.0,36,950,800,150,0.8421052631578947,11,8,3,348.893561281912,0.4257936507936508,-0.05352271534991093,0.18382004049629092,127152.04081632651,1673.0482036564563,128825.08901998296,1408,0,332.52777777777777,34,2,20,39.060040919106065,0.5955882352941176,47.857142857142854,1008.5714285714284,29.663865546218485,0
4730,4,2,1,37,0.05263157894736842,0.02631578947368421,0.9736842105263158,38,1000,700,300,0.7,13,7,6,333.27240440275625,0.43018018018018017,-0.03503692415894932,0.1785671951990901,127831.16731596454,920.5200978004993,128751.68741376504,1409,0,315.9736842105263,36,2,17,38.7590478841871,0.5983796296296297,47.18468468468468,1011.2612612612606,28.090590590590573,0
4731,4,2,1,38,0.05128205128205128,0.02564102564102564,0.9743589743589743,39,850,600,250,0.7058823529411765,11,6,5,323.71267002671385,0.4311178587494377,0.00868106114185041,0.1761461821304867,128450.01737313403,516.1796177669983,128966.19699090104,1410,0,308.46153846153845,37,2,15,38.36972687939425,0.602759009009009,46.5734649122807,1013.7061403508771,27.39746325272641,0
4732,4,0,0,38,0.0,0.0,1.0,38,1150,1000,150,0.8695652173913043,13,10,3,333.5083008288512,0.42860953058321477,0.009857458576456368,0.18151400991906427,128458.27880245139,968.3804581608956,129426.65926061229,1411,1,317.2105263157895,36,2,15,38.11305820928683,0.6047453703703703,46.56531531531533,1013.7387387387411,28.159409409409474,0
4733,4,0,1,37,0.0,0.02631578947368421,0.9736842105263158,38,850,700,150,0.8235294117647058,10,7,3,339.9421737476514,0.4294541251778094,-0.008779765402788131,0.17908953576964493,127148.79575521457,1185.79698786623,128334.5927430808,1412,2,318.2105263157895,36,2,18,39.28907064165549,0.5914351851851851,47.86036036036035,1008.5585585585577,28.015515515515492,8
4734,4,2,1,38,0.05128205128205128,0.02564102564102564,0.9743589743589743,39,1150,800,350,0.6956521739130435,15,8,7,332.28367934992286,0.4306117858749438,0.016448539886040114,0.17721796231995887,127645.42936288082,682.8985841797398,128328.32794706056,1413,0,310.9230769230769,37,2,16,38.973885995370374,0.5945945945945945,47.368421052631575,1010.5263157894731,27.311522048364136,0
4735,4,2,0,40,0.05,0.0,1.0,40,1550,1100,450,0.7096774193548387,20,11,9,322.3862240486898,0.4339075854700855,0.0224714949324325,0.17350240421529478,128009.35057345306,253.690234860099,128263.04080831316,1414,0,304.1,38,2,18,38.85245108389638,0.5964912280701755,47.008547008547005,1011.9658119658113,26.630679262258194,0
4736,4,1,0,41,0.024390243902439025,0.0,1.0,41,750,600,150,0.8,9,6,3,315.36137745788153,0.43645833333333334,0.03750327825858868,0.1713355112580448,128388.03624260347,-102.20306907006727,128285.8331735334,1415,0,297.6585365853659,38,3,11,38.64444971537001,0.600328947368421,46.63461538461538,1013.4615384615379,26.670040485829944,0
4737,4,1,2,40,0.023809523809523808,0.047619047619047616,0.9523809523809523,42,850,300,550,0.35294117647058826,14,3,11,313.1268913083443,0.43792344173441733,0.05182791286207711,0.1721403163893083,128857.43408203141,-330.25444878470853,128527.1796332467,1416,0,291.54761904761904,39,3,13,38.2238338292124,0.6033653846153846,46.17187500000001,1015.3125000000013,26.03365384615388,0
4738,4,1,0,41,0.024390243902439025,0.0,1.0,41,1050,600,450,0.5714285714285714,15,6,9,313.1438641877029,0.4347560975609756,0.05597254875733726,0.1696702925844457,128279.78326576091,-42.923305137215436,128236.8599606237,1417,0,299.5365853658537,38,3,21,38.81081698657105,0.5992324561403508,46.741452991452995,1013.0341880341887,26.658794421952333,8
4739,4,1,0,42,0.023809523809523808,0.0,1.0,42,1200,800,400,0.6666666666666666,16,8,8,309.96810441578316,0.4367378048780488,0.08458772130647185,0.1696667518907447,128685.30636525892,-422.3319039592652,128262.97446129966,1418,0,293.3809523809524,40,2,15,38.478857839209404,0.6,46.341463414634156,1014.6341463414645,25.365853658536615,0
4740,4,1,2,41,0.023255813953488372,0.046511627906976744,0.9534883720930233,43,1650,1300,350,0.7878787878787878,20,13,7,303.59730197396703,0.4386766334440753,0.08402422745475513,0.1679293067722094,129100.5487843286,-761.084341143862,128339.46444318473,1419,0,287.5348837209302,41,2,18,38.21912013536379,0.6026422764227642,45.932539682539684,1016.2698412698417,24.78706929926443,0
4741,4,0,0,41,0.0,0.0,1.0,41,1300,700,600,0.5384615384615384,19,7,12,313.51984679166526,0.4324695121951219,0.09023940147131615,0.17316379306941712,129042.58355034741,-108.51779513887004,128934.06575520853,1420,1,302.0487804878049,39,2,18,38.0258526416513,0.6052350427350428,45.98958333333334,1016.0416666666682,26.05235042735047,0
4742,4,0,1,40,0.0,0.024390243902439025,0.975609756097561,41,1150,500,650,0.43478260869565216,18,5,13,313.5105897959125,0.4319613821138211,0.08630201706342122,0.17350668318994444,129121.97401258688,-103.77875434027283,129018.19525824662,1421,2,303.0487804878049,39,2,20,37.94551347750332,0.6060363247863247,45.911458333333336,1016.3541666666673,26.060363247863265,0
4743,4,1,0,41,0.024390243902439025,0.0,1.0,41,1050,600,450,0.5714285714285714,15,6,9,309.62923248245124,0.43325711382113824,0.08901171233701244,0.17253359747983482,129391.54071015022,-187.29489797638982,129204.24581217383,1422,0,301.9512195121951,38,3,21,37.77083552101931,0.6104714912280702,45.64636752136751,1017.4145299145277,26.7740665766981,0
4744,4,0,1,40,0.0,0.024390243902439025,0.975609756097561,41,1100,800,300,0.7272727272727273,14,8,6,309.8567797135595,0.433130081300813,0.09210677933550993,0.17289899395264496,129445.89548405624,-178.06233563448555,129267.83314842175,1423,1,302.9512195121951,38,3,15,37.70997375328083,0.6110197368421053,45.5929487179487,1017.6282051282027,26.779689608636914,0
4745,4,0,1,39,0.0,0.025,0.975,40,1200,900,300,0.75,15,9,6,320.73444058468715,0.43043536324786325,0.09989494666523013,0.17899797613147775,129452.33298947723,303.9643207525037,129756.29731022974,1424,2,310.6,37,3,15,37.42670958589231,0.6128941441441442,45.58662280701753,1017.6535087719275,27.50414888572777,0
4746,4,0,0,39,0.0,0.0,1.0,39,850,500,350,0.5882352941176471,12,5,7,329.39078532700586,0.4285874943769681,0.09757330062910263,0.18319320031240846,129315.90374157915,719.0934177420359,130034.9971593212,1425,6,319.5128205128205,36,3,21,37.34499557130205,0.6134259259259259,45.720720720720706,1017.117117117115,28.25325325325319,0
4747,4,0,1,38,0.0,0.02564102564102564,0.9743589743589743,39,950,600,350,0.631578947368421,13,6,7,331.52169782254555,0.426984930274404,0.09939833371628959,0.1853200140147179,129516.42679419278,787.5011413440404,130303.92793553682,1426,7,320.5128205128205,36,3,16,37.08720544307999,0.6154513888888888,45.523648648648646,1017.905405405405,28.27515015015014,0
4748,4,0,0,38,0.0,0.0,1.0,38,800,500,300,0.625,11,5,6,341.3935040213552,0.42576458036984355,0.1078758821311212,0.19059511624506492,129466.28146701372,1239.7894965277571,130706.07096354147,1427,8,329.10526315789474,35,3,16,36.886941316956666,0.6169642857142856,45.57291666666666,1017.7083333333319,29.07738095238091,0
4749,4,1,1,38,0.02564102564102564,0.02564102564102564,0.9743589743589743,39,850,500,350,0.5882352941176471,12,5,7,335.4004720406609,0.4280251911830859,0.11838154480664409,0.1892796180119741,129889.23890106328,912.9824080837616,130802.22130914703,1428,0,321.64102564102564,36,3,17,36.61023346590071,0.619212962962963,45.15765765765766,1019.3693693693698,28.315815815815828,0
4750,4,0,0,38,0.0,0.0,1.0,38,1250,1000,250,0.8,15,10,5,343.9414695109344,0.4247125414888573,0.12218343952090094,0.19390195777933966,129849.38298396765,1332.1175197187795,131181.50050368643,1429,1,330.8157894736842,35,3,18,36.43301915360738,0.6208333333333333,45.19675925925925,1019.2129629629619,29.120370370370342,0
4751,4,0,0,38,0.0,0.0,1.0,38,950,600,350,0.631578947368421,13,6,7,346.5941043840989,0.4246088193456614,0.12792322993387462,0.1961362012670709,129996.88042534713,1411.2304687499905,131408.11089409713,1430,2,331.8157894736842,35,3,21,36.21573884916581,0.6223214285714286,45.05208333333333,1019.7916666666658,29.136904761904738,0
4752,4,0,0,38,0.0,0.0,1.0,38,1150,900,250,0.782608695652174,14,9,5,346.38531123028037,0.4246088193456614,0.12527247427544186,0.1963147104741131,130055.9028447573,1409.890876843262,131465.79372160055,1431,3,332.8157894736842,35,3,21,36.161187072128286,0.6229166666666667,44.994212962962955,1020.0231481481475,29.143518518518498,0
4753,4,0,0,38,0.0,0.0,1.0,38,1250,800,450,0.64,17,8,9,351.1970933604027,0.42309743954480794,0.13215187304921794,0.1999488164199735,130233.05047850215,1547.4937575017052,131780.54423600386,1432,4,333.8157894736842,35,3,21,35.8587755603432,0.624702380952381,44.82060185185185,1020.7175925925919,29.16335978835977,0
4754,4,0,0,38,0.0,0.0,1.0,38,750,600,150,0.8,9,6,3,361.0937195436068,0.4232159791370318,0.041775088373919855,0.20590024859082248,130292.97052154188,1880.013668758392,132172.98419030028,1433,5,334.8157894736842,34,4,20,35.54541744402986,0.6274509803921569,44.76190476190476,1020.9523809523804,30.028011204481775,8
4755,4,0,3,35,0.0,0.07894736842105263,0.9210526315789473,38,600,500,100,0.8333333333333334,7,5,2,391.5590851493594,0.42263809862494073,-0.04601226993865015,0.22008320992877797,129731.4453125001,2580.46963577099,132311.9149482711,1434,6,335.8157894736842,35,3,18,35.339979550102264,0.6196428571428572,45.31250000000001,1018.7500000000008,29.10714285714288,8
4756,4,0,0,35,0.0,0.0,1.0,35,1400,1200,200,0.8571428571428571,16,12,4,397.4471700736402,0.4172619047619048,0.007523317130146534,0.22410631277982812,129856.32216274986,3322.2055519511673,133178.52771470102,1435,16,361.22857142857146,33,2,19,35.0625976914753,0.6253156565656566,45.189950980392155,1019.240196078431,30.886066547831245,0
4757,4,0,0,35,0.0,0.0,1.0,35,1050,800,250,0.7619047619047619,13,8,5,396.13419933431976,0.41628151260504204,0.0009890109890113852,0.22390193875418057,129950.01922337554,3295.529363706259,133245.5485870818,1436,17,362.22857142857146,33,2,19,35.00050080128206,0.6262626262626263,45.09803921568627,1019.6078431372542,30.897207367795584,0
4758,4,1,1,35,0.027777777777777776,0.027777777777777776,0.9722222222222222,36,600,400,200,0.6666666666666666,8,4,4,387.06553954110336,0.41759259259259257,0.0015943381552341318,0.22002160510254223,130171.45691609973,2876.977040816324,133048.43395691607,1437,0,353.1388888888889,34,2,20,35.00617319956448,0.6262254901960784,44.88095238095238,1020.4761904761901,30.014005602240886,0
4759,4,0,0,35,0.0,0.0,1.0,35,950,800,150,0.8421052631578947,11,8,3,386.3390254060805,0.4154761904761905,0.016326530612244428,0.22012339819648788,130262.58680555565,3065.1041666666742,133327.69097222234,1438,1,361.25714285714287,33,2,20,34.93197278911565,0.6294191919191919,44.79166666666667,1020.8333333333342,30.93434343434346,0
4760,4,0,1,34,0.0,0.02857142857142857,0.9714285714285714,35,950,800,150,0.8421052631578947,11,8,3,387.92119738186346,0.4148809523809524,0.009928677353294502,0.22231291283385562,130488.24737271717,3123.8314330170588,133612.07880573423,1439,2,362.25714285714287,32,3,16,34.66206335475368,0.6341145833333333,44.57070707070708,1021.7171717171725,31.92866161616164,0
4761,4,0,0,34,0.0,0.0,1.0,34,600,500,100,0.8333333333333334,7,5,2,388.54135601035296,0.41083630421865713,0.03571455337135432,0.22309152182335495,130561.83073255763,3345.734151204435,133907.56488376207,1440,3,373.3235294117647,31,3,16,34.57141567927972,0.6374327956989247,44.49869791666667,1022.0052083333344,32.967909946236595,0
4762,4,0,0,34,0.0,0.0,1.0,34,600,500,100,0.8333333333333334,7,5,2,386.3641315553645,0.410427807486631,0.040762885207579425,0.22222306203964604,130628.37600708018,3294.0238104926343,133922.39981757282,1441,4,374.3235294117647,31,3,16,34.55942448944933,0.6381048387096775,44.43359375000001,1022.2656250000008,32.976310483870996,0
4763,4,0,1,33,0.0,0.029411764705882353,0.9705882352941176,34,900,500,400,0.5555555555555556,13,5,8,384.8917677941001,0.40975935828877,0.040565628134684895,0.2227157224835079,130861.4179823133,3273.496500651036,134134.91448296435,1442,5,375.3235294117647,31,3,17,34.36041825740222,0.6404569892473118,44.205729166666664,1023.1770833333328,33.00571236559138,0
4764,4,0,0,33,0.0,0.0,1.0,33,900,600,300,0.6666666666666666,12,6,6,394.43339698033003,0.40707859848484845,0.03783996846669302,0.22794476722986257,130812.00003251815,3719.324307723429,134531.32434024158,1443,25,387.54545454545456,30,3,18,34.16655717601718,0.6427083333333333,44.25403225806451,1022.9838709677414,34.09946236559138,0
4765,4,1,0,34,0.029411764705882353,0.0,1.0,34,1050,800,250,0.7619047619047619,13,8,5,383.4693926362266,0.4087938205585264,0.039196997899426655,0.22401786567590698,131228.04641723633,3264.3878512912333,134492.43426852755,1444,0,377.11764705882354,31,3,20,34.02499788198416,0.6441532258064516,43.84765625,1024.609375,33.05191532258065,0
4766,4,0,0,34,0.0,0.0,1.0,34,1300,1200,100,0.9230769230769231,14,12,2,382.8746226312224,0.4087381164587047,0.041134629896668606,0.2244506257614009,131361.49300469295,3258.996412489158,134620.4894171821,1445,1,378.11764705882354,31,3,20,33.905039375079404,0.645497311827957,43.71744791666667,1025.1302083333337,33.06871639784948,0
4767,4,0,0,34,0.0,0.0,1.0,34,850,500,350,0.5882352941176471,12,5,7,380.90334313178226,0.40760546642899587,0.0483326613204309,0.2242717890278163,131528.3966064453,3219.9211968315967,134748.3178032769,1446,2,379.11764705882354,31,3,21,33.78659981382752,0.6471774193548387,43.5546875,1025.78125,33.08971774193548,0
4768,4,0,0,34,0.0,0.0,1.0,34,1250,1000,250,0.8,15,10,5,381.394885016822,0.40688131313131315,0.04765190794136309,0.22594280002687014,131762.23966810433,3250.6888495551157,135012.92851765946,1447,3,380.11764705882354,31,3,16,33.53743923060663,0.6495295698924731,43.326822916666664,1026.692708333333,33.119119623655905,0
4769,4,0,0,34,0.0,0.0,1.0,34,950,800,150,0.8421052631578947,11,8,3,385.3902289629234,0.40658422459893045,0.049819927971188616,0.22911405548519237,131895.95752292214,3366.2826538085983,135262.24017673073,1448,4,381.11764705882354,31,3,16,33.29966303291503,0.6508736559139785,43.196614583333336,1027.213541666667,33.13592069892474,0
4770,4,0,0,34,0.0,0.0,1.0,34,1150,1100,50,0.9565217391304348,12,11,1,382.835834963407,0.40606431966726086,0.044126960473866994,0.228803097428925,132096.66146172423,3314.2671373155417,135410.92859903976,1449,5,382.11764705882354,31,3,16,33.16247097318978,0.6528897849462365,43.001302083333336,1027.994791666667,33.16112231182797,0
4771,4,0,0,34,0.0,0.0,1.0,34,750,400,350,0.5333333333333333,11,4,7,383.77011991867636,0.4049873737373737,0.0508217719294326,0.2301746527894931,132230.54885864258,3349.2267184787315,135579.7755771213,1450,6,383.11764705882354,31,3,17,33.00325463138795,0.654233870967742,42.87109375,1028.515625,33.177923387096776,0
4772,4,0,0,34,0.0,0.0,1.0,34,1000,800,200,0.8,12,8,4,384.5011135700124,0.4044303327391563,0.05583433221409062,0.23102230405449953,132297.51798841692,3373.708597819014,135671.22658623592,1451,7,384.11764705882354,31,3,17,32.916851242458755,0.6549059139784946,42.805989583333336,1028.776041666667,33.18632392473119,0
4773,4,0,1,33,0.0,0.029411764705882353,0.9705882352941176,34,800,500,300,0.625,11,5,6,381.7469553672413,0.4038918597742127,0.05084543939033148,0.22997926335538665,132398.0034722221,3308.5069444444334,135706.51041666654,1452,8,385.11764705882354,31,3,18,32.88630229419705,0.6559139784946236,42.70833333333333,1029.1666666666656,33.198924731182764,0
4774,4,0,0,33,0.0,0.0,1.0,33,1200,1000,200,0.8333333333333334,14,10,4,390.759231915548,0.40317234848484845,0.04222235417532638,0.234977370016773,132328.84807853508,3741.7438070875214,136070.5918856226,1453,9,374.8181818181818,30,3,18,32.72425430002176,0.6579861111111112,42.7755376344086,1028.8978494623655,34.29659498207885,0
4775,4,0,0,33,0.0,0.0,1.0,33,1050,600,450,0.5714285714285714,15,6,9,392.30376200759554,0.4032512626262626,0.04108992774440656,0.23655607948458005,132432.58794369295,3790.7604925424994,136223.34843623545,1454,10,375.8181818181818,30,3,19,32.5797640811352,0.6590277777777778,42.6747311827957,1029.3010752688176,34.31003584229392,0
4776,4,0,0,33,0.0,0.0,1.0,33,800,300,500,0.375,13,3,10,391.78274268348946,0.40246212121212116,0.04903228868768639,0.2368940482792592,132536.36845661353,3785.092387848315,136321.46084446184,1455,11,376.8181818181818,30,3,20,32.488415350476444,0.6600694444444444,42.5739247311828,1029.704301075269,34.32347670250897,0
4777,4,0,0,33,0.0,0.0,1.0,33,950,600,350,0.631578947368421,13,6,7,393.7184849829346,0.40135732323232326,0.047009813802562084,0.23938458559588874,132744.05142574277,3852.757363568034,136596.8087893108,1456,12,377.8181818181818,30,3,16,32.22903352028173,0.6621527777777778,42.372311827956985,1030.5107526881714,34.350358422939046,0
4778,4,0,0,33,0.0,0.0,1.0,33,1100,700,400,0.6363636363636364,15,7,8,417.53515355592543,0.40151515151515155,0.014962362478285973,0.23994516511083536,130595.10125054236,4305.60913085935,134900.7103814017,1457,13,378.8181818181818,31,2,14,33.79670912951168,0.637768817204301,44.46614583333332,1022.1354166666652,32.97211021505372,7
4779,4,1,0,34,0.029411764705882353,0.0,1.0,34,800,600,200,0.75,10,6,4,407.44553613547254,0.4057115270350564,0.021879218008447276,0.23624846322704846,130940.15438475656,3870.1962809917263,134810.3506657483,1458,0,368.6470588235294,32,2,15,33.703429558351836,0.638671875,44.128787878787875,1023.4848484848477,31.98390151515149,0
4780,4,0,0,34,0.0,0.0,1.0,34,1150,900,250,0.782608695652174,14,9,5,407.5095638935674,0.40483882947118244,0.0270547622328432,0.23727997650687166,131101.73906042732,3885.0425020405846,134986.78156246792,1459,1,369.6470588235294,32,2,15,33.537531336045696,0.6402994791666667,43.970959595959584,1024.11616161616,32.003630050505,0
4781,4,1,0,35,0.02857142857142857,0.0,1.0,35,950,700,250,0.7368421052631579,12,7,5,396.4275581833688,0.407843137254902,0.042039499513510714,0.23314843530826485,131485.1878634418,3424.870392397134,134910.05825583893,1460,0,360.0571428571429,33,2,17,33.43228482096626,0.641729797979798,43.596813725490186,1025.612745098038,31.07917409387994,0
4782,4,0,0,35,0.0,0.0,1.0,35,900,700,200,0.7777777777777778,11,7,4,398.5081247737826,0.40777310924369753,0.07062510248328402,0.22725106955281688,130295.81917656805,3464.122483291262,133759.94165985932,1461,1,361.0571428571429,31,4,17,34.58755792203376,0.634744623655914,44.75911458333334,1020.9635416666677,32.934307795698956,7
4783,4,0,0,35,0.0,0.0,1.0,35,700,400,300,0.5714285714285714,10,4,6,398.00533893022714,0.4077380952380953,0.07081283929026805,0.22715850566891144,130329.05578613296,3374.3320041232773,133703.38779025624,1462,2,362.0571428571429,31,4,18,34.56654339879281,0.6350806451612903,44.72656250000001,1021.0937500000011,32.938508064516164,0
4784,4,0,0,35,0.0,0.0,1.0,35,1300,1000,300,0.7692307692307693,16,10,6,396.75113760400154,0.40710784313725495,0.06882844080422257,0.22756250578520126,130520.50053884836,3356.8314138863752,133877.33195273473,1463,3,363.0571428571429,32,3,17,34.403702788417995,0.6344401041666667,44.53914141414143,1021.8434343434366,31.932607323232393,0
4785,4,0,0,35,0.0,0.0,1.0,35,900,700,200,0.7777777777777778,11,7,4,400.73951962508187,0.4064425770308124,0.07366804906026658,0.2302332442416637,130585.01882779835,3466.11554305685,134051.1343708552,1464,4,364.0571428571429,32,3,17,34.236154004529546,0.6350911458333333,44.47601010101011,1022.095959595961,31.94049873737378,0
4786,4,0,0,35,0.0,0.0,1.0,35,750,600,150,0.8,9,6,3,398.8318938886513,0.4057773109243697,0.06951275447200378,0.2297112856835207,130681.82615294371,3424.0160442812166,134105.84219722493,1465,5,365.0571428571429,32,3,18,34.186424631596296,0.6360677083333333,44.38131313131314,1022.4747474747486,31.952335858585894,0
4787,4,0,0,35,0.0,0.0,1.0,35,1500,1200,300,0.8,18,12,6,366.9828055730512,0.4051820728291316,-0.02073398299813345,0.19909539609435634,128330.7201557095,2419.033544790487,130749.75370049998,1466,6,366.0571428571429,33,2,19,37.39517819706501,0.6098484848484849,46.691176470588246,1013.2352941176482,30.704099821746915,8
4788,4,0,0,35,0.0,0.0,1.0,35,800,500,300,0.625,11,5,6,365.8865174601458,0.4054271708683473,-0.02059077560891298,0.19880955975002682,128392.81316080366,2395.439854863534,130788.2530156672,1467,7,367.0571428571429,33,2,17,37.35943168077389,0.610479797979798,46.62990196078432,1013.4803921568637,30.711527035056474,0
4789,4,1,1,35,0.027777777777777776,0.027777777777777776,0.9722222222222222,36,1000,800,200,0.8,12,8,4,355.570521980058,0.4103670634920635,-0.01059799822627605,0.19514101863361139,128789.87295310364,1958.7764703360863,130748.64942343973,1468,0,357.8333333333333,35,1,19,37.21541239072596,0.6101190476190477,46.23842592592593,1015.0462962962969,29.001322751322768,0
4790,4,1,0,36,0.027777777777777776,0.0,1.0,36,1250,900,350,0.72,16,9,7,352.0010792804104,0.40934193121693124,-0.0055302455074666135,0.19462024408576853,129083.74592764064,1887.5235768175621,130971.2695044582,1469,0,358.5833333333333,35,1,20,37.00645406226271,0.6130952380952381,45.949074074074076,1016.203703703704,29.034391534391546,0
4791,4,1,0,37,0.02702702702702703,0.0,1.0,37,1000,600,400,0.6,14,6,8,344.5715680019955,0.415477977977978,-0.004593149627843962,0.19208171555520223,129407.39300679415,1518.0752475565573,130925.46825435071,1470,0,349.86486486486484,35,2,22,36.86594718082888,0.6163690476190475,45.630787037037024,1017.4768518518497,29.070767195767132,0
4792,4,0,0,37,0.0,0.0,1.0,37,1050,600,450,0.5714285714285714,15,6,9,346.2754681372596,0.4154466966966967,-0.009955385125917315,0.19375566270580988,129554.63927469119,1572.3186728394842,131126.95794753067,1471,1,350.86486486486484,35,2,18,36.67291950886766,0.6178571428571429,45.4861111111111,1018.0555555555541,29.087301587301546,0
4793,4,1,1,37,0.02631578947368421,0.02631578947368421,0.9736842105263158,38,1150,800,350,0.6956521739130435,15,8,7,346.3939774332243,0.41825213371266007,0.02984053110670004,0.18627760045185268,127978.05574792235,1266.1655509387385,129244.22129886108,1472,0,342.60526315789474,37,1,20,38.2770733997977,0.597972972972973,47.03947368421052,1011.8421052631571,27.347083926031274,8
4794,4,0,0,37,0.0,0.0,1.0,37,850,500,350,0.5882352941176471,12,5,7,392.08095736739926,0.4175425425425425,0.08983477404530027,0.1957607538627481,124940.48327664412,2417.675611334115,127358.15888797824,1473,1,352.7837837837838,34,3,19,40.25983369056125,0.5729166666666667,50.05952380952382,999.7619047619058,29.404761904761937,8
4795,4,5,2,40,0.11904761904761904,0.047619047619047616,0.9523809523809523,42,1150,800,350,0.6956521739130435,15,8,7,359.0286466423467,0.4334833526906698,0.1380322936836884,0.18537008262442042,126326.69990514162,685.5322659256046,127012.23217106723,1474,0,311.6666666666667,36,6,12,39.65357902990927,0.5830439814814814,48.6768018018018,1005.2927927927926,27.924799799799796,0
4796,4,2,0,42,0.047619047619047616,0.0,1.0,42,850,500,350,0.5882352941176471,12,5,7,361.89319324078934,0.43253968253968256,0.14916601365722593,0.18762576292628966,126496.5699440995,755.6495262154024,127252.2194703149,1475,0,312.6190476190476,36,6,14,39.40655434904288,0.5847800925925926,48.50788288288288,1005.9684684684684,27.943568568568566,0
4797,4,2,0,44,0.045454545454545456,0.0,1.0,44,1350,900,450,0.6666666666666666,18,9,9,350.2890717624355,0.4365089852008457,0.15819755342368413,0.18441144254159936,127120.4032368515,108.57390329516116,127228.97714014667,1476,0,299.3636363636364,36,8,18,39.057323655313596,0.5911458333333333,47.8885135135135,1008.4459459459441,28.012387387387335,0
4798,4,2,3,43,0.043478260869565216,0.06521739130434782,0.9347826086956522,46,800,500,300,0.625,11,5,6,335.8813217820825,0.4377415458937198,0.1574714395199066,0.17913054989598573,127644.04432508671,-625.3499348958383,127018.69439019087,1477,0,287.30434782608694,39,7,11,38.884414836958406,0.5910790598290598,47.369791666666664,1010.5208333333326,25.91079059829058,0
4799,4,2,1,44,0.044444444444444446,0.022222222222222223,0.9777777777777777,45,1000,400,600,0.4,16,4,12,350.6643649186226,0.4380681818181818,0.16483575849393484,0.18733120025381614,127712.20419908303,-43.17620443423431,127669.0279946488,1478,0,294.6222222222222,38,7,13,38.44114434696827,0.5934758771929824,47.30235042735042,1010.7905982905968,26.59975258659465,0
4800,4,0,0,44,0.0,0.0,1.0,44,1550,1200,350,0.7741935483870968,19,12,7,358.98433519242417,0.4343397639182523,0.15991753013322074,0.19139085920236443,127631.22420374007,363.52203411496384,127994.74623785504,1479,1,302.22727272727275,38,6,13,38.31390533587086,0.5926535087719298,47.38247863247862,1010.4700854700842,26.591318038686428,0
4801,4,0,1,43,0.0,0.022727272727272728,0.9772727272727273,44,1250,900,350,0.72,16,9,7,357.6329255271795,0.43455998942917545,0.16051487671438225,0.19110517121782739,127723.00347222203,335.59027777775896,128058.59374999978,1480,2,303.22727272727275,39,5,14,38.25398461115691,0.5918803418803419,47.29166666666666,1010.8333333333318,25.91880341880338,0
4802,4,1,0,44,0.022727272727272728,0.0,1.0,44,1300,1000,300,0.7692307692307693,16,10,6,357.8698827162563,0.4363107822410148,0.16770812855150252,0.19211025047305488,127907.33642578112,354.83669704859676,128262.17312282971,1481,0,304.09090909090907,39,5,15,38.059181169120905,0.59375,47.10937499999999,1011.562499999999,25.937499999999975,0
4803,4,0,0,44,0.0,0.0,1.0,44,1250,900,350,0.72,16,9,7,360.4292061265359,0.4356060606060606,0.16529031956206364,0.19399278324206637,128012.72922092023,427.90527343750375,128440.63449435773,1482,1,305.09090909090907,39,5,15,37.88653714187682,0.5948183760683761,47.005208333333336,1011.9791666666674,25.94818376068378,0
4804,4,2,0,46,0.043478260869565216,0.0,1.0,46,1400,800,600,0.5714285714285714,20,8,12,347.64239845848317,0.4384561191626409,0.18333184537094893,0.19022679556099026,128672.41753472229,-253.3311631944337,128419.08637152785,1483,0,292.7826086956522,37,9,15,37.53636208076661,0.6050112612612613,46.35416666666667,1014.5833333333339,27.42117117117119,0
4805,4,0,0,46,0.0,0.0,1.0,46,1100,900,200,0.8181818181818182,13,9,4,347.637804980992,0.43847624798711754,0.18362707151178115,0.19062414235213668,128755.86718990482,-247.91859033545646,128507.94859956937,1484,1,293.7826086956522,37,9,15,37.45138288677615,0.6058558558558558,46.27192982456142,1014.9122807017563,27.430061640588008,0
4806,4,1,0,47,0.02127659574468085,0.0,1.0,47,1150,700,450,0.6086956521739131,16,7,9,342.6602121699766,0.44110391612704286,0.18284438163530492,0.18951207652666116,129095.50781250047,-552.8211805555105,128542.68663194496,1485,0,288.51063829787233,39,8,17,37.23178898455651,0.6057692307692308,45.93750000000002,1016.2500000000038,26.057692307692403,0
4807,4,1,1,47,0.020833333333333332,0.020833333333333332,0.9791666666666666,48,1700,1500,200,0.8823529411764706,19,15,4,334.15977039727204,0.44249593676122934,0.18979467362746072,0.1864309992581927,129439.78000217034,-949.2431640624803,128490.53683810786,1486,0,283.4791666666667,39,9,11,37.0978989661173,0.6092414529914529,45.59895833333334,1017.6041666666683,26.092414529914574,0
4808,4,0,1,46,0.0,0.02127659574468085,0.9787234042553191,47,1600,1100,500,0.6875,21,11,10,345.06293012586025,0.4411810052420598,0.1945652538113587,0.192543902135256,129445.89548405661,-466.60400230110713,128979.29148175551,1487,1,290.29787234042556,38,9,11,36.81430446194226,0.6110197368421053,45.59294871794872,1017.6282051282058,26.779689608636993,0
4809,4,0,0,46,0.0,0.0,1.0,46,1050,600,450,0.5714285714285714,15,6,9,343.5975639968332,0.43978462157809983,0.19791505086910877,0.1923904103930567,129581.83235627161,-295.19961282780014,129286.63274344381,1488,2,296.0652173913044,38,8,11,36.713448758307095,0.612390350877193,45.45940170940172,1018.1623931623944,26.793747188484065,0
4810,4,0,2,44,0.0,0.043478260869565216,0.9565217391304348,46,1700,1300,400,0.7647058823529411,21,13,8,340.41523326651946,0.4399355877616747,0.19014444120221796,0.19140328210079785,129745.05077069195,-366.56165534368756,129378.48911534826,1489,3,297.0652173913044,38,8,11,36.62874021252797,0.6140350877192983,45.29914529914531,1018.8034188034201,26.81061628430053,0
4811,4,0,0,44,0.0,0.0,1.0,44,900,600,300,0.6666666666666666,12,6,6,354.07909167110967,0.43403144820295986,0.18803893947778816,0.19735376886171985,129401.82317029881,363.6960017450019,129765.51917204382,1490,4,311.22727272727275,36,8,17,36.629773104593234,0.6142939814814814,45.63626126126127,1017.4549549549561,28.262637637637667,0
4812,4,1,0,45,0.022222222222222223,0.0,1.0,45,1400,1100,300,0.7857142857142857,17,11,6,344.10579047761416,0.43526936026936025,0.19792936900748415,0.19382540707266332,129815.23762119107,-65.9650084641508,129749.27261272693,1491,0,305.2888888888889,37,8,13,36.463488989312104,0.6165540540540541,45.23026315789473,1019.0789473684206,27.542674253200556,0
4813,4,0,1,44,0.0,0.022222222222222223,0.9777777777777777,45,1200,900,300,0.75,15,9,6,344.66343325770646,0.4346170033670034,0.1943850827571767,0.1951457374779399,130017.30974687707,-37.55752794213652,129979.75221893494,1492,1,306.2888888888889,38,7,14,36.244238424471,0.6167763157894737,45.032051282051285,1019.8717948717949,26.838731443994604,0
4814,4,0,2,42,0.0,0.045454545454545456,0.9545454545454546,44,1150,700,450,0.6086956521739131,16,7,9,357.15944039773393,0.4325449260042283,0.19292277614858278,0.20204274913010503,129982.90339335182,484.9242074484503,130467.82760080027,1493,2,314.04545454545456,37,7,15,35.960573476702514,0.6182432432432432,45.06578947368421,1019.7368421052633,27.560455192034144,0
4815,4,0,0,42,0.0,0.0,1.0,42,1100,900,200,0.8181818181818182,13,9,4,373.8074587023935,0.42930942702284164,0.19467118893450808,0.2102637098375193,129760.92470689755,1301.120300711623,131062.04500760918,1494,3,329.3333333333333,35,7,15,35.762074482184104,0.6199404761904762,45.28356481481483,1018.8657407407429,29.110449735449798,0
4816,4,1,0,43,0.023255813953488372,0.0,1.0,43,1750,1000,750,0.5714285714285714,25,10,15,365.2573120254376,0.43080933923957176,0.19919639595762773,0.20738450236878334,130126.29323727106,905.9160183359218,131032.20925560698,1495,0,322.6511627906977,38,5,16,35.608420593368244,0.6178728070175439,44.92521367521369,1020.2991452991474,26.8499775078723,0
4817,4,0,0,43,0.0,0.0,1.0,43,1500,1300,200,0.8666666666666667,17,13,4,366.9408355902927,0.4309016242155777,0.1966075440342221,0.20953523281692557,130348.82010388783,966.203671853817,131315.02377574166,1496,1,323.6511627906977,36,7,17,35.339472136450546,0.6238425925925926,44.70720720720722,1021.1711711711724,28.3658658658659,0
4818,4,0,0,43,0.0,0.0,1.0,43,1000,600,400,0.6,14,6,8,365.8807807030662,0.4305324843115541,0.207467284498003,0.20986107484826957,130521.37230135548,951.0523192111111,131472.4246205666,1497,2,324.6511627906977,36,7,15,35.191435236206004,0.6255787037037037,44.53828828828829,1021.8468468468475,28.38463463463465,0
4819,4,0,0,43,0.0,0.0,1.0,43,1300,900,400,0.6923076923076923,17,9,8,365.7422460343416,0.43027870062753787,0.20993501486947852,0.21056270461292242,130665.25298524875,957.9606210940649,131623.21360634282,1498,3,325.6511627906977,36,7,15,35.04906010206704,0.627025462962963,44.39752252252252,1022.4099099099099,28.400275275275273,0
4820,4,0,0,43,0.0,0.0,1.0,43,1000,500,500,0.5,15,5,10,366.70075333871995,0.42960963455149503,0.21221058236818124,0.2119026490667258,130809.21292914523,993.5673849525066,131802.78031409773,1499,4,326.6511627906977,36,7,15,34.87863276089829,0.6284722222222222,44.25675675675675,1022.9729729729719,28.415915915915885,0
4821,4,0,0,43,0.0,0.0,1.0,43,1100,700,400,0.6363636363636364,15,7,8,363.963564572594,0.4293327796234773,0.2075931453401172,0.21100844172177594,130935.05333371805,931.1177477685449,131866.1710814866,1500,5,327.6511627906977,37,6,15,34.82117348760804,0.6278153153153153,44.13377192982456,1023.4649122807016,27.661213845424367,0
4822,4,0,0,43,0.0,0.0,1.0,43,1100,600,500,0.5454545454545454,16,6,10,366.4415476939687,0.42834071613141383,0.21859768089099996,0.2136889474754715,131159.5935768697,1012.4648930440004,132172.0584699137,1501,6,328.6511627906977,37,6,15,34.530436023692296,0.6300675675675675,43.91447368421052,1024.342105263157,27.68492176386911,0
4823,4,0,0,43,0.0,0.0,1.0,43,1100,500,600,0.45454545454545453,17,5,12,360.8233239192881,0.4274640088593577,0.22029467148581983,0.21149449876623344,131356.22409058549,879.2778787703785,132235.50196935586,1502,7,329.6511627906977,37,6,16,34.475500944842565,0.6320382882882882,43.72258771929824,1025.1096491228063,27.70566619250828,0
4824,4,0,1,42,0.0,0.023255813953488372,0.9767441860465116,43,1000,600,400,0.6,14,6,8,361.9718123496499,0.427141011443337,0.22431626514264114,0.21247949888773215,131412.4312889542,913.5191837873103,132325.9504727415,1503,8,330.6511627906977,37,6,16,34.38925872455708,0.6326013513513513,43.66776315789473,1025.3289473684204,27.711593172119468,0
4825,4,0,0,42,0.0,0.0,1.0,42,1550,1100,450,0.7096774193548387,20,11,9,363.56170455689363,0.4269502516453736,0.2269803957484271,0.21467343804088096,131637.38031173032,1171.6620739073348,132809.04238563764,1504,9,336.2142857142857,37,5,14,34.12123357196282,0.6348536036036037,43.44846491228069,1026.2061403508756,27.735301090564203,0
4826,4,1,0,43,0.023255813953488372,0.0,1.0,43,1150,700,450,0.6086956521739131,16,7,9,356.03664004016895,0.4291020671834625,0.2246699763742026,0.21201265431989463,131958.55391418264,796.4160320329929,132754.96994621563,1505,0,329.3720930232558,38,5,15,33.99037295067763,0.6362390350877193,43.13568376068375,1027.4572649572626,27.0383490778227,0
4827,4,0,0,43,0.0,0.0,1.0,43,1500,900,600,0.6,21,9,12,351.83276092448097,0.42870985603543743,0.2253296546659007,0.2108805826064163,132205.65440317005,702.8560796989905,132908.51048286902,1506,1,330.3720930232558,38,5,16,33.84951347046195,0.6387061403508771,42.89529914529913,1028.4188034188005,27.06365272154738,0
4828,4,0,0,43,0.0,0.0,1.0,43,950,600,350,0.631578947368421,13,6,7,353.232347660787,0.42889442598744926,0.23063565247423634,0.21218180134907744,132288.07259706678,745.6852901964874,133033.75788726326,1507,2,331.3720930232558,38,5,16,33.73057084501678,0.6395285087719298,42.81517094017093,1028.7393162393146,27.072087269455647,0
4829,4,0,0,43,0.0,0.0,1.0,43,1350,1100,250,0.8148148148148148,16,11,5,353.88221409955906,0.4283637873754153,0.23349967046417475,0.21319245581119786,132398.00347222228,770.7053793191669,133168.70885154145,1508,3,332.3720930232558,37,6,16,33.603238866396765,0.642454954954955,42.708333333333336,1029.166666666667,27.815315315315324,0
4830,4,0,0,43,0.0,0.0,1.0,43,1300,900,400,0.6923076923076923,17,9,8,357.06634715974644,0.42764857881136953,0.2383368119257534,0.21624269496270146,132595.55975155823,869.0824340181643,133464.6421855764,1509,4,333.3720930232558,37,6,17,33.32257620923382,0.6444256756756757,42.516447368421055,1029.9342105263163,27.836059743954493,0
4831,4,0,0,43,0.0,0.0,1.0,43,1150,800,350,0.6956521739130435,15,8,7,341.67415097767554,0.42751015134736065,0.2546971147931678,0.2070446567929461,132618.0021938236,588.8197138023595,133206.82190762597,1510,5,334.3720930232558,38,5,19,33.69636621373994,0.6428179824561404,42.494658119658126,1030.0213675213683,27.105825461088642,8
4832,4,0,0,43,0.0,0.0,1.0,43,1500,1100,400,0.7333333333333333,19,11,8,343.9859173048195,0.4267718715393134,0.25612004617902295,0.20967278054796007,132838.18354381275,538.8928838848943,133377.07642769764,1511,6,335.3720930232558,38,5,16,33.41581165578472,0.6450109649122807,42.28098290598292,1030.87606837607,27.128317588843945,0
4833,4,0,0,43,0.0,0.0,1.0,43,1150,700,450,0.6086956521739131,16,7,9,342.5801760960274,0.4270717977113326,0.25347512434815034,0.20974074826931816,133003.4394061839,512.8683386295672,133516.30774481347,1512,7,336.3720930232558,38,5,16,33.28629380286553,0.6466557017543859,42.1207264957265,1031.517094017095,27.14518668466039,0
4834,4,1,0,44,0.022727272727272728,0.0,1.0,44,1000,700,300,0.7,13,7,6,338.26354065024213,0.42789816772374917,0.24889973868793835,0.20896467324281315,133337.70751953125,220.65700954861234,133558.36452907987,1513,0,329.70454545454544,39,5,18,33.062804673054295,0.6482371794871795,41.796875,1032.8125,26.482371794871796,0
4835,4,0,1,43,0.0,0.022727272727272728,0.9772727272727273,44,850,600,250,0.7058823529411765,11,6,5,337.5108100427237,0.4264667019027484,0.2512264691785011,0.20941257636582838,133499.82336410612,211.59452167626898,133711.4178857824,1514,1,330.70454545454544,38,6,18,32.92002653433958,0.6515899122807017,41.63995726495726,1033.4401709401702,27.195793972109744,0
4836,4,0,1,42,0.0,0.023255813953488372,0.9767441860465116,43,900,200,700,0.2222222222222222,16,2,14,342.3875330994352,0.42374953857512,0.2536237284794165,0.21243839689998947,133499.82336410615,541.7350381693252,134041.5584022755,1515,2,339.1860465116279,38,5,18,32.794031496605655,0.6515899122807017,41.63995726495726,1033.4401709401704,27.195793972109747,0
4837,4,0,0,42,0.0,0.0,1.0,42,550,300,250,0.5454545454545454,8,3,5,346.6656664696604,0.42228029423151375,0.24955561792496983,0.21477281617092153,133444.62393390673,852.1338985681931,134296.75783247492,1516,3,345.95238095238096,38,4,19,32.738772274497634,0.6510416666666667,41.69337606837607,1033.2264957264954,27.19017094017093,0
4838,4,1,0,43,0.023255813953488372,0.0,1.0,43,1100,800,300,0.7272727272727273,14,8,6,337.81172837888556,0.4246031746031746,0.241803761199624,0.21053958267734912,133665.49014034987,430.756903353051,134096.24704370293,1517,0,338.8837209302326,38,5,20,32.74658194717084,0.653234649122807,41.47970085470085,1034.0811965811963,27.21266306792622,0
4839,4,0,3,40,0.0,0.06976744186046512,0.9302325581395349,43,1250,900,350,0.72,16,9,7,341.5997386891356,0.4246493170911776,0.1056630358955939,0.2021381933508473,131719.0404707022,413.4228001395137,132132.46327084172,1518,1,339.8837209302326,40,3,14,34.60239085239086,0.63046875,43.3689024390244,1026.5243902439042,25.663109756097604,8
4840,4,0,0,40,0.0,0.0,1.0,40,1250,900,350,0.72,16,9,7,352.9927187677096,0.4194577991452992,0.134794806027573,0.20812557463827708,131581.12502164117,1289.4358119805988,132870.56083362177,1519,24,363.6,37,3,14,34.449142353318365,0.6342905405405406,43.503289473684205,1025.9868421052624,27.72937411095304,0
4841,4,0,0,40,0.0,0.0,1.0,40,650,400,250,0.6153846153846154,9,4,5,350.9010803288544,0.4188034188034188,0.14030293566520924,0.20730355336033063,131656.85609796192,1239.7066074950758,132896.562705457,1520,25,364.6,38,2,15,34.426400166562566,0.6332236842105263,43.42948717948718,1026.2820512820517,27.007422402159257,0
4842,4,0,0,40,0.0,0.0,1.0,40,1450,1000,450,0.6896551724137931,19,10,9,350.0479144491571,0.4184561965811966,0.13748178980228887,0.2073958358727742,131766.52444480965,1224.9194152238927,132991.44386003356,1521,26,365.6,38,2,17,34.337712452306604,0.6343201754385965,43.32264957264957,1026.7094017094012,27.01866846603687,0
4843,4,0,0,40,0.0,0.0,1.0,40,1250,1000,250,0.8,15,10,5,356.1340801567643,0.4185363247863248,0.10348706109739081,0.2033523414163058,130346.5504410012,1285.6793063502075,131632.2297473514,1522,27,366.6,37,3,17,35.61766258634883,0.6219031531531531,44.70942982456141,1021.1622807017554,27.598980559506902,8
4844,4,0,0,40,0.0,0.0,1.0,40,1050,600,450,0.5714285714285714,15,6,9,352.05904941046515,0.4181623931623932,0.09528549962434263,0.2016062792475295,130458.54403518398,1185.8222001000404,131644.36623528402,1523,28,367.6,37,3,17,35.608184859217914,0.6230292792792793,44.59978070175439,1021.600877192983,27.61083451872927,0
4845,4,0,1,39,0.0,0.025,0.975,40,1100,900,200,0.8181818181818182,13,9,4,355.4926327367555,0.4181891025641025,0.09911758395022008,0.20416185026120137,130570.58572108728,1283.3762551939087,131853.9619762812,1524,29,368.6,37,3,15,35.40694399742516,0.6241554054054055,44.49013157894737,1022.0394736842107,27.62268847795164,0
4846,4,0,0,39,0.0,0.0,1.0,39,850,500,350,0.5882352941176471,12,5,7,356.7737178814726,0.4164136302294197,0.11891064473948076,0.20539940295788747,130665.2529852486,1523.5856210940508,132188.83860634264,1525,30,378.20512820512823,36,3,15,35.278297903587045,0.627025462962963,44.397522522522515,1022.4099099099086,28.400275275275238,0
4847,4,0,0,39,0.0,0.0,1.0,39,1350,1100,250,0.8148148148148148,16,11,5,359.73290823879535,0.4161043634727845,0.12363242217931836,0.20787619201279992,130809.21292914524,1611.2757182858415,132420.48864743108,1526,31,379.20512820512823,36,3,15,35.05683069132541,0.6284722222222222,44.25675675675675,1022.972972972972,28.41591591591589,0
4848,4,0,0,39,0.0,0.0,1.0,39,900,400,500,0.4444444444444444,14,4,10,359.80387876172904,0.4160762483130904,0.11999853302526886,0.20869543420965878,130953.25213304514,1623.497610786455,132576.7497438316,1527,32,380.20512820512823,36,3,16,34.90918509553673,0.6299189814814814,44.11599099099099,1023.5360360360355,28.431556556556544,0
4849,4,0,1,38,0.0,0.02564102564102564,0.9743589743589743,39,1300,900,400,0.6923076923076923,17,9,8,362.01295389072516,0.4160481331533963,0.12185197404596959,0.21060676837673456,131068.54056336729,1689.7019062981776,132758.24246966548,1528,33,381.20512820512823,36,3,16,34.735969060449435,0.6310763888888888,44.00337837837837,1023.9864864864855,28.444069069069045,0
4850,4,1,1,38,0.02564102564102564,0.02564102564102564,0.9743589743589743,39,1150,1000,150,0.8695652173913043,13,10,3,355.4766064243424,0.4175101214574899,0.12627000960517432,0.20836468437094569,131356.98356718197,1538.8669497199862,132895.85051690196,1529,0,380.02564102564105,36,3,17,34.611758028488794,0.6339699074074074,43.721846846846844,1025.112612612612,28.475350350350336,0
4851,4,1,1,38,0.02564102564102564,0.02564102564102564,0.9743589743589743,39,1350,1100,250,0.8148148148148148,16,11,5,348.3792642791822,0.4192813765182186,0.11510933250063715,0.20601252640034265,131693.6476247499,1375.8672139504442,133069.51483870033,1530,0,371.7692307692308,37,2,15,34.45400687248513,0.6354166666666667,43.39364035087719,1026.425438596491,27.74122807017543,0
4852,4,0,0,38,0.0,0.0,1.0,38,1000,700,300,0.7,13,7,6,357.0517236887607,0.41594061166429586,0.12999087580702895,0.21103562968218947,131674.63705259303,1802.9312251440476,133477.56827773707,1531,2,382.55263157894734,36,2,16,34.25064918440494,0.6371527777777778,43.412162162162154,1026.3513513513503,28.50975975975973,0
4853,4,0,0,38,0.0,0.0,1.0,38,800,500,300,0.625,11,5,6,356.8100540151156,0.41534791370317686,0.1309091434015648,0.21105279963321072,131703.5336645766,1798.6289921678228,133502.16265674442,1532,3,383.55263157894734,36,2,16,34.22769244834521,0.6374421296296297,43.384009009009,1026.4639639639627,28.512887887887853,0
4854,4,0,0,38,0.0,0.0,1.0,38,1200,700,500,0.5833333333333334,17,7,10,354.71345182975716,0.4156294452347084,0.12469262649934754,0.2102911088285907,131790.24252292825,1749.5543685577409,133539.79689148598,1533,4,384.55263157894734,36,2,16,34.19403926299628,0.6383101851851851,43.299549549549546,1026.8018018018013,28.522272272272257,0
4855,4,0,0,38,0.0,0.0,1.0,38,1200,800,400,0.6666666666666666,16,8,8,355.82846804923525,0.4156146277856804,0.13321196313885264,0.21143397114508627,131876.97991488106,1785.1167468143751,133662.09666169542,1534,5,385.55263157894734,36,2,17,34.07795197894968,0.6391782407407407,43.21509009009009,1027.1396396396392,28.531656656656644,0
4856,4,0,1,37,0.0,0.02631578947368421,0.9736842105263158,38,1450,1100,350,0.7586206896551724,18,11,7,360.1083232818693,0.4151701043148412,0.13423157433410426,0.21495805536910556,132050.5402995902,1910.499731150076,133961.0400307403,1535,6,386.55263157894734,36,2,18,33.79304992513056,0.6409143518518519,43.046171171171174,1027.815315315316,28.550425425425445,0
4857,4,0,0,37,0.0,0.0,1.0,37,1300,900,400,0.6923076923076923,17,9,8,367.42147552958374,0.41388263263263264,0.14579985390796213,0.21926765475152574,132040.8950617284,2302.9320987654355,134343.82716049382,1536,7,396.4594594594595,35,2,18,33.61486486486488,0.6428571428571428,43.05555555555556,1027.7777777777778,29.365079365079367,0
4858,4,0,1,36,0.0,0.02702702702702703,0.972972972972973,37,900,600,300,0.6666666666666666,12,6,6,365.54713846565045,0.4131944444444444,0.14625317495323142,0.21900784391552966,132189.63162562164,2264.3083151148903,134453.93994073654,1537,8,397.4594594594595,35,2,19,33.51306040142563,0.6443452380952381,42.91087962962963,1028.356481481482,29.38161375661377,0
4859,4,0,0,36,0.0,0.0,1.0,36,1150,900,250,0.782608695652174,14,9,5,372.36802537602966,0.4135085978835979,0.1427795140898509,0.2232399286067675,132214.28748582763,2646.4746315192688,134860.7621173469,1538,9,394.6388888888889,34,2,19,33.31283520469191,0.6467524509803921,42.88690476190476,1028.4523809523807,30.248599439775905,0
4860,4,0,0,36,0.0,0.0,1.0,36,650,600,50,0.9230769230769231,7,6,1,371.9264770146217,0.41307870370370375,0.14155704715246475,0.22333680944290119,132275.51197562364,2639.353032879826,134914.86500850346,1539,10,395.6388888888889,34,2,19,33.26245033368052,0.6473651960784313,42.827380952380956,1028.6904761904766,30.25560224089637,0
4861,4,0,0,36,0.0,0.0,1.0,36,1250,900,350,0.72,16,9,7,374.2608555318133,0.4118716931216931,0.13490502994319797,0.22565267482064572,132428.6352040817,2712.5708616780094,135141.2060657597,1540,11,396.6388888888889,34,2,20,33.0480376281903,0.6488970588235294,42.67857142857143,1029.2857142857147,30.27310924369749,0
4862,4,1,0,37,0.02702702702702703,0.0,1.0,37,950,700,250,0.7368421052631579,12,7,5,366.51401152832074,0.4131006006006006,0.13533245702177532,0.2227354433199071,132725.77649444874,2329.1713552383426,135054.94784968707,1541,0,386.8918918918919,35,2,17,32.948280542139344,0.649702380952381,42.3900462962963,1030.439814814815,29.44113756613757,0
4863,4,0,0,37,0.0,0.0,1.0,37,1150,800,350,0.6956521739130435,15,8,7,366.4524028160392,0.41234984984984985,0.13802893802893812,0.22394313505424618,132934.5703125,2342.8385416666674,135277.40885416666,1542,1,387.8918918918919,35,2,17,32.73989898989899,0.6517857142857143,42.1875,1031.25,29.464285714285715,0
4864,4,0,0,37,0.0,0.0,1.0,37,1350,1000,350,0.7407407407407407,17,10,7,360.9347250504097,0.41094219219219225,0.13499572683246175,0.22198730193100344,133173.39275763018,2213.3803798010845,135386.77313743127,1543,2,388.8918918918919,35,2,18,32.64231516782538,0.6541666666666667,41.95601851851851,1032.175925925925,29.490740740740712,0
4865,4,0,0,37,0.0,0.0,1.0,37,950,500,450,0.5263157894736842,14,5,9,362.7668862527547,0.40962837837837834,0.039219029755307666,0.21581225753213465,131921.96609224955,2171.7190715020465,134093.6851637516,1544,3,389.8918918918919,35,2,19,33.85440138200389,0.6416666666666666,43.17129629629629,1027.314814814814,29.35185185185183,8
4866,4,0,0,37,0.0,0.0,1.0,37,1100,700,400,0.6363636363636364,15,7,8,365.0275285344343,0.40990990990990994,0.04280623377571935,0.21801005251609346,132070.63567654745,2241.8835465963575,134312.5192231438,1545,4,390.8918918918919,35,2,19,33.646384603835905,0.643154761904762,43.02662037037037,1027.8935185185182,29.368386243386237,0
4867,4,0,0,37,0.0,0.0,1.0,37,1350,1000,350,0.7407407407407407,17,10,7,365.07898152652473,0.409690940940941,0.04726536124240366,0.21889958366023612,132219.3889853395,2254.10397376543,134473.49295910491,1546,5,391.8918918918919,35,2,19,33.495104659014174,0.6446428571428571,42.88194444444444,1028.4722222222222,29.384920634920633,0
4868,4,1,1,37,0.02631578947368421,0.02631578947368421,0.9736842105263158,38,1350,700,650,0.5185185185185185,20,7,13,354.1491188065388,0.41167318634423894,0.05895231683669744,0.21467210004793952,132629.89921932053,1794.152387184476,134424.051606505,1547,0,382.55263157894734,36,2,17,33.36317007397691,0.6467013888888888,42.483108108108105,1030.0675675675666,28.61298798798796,0
4869,4,0,0,37,0.0,0.0,1.0,37,500,200,300,0.4,8,2,6,360.3078802933563,0.40862737737737737,0.0648442080385434,0.21792380767980898,132546.94097490137,2151.5414684070597,134698.48244330843,1548,7,393.8918918918919,35,2,20,33.288023116406286,0.6479166666666667,42.563657407407405,1029.74537037037,29.421296296296287,0
4870,4,0,2,35,0.0,0.05405405405405406,0.9459459459459459,37,1050,700,350,0.6666666666666666,14,7,7,360.9548259525402,0.4081894394394394,0.06920837494801346,0.2193570522495197,132725.77649444863,2181.6019107938846,134907.37840524252,1549,8,394.8918918918919,35,2,17,33.09149069602007,0.649702380952381,42.39004629629629,1030.439814814814,29.441137566137545,0
4871,4,0,0,35,0.0,0.0,1.0,35,900,700,200,0.7777777777777778,11,7,4,375.7572299314436,0.40472689075630247,0.10606029706672149,0.22789431997140766,132650.37035034577,2968.8671424451813,135619.23749279094,1550,9,416.0857142857143,33,2,17,32.78610516297881,0.6534090909090908,42.46323529411763,1030.1470588235272,31.216577540106886,0
4872,4,0,0,35,0.0,0.0,1.0,35,600,500,100,0.8333333333333334,7,5,2,374.5730358744926,0.40409663865546214,0.10753024330569616,0.22755853219889668,132713.49961553232,2942.1796905036326,135655.67930603595,1551,10,417.0857142857143,33,2,17,32.75303282588012,0.654040404040404,42.401960784313715,1030.3921568627436,31.224004753416473,0
4873,4,1,0,36,0.027777777777777776,0.0,1.0,36,1650,1400,250,0.8484848484848485,19,14,5,369.2230071722833,0.4044312169312169,0.10361806276349061,0.22722020547841482,133195.58000283432,2635.7745181405767,135831.35452097488,1552,0,406.47222222222223,34,2,19,32.40615269288433,0.6565563725490196,41.9345238095238,1032.2619047619037,30.36064425770305,0
4874,4,0,0,36,0.0,0.0,1.0,36,900,600,300,0.6666666666666666,12,6,6,368.9364174160507,0.4043816137566138,0.10350216483488373,0.2276070045993471,133287.76218820846,2634.941893424021,135922.7040816325,1553,1,407.47222222222223,34,2,19,32.32096879563446,0.6574754901960784,41.84523809523809,1032.6190476190463,30.371148459383715,0
4875,4,0,0,36,0.0,0.0,1.0,36,950,900,50,0.9473684210526315,10,9,1,368.56406883279783,0.40410052910052907,0.10943682532365218,0.22794229688255055,133379.97626133778,2631.813350340119,136011.7896116779,1554,2,408.47222222222223,34,2,19,32.23800468671966,0.6583946078431373,41.75595238095237,1032.9761904761897,30.381652661064404,0
4876,4,0,0,36,0.0,0.0,1.0,36,1200,800,400,0.6666666666666666,16,8,8,367.8617401215784,0.4037202380952381,0.10804602114208173,0.22845319225576136,133533.73724489796,2624.390589569155,136158.1278344671,1555,3,409.47222222222223,34,2,20,32.101858250787075,0.6599264705882353,41.607142857142854,1033.5714285714284,30.399159663865543,0
4877,4,0,0,36,0.0,0.0,1.0,36,800,500,300,0.625,11,5,6,368.23318046052094,0.4031911375661376,0.10594954844321691,0.2294457249268352,133656.80980725616,2643.374433106568,136300.18424036272,1556,4,410.47222222222223,34,2,20,31.968829150356903,0.6611519607843137,41.488095238095234,1034.0476190476184,30.41316526610642,0
4878,4,0,0,36,0.0,0.0,1.0,36,950,700,250,0.7368421052631579,12,7,5,367.47792854768716,0.40381944444444445,0.10765886715253825,0.22973979849492088,133779.93905895686,2632.234977324252,136412.17403628113,1557,5,411.47222222222223,34,2,16,31.864930955120823,0.6623774509803921,41.36904761904761,1034.523809523809,30.42717086834732,0
4879,4,0,0,36,0.0,0.0,1.0,36,950,600,350,0.631578947368421,13,6,7,368.9196239018323,0.4035714285714285,0.09859465470301787,0.23121977581677186,133872.32320011323,2677.6254251700557,136549.9486252833,1558,6,412.47222222222223,34,2,16,31.735064611373133,0.663296568627451,41.2797619047619,1034.8809523809514,30.437675070027982,0
4880,4,0,1,35,0.0,0.027777777777777776,0.9722222222222222,36,850,800,50,0.9411764705882353,9,8,1,381.86076882246414,0.40324074074074073,0.08528378413288928,0.22224400090736351,131084.19075963701,2811.181972789093,133895.3727324261,1559,7,413.47222222222223,34,2,19,34.21200496008679,0.6354166666666667,43.98809523809523,1024.0476190476177,30.119047619047578,8
4881,4,0,0,35,0.0,0.0,1.0,35,1350,1100,250,0.8148148148148148,16,11,5,388.711207191881,0.400875350140056,0.09651918211037414,0.2261887776668075,131077.01965590153,3190.2213091118747,134267.2409650134,1560,19,426.0857142857143,33,2,19,34.043900590394124,0.6376262626262627,43.995098039215684,1024.019607843137,31.030897207367786,0
4882,4,1,0,36,0.027777777777777776,0.0,1.0,36,1050,700,350,0.6666666666666666,14,7,7,376.4191105016629,0.40355489417989415,0.10858947815469544,0.22192822486760017,131579.4706362938,2706.0457516339925,134285.51638792778,1561,0,415.22222222222223,33,3,18,33.849936295588456,0.6426767676767677,43.504901960784316,1025.9803921568632,31.090314913844338,0
4883,4,0,0,36,0.0,0.0,1.0,36,550,300,250,0.5454545454545454,8,3,5,391.45825628698236,0.4029431216931217,0.12059294871794868,0.22125901442307677,129950.01922337546,3097.0311899269295,133047.0504133024,1562,1,416.22222222222223,33,3,17,35.11969150641025,0.6262626262626263,45.09803921568626,1019.6078431372537,30.897207367795566,8
4884,4,2,1,37,0.05263157894736842,0.02631578947368421,0.9736842105263158,38,750,600,150,0.8,9,6,3,372.053205423432,0.40915422000948315,0.1287480108946355,0.21376719955070442,130587.70743580669,2117.11502807784,132704.82246388454,1563,0,395.2631578947368,35,3,18,34.96642981164836,0.6282738095238095,44.473379629629626,1022.106481481481,29.20304232804231,0
4885,4,0,0,37,0.0,0.0,1.0,37,1100,900,200,0.8181818181818182,13,9,4,381.3155281265087,0.4078453453453454,0.12513107305138083,0.2186259971883648,130505.75573979582,2552.7742346938676,133058.52997448968,1564,1,392.2432432432432,34,3,18,34.81300244669697,0.6295955882352942,44.55357142857142,1021.7857142857134,30.052521008403335,0
4886,4,0,0,37,0.0,0.0,1.0,37,1100,900,200,0.8181818181818182,13,9,4,379.9399007555628,0.40840840840840836,0.1253643580687609,0.21835100320530507,130597.00255102025,2523.8024376417115,133120.80498866196,1565,2,393.2432432432432,34,3,18,34.75546432176412,0.6305147058823529,44.46428571428571,1022.142857142856,30.063025210084,0
4887,4,0,0,37,0.0,0.0,1.0,37,900,500,400,0.5555555555555556,13,5,8,379.74280405648045,0.4088463463463463,0.13264952962275411,0.21892554945269582,130718.71456916103,2527.8982426303855,133246.61281179142,1566,3,394.2432432432432,34,3,18,34.63693247962747,0.6317401960784313,44.345238095238095,1022.6190476190479,30.07703081232494,0
4888,4,0,0,37,0.0,0.0,1.0,37,950,700,250,0.7368421052631579,12,7,5,383.3835277752321,0.40897147147147145,0.11081782419362085,0.2028917321147575,127332.20663265295,2374.1319444444343,129706.33857709738,1567,4,395.2432432432432,34,3,16,38.0049834866714,0.5974264705882353,47.67857142857142,1009.2857142857133,29.684873949579803,8
4889,4,1,0,38,0.02631578947368421,0.0,1.0,38,1200,800,400,0.6666666666666666,16,8,8,374.76603067262425,0.4112879326695116,0.11849334875650697,0.20061005171299287,127793.20987654306,1978.5108024691208,129771.72067901217,1568,0,385.8157894736842,35,3,17,37.748969780219774,0.6,47.222222222222214,1011.11111111111,28.888888888888857,0
4890,4,1,0,39,0.02564102564102564,0.0,1.0,39,850,300,550,0.35294117647058826,14,3,11,369.454628242232,0.41402384165542055,0.13230084709506307,0.19936357190262086,128116.02776763242,1666.611882152414,129782.63964978483,1569,0,376.8974358974359,36,3,18,37.55237300704486,0.6012731481481481,46.90315315315315,1012.3873873873868,28.121871871871853,0
4891,4,2,0,41,0.04878048780487805,0.0,1.0,41,1050,800,250,0.7619047619047619,13,8,5,368.23304329271934,0.42047764227642276,0.1514908406651545,0.18793645171063444,125851.22495623659,1117.441528354321,126968.66648459091,1570,0,359.4634146341463,37,4,18,39.91310148253378,0.576295045045045,49.15021929824562,1003.399122807018,27.118895211000485,8
4892,4,1,0,42,0.023809523809523808,0.0,1.0,42,850,500,350,0.5882352941176471,12,5,7,362.4641699817178,0.42349012775842043,0.171111111111111,0.1868857722176103,126270.10192202347,753.9720991228828,127024.07402114636,1571,0,351.8809523809524,36,6,18,39.62558356676002,0.5824652777777778,48.73310810810811,1005.0675675675684,27.918543543543567,0
4893,4,0,0,42,0.0,0.0,1.0,42,1650,1100,550,0.6666666666666666,22,11,11,371.61865547758504,0.4224254742547426,0.1888899552655008,0.1924015195403084,126439.93391618002,997.4876481211313,127437.42156430114,1572,1,352.8809523809524,36,6,18,39.22036539394618,0.5842013888888888,48.56418918918921,1005.743243243246,27.937312312312386,0
4894,4,2,0,44,0.045454545454545456,0.0,1.0,44,1400,900,500,0.6428571428571429,19,9,10,356.56187479362075,0.426301532769556,0.19994795281054767,0.18683842239185752,126930.47337278127,251.71351084814918,127182.18688362942,1573,0,337.79545454545456,38,6,20,39.09430661577608,0.5855263157894737,48.07692307692309,1007.6923076923094,26.51821862348183,0
4895,4,2,2,44,0.043478260869565216,0.043478260869565216,0.9565217391304348,46,1050,900,150,0.8571428571428571,12,9,3,342.0453998007439,0.4312701288244767,0.19979668439161702,0.18162995050093442,127469.34125940542,-479.73418438161383,126989.60707502381,1574,0,324.0652173913044,38,8,16,38.90755043024404,0.5910087719298245,47.542735042735046,1009.8290598290604,26.57444894287001,0
4896,4,2,0,46,0.043478260869565216,0.0,1.0,46,1100,800,300,0.7272727272727273,14,8,6,352.6649166345035,0.43266908212560384,0.1519633202246935,0.1930408480275433,128685.96734832697,-109.92311344876799,128576.04423487821,1575,0,325.0217391304348,38,8,17,37.39514232564668,0.6033442982456141,46.34081196581196,1014.6367521367509,26.700967161493445,8
4897,4,0,1,45,0.0,0.021739130434782608,0.9782608695652174,46,1400,1200,200,0.8571428571428571,16,12,4,353.49096952908627,0.4324074074074074,0.1558764302059501,0.19388938859851712,128767.28121119132,-96.38578420630961,128670.89542698501,1576,1,326.0217391304348,38,8,18,37.291228070175436,0.6041666666666667,46.260683760683754,1014.9572649572638,26.70940170940168,0
4898,4,1,1,45,0.021739130434782608,0.021739130434782608,0.9782608695652174,46,1700,1200,500,0.7058823529411765,22,12,10,346.46123779355224,0.43350442834138486,0.14425949092394497,0.1885059066972585,128446.04768990923,-164.7879190576141,128281.25977085161,1577,0,326.8478260869565,41,5,15,37.79726952436875,0.5960365853658536,46.57738095238095,1013.6904761904757,24.724157955865262,8
4899,4,2,0,47,0.0425531914893617,0.0,1.0,47,1000,700,300,0.7,13,7,6,354.7589955812616,0.43738436632747457,0.1919134731480634,0.19587404258396676,129029.04652852892,-245.15701054624265,128783.88951798268,1578,0,320.7659574468085,42,5,18,36.99213161659513,0.6004464285714286,46.002906976744185,1015.9883720930231,24.19019933554817,0
4900,4,0,0,47,0.0,0.0,1.0,47,1350,900,450,0.6666666666666666,18,9,9,361.9476676175881,0.4368832870798643,0.20341805121130352,0.20047194345754357,129153.25574638446,-50.65606347564767,129102.59968290881,1579,1,321.7659574468085,43,4,18,36.68289236693374,0.6002906976744187,45.88068181818183,1016.477272727274,23.639006342494746,0
4901,4,3,3,47,0.06,0.06,0.94,50,1250,700,550,0.56,18,7,11,345.0544464587258,0.441156462585034,0.2140624065397272,0.19478003108764633,129899.73855054847,-1035.4497187650518,128864.28883178341,1580,0,303.4,40,10,17,36.35355398265378,0.6122395833333334,45.14735772357723,1019.4105691056899,25.485264227642247,0
4902,4,0,1,46,0.0,0.02127659574468085,0.9787234042553191,47,1750,1400,350,0.8,21,14,7,366.72962250565405,0.43651711378353375,0.21478247917597604,0.2052492191057865,129563.94184989613,102.98709699138305,129666.92894688752,1581,1,323.6595744680851,37,10,17,36.14286034823192,0.6140202702702703,45.47697368421053,1018.0921052631579,27.516002844950215,0
4903,4,0,1,45,0.0,0.021739130434782608,0.9782608695652174,46,1350,800,550,0.5925925925925926,19,8,11,365.5045011345205,0.4353260869565217,0.22767726874817562,0.20551007799639107,129745.050770692,284.4800113229801,130029.53078201499,1582,2,331.30434782608694,38,8,18,35.98971441554808,0.6140350877192983,45.29914529914531,1018.8034188034205,26.81061628430054,0
4904,4,2,2,45,0.0425531914893617,0.0425531914893617,0.9574468085106383,47,1550,1400,150,0.9032258064516129,17,14,3,358.0514275359944,0.43952358926919516,0.2372308164668342,0.2051555303491144,130480.8049003764,-54.17203137553747,130426.63286900087,1583,0,316.1914893617021,38,9,20,35.4325699745547,0.6214364035087719,44.57799145299146,1021.6880341880357,26.886527215474622,0
4905,4,0,0,45,0.0,0.0,1.0,45,1150,800,350,0.6956521739130435,15,8,7,363.03473926565283,0.43756313131313135,0.21931143082098603,0.207442058988975,130374.54433094815,466.0977416128218,130840.64207256096,1584,1,318.0,37,8,20,35.41308782477991,0.6221846846846847,44.68201754385966,1021.2719298245628,27.601944049312507,0
4906,4,0,1,44,0.0,0.022222222222222223,0.9777777777777777,45,1050,700,350,0.6666666666666666,14,7,7,363.29578138848785,0.43691077441077436,0.2138714624285516,0.20830700558750007,130508.09500328742,482.6080703484696,130990.7030736359,1585,2,319.0,38,7,19,35.270937892095375,0.6217105263157895,44.55128205128206,1021.7948717948726,26.889338731444017,0
4907,4,0,0,44,0.0,0.0,1.0,44,1200,800,400,0.6666666666666666,16,8,8,368.6958199425966,0.4353417899929528,0.21769271719601102,0.2112545312229511,130480.80490037627,821.5454699028464,131302.3503702791,1586,3,326.90909090909093,38,6,20,35.16068876572901,0.6214364035087719,44.577991452991455,1021.6880341880346,26.886527215474597,0
4908,4,0,0,44,0.0,0.0,1.0,44,1400,900,500,0.6428571428571429,19,9,10,371.65129702181616,0.4353858350951374,0.22444339918469725,0.21354882634280567,130589.98243343196,906.7872698882334,131496.7697033202,1587,4,327.90909090909093,38,6,19,34.97439113619735,0.622532894736842,44.47115384615385,1022.1153846153846,26.897773279352226,0
4909,4,0,0,44,0.0,0.0,1.0,44,1350,1000,350,0.7407407407407407,17,10,7,374.6440420581762,0.4347692036645525,0.22926243209360653,0.21602968497475059,130726.51855504415,995.1822631309755,131721.70081817513,1588,5,328.90909090909093,38,6,19,34.75936759994428,0.6239035087719298,44.337606837606835,1022.6495726495723,26.91183085919927,0
4910,4,0,0,44,0.0,0.0,1.0,44,1650,1000,650,0.6060606060606061,23,10,13,373.89357292441343,0.4341195384073291,0.23159608193018055,0.2165146699800505,130890.45606874146,987.8200562495565,131878.276124991,1589,6,329.90909090909093,38,6,20,34.61230597897959,0.6255482456140351,44.17735042735043,1023.2905982905994,26.928699955015773,0
4911,4,0,0,44,0.0,0.0,1.0,44,1000,500,500,0.5,15,5,10,374.41003941366307,0.43333773784355184,0.22290182425317484,0.21758468209224613,131027.1491366245,1011.5760145007134,132038.72515112523,1590,7,330.90909090909093,38,6,20,34.4605464537897,0.6269188596491229,44.04380341880343,1023.824786324788,26.942757534862842,0
4912,4,0,0,44,0.0,0.0,1.0,44,1500,1200,300,0.8,18,12,6,371.4088276618218,0.4326770613107822,0.2162488213433913,0.21663312047605932,131168.01757812512,943.391927083348,132111.40950520846,1591,8,331.90909090909093,39,5,20,34.39470205409803,0.6266025641025641,43.90625000000001,1024.375000000001,26.266025641025664,0
4913,4,0,1,43,0.0,0.022727272727272728,0.9772727272727273,44,1600,900,700,0.5625,23,9,14,364.51354897439643,0.43187323819591267,0.20944474686989678,0.21412881344274834,131440.53939673738,782.5668114227398,132223.1062081601,1592,9,332.90909090909093,37,7,20,34.29569432563445,0.6328828828828829,43.64035087719298,1025.4385964912276,27.71455666192507,0
4914,4,1,1,43,0.022727272727272728,0.022727272727272728,0.9772727272727273,44,1000,500,500,0.5,15,5,10,364.6159843348796,0.4326440274841437,0.21060022936225664,0.21450427153889695,131496.76462950124,789.1644544475062,132285.92908394875,1593,0,333.34090909090907,37,7,21,34.23624474378161,0.6334459459459459,43.585526315789465,1025.657894736841,27.72048364153624,0
4915,4,0,0,43,0.0,0.0,1.0,43,1300,800,500,0.6153846153846154,18,8,10,368.906858811532,0.4329318936877076,0.21184321096309966,0.21702860108950123,131496.76462950138,1102.0116766697422,132598.77630617112,1594,1,337.83720930232556,37,6,21,34.12622051172403,0.6334459459459459,43.58552631578947,1025.657894736842,27.720483641536273,0
4916,4,0,0,43,0.0,0.0,1.0,43,1950,1200,750,0.6153846153846154,27,12,15,372.0757958431814,0.43277039497969727,0.21472900489901892,0.22012957182643358,131711.68456424848,1201.3459712177496,132913.03053546624,1595,2,338.83720930232556,38,5,19,33.82771301693033,0.6337719298245614,43.37606837606837,1026.495726495725,27.013045434098025,0
4917,4,0,0,43,0.0,0.0,1.0,43,950,600,350,0.631578947368421,13,6,7,375.0816711260494,0.43270118124769286,0.21828037654574928,0.22222779651796112,131766.5244448095,1284.6416374460991,133051.1660822556,1596,3,339.83720930232556,38,5,20,33.695152618799845,0.6343201754385965,43.32264957264956,1026.7094017094,27.018668466036843,0
4918,4,0,0,43,0.0,0.0,1.0,43,1200,1000,200,0.8333333333333334,14,10,4,376.1819115510334,0.4322858988556663,0.21083336356710114,0.2236851626198629,131903.67408366187,1323.9552514792722,133227.62933514113,1597,4,340.83720930232556,38,5,20,33.52834113364535,0.6356907894736843,43.189102564102555,1027.2435897435882,27.0327260458839,0
4919,4,0,0,43,0.0,0.0,1.0,43,1500,1200,300,0.8,18,12,6,376.49070005791987,0.4313861203396087,0.20997672243130894,0.22484277003459024,132068.3478180474,1344.5009451019057,133412.8487631493,1598,5,341.83720930232556,38,5,20,33.354121193223136,0.6373355263157895,43.02884615384615,1027.8846153846157,27.04959514170041,0
4920,4,0,0,43,0.0,0.0,1.0,43,1200,600,600,0.5,18,6,12,381.05123300618277,0.4309708379475821,0.2140375629955693,0.22839347253533723,132205.65440317048,1475.4255241434792,133681.07992731396,1599,6,342.83720930232556,38,5,20,33.0982928180622,0.6387061403508771,42.89529914529915,1028.4188034188037,27.063652721547466,0
4921,4,0,1,42,0.0,0.023255813953488372,0.9767441860465116,43,1250,900,350,0.72,16,9,7,381.7764302264765,0.4309246954595792,0.21417375322125265,0.22932783821901084,132288.07259706705,1500.89362352985,133788.9662205969,1600,7,343.83720930232556,38,5,20,32.99646034548413,0.6395285087719298,42.815170940170944,1028.7393162393168,27.072087269455707,0
4922,4,0,0,42,0.0,0.0,1.0,42,950,600,350,0.631578947368421,13,6,7,391.79214056355244,0.4263332365466512,0.2126769283861898,0.23550196379934726,132313.38158135183,1967.8685989919823,134281.2501803438,1601,8,352.6190476190476,37,5,20,32.71330686702902,0.6416103603603603,42.79057017543859,1028.8377192982446,27.8064248458985,0
4923,4,0,0,42,0.0,0.0,1.0,42,1200,1000,200,0.8333333333333334,14,10,4,388.6875563663729,0.42542586140147115,0.21601958251172926,0.23534079421491355,132587.25610342188,1907.1115224034993,134494.36762582537,1602,9,353.6190476190476,33,9,20,32.516757893066796,0.6527777777777778,42.524509803921575,1029.9019607843145,31.20915032679741,0
4924,4,0,1,41,0.0,0.023809523809523808,0.9761904761904762,42,1450,1200,250,0.8275862068965517,17,12,5,391.14971893904686,0.4245789779326365,0.2184602184602189,0.23815571494896398,132796.49234693873,1988.6621315192715,134785.154478458,1603,10,354.6190476190476,34,8,18,32.2423384923385,0.6525735294117647,42.32142857142857,1030.7142857142853,30.315126050420158,0
4925,4,0,0,41,0.0,0.0,1.0,41,1300,900,400,0.6923076923076923,17,9,8,350.25208434170247,0.4255589430894309,0.07917467999745265,0.20239370594881112,130808.47447083422,963.1881665936118,131771.66263742783,1604,11,357.9512195121951,38,3,17,35.300043516100956,0.6247258771929824,44.25747863247863,1022.9700854700852,26.920265407107507,8
4926,4,0,0,41,0.0,0.0,1.0,41,900,400,500,0.4444444444444444,14,4,10,350.01864656340587,0.42558434959349595,0.07714834300149254,0.20268915337269022,130890.45606874114,962.8200562495261,131853.27612499066,1605,12,358.9512195121951,38,3,18,35.22308067098213,0.6255482456140351,44.17735042735042,1023.2905982905968,26.928699955015706,0
4927,4,0,1,40,0.0,0.024390243902439025,0.975609756097561,41,1150,700,450,0.6086956521739131,16,7,9,348.81268063279276,0.4253302845528455,0.07610305908945092,0.20256503671657064,130999.80481591041,938.8786160420573,131938.68343195246,1606,13,359.9512195121951,38,3,18,35.143367772907524,0.6266447368421053,44.07051282051281,1023.7179487179474,26.93994601889335,0
4928,4,0,0,40,0.0,0.0,1.0,40,1300,1200,100,0.9230769230769231,14,12,2,363.52422228871256,0.42538728632478634,0.1442254733218593,0.1916584148364261,127179.55789448273,1270.0947941206978,128449.65268860343,1607,14,361.4,35,5,19,38.662865748709116,0.59375,47.82986111111109,1008.6805555555532,28.819444444444375,8
4929,4,2,0,42,0.047619047619047616,0.0,1.0,42,1300,1000,300,0.7692307692307693,16,10,6,350.0728340479053,0.43140243902439024,0.1466761836082946,0.18743281853850075,127801.98703342023,548.0007595486204,128349.98779296885,1608,0,345.14285714285717,39,3,17,38.36417447889839,0.5926816239316239,47.21354166666667,1011.1458333333342,25.92681623931626,0
4930,4,0,1,41,0.0,0.023809523809523808,0.9761904761904762,42,1400,800,600,0.5714285714285714,20,8,12,350.0652960773329,0.43136614401858303,0.14364417376465588,0.18792062411315555,127907.3364257814,555.1839192708478,128462.52034505224,1609,1,346.14285714285717,39,3,17,38.25655184841931,0.59375,47.10937500000001,1011.5625000000011,25.93750000000003,0
4931,4,1,0,42,0.023809523809523808,0.0,1.0,42,1050,800,250,0.7619047619047619,13,8,5,354.11268607427695,0.4328784359272164,0.15177346658828128,0.19122085048010978,128144.53125000016,675.5208333333478,128820.0520833335,1610,0,346.73809523809524,39,3,19,37.911522633744866,0.5961538461538461,46.87500000000001,1012.5000000000013,25.961538461538492,0
4932,4,1,0,43,0.023255813953488372,0.0,1.0,43,1200,900,300,0.75,15,9,6,347.4869000649947,0.4352390180878553,0.16296629120637918,0.1896646679991117,128572.46393352811,335.449385196005,128907.91331872411,1611,0,339.6511627906977,36,7,18,37.64226626693314,0.6059027777777778,46.4527027027027,1014.1891891891892,28.17192192192192,0
4933,4,2,0,45,0.044444444444444446,0.0,1.0,45,1250,900,350,0.72,16,9,7,334.419234518098,0.4391414141414141,0.165567354758817,0.1848147204823723,129065.65176647295,-367.59270673535167,128698.0590597376,1612,0,325.5111111111111,38,7,20,37.47152420004904,0.6071820175438596,45.966880341880334,1016.1324786324776,26.7403283850652,0
4934,4,0,2,43,0.0,0.044444444444444446,0.9555555555555556,45,1350,1000,350,0.7407407407407407,17,10,7,338.2827196990054,0.4387626262626263,0.16612021857923498,0.18759314456035775,129201.38888888907,-258.537877127602,128942.85101176146,1613,1,326.5111111111111,36,9,20,37.23531420765028,0.6122685185185186,45.83333333333334,1016.6666666666681,28.24074074074078,0
4935,4,0,2,41,0.0,0.046511627906976744,0.9534883720930233,43,1500,1100,400,0.7333333333333333,19,11,8,361.06869381978305,0.4361387966039129,0.07429106189712087,0.19223425829420016,127575.0639786746,690.797342951058,128265.86132162566,1614,2,341.4186046511628,36,7,17,38.318842195221634,0.595775462962963,47.43806306306306,1010.2477477477476,28.06243743743743,8
4936,4,1,0,42,0.023809523809523808,0.0,1.0,42,1450,1100,350,0.7586206896551724,18,11,7,364.1141752733541,0.4333744676732481,0.10413737479427643,0.19519200389807173,127851.72994898837,910.5254415294992,128762.25539051788,1615,0,350.3809523809524,35,7,18,37.95824750133517,0.6005952380952381,47.164351851851855,1011.3425925925928,28.895502645502653,0
4937,4,1,1,42,0.023255813953488372,0.023255813953488372,0.9767441860465116,43,1250,800,450,0.64,17,8,9,353.47360007356417,0.435515873015873,0.09316465924298667,0.18774462841277517,127479.27847991674,412.11189981530697,127891.39037973205,1616,0,343.2093023255814,37,6,16,38.6088490770901,0.5929054054054055,47.532894736842096,1009.8684210526302,27.293741109530547,8
4938,4,1,1,42,0.023255813953488372,0.023255813953488372,0.9767441860465116,43,750,600,150,0.8,9,6,3,352.07745557964785,0.43512366186784796,0.09742505085789555,0.18751685986768055,127590.033712296,384.3148853493261,127974.34859764534,1617,0,343.4186046511628,37,6,18,38.530587511757474,0.5940315315315315,47.42324561403508,1010.3070175438589,27.305595068752943,0
4939,4,0,1,41,0.0,0.023809523809523808,0.9761904761904762,42,1200,900,300,0.75,15,9,6,350.5367280455038,0.43217673248161054,0.10655653018421529,0.18721017144400076,127700.8370363958,552.766716682052,128253.60375307784,1618,1,351.64285714285717,37,5,18,38.45600998047298,0.5951576576576576,47.31359649122807,1010.7456140350876,27.31744902797534,0
4940,4,1,1,41,0.023809523809523808,0.023809523809523808,0.9761904761904762,42,1400,900,500,0.6428571428571429,19,9,10,371.7347177128562,0.43064024390243905,0.10983861006815254,0.1957054136212757,127121.191875107,1127.3094753721555,128248.50135047916,1619,0,352.54761904761904,35,7,16,38.51584318451357,0.5931547619047619,47.887731481481474,1008.4490740740728,28.81283068783065,8
4941,4,1,0,42,0.023809523809523808,0.0,1.0,42,1150,800,350,0.6956521739130435,15,8,7,368.6947594202528,0.4302893921796361,0.11703277802348988,0.19522689720121567,127354.7363281249,991.0047743055408,128345.74110243045,1620,0,353.45238095238096,35,7,15,38.35246818025454,0.5955357142857143,47.65624999999999,1009.3749999999992,28.83928571428569,0
4942,4,2,0,44,0.045454545454545456,0.0,1.0,44,850,600,250,0.7058823529411765,11,6,5,358.60097009536514,0.433491895701198,0.14394419327900465,0.19286256602914256,127982.3229988493,378.9170364891331,128361.24003533843,1621,0,338.34090909090907,38,6,17,37.96391616513567,0.596217105263158,47.0352564102564,1011.8589743589732,26.627867746288768,0
4943,4,1,0,45,0.022222222222222223,0.0,1.0,45,1700,1500,200,0.8823529411764706,19,15,4,347.0682119269496,0.4366372053872054,0.14449012960157703,0.18846089392649035,128366.66690712518,-89.3966321681284,128277.27027495706,1622,0,331.8,37,8,18,37.86292649498663,0.6019144144144144,46.65570175438596,1013.3771929824554,27.388572783309606,0
4944,4,0,2,43,0.0,0.044444444444444446,0.9555555555555556,45,1250,900,350,0.72,16,9,7,347.7483109511403,0.4367213804713805,0.1450499513954775,0.1890594971916026,128415.10662073546,-68.77271440574197,128346.33390632972,1623,1,332.8,38,7,13,37.79623871262429,0.6006030701754386,46.607905982905976,1013.5683760683747,26.672852001799335,0
4945,4,1,0,44,0.022727272727272728,0.0,1.0,44,1500,1100,400,0.7333333333333333,19,11,8,349.29214968313164,0.4339543692741367,0.14305235146027018,0.19119467121272019,128685.96734832684,189.79963383005347,128875.7669821569,1624,0,333.95454545454544,38,6,15,37.48069565827805,0.6033442982456141,46.34081196581195,1014.6367521367498,26.700967161493416,0
4946,4,0,4,40,0.0,0.09090909090909091,0.9090909090909091,44,1450,800,650,0.5517241379310345,21,8,13,364.78328949302977,0.43388830162085973,0.09432028139233894,0.19256288276680242,127230.25504241693,484.3544679813799,127714.60951039831,1625,1,334.95454545454544,37,7,16,38.57902673622433,0.5903716216216216,47.7796052631579,1008.8815789473687,27.267069701280235,8
4947,4,2,0,42,0.047619047619047616,0.0,1.0,42,1400,1000,400,0.7142857142857143,18,10,8,374.65208146448447,0.4314750290360046,0.13191999257573062,0.19866809158751958,127413.15593117705,1147.1208151148771,128560.27674629193,1626,0,350.54761904761904,35,7,15,38.14210038595286,0.5961309523809524,47.598379629629626,1009.6064814814808,28.845899470899454,0
4948,4,0,0,42,0.0,0.0,1.0,42,900,600,300,0.6666666666666666,12,6,6,373.12230464658404,0.43163230739450253,0.13299608176986144,0.19828655483228325,127500.81045310349,1114.6792481138443,128615.48970121733,1627,1,351.54761904761904,35,7,17,38.090667736267086,0.5970238095238095,47.51157407407407,1009.9537037037031,28.85582010582009,0
4949,4,1,0,43,0.023255813953488372,0.0,1.0,43,1300,1000,300,0.7692307692307693,16,10,6,365.52391163646365,0.4337393872277593,0.13793424968336998,0.19570895662395985,127802.69870799854,742.9884698888086,128545.68717788735,1628,0,344.3488372093023,36,7,18,37.972862605338385,0.5980902777777778,47.21283783783784,1011.1486486486486,28.08746246246246,0
4950,4,1,0,44,0.022727272727272728,0.0,1.0,44,1000,600,400,0.6,14,6,8,356.74741330258735,0.43561707188160675,0.13873247341196726,0.1925168300881649,128118.1654188369,341.16482204861995,128459.33024088552,1629,0,337.5,39,5,19,37.87180179716706,0.5958867521367521,46.90104166666667,1012.3958333333342,25.958867521367544,0
4951,4,0,0,44,0.0,0.0,1.0,44,850,600,250,0.7058823529411765,11,6,5,356.43747202402307,0.4354188689217759,0.1402741546488162,0.19260971645066408,128172.28768707669,337.08666669069925,128509.37435376739,1630,1,338.5,37,7,19,37.82428713228659,0.5999436936936937,46.84758771929824,1012.6096491228062,27.36782835467044,0
4952,4,1,1,44,0.022222222222222223,0.022222222222222223,0.9777777777777777,45,1550,1100,450,0.7096774193548387,20,11,9,352.5131442918913,0.4370159932659932,0.13639217029047535,0.19225296692893906,128540.34423828122,62.432183159720694,128602.77642144094,1631,0,331.9555555555556,39,6,14,37.54761599041261,0.6001602564102564,46.484375,1014.0624999999998,26.00160256410256,0
4953,4,2,1,45,0.043478260869565216,0.021739130434782608,0.9782608695652174,46,1350,1000,350,0.7407407407407407,17,10,7,348.82746090276504,0.43841586151368755,0.1458535093531783,0.1919676284839088,128898.98667800463,-207.29875283445614,128691.68792517018,1632,0,325.69565217391306,41,5,16,37.275302852676845,0.600609756097561,46.13095238095239,1015.4761904761912,24.767711962833932,0
4954,4,0,3,42,0.0,0.06666666666666667,0.9333333333333333,45,1300,1000,300,0.7692307692307693,16,10,6,353.7735737963275,0.43602693602693604,0.1435935084148121,0.1942740092716612,128814.23017259905,114.21411279662334,128928.44428539567,1633,1,333.8666666666667,40,5,16,37.23616811826342,0.6013020833333333,46.21443089430895,1015.1422764227648,25.37855691056912,0
4955,4,0,2,40,0.0,0.047619047619047616,0.9523809523809523,42,1350,600,750,0.4444444444444444,21,6,15,394.92239245635386,0.43354384436701515,0.16883266056250212,0.20687089944193848,126917.01630015434,1625.6362269436568,128542.65252709799,1634,2,354.9761904761905,35,7,19,38.141798759476224,0.5910714285714286,48.09027777777778,1007.638888888889,28.789682539682545,8
4956,4,0,1,39,0.0,0.025,0.975,40,900,600,300,0.6666666666666666,12,6,6,399.40113701704473,0.4298878205128205,0.1739428301441064,0.2095000016100556,126972.00255102025,2142.552437641707,129114.55498866196,1635,3,362.95,34,6,19,37.972232065516984,0.59375,48.03571428571428,1007.8571428571416,29.642857142857107,0
4957,4,3,1,41,0.07142857142857142,0.023809523809523808,0.9761904761904762,42,1100,800,300,0.7272727272727273,14,8,6,381.0370253920219,0.4367378048780488,0.18451221973155318,0.2032275057237472,127646.96830257626,1327.700909807075,128974.66921238333,1636,0,346.3809523809524,35,7,16,37.7406415836292,0.5985119047619047,47.366898148148145,1010.5324074074072,28.87235449735449,0
4958,4,1,1,41,0.023809523809523808,0.023809523809523808,0.9761904761904762,42,750,500,250,0.6666666666666666,10,5,5,381.11642703956164,0.4384315718157181,0.19488162871253012,0.20376903904312935,127745.77100326664,1337.2023628357906,129082.97336610242,1637,0,347.35714285714283,36,6,17,37.63715606550072,0.5975115740740741,47.269144144144136,1010.9234234234223,28.081206206206176,0
4959,4,1,0,42,0.023809523809523808,0.0,1.0,42,1850,1300,550,0.7027027027027027,24,13,11,374.09608968822516,0.4390364885791715,0.18018812463256917,0.2020118884316414,128144.53124999988,1189.537806387453,129334.06905638734,1638,0,323.9761904761905,34,8,20,37.4056927297668,0.6056985294117647,46.87499999999999,1012.4999999999991,29.779411764705856,0
4960,4,0,1,41,0.0,0.023809523809523808,0.9761904761904762,42,1450,1000,450,0.6896551724137931,19,10,9,374.8587688900558,0.43912117692605496,0.19276174810189617,0.20334117157573375,128325.39859693873,1220.7801870748244,129546.17878401355,1639,1,324.9761904761905,34,8,21,37.201122077311716,0.6075367647058824,46.69642857142857,1013.2142857142853,29.800420168067216,0
4961,4,1,0,42,0.023809523809523808,0.0,1.0,42,850,500,350,0.5882352941176471,12,5,7,375.44347555231985,0.4394236353077816,0.1961400685142034,0.2052055070674354,128627.1276218821,1258.4431689342439,129885.57079081635,1640,0,325.42857142857144,34,8,18,36.87751828815084,0.6106004901960784,46.398809523809526,1014.404761904762,29.835434173669473,0
4962,4,0,1,41,0.0,0.023809523809523808,0.9761904761904762,42,1300,900,400,0.6923076923076923,17,9,8,369.26823811791843,0.43828639179248935,0.18504095271594423,0.2030618183692926,128868.76594387765,1117.4284297052277,129986.19437358287,1641,1,326.42857142857144,34,8,20,36.78723570563177,0.6130514705882353,46.16071428571429,1015.3571428571436,29.863445378151283,0
4963,4,0,0,41,0.0,0.0,1.0,41,1200,1000,200,0.8333333333333334,14,10,4,376.10065962546594,0.4367632113821138,0.19172468610624605,0.20676801360298488,128858.9894061177,1492.7901828623492,130351.77958898005,1642,2,335.3170731707317,33,8,20,36.62379299939651,0.6152146464646464,46.170343137254896,1015.3186274509793,30.76723113487816,0
4964,4,1,1,41,0.023809523809523808,0.023809523809523808,0.9761904761904762,42,1650,1100,550,0.6666666666666666,22,11,11,369.8729789748583,0.43857675183894695,0.18968148772944504,0.2055978467858238,129294.84941188479,1164.9885260476608,130459.83793793245,1643,0,328.3095238095238,33,9,21,36.337083785195,0.6196338383838385,45.741421568627445,1017.0343137254897,30.819221628045142,0
4965,4,0,0,41,0.0,0.0,1.0,41,1600,1100,500,0.6875,21,11,10,374.0496025779533,0.43841463414634146,0.1831735513886934,0.208743810470922,129450.69204152234,1484.1959823144766,130934.88802383681,1644,1,320.8780487804878,33,8,18,36.07197334617854,0.6212121212121212,45.58823529411764,1017.6470588235281,30.837789661319036,0
4966,4,0,0,41,0.0,0.0,1.0,41,1200,800,400,0.6666666666666666,16,8,8,372.8426742669179,0.4385162601626016,0.17959362899684672,0.2089971320890703,129625.34722222207,1465.972222222203,131091.31944444426,1645,2,321.8780487804878,34,7,19,35.92471358428804,0.6207107843137255,45.41666666666666,1018.3333333333321,29.950980392156826,0
4967,4,0,0,41,0.0,0.0,1.0,41,900,600,300,0.6666666666666666,12,6,6,371.9032841410258,0.4374491869918699,0.17889978853048683,0.20911618302752283,129746.6057256235,1450.6377551020341,131197.24348072553,1646,3,322.8780487804878,34,7,20,35.825153852146144,0.6219362745098039,45.297619047619044,1018.8095238095232,29.96498599439774,0
4968,4,0,0,41,0.0,0.0,1.0,41,1500,1200,300,0.8,18,12,6,368.1346841955956,0.4375,0.17920362805590195,0.20763960250874117,129867.92091836738,1361.7772108843583,131229.69812925174,1647,4,323.8780487804878,34,7,20,35.797710815230076,0.6231617647058824,45.17857142857143,1019.2857142857147,29.978991596638668,0
4969,4,0,1,40,0.0,0.024390243902439025,0.975609756097561,41,850,700,150,0.8235294117647058,10,7,3,365.86001032749306,0.4374491869918699,0.17337464827240479,0.20667711929054414,129928.59977324259,1307.1357709750455,131235.73554421763,1648,5,324.8780487804878,34,7,20,35.79397283200995,0.6237745098039216,45.11904761904761,1019.5238095238092,29.985994397759093,0
4970,4,0,0,40,0.0,0.0,1.0,40,1500,1200,300,0.8,18,12,6,372.8487731684535,0.4355902777777778,0.17718802596778094,0.2104040770159562,129887.55076172622,1685.6827902729672,131573.23355199918,1649,6,333.8,33,7,20,35.65761000240442,0.6256313131313131,45.15931372549019,1019.3627450980389,30.889780154486026,0
4971,4,0,0,40,0.0,0.0,1.0,40,1200,800,400,0.6666666666666666,16,8,8,370.4165125739646,0.4350026709401709,0.17736778846153856,0.20936585493311038,129950.01922337555,1627.1265859284813,131577.14580930403,1650,7,334.8,33,7,20,35.65604967948719,0.6262626262626263,45.09803921568627,1019.6078431372543,30.897207367795588,0
4972,4,1,1,40,0.024390243902439025,0.024390243902439025,0.975609756097561,41,1450,1200,250,0.8275862068965517,17,12,5,361.09371954360654,0.4351626016260162,0.17568597560975596,0.20590024859082243,130292.97052154191,1209.5946712018085,131502.56519274373,1651,0,327.609756097561,34,7,21,35.54541744402986,0.6274509803921569,44.76190476190476,1020.9523809523806,30.028011204481782,0
4973,4,0,1,39,0.0,0.025,0.975,40,900,600,300,0.6666666666666666,12,6,6,361.6000605223633,0.435403311965812,0.17010432451334645,0.20667334571761187,130384.14292800447,1429.3827947845732,131813.52572278905,1652,1,332.275,34,6,21,35.4399794070793,0.6283700980392157,44.672619047619044,1021.3095238095233,30.03851540616245,0
4974,4,0,0,39,0.0,0.0,1.0,39,1350,1100,250,0.8148148148148148,16,11,5,370.68283332512783,0.43328272604588397,0.17321773173411636,0.21137294212400012,130293.86421388417,1859.5397503364184,132153.40396422058,1653,2,341.38461538461536,33,6,22,35.299758932501106,0.6297348484848485,44.76102941176471,1020.9558823529418,30.938057040998235,0
4975,4,0,0,39,0.0,0.0,1.0,39,900,600,300,0.6666666666666666,12,6,6,370.5512892304404,0.4330015744489429,0.16709729809537888,0.21215079306490056,130450.30757401,1867.705930411383,132318.0135044214,1654,3,342.38461538461536,33,6,22,35.14425383877159,0.6313131313131313,44.6078431372549,1021.5686274509806,30.95662507427214,0
4976,4,0,0,39,0.0,0.0,1.0,39,1100,900,200,0.8181818181818182,13,9,4,366.73918582837365,0.4322143499775079,0.17092377773269662,0.21098884746070992,130638.16350682438,1782.0267445213487,132420.19025134572,1655,4,343.38461538461536,33,6,20,35.05104691121235,0.6332070707070707,44.42401960784314,1022.3039215686281,30.97890671420085,0
4977,4,0,0,39,0.0,0.0,1.0,39,1150,900,250,0.782608695652174,14,9,5,366.7232175078084,0.43100539811066124,0.16606611311295616,0.2118365879956872,130794.81336805574,1793.0989583333533,132587.91232638908,1656,5,344.38461538461536,33,6,20,34.89265105227426,0.6347853535353536,44.27083333333334,1022.9166666666681,30.99747474747479,0
4978,4,1,1,39,0.025,0.025,0.975,40,1100,900,200,0.8181818181818182,13,9,4,361.4772109602425,0.43301282051282053,0.1703213995117978,0.21054762666831214,131114.67013888905,1478.9930555555752,132593.6631944446,1657,0,336.75,34,6,21,34.70301057770545,0.6357230392156863,43.95833333333334,1024.166666666668,30.122549019607884,0
4979,4,0,0,39,0.0,0.0,1.0,39,1150,700,450,0.6086956521739131,16,7,9,375.87023345502047,0.43139901034637873,0.17910978973561242,0.21889529902324786,131108.39468293454,2055.9485834775173,133164.34326641206,1658,1,346.2307692307692,33,6,21,34.340846994535525,0.6379419191919191,43.96446078431373,1024.1421568627457,31.034610814022596,0
4980,4,0,0,39,0.0,0.0,1.0,39,1050,700,350,0.6666666666666666,14,7,7,376.7450398755524,0.43052744039586144,0.1752985115816974,0.22030363800275324,131265.3261365822,2090.712105920816,133356.03824250304,1659,2,347.2307692307692,33,6,21,34.15949134975684,0.639520202020202,43.81127450980393,1024.7549019607852,31.053178847296522,0
4981,4,0,0,39,0.0,0.0,1.0,39,1200,900,300,0.75,15,9,6,378.01724877591647,0.4288686459739091,0.18022591378907582,0.22216035416483285,131457.57607642058,2138.6612660940386,133596.23734251462,1660,3,348.2307692307692,32,7,21,33.93227242879422,0.6438802083333333,43.62373737373736,1025.505050505049,32.04703282828278,0
4982,4,2,0,41,0.04878048780487805,0.0,1.0,41,1450,1100,350,0.7586206896551724,18,11,7,358.84361051054236,0.4295223577235772,0.18794103854867683,0.21426388196044405,132061.28826530607,1277.8698979591818,133339.15816326524,1661,0,332.1951219512195,34,7,21,33.81471507991662,0.6452205882352942,43.035714285714285,1027.8571428571424,30.231092436974777,0
4983,4,1,1,41,0.023809523809523808,0.023809523809523808,0.9761904761904762,42,1400,1000,400,0.7142857142857143,18,10,8,349.821243609877,0.4304829655439411,0.19187998898981617,0.21160515784793235,132551.19756235814,874.2736678004411,133425.47123015858,1662,0,325.26190476190476,34,8,23,33.55370905587669,0.6501225490196079,42.5595238095238,1029.7619047619037,30.287114845938344,0
4984,4,0,0,41,0.0,0.0,1.0,41,1400,1000,400,0.7142857142857143,18,10,8,358.40233110027174,0.42792174796747967,0.20197943914923,0.21645851787012105,132492.61289227704,1297.132262831605,133789.74515510866,1663,1,334.0731707317073,33,8,23,33.3917341189541,0.6518308080808081,42.61642156862745,1029.5343137254904,31.198009506833042,0
4985,4,0,0,41,0.0,0.0,1.0,41,1900,1500,400,0.7894736842105263,23,15,8,355.34102866777414,0.4276930894308943,0.19833453100562193,0.21582291951716384,132704.4802295918,1231.0693027210873,133935.5495323129,1664,2,335.0731707317073,34,7,20,33.257510109763146,0.6516544117647058,42.410714285714285,1030.3571428571427,30.30462184873949,0
4986,4,0,0,41,0.0,0.0,1.0,41,1600,1200,400,0.75,20,12,8,354.6012284509925,0.4270833333333333,0.20012002129955442,0.21572613033733234,132765.81809807243,1215.7844387754926,133981.60253684793,1665,3,336.0731707317073,34,7,20,33.21493203958261,0.6522671568627452,42.35119047619047,1030.5952380952372,30.311624649859915,0
4987,4,0,0,41,0.0,0.0,1.0,41,1350,1200,150,0.8888888888888888,15,12,3,353.5662232419237,0.4264989837398374,0.19718873014174632,0.21597959278713275,132919.22477324257,1199.1496598639394,134118.3744331065,1666,4,337.0731707317073,34,7,21,33.08752789963826,0.6537990196078431,42.20238095238095,1031.1904761904757,30.32913165266105,0
4988,4,0,0,41,0.0,0.0,1.0,41,1050,500,550,0.47619047619047616,16,5,11,353.0891713927047,0.42609247967479674,0.19543717246542425,0.21639821494265746,133042.0138888888,1195.1388888888803,134237.15277777766,1667,5,338.0731707317073,34,7,22,32.97657512116317,0.6550245098039216,42.08333333333333,1031.6666666666658,30.343137254901936,0
4989,4,0,0,41,0.0,0.0,1.0,41,1250,700,550,0.56,18,7,11,353.77167134913117,0.42553353658536586,0.199387711459025,0.21717371439477812,133103.42970521533,1217.6445578231185,134321.07426303843,1668,6,339.0731707317073,34,7,22,32.89734271650515,0.6556372549019608,42.02380952380952,1031.9047619047612,30.35014005602239,0
4990,4,0,2,39,0.0,0.04878048780487805,0.9512195121951219,41,1050,500,550,0.47619047619047616,16,5,11,354.69399969022766,0.4251524390243902,0.1935019350193503,0.21845925890011747,133226.30385487527,1250.9141156462588,134477.21797052154,1669,7,340.0731707317073,34,7,23,32.75027867466176,0.6568627450980392,41.904761904761905,1032.3809523809523,30.364145658263304,0
4991,4,0,0,39,0.0,0.0,1.0,39,850,700,150,0.8235294117647058,10,7,3,368.9344692350366,0.42524179037336934,0.2348912190356811,0.21287565753447268,130751.61944038617,1854.3070261035837,132605.92646648976,1670,8,349.53846153846155,36,3,17,34.879890626146945,0.6278935185185186,44.313063063063055,1022.7477477477465,28.409659659659624,8
4992,4,0,0,39,0.0,0.0,1.0,39,1350,1100,250,0.8148148148148148,16,11,5,363.4354414539362,0.4243421052631579,0.22969168711742927,0.2109596527979744,130982.06948502551,1720.7052491680743,132702.77473419358,1671,9,350.53846153846155,36,3,17,34.78708287495414,0.6302083333333333,44.08783783783783,1023.6486486486482,28.434684684684672,0
4993,4,0,0,39,0.0,0.0,1.0,39,1350,800,550,0.5925925925925926,19,8,11,357.1062057550689,0.42335807467386416,0.13899935613377323,0.20056743566371132,129701.9692670823,1494.5360348578815,131196.50530194017,1672,10,351.53846153846155,35,4,15,36.24741980078021,0.6193452380952381,45.341435185185176,1018.6342592592578,29.103835978835935,8
4994,4,2,0,41,0.04878048780487805,0.0,1.0,41,1250,800,450,0.64,17,8,9,342.312640319607,0.4291412601626016,0.13492875350426625,0.19533519488354253,130321.66950660125,724.5689193243902,131046.23842592564,1673,0,335.3414634146341,35,6,18,35.995711478878555,0.6255952380952381,44.73379629629628,1021.0648148148127,29.173280423280364,0
4995,4,0,0,41,0.0,0.0,1.0,41,1150,900,250,0.782608695652174,14,9,5,347.2721080041695,0.4275660569105691,0.1422966835014976,0.19907260840654567,130498.99798525349,863.7324245541495,131362.73040980764,1674,1,336.3414634146341,35,6,15,35.68947288929165,0.6273809523809524,44.56018518518517,1021.759259259257,29.19312169312163,0
4996,4,1,1,41,0.023809523809523808,0.023809523809523808,0.9761904761904762,42,850,500,350,0.5882352941176471,12,5,7,339.01468800942473,0.4272164150212931,0.14940354960721614,0.19583083742662016,130794.81336805518,468.2725694444047,131263.0859374996,1675,0,329.3095238095238,37,5,16,35.601238968092325,0.6264076576576576,44.270833333333314,1022.9166666666637,27.646396396396316,0
4997,4,0,0,41,0.0,0.0,1.0,41,1000,700,300,0.7,13,7,6,343.70639844532803,0.42416158536585363,0.15747578968852927,0.19831902863281223,130751.61944038606,788.0336417498265,131539.6530821359,1676,1,338.2926829268293,36,5,16,35.52493944065182,0.6278935185185186,44.31306306306305,1022.7477477477455,28.409659659659596,0
4998,4,0,1,40,0.0,0.024390243902439025,0.975609756097561,41,1000,1000,0,1.0,10,10,0,347.8493398541753,0.4239837398373984,0.1663293300333406,0.20130949693726338,130866.8190995048,904.3873265156981,131771.2064260205,1677,2,339.2926829268293,36,5,17,35.30248000586984,0.6290509259259259,44.20045045045045,1023.1981981981974,28.42217217217215,0
4999,4,0,0,40,0.0,0.0,1.0,40,800,500,300,0.625,11,5,6,356.53520375286934,0.4244791666666667,0.1647816000905289,0.20579370317205123,130765.21675936632,1324.4806402177517,132089.69739958408,1678,3,343.7,35,5,17,35.18315510542794,0.6300595238095238,44.29976851851851,1022.8009259259251,29.222883597883573,0
5000,4,0,0,40,0.0,0.0,1.0,40,900,400,500,0.4444444444444444,14,4,10,359.78655067280556,0.422769764957265,0.1689287733182594,0.2089502324820065,131002.08340031267,1426.5575435099192,132428.6409438226,1679,4,344.7,35,5,18,34.860208215564356,0.6324404761904762,44.068287037037024,1023.7268518518497,29.249338624338563,0
