period,mktsize,entries,exits,surviv,entryrate,exitrate,survivrate,firms,totresinv,totinninv,totimiinv,costshareinn,firmsres,firmsinn,firmsimi,hindex,div,gini,pcm,cs,totprofits,ts,maxage,minage,avgage,actfirms,inactfirms,profitablefirms,wmc,avgproxopt,price,totoutput,avgoutput,magtechshock
1,4,40,24,16,1.0,0.6,0.4,40,0,0,0,0,0,0,0,409.8644726422912,0.4972355769230769,0.12504049519842675,0.17597906791094495,118416.74180514974,2506.9630863972106,120923.70489154695,0,0,0.0,36,4,16,46.699159242546976,0.5008680555555556,56.6722972972973,973.3108108108107,27.036411411411407,0
2,4,37,38,15,0.6981132075471698,0.7169811320754716,0.28301886792452835,53,300,300,0,1.0,3,3,0,315.21404579335467,0.5015874455732946,-0.12736928457320496,0.15137201979307244,123301.26549586773,-826.7418503213977,122474.52364554633,1,0,0.3018867924528302,43,10,12,43.877923976608194,0.5406976744186046,51.70454545454545,993.1818181818178,23.09725158562367,0
3,4,33,30,18,0.6875,0.625,0.375,48,500,300,200,0.6,7,3,4,332.952981963106,0.4961122192671395,-0.21002044989774993,0.16056608301771136,123480.25728732935,222.62397547760133,123702.88126280696,2,0,0.5,40,8,17,43.25132072256305,0.5468749999999998,51.52439024390246,993.9024390243935,24.847560975609838,0
4,4,28,24,22,0.6086956521739131,0.5217391304347826,0.4782608695652174,46,500,300,200,0.6,7,3,4,330.5391740007939,0.49688003220611915,-0.1556684954307832,0.16184088219274548,124121.91786694109,-594.5687585733812,123527.3491083677,3,0,0.8260869565217391,44,2,18,42.645225484730226,0.5478219696969697,50.87962962962963,996.4814814814821,22.647306397306412,8
5,4,12,10,24,0.35294117647058826,0.29411764705882354,0.7058823529411764,34,650,500,150,0.7692307692307693,8,5,3,349.23023654840574,0.4864267676767677,-0.04331652794625984,0.1732520670848362,124672.8334041953,1907.9046201814415,126580.73802437674,4,0,1.6176470588235294,34,0,18,41.60805817141495,0.5701593137254901,50.32738095238097,998.6904761904785,29.37324929971996,0
6,4,11,14,21,0.3142857142857143,0.4,0.6,35,650,300,350,0.46153846153846156,10,3,7,339.4096339451127,0.48564425770308123,-0.031116320948642806,0.17080165241438994,125268.00063775525,1526.6794217687302,126794.68005952398,5,0,2.2,34,1,13,41.23781067903438,0.5762867647058822,49.73214285714287,1001.0714285714298,29.443277310924405,4
7,4,16,15,22,0.43243243243243246,0.40540540540540543,0.5945945945945945,37,500,200,300,0.4,8,2,6,327.9261440045968,0.48604854854854856,-0.11760536760536733,0.1674765664023477,125878.73191751314,855.7854339796935,126734.51735149283,6,0,2.2432432432432434,37,0,15,40.89588796620046,0.5765765765765765,49.12280701754386,1003.508771929825,27.12185870080608,0
8,4,10,9,23,0.3125,0.28125,0.71875,32,700,400,300,0.5714285714285714,10,4,6,354.47821706013997,0.4871051747311828,-0.03811761377923062,0.1819044992578292,126075.53597847157,2538.206241710026,128613.7422201816,7,0,3.21875,32,0,20,40.0267685022211,0.5891927083333334,48.926767676767675,1004.2929292929291,31.384154040404034,0
9,4,7,6,24,0.23333333333333334,0.2,0.8,30,900,700,200,0.7777777777777778,11,7,4,367.85528199906054,0.4844588122605364,-0.026085214371577514,0.1911264744154732,126584.28945904164,3312.939899121303,129897.22935816295,8,0,3.566666666666667,30,0,19,39.16622145051423,0.5996527777777776,48.42069892473119,1006.3172043010763,33.54390681003588,0
10,4,5,6,23,0.1724137931034483,0.20689655172413793,0.7931034482758621,29,950,700,250,0.7368421052631579,12,7,5,376.1344773280087,0.4823481116584565,-0.04396587410724062,0.19568173418493046,126637.2709297841,3726.528742283967,130363.79967206807,9,0,4.241379310344827,29,0,19,38.903310565291385,0.6030890804597699,48.368055555555564,1006.5277777777791,34.707854406130316,0
11,4,5,3,25,0.17857142857142858,0.10714285714285714,0.8928571428571429,28,750,500,250,0.6666666666666666,10,5,5,388.2463671733962,0.4813161375661376,-0.039926164640613604,0.20172682163816535,126585.45547628494,4229.268645131473,130814.72412141642,10,0,5.107142857142857,28,0,21,38.65202027412907,0.6056547619047619,48.419540229885065,1006.3218390804606,35.94006568144502,0
12,4,5,4,26,0.16666666666666666,0.13333333333333333,0.8666666666666667,30,750,300,450,0.4,12,3,9,359.7950669530088,0.47844827586206895,-0.017877739331026765,0.1911952003596117,127498.92509249628,3174.696858018272,130673.62195051456,11,0,5.6,30,0,18,38.429099015171666,0.6090277777777777,47.513440860215056,1009.9462365591401,33.66487455197134,0
13,4,3,4,25,0.10344827586206896,0.13793103448275862,0.8620689655172413,29,1050,700,350,0.6666666666666666,14,7,7,370.4781839277205,0.47490763546798026,-0.013939132454946712,0.19710957071735985,127547.57185570977,3650.7185570987526,131198.29041280854,12,0,6.482758620689655,29,0,20,38.10941725101975,0.6124281609195403,47.46527777777777,1010.138888888888,34.832375478927176,0
14,4,4,5,24,0.13793103448275862,0.1724137931034483,0.8275862068965517,29,550,400,150,0.7272727272727273,7,4,3,373.7674886823316,0.4753694581280788,-0.06485072008950177,0.1990325558327438,127582.64853395066,3737.2492283950637,131319.89776234573,13,0,6.586206896551724,29,0,20,37.99033085876636,0.612787356321839,47.43055555555556,1010.277777777778,34.83716475095786,0
15,4,3,2,25,0.1111111111111111,0.07407407407407407,0.9259259259259259,27,600,500,100,0.8333333333333334,7,5,2,394.0806893022427,0.47269705603038936,-0.06420335429769408,0.20886276533018858,127392.29024943303,4640.568310657583,132032.85856009062,14,0,7.518518518518518,27,0,21,37.67320165094339,0.617283950617284,47.61904761904761,1009.523809523809,37.389770723104036,0
16,4,0,0,25,0.0,0.0,1.0,25,650,500,150,0.7692307692307693,8,5,3,416.5646407065491,0.4714583333333333,-0.03173049419990415,0.2193674714616163,127132.41506923908,5591.7737610947,132724.1888303338,15,1,9.12,25,0,25,37.374033317442674,0.6220833333333332,47.876602564102576,1008.4935897435905,40.33974358974362,0
17,4,2,2,25,0.07407407407407407,0.07407407407407407,0.9259259259259259,27,1000,800,200,0.8,12,8,4,390.0671456363461,0.47198480531813863,-0.048837652958329536,0.2088657411031496,127805.74876434937,4570.564723285135,132376.3134876345,16,0,9.37037037037037,27,0,22,37.34930708854551,0.6215277777777777,47.20982142857142,1011.1607142857133,37.45039682539679,0
18,4,3,5,23,0.10714285714285714,0.17857142857142858,0.8214285714285714,28,900,600,300,0.6666666666666666,12,6,6,380.79688041527464,0.47034832451499115,-0.062307442840927485,0.20581720959868524,128180.9023649095,4162.177549874492,132343.079914784,17,0,9.714285714285714,28,0,22,37.19879161937193,0.6220238095238095,46.839080459770116,1012.6436781609195,36.16584564860427,0
19,4,3,3,23,0.11538461538461539,0.11538461538461539,0.8846153846153846,26,1100,900,200,0.8181818181818182,13,9,4,407.69838587494894,0.4707051282051282,-0.05453904873752202,0.21781602181736692,127715.20395137949,5213.856500533477,132929.06045191296,18,0,10.653846153846153,26,0,22,36.996819338422405,0.6241987179487178,47.299382716049394,1010.8024691358034,38.87701804368475,0
20,4,1,1,23,0.041666666666666664,0.041666666666666664,0.9583333333333334,24,800,400,400,0.5,12,4,8,432.6165202520364,0.46735356280193235,-0.02768834956799293,0.22925269144064614,127386.28124999999,6221.881944444444,133608.16319444444,19,0,12.5,24,0,22,36.70684057013924,0.62890625,47.625,1009.4999999999999,42.06249999999999,0
21,4,2,1,24,0.08,0.04,0.96,25,900,700,200,0.7777777777777778,11,7,4,415.6420187331649,0.46798611111111116,-0.0260370781175725,0.2228646372323708,127860.73422604379,5628.858738083506,133489.59296412728,20,0,12.92,25,0,23,36.64616674589341,0.6295833333333333,47.15544871794872,1011.3782051282056,40.455128205128226,0
22,4,1,1,24,0.04,0.04,0.96,25,400,100,300,0.25,7,1,6,417.2902056145775,0.46597222222222223,-0.03096120348376874,0.2246536784702522,128022.86543084326,5684.537567800801,133707.40299864407,21,0,13.88,25,0,23,36.43754948535233,0.6312499999999999,46.995192307692314,1012.0192307692313,40.480769230769255,0
23,4,4,2,26,0.14285714285714285,0.07142857142857142,0.9285714285714286,28,800,700,100,0.875,9,7,2,392.74093277741,0.46990740740740744,0.008259755055539664,0.20735540074909586,127236.93065464399,4394.230165807907,131631.16082045189,22,0,13.25,28,0,22,37.86700132915599,0.6123511904761905,47.77298850574713,1008.9080459770119,36.03243021346471,5
24,4,4,3,27,0.13333333333333333,0.1,0.9,30,700,500,200,0.7142857142857143,9,5,4,371.8111900289174,0.466786398467433,0.017979368663390227,0.20009767331863598,128008.47867166714,3518.996957740763,131527.4756294079,23,0,13.233333333333333,30,0,20,37.60293531677513,0.6142361111111112,47.00940860215053,1011.962365591397,33.732078853046566,0
25,4,1,0,28,0.03571428571428571,0.0,1.0,28,850,700,150,0.8235294117647058,10,7,3,393.8890257661067,0.4641203703703704,0.058275484106685926,0.21097343708842126,127817.42345422102,4469.176080063392,132286.5995342844,24,0,15.107142857142858,28,0,21,37.24069337880079,0.6183035714285715,47.198275862068954,1011.2068965517229,36.11453201970439,0
26,4,0,1,27,0.0,0.03571428571428571,0.9642857142857143,28,900,700,200,0.7777777777777778,11,7,4,393.9408735795455,0.4641754850088184,0.057081980519480435,0.21138290777439014,127890.07794953087,4476.225805918861,132366.3037554497,25,1,16.107142857142858,28,0,21,37.16471354166666,0.6190476190476191,47.126436781609186,1011.4942528735622,36.124794745484365,0
27,4,4,3,28,0.12903225806451613,0.0967741935483871,0.9032258064516129,31,650,400,250,0.6153846153846154,9,4,5,385.39297828051,0.467652329749104,0.04793149790091622,0.20423457010313031,127387.59570651595,3618.8569810655476,131006.45268758149,26,0,15.129032258064516,31,0,14,37.897292445934895,0.6051747311827957,47.62369791666667,1009.5052083333343,32.56468413978498,6
28,4,5,2,31,0.15151515151515152,0.06060606060606061,0.9393939393939394,33,1400,1200,200,0.8571428571428571,16,12,4,362.1572501451026,0.467605744949495,0.037669674957810484,0.1952623293863281,128082.49831795464,2677.201076509037,130759.69939446368,27,0,15.06060606060606,33,0,19,37.77138821630346,0.6073232323232323,46.93627450980392,1012.2549019607844,30.674390968508618,0
29,4,2,3,30,0.06060606060606061,0.09090909090909091,0.9090909090909091,33,600,200,400,0.3333333333333333,10,2,8,360.35784300887804,0.4657118055555556,0.06850419084461667,0.19611053140588425,128454.92118415996,2657.9476643598646,131112.86884851984,28,0,16.0,33,0,17,37.43602917472599,0.611111111111111,46.568627450980394,1013.7254901960786,30.718954248366018,0
30,4,1,2,29,0.03225806451612903,0.06451612903225806,0.935483870967742,31,650,300,350,0.46153846153846156,10,3,7,373.7073594055909,0.4650089605734767,0.05633639070084162,0.20064495336710683,127913.92220391173,3360.474819607209,131274.39702351895,29,0,15.64516129032258,31,0,19,37.65191251555326,0.6105510752688172,47.102864583333336,1011.5885416666671,32.63188844086023,3
31,4,4,0,33,0.12121212121212122,0.0,1.0,33,1000,600,400,0.6,14,6,8,369.0663388499307,0.46756628787878785,0.13627154108554573,0.19386588144185996,127030.2362673009,2776.516844482874,129806.75311178378,30,0,15.363636363636363,33,0,20,38.67665532052841,0.5965909090909092,47.97794117647058,1008.0882352941165,30.548128342245956,7
32,4,3,6,30,0.08333333333333333,0.16666666666666666,0.8333333333333334,36,850,500,350,0.5882352941176471,12,5,7,348.7650621897013,0.4692625661375662,0.13385398787046654,0.18709993115259663,127880.99500868049,1720.0996536788693,129601.09466235936,31,0,15.0,35,1,17,38.31638345348438,0.6008928571428571,47.135416666666664,1011.4583333333328,28.898809523809508,0
33,4,2,1,31,0.0625,0.03125,0.96875,32,1100,700,400,0.6363636363636364,15,7,8,384.63866805411016,0.4684559811827957,0.14605645161290304,0.20333899573119754,127289.03028700093,3392.0566134982737,130681.08690049921,32,0,17.5,31,1,21,38.017741935483876,0.6041666666666666,47.72135416666667,1009.1145833333339,32.55208333333335,0
34,4,2,1,32,0.06060606060606061,0.030303030303030304,0.9696969696969697,33,1050,600,450,0.5714285714285714,15,6,9,376.17060089998273,0.4661458333333333,0.15115579714256522,0.20184210876153802,127888.9769698246,3021.6146630446015,130910.5916328692,33,0,17.90909090909091,32,1,20,37.615206174842946,0.6077473958333333,47.12752525252526,1011.4898989898998,31.609059343434367,0
35,4,1,1,32,0.030303030303030304,0.030303030303030304,0.9696969696969697,33,750,400,350,0.5333333333333333,11,4,7,375.90812984851823,0.46417297979797983,0.1629702922508871,0.20316297347767084,128178.55568562813,3037.18238291901,131215.73806854713,34,0,18.848484848484848,30,3,21,37.32496018051499,0.6159722222222224,46.841397849462346,1012.6344086021484,33.75448028673828,0
36,4,1,1,32,0.030303030303030304,0.030303030303030304,0.9696969696969697,33,850,600,250,0.7058823529411765,11,6,5,367.9226913894326,0.46216066919191917,0.14669607122437345,0.2011568904291274,128639.39285278298,2865.870327419675,131505.26318020266,35,0,18.939393939393938,31,2,17,37.05571064903948,0.617943548387097,46.386718749999986,1014.4531249999983,32.724294354838655,0
37,4,1,1,32,0.030303030303030304,0.030303030303030304,0.9696969696969697,33,1150,700,450,0.6086956521739131,16,7,9,366.669592508001,0.4627919823232323,0.15420347104112975,0.2015831170490235,128858.98940611763,2849.734627306779,131708.7240334244,36,0,19.90909090909091,33,0,19,36.86318145242405,0.6152146464646466,46.17034313725489,1015.3186274509787,30.767231134878145,0
38,4,1,2,31,0.030303030303030304,0.06060606060606061,0.9393939393939394,33,1000,800,200,0.8,12,8,4,378.1142690560281,0.4618055555555556,0.19189978928741902,0.20985745039506173,129234.4856262205,3173.9892187415235,132408.474844962,37,0,20.78787878787879,31,2,20,36.18914607077303,0.6239919354838711,45.800781249999986,1016.7968749999984,32.799899193548335,0
39,4,1,0,32,0.03125,0.0,1.0,32,1300,1000,300,0.7692307692307693,16,10,6,388.9474109697346,0.460958501344086,0.18220975948196072,0.2162501880094035,129303.89577191009,3658.48309775697,132962.37886966707,38,0,21.34375,30,2,22,35.84285934540328,0.6274305555555555,45.73252688172043,1017.0698924731187,33.902329749103956,0
40,4,1,3,30,0.030303030303030304,0.09090909090909091,0.9090909090909091,33,950,700,250,0.7368421052631579,12,7,5,380.2837370825857,0.4596354166666667,0.1712342034510279,0.21338446136728725,129665.12891981332,3261.9079589843705,132927.0368787977,39,0,21.666666666666668,31,2,16,35.69472854342453,0.6283602150537635,45.377604166666664,1018.4895833333329,32.854502688172026,0
41,4,1,0,31,0.03225806451612903,0.0,1.0,31,950,500,450,0.5263157894736842,14,5,9,407.4523314242547,0.4585573476702509,0.16643748831605842,0.21804737102062968,127782.23885430227,4213.034227159284,131995.27308146155,40,0,22.967741935483872,31,0,19,36.93402554196178,0.6092069892473118,47.233072916666664,1011.067708333333,32.615087365591386,7
42,4,1,0,32,0.03125,0.0,1.0,32,950,700,250,0.7368421052631579,12,7,5,402.25475246128406,0.4596564180107527,0.1672104011313964,0.21757562341056094,128210.45769585497,3915.166049533411,132125.62374538838,41,0,23.21875,31,1,20,36.62520356561241,0.6135752688172043,46.80989583333333,1012.7604166666661,32.669690860215034,0
43,4,4,3,33,0.1111111111111111,0.08333333333333333,0.9166666666666666,36,800,400,400,0.5,12,4,8,367.39593383537647,0.46192129629629625,0.14665200020229618,0.20434654851552464,129319.08543381348,2302.2612311385515,131621.34666495203,42,0,21.52777777777778,35,1,19,36.37536033985739,0.6154761904761905,45.717592592592595,1017.12962962963,29.06084656084657,0
44,4,0,0,33,0.0,0.0,1.0,33,1000,600,400,0.6,14,6,8,390.1037830425335,0.45900410353535354,0.15051283790403436,0.21458376355869024,128880.67065860609,3455.367436996205,132336.0380956023,43,1,23.90909090909091,32,1,19,36.246165962032656,0.6178385416666667,46.14898989898989,1015.404040404039,31.73137626262622,0
45,4,3,4,32,0.08333333333333333,0.1111111111111111,0.8888888888888888,36,1150,800,350,0.6956521739130435,15,8,7,360.08256025039503,0.46258267195767194,0.10862948649945703,0.20178384490974338,129613.56122470836,2134.3165937928516,131747.8778185012,44,0,22.833333333333332,35,1,16,36.26155565658863,0.618452380952381,45.42824074074073,1018.2870370370359,29.093915343915313,0
46,4,2,3,31,0.058823529411764705,0.08823529411764706,0.9117647058823529,34,850,800,50,0.9411764705882353,9,8,1,376.91980285270665,0.45916889483065954,0.13524595968895592,0.21067939989869322,129513.0553753364,2963.207059784692,132476.26243512108,45,0,24.88235294117647,33,1,18,35.935368007063154,0.6218434343434345,45.52696078431372,1017.892156862745,30.845216874628637,0
47,4,0,0,31,0.0,0.0,1.0,31,750,500,250,0.6666666666666666,10,5,5,392.7035743079815,0.45515232974910397,0.12533051295610775,0.21777198211624446,129201.38888888895,3947.56944444445,133148.9583333334,46,1,25.903225806451612,31,0,20,35.8521174863388,0.6236559139784945,45.833333333333336,1016.6666666666672,32.7956989247312,0
48,4,2,2,31,0.06060606060606061,0.06060606060606061,0.9393939393939394,33,1250,800,450,0.64,17,8,9,371.91253638679905,0.457070707070707,0.10037833227633586,0.20920709252502326,129762.65889321403,3052.07191945404,132814.73081266807,47,0,25.272727272727273,33,0,19,35.80857589607889,0.6243686868686871,45.28186274509803,1018.8725490196069,30.874925727866877,0
49,4,1,1,31,0.03125,0.03125,0.96875,32,1300,1000,300,0.7692307692307693,16,10,6,383.35157605568327,0.45383904569892475,0.11401524541398111,0.21538165150537986,129715.36705438225,3545.3180797877817,133260.68513417002,48,0,27.03125,32,0,19,35.56540241282433,0.6263020833333334,45.32828282828283,1018.686868686869,31.833964646464658,0
50,4,1,2,30,0.03125,0.0625,0.9375,32,1200,900,300,0.75,15,9,6,384.5496883680437,0.4545950940860215,0.1119423791821561,0.21640976186402452,129779.68606519743,3581.347566574839,133361.03363177227,49,0,28.0,32,0,19,35.4693308550186,0.626953125,45.265151515151516,1018.9393939393939,31.84185606060606,0
51,4,1,2,29,0.03225806451612903,0.06451612903225806,0.935483870967742,31,650,400,250,0.6153846153846154,9,4,5,397.72445871097676,0.45358422939068105,0.12033994053926977,0.22335954346704756,129698.28499688051,4116.836039225265,133815.1210361058,50,0,29.64516129032258,31,0,19,35.21680195151049,0.6286962365591398,45.345052083333336,1018.6197916666673,32.85870295698927,0
52,4,0,1,28,0.0,0.034482758620689655,0.9655172413793104,29,750,300,450,0.4,12,3,9,417.0753542320799,0.45094417077175697,0.10612974549560161,0.23337117149016373,129554.6392746913,5006.809413580239,134561.44868827154,51,6,30.96551724137931,29,0,19,34.870964074579355,0.6329022988505747,45.48611111111111,1018.0555555555552,35.10536398467432,0
53,4,1,1,28,0.034482758620689655,0.034482758620689655,0.9655172413793104,29,1050,800,250,0.7619047619047619,13,8,5,412.04259877478563,0.4514059934318555,0.07851111299387159,0.2297278598648462,129413.28125,4864.756944444446,134278.03819444444,52,0,30.275862068965516,29,0,21,35.1436663936664,0.6314655172413792,45.625,1017.5,35.08620689655172,2
54,4,1,1,28,0.034482758620689655,0.034482758620689655,0.9655172413793104,29,850,600,250,0.7058823529411765,11,6,5,409.26000418915316,0.4527401477832513,0.06575759998871122,0.2292043613988298,129589.99083719139,4807.200038580255,134397.19087577166,53,0,30.137931034482758,29,0,20,35.03373232392126,0.6332614942528736,45.45138888888889,1018.1944444444447,35.11015325670499,0
55,4,2,1,29,0.06666666666666667,0.03333333333333333,0.9666666666666667,30,1100,900,200,0.8181818181818182,13,9,4,395.22124177605747,0.4551005747126437,0.06115284917182873,0.22360503813236018,129988.31376821034,4274.828556769586,134263.14232497994,54,0,30.033333333333335,30,0,21,34.98473265673739,0.6343749999999999,45.06048387096775,1019.7580645161302,33.991935483871,0
56,4,0,0,29,0.0,0.0,1.0,29,800,500,300,0.625,11,5,6,401.74030544439375,0.45202175697865354,0.05975758714648083,0.22682875707398872,129908.37191358043,4637.885802469158,134546.2577160496,55,1,32.06896551724138,29,0,21,34.900090826521335,0.6364942528735631,45.1388888888889,1019.4444444444459,35.1532567049809,0
57,4,0,1,28,0.0,0.034482758620689655,0.9655172413793104,29,750,300,450,0.4,12,3,9,403.23464751760235,0.4514059934318555,0.05914548851357071,0.22891512524453697,130120.84297839507,4693.846450617284,134814.68942901236,56,2,33.06896551724138,29,0,21,34.64527180324894,0.6386494252873562,44.93055555555556,1020.2777777777778,35.18199233716475,0
58,4,0,0,28,0.0,0.0,1.0,28,1200,900,300,0.75,15,9,6,414.34239238246374,0.4505070546737213,0.056016096579476704,0.23497052603158888,130079.31199630076,5179.474666402441,135258.7866627032,57,3,33.642857142857146,28,0,21,34.40434272300469,0.6413690476190477,44.9712643678161,1020.1149425287362,36.43267651888343,0
59,4,1,1,28,0.034482758620689655,0.034482758620689655,0.9655172413793104,29,1050,700,350,0.6666666666666666,14,7,7,406.1897339037389,0.45063628899835795,0.04360158465974373,0.23249225625385214,130439.87509645063,4796.667631172843,135236.54272762348,58,0,33.44827586206897,29,0,21,34.24470314978473,0.641882183908046,44.61805555555556,1021.5277777777778,35.225095785440615,0
60,4,0,2,26,0.0,0.07142857142857142,0.9285714285714286,28,750,500,250,0.6666666666666666,10,5,5,419.21855756848043,0.44923941798941797,0.05800932813316728,0.23908242938054736,130299.25724996685,5324.773335315084,135624.03058528193,59,5,35.642857142857146,28,0,21,34.05543437470682,0.6436011904761905,44.75574712643677,1020.9770114942519,36.463464696223284,0
61,4,0,1,25,0.0,0.038461538461538464,0.9615384615384616,26,700,600,100,0.8571428571428571,8,6,2,438.8360307268754,0.44769230769230767,0.0196974472108411,0.24385757013947038,129282.86540516112,6150.8420082089015,135433.70741337002,60,6,35.42307692307692,25,1,20,34.59593969954828,0.6441666666666668,45.75320512820513,1016.9871794871799,40.6794871794872,4
62,4,1,1,25,0.038461538461538464,0.038461538461538464,0.9615384615384616,26,850,600,250,0.7058823529411765,11,6,5,435.8725133200637,0.44846153846153847,-0.013596044786971406,0.24271216794348818,129364.36760355036,6077.274408284033,135441.6420118344,58,0,34.07692307692308,25,1,20,34.58766540642722,0.645,45.67307692307693,1017.3076923076928,40.692307692307715,0
63,4,0,0,25,0.0,0.0,1.0,25,550,500,50,0.9090909090909091,6,5,1,450.14780972856755,0.44729166666666664,0.002295081967213175,0.24962742175856947,129201.38888888899,6631.944444444464,135833.33333333346,59,8,36.44,24,1,20,34.392076502732245,0.6475694444444444,45.83333333333334,1016.6666666666675,42.36111111111115,0
64,4,1,1,25,0.038461538461538464,0.038461538461538464,0.9615384615384616,26,1000,700,300,0.7,13,7,6,433.0454303035202,0.44974358974358974,-0.011609888380426758,0.2426429157097504,129609.0282914202,6025.319485535847,135634.34777695604,60,0,36.0,25,1,19,34.408771377609895,0.6475,45.432692307692314,1018.2692307692314,40.730769230769255,0
65,4,0,0,25,0.0,0.0,1.0,25,450,300,150,0.6666666666666666,6,3,3,448.5000301243189,0.44729166666666664,0.004270509251678378,0.250593749676964,129498.0868055556,6615.979166666677,136114.06597222228,61,10,38.44,24,1,19,34.129209650128274,0.6506076388888888,45.54166666666667,1017.8333333333338,42.40972222222224,0
66,4,0,0,25,0.0,0.0,1.0,25,850,600,250,0.7058823529411765,11,6,5,449.48401630755455,0.4465277777777778,0.006050090031101574,0.2516863295712973,129582.920138889,6649.090277777798,136232.0104166668,62,11,39.44,24,1,19,34.01709226823812,0.6514756944444444,45.45833333333334,1018.1666666666677,42.42361111111115,0
67,4,1,1,25,0.038461538461538464,0.038461538461538464,0.9615384615384616,26,650,400,250,0.6153846153846154,9,4,5,436.4324987144498,0.44698717948717953,-0.007740686985969969,0.24607364289218966,129853.92011834319,6134.494165023016,135988.4142833662,63,0,38.88461538461539,25,1,19,34.07167190775682,0.6499999999999999,45.19230769230769,1019.2307692307692,40.76923076923077,0
68,4,2,1,26,0.07407407407407407,0.037037037037037035,0.962962962962963,27,850,500,350,0.5882352941176471,12,5,7,419.3340061614582,0.44770892687559355,-0.009460790899726845,0.23916498144519047,130301.9737844841,5528.009735558609,135829.9835200427,64,0,38.370370370370374,26,1,20,34.04971533655783,0.6506410256410255,44.75308641975309,1020.9876543209879,39.26875593542261,0
69,4,0,0,26,0.0,0.0,1.0,26,1250,900,350,0.72,16,9,7,436.53330168650655,0.4448397435897436,-0.0004044770172539902,0.24898421352235764,130303.48878718777,6176.36243630836,136479.85122349614,65,1,40.84615384615385,25,1,21,33.609159995814366,0.6545833333333333,44.75160256410257,1020.9935897435903,40.83974358974361,0
70,4,0,1,25,0.0,0.038461538461538464,0.9615384615384616,26,1100,600,500,0.5454545454545454,16,6,10,436.53330168650655,0.4448397435897436,-0.0004044770172539902,0.24898421352235764,130303.48878718777,6176.36243630836,136479.85122349614,66,2,41.84615384615385,25,1,21,33.609159995814366,0.6545833333333333,44.75160256410257,1020.9935897435903,40.83974358974361,0
71,4,0,0,25,0.0,0.0,1.0,25,950,700,250,0.7368421052631579,12,7,5,434.1029297224398,0.44069444444444444,-0.030348289927831784,0.2483816942595002,130426.23325525977,6323.681993754122,136749.9152490139,67,3,42.0,25,0,22,33.54578495973224,0.6558333333333333,44.63141025641026,1021.4743589743596,40.858974358974386,0
72,4,0,0,25,0.0,0.0,1.0,25,750,600,150,0.8,9,6,3,434.54959777460004,0.4396527777777777,-0.03033401285871129,0.2494259932501012,130549.03550809501,6346.006173980934,136895.04168207594,68,4,43.0,25,0,20,33.40896320108724,0.6570833333333334,44.51121794871795,1021.9551282051283,40.87820512820513,0
73,4,1,1,25,0.038461538461538464,0.038461538461538464,0.9615384615384616,26,850,600,250,0.7058823529411765,11,6,5,419.1881348162358,0.4402884615384615,-0.04274084124830391,0.24326114595241405,130972.46334876544,5780.420524691358,136752.8838734568,69,0,42.30769230769231,26,0,20,33.37008141112618,0.6574519230769231,44.09722222222222,1023.6111111111112,39.369658119658126,0
74,4,1,1,25,0.038461538461538464,0.038461538461538464,0.9615384615384616,26,750,500,250,0.6666666666666666,10,5,5,415.8396253870881,0.4383974358974359,-0.036305466685213617,0.24206243456743132,131090.963648834,5702.563443072702,136793.5270919067,70,0,43.26923076923077,26,0,21,33.33521699819169,0.6586538461538461,43.98148148148148,1024.074074074074,39.387464387464384,0
75,4,1,2,24,0.038461538461538464,0.07692307692307693,0.9230769230769231,26,950,600,350,0.631578947368421,13,6,7,418.95153680258665,0.4407692307692308,-0.044116624562542284,0.2443761248941628,131169.99361758892,5790.774081694884,136960.7676992838,71,0,44.23076923076923,26,0,21,33.175153158581885,0.6594551282051281,43.90432098765433,1024.3827160493838,39.399335232668605,0
76,4,1,2,23,0.04,0.08,0.92,25,550,300,250,0.5454545454545454,8,3,5,429.5271856396367,0.4380555555555556,-0.05567939887288664,0.24943815107872744,130999.80481591073,6253.59549638398,137253.40031229472,72,0,44.32,25,0,21,33.077645585472766,0.6616666666666666,44.07051282051283,1023.7179487179499,40.94871794871799,0
77,4,0,0,23,0.0,0.0,1.0,23,800,600,200,0.75,10,6,4,458.0297830024284,0.43667654808959155,-0.04077471967380242,0.2627644544592879,130528.564453125,7357.194010416666,137885.75846354166,73,9,47.130434782608695,23,0,21,32.83002038735983,0.6657608695652174,44.53125,1021.875,44.42934782608695,0
78,4,1,1,23,0.041666666666666664,0.041666666666666664,0.9583333333333334,24,750,500,250,0.6666666666666666,10,5,5,444.6129324601973,0.4395757850241546,-0.05818134940020647,0.2578251197580804,130944.03125,6843.881944444445,137787.91319444444,74,0,46.125,24,0,22,32.7484665906747,0.6653645833333334,44.125,1023.5,42.645833333333336,0
79,4,1,1,23,0.041666666666666664,0.041666666666666664,0.9583333333333334,24,750,500,250,0.6666666666666666,10,5,5,442.662477330604,0.4390474033816425,-0.052397037278202996,0.2572635381496595,131029.33680555553,6800.3541666666615,137829.6909722222,75,0,47.083333333333336,24,0,22,32.71135167399208,0.666232638888889,44.041666666666664,1023.8333333333331,42.659722222222214,0
80,4,0,0,23,0.0,0.0,1.0,23,500,300,200,0.6,7,3,4,459.5550872943119,0.4352766798418972,-0.03931639068449466,0.2654606445429495,130794.81336805549,7421.484374999993,138216.29774305547,76,12,50.130434782608695,23,0,22,32.51866938221316,0.6684782608695652,44.27083333333333,1022.9166666666661,44.47463768115939,0
81,4,0,0,23,0.0,0.0,1.0,23,600,300,300,0.5,9,3,6,459.3940983618639,0.43478260869565216,-0.03717856036352374,0.2659792549847569,130883.62328800146,7425.43282214505,138309.0561101465,77,13,51.130434782608695,23,0,22,32.43199298721864,0.6693840579710145,44.18402777777777,1023.2638888888882,44.48973429951688,0
82,4,0,0,23,0.0,0.0,1.0,23,750,400,350,0.5333333333333333,11,4,7,477.0840427591826,0.4345355731225296,-0.04889338276598143,0.25017821754444936,126960.75439453124,7514.189995659722,134474.94439019097,78,14,52.130434782608695,23,0,21,36.02659345391904,0.6290760869565217,48.046875,1007.8124999999999,43.81793478260869,8
83,4,2,2,23,0.08,0.08,0.92,25,150,100,50,0.6666666666666666,2,1,1,448.51897738387476,0.4425694444444444,-0.0779050944294557,0.238089138710682,127455.85565109311,6433.274007643015,133889.1296587361,79,0,48.88,25,0,19,36.23350129609057,0.6254166666666666,47.55608974358975,1009.7756410256417,40.391025641025664,0
84,4,3,3,23,0.11538461538461539,0.11538461538461539,0.8846153846153846,26,800,700,100,0.875,9,7,2,433.466567598456,0.44403846153846155,-0.08714584164690964,0.23248280556794443,127871.2396166743,5885.581466239907,133756.82108291422,80,0,47.88461538461539,26,0,19,36.184645509103866,0.625801282051282,47.14506172839506,1011.4197530864199,38.90075973409307,0
85,4,4,4,23,0.14814814814814814,0.14814814814814814,0.8518518518518519,27,750,500,250,0.6666666666666666,10,5,5,421.4592075288535,0.4478276353276353,-0.10147908708002729,0.228016801783893,128219.87714356558,5407.889562074808,133627.7667056404,81,0,46.96296296296296,27,0,19,36.12927319032228,0.6257716049382717,46.80059523809523,1012.7976190476177,37.511022927689545,0
86,4,2,1,24,0.08,0.04,0.96,25,1050,1000,50,0.9523809523809523,11,10,1,441.0647486720492,0.4417361111111111,-0.05233739515746194,0.23841643685702996,128185.09936411079,6307.585726906642,134492.68509101743,82,0,51.64,25,0,20,35.66871736034183,0.6329166666666668,46.8349358974359,1012.6602564102566,40.50641025641026,0
87,4,1,0,25,0.04,0.0,1.0,25,650,600,50,0.9230769230769231,7,6,1,439.2024871502447,0.44,-0.03288537549407122,0.238861197869759,128428.64287988989,6281.235874835639,134709.87875472553,83,0,52.6,25,0,18,35.46492094861661,0.6354166666666667,46.594551282051285,1013.6217948717949,40.544871794871796,0
88,4,1,0,26,0.038461538461538464,0.0,1.0,26,600,300,300,0.5,9,3,6,424.37413421066645,0.4442948717948718,-0.03947922515440805,0.23255702554744515,128731.13854595329,5726.03309327845,134457.17163923173,84,0,51.53846153846154,26,0,19,35.52976733576642,0.6346153846153846,46.29629629629629,1014.8148148148143,39.031339031339016,0
89,4,0,0,26,0.0,0.0,1.0,26,550,400,150,0.7272727272727273,7,4,3,425.56118581603425,0.44413461538461535,-0.039315329645267294,0.23343752452977948,128770.29332895127,5759.927745389406,134530.2210743407,85,1,52.53846153846154,26,0,19,35.45942932441335,0.6350160256410258,46.25771604938271,1014.9691358024683,39.03727445394109,0
90,4,3,2,27,0.10344827586206896,0.06896551724137931,0.9310344827586207,29,550,300,250,0.5454545454545454,8,3,5,406.2406477748239,0.4501231527093596,-0.028178234448603234,0.2153875469493214,127407.31336805562,4551.605902777785,131958.9192708334,86,0,48.0,29,0,17,37.35082198376668,0.6109913793103448,47.60416666666667,1009.5833333333339,34.81321839080462,5
91,4,1,0,28,0.03571428571428571,0.0,1.0,28,600,300,300,0.5,9,3,6,416.0555112665848,0.44637345679012347,-0.0035368729164975132,0.22084880159981554,127454.46062888096,5005.626156031172,132460.08678491213,87,0,50.67857142857143,28,0,18,37.054460728514485,0.6145833333333334,47.55747126436781,1009.7701149425287,36.0632183908046,0
92,4,3,1,30,0.0967741935483871,0.03225806451612903,0.967741935483871,31,800,500,300,0.625,11,5,6,382.79210043756495,0.45313620071684585,-0.01432770478958223,0.20756134728255682,128309.37915378137,3623.163350423166,131932.54250420452,88,0,46.67741935483871,31,0,20,37.01658420083109,0.6145833333333334,46.71223958333333,1013.1510416666658,32.68229166666664,0
93,4,4,5,29,0.11764705882352941,0.14705882352941177,0.8529411764705882,34,600,400,200,0.6666666666666666,8,4,4,359.3619650114278,0.45829619726678555,-0.04030756499551735,0.19776500397080518,128898.98667800464,2464.278628117927,131363.26530612257,89,0,43.44117647058823,34,0,15,37.00786440015631,0.6133578431372548,46.13095238095239,1015.4761904761913,29.866946778711508,0
94,4,3,3,29,0.09375,0.09375,0.90625,32,900,800,100,0.8888888888888888,10,8,2,377.30663086193647,0.454133064516129,-0.0005129321064414327,0.20754445454115547,128880.67065860624,3325.506325885108,132206.17698449135,90,0,47.03125,32,0,16,36.571022962778734,0.6178385416666667,46.148989898989896,1015.4040404040402,31.731376262626256,0
95,4,0,1,28,0.0,0.034482758620689655,0.9655172413793104,29,1400,1300,100,0.9285714285714286,15,13,2,411.6719834865827,0.4477627257799672,0.013887576759564979,0.22426906563075028,128496.33487654316,4779.66820987653,133276.0030864197,91,1,52.6551724137931,29,0,18,36.09303652968036,0.6221264367816093,46.52777777777777,1013.8888888888885,34.96168582375478,0
96,4,2,2,28,0.06666666666666667,0.06666666666666667,0.9333333333333333,30,700,500,200,0.7142857142857143,9,5,4,398.0694627846146,0.4458572796934866,0.008341052445855812,0.2194172815655237,128962.36423647236,4267.19581020926,133229.5600466816,92,0,51.53333333333333,30,0,19,35.960312734330195,0.6239583333333334,46.06854838709677,1015.7258064516124,33.85752688172041,0
97,4,2,1,29,0.06666666666666667,0.03333333333333333,0.9666666666666667,30,550,300,250,0.5454545454545454,8,3,5,396.4994028733013,0.4454501915708812,0.00519262981574542,0.21949696079999279,129133.07354896507,4240.237310671738,133373.3108596368,93,0,52.266666666666666,30,0,20,35.82550912457021,0.6256944444444446,45.90053763440859,1016.3978494623644,33.87992831541215,0
98,4,1,0,30,0.03333333333333333,0.0,1.0,30,1150,900,250,0.782608695652174,14,9,5,394.9381590659232,0.4438697318007663,0.007125307125307012,0.22019154895867224,129413.28125000001,4222.066676783444,133635.34792678346,94,0,53.233333333333334,29,1,21,35.57876057876058,0.6314655172413792,45.625,1017.5000000000001,35.08620689655173,0
99,4,0,0,30,0.0,0.0,1.0,30,600,500,100,0.8333333333333334,7,5,2,394.9381590659232,0.4438697318007663,0.007125307125307012,0.22019154895867224,129413.28125000001,4222.048611111112,133635.32986111112,95,1,54.233333333333334,29,1,21,35.57876057876058,0.6314655172413792,45.625,1017.5000000000001,35.08620689655173,0
100,4,0,0,30,0.0,0.0,1.0,30,450,300,150,0.6666666666666666,6,3,3,393.3833859813822,0.443654214559387,0.008636921817437582,0.21991661600744117,129519.29253472236,4190.147569444465,133709.44010416683,96,2,55.233333333333334,29,1,17,35.510045708827946,0.6325431034482758,45.52083333333334,1017.9166666666679,35.10057471264372,0
101,4,0,1,29,0.0,0.03333333333333333,0.9666666666666667,30,600,400,200,0.6666666666666666,8,4,4,384.1304298362873,0.4433429118773946,-0.010357865119141607,0.216380157430812,129817.039903457,3973.3350676378723,133790.37497109486,97,3,56.233333333333334,30,0,19,35.441945836630616,0.632638888888889,45.22849462365591,1019.0860215053759,33.9695340501792,1
102,4,0,0,29,0.0,0.0,1.0,29,700,600,100,0.8571428571428571,8,6,2,394.40588662304054,0.4406814449917898,-0.0025396467069245254,0.22108440066667673,129625.34722222215,4424.999999999995,134050.34722222213,98,4,58.86206896551724,29,0,19,35.37575013638845,0.6336206896551724,45.416666666666664,1018.3333333333327,35.11494252873561,0
103,4,1,1,29,0.03333333333333333,0.03333333333333333,0.9666666666666667,30,650,300,350,0.46153846153846156,10,3,7,385.47666112339635,0.4415948275862069,-0.010762469786860462,0.21770964070148624,129919.79067305458,4016.209424499922,133936.0000975545,99,0,57.86666666666667,30,0,19,35.30295539441879,0.6336805555555556,45.127688172043,1019.4892473118271,33.98297491039423,0
104,4,0,0,29,0.0,0.0,1.0,29,800,400,400,0.5,12,4,8,397.80601967334985,0.44021962233169126,-0.007048805932275082,0.22420127283894337,129837.58680555559,4530.034722222228,134367.6215277778,100,6,60.86206896551724,29,0,19,35.072567457072765,0.6357758620689655,45.208333333333336,1019.166666666667,35.14367816091955,0
105,4,1,2,28,0.03333333333333333,0.06666666666666667,0.9333333333333333,30,650,200,450,0.3076923076923077,11,2,9,390.3324002527203,0.4403256704980843,-0.014971900245873027,0.2218116454130726,130159.70054341531,4161.109665857306,134320.8102092726,101,0,59.8,30,0,19,34.93479978925183,0.6361111111111111,44.89247311827956,1020.4301075268808,34.014336917562694,0
106,4,1,1,28,0.034482758620689655,0.034482758620689655,0.9655172413793104,29,800,500,300,0.625,11,5,6,403.84881839847884,0.44042487684729065,-0.004788619985446552,0.22905556533875127,130085.41907793222,4706.96855709878,134792.38763503102,102,0,62.58620689655172,29,0,20,34.66573065577491,0.6382902298850575,44.965277777777786,1020.1388888888898,35.17720306513413,0
107,4,0,0,28,0.0,0.0,1.0,28,1000,800,200,0.8,12,8,4,413.62936023517756,0.43945656966490304,0.0021878206288852287,0.23478673757234184,130115.9566364447,5163.9559799841445,135279.91261642883,103,1,64.0,28,0,20,34.385121813829045,0.6417410714285714,44.935344827586206,1020.2586206896551,36.437807881773395,0
108,4,3,2,29,0.0967741935483871,0.06451612903225806,0.935483870967742,31,700,500,200,0.7142857142857143,9,5,4,382.7182041487562,0.4427867383512545,-0.0015753652262742168,0.22241782994986498,131028.00369262708,3829.3604532877757,134857.36414591485,104,0,58.70967741935484,31,0,17,34.24702721607529,0.6421370967741935,44.04296875000001,1023.828125000001,33.02671370967745,0
109,4,0,0,29,0.0,0.0,1.0,29,700,300,400,0.42857142857142855,11,3,8,402.6531955618676,0.4391420361247948,0.019674987937359,0.23173809011187702,130652.78018904317,4721.551890432099,135374.33207947528,105,1,63.758620689655174,29,0,17,34.118298012045464,0.644037356321839,44.40972222222222,1022.3611111111109,35.25383141762451,0
110,4,0,1,28,0.0,0.034482758620689655,0.9655172413793104,29,950,700,250,0.7368421052631579,12,7,5,402.89223584589183,0.43852627257799676,0.01798123208900715,0.2325155505304974,130759.2978395062,4736.38117283951,135495.6790123457,106,2,64.75862068965517,29,0,17,34.00382491399603,0.6451149425287357,44.30555555555556,1022.7777777777779,35.26819923371648,0
111,4,2,3,27,0.06666666666666667,0.1,0.9,30,900,600,300,0.6666666666666666,12,6,6,390.26735831249414,0.43927203065134096,-0.008136482939632872,0.22735758947562765,131121.5530697192,4234.492426870177,135356.0454965894,107,0,63.4,30,0,17,33.9588801399825,0.6458333333333333,43.951612903225815,1024.193548387098,34.139784946236595,0
112,4,2,1,28,0.06896551724137931,0.034482758620689655,0.9655172413793104,29,800,700,100,0.875,9,7,2,402.5166864268184,0.4403735632183908,0.017388621671270865,0.23510416435238624,131221.3758680555,4763.758680555552,135985.13454861107,108,0,63.89655172413793,29,0,18,33.54386945912972,0.6497844827586208,43.854166666666664,1024.583333333333,35.330459770114935,0
113,4,0,0,28,0.0,0.0,1.0,28,850,500,350,0.5882352941176471,12,5,7,413.72457576427746,0.4369212962962963,0.002202710092969795,0.22463429044383726,128362.8353522591,5021.371920002632,133384.20727226173,109,1,67.17857142857143,28,0,20,36.178162956661474,0.6238839285714286,46.65948275862068,1013.3620689655164,36.19150246305416,7
114,4,2,1,29,0.06666666666666667,0.03333333333333333,0.9666666666666667,30,500,300,200,0.6,7,3,4,389.9323776532213,0.44058908045977013,-0.011078755790867145,0.21456220780554153,128894.11212640184,4051.997521389751,132946.1096477916,110,0,63.63333333333333,30,0,18,36.2367637326274,0.623263888888889,46.13575268817204,1015.4569892473114,33.84856630824371,0
115,4,1,1,29,0.03333333333333333,0.03333333333333333,0.9666666666666667,30,650,400,250,0.6153846153846154,9,4,5,419.37455556589475,0.44090038314176244,0.04208645944980338,0.21381227341146425,125807.75234131106,4552.114044976286,130359.86638628735,111,0,64.6,30,0,18,38.67536396927473,0.5916666666666668,49.19354838709677,1003.2258064516122,33.44086021505374,7
116,4,2,3,28,0.06451612903225806,0.0967741935483871,0.9032258064516129,31,800,600,200,0.75,10,6,4,410.1575192211298,0.4446236559139785,0.026320785653877632,0.21118027642542447,126212.6040582725,4153.631019482005,130366.2350777545,112,0,63.41935483870968,30,1,19,38.486768771178895,0.5958333333333334,48.79032258064515,1004.8387096774183,33.49462365591394,0
117,4,3,2,29,0.0967741935483871,0.06451612903225806,0.935483870967742,31,1000,700,300,0.7,13,7,6,408.0430116838912,0.4460125448028674,0.03059385536039194,0.21113262886714176,126415.27380332972,4116.57380911086,130531.84761244059,113,0,63.67741935483871,30,1,17,38.33004766996347,0.5979166666666667,48.588709677419345,1005.6451612903213,33.521505376344045,0
118,4,1,0,30,0.03333333333333333,0.0,1.0,30,850,500,350,0.5882352941176471,12,5,7,412.2700607315379,0.443654214559387,0.05918667770724051,0.21429762267293564,126602.32445987644,4438.869598765419,131041.19405864186,114,0,66.76666666666667,29,1,20,38.0301775692336,0.6027298850574713,48.40277777777777,1006.3888888888881,34.70306513409959,0
119,4,2,3,29,0.0625,0.09375,0.90625,32,1300,800,500,0.6153846153846154,18,8,10,392.73273683491584,0.44781165994623656,0.03279958677686001,0.20661157024793395,127092.01388888882,3582.638888888884,130674.65277777771,115,0,63.53125,31,1,20,38.01652892561984,0.6021505376344086,47.916666666666664,1008.3333333333327,32.52688172043009,0
120,4,4,4,29,0.12121212121212122,0.12121212121212122,0.8787878787878788,33,600,400,200,0.6666666666666666,8,4,4,378.0114241602636,0.45430871212121215,-0.002250844066524982,0.2005943834777457,127442.37075617282,3034.934413580245,130477.30516975306,116,0,59.0,32,1,17,38.02728106373223,0.6031901041666667,47.56944444444444,1009.7222222222222,31.553819444444443,0
121,4,5,4,30,0.14705882352941177,0.11764705882352941,0.8823529411764706,34,1000,900,100,0.9,11,9,2,367.04027714257444,0.452243018419489,0.014493940969872332,0.19743658425838637,127989.47707912793,2595.458627691235,130584.93570681916,117,0,58.11764705882353,33,1,19,37.74310181260345,0.6063762626262628,47.028186274509785,1011.8872549019584,30.663250148544194,0
122,4,2,2,30,0.0625,0.0625,0.9375,32,750,700,50,0.9333333333333333,8,7,1,373.36804702246707,0.45251596102150543,0.03128217917363907,0.20046277521199332,127913.92220391158,3151.7942640516394,131065.71646796323,118,0,61.03125,31,1,19,37.66049362852362,0.6105510752688172,47.10286458333333,1011.5885416666658,32.63188844086019,0
123,4,0,0,30,0.0,0.0,1.0,30,750,300,450,0.4,12,3,9,394.9257743306335,0.4445402298850574,0.04683892248488197,0.2106656843130269,127652.81635802452,4082.6774691357805,131735.4938271603,119,2,66.1,29,1,19,37.383750229063594,0.6135057471264369,47.3611111111111,1010.5555555555541,34.8467432950191,0
124,4,6,5,31,0.16666666666666666,0.1388888888888889,0.8611111111111112,36,650,500,150,0.7692307692307693,8,5,3,341.96518302249774,0.4510582010582011,0.032054201776360536,0.18935297839240692,129142.5607103051,1632.4518818586942,130775.0125921638,120,0,55.916666666666664,35,1,20,37.20156760039474,0.6136904761904762,45.891203703703695,1016.4351851851843,29.041005291005266,0
125,4,1,2,30,0.03125,0.0625,0.9375,32,450,300,150,0.6666666666666666,6,3,3,374.7117034688347,0.44669858870967744,0.06923767967145844,0.20503887594305895,128672.41753472215,3243.0121527777737,131915.4296874999,121,0,62.75,31,1,20,36.84976043805614,0.6182795698924731,46.354166666666664,1014.5833333333327,32.72849462365589,0
126,4,0,0,30,0.0,0.0,1.0,30,850,500,350,0.5882352941176471,12,5,7,394.8668542166392,0.4429358237547893,0.07777777777777772,0.21492417367093586,128461.13281250001,4145.008680555557,132606.14149305556,122,2,65.3,29,1,20,36.55509316344704,0.6217672413793103,46.5625,1013.7500000000001,34.95689655172414,0
127,4,3,3,30,0.09090909090909091,0.09090909090909091,0.9090909090909091,33,600,400,200,0.6666666666666666,8,4,4,363.56591180895794,0.4508364898989899,0.04738565782044013,0.2012864917511767,129137.21335833064,2789.977744617877,131927.1911029485,123,0,60.27272727272727,32,1,22,36.65812629399586,0.6204427083333335,45.896464646464636,1016.4141414141403,31.762941919191885,0
128,4,1,1,30,0.03225806451612903,0.03225806451612903,0.967741935483871,31,850,700,150,0.8235294117647058,10,7,3,375.45344567312037,0.44377240143369173,0.05483401790550757,0.20802596407515095,129167.22896071801,3499.256236270089,132666.4851969881,124,0,62.25806451612903,30,1,22,36.32542201066597,0.6260416666666666,45.86693548387097,1016.5322580645162,33.88440860215054,0
129,4,1,1,30,0.03225806451612903,0.03225806451612903,0.967741935483871,31,950,600,350,0.631578947368421,13,6,7,377.6070184240754,0.4460125448028674,0.04930778149082715,0.21012719966422114,129338.07376575352,3567.7928806798836,132905.8666464334,125,0,63.225806451612904,30,1,23,36.096337649753345,0.6277777777777775,45.698924731182814,1017.2043010752709,33.90681003584236,0
130,4,1,0,31,0.03225806451612903,0.0,1.0,31,950,700,250,0.7368421052631579,12,7,5,374.7837261753112,0.44327956989247314,0.06095509087888673,0.20946399692440093,129509.03148124067,3507.5754783790194,133016.6069596197,126,0,64.19354838709677,30,1,18,35.993826752938084,0.6295138888888887,45.53091397849463,1017.8763440860221,33.92921146953407,0
131,4,1,1,31,0.03125,0.03125,0.96875,32,950,700,250,0.7368421052631579,12,7,5,367.00027280025984,0.4459845430107527,0.043836250958344314,0.20662907445574363,129797.7786593969,3127.164035373298,132924.9426947702,127,0,63.15625,31,1,19,35.89796831075903,0.6297043010752686,45.24739583333335,1019.0104166666683,32.87130376344091,0
132,4,2,1,32,0.06060606060606061,0.030303030303030304,0.9696969696969697,33,1250,1000,250,0.8,15,10,5,359.7785267106338,0.445864898989899,0.0528954230734644,0.20550061610420964,130359.27456382013,2780.0935491276514,133139.3681129478,128,0,62.18181818181818,32,1,23,35.511714886251234,0.6328125,44.6969696969697,1021.212121212122,31.912878787878814,0
133,4,0,0,32,0.0,0.0,1.0,32,1100,800,300,0.7272727272727273,14,8,6,369.5275965378793,0.4438214045698925,0.05576855630659305,0.2107247915966192,130295.81917656801,3229.580179850265,133525.39935641826,129,1,64.96875,31,1,23,35.3272594907112,0.634744623655914,44.759114583333336,1020.9635416666673,32.93430779569895,0
134,4,1,2,31,0.030303030303030304,0.06060606060606061,0.9393939393939394,33,1400,1100,300,0.7857142857142857,17,11,6,360.1901600092477,0.44389204545454547,0.05098545679151001,0.20693678816713,130585.01882779824,2807.08776527906,133392.1065930773,130,0,63.96969696969697,32,1,15,35.272287420218234,0.6350911458333333,44.476010101010104,1022.09595959596,31.94049873737375,0
135,4,0,0,31,0.0,0.0,1.0,31,700,400,300,0.5714285714285714,10,4,6,380.5874019160084,0.4422491039426523,0.05999881123215767,0.21742128419231824,130365.51371545848,3723.0944328824216,134088.6081483409,131,3,68.6774193548387,30,1,24,34.97411599543741,0.6381944444444445,44.69086021505377,1021.2365591397853,34.04121863799284,0
136,4,1,1,31,0.03125,0.03125,0.96875,32,1450,1200,250,0.8275862068965517,17,12,5,373.5598922764697,0.4448084677419355,0.04901165011459141,0.21541405241845768,130728.22570800783,3366.9643825954854,134095.1900906033,132,0,67.5,31,1,19,34.78535353535353,0.6391129032258065,44.3359375,1022.6562500000001,32.988911290322584,0
137,4,0,0,31,0.0,0.0,1.0,31,1150,900,250,0.782608695652174,14,9,5,384.4273530208898,0.44193548387096776,0.055345591822018925,0.22098034918547743,130605.83457986466,3841.6910553243115,134447.52563518897,133,5,70.6774193548387,30,1,19,34.63182117028272,0.640625,44.45564516129032,1022.1774193548382,34.072580645161274,0
138,4,1,0,32,0.03125,0.0,1.0,32,800,400,400,0.5,12,4,8,375.53247761266556,0.44310735887096775,0.052017077979900295,0.2178642661633333,130961.35669284409,3436.0485500759637,134397.40524292004,134,0,69.4375,31,1,20,34.498499978798286,0.6414650537634408,44.10807291666667,1023.5677083333343,33.018313172043044,0
139,4,0,1,31,0.0,0.03125,0.96875,32,800,400,400,0.5,12,4,8,375.7619939673705,0.44310735887096775,0.055127654839119966,0.21837520758059376,131028.00369262694,3447.068786621092,134475.07247924802,135,1,70.4375,31,1,20,34.425076306753155,0.6421370967741935,44.04296875,1023.8281249999999,33.026713709677416,0
140,4,1,0,32,0.03125,0.0,1.0,32,950,600,350,0.631578947368421,13,6,7,373.66677272091715,0.44472446236559143,0.054254575495678914,0.21810164449318797,131194.69536675338,3404.6196831597113,134599.3150499131,136,0,70.09375,31,1,22,34.30986273512965,0.6438172043010754,43.88020833333333,1024.4791666666658,33.04771505376341,0
141,4,0,0,32,0.0,0.0,1.0,32,950,700,250,0.7368421052631579,12,7,5,376.2511109090571,0.44428343413978494,0.05307060729259305,0.2201838285475976,131294.76123385964,3479.9599541558196,134774.72118801545,137,1,71.09375,31,1,22,34.1423421420404,0.6448252688172043,43.782552083333336,1024.869791666667,33.06031586021506,0
142,4,1,1,32,0.030303030303030304,0.030303030303030304,0.9696969696969697,33,600,400,200,0.6666666666666666,8,4,4,366.0101605597192,0.4446022727272727,0.05694554990329648,0.21606936894165893,131628.58963012692,3035.484483506942,134664.07411363386,138,0,69.9090909090909,31,2,17,34.067297931734565,0.6481854838709677,43.45703125,1026.1718749999998,33.10231854838709,0
143,4,0,0,32,0.0,0.0,1.0,32,1100,1000,100,0.9090909090909091,12,10,2,366.0101605597192,0.4427293346774193,0.03487422281436414,0.21606936894165893,131628.58963012692,3235.4802449544245,134864.06987508136,139,1,68.90625,31,1,17,34.067297931734565,0.6481854838709677,43.45703125,1026.1718749999998,33.10231854838709,0
144,4,0,0,32,0.0,0.0,1.0,32,1100,900,200,0.8181818181818182,13,9,4,365.8180259632141,0.44214129704301075,0.03285947608778339,0.21633484611162937,131695.4061720107,3235.3107028537374,134930.71687486445,140,2,69.90625,31,1,18,34.00474121527337,0.6488575268817204,43.391927083333336,1026.4322916666672,33.110719086021525,0
145,4,1,1,32,0.030303030303030304,0.030303030303030304,0.9696969696969697,33,1200,900,300,0.75,15,9,6,359.4422907996975,0.44077493686868685,0.03308220324794875,0.21542733322763308,132203.15728305775,2903.8811409549903,135107.03842401275,141,0,68.75757575757575,32,1,19,33.65638428483733,0.6513671875,42.897727272727266,1028.40909090909,32.137784090909065,0
146,4,0,0,32,0.0,0.0,1.0,32,1300,900,400,0.6923076923076923,17,9,8,368.70739731939256,0.4380250336021505,0.03675189993666872,0.2203591901466015,132096.66146172426,3341.0032484266535,135437.66471015092,142,1,71.75,31,1,20,33.52556998100062,0.6528897849462365,43.001302083333336,1027.9947916666672,33.161122311827974,0
147,4,0,1,31,0.0,0.03125,0.96875,32,700,400,300,0.5714285714285714,10,4,6,368.5463191573658,0.43806703629032256,0.04031198556413873,0.22065278865699126,132163.59668307827,3341.6814168294227,135505.2780999077,143,2,72.75,31,1,20,33.46220611202568,0.6535618279569892,42.936197916666664,1028.2552083333328,33.169522849462346,0
148,4,0,0,31,0.0,0.0,1.0,31,1100,900,200,0.8181818181818182,13,9,4,376.35704250625867,0.43548387096774194,0.048918545012822445,0.2248733328974896,132086.9464677998,3742.370505260734,135829.31697306054,144,3,75.80645161290323,30,1,21,33.33878138075314,0.6555555555555554,43.01075268817205,1027.9569892473123,34.26523297491041,0
149,4,0,1,30,0.0,0.03225806451612903,0.967741935483871,31,1200,800,400,0.6666666666666666,16,8,8,377.18348549950286,0.4353494623655914,0.048794065427064215,0.22557282881827195,132121.49029150768,3766.8088435079203,135888.2991350156,145,4,76.80645161290323,30,1,21,33.28267311631151,0.6559027777777777,42.97715053763441,1028.0913978494623,34.26971326164874,0
150,4,0,0,30,0.0,0.0,1.0,30,350,100,250,0.2857142857142857,6,1,5,388.09366207626584,0.433860153256705,0.05267712276906389,0.23073478494502125,131898.18672839514,4237.770061728408,136135.95679012354,146,5,79.3,29,1,21,33.227983594735896,0.6566091954022988,43.19444444444445,1027.2222222222229,35.42145593869734,0
151,4,1,1,30,0.03225806451612903,0.03225806451612903,0.967741935483871,31,800,400,400,0.5,12,4,8,378.3269682600708,0.43637992831541217,0.04265654648956363,0.2264633260711693,132156.03863163374,3799.6386865533627,135955.6773181871,147,0,77.70967741935483,30,1,21,33.21840958605664,0.65625,42.943548387096776,1028.2258064516132,34.2741935483871,0
152,4,0,0,30,0.0,0.0,1.0,30,800,600,200,0.75,10,6,4,390.37989761707314,0.43170498084291187,0.05271548230208012,0.23340807771902883,132112.27816358034,4314.795524691364,136427.07368827172,148,7,81.3,29,1,22,32.95280554805008,0.6587643678160919,42.986111111111114,1028.055555555556,35.450191570881245,0
153,4,0,0,30,0.0,0.0,1.0,30,500,100,400,0.2,9,1,8,390.9078398673767,0.4308908045977011,0.04842019983796897,0.23460806013434268,132255.1022376542,4339.911265432082,136595.0135030863,149,8,82.3,29,1,22,32.794918534521564,0.6602011494252873,42.847222222222214,1028.6111111111102,35.4693486590038,0
154,4,0,1,29,0.0,0.03333333333333333,0.9666666666666667,30,1100,700,400,0.6363636363636364,15,7,8,391.2662826621716,0.4306752873563218,0.052490214603860164,0.23549081139269112,132362.27092978384,4357.778742283939,136720.04967206778,150,9,83.3,29,1,23,32.67745872137491,0.6612787356321839,42.74305555555555,1029.027777777777,35.483716475095754,0
155,4,0,0,29,0.0,0.0,1.0,29,750,500,250,0.6666666666666666,10,5,5,403.7629810657806,0.42775041050903123,0.061123928886234635,0.2422916329798762,132250.17598510368,4879.545060443909,137129.72104554757,151,10,86.03448275862068,28,1,23,32.46932765283793,0.6633184523809523,42.85201149425287,1028.5919540229881,36.73542692939243,0
156,4,0,0,29,0.0,0.0,1.0,29,700,500,200,0.7142857142857143,9,5,4,403.92437422046726,0.4270833333333333,0.06085645907670356,0.2428633454066134,132324.07940695604,4889.784193750827,137213.86360070686,152,11,87.03448275862068,28,1,24,32.3904366243076,0.6640625,42.7801724137931,1028.8793103448277,36.74568965517242,0
157,4,1,1,29,0.03333333333333333,0.03333333333333333,0.9666666666666667,30,800,400,400,0.5,12,4,8,392.6587183403366,0.4282327586206896,0.05010114632501694,0.2376787262443751,132576.73852237652,4411.482445987654,136988.22096836416,153,0,85.1,29,1,24,32.42512362328613,0.663433908045977,42.53472222222222,1029.8611111111109,35.512452107279685,0
158,4,0,0,29,0.0,0.0,1.0,29,600,300,300,0.5,9,3,6,403.95854801361816,0.4269807060755337,0.07023588401166414,0.24407815809996503,132508.92827652255,4905.622853084937,137414.55112960748,154,13,89.03448275862068,28,1,24,32.20270490278165,0.6659226190476191,42.60057471264367,1029.5977011494244,36.7713464696223,0
159,4,0,0,29,0.0,0.0,1.0,29,850,700,150,0.8235294117647058,10,7,3,406.97143145839436,0.4257491789819376,0.07151409652864249,0.24711195046470327,132693.90616742635,5000.525787752673,137694.43195517902,155,14,90.03448275862068,28,1,21,31.93824664156557,0.6677827380952381,42.42097701149425,1030.316091954023,36.797003284072254,0
160,4,0,0,29,0.0,0.0,1.0,29,650,300,350,0.46153846153846156,10,3,7,406.6087859164321,0.4252360426929393,0.06971535141266849,0.2476240602856096,132804.95483221015,4999.932289602302,137804.88712181244,156,15,91.03448275862068,28,1,21,31.83544744912183,0.6688988095238095,42.313218390804586,1030.7471264367803,36.812397372742154,0
161,4,0,0,29,0.0,0.0,1.0,29,800,600,200,0.75,10,6,4,406.0290643324551,0.4251847290640394,0.06846569746485631,0.2475155935926393,132841.98137551194,4987.541080393705,137829.52245590565,157,16,92.03448275862068,28,1,22,31.813008130081297,0.6692708333333334,42.27729885057471,1030.890804597701,36.81752873563217,0
162,4,0,0,29,0.0,0.0,1.0,29,950,600,350,0.631578947368421,13,6,7,406.18058289465506,0.42462027914614126,0.07307769909973993,0.24834448245467056,132953.0919705376,5000.59287884792,137953.68484938552,158,17,93.03448275862068,28,1,23,31.696967586142847,0.6703869047619049,42.16954022988505,1031.3218390804589,36.8329228243021,0
163,4,0,0,29,0.0,0.0,1.0,29,900,700,200,0.7777777777777778,11,7,4,402.8142050957388,0.423747947454844,0.06949336353253921,0.24825239089348006,133249.61396815948,4934.967465979632,138184.5814341391,159,18,94.03448275862068,28,1,23,31.484831617033116,0.6733630952380953,41.88218390804597,1032.4712643678151,36.87397372742197,0
164,4,1,0,30,0.03333333333333333,0.0,1.0,30,850,500,350,0.5882352941176471,12,5,7,393.6552218464522,0.42332375478927203,0.05727529222087813,0.2447765928323427,133579.8828124999,4516.883680555543,138096.76649305545,160,0,91.86666666666666,29,1,24,31.388972860405747,0.673491379310345,41.56249999999999,1033.7499999999993,35.64655172413791,0
165,4,0,0,30,0.0,0.0,1.0,30,650,500,150,0.7692307692307693,8,5,3,393.6552218464522,0.42332375478927203,0.05727529222087813,0.2447765928323427,133579.8828124999,4516.883680555543,138096.76649305545,161,1,92.86666666666666,29,1,24,31.388972860405747,0.673491379310345,41.56249999999999,1033.7499999999993,35.64655172413791,0
166,4,1,1,30,0.03225806451612903,0.03225806451612903,0.967741935483871,31,600,500,100,0.8333333333333334,7,5,2,384.335975712599,0.4260304659498208,0.03989107666527025,0.2409924277676719,133889.21407099083,4091.688345473455,137980.9024164643,162,0,90.83870967741936,30,1,20,31.319264069264058,0.6736111111111112,41.26344086021505,1034.9462365591394,34.498207885304645,0
167,4,1,0,31,0.03225806451612903,0.0,1.0,31,1050,900,150,0.8571428571428571,12,9,3,386.60416056792417,0.4255824372759857,0.01964813204082594,0.2372470136434815,133090.55102107173,4092.3025783327485,137182.85359940448,163,0,91.80645161290323,30,1,21,32.06330597889801,0.6656249999999999,42.03629032258064,1031.8548387096769,34.39516129032256,4
168,4,0,0,31,0.0,0.0,1.0,31,800,500,300,0.625,11,5,6,388.0845880501054,0.42576164874551975,0.019090993118167532,0.23837707736389688,133125.22582090425,4132.769684356585,137257.99550526083,164,1,92.80645161290323,30,1,21,31.99021012416427,0.6659722222222222,42.002688172043015,1031.9892473118286,34.399641577060954,0
169,4,1,1,31,0.03125,0.03125,0.96875,32,650,300,350,0.46153846153846156,10,3,7,377.83336880885406,0.42777637768817206,0.011740418557740995,0.2334092119464042,133337.70751953125,3675.887044270834,137013.5945638021,165,0,90.875,31,1,21,32.04109934442764,0.6653225806451613,41.796875,1032.8125,33.31653225806452,0
170,4,0,0,31,0.0,0.0,1.0,31,1200,1100,100,0.9166666666666666,13,11,2,387.5977090320675,0.4253584229390681,0.022440757995203064,0.23829966434405514,133159.90513715468,4122.494833217727,137282.3999703724,166,3,94.80645161290323,30,1,22,31.967866909753877,0.6663194444444444,41.96908602150538,1032.1236559139793,34.40412186379931,0
171,4,0,0,31,0.0,0.0,1.0,31,750,600,150,0.8,9,6,3,387.8234118444063,0.42473118279569894,0.028021648129721077,0.23932909824904205,133298.66756633716,4139.268809978035,137437.9363763152,167,4,95.80645161290323,30,1,22,31.822421797041088,0.6677083333333333,41.83467741935484,1032.6612903225807,34.42204301075269,0
172,4,0,0,31,0.0,0.0,1.0,31,750,700,50,0.9333333333333333,8,7,1,387.14644785721407,0.4241935483870967,0.030251903334927777,0.23958193222468188,133402.786810614,4129.283009596486,137532.06982021048,168,5,96.80645161290323,30,1,22,31.73518952207477,0.66875,41.733870967741936,1033.0645161290327,34.43548387096776,0
173,4,0,1,30,0.0,0.03225806451612903,0.967741935483871,31,750,500,250,0.6666666666666666,10,5,5,386.8993398862674,0.42383512544802865,0.03411708917862999,0.23965312052423357,133437.50225820908,4125.376307954683,137562.87856616377,169,6,97.80645161290323,30,1,22,31.7066692684619,0.6690972222222221,41.700268817204304,1033.198924731183,34.4399641577061,0
174,4,0,1,29,0.0,0.03333333333333333,0.9666666666666667,30,700,300,400,0.42857142857142855,11,3,8,396.94036552417924,0.422389846743295,0.042904247472775214,0.24495524725480075,133298.6675663372,4582.324365533591,137880.99193187078,170,7,101.03333333333333,30,0,22,31.587053668271935,0.6677083333333333,41.83467741935484,1032.661290322581,34.422043010752695,0
175,4,0,0,29,0.0,0.0,1.0,29,450,200,250,0.4444444444444444,7,2,5,420.80002967630753,0.4214388341543514,0.06230471308024743,0.24464809296322848,131043.55709876536,5228.626543209865,136272.18364197522,171,8,103.24137931034483,29,0,20,33.25646590703562,0.6479885057471264,44.02777777777777,1023.8888888888883,35.30651340996167,8
176,4,0,0,29,0.0,0.0,1.0,29,850,600,250,0.7058823529411765,11,6,5,419.9369588087186,0.4211309523809524,0.06397126904407835,0.24459835183692677,131114.67013888896,5211.979166666675,136326.64930555565,172,9,104.24137931034483,29,0,20,33.20619745050175,0.6487068965517242,43.958333333333336,1024.1666666666672,35.31609195402301,0
177,4,0,1,28,0.0,0.034482758620689655,0.9655172413793104,29,300,100,200,0.3333333333333333,5,1,4,417.337546681988,0.42092569786535305,0.06031560490940979,0.2433094392711194,131150.23389274688,5146.783371913575,136297.01726466045,173,10,105.24137931034483,29,0,20,33.23658192090395,0.649066091954023,43.92361111111111,1024.3055555555552,35.32088122605363,0
178,4,0,0,28,0.0,0.0,1.0,28,1150,900,250,0.782608695652174,14,9,5,428.12894816729465,0.41947751322751325,0.07991622574955892,0.2493221521680128,131107.31272294887,5626.167178623334,136733.4799015722,174,11,108.85714285714286,28,0,21,33.00393986157875,0.6517857142857143,43.96551724137931,1024.1379310344828,36.576354679802954,0
179,4,0,0,28,0.0,0.0,1.0,28,250,100,150,0.4,4,1,3,425.7628012680412,0.4192294973544974,0.07830691541590684,0.2481817669860889,131144.10186699044,5567.256036134249,136711.3579031247,175,12,109.85714285714286,28,0,21,33.02707252069013,0.6521577380952381,43.92959770114943,1024.281609195403,36.581486042692966,0
180,4,0,0,28,0.0,0.0,1.0,28,850,600,250,0.7058823529411765,11,6,5,426.53768107781826,0.4193121693121693,0.08161405336110872,0.2493497329054917,131254.50026423568,5596.998034746991,136851.49829898268,176,13,110.85714285714286,28,0,21,32.89487521031969,0.6532738095238095,43.82183908045977,1024.7126436781607,36.59688013136288,0
181,4,0,0,28,0.0,0.0,1.0,28,1000,500,500,0.5,15,5,10,429.1874250182558,0.4182925485008819,0.08549904895384919,0.2516230301976381,131364.9451091624,5676.036505813191,137040.98161497558,177,14,111.85714285714286,28,0,21,32.7146110721794,0.6543898809523809,43.714080459770116,1025.1436781609198,36.61227422003285,0
182,4,1,0,29,0.034482758620689655,0.0,1.0,29,950,800,150,0.8421052631578947,11,8,3,417.03212291781506,0.4232861247947455,0.0806308618356586,0.24654939106901236,131684.26890432107,5183.3140432098935,136867.58294753096,178,0,108.96551724137932,29,0,20,32.701849345963026,0.6544540229885057,43.402777777777786,1026.3888888888896,35.39272030651343,0
183,4,1,1,29,0.03333333333333333,0.03333333333333333,0.9666666666666667,30,650,500,150,0.7692307692307693,8,5,3,406.56012601563765,0.42552681992337166,0.06865463423140628,0.24247727952539505,132017.8723696381,4734.6405653832835,136752.51293502137,179,0,106.3,30,0,20,32.632531170982645,0.6548611111111111,43.07795698924731,1027.6881720430106,34.256272401433684,0
184,4,0,0,29,0.0,0.0,1.0,29,1250,1000,250,0.8,15,10,5,413.30483336671546,0.42087438423645324,0.08526340802035137,0.24688208811517862,132076.584201389,5117.57812500002,137194.16232638902,180,2,110.96551724137932,29,0,20,32.399760167544926,0.658405172413793,43.02083333333334,1027.9166666666677,35.44540229885061,0
185,4,0,0,29,0.0,0.0,1.0,29,500,300,200,0.6,7,3,4,416.11394077580394,0.4200533661740558,0.09081763818252941,0.24926437034822427,132183.6805555555,5200.694444444441,137384.37499999994,181,3,111.96551724137932,29,0,20,32.219070772555376,0.6594827586206896,42.916666666666664,1028.333333333333,35.459770114942515,0
186,4,1,0,30,0.03333333333333333,0.0,1.0,30,800,600,200,0.75,10,6,4,404.5543943670607,0.4211446360153257,0.07647826654483758,0.2446165126476758,132536.36845661353,4723.6340545149815,137260.00251112852,182,0,109.2,30,0,21,32.15963973371624,0.6600694444444444,42.5739247311828,1029.704301075269,34.32347670250897,0
187,4,0,1,29,0.0,0.03333333333333333,0.9666666666666667,30,750,400,350,0.5333333333333333,11,4,7,401.62308746604924,0.42042624521072797,0.07967384213959572,0.24374037731015563,132674.80570369403,4657.053019135155,137331.85872282917,183,1,110.2,30,0,20,32.095292454881495,0.6614583333333334,42.439516129032256,1030.2419354838707,34.34139784946236,0
188,4,0,1,28,0.0,0.034482758620689655,0.9655172413793104,29,850,500,350,0.5882352941176471,12,5,7,402.6053283541968,0.4181547619047619,0.062180500046472575,0.24486324068755255,132755.59413580253,4889.621913580254,137645.21604938278,184,2,109.58620689655173,29,0,20,31.988432165318965,0.6652298850574712,42.361111111111114,1030.5555555555559,35.53639846743296,0
189,4,0,0,28,0.0,0.0,1.0,28,750,300,450,0.4,12,3,9,416.72297886439725,0.4157297178130512,0.07773636798469341,0.2522863439611487,132582.90395032373,5450.068536134236,138032.97248645796,185,7,114.42857142857143,28,0,20,31.799316406249993,0.6666666666666666,42.52873563218391,1029.8850574712646,36.78160919540231,0
190,4,0,0,28,0.0,0.0,1.0,28,900,700,200,0.7777777777777778,11,7,4,414.3761099731758,0.4150683421516755,0.07800358637178695,0.25136012762332227,132656.90026753861,5393.970058792436,138050.87032633106,186,8,115.42857142857143,28,0,20,31.78492561599255,0.6674107142857143,42.456896551724135,1030.1724137931033,36.791871921182256,0
191,4,0,0,28,0.0,0.0,1.0,28,650,500,150,0.7692307692307693,8,5,3,411.9101118139107,0.4143794091710758,0.07867098058735689,0.25110068413464803,132841.9813755119,5343.791080393705,138185.77245590562,187,9,116.42857142857143,28,0,20,31.66144018583043,0.6692708333333334,42.27729885057471,1030.8908045977007,36.817528735632166,0
192,4,0,0,28,0.0,0.0,1.0,28,900,700,200,0.7777777777777778,11,7,4,410.13842226550076,0.41335978835978837,0.08251094309590123,0.25126227575650983,133027.19150482235,5311.912488439695,138339.10399326205,188,10,117.42857142857143,28,0,20,31.52013695450325,0.6711309523809523,42.09770114942529,1031.6091954022993,36.84318555008212,0
193,4,0,0,28,0.0,0.0,1.0,28,550,300,250,0.5454545454545454,8,3,5,406.82035617382854,0.4127535273368607,0.07266146993318512,0.25022238345486153,133175.45250363313,5235.69700422776,138411.1495078609,189,11,118.42857142857143,28,0,20,31.45618736080178,0.6726190476190477,41.95402298850574,1032.1839080459763,36.86371100164201,0
194,4,0,0,28,0.0,0.0,1.0,28,850,600,250,0.7058823529411765,11,6,5,406.579056976492,0.4115961199294533,0.06628110342634574,0.25107304652465834,133323.79607609982,5241.332656229355,138565.12873232918,190,12,119.42857142857143,28,0,21,31.31289417547766,0.6741071428571429,41.810344827586206,1032.758620689655,36.88423645320196,0
195,4,0,0,28,0.0,0.0,1.0,28,1250,1000,250,0.8,15,10,5,403.87617065556714,0.4106040564373898,0.06653225806451601,0.2504032258064514,133472.2222222221,5181.332573655681,138653.55479587778,191,13,120.42857142857143,27,1,23,31.23319892473117,0.6790123456790124,41.66666666666666,1033.3333333333323,38.271604938271565,0
196,4,0,0,28,0.0,0.0,1.0,28,750,400,350,0.5333333333333333,11,4,7,402.1505317078294,0.4095293209876543,0.06794813794238008,0.2501109886995782,133587.57451548323,5144.462824192165,138732.0373396754,192,14,121.42857142857143,27,1,23,31.161682500839696,0.6801697530864198,41.55505952380952,1033.7797619047615,38.28813932980598,0
197,4,0,0,28,0.0,0.0,1.0,28,550,300,250,0.5454545454545454,8,3,5,399.5143793510521,0.4088128306878307,0.0695081283868273,0.24894415482160362,133657.8710240785,5079.648277513536,138737.51930159202,193,15,122.42857142857143,28,0,23,31.15910564587096,0.6774553571428572,41.48706896551724,1034.051724137931,36.93041871921182,0
198,4,0,0,28,0.0,0.0,1.0,28,900,700,200,0.7777777777777778,11,7,4,400.71215060212285,0.408234126984127,0.0756436704090131,0.25095033988143395,133843.64884727186,5126.555274805133,138970.204122077,194,16,123.42857142857143,28,0,20,30.941347310932144,0.679315476190476,41.30747126436782,1034.7701149425293,36.95607553366176,0
199,4,0,0,28,0.0,0.0,1.0,28,900,700,200,0.7777777777777778,11,7,4,401.82231106723657,0.4079585537918871,0.07907313397318916,0.2521540007777329,133917.99610252355,5162.247737481846,139080.2438400054,195,17,124.42857142857143,28,0,20,30.837902554136594,0.6800595238095237,41.23563218390805,1035.0574712643686,36.966338259441734,0
200,4,0,0,28,0.0,0.0,1.0,28,600,300,300,0.5,9,3,6,400.9865102408101,0.40735229276895946,0.08075352782622458,0.2526495424664128,134066.75254326878,5151.791848328734,139218.5443915975,196,18,125.42857142857143,28,0,20,30.710090640029595,0.681547619047619,41.09195402298852,1035.6321839080474,36.986863711001696,0
201,4,1,0,29,0.034482758620689655,0.0,1.0,29,1000,800,200,0.8,12,8,4,389.5440646796423,0.4078920361247948,0.0842101375339912,0.24846324672008951,134514.75935570983,4679.88522376543,139194.64457947525,197,0,122.06896551724138,29,0,21,30.55727562815192,0.6828304597701149,40.65972222222222,1037.3611111111109,35.77107279693486,0
202,4,0,0,29,0.0,0.0,1.0,29,1050,800,250,0.7619047619047619,13,8,5,388.406692224393,0.4075328407224959,0.08014472830030206,0.2487455624671112,134662.6040428061,4660.776143048759,139323.38018585485,198,1,123.06896551724138,28,1,23,30.43875738279809,0.6875,40.51724137931034,1037.9310344827582,37.06896551724136,0
203,4,0,0,29,0.0,0.0,1.0,29,850,700,150,0.8235294117647058,10,7,3,391.06632571777556,0.40645525451559933,0.0816287580576669,0.25122100764109906,134774.4732832937,4741.151613489234,139515.62489678292,199,2,124.06896551724138,28,1,23,30.257771781744385,0.6886160714285714,40.40948275862069,1038.3620689655172,37.08435960591133,0
204,4,0,0,29,0.0,0.0,1.0,29,1400,1000,400,0.7142857142857143,18,10,8,393.3725016261576,0.40532635467980294,0.07945674514423029,0.2537445637162128,134923.70452255913,4815.055035341522,139738.75955790066,200,3,125.06896551724138,28,1,20,30.048575577375175,0.6901041666666667,40.26580459770115,1038.9367816091956,37.10488505747127,0
205,4,0,0,29,0.0,0.0,1.0,29,1000,700,300,0.7,13,7,6,395.09778684799284,0.4051724137931034,0.08072197828916305,0.2553835828660887,134998.35110731277,4867.5099501255145,139865.86105743828,201,4,126.06896551724138,28,1,20,29.929086593852247,0.6908482142857142,40.19396551724138,1039.2241379310349,37.115147783251246,0
206,4,0,0,29,0.0,0.0,1.0,29,1150,900,250,0.782608695652174,14,9,5,397.7567020251608,0.4046592775041051,0.08386229770686837,0.25790031324857204,135110.35969084417,4948.21021601268,140058.56990685684,202,5,127.06896551724138,28,1,20,29.74796158098397,0.6919642857142858,40.08620689655172,1039.6551724137928,37.130541871921174,0
207,4,1,0,30,0.03333333333333333,0.0,1.0,30,750,500,250,0.6666666666666666,10,5,5,382.8703438110985,0.4046216475095785,0.07029387719977565,0.25115127464052345,135528.6941590069,4377.983545785647,139906.67770479256,203,0,123.8,30,0,22,29.71741749494427,0.6899305555555555,39.68413978494624,1041.2634408602157,34.708781362007194,0
208,4,0,0,30,0.0,0.0,1.0,30,600,300,300,0.5,9,3,6,390.456038561197,0.4042624521072797,0.10074730622175876,0.23850149107018323,132917.24476818126,4379.668169730603,137296.91293791187,204,1,124.8,30,0,20,32.138512339242276,0.663888888888889,42.204301075268816,1031.1827956989243,34.372759856630815,5
209,4,0,0,30,0.0,0.0,1.0,30,850,400,450,0.47058823529411764,13,4,9,387.58250450244367,0.4037116858237548,0.09543224349789403,0.23784739305078018,133090.55102107173,4316.7138180714455,137407.26483914317,205,2,125.8,30,0,20,32.038068255829096,0.6656250000000001,42.03629032258064,1031.8548387096769,34.39516129032256,0
210,4,1,1,30,0.03225806451612903,0.03225806451612903,0.967741935483871,31,750,600,150,0.8,9,6,3,377.54314028471254,0.40712365591397853,0.08847182806541065,0.23365267355841704,133404.9563937716,3873.2252332899216,137278.1816270615,206,0,122.70967741935483,31,0,21,31.98103100579784,0.665994623655914,41.73177083333333,1033.0729166666658,33.3249327956989,0
211,4,0,1,29,0.0,0.03333333333333333,0.9666666666666667,30,650,500,150,0.7692307692307693,8,5,3,385.4101709765219,0.4060344827586207,0.008910373660830917,0.2315486223433516,132294.27715631868,4197.5119956064345,136491.78915192513,207,1,120.96666666666667,30,0,20,32.89674244403797,0.6576388888888889,42.80913978494624,1028.7634408602153,34.29211469534051,5
212,4,0,0,29,0.0,0.0,1.0,29,750,700,50,0.9333333333333333,8,7,1,395.4706954304378,0.4013238916256157,0.028219516170341796,0.237122307664971,132219.38898533955,4657.778742283963,136877.1677276235,208,5,126.10344827586206,29,0,20,32.71367882061671,0.6598419540229885,42.88194444444445,1028.4722222222226,35.46455938697319,0
213,4,0,0,29,0.0,0.0,1.0,29,800,400,400,0.5,12,4,8,396.48680967450264,0.4010160098522168,0.029891886354959096,0.23795634622766337,132255.1022376543,4687.480709876542,136942.58294753084,209,6,127.10344827586206,29,0,20,32.65145377621747,0.6602011494252873,42.84722222222222,1028.6111111111109,35.46934865900382,0
214,4,0,0,29,0.0,0.0,1.0,29,650,500,150,0.7692307692307693,8,5,3,398.4658001278501,0.40004105090311987,0.037693703755409924,0.24005134788189988,132398.00347222216,4751.215277777768,137149.21874999994,210,7,128.10344827586206,29,0,20,32.4561403508772,0.6616379310344829,42.70833333333333,1029.166666666666,35.48850574712642,0
215,4,0,0,29,0.0,0.0,1.0,29,900,600,300,0.6666666666666666,12,6,6,396.76474519958435,0.40029761904761907,0.03740439548169738,0.23948047975727355,132469.48302469132,4711.844135802462,137181.3271604938,211,8,129.10344827586206,29,0,21,32.42770732146069,0.6623563218390804,42.638888888888886,1029.4444444444443,35.49808429118774,0
216,4,0,0,29,0.0,0.0,1.0,29,850,500,350,0.5882352941176471,12,5,7,397.82356600751325,0.40029761904761907,0.07058424936003616,0.22219901613590362,129483.95061728386,4502.3533950617175,133986.3040123456,212,9,130.10344827586206,29,0,20,35.43315593158661,0.632183908045977,45.55555555555555,1017.777777777777,35.095785440613,6
217,4,0,0,29,0.0,0.0,1.0,29,1050,800,250,0.7619047619047619,13,8,5,394.40588662304026,0.39998973727422005,0.06828827811953242,0.2210844006666765,129625.3472222221,4424.999999999981,134050.34722222207,213,10,131.10344827586206,29,0,20,35.37575013638843,0.6336206896551726,45.41666666666666,1018.3333333333323,35.1149425287356,0
218,4,2,1,30,0.06451612903225806,0.03225806451612903,0.967741935483871,31,600,300,300,0.5,9,3,6,374.9511428837633,0.4082885304659498,0.052416268139501954,0.21327046864462545,130196.13477918845,3563.4379069010474,133759.5726860895,214,0,123.58064516129032,31,0,21,35.29014629582376,0.6337365591397849,44.856770833333336,1020.5729166666673,32.92170698924733,0
219,4,0,0,30,0.0,0.0,1.0,30,550,400,150,0.7272727272727273,7,4,3,379.7884501638398,0.4048611111111111,0.06437069230431547,0.21601001513812984,130193.9914477106,3889.2348465140344,134083.22629422465,215,1,128.7,30,0,23,35.168905570920586,0.6364583333333333,44.85887096774193,1020.5645161290313,34.018817204301044,0
220,4,1,1,30,0.03225806451612903,0.03225806451612903,0.967741935483871,31,1000,800,200,0.8,12,8,4,367.83493927954277,0.4083333333333334,0.06392423794021918,0.21102109674457967,130528.5644531249,3402.5933159722085,133931.1577690971,216,0,125.51612903225806,31,0,20,35.13421678559294,0.6370967741935485,44.53124999999999,1021.8749999999992,32.96370967741933,0
221,4,1,1,30,0.03225806451612903,0.03225806451612903,0.967741935483871,31,450,300,150,0.6666666666666666,6,3,3,367.59821371020394,0.40801971326164876,0.0604967141900139,0.21106645057874093,130561.83073255747,3398.8591512044222,133960.6898837619,217,0,126.48387096774194,31,0,21,35.10651569202021,0.6374327956989247,44.498697916666664,1022.005208333333,32.96790994623655,0
222,4,1,1,30,0.03225806451612903,0.03225806451612903,0.967741935483871,31,550,300,250,0.5454545454545454,8,3,5,367.1566361799245,0.4074372759856631,0.05705552725420304,0.21135732458099454,130661.65500217002,3394.658745659704,134056.31374782973,218,0,127.45161290322581,31,0,22,35.01655629139073,0.6384408602150538,44.40104166666666,1022.3958333333323,32.98051075268814,0
223,4,2,3,29,0.0625,0.09375,0.90625,32,700,400,300,0.5714285714285714,10,4,6,360.37674754725634,0.41250840053763443,0.0440183197631383,0.2089566463246109,130940.15438475664,3037.5573921028404,133977.71177685948,219,0,124.40625,32,0,22,34.90778435726622,0.638671875,44.128787878787875,1023.4848484848483,31.98390151515151,0
224,4,1,1,29,0.03333333333333333,0.03333333333333333,0.9666666666666667,30,750,400,350,0.5333333333333333,11,4,7,379.44915893265875,0.4016762452107279,0.06713133438541163,0.21792533266797076,130571.48947855225,3909.0483726442135,134480.53785119645,220,0,133.5,30,0,22,34.79391329125022,0.640277777777778,44.489247311827945,1022.0430107526867,34.06810035842289,0
225,4,2,1,30,0.06451612903225806,0.03225806451612903,0.967741935483871,31,1150,1000,150,0.8695652173913043,13,10,3,368.409451002754,0.3991487455197133,0.06221901355298165,0.21428786410396863,131061.33355034718,3456.8467881944393,134518.18033854163,221,0,130.1290322580645,31,0,23,34.57951848084096,0.64247311827957,44.010416666666664,1023.9583333333329,33.03091397849461,0
226,4,0,0,30,0.0,0.0,1.0,30,1000,800,200,0.8,12,8,4,379.8274380174289,0.3959530651340996,0.06715242221346984,0.22068234899914246,131018.32807622274,3952.871177303739,134971.1992535265,222,1,135.46666666666667,30,0,23,34.3308279725176,0.6447916666666667,44.05241935483871,1023.7903225806456,34.12634408602152,0
227,4,0,0,30,0.0,0.0,1.0,30,950,700,250,0.7368421052631579,12,7,5,382.1392422174237,0.39537835249042147,0.07064252285351902,0.22282197130367126,131155.97043372056,4023.9686307665543,135179.93906448712,223,2,136.46666666666667,30,0,23,34.132113021038364,0.6461805555555555,43.91801075268817,1024.3279569892466,34.14426523297489,0
228,4,0,0,30,0.0,0.0,1.0,30,700,400,300,0.5714285714285714,10,4,6,381.4080330126266,0.3951388888888889,0.06981066071975128,0.2227948992839274,131224.81871097806,4010.03999739853,135234.8587083766,224,3,137.46666666666667,30,0,23,34.0810704447068,0.6468750000000001,43.8508064516129,1024.5967741935478,34.153225806451594,0
229,4,1,1,30,0.03225806451612903,0.03225806451612903,0.967741935483871,31,950,600,350,0.631578947368421,13,6,7,371.333694386487,0.39932795698924733,0.060536078421737916,0.21863728283832154,131528.39660644523,3568.185085720471,135096.5816921657,225,0,134.0,31,0,23,34.03200897012777,0.6471774193548387,43.55468749999999,1025.7812499999993,33.08971774193546,0
230,4,0,0,30,0.0,0.0,1.0,30,900,500,400,0.5555555555555556,13,5,8,384.31383685170067,0.39415708812260536,0.06944954931303049,0.2234887640562026,131052.73189096992,4073.075644583169,135125.8075355531,226,5,139.46666666666667,30,0,20,34.18110615209591,0.6451388888888889,44.018817204301065,1023.9247311827946,34.13082437275982,1
231,4,0,0,30,0.0,0.0,1.0,30,1100,900,200,0.8181818181818182,13,9,4,385.02214290435586,0.392911877394636,0.07615176151761505,0.22551296941540838,131328.125,4112.847222222223,135440.97222222222,227,6,140.46666666666667,30,0,22,33.88380758807588,0.6479166666666667,43.75,1025.0,34.166666666666664,0
232,4,0,0,30,0.0,0.0,1.0,30,850,700,150,0.8235294117647058,10,7,3,384.1802577042766,0.3921455938697318,0.0745062052088794,0.22542515428986337,131397.01844143838,4096.028081281082,135493.04652271947,228,7,141.46666666666667,30,0,22,33.83559473868204,0.648611111111111,43.682795698924735,1025.2688172043015,34.175627240143385,0
233,4,0,0,30,0.0,0.0,1.0,30,550,400,150,0.7272727272727273,7,4,3,384.5687100128326,0.3916906130268199,0.07842443308428337,0.22585640405603535,131431.47193678463,4108.886323563415,135540.35826034803,229,8,142.46666666666667,30,0,22,33.79074365360248,0.6489583333333333,43.649193548387096,1025.4032258064517,34.18010752688172,0
234,4,0,0,30,0.0,0.0,1.0,30,750,600,150,0.8,9,6,3,381.0592054222425,0.3913074712643678,0.06943025540275038,0.22501059809735666,131638.2877536421,4032.396266909479,135670.6840205516,230,9,143.46666666666667,30,0,19,33.6714145383104,0.6510416666666665,43.447580645161295,1026.2096774193553,34.206989247311846,0
235,4,1,1,30,0.03225806451612903,0.03225806451612903,0.967741935483871,31,650,400,250,0.6153846153846154,9,4,5,371.1652133065917,0.39646057347670255,0.06030642713789214,0.22440172070554512,132532.04345703137,3638.256835937515,136170.3002929689,231,0,139.80645161290323,31,0,23,33.02352048558422,0.657258064516129,42.57812500000001,1029.687500000001,33.215725806451644,1
236,4,1,1,30,0.03225806451612903,0.03225806451612903,0.967741935483871,31,850,600,250,0.7058823529411765,11,6,5,368.3606228987555,0.39551971326164875,0.05792020480793192,0.2237020421333733,132699.6888054743,3576.268005371113,136275.9568108454,232,0,137.4516129032258,31,0,19,32.92696090821013,0.6589381720430106,42.41536458333334,1030.3385416666677,33.23672715053767,0
237,4,0,0,30,0.0,0.0,1.0,30,900,600,300,0.6666666666666666,12,6,6,378.02865625502784,0.3940852490421456,0.07243179741548067,0.22857754819019505,132536.36845661368,4020.509054514996,136556.87751112867,233,2,143.03333333333333,30,0,23,32.84248139929513,0.6600694444444444,42.57392473118281,1029.7043010752702,34.323476702509005,0
238,4,0,0,30,0.0,0.0,1.0,30,950,700,250,0.7368421052631579,12,7,5,378.3980976393871,0.3940373563218391,0.07510983513854441,0.2292224997794959,132605.57804731763,4035.5396938952504,136641.1177412129,234,3,144.03333333333333,30,0,23,32.76322371569012,0.6607638888888887,42.50672043010753,1029.97311827957,34.33243727598566,0
239,4,0,0,30,0.0,0.0,1.0,30,700,400,300,0.5714285714285714,10,4,6,378.3791859576397,0.392911877394636,0.0768327680667884,0.22984586684241404,132709.4263065094,4042.8969389524805,136752.32324546188,235,4,145.03333333333333,30,0,21,32.6590899208627,0.6618055555555555,42.405913978494624,1030.3763440860214,34.34587813620071,0
240,4,0,1,29,0.0,0.03333333333333333,0.9666666666666667,30,550,200,350,0.36363636363636365,9,2,7,376.6282745572913,0.3928400383141763,0.07720693701916792,0.22941717534391326,132813.31521346405,4004.249949416131,136817.56516288017,236,5,146.03333333333333,30,0,21,32.599589255444,0.6628472222222221,42.30510752688173,1030.7795698924738,34.359318996415794,0
241,4,0,0,29,0.0,0.0,1.0,29,900,700,200,0.7777777777777778,11,7,4,397.5311567083556,0.38485221674876846,0.06429699621206808,0.23745989433402273,132076.58420138893,4700.911458333338,136777.49565972228,237,16,151.89655172413794,29,0,20,32.80511079583838,0.6584051724137931,43.020833333333336,1027.916666666667,35.44540229885059,5
242,4,0,0,29,0.0,0.0,1.0,29,850,600,250,0.7058823529411765,11,6,5,402.03596216035567,0.3834154351395731,0.06426226454632222,0.24105880970019716,132219.38898533958,4831.389853395072,137050.77883873467,238,17,152.89655172413794,29,0,20,32.544873959036686,0.6598419540229885,42.88194444444445,1028.4722222222229,35.4645593869732,0
243,4,0,0,29,0.0,0.0,1.0,29,650,300,350,0.46153846153846156,10,3,7,403.7066529543125,0.38372331691297207,0.06229804352482149,0.2422894223484311,132255.1022376544,4878.452932098778,137133.55516975318,239,18,153.89655172413794,29,0,20,32.46579350076515,0.6602011494252873,42.84722222222223,1028.6111111111118,35.469348659003856,0
244,4,0,0,29,0.0,0.0,1.0,29,550,500,50,0.9090909090909091,6,5,1,406.3055932513131,0.3835180623973728,0.0658852870151081,0.24500657051143054,132433.74083719138,4961.713927469141,137395.4547646605,240,19,154.89655172413794,29,0,21,32.218296001439306,0.6619971264367815,42.673611111111114,1029.3055555555557,35.49329501915709,0
245,4,0,0,29,0.0,0.0,1.0,29,700,400,300,0.5714285714285714,10,4,6,407.5261704325414,0.38295361247947457,0.06670481028202979,0.2462095763175575,132505.2300347223,4999.869791666675,137505.099826389,241,20,155.89655172413794,29,0,22,32.11461284230405,0.6627155172413792,42.60416666666667,1029.5833333333342,35.50287356321842,0
246,4,0,0,29,0.0,0.0,1.0,29,850,600,250,0.7058823529411765,11,6,5,415.05852532534124,0.3834154351395731,0.0642413370463073,0.23498648816221882,130014.58574459865,4992.732445987638,135007.3181905863,242,21,156.89655172413794,29,0,20,34.45217100186118,0.6375718390804599,45.034722222222214,1019.8611111111102,35.16762452107277,8
247,4,1,1,29,0.03333333333333333,0.03333333333333333,0.9666666666666667,30,1050,900,150,0.8571428571428571,12,9,3,402.82886722447427,0.3889607279693486,0.05263919968408537,0.22992418514683158,130331.20022907258,4500.233950456676,134831.43417952926,243,0,152.63333333333333,30,0,20,34.44122680005263,0.6378472222222223,44.724462365591386,1021.1021505376333,34.03673835125444,0
248,4,0,0,29,0.0,0.0,1.0,29,1050,800,250,0.7619047619047619,13,8,5,413.9868384374685,0.38444170771756975,0.07289648605162835,0.23609133043862138,130298.03481867269,4988.334297839489,135286.36911651219,244,23,158.89655172413794,29,0,21,34.19021788418809,0.6404454022988506,44.756944444444436,1020.972222222221,35.20593869731797,0
249,4,1,1,29,0.03333333333333333,0.03333333333333333,0.9666666666666667,30,800,600,200,0.75,10,6,4,407.03887679482114,0.3918103448275862,0.06223917236542187,0.23377066609877767,130571.48947855225,4629.534483755325,135201.02396230758,245,0,154.56666666666666,30,0,17,34.088966333508694,0.640277777777778,44.489247311827945,1022.0430107526867,34.06810035842289,0
250,4,1,0,30,0.03333333333333333,0.0,1.0,30,700,400,300,0.5714285714285714,10,4,6,404.20329378364966,0.39001436781609194,0.07455644631357594,0.23317534968914239,130743.26014929463,4569.371278471485,135312.63142776611,246,0,155.53333333333333,30,0,19,33.98661672580715,0.642013888888889,44.32123655913978,1022.7150537634401,34.09050179211467,0
251,4,1,1,30,0.03225806451612903,0.03225806451612903,0.967741935483871,31,1150,1000,150,0.8695652173913043,13,10,3,392.5025330099598,0.3957437275985663,0.06536103192994691,0.22849980918751517,131094.6676466198,4090.997823079402,135185.66546969922,247,0,151.48387096774192,31,0,21,33.92893091756728,0.6428091397849464,43.97786458333332,1024.0885416666652,33.03511424731178,0
252,4,1,1,30,0.03225806451612903,0.03225806451612903,0.967741935483871,31,500,200,300,0.4,8,2,6,392.85475211348233,0.3957437275985663,0.06271217016252062,0.22930127519502036,131194.6953667533,4108.091905381921,135302.7872721352,248,0,152.4516129032258,31,0,21,33.81842060667684,0.6438172043010755,43.88020833333332,1024.4791666666652,33.04771505376339,0
253,4,0,0,30,0.0,0.0,1.0,30,500,300,200,0.6,7,3,4,404.84734411548664,0.3896072796934866,0.07026341121904256,0.23542954713525,131052.73189096992,4611.270089027614,135664.00197999753,249,3,158.53333333333333,30,0,21,33.655487004463104,0.6451388888888889,44.018817204301065,1023.9247311827946,34.13082437275982,0
254,4,0,0,30,0.0,0.0,1.0,30,650,300,350,0.46153846153846156,10,3,7,403.64936140015067,0.3887691570881226,0.0747102305034335,0.2353643292448772,131155.97043372053,4588.204741877653,135744.17517559818,250,4,159.53333333333333,30,0,21,33.5812776101124,0.6461805555555556,43.91801075268816,1024.327956989246,34.14426523297487,0
255,4,0,0,30,0.0,0.0,1.0,30,900,500,400,0.5555555555555556,13,5,8,406.6942030036574,0.3872365900383142,0.07842443308428337,0.2388506601012242,131431.47193678463,4690.483545785639,136121.95548257028,251,5,160.53333333333333,30,0,21,33.22355485646873,0.6489583333333333,43.649193548387096,1025.4032258064517,34.18010752688172,0
256,4,1,1,30,0.03225806451612903,0.03225806451612903,0.967741935483871,31,150,0,150,0.0,3,0,3,400.3681297359858,0.39265232974910397,0.06731548403467258,0.2365593402233164,131661.9957817926,4342.653401692717,136004.6491834853,252,0,156.32258064516128,31,0,17,33.15201302545886,0.648521505376344,43.42447916666667,1026.302083333334,33.10651881720432,0
257,4,2,1,31,0.0625,0.03125,0.96875,32,950,700,250,0.7368421052631579,12,7,5,387.38059174196417,0.3941742271505377,0.06827708512467745,0.2313767716339934,132073.33953486886,3832.529684470967,135905.86921933983,253,0,152.375,32,0,19,33.06923801334806,0.6500651041666667,43.023989898989896,1027.9040404040402,32.122001262626256,0
258,4,0,0,31,0.0,0.0,1.0,31,850,700,150,0.8235294117647058,10,7,3,399.39855647840477,0.3905913978494624,0.0844848232202482,0.23828063539561978,132029.7431945802,4346.49776882597,136376.24096340616,254,1,158.29032258064515,31,0,20,32.80451560454411,0.6522177419354838,43.06640625000001,1027.734375000001,33.15272177419358,0
259,4,0,0,31,0.0,0.0,1.0,31,500,100,400,0.2,9,1,8,410.27536614064195,0.3905913978494624,0.0844511730974169,0.2407369609939092,131397.01844143838,4582.304835024572,135979.32327646296,255,2,159.29032258064515,30,1,23,33.166732214647794,0.648611111111111,43.682795698924735,1025.2688172043015,34.175627240143385,1
260,4,1,2,30,0.03125,0.0625,0.9375,32,850,500,350,0.5882352941176471,12,5,7,397.5355951054494,0.39396421370967744,0.06762444514901733,0.23550474586074144,131762.23966810433,4076.036071777338,135838.27573988168,256,0,155.28125,31,1,18,33.12315049672373,0.6495295698924731,43.326822916666664,1026.692708333333,33.119119623655905,0
261,4,0,0,30,0.0,0.0,1.0,30,1000,800,200,0.8,12,8,4,407.08167125422,0.3897988505747127,0.05710668762004545,0.24059408991464565,131672.7728639148,4720.314487223944,136393.08735113876,257,4,158.13333333333333,30,0,20,32.96883184913566,0.6513888888888889,43.41397849462365,1026.3440860215046,34.21146953405015,0
262,4,0,1,29,0.0,0.03333333333333333,0.9666666666666667,30,900,600,300,0.6666666666666666,12,6,6,407.9295173359998,0.3904454022988506,0.055866823755290396,0.2417512477059505,131776.255293242,4751.084843623539,136527.34013686553,258,5,159.13333333333333,30,0,20,32.84215865951042,0.6524305555555556,43.31317204301075,1026.747311827957,34.22491039426523,0
263,4,0,0,29,0.0,0.0,1.0,29,700,500,200,0.7142857142857143,9,5,4,415.83523850923007,0.39116379310344823,0.04956109034398759,0.24561203655832944,131648.6328125,5148.828125,136797.4609375,259,6,157.75862068965517,29,0,20,32.76872716199757,0.6540948275862069,43.4375,1026.25,35.38793103448276,0
264,4,0,0,29,0.0,0.0,1.0,29,800,700,100,0.875,9,7,2,420.8800685167086,0.3908045977011494,0.04673572857829145,0.24952416572125322,131791.20611496913,5293.658371913572,137084.8644868827,260,7,158.75862068965517,29,0,20,32.49456129672211,0.6555316091954023,43.29861111111111,1026.8055555555554,35.40708812260536,0
265,4,0,0,29,0.0,0.0,1.0,29,800,500,300,0.625,11,5,6,421.78475981140934,0.3897270114942529,0.03775994928046322,0.2510009548129522,131933.8565779321,5329.53800154321,137263.3945794753,261,8,159.75862068965517,29,0,21,32.326590734982645,0.6569683908045977,43.15972222222222,1027.3611111111113,35.42624521072798,0
266,4,0,1,28,0.0,0.034482758620689655,0.9655172413793104,29,550,300,250,0.5454545454545454,8,3,5,419.0447670472523,0.38952175697865354,0.03411458211967133,0.2498398252524272,132005.21074459885,5263.218557098784,137268.42930169764,262,9,160.75862068965517,29,0,21,32.324610307699245,0.6576867816091954,43.090277777777786,1027.6388888888896,35.4358237547893,0
267,4,0,0,28,0.0,0.0,1.0,28,550,200,350,0.36363636363636365,9,2,7,428.14599461793074,0.38417658730158727,0.04361970057366715,0.2539385413721454,131807.1889656824,5686.544003501129,137493.73296918353,263,17,167.17857142857142,28,0,21,32.2918124154657,0.6588541666666666,43.2830459770115,1026.8678160919542,36.67385057471265,0
268,4,0,0,28,0.0,0.0,1.0,28,750,500,250,0.6666666666666666,10,5,5,427.62227981808405,0.3834325396825397,0.04519480519480501,0.2543676622877955,131917.8660490158,5682.203725723361,137600.06977473915,264,18,168.17857142857142,28,0,22,32.192890442890445,0.6599702380952381,43.175287356321846,1027.2988505747135,36.689244663382624,0
269,4,1,0,29,0.034482758620689655,0.0,1.0,29,850,500,350,0.5882352941176471,12,5,7,415.19276726310096,0.3879310344827586,0.03240615716986195,0.24918295254056125,132255.10223765436,5182.272376543209,137437.37461419756,265,0,163.3448275862069,29,0,23,32.17042488072733,0.6602011494252873,42.84722222222222,1028.6111111111113,35.46934865900384,0
270,4,1,1,29,0.03333333333333333,0.03333333333333333,0.9666666666666667,30,600,400,200,0.6666666666666666,8,4,4,403.9192151349354,0.3919061302681992,0.02751239885147516,0.24445726906507692,132570.97099375646,4709.592510694875,137280.56350445133,266,0,158.86666666666667,30,0,23,32.141031497433225,0.6604166666666667,42.54032258064516,1029.838709677419,34.327956989247305,0
271,4,0,0,29,0.0,0.0,1.0,29,750,700,50,0.9333333333333333,8,7,1,414.5478205247009,0.38716133004926107,0.0385365422296271,0.2495032333279864,132362.27092978414,5174.0981867284145,137536.36911651256,267,2,165.3448275862069,29,0,23,32.07852499212668,0.6612787356321839,42.743055555555564,1029.0277777777792,35.48371647509583,0
272,4,0,0,29,0.0,0.0,1.0,29,1000,900,100,0.9,11,9,2,414.5478205247009,0.38716133004926107,0.0385365422296271,0.2495032333279864,132362.27092978414,5174.0981867284145,137536.36911651256,268,3,166.3448275862069,29,0,23,32.07852499212668,0.6612787356321839,42.743055555555564,1029.0277777777792,35.48371647509583,0
273,4,0,0,29,0.0,0.0,1.0,29,950,700,250,0.7368421052631579,12,7,5,416.13755393672534,0.38634031198686375,0.04438881625170432,0.2509353468043183,132433.7408371914,5222.130594135809,137655.87143132722,269,4,167.3448275862069,29,0,23,31.965293707551837,0.6619971264367815,42.673611111111114,1029.3055555555559,35.4932950191571,0
274,4,0,0,29,0.0,0.0,1.0,29,600,400,200,0.6666666666666666,8,4,4,416.3056951069681,0.3854679802955665,0.046045226644837234,0.2517528893575093,132540.98186728408,5235.513117283963,137776.49498456804,270,5,168.3448275862069,29,0,23,31.852463807211564,0.663074712643678,42.56944444444445,1029.7222222222233,35.50766283524908,0
275,4,0,0,29,0.0,0.0,1.0,29,550,300,250,0.5454545454545454,8,3,5,413.19739005666054,0.385621921182266,0.04435888851690639,0.2503490069166827,132612.50000000017,5159.027777777808,137771.52777777798,271,6,169.3448275862069,29,0,23,31.860167206041005,0.6637931034482758,42.500000000000014,1030.0000000000014,35.51724137931039,0
276,4,0,0,29,0.0,0.0,1.0,29,650,600,50,0.9230769230769231,7,6,1,414.8336199985317,0.38500615763546797,0.046850816403363416,0.25205983839222834,132719.81336805565,5211.328125000021,137931.14149305568,272,7,170.3448275862069,29,0,18,31.7095464348295,0.6648706896551724,42.39583333333334,1030.4166666666677,35.53160919540233,0
277,4,0,0,29,0.0,0.0,1.0,29,550,400,150,0.7272727272727273,7,4,3,417.17400194413585,0.38454433497536944,0.04711698860177704,0.25396622382505624,132791.37972608046,5279.422260802494,138070.80198688296,273,8,171.3448275862069,29,0,18,31.576915734626947,0.66558908045977,42.3263888888889,1030.6944444444462,35.54118773946366,0
278,4,1,1,29,0.03333333333333333,0.03333333333333333,0.9666666666666667,30,750,500,250,0.6666666666666666,10,5,5,412.0411028654325,0.3906369731800767,0.03405410099431183,0.2528568782332478,133090.55102107208,4967.755484738155,138058.30650581024,274,0,166.6,30,0,18,31.407125179106423,0.6656249999999999,42.03629032258066,1031.8548387096796,34.395161290322655,0
279,4,0,0,29,0.0,0.0,1.0,29,950,700,250,0.7368421052631579,12,7,5,423.25726519869,0.3841851395730706,0.05487898302094396,0.25915347968925584,133006.1945408952,5459.167631172856,138465.36217206807,275,10,173.3448275862069,29,0,19,31.20301490058795,0.6677442528735631,42.118055555555564,1031.5277777777787,35.56992337164754,0
280,4,0,1,28,0.0,0.034482758620689655,0.9655172413793104,29,500,400,100,0.8,6,4,2,422.7074258601475,0.38439039408866993,0.05570720294134057,0.2590652441657738,133042.013888889,5447.569444444463,138489.58333333346,276,11,174.3448275862069,29,0,20,31.18100430802371,0.668103448275862,42.08333333333334,1031.6666666666677,35.5747126436782,0
281,4,0,0,28,0.0,0.0,1.0,28,1150,900,250,0.782608695652174,14,9,5,432.2967278504388,0.37781084656084657,0.06868208414600163,0.2643122583058305,132953.09197053773,5895.0373232923785,138848.1292938301,277,31,181.17857142857142,28,0,21,31.023613820005586,0.6703869047619048,42.16954022988506,1031.3218390804598,36.83292282430214,0
282,4,0,0,28,0.0,0.0,1.0,28,600,500,100,0.8333333333333334,7,5,2,431.9902264038324,0.37728725749559083,0.06939386703281403,0.2643868572338545,132990.1391572533,5890.08806480381,138880.2272220571,278,32,182.17857142857142,28,0,21,30.994045131633932,0.6707589285714286,42.133620689655174,1031.4655172413795,36.83805418719213,0
283,4,0,0,28,0.0,0.0,1.0,28,900,600,300,0.6666666666666666,12,6,6,428.719234578913,0.37714947089947093,0.06922067072443006,0.26316765322613267,133101.3116825208,5812.618493195929,138913.93017571676,279,33,183.17857142857142,28,0,22,30.966014573470712,0.671875,42.025862068965516,1031.896551724138,36.85344827586207,0
284,4,0,0,28,0.0,0.0,1.0,28,850,600,250,0.7058823529411765,11,6,5,426.5921559912279,0.37632275132275134,0.06514651504910351,0.26290662375239837,133249.61396815965,5768.648021535217,139018.26198969487,280,34,184.17857142857142,28,0,22,30.871080341404586,0.6733630952380952,41.88218390804598,1032.4712643678165,36.87397372742202,0
285,4,0,0,28,0.0,0.0,1.0,28,850,600,250,0.7058823529411765,11,6,5,427.2892819979187,0.3754960317460318,0.06682027649769573,0.2649193548387097,133472.22222222228,5806.25000000001,139278.47222222228,281,35,185.17857142857142,28,0,22,30.628360215053764,0.6755952380952381,41.66666666666667,1033.333333333334,36.904761904761926,0
286,4,0,0,28,0.0,0.0,1.0,28,650,500,150,0.7692307692307693,8,5,3,426.66992518168195,0.37466931216931215,0.0691052067198854,0.2650659276128687,133546.4662604043,5796.052153520941,139342.51841392525,282,36,186.17857142857142,28,0,22,30.569456028171622,0.6763392857142857,41.5948275862069,1033.6206896551726,36.91502463054188,0
287,4,0,0,28,0.0,0.0,1.0,28,450,300,150,0.6666666666666666,6,3,3,426.66992518168195,0.37466931216931215,0.0691052067198854,0.2650659276128687,133546.4662604043,5796.052153520941,139342.51841392525,283,37,187.17857142857142,28,0,22,30.569456028171622,0.6763392857142857,41.5948275862069,1033.6206896551726,36.91502463054188,0
288,4,0,0,28,0.0,0.0,1.0,28,650,400,250,0.6153846153846154,9,4,5,426.6544844103062,0.374944885361552,0.0641924084809018,0.2655887257626786,133620.73094200031,5801.976813317487,139422.7077553178,284,38,188.17857142857142,28,0,22,30.49495089864738,0.6770833333333333,41.52298850574713,1033.908045977012,36.92528735632186,0
289,4,0,0,28,0.0,0.0,1.0,28,1050,800,250,0.7619047619047619,13,8,5,427.4579475308642,0.3744488536155203,0.06473214285714257,0.2671612172067902,133769.32223543403,5836.151985070686,139605.47422050472,285,39,189.17857142857142,28,0,18,30.32436342592593,0.6785714285714286,41.37931034482759,1034.4827586206898,36.94581280788178,0
290,4,0,0,28,0.0,0.0,1.0,28,750,600,150,0.8,9,6,3,427.9516450774535,0.3736221340388007,0.06586464077438792,0.2680093693780714,133843.64884727183,5855.7219414718,139699.37078874363,286,40,190.17857142857142,28,0,19,30.23668194020179,0.679315476190476,41.30747126436782,1034.770114942529,36.95607553366175,0
291,4,0,0,28,0.0,0.0,1.0,28,800,600,200,0.75,10,6,4,427.1020849975074,0.37389770723104054,0.06785912588244636,0.26801771954024783,133917.99610252352,5839.331070815182,139757.3271733387,287,41,191.17857142857142,28,0,19,30.18375208217657,0.6800595238095237,41.23563218390805,1035.0574712643684,36.96633825944173,0
292,4,0,0,28,0.0,0.0,1.0,28,1100,900,200,0.8181818181818182,13,9,4,424.61953422082496,0.37290564373897706,0.06724671000475646,0.26754000023284163,134066.75254326867,5785.472403884274,139852.22494715295,288,42,192.17857142857142,28,0,19,30.09821263411025,0.6815476190476191,41.09195402298851,1035.6321839080465,36.98686371100166,0
293,4,0,0,28,0.0,0.0,1.0,28,550,500,50,0.9090909090909091,6,5,1,424.9042006406297,0.37205136684303347,0.07339481347940646,0.2685349860490431,134178.37406278902,5802.590954881757,139980.96501767077,289,43,193.17857142857142,28,0,19,29.978505061711274,0.6826636904761905,40.98419540229885,1036.0632183908046,37.0022577996716,0
294,4,0,0,28,0.0,0.0,1.0,28,550,400,150,0.7272727272727273,7,4,3,424.9042006406297,0.37205136684303347,0.07339481347940646,0.2685349860490431,134178.37406278902,5802.590954881757,139980.96501767077,290,44,194.17857142857142,28,0,19,29.978505061711274,0.6826636904761905,40.98419540229885,1036.0632183908046,37.0022577996716,0
295,4,0,0,28,0.0,0.0,1.0,28,750,400,350,0.5333333333333333,11,4,7,424.4380804997585,0.3712522045855379,0.07264644144322552,0.2690594299407081,134290.0420299908,5799.56153388824,140089.60356387903,291,45,195.17857142857142,28,0,19,29.878246003142046,0.6837797619047619,40.8764367816092,1036.4942528735635,37.017651888341554,0
296,4,0,0,28,0.0,0.0,1.0,28,800,600,200,0.75,10,6,4,424.73247932169215,0.37053571428571425,0.06256184934489162,0.2703455939809499,134439.0049048751,5820.12237415774,140259.12727903284,292,46,196.17857142857142,28,0,20,29.72083679689665,0.6852678571428572,40.73275862068965,1037.068965517241,37.03817733990146,0
297,4,0,0,28,0.0,0.0,1.0,28,1100,800,300,0.7272727272727273,14,8,6,429.35671266931786,0.36959876543209874,0.06109308857854967,0.2744083344157357,134588.05035341525,5957.256572862997,140545.30692627825,293,47,197.17857142857142,28,0,20,29.45109849533832,0.6867559523809523,40.589080459770116,1037.6436781609195,37.058702791461414,0
298,4,0,0,28,0.0,0.0,1.0,28,900,800,100,0.8888888888888888,10,8,2,426.6997523856903,0.36739417989417994,0.0610592700960817,0.27383058709937824,134737.17837561114,5898.464130003979,140635.6425056151,294,48,198.17857142857142,28,0,20,29.370214041885788,0.6882440476190476,40.44540229885058,1038.2183908045984,37.07922824302137,0
299,4,0,0,28,0.0,0.0,1.0,28,650,400,250,0.6153846153846154,9,4,5,425.15184732433045,0.36667768959435626,0.06675558190080988,0.2739614845057852,134886.3889714626,5869.439490025114,140755.82846148772,295,49,199.17857142857142,28,0,20,29.260603964960797,0.6897321428571428,40.30172413793104,1038.7931034482765,37.0997536945813,0
300,4,0,1,27,0.0,0.03571428571428571,0.9642857142857143,28,900,500,400,0.5555555555555556,13,5,8,424.40948529689183,0.3645557760141094,0.05454141573699278,0.27489728076302733,135073.01833548042,5865.254037851788,140938.2723733322,296,50,200.17857142857142,28,0,20,29.09266298087998,0.6915922619047619,40.12212643678162,1039.5114942528749,37.12541050903125,0
301,4,0,0,27,0.0,0.0,1.0,27,500,300,200,0.6,7,3,4,432.8006423160322,0.3598053181386515,0.07455142382823876,0.27957880529998663,134975.6883547691,6283.512923398544,141259.20127816766,297,76,206.74074074074073,27,0,21,28.972295813642653,0.6940586419753085,40.21577380952382,1039.1369047619057,38.48655202821873,0
302,4,0,0,27,0.0,0.0,1.0,27,1050,900,150,0.8571428571428571,12,9,3,433.6218986487561,0.35944919278252613,0.07571780800127281,0.28070889361089546,135053.01616089148,6312.389057185383,141365.40521807686,298,77,207.74074074074073,27,0,21,28.87332975423527,0.6948302469135802,40.14136904761905,1039.434523809524,38.4975749559083,0
303,4,0,0,27,0.0,0.0,1.0,27,900,500,400,0.5555555555555556,13,5,8,434.4962470030239,0.3590930674264008,0.07333184888295108,0.28157613929157044,135091.6883680557,6339.36631944447,141431.05468750017,299,78,208.74074074074073,27,0,21,28.81179024716099,0.695216049382716,40.10416666666668,1039.5833333333346,38.50308641975313,0
304,4,0,0,27,0.0,0.0,1.0,27,600,500,100,0.8333333333333334,7,5,2,436.0819152865793,0.35873694207027546,0.07419065939598224,0.2835140935756188,135207.73820595938,6392.329887684229,141600.0680936436,300,79,209.74074074074073,27,0,21,28.654105260647686,0.6963734567901234,39.99255952380952,1040.0297619047612,38.51962081128745,0
305,4,0,0,27,0.0,0.0,1.0,27,750,500,250,0.6666666666666666,10,5,5,437.22792216962296,0.3588556505223172,0.07180628410957435,0.2845645415238049,135246.43255739793,6426.703337585025,141673.13589498296,301,80,210.74074074074073,27,0,21,28.58547925608012,0.6967592592592593,39.95535714285714,1040.178571428571,38.525132275132265,0
306,4,0,0,27,0.0,0.0,1.0,27,800,500,300,0.625,11,5,6,438.34625416206995,0.3589150047483381,0.07355503651799955,0.2862143188940575,135362.548828125,6467.133246527779,141829.68207465278,302,81,211.74074074074073,27,0,21,28.4398982315649,0.6979166666666667,39.84375,1040.625,38.541666666666664,0
307,4,0,0,27,0.0,0.0,1.0,27,650,400,250,0.6153846153846154,9,4,5,438.28365098934654,0.3583214624881292,0.06878987636671696,0.2867908455257697,135439.98735561926,6472.226429634345,141912.2137852536,303,82,212.74074074074073,27,0,21,28.363861091255668,0.6986882716049383,39.769345238095234,1040.9226190476186,38.552689594356245,0
308,4,0,0,27,0.0,0.0,1.0,27,750,700,50,0.9333333333333333,8,7,1,447.22623727258645,0.3587962962962963,0.07723890171927139,0.2727450151253945,132857.851473923,6483.503401360555,139341.35487528355,304,83,213.74074074074073,27,0,17,30.73518090839106,0.6728395061728394,42.261904761904766,1030.9523809523816,38.183421516754876,4
309,4,0,0,27,0.0,0.0,1.0,27,500,400,100,0.8,6,4,2,446.51458400995705,0.3583214624881292,0.07453376308911008,0.27259026895198174,132896.20812517725,6468.019017502847,139364.2271426801,305,84,214.74074074074073,27,0,18,30.714659402511188,0.6732253086419753,42.22470238095239,1031.1011904761913,38.188932980599674,0
310,4,1,1,27,0.03571428571428571,0.03571428571428571,0.9642857142857143,28,650,400,250,0.6153846153846154,9,4,5,452.7732067301253,0.3657958553791887,0.03921412663060764,0.2784865340025018,133175.45250363325,6459.655337561109,139635.10784119435,306,0,208.03571428571428,28,0,19,30.270392538975493,0.6726190476190477,41.95402298850575,1032.1839080459772,36.863711001642045,4
311,4,0,0,27,0.0,0.0,1.0,27,600,500,100,0.8333333333333334,7,5,2,466.06004445217553,0.35844017094017094,0.05444706209166039,0.28569357101564385,133049.69009088006,7001.8288956207425,140051.5189865008,307,86,216.74074074074073,27,0,21,30.055080773114085,0.6747685185185186,42.075892857142854,1031.6964285714282,38.21097883597882,0
312,4,0,0,27,0.0,0.0,1.0,27,750,600,150,0.8,9,6,3,464.4954773676051,0.35826210826210825,0.04934711207241871,0.285321181181961,133126.46429014305,6967.3281161422765,140093.79240628533,308,87,217.74074074074073,27,0,21,30.017573900504683,0.6755401234567902,42.00148809523809,1031.9940476190468,38.2220017636684,0
313,4,0,0,27,0.0,0.0,1.0,27,850,700,150,0.8235294117647058,10,7,3,463.03872847851187,0.3580246913580247,0.051418382926021966,0.28530752204120013,133241.667109552,6939.210423752812,140180.87753330483,309,88,218.74074074074073,27,0,21,29.93838281925626,0.6766975308641976,41.88988095238094,1032.4404761904752,38.23853615520279,0
314,4,0,0,27,0.0,0.0,1.0,27,400,300,100,0.75,5,3,2,464.93866737536257,0.35760921177587845,0.04961041733376059,0.28707067184920043,133318.49666950095,6996.984835600877,140315.48150510184,310,89,219.74074074074073,27,0,21,29.81147934678193,0.6774691358024691,41.815476190476176,1032.7380952380936,38.249559082892354,0
315,4,0,0,27,0.0,0.0,1.0,27,900,700,200,0.7777777777777778,11,7,4,466.1374598154142,0.35665954415954415,0.05587033302389122,0.2884069738002321,133395.3483737244,7036.1137684240275,140431.46214214843,311,90,220.74074074074073,27,0,21,29.702655334677807,0.6782407407407407,41.74107142857142,1033.0357142857138,38.26058201058199,0
316,4,0,0,27,0.0,0.0,1.0,27,900,500,400,0.5555555555555556,13,5,8,468.0614197185164,0.3565408357075024,0.05553955913875308,0.29080095003263107,133549.11821499432,7101.837974773243,140650.95618976757,312,91,221.74074074074073,27,0,22,29.49719262885114,0.6797839506172839,41.592261904761905,1033.6309523809523,38.282627865961196,0
317,4,1,1,27,0.03571428571428571,0.03571428571428571,0.9642857142857143,28,650,500,150,0.7692307692307693,8,5,3,455.7686434368416,0.36257164902998235,0.03869006288809107,0.28514248491648103,133806.48296092617,6596.959844431236,140403.4428053574,313,0,214.78571428571428,28,0,20,29.55463361570153,0.6789434523809523,41.3433908045977,1034.6264367816093,36.95094417077176,0
318,4,0,0,27,0.0,0.0,1.0,27,800,400,400,0.5,12,4,8,468.8146576264171,0.3563627730294397,0.053418598454569866,0.29248311225346474,133702.97663336163,7136.38304280045,140839.35967616207,314,93,223.74074074074073,27,0,20,29.321942446043177,0.6813271604938271,41.44345238095238,1034.2261904761901,38.30467372134038,0
319,4,1,0,28,0.03571428571428571,0.0,1.0,28,950,700,250,0.7368421052631579,12,7,5,455.37318806629435,0.3618000440917108,0.04383139408115122,0.2866265996850466,134029.55569180215,6606.693214096981,140636.24890589912,315,0,216.71428571428572,28,0,21,29.339531011516577,0.6811755952380952,41.127873563218394,1035.4885057471267,36.98173234811167,0
320,4,0,0,28,0.0,0.0,1.0,28,450,300,150,0.6666666666666666,6,3,3,454.40361923673413,0.3623787477954145,0.04569327731092421,0.28630605659601227,134066.75254326855,6584.083514995369,140650.83605826393,316,1,217.71428571428572,28,0,21,29.32707870884203,0.6815476190476191,41.0919540229885,1035.6321839080456,36.986863711001625,0
321,4,0,0,28,0.0,0.0,1.0,28,750,600,150,0.8,9,6,3,454.39397636479623,0.3627369929453263,0.04353189465549012,0.28659021658913525,134103.95455558857,6587.2058313515645,140691.16038694014,317,2,218.71428571428572,28,0,21,29.28977666805382,0.6819196428571428,41.05603448275862,1035.7758620689654,36.99199507389162,0
322,4,0,0,28,0.0,0.0,1.0,28,1100,900,200,0.8181818181818182,13,9,4,459.0893304637412,0.36317791005291006,0.046379552791586676,0.29072970506013734,134252.8142134033,6726.806918020867,140979.62113142415,318,3,219.71428571428572,28,0,21,29.017919035075558,0.6834077380952381,40.91235632183908,1036.3505747126433,37.01252052545154,0
323,4,0,0,28,0.0,0.0,1.0,28,300,200,100,0.6666666666666666,4,2,2,459.3438704536641,0.36315035273368607,0.043645292882886544,0.29118687886227856,134290.0420299906,6737.061533888209,141027.10356387883,319,4,220.71428571428572,28,0,21,28.973754736161165,0.6837797619047619,40.876436781609186,1036.4942528735621,37.017651888341504,0
324,4,0,0,28,0.0,0.0,1.0,28,1100,900,200,0.8181818181818182,13,9,4,460.2329500458399,0.3629574514991181,0.04493119493119502,0.29204755801061866,134327.2750074316,6764.367609657814,141091.6426170894,320,5,221.71428571428572,28,0,21,28.913143913143916,0.6841517857142858,40.84051724137931,1036.6379310344826,37.02278325123152,0
325,4,0,0,28,0.0,0.0,1.0,28,750,500,250,0.6666666666666666,10,5,5,460.3603538049058,0.3627369929453263,0.04692788851719154,0.2927242884061677,134401.75644487375,6774.648029792564,141176.4044746663,321,6,222.71428571428572,28,0,21,28.834695857004295,0.6848958333333334,40.768678160919535,1036.9252873563212,37.03304597701147,0
326,4,0,0,28,0.0,0.0,1.0,28,1000,800,200,0.8,12,8,4,433.1038003039948,0.3627369929453263,0.06731764900799408,0.25622212817298057,131709.7262081915,5808.879165208974,137518.6053734005,322,7,223.71428571428572,27,1,19,32.26357881511549,0.6612654320987654,43.37797619047618,1026.4880952380945,38.01807760141091,8
327,4,0,0,28,0.0,0.0,1.0,28,750,600,150,0.8,9,6,3,438.6968047319804,0.3627369929453263,0.08054288225691697,0.24188565340068646,128974.55401431405,5716.14494756236,134690.69896187642,323,8,224.71428571428572,27,1,19,34.91612950483446,0.6334876543209875,46.05654761904762,1015.7738095238095,37.62125220458554,6
328,4,1,1,28,0.034482758620689655,0.034482758620689655,0.9655172413793104,29,600,400,200,0.6666666666666666,8,4,4,424.8558454749026,0.36832922824302133,0.06316722944165898,0.2358199857588931,129237.90966854939,5181.496275928136,134419.40594447753,324,0,217.93103448275863,28,1,19,34.99746832461967,0.6328125,45.79741379310345,1016.8103448275866,36.31465517241381,0
329,4,4,2,30,0.125,0.0625,0.9375,32,350,200,150,0.5714285714285714,5,2,3,389.5242986584866,0.38602570564516125,0.05728369065849925,0.22118205828173215,130129.69970703137,3737.736002604181,133867.43570963555,325,0,198.375,31,1,19,34.9859622256253,0.6330645161290323,44.92187500000001,1020.3125000000009,32.91330645161293,0
330,4,1,0,31,0.03225806451612903,0.0,1.0,31,650,500,150,0.7692307692307693,8,5,3,399.0591600833909,0.38181003584229395,0.08126992222363927,0.22637212444192367,130091.1322840792,4182.8115967163985,134273.9438807956,326,0,205.74193548387098,30,1,20,34.782059727711896,0.6354166666666665,44.95967741935485,1020.1612903225815,34.00537634408605,0
331,4,1,1,31,0.03125,0.03125,0.96875,32,500,400,100,0.8,6,4,2,389.01367553689334,0.3880208333333333,0.06797532517215021,0.2220265825007508,130329.0557861328,3739.957004123265,134069.01279025606,327,0,200.28125,31,1,20,34.79607668111876,0.6350806451612903,44.7265625,1021.0937499999999,32.93850806451613,0
332,4,2,0,33,0.06060606060606061,0.0,1.0,33,800,600,200,0.75,10,6,4,380.3318964369433,0.3897174873737374,0.08411690342077893,0.21978951675692687,130810.95838434853,3350.315975410672,134161.2743597592,328,0,195.15151515151516,32,1,20,34.528254340492055,0.6373697916666666,44.255050505050505,1022.979797979798,31.96811868686869,0
333,4,0,0,33,0.0,0.0,1.0,33,350,100,250,0.2857142857142857,6,1,5,383.76616768611615,0.3895596590909091,0.08085671349994872,0.2148469892948957,129575.43372741248,3345.333525567082,132920.76725297957,329,1,196.15151515151516,33,0,17,35.6975204622051,0.6224747474747474,45.4656862745098,1018.1372549019604,30.852644087938195,2
334,4,1,0,34,0.029411764705882353,0.0,1.0,34,1200,900,300,0.75,15,9,6,373.2311263862709,0.39427361853832443,0.08700608424551226,0.21116894508750295,129989.29280045343,2903.2100340135935,132892.502834467,330,0,191.35294117647058,34,0,18,35.544351700521446,0.6243872549019608,45.0595238095238,1019.761904761904,29.99299719887953,0
335,4,0,0,34,0.0,0.0,1.0,34,900,700,200,0.7777777777777778,11,7,4,374.16576275530724,0.3942179144385027,0.09257861548912105,0.21285488282025525,130201.83000283434,2943.413407029462,133145.2434098638,331,1,192.35294117647058,34,0,18,35.30439558303198,0.6265318627450981,44.85119047619047,1020.595238095237,30.01750700280109,0
336,4,0,0,34,0.0,0.0,1.0,34,950,600,350,0.631578947368421,13,6,7,374.9615077590051,0.39288101604278075,0.09660638913592834,0.2143298494968139,130387.7189662629,2978.089311705066,133365.80827796797,332,2,193.35294117647058,33,1,21,35.09519238460924,0.6306818181818183,44.66911764705882,1021.3235294117641,30.94919786096255,0
337,4,0,0,34,0.0,0.0,1.0,34,850,600,250,0.7058823529411765,11,6,5,376.4142020502102,0.39243538324420674,0.09897281052022677,0.2158556820285179,130512.91120001912,3025.3826653210194,133538.29386534015,333,3,194.35294117647058,33,1,18,34.93093867434238,0.6319444444444446,44.546568627450974,1021.8137254901952,30.964052287581673,0
338,4,0,0,34,0.0,0.0,1.0,34,800,500,300,0.625,11,5,6,374.38062736499444,0.39221256684491984,0.09366494140211867,0.215385047826123,130638.16350682426,2981.679522299114,133619.84302912338,334,4,195.35294117647058,33,1,18,34.85575001997923,0.6332070707070707,44.424019607843135,1022.3039215686272,30.978906714200825,0
339,4,0,1,33,0.0,0.029411764705882353,0.9705882352941176,34,950,700,250,0.7368421052631579,12,7,5,376.653320462198,0.3922311348781937,0.0948401649455477,0.21721990043241474,130732.14215986631,3048.139087129945,133780.28124699625,335,5,196.35294117647058,33,1,18,34.702291791491916,0.6341540404040404,44.33210784313725,1022.6715686274503,30.99004753416516,0
340,4,1,2,32,0.029411764705882353,0.058823529411764705,0.9411764705882353,34,1150,900,250,0.782608695652174,14,9,5,371.83817679691225,0.39579619726678555,0.06594781938962235,0.20843406057148,129625.34722222216,2839.93055555555,132465.27777777772,336,0,197.02941176470588,34,0,17,35.950286415711965,0.6207107843137255,45.416666666666664,1018.3333333333328,29.950980392156847,8
341,4,0,0,32,0.0,0.0,1.0,32,1100,600,500,0.5454545454545454,16,6,10,394.81852331959556,0.39058299731182794,0.06539884357125114,0.21717719319672954,128880.67065860619,3776.8952147739965,132657.5658733802,337,7,202.5625,32,0,20,36.12648180386306,0.6178385416666667,46.148989898989896,1015.4040404040398,31.731376262626245,2
342,4,0,0,32,0.0,0.0,1.0,32,1000,800,200,0.8,12,8,4,392.53112043445117,0.3891969086021505,0.06740028578528845,0.21697049843794375,129073.05377002341,3733.038082848686,132806.0918528721,338,8,203.5625,32,0,20,35.98771951623593,0.6197916666666667,45.95959595959596,1016.1616161616157,31.75505050505049,0
343,4,2,1,33,0.058823529411764705,0.029411764705882353,0.9705882352941176,34,400,100,300,0.25,7,1,6,375.92627452823115,0.393270944741533,0.07596683128387305,0.21146488812095485,129762.65889321409,2956.302355123882,132718.96124833796,339,0,192.52941176470588,33,1,21,35.70633870579746,0.6243686868686869,45.28186274509804,1018.8725490196074,30.87492572786689,0
344,4,0,0,33,0.0,0.0,1.0,33,450,200,250,0.4444444444444444,7,2,5,381.11261247929457,0.38999368686868685,0.09301591951238808,0.2142994892052563,129747.5245670085,3289.6836100908145,133037.20817709932,340,1,198.96969696969697,32,1,21,35.58965381914323,0.6266276041666666,45.29671717171718,1018.8131313131315,31.83791035353536,0
345,4,0,0,33,0.0,0.0,1.0,33,900,800,100,0.8888888888888888,10,8,2,378.0166435676533,0.39034880050505055,0.09437787188034985,0.2130831247819901,129844.02101826348,3216.640202530364,133060.66122079385,341,2,199.96969696969697,32,1,21,35.570232490915124,0.6276041666666666,45.20202020202021,1019.1919191919195,31.849747474747485,0
346,4,2,0,35,0.05714285714285714,0.0,1.0,35,550,200,350,0.36363636363636365,9,2,7,360.1189858025871,0.3975490196078431,0.10421135592639552,0.20651114880481236,130512.91120001923,2400.7090031947164,132913.62020321394,342,0,189.4857142857143,33,2,18,35.347205564883666,0.6319444444444444,44.54656862745098,1021.8137254901961,30.9640522875817,0
347,4,0,0,35,0.0,0.0,1.0,35,950,600,350,0.631578947368421,13,6,7,355.3466444570435,0.39796918767507,0.09829290206648666,0.20421728844097542,130597.00255102033,2281.4413265305984,132878.44387755092,343,1,190.4857142857143,34,1,18,35.38390985324947,0.630514705882353,44.46428571428571,1022.1428571428565,30.063025210084017,0
348,4,0,0,35,0.0,0.0,1.0,35,1050,700,350,0.6666666666666666,14,7,7,351.6215251781602,0.3971988795518207,0.10142474771824306,0.20319325930436655,130810.03578514732,2199.1248582766398,133009.16064342397,344,2,191.4857142857143,34,1,20,35.26344117304784,0.6326593137254901,44.25595238095238,1022.9761904761899,30.087535014005585,0
349,4,0,0,35,0.0,0.0,1.0,35,550,300,250,0.5454545454545454,8,3,5,352.0824809532171,0.3970238095238095,0.10002493143854418,0.20378107230928624,130870.93431122448,2215.4726473922847,133086.40695861678,345,3,192.4857142857143,34,1,21,35.19003296490206,0.6332720588235294,44.19642857142857,1023.2142857142856,30.094537815126046,0
350,4,0,0,35,0.0,0.0,1.0,35,950,600,350,0.631578947368421,13,6,7,353.39372633856135,0.3963235294117647,0.10152823920265774,0.2053504085480829,131023.24263038544,2260.558390022667,133283.8010204081,346,4,193.4857142857143,34,1,21,35.00242248062014,0.6348039215686274,44.047619047619044,1023.8095238095234,30.11204481792716,0
351,4,0,0,35,0.0,0.0,1.0,35,1000,700,300,0.7,13,7,6,356.4438469181837,0.39569327731092435,0.10628372208848691,0.20794571543938756,131175.6395266438,2351.3499149659597,133526.98944160974,347,5,194.4857142857143,34,1,21,34.77024017044352,0.6363357843137256,43.89880952380951,1024.4047619047603,30.129551820728246,0
352,4,1,0,36,0.027777777777777776,0.0,1.0,36,750,500,250,0.6666666666666666,10,5,5,338.01830970548576,0.39961970899470894,0.061278646712426665,0.20283380947688356,132249.14969403684,1740.5268079131947,133989.67650195005,348,0,190.05555555555554,35,1,21,34.16097014365552,0.6449404761904765,42.85300925925924,1028.58796296296,29.38822751322743,4
353,4,0,0,36,0.0,0.0,1.0,36,600,300,300,0.5,9,3,6,338.84510218000025,0.39894179894179893,0.0666854143232094,0.2038114315548172,132338.45191400868,1768.447252229049,134106.89916623774,349,1,191.05555555555554,35,1,21,34.0499625046869,0.6458333333333335,42.76620370370369,1028.9351851851834,29.398148148148096,0
354,4,1,1,36,0.02702702702702703,0.02702702702702703,0.972972972972973,37,950,400,550,0.42105263157894735,15,4,11,331.7672077557695,0.4021521521521521,0.06511781845260955,0.200949859743991,132600.90115453277,1398.5261443876163,133999.42729892037,350,0,186.86486486486487,36,1,22,33.968629273270636,0.6464120370370372,42.511261261261254,1029.9549549549538,28.609859859859828,0
355,4,0,0,36,0.0,0.0,1.0,36,550,300,250,0.5454545454545454,8,3,5,340.1425853621082,0.40148809523809526,0.05972456436200124,0.20540178525430755,132487.35592689025,1812.9183545524422,134300.2742814427,351,1,184.5,35,1,22,33.866989881956144,0.6473214285714286,42.621527777777764,1029.5138888888873,29.414682539682495,0
356,4,1,1,36,0.02702702702702703,0.02702702702702703,0.972972972972973,37,900,600,300,0.6666666666666666,12,6,6,332.22873182238936,0.40362237237237236,0.05288435976960537,0.2018521179398978,132716.9124360846,1418.474302004686,134135.38673808926,352,0,180.48648648648648,36,1,17,33.84039162112931,0.6475694444444446,42.39864864864864,1030.4054054054043,28.62237237237234,0
357,4,0,0,36,0.0,0.0,1.0,36,700,500,200,0.7142857142857143,9,5,4,343.43217711552165,0.4010251322751323,0.06130838671011696,0.20804649041191461,132606.53941883138,1908.2705064728955,134514.8099253043,353,3,186.5,35,1,22,33.66260722178521,0.6485119047619048,42.50578703703703,1029.9768518518513,29.427910052910036,0
358,4,1,1,36,0.02702702702702703,0.02702702702702703,0.972972972972973,37,950,600,350,0.631578947368421,13,6,7,338.2823911052736,0.40509259259259256,0.0683067607404324,0.20696916634156334,132978.12328798402,1596.8315021102255,134574.95479009426,354,0,182.43243243243242,36,1,19,33.422498817192555,0.6501736111111112,42.145270270270274,1031.4189189189196,28.650525525525545,0
359,4,0,0,36,0.0,0.0,1.0,36,950,700,250,0.7368421052631579,12,7,5,345.6248983971683,0.401223544973545,0.07188166610531055,0.21071053867375605,132845.0671537422,1982.9125675154205,134827.9797212576,355,1,188.38888888888889,35,1,19,33.366663859885485,0.6508928571428572,42.27430555555555,1030.902777777777,29.454365079365054,0
360,4,0,1,35,0.0,0.027777777777777776,0.9722222222222222,36,1150,800,350,0.6956521739130435,15,8,7,344.9581603414361,0.4015707671957672,0.0709848825026198,0.21047173235078817,132874.89819101486,1967.2560871056016,134842.15427812046,356,2,189.38888888888889,35,1,19,33.35391408471787,0.6511904761904763,42.24537037037036,1031.0185185185167,29.457671957671906,0
361,4,0,0,35,0.0,0.0,1.0,35,1200,900,300,0.75,15,9,6,352.02855252097163,0.39670868347338933,0.06666336780642279,0.2148639389277051,132888.53635204077,2356.111819727884,135244.64817176864,357,3,195.4,34,1,19,33.15797829349959,0.6534926470588236,42.232142857142854,1031.0714285714282,30.32563025210083,0
362,4,0,0,35,0.0,0.0,1.0,35,1300,1100,200,0.8461538461538461,15,11,4,354.8542947415314,0.3961484593837535,0.06690297584700367,0.2173012342003798,133011.31129535165,2439.927012471674,135451.23830782334,358,4,196.4,34,1,20,32.96186766685901,0.6547181372549018,42.11309523809525,1031.5476190476204,30.339635854341775,0
363,4,0,0,35,0.0,0.0,1.0,35,850,500,350,0.5882352941176471,12,5,7,357.68466844084253,0.3956582633053221,0.06840925571890044,0.21957582904003,133103.42970521544,2521.8112244897975,135625.24092970524,359,5,197.4,34,1,20,32.796396708198735,0.6556372549019608,42.023809523809526,1031.9047619047622,30.350140056022415,0
364,4,0,0,35,0.0,0.0,1.0,35,950,500,450,0.5263157894736842,14,5,9,355.01978203591966,0.3950280112044818,0.06449657353716365,0.21865991120848713,133226.30385487544,2459.5946712018285,135685.89852607728,360,6,198.4,34,1,20,32.741870387453865,0.6568627450980391,41.90476190476191,1032.3809523809537,30.364145658263343,0
365,4,0,0,35,0.0,0.0,1.0,35,800,500,300,0.625,11,5,6,354.2829716087595,0.3947128851540616,0.06127342797852431,0.21856689158850495,133287.7621882087,2444.3168934240484,135732.07908163275,361,7,199.4,34,1,20,32.69925447698102,0.6574754901960783,41.8452380952381,1032.6190476190482,30.371148459383768,0
366,4,1,0,36,0.027777777777777776,0.0,1.0,36,650,300,350,0.46153846153846156,10,3,7,355.17543820559195,0.39573412698412697,0.09206011784888446,0.22199706760011076,133771.386584791,2302.4621699245704,136073.84875471558,362,0,194.83333333333334,35,1,18,32.19167226075929,0.6601190476190475,41.377314814814824,1034.4907407407422,29.55687830687835,0
367,4,0,0,36,0.0,0.0,1.0,36,1200,900,300,0.75,15,9,6,354.23949676388895,0.3947255291005291,0.09138612384893596,0.22195202106278442,133861.20119866694,2283.7849097651033,136144.98610843203,363,1,195.83333333333334,35,1,19,32.12599727845506,0.6610119047619047,41.29050925925927,1034.8379629629637,29.566798941798965,0
368,4,0,0,36,0.0,0.0,1.0,36,1350,1000,350,0.7407407407407407,17,10,7,358.04708045971256,0.3948578042328042,0.09384199739146659,0.22506894832832972,133981.00090288516,2394.301242069644,136375.3021449548,364,2,196.83333333333334,35,1,21,31.90760667039315,0.6622023809523808,41.17476851851853,1035.3009259259277,29.580026455026506,0
369,4,0,0,36,0.0,0.0,1.0,36,950,500,450,0.5263157894736842,14,5,9,363.7233755619174,0.39464285714285713,0.1348641489539535,0.2184109581814128,132275.51197562364,2423.5481256867524,134699.0601013104,365,3,197.83333333333334,34,2,18,33.47341164217105,0.6473651960784313,42.827380952380956,1028.6904761904766,30.25560224089637,3
370,4,0,0,36,0.0,0.0,1.0,36,800,700,100,0.875,9,7,2,363.65095897767867,0.3945271164021164,0.1382204740603632,0.2188996441088478,132367.37528344675,2427.1045918367386,134794.4798752835,366,4,198.83333333333334,34,2,18,33.38274140058615,0.6482843137254901,42.73809523809524,1029.0476190476193,30.266106442577037,0
371,4,1,0,37,0.02702702702702703,0.0,1.0,37,750,500,250,0.6666666666666666,10,5,5,361.4810518227194,0.3995245245245245,0.05713746342384263,0.2083974654467892,130718.71456916102,2050.4712301587306,132769.18579931976,367,0,194.43243243243242,34,3,15,35.10380287155607,0.6317401960784313,44.345238095238095,1022.6190476190478,30.077030812324935,5
372,4,0,0,37,0.0,0.0,1.0,37,1050,700,350,0.6666666666666666,14,7,7,382.33070656230655,0.39958708708708707,0.03756676300756889,0.2043620802396071,127734.70320001696,2367.379865397783,130102.08306541474,368,1,195.43243243243242,35,2,15,37.61783451644912,0.599404761904762,47.28009259259258,1010.8796296296281,28.882275132275087,7
373,4,2,1,38,0.05128205128205128,0.02564102564102564,0.9743589743589743,39,650,500,150,0.7692307692307693,8,5,3,366.98335280868434,0.40826023391812866,0.040730188878336904,0.19817101051668942,128144.5312499999,1606.038344478724,129750.56959447863,369,0,186.35897435897436,36,3,16,37.58573388203017,0.6015625000000002,46.87499999999999,1012.4999999999992,28.12499999999998,0
374,4,2,0,40,0.05,0.0,1.0,40,850,600,250,0.7058823529411765,11,6,5,358.1735390077994,0.4127003205128205,0.055083234244946766,0.19571549966693147,128616.79945992978,1213.4268476838797,129830.22630761366,370,0,182.65,37,3,17,37.32603232083018,0.6044481981981983,46.408991228070164,1014.3640350877178,27.41524419155994,0
375,4,1,0,41,0.024390243902439025,0.0,1.0,41,900,600,300,0.6666666666666666,12,6,6,353.8376311621802,0.41552337398373984,0.06497895150216038,0.19504074287520695,128963.2175021699,926.4078776041426,129889.62537977404,371,0,179.17073170731706,39,2,18,37.08262827744162,0.6044337606837609,46.06770833333332,1015.7291666666647,26.044337606837555,0
376,4,1,1,41,0.023809523809523808,0.023809523809523808,0.9761904761904762,42,1050,900,150,0.8571428571428571,12,9,3,342.80343348671533,0.4185540069686411,0.07055549865137078,0.19048320552821849,129280.82817925338,463.8020833333233,129744.63026258671,372,0,175.88095238095238,39,3,18,37.03960958038855,0.6076388888888891,45.75520833333333,1016.9791666666658,26.076388888888868,0
377,4,1,1,41,0.023809523809523808,0.023809523809523808,0.9761904761904762,42,1250,900,350,0.72,16,9,7,350.8781136118643,0.41636420828494,0.08486483325292005,0.1960223012064907,129492.78564453113,687.2368706597077,130180.02251519084,373,0,176.85714285714286,39,3,17,36.61867174973559,0.6097756410256412,45.54687499999999,1017.8124999999991,26.097756410256387,0
378,4,0,0,41,0.0,0.0,1.0,41,1000,600,400,0.6,14,6,8,352.75264773527726,0.41552337398373984,0.09256015212085833,0.1974687502270675,129572.314453125,941.3953993055554,130513.70985243056,374,1,181.34146341463415,39,2,17,36.490092763113026,0.6105769230769231,45.46875,1018.125,26.10576923076923,0
379,4,0,0,41,0.0,0.0,1.0,41,850,600,250,0.7058823529411765,11,6,5,352.1160141728497,0.4157520325203252,0.0966929243847563,0.1976458316063216,129678.3908420138,932.3676215277677,130610.75846354157,375,2,182.34146341463415,39,2,18,36.39846253494239,0.6116452991452992,45.36458333333333,1018.541666666666,26.116452991452974,0
380,4,0,0,41,0.0,0.0,1.0,41,900,200,700,0.2222222222222222,16,2,14,351.8000137998136,0.4151422764227642,0.09076332660883102,0.19786980649660577,129757.97661675337,929.7715928819346,130687.7482096353,376,3,183.34146341463415,39,2,18,36.32563558600008,0.6124465811965812,45.28645833333333,1018.8541666666657,26.124465811965788,0
381,4,0,2,39,0.0,0.04878048780487805,0.9512195121951219,41,1700,1200,500,0.7058823529411765,22,12,10,353.07866598829037,0.41420223577235776,0.0900225355483315,0.1989931836422487,129837.58680555574,968.5763888889077,130806.16319444464,377,4,184.34146341463415,39,2,20,36.21218315617335,0.6132478632478633,45.20833333333334,1019.1666666666681,26.13247863247867,0
382,4,2,1,40,0.04878048780487805,0.024390243902439025,0.975609756097561,41,800,300,500,0.375,13,3,10,345.9771669401391,0.4160569105691057,0.09594242956212096,0.19645486087992253,130129.69970703125,804.3809678819445,130934.08067491319,378,0,183.21951219512195,39,2,21,36.09675429640972,0.6161858974358975,44.921875,1020.3125,26.161858974358974,0
383,4,1,1,40,0.024390243902439025,0.024390243902439025,0.975609756097561,41,1150,800,350,0.6956521739130435,15,8,7,350.88671012387647,0.4164380081300813,0.11293060095549401,0.20021182871774149,130318.55955678683,945.5457598732448,131264.10531666008,379,0,184.1951219512195,37,4,22,35.779997136311586,0.6216216216216215,44.736842105263165,1021.0526315789484,27.596017069701308,0
384,4,0,0,40,0.0,0.0,1.0,40,1300,1000,300,0.7692307692307693,16,10,6,348.07230965480517,0.4169337606837607,0.10707675415664553,0.1994377170298925,130480.80490037637,1083.3510254584155,131564.15592583478,380,1,183.525,38,2,22,35.68745860782879,0.6214364035087718,44.57799145299146,1021.6880341880354,26.886527215474615,0
385,4,0,0,40,0.0,0.0,1.0,40,1050,600,450,0.5714285714285714,15,6,9,349.2442962545586,0.4165865384615384,0.10912441191845224,0.20039122337581622,130535.38795976707,1117.7479408649376,131653.135900632,381,2,184.525,38,2,15,35.60223906603939,0.6219846491228069,44.524572649572654,1021.9017094017103,26.89215024741343,0
386,4,0,0,40,0.0,0.0,1.0,40,1350,1100,250,0.8148148148148148,16,11,5,348.0311710773282,0.4160924145299145,0.11413793103448322,0.2004006201690755,130671.89554569374,1095.5785667324299,131767.47411242616,382,3,185.525,38,2,17,35.4950365726228,0.6233552631578946,44.39102564102565,1022.4358974358984,26.906207827260484,0
387,4,0,1,39,0.0,0.025,0.975,40,850,700,150,0.8235294117647058,10,7,3,348.2612602171942,0.41589209401709404,0.10550130548302894,0.20124330516473363,130808.47447083434,1111.1048332602918,131919.57930409463,383,4,186.525,38,2,17,35.350957354221066,0.6247258771929824,44.25747863247864,1022.9700854700861,26.92026540710753,0
388,4,0,1,38,0.0,0.02564102564102564,0.9743589743589743,39,1450,1000,450,0.6896551724137931,19,10,9,352.0632119422028,0.41483918128654973,0.10913449511069362,0.20307319590506656,130738.73842191827,1405.6600348184068,132144.39845673667,384,5,192.05128205128204,37,2,18,35.324304885458,0.6258445945945945,44.32565789473684,1022.6973684210526,27.640469416785205,0
389,4,0,0,38,0.0,0.0,1.0,38,900,700,200,0.7777777777777778,11,7,4,355.49733338431105,0.4127400426742532,0.07028320186214909,0.19820193792796537,129413.28125000013,1603.8663338719753,131017.14758387211,385,6,197.94736842105263,34,4,20,36.58203658203658,0.6185661764705882,45.62500000000001,1017.500000000001,29.926470588235325,5
390,4,0,0,38,0.0,0.0,1.0,38,1050,600,450,0.5714285714285714,15,6,9,354.8005272015296,0.41241405879563775,0.07342145261434885,0.1987301184777132,129595.04145408163,1596.0778061224441,131191.11926020408,386,7,198.94736842105263,34,4,18,36.41485443703963,0.6204044117647058,45.44642857142857,1018.2142857142856,29.947478991596633,0
391,4,1,1,38,0.02564102564102564,0.02564102564102564,0.9743589743589743,39,1000,600,400,0.6,14,6,8,353.17036848118215,0.4145017993702204,0.03607014746911141,0.19474823176248046,128978.53185595572,1310.2791243459562,130288.81098030167,387,0,194.82051282051282,37,2,17,37.08396301093839,0.6081081081081081,46.05263157894737,1015.7894736842109,27.453769559032725,6
392,4,1,2,37,0.02564102564102564,0.05128205128205128,0.9487179487179487,39,950,700,250,0.7368421052631579,12,7,5,354.0896035952223,0.4152890238416554,0.07047270626744973,0.19709268689033604,129348.51794249385,1360.5778225416507,130709.09576503551,388,0,195.35897435897436,35,4,19,36.68375715856943,0.6157738095238096,45.6886574074074,1017.2453703703692,29.064153439153404,0
393,4,0,0,37,0.0,0.0,1.0,37,750,600,150,0.8,9,6,3,360.8346543141565,0.4093781281281281,0.09003738116773441,0.20102300885063734,129383.0002834465,1937.174036281151,131320.17431972764,389,1,205.16216216216216,34,3,19,36.47710429830718,0.6182598039215688,45.65476190476189,1017.3809523809507,29.922969187675022,0
394,4,1,2,36,0.02631578947368421,0.05263157894736842,0.9473684210526316,38,950,700,250,0.7368421052631579,12,7,5,353.7429690407046,0.4103544333807492,0.08924758196206528,0.1983801392344905,129643.02722318651,1572.0618730709614,131215.08909625746,390,0,200.73684210526315,35,3,16,36.39298499829526,0.6187500000000001,45.39930555555554,1018.402777777776,29.09722222222217,0
395,4,1,2,35,0.02702702702702703,0.05405405405405406,0.9459459459459459,37,1050,700,350,0.6666666666666666,14,7,7,352.29783917176223,0.4093781281281281,0.0982990712720444,0.19861298154587287,129849.38298396765,1749.1314086076673,131598.5143925753,391,0,205.45945945945945,35,2,18,36.22009614656673,0.6208333333333333,45.19675925925925,1019.2129629629619,29.120370370370342,0
396,4,2,2,35,0.05405405405405406,0.05405405405405406,0.9459459459459459,37,1000,600,400,0.6,14,6,8,355.3958595742399,0.4089089089089089,0.10276587719002328,0.20142146047767046,130055.90284475726,1844.2658768432618,131900.16872160052,392,0,205.72972972972974,35,2,18,35.931412874919616,0.6229166666666668,44.994212962962955,1020.0231481481472,29.143518518518494,0
397,4,0,0,35,0.0,0.0,1.0,35,750,400,350,0.5333333333333333,11,4,7,371.17799034426287,0.4007002801120448,0.12541476316422218,0.20946122955790894,129887.55076172622,2642.2800124951887,132529.8307742214,393,2,218.4857142857143,33,2,18,35.70018834655767,0.6256313131313131,45.15931372549019,1019.3627450980389,30.889780154486026,0
398,4,0,0,35,0.0,0.0,1.0,35,900,600,300,0.6666666666666666,12,6,6,375.95816684158393,0.40014005602240893,0.13080646822535824,0.21283835812623533,130012.5027032871,2775.85243656285,132788.35513984994,394,3,219.4857142857143,33,2,18,35.451213650564775,0.6268939393939394,45.03676470588235,1019.8529411764698,30.904634581105146,0
399,4,3,3,35,0.07894736842105263,0.07894736842105263,0.9210526315789473,38,550,300,250,0.5454545454545454,8,3,5,349.79819598479645,0.40922830725462306,0.11832105321128639,0.2013835016706381,130665.25298524856,1541.2939544273836,132206.54693967596,395,0,203.07894736842104,36,2,15,35.456593971435936,0.627025462962963,44.397522522522515,1022.4099099099083,28.40027527527523,0
400,4,1,0,36,0.027777777777777776,0.0,1.0,36,800,500,300,0.625,11,5,6,367.62868056574365,0.40740740740740744,0.11454286454286433,0.2102836052836051,130414.54081632636,2388.8251133786625,132803.36592970503,396,0,215.33333333333334,34,2,19,35.25519619269618,0.6286764705882355,44.64285714285713,1021.4285714285701,30.04201680672265,0
401,4,1,3,34,0.02702702702702703,0.08108108108108109,0.9189189189189189,37,950,700,250,0.7368421052631579,12,7,5,359.13132088846913,0.4122872872872873,0.10685957696827275,0.20650050951086918,130617.28395061691,1981.75154320983,132599.03549382676,397,0,210.48648648648648,35,2,15,35.26664402173911,0.6285714285714288,44.44444444444442,1022.2222222222192,29.20634920634912,0
402,4,2,1,35,0.05555555555555555,0.027777777777777776,0.9722222222222222,36,1050,400,650,0.38095238095238093,17,4,13,351.8093128140721,0.40568783068783065,0.09600743681855484,0.19969086236033717,130114.93866008613,1955.1294313699739,132070.0680914561,398,0,215.33333333333334,35,1,16,35.96296558895821,0.6235119047619049,44.93634259259257,1020.2546296296259,29.15013227513217,2
403,4,1,0,36,0.027777777777777776,0.0,1.0,36,1050,700,350,0.6666666666666666,14,7,7,350.5041104573079,0.40600198412698413,0.09672833028901562,0.200018213931625,130323.35778061199,1935.8582426347245,132259.2160232467,399,0,216.30555555555554,34,2,17,35.78489953752282,0.6277573529411766,44.73214285714284,1021.0714285714264,30.031512605041954,0
404,4,0,0,36,0.0,0.0,1.0,36,800,600,200,0.75,10,6,4,349.72274432416793,0.40598544973544975,0.0935008284146217,0.20066978858814544,130536.16780045332,1930.2933673469124,132466.46116780024,400,1,217.30555555555554,34,2,14,35.589226079527805,0.6299019607843138,44.52380952380951,1021.9047619047603,30.05602240896354,0
405,4,0,0,36,0.0,0.0,1.0,36,950,800,150,0.8421052631578947,11,8,3,352.68791404639296,0.4058531746031746,0.09351787147035218,0.20268931927726422,130597.00255102031,2011.996882086155,132608.99943310648,401,2,218.30555555555554,34,2,14,35.45184991070735,0.630514705882353,44.46428571428571,1022.1428571428564,30.063025210084014,0
406,4,0,2,34,0.0,0.05555555555555555,0.9444444444444444,36,650,400,250,0.6153846153846154,9,4,5,367.15052193688564,0.4062169312169312,-0.02550463720676488,0.20580639348939153,129625.34722222206,2512.407879818574,132137.75510204062,402,3,219.30555555555554,34,2,18,36.06962629569012,0.6207107843137256,45.41666666666666,1018.333333333332,29.950980392156822,8
407,4,2,2,34,0.05555555555555555,0.05555555555555555,0.9444444444444444,36,900,400,500,0.4444444444444444,14,4,10,356.368846154342,0.4085978835978836,0.00040988775381545217,0.20151537449420726,129967.37423911154,2063.2646390603268,132030.63887817186,403,0,220.05555555555554,35,1,19,35.99650018917897,0.6220238095238096,45.081018518518505,1019.6759259259238,29.133597883597822,0
408,4,0,0,34,0.0,0.0,1.0,34,850,700,150,0.8235294117647058,10,7,3,373.4159588858567,0.397225935828877,0.019337837359838517,0.2102202910044613,129793.87622849365,2893.4209498750156,132687.29717836867,404,13,234.0,33,1,19,35.73849969933852,0.6246843434343435,45.25122549019606,1018.9950980392141,30.87863933452164,0
409,4,0,0,34,0.0,0.0,1.0,34,1300,1100,200,0.8461538461538461,15,11,4,379.2035478943161,0.397671568627451,0.021833490035841008,0.2145039239992249,129981.25908604836,3057.870921039947,133039.1300070883,405,14,235.0,33,1,19,35.40026739574568,0.626578282828283,45.067401960784295,1019.7303921568606,30.900920974450322,0
410,4,0,2,32,0.0,0.058823529411764705,0.9411764705882353,34,1200,1000,200,0.8333333333333334,14,10,4,382.56851232062866,0.3974301841948901,0.01350129290246005,0.21727595044894613,130137.51471789683,3157.303080545929,133294.81779844276,406,15,236.0,33,1,19,35.15543678437025,0.6281565656565657,44.9142156862745,1020.343137254901,30.919489007724273,0
411,4,1,0,33,0.030303030303030304,0.0,1.0,33,1100,900,200,0.8181818181818182,13,9,4,385.08296290851325,0.3937815656565657,0.0501542656238787,0.22076928235524262,130502.81282518209,3451.0021122209014,133953.814937403,407,0,241.0,30,3,18,34.71975576602647,0.6395833333333334,44.556451612903224,1021.774193548387,34.05913978494623,0
412,4,0,0,33,0.0,0.0,1.0,33,900,700,200,0.7777777777777778,11,7,4,384.76765876150904,0.39374210858585856,0.05010122264199057,0.22097985477511442,130571.48947855247,3447.9372615331304,134019.4267400856,408,1,242.0,30,3,18,34.658019901806064,0.6402777777777777,44.48924731182796,1022.0430107526885,34.068100358422946,0
413,4,1,1,33,0.029411764705882353,0.029411764705882353,0.9705882352941176,34,850,600,250,0.7058823529411765,11,6,5,376.8581443245519,0.39963978015448604,0.04075592837313047,0.21863334852659053,130961.35669284391,3070.770772298172,134032.12746514208,409,0,235.85294117647058,31,3,19,34.464577237840835,0.6414650537634409,44.108072916666664,1023.5677083333328,33.018313172042994,0
414,4,0,0,33,0.0,0.0,1.0,33,400,300,100,0.75,5,3,2,386.54512614807635,0.3941761363636364,0.050682913232191096,0.2231872845210061,130777.62783269741,3510.2909295872378,134287.91876228465,410,3,244.0,30,3,19,34.403197547087174,0.642361111111111,44.28763440860215,1022.8494623655913,34.09498207885304,0
415,4,1,0,34,0.029411764705882353,0.0,1.0,34,1000,600,400,0.6,14,6,8,379.169731652803,0.3974858882947118,0.05366180021379563,0.22150605927066858,131228.0464172363,3151.5406290690103,134379.5870463053,411,0,237.7941176470588,31,3,21,34.135134705807616,0.6441532258064516,43.84765625,1024.6093749999998,33.05191532258064,0
416,4,2,2,34,0.05555555555555555,0.05555555555555555,0.9444444444444444,36,900,800,100,0.8888888888888888,10,8,2,360.38648946160674,0.40532407407407406,0.04751704724032857,0.21342334638108693,131749.07415378527,2296.1554117925702,134045.22956557784,412,0,225.52777777777777,32,4,18,34.08995408518839,0.6468098958333334,43.339646464646464,1026.6414141414139,32.08254419191918,0
417,4,0,0,34,0.0,0.0,1.0,34,1150,600,550,0.5217391304347826,17,6,11,378.1280594055747,0.3971887997623292,0.0714056342139835,0.21106039880948288,129458.25043362926,2990.359402101831,132448.6098357311,413,2,239.7941176470588,32,2,18,35.96050454921423,0.6236979166666666,45.58080808080808,1017.676767676768,31.802398989899,6
418,4,0,0,34,0.0,0.0,1.0,34,650,400,250,0.6153846153846154,9,4,5,364.23084337320046,0.3972073677956031,0.005332483829416201,0.19506789303984617,127813.27239229005,2510.707199546463,130323.97959183651,414,3,240.7941176470588,34,0,18,37.99471195353585,0.6023284313725491,47.20238095238094,1011.1904761904746,29.74089635854337,8
419,4,1,0,35,0.02857142857142857,0.0,1.0,35,950,600,350,0.631578947368421,13,6,7,357.5495374023026,0.40171568627450976,0.01795997373060043,0.1936765711774202,128268.64216887731,2173.3361604445645,130441.97832932188,415,0,234.88571428571427,33,2,20,37.69759658036941,0.6092171717171717,46.752450980392155,1012.990196078431,30.696672608437304,0
420,4,2,2,35,0.05405405405405406,0.05405405405405406,0.9459459459459459,37,1100,800,300,0.7272727272727273,14,8,6,341.8243804573153,0.40975350350350354,0.004658725038895639,0.18783097558779116,128839.34389667968,1408.0857812019005,130247.42967788158,416,0,223.13513513513513,37,0,19,37.51383788746086,0.6067004504504505,46.18969298245614,1015.2412280701749,27.438952110004728,0
421,4,1,1,35,0.027777777777777776,0.027777777777777776,0.9722222222222222,36,1150,900,250,0.782608695652174,14,9,5,350.6580917517601,0.4046626984126984,0.011402016616128163,0.19249890615410267,128800.98637488841,1833.021619592566,130634.00799448097,417,0,230.30555555555554,36,0,19,37.32873862879965,0.6082175925925927,46.22747747747748,1015.0900900900901,28.196946946946948,0
422,4,0,0,35,0.0,0.0,1.0,35,800,600,200,0.75,10,6,4,361.9736091084852,0.4003501400560224,0.012901123961557515,0.19865510337180306,128789.87295310339,2323.707025891613,131113.579978995,418,3,237.88571428571427,35,0,20,37.05292664386164,0.6101190476190477,46.23842592592592,1015.0462962962949,29.001322751322714,0
423,4,3,3,35,0.07894736842105263,0.07894736842105263,0.9210526315789473,38,1250,900,350,0.72,16,9,7,337.95272625961525,0.41333274063537223,0.00777214143026006,0.1886398262636282,129459.11864144541,1151.5252168772752,130610.64385832268,419,0,220.02631578947367,36,2,19,36.981760171148224,0.6148726851851853,45.57995495495495,1017.6801801801795,28.268893893893875,0
424,4,0,0,35,0.0,0.0,1.0,35,1000,800,200,0.8,12,8,4,361.7941524560002,0.40161064425770304,0.025298500178937422,0.20033267634732627,129142.5607103052,2344.604659636485,131487.16536994168,420,1,239.54285714285714,35,0,21,36.6976960449404,0.6136904761904762,45.8912037037037,1016.4351851851851,29.041005291005288,0
425,4,0,0,35,0.0,0.0,1.0,35,900,500,400,0.5555555555555556,13,5,8,363.4935216422715,0.4014705882352941,0.025709809053186428,0.20173282602447676,129232.53864198868,2395.064908187618,131627.6035501763,421,2,240.54285714285714,33,2,21,36.562788758989186,0.6190025252525253,45.802696078431374,1016.7892156862747,30.811794414735598,0
426,4,1,1,35,0.027777777777777776,0.027777777777777776,0.9722222222222222,36,650,400,250,0.6153846153846154,9,4,5,354.8579049964092,0.4062830687830688,0.026543209876543017,0.1983029469097581,129504.14540816325,1991.113945578229,131495.25935374148,422,0,234.83333333333334,34,2,20,36.505847953216374,0.619485294117647,45.535714285714285,1017.8571428571428,29.936974789915965,0
427,4,3,1,37,0.07894736842105263,0.02631578947368421,0.9736842105263158,38,850,600,250,0.7058823529411765,11,6,5,342.8224395616175,0.4107693219535325,0.046502846520274144,0.19460973072858742,130118.92804967136,1321.5376694261877,131440.46571909756,423,0,223.39473684210526,36,2,22,36.18814385577631,0.6215277777777778,44.932432432432435,1020.2702702702709,28.34084084084086,0
428,4,1,0,38,0.02631578947368421,0.0,1.0,38,800,600,200,0.75,10,6,4,344.36678640202916,0.41118421052631576,0.05031619379742103,0.1963668513015266,130293.86421388404,1374.0136414572528,131667.8778553413,424,0,224.3684210526316,33,5,23,35.97144700516145,0.6297348484848485,44.7610294117647,1020.9558823529408,30.938057040998206,0
429,4,0,0,38,0.0,0.0,1.0,38,1000,700,300,0.7,13,7,6,343.3663896820096,0.4095098387861546,0.058246799845435904,0.19655950566119548,130444.94224773231,1358.081774376408,131803.02402210873,425,1,225.3684210526316,34,4,24,35.84396729207941,0.6289828431372548,44.613095238095234,1021.5476190476181,30.045518207282885,0
430,4,2,2,38,0.05,0.05,0.95,40,1150,900,250,0.782608695652174,14,9,5,326.89697790020807,0.4143696581196581,0.05092394215318663,0.18965713416398053,130963.11034404837,562.2889975761934,131525.39934162455,426,0,215.05,37,3,19,35.741273879664334,0.6280968468468467,44.106359649122815,1023.5745614035104,27.66417733523001,0
431,4,1,0,39,0.02564102564102564,0.0,1.0,39,1650,1300,350,0.7878787878787878,20,13,7,332.58033510807377,0.41053756185335133,0.056665128644562746,0.19309514978662823,130991.17036011103,913.0174669129154,131904.18782702394,427,0,221.53846153846155,37,2,21,35.567516423878885,0.6283783783783783,44.07894736842106,1023.6842105263177,27.667140825035613,0
432,4,1,1,39,0.025,0.025,0.975,40,1250,1000,250,0.8,15,10,5,326.9974654939448,0.4126469017094017,0.05578920627752071,0.19167548324817144,131357.7852393047,592.0310456844072,131949.81628498912,428,0,216.975,35,5,22,35.34080858831057,0.6360119047619047,43.72106481481482,1025.1157407407409,29.289021164021168,0
433,4,0,0,39,0.0,0.0,1.0,39,1100,900,200,0.8181818181818182,13,9,4,339.4738359911305,0.40786662168241117,0.05510063560775014,0.1986889132754596,131300.0289151467,1114.5848963142193,132414.6138114609,429,1,223.30769230769232,37,2,22,35.07932580863734,0.6314752252252254,43.77741228070174,1024.8903508771907,27.699739212897047,0
434,4,1,1,39,0.025,0.025,0.975,40,1200,800,400,0.6666666666666666,16,8,8,326.1287456594083,0.40976228632478634,0.047964308612951534,0.19242829772261935,131609.25116381957,584.3150055786306,132193.5661693982,430,0,218.7,37,3,16,35.10988815273919,0.6345720720720721,43.47587719298245,1026.0964912280697,27.73233760075864,0
435,4,0,0,39,0.0,0.0,1.0,39,1150,600,550,0.5217391304347826,17,6,11,333.0630433194535,0.40626405757984707,0.047161954854262556,0.19680998014331344,131665.51246537408,970.5832563865908,132636.09572176068,431,3,225.30769230769232,37,2,17,34.87535612535613,0.6351351351351351,43.42105263157895,1026.315789473685,27.738264580369865,0
436,4,0,0,39,0.0,0.0,1.0,39,1300,1000,300,0.7692307692307693,16,10,6,333.1741720077764,0.40648897885739993,0.04904739605156139,0.1973124460789888,131749.92696069946,979.1345654432148,132729.06152614267,432,4,226.30769230769232,37,2,17,34.78752803588592,0.6359797297297296,43.338815789473685,1026.6447368421054,27.747155049786635,0
437,4,0,0,39,0.0,0.0,1.0,39,900,700,200,0.7777777777777778,11,7,4,331.75514005196726,0.4063202878992353,0.03811119139897934,0.1972006441628701,131890.6779008927,951.0820637119234,132841.75996460463,433,5,227.30769230769232,37,2,18,34.68234059208654,0.6373873873873873,43.20175438596492,1027.1929824561414,27.761972498814632,0
438,4,1,3,37,0.025,0.075,0.925,40,1150,900,250,0.782608695652174,14,9,5,325.1281863918755,0.4088675213675214,0.03379052369077318,0.19459164588528688,132150.72320841564,593.1849934253928,132743.90820184103,434,0,222.6,38,2,18,34.59125623441396,0.638157894736842,42.948717948717956,1028.2051282051293,27.058029689608667,0
439,4,0,1,36,0.0,0.02702702702702703,0.972972972972973,37,800,400,400,0.5,12,4,8,338.38533867436666,0.40221471471471476,0.05191464899830245,0.2010692295797329,131876.97991488114,1525.0473023699444,133402.02721725107,435,7,239.51351351351352,36,1,19,34.52586521945694,0.6391782407407407,43.215090090090094,1027.1396396396399,28.531656656656665,0
440,4,0,0,36,0.0,0.0,1.0,36,650,400,250,0.6153846153846154,9,4,5,349.72082664908226,0.3975198412698413,0.05347660555054601,0.20740128168654137,131803.0907064472,2018.8571673525396,133821.94787379974,436,8,246.86111111111111,35,1,19,34.309250075142764,0.6404761904761904,43.28703703703704,1026.851851851852,29.338624338624342,0
441,4,0,0,36,0.0,0.0,1.0,36,1200,1000,200,0.8333333333333334,14,10,4,347.9617324345175,0.3970899470899471,0.05504231135145954,0.20700458023383253,131921.9660922498,1980.7591735253945,133902.72526577517,437,9,247.86111111111111,35,1,19,34.234640228331074,0.6416666666666666,43.171296296296305,1027.314814814816,29.351851851851883,0
442,4,1,1,36,0.02702702702702703,0.02702702702702703,0.972972972972973,37,950,700,250,0.7368421052631579,12,7,5,339.94930233729923,0.40137012012012013,0.0550664574760964,0.2033903755137314,132137.36329234642,1584.0008927846825,133721.3641851311,438,0,242.13513513513513,36,1,20,34.223713033954006,0.6417824074074073,42.961711711711715,1028.1531531531532,28.55980980980981,0
443,4,0,0,36,0.0,0.0,1.0,36,400,300,100,0.75,5,3,2,346.71292914536167,0.3968253968253968,0.05412912912912948,0.20690932868352227,132040.8950617284,1956.0570987654346,133996.95216049382,439,1,249.44444444444446,35,1,20,34.14695945945947,0.6428571428571428,43.05555555555556,1027.7777777777778,29.365079365079367,0
444,4,0,0,36,0.0,0.0,1.0,36,850,700,150,0.8235294117647058,10,7,3,350.40328138017026,0.39618055555555554,0.05459119726450834,0.20980540080539917,132166.3106307322,2062.301786583897,134228.6124173161,440,2,250.44444444444446,36,0,20,33.925866097178115,0.6420717592592592,42.933558558558566,1028.2657657657667,28.562937937937964,0
445,4,0,1,35,0.0,0.027777777777777776,0.9722222222222222,36,1050,800,250,0.7619047619047619,13,8,5,350.50599810936,0.39573412698412697,0.062112254579957726,0.21034965747246376,132253.17166829002,2071.1059877445173,134324.27765603454,441,3,251.44444444444446,36,0,20,33.83580578059996,0.6429398148148149,42.84909909909911,1028.6036036036046,28.57232232232235,0
446,4,0,0,35,0.0,0.0,1.0,35,1100,900,200,0.8181818181818182,13,9,4,351.6358542921168,0.3942577030812325,0.08052707697252148,0.21150492183064398,132338.45191400888,2306.988918895744,134645.44083290463,442,4,257.62857142857143,35,0,20,33.720941132358455,0.6458333333333334,42.7662037037037,1028.935185185185,29.39814814814814,0
447,4,1,0,36,0.027777777777777776,0.0,1.0,36,1050,600,450,0.5714285714285714,15,6,9,342.83238597042435,0.39889219576719576,0.08022730481434426,0.20856640655980044,132765.8180980724,1903.3112306136265,134669.12932868602,443,0,251.44444444444446,34,2,17,33.51815486504177,0.6522671568627452,42.35119047619047,1030.595238095237,30.31162464985991,0
448,4,0,0,36,0.0,0.0,1.0,36,1050,800,250,0.7619047619047619,13,8,5,343.3673012588807,0.3991898148148148,0.08180634150723143,0.20923416337794837,132827.17013888882,1921.701388888884,134748.8715277777,444,1,252.44444444444446,34,2,17,33.44280517380761,0.6528799019607843,42.291666666666664,1030.8333333333328,30.318627450980376,0
449,4,1,0,37,0.02702702702702703,0.0,1.0,37,900,700,200,0.7777777777777778,11,7,4,334.73477897795294,0.4009634634634635,0.08628278345640394,0.2055437527112552,133113.667052469,1511.5547839505966,134625.2218364196,445,0,246.59459459459458,35,2,18,33.378196500672935,0.6535714285714287,42.01388888888888,1031.9444444444434,29.484126984126956,0
450,4,0,2,35,0.0,0.05405405405405406,0.9459459459459459,37,900,600,300,0.6666666666666666,12,6,6,335.07419449108585,0.40127627627627627,0.08607194480050184,0.20624753213705943,133203.26063368036,1526.595052083309,134729.85568576367,446,1,247.59459459459458,35,2,18,33.279725866128494,0.6544642857142857,41.92708333333332,1032.2916666666652,29.494047619047574,0
451,4,0,1,34,0.0,0.02857142857142857,0.9714285714285714,35,950,600,350,0.631578947368421,13,6,7,350.54200417213565,0.3944327731092437,0.09604400828551052,0.21403921793210093,132902.97752066512,2317.615220107652,135220.5927407728,447,2,260.9428571428571,33,2,19,33.181800174312656,0.6559343434343434,42.21813725490196,1031.1274509803923,31.24628639334522,0
452,4,0,1,33,0.0,0.029411764705882353,0.9705882352941176,34,1250,1100,150,0.88,14,11,3,351.9862785698568,0.39380941770647654,0.06448232499650697,0.2160149027374778,133092.5905901577,2569.3531334102363,135661.94372356794,447,3,256.47058823529414,33,1,19,32.95427553444181,0.6578282828282829,42.0343137254902,1031.8627450980398,31.268568033273933,0
453,4,0,0,33,0.0,0.0,1.0,33,800,600,200,0.75,10,6,4,361.3052186840754,0.3925189393939394,0.06826804330169889,0.2214722386997437,133048.5270157384,3014.2254298031094,136062.7524455415,448,4,264.1212121212121,32,1,20,32.75812834006445,0.6598307291666665,42.077020202020215,1031.6919191919208,32.240372474747524,0
454,4,1,0,34,0.029411764705882353,0.0,1.0,34,1150,900,250,0.782608695652174,14,9,5,353.4729448491152,0.39475638740344626,0.07542694497153679,0.21915322580645172,133472.2222222223,2635.763888888899,136107.9861111112,449,0,257.3235294117647,33,1,21,32.535282258064505,0.6616161616161615,41.66666666666667,1033.3333333333342,31.31313131313134,0
455,4,0,0,34,0.0,0.0,1.0,34,700,600,100,0.8571428571428571,8,6,2,353.4729448491152,0.39475638740344626,0.07542694497153679,0.21915322580645172,133472.2222222223,2635.763888888899,136107.9861111112,450,1,258.3235294117647,33,1,21,32.535282258064505,0.6616161616161615,41.66666666666667,1033.3333333333342,31.31313131313134,0
456,4,0,0,34,0.0,0.0,1.0,34,650,500,150,0.7692307692307693,8,5,3,351.07765507639334,0.39375371360665473,0.07289720968993385,0.21843646198826072,133602.72548719533,2580.986315171939,136183.71180236727,451,2,259.3235294117647,32,2,24,32.46646515225534,0.6653645833333333,41.54040404040405,1033.838383838385,32.30744949494953,0
457,4,0,0,34,0.0,0.0,1.0,34,650,300,350,0.46153846153846156,10,3,7,353.8848116229297,0.3935494652406417,0.07497109452986406,0.22076698339706174,133700.6447843334,2662.925498673624,136363.57028300702,452,3,260.3235294117647,32,2,18,32.2958633459488,0.6663411458333333,41.44570707070708,1034.217171717173,32.319286616161655,0
458,4,0,0,34,0.0,0.0,1.0,34,950,700,250,0.7368421052631579,12,7,5,352.70394662411877,0.39293672014260245,0.07230541716320427,0.22061497241511654,133798.59995153546,2638.25885113763,136436.8588026731,453,4,261.3235294117647,32,2,18,32.22835814823855,0.6673177083333334,41.3510101010101,1034.595959595959,32.331123737373716,0
459,4,0,0,34,0.0,0.0,1.0,34,850,600,250,0.7058823529411765,11,6,5,352.6235345313609,0.3920825906120024,0.07423994487985519,0.22095584778432972,133863.92332415053,2640.7139577594007,136504.63728190993,454,5,262.3235294117647,32,2,19,32.16508052708639,0.66796875,41.28787878787878,1034.848484848484,32.33901515151513,0
460,4,0,0,34,0.0,0.0,1.0,34,800,600,200,0.75,10,6,4,352.1786146616071,0.39141414141414144,0.07783103482915532,0.22106893437946804,133929.26263901638,2633.404435771858,136562.66707478825,455,6,263.3235294117647,32,2,19,32.11123648044238,0.6686197916666667,41.224747474747474,1035.1010101010097,32.34690656565655,0
461,4,0,0,34,0.0,0.0,1.0,34,950,800,150,0.8421052631578947,11,8,3,351.69363474122554,0.3905600118835413,0.07881635581061675,0.22115704025138402,133994.61789613302,2625.010840730533,136619.62873686355,456,7,264.3235294117647,32,2,19,32.05843495934958,0.6692708333333334,41.16161616161616,1035.353535353535,32.35479797979797,0
462,4,0,0,34,0.0,0.0,1.0,34,500,100,400,0.2,9,1,8,351.43614062845853,0.3903186274509804,0.08037398595580192,0.2211916952643122,134027.30150303527,2620.4075158146984,136647.70901884997,457,8,265.3235294117647,32,2,20,32.0324249075316,0.6695963541666667,41.1300505050505,1035.479797979797,32.35874368686866,0
463,4,0,1,33,0.0,0.029411764705882353,0.9705882352941176,34,850,600,250,0.7058823529411765,11,6,5,364.6346479951165,0.39007724301841945,0.08431554019108844,0.21949177557589,132367.37528344637,2853.1462585033632,135220.52154194974,458,9,266.3235294117647,34,0,21,33.35743482955423,0.6482843137254903,42.73809523809522,1029.0476190476163,30.26610644257695,3
464,4,0,0,33,0.0,0.0,1.0,33,700,400,300,0.5714285714285714,10,4,6,372.86297001574087,0.3859690656565657,0.0915661258763476,0.22387780903520219,132271.9101427334,3263.859453094944,135535.76959582834,459,10,274.45454545454544,33,0,21,33.241998252720194,0.6496212121212122,42.83088235294117,1028.676470588234,31.172014260249515,0
465,4,0,0,33,0.0,0.0,1.0,33,900,700,200,0.7777777777777778,11,7,4,373.8832053467691,0.3859690656565657,0.09375315806949946,0.22486557249938907,132334.9492983467,3295.5630046136025,135630.5123029603,460,11,275.45454545454544,33,0,21,33.15219548991584,0.6502525252525253,42.76960784313725,1028.9215686274504,31.179441473559102,0
466,4,0,0,33,0.0,0.0,1.0,33,850,700,150,0.8235294117647058,10,7,3,373.2236227441855,0.38506155303030304,0.09495767390504284,0.2248444751653994,132398.00347222213,3282.8425365244043,135680.84600874654,461,12,276.45454545454544,31,2,21,33.10560053981108,0.6559139784946237,42.70833333333333,1029.1666666666658,33.19892473118277,0
467,4,0,0,33,0.0,0.0,1.0,33,600,400,200,0.6666666666666666,8,4,4,371.7193658404323,0.38450915404040403,0.09474110663856816,0.2243247956844591,132462.98408644515,3247.8112883889276,135710.7953748341,462,13,277.45454545454544,32,1,21,33.07882579009771,0.6539713541666667,42.645202020202014,1029.419191919191,32.16934974747472,0
468,4,0,0,33,0.0,0.0,1.0,33,1000,700,300,0.7,13,7,6,372.53203921490456,0.3851404671717172,0.0896797364501738,0.22598430542411935,132658.02158261905,3283.872659677575,135941.89424229664,463,14,278.45454545454544,32,1,18,32.86146178044695,0.6559244791666667,42.455808080808076,1030.1767676767672,32.193023989898975,0
469,4,0,0,33,0.0,0.0,1.0,33,1250,1100,150,0.88,14,11,3,373.0860778884909,0.38450915404040403,0.09586493379216687,0.22710676016433615,132788.12629132214,3308.280245638183,136096.40653696033,464,15,279.45454545454544,32,1,18,32.71621952713464,0.6572265625,42.329545454545446,1030.6818181818169,32.20880681818178,0
470,4,0,1,32,0.0,0.030303030303030304,0.9696969696969697,33,1000,700,300,0.7,13,7,6,371.4427983424231,0.383364898989899,0.08987906159287151,0.22680113971358107,132902.9775206651,3273.170775663194,136176.1482963283,465,16,280.45454545454544,33,0,18,32.64301560890577,0.6559343434343434,42.218137254901954,1031.1274509803918,31.246286393345205,0
471,4,0,0,32,0.0,0.0,1.0,32,750,700,50,0.9333333333333333,8,7,1,379.62322529616745,0.37850722446236557,0.0948755053289232,0.23108608412323728,132788.12629132217,3681.891356749295,136470.01764807146,466,17,288.625,32,0,18,32.54777655273796,0.6572265625,42.329545454545446,1030.681818181817,32.208806818181785,0
472,4,1,0,33,0.030303030303030304,0.0,1.0,33,950,700,250,0.7368421052631579,12,7,5,372.642681732584,0.3815498737373737,0.10710163219953195,0.2300556687883137,133313.97667063138,3335.695555795835,136649.6722264272,467,0,280.8484848484849,33,0,20,32.198958704165186,0.6600378787878789,41.819852941176464,1032.7205882352932,31.29456327985737,0
473,4,0,0,33,0.0,0.0,1.0,33,1000,600,400,0.6,14,6,8,372.678678079245,0.38143150252525254,0.10780961830908442,0.23047018177035603,133377.26362757094,3341.3724589100048,136718.63608648095,468,1,281.8484848484849,33,0,21,32.13447126982242,0.660669191919192,41.758578431372534,1032.9656862745082,31.301990493166915,0
474,4,0,0,33,0.0,0.0,1.0,33,400,300,100,0.75,5,3,2,372.678678079245,0.38143150252525254,0.10780961830908442,0.23047018177035603,133377.26362757094,3341.3724589100048,136718.63608648095,469,2,282.8484848484849,33,0,21,32.13447126982242,0.660669191919192,41.758578431372534,1032.9656862745082,31.301990493166915,0
475,4,1,0,34,0.029411764705882353,0.0,1.0,34,750,500,250,0.6666666666666666,10,5,5,363.4585195024756,0.38543523469994057,0.10581771170006471,0.22653921421044695,133668.00103305772,2916.622334246031,136584.62336730375,470,0,275.5,32,2,22,32.081043956043956,0.666015625,41.47727272727272,1034.090909090908,32.31534090909088,0
476,4,0,1,33,0.0,0.029411764705882353,0.9705882352941176,34,900,600,300,0.6666666666666666,12,6,6,386.98373226457636,0.38543523469994057,0.07835038836148489,0.2253284316150738,131101.73906042744,3349.753532802766,134451.4925932302,471,1,276.5,32,2,21,34.06305223359224,0.6402994791666667,43.97095959595959,1024.116161616161,32.00363005050503,7
477,4,0,1,32,0.0,0.030303030303030304,0.9696969696969697,33,1050,900,150,0.8571428571428571,12,9,3,373.5325979248824,0.38178661616161613,0.0607638301948461,0.20969293440918732,129683.21352731847,3088.181531221288,132771.39505853975,472,5,285.8484848484849,32,1,18,35.84820875170448,0.6259765625,45.35984848484848,1018.5606060606046,31.830018939393895,6
478,4,0,0,32,0.0,0.0,1.0,32,800,500,300,0.625,11,5,6,381.9961816901619,0.3774151545698925,0.08989917550811688,0.21452664245241468,129698.28499688048,3508.8499281141535,133207.13492499464,473,6,295.0625,31,1,18,35.61733030806595,0.6286962365591398,45.345052083333336,1018.6197916666671,32.85870295698926,0
479,4,0,0,32,0.0,0.0,1.0,32,500,400,100,0.8,6,4,2,380.38265972852423,0.3774151545698925,0.04638935268430533,0.20710904815708314,128474.33302137582,3373.8817003038157,131848.21472167963,474,7,296.0625,31,1,19,36.90866084425036,0.6162634408602151,46.549479166666664,1013.8020833333329,32.703293010752674,7
480,4,0,0,32,0.0,0.0,1.0,32,450,200,250,0.4444444444444444,7,2,5,381.1522561277357,0.3773101478494623,0.044613618851932824,0.2076999733006771,128507.33651055221,3396.172247992614,131903.50875854483,475,8,297.0625,31,1,19,36.855362570095465,0.6165994623655915,46.51692708333333,1013.9322916666658,32.70749327956987,0
481,4,2,2,32,0.058823529411764705,0.058823529411764705,0.9411764705882353,34,800,500,300,0.625,11,5,6,363.50392365996817,0.3885732323232323,0.033144114099198596,0.20062899648076796,129014.56921616681,2579.4604238754305,131594.02964004225,476,0,280.52941176470586,33,1,19,36.78478086047448,0.6167929292929293,46.0171568627451,1015.9313725490192,30.785799168152096,0
482,4,0,1,31,0.0,0.03125,0.96875,32,400,300,100,0.75,5,3,2,382.71837268740927,0.377919186827957,0.04519415917843417,0.2090726594133883,128606.3724093966,3444.0043131510324,132050.37672254763,477,10,299.0625,31,1,19,36.71427043217802,0.6176075268817205,46.41927083333333,1014.3229166666658,32.720094086021476,0
483,4,2,1,32,0.06060606060606061,0.030303030303030304,0.9696969696969697,33,750,600,150,0.8,9,6,3,366.21509310267277,0.3835621843434343,0.030156238825969073,0.20291794319130194,129169.2991308284,2860.7493814406553,132030.04851226904,478,0,277.57575757575756,32,1,20,36.55808802219185,0.6207682291666667,45.86489898989898,1016.5404040404034,31.766887626262605,0
484,4,1,0,33,0.030303030303030304,0.0,1.0,33,750,400,350,0.5333333333333333,11,4,7,366.19233931489964,0.38446969696969696,0.05143130022147302,0.20423142301306402,129426.12879106712,2878.9713740944653,132305.1001651616,479,0,278.54545454545456,32,1,18,36.29689374198618,0.6233723958333335,45.61237373737373,1017.5505050505042,31.798453282828255,0
485,4,0,0,33,0.0,0.0,1.0,33,800,500,300,0.625,11,5,6,364.4193004094232,0.38360164141414144,0.0533516760259507,0.2037412205201642,129522.50567544118,2840.100181103955,132362.60585654512,480,1,279.54545454545456,32,1,18,36.24384974778798,0.6243489583333335,45.51767676767676,1017.929292929292,31.810290404040376,0
486,4,1,1,33,0.029411764705882353,0.029411764705882353,0.9705882352941176,34,800,700,100,0.875,9,7,2,354.1808520163502,0.3877005347593583,0.03969668675551041,0.19955067516043107,129825.09731833884,2396.3127162629435,132221.41003460178,481,0,272.29411764705884,33,1,19,36.196789321789325,0.6250000000000002,45.2205882352941,1019.1176470588214,30.882352941176407,0
487,4,0,0,33,0.0,0.0,1.0,33,700,300,400,0.42857142857142855,11,3,8,364.16147158768854,0.3835227272727273,0.04737595366081804,0.2044321914612303,129683.21352731848,2845.1259756657337,132528.33950298422,482,3,281.54545454545456,32,1,19,36.086835254741544,0.6259765625,45.35984848484848,1018.5606060606048,31.8300189393939,0
488,4,0,0,33,0.0,0.0,1.0,33,800,600,200,0.75,10,6,4,364.57001047926144,0.38399621212121215,0.0486966055049316,0.20533458161745416,129811.85154894904,2865.1016159065325,132676.95316485557,483,4,282.54545454545456,32,1,19,35.94556643125593,0.6272786458333334,45.233585858585855,1019.0656565656561,31.845801767676754,0
489,4,0,0,33,0.0,0.0,1.0,33,1000,800,200,0.8,12,8,4,367.1488464377114,0.3830097853535353,0.04952059292616595,0.2074686448554599,129940.5533395828,2941.504852821154,132882.05819240396,484,5,283.54545454545456,32,1,20,35.74896800825593,0.6285807291666666,45.10732323232324,1019.5707070707078,31.86158459595962,0
490,4,0,0,33,0.0,0.0,1.0,33,700,500,200,0.7142857142857143,9,5,4,366.21646547057503,0.38257575757575757,0.04821925619152645,0.20745418008915176,130037.12153096624,2924.347005407613,132961.46853637384,485,6,284.54545454545456,32,1,20,35.674568787653705,0.6295572916666666,45.01262626262626,1019.949494949495,31.87342171717172,0
491,4,0,0,33,0.0,0.0,1.0,33,1350,1000,350,0.7407407407407407,17,10,7,368.7404837038899,0.38178661616161613,0.043145457544270016,0.20992239931424284,130230.36552392627,3004.2415952454035,133234.60711917168,486,7,285.54545454545456,32,1,20,35.41383184891967,0.6315104166666665,44.82323232323233,1020.7070707070719,31.897095959595998,0
492,4,3,3,33,0.08333333333333333,0.08333333333333333,0.9166666666666666,36,850,500,350,0.5882352941176471,12,5,7,345.4196343754476,0.3933862433862434,0.028644851592149134,0.20014419443956122,130913.23329260963,1844.0002357681674,132757.2335283778,487,0,262.6666666666667,35,1,16,35.31770715524392,0.631547619047619,44.15509259259259,1023.3796296296288,29.239417989417966,0
493,4,1,1,33,0.029411764705882353,0.029411764705882353,0.9705882352941176,34,700,600,100,0.8571428571428571,8,6,2,366.2154589007455,0.38524955436720143,0.04556603374635282,0.21137166113316885,130763.47588667825,2777.521265859292,133540.99715253754,488,0,279.0882352941176,33,1,17,34.93739515935778,0.6344696969696969,44.3014705882353,1022.7941176470592,30.993761140819977,0
494,4,2,1,34,0.05714285714285714,0.02857142857142857,0.9714285714285714,35,900,700,200,0.7777777777777778,11,7,4,354.3314808655049,0.39103641456582633,0.04611808461180811,0.2065493266508676,131145.15306122456,2293.771258503407,133438.92431972796,489,0,272.0571428571429,34,1,18,34.855154579265445,0.6360294117647058,43.92857142857143,1024.285714285715,30.126050420168085,0
495,4,1,1,34,0.02857142857142857,0.02857142857142857,0.9714285714285714,35,1050,800,250,0.7619047619047619,13,8,5,354.35509921931686,0.3881652661064426,0.05890140517942144,0.20771625319111917,131358.63272392296,2309.5202664399103,133668.15299036287,490,0,273.0285714285714,34,1,19,34.63883404947159,0.6381740196078431,43.720238095238095,1025.119047619048,30.150560224089645,0
496,4,0,0,34,0.0,0.0,1.0,34,1000,700,300,0.7,13,7,6,360.2125788459667,0.3860294117647059,0.05496152060441495,0.21063619470699102,131265.326136582,2656.68432814301,133922.01046472503,491,1,281.70588235294116,33,1,19,34.58303436179542,0.6395202020202021,43.811274509803916,1024.7549019607836,31.053178847296472,0
497,4,0,1,33,0.0,0.029411764705882353,0.9705882352941176,34,900,600,300,0.6666666666666666,12,6,6,363.5357667164834,0.38528669043374925,0.05238564044864802,0.21310278126022292,131359.5300635572,2750.777495434434,134110.30755899163,492,2,282.70588235294116,33,1,19,34.402644949193046,0.6404671717171718,43.71936274509803,1025.122549019607,31.06431966726082,0
498,4,2,1,34,0.05714285714285714,0.02857142857142857,0.9714285714285714,35,450,300,150,0.6666666666666666,6,3,3,346.64529330201555,0.39285714285714285,0.05601669371667062,0.20565077716803187,131816.67375283426,2138.725907029453,133955.39965986373,493,0,271.1714285714286,34,1,17,34.374516964216696,0.6427696078431373,43.27380952380951,1026.9047619047603,30.203081232492952,0
499,4,1,1,34,0.02857142857142857,0.02857142857142857,0.9714285714285714,35,950,700,250,0.7368421052631579,12,7,5,347.45340772536247,0.39079131652661064,0.06022253129346322,0.20646198359878976,131877.806122449,2164.2786281179174,134042.08475056692,494,0,272.14285714285717,34,1,17,34.29217856590944,0.6433823529411764,43.214285714285715,1027.1428571428573,30.21008403361345,0
500,4,1,2,33,0.02857142857142857,0.05714285714285714,0.9428571428571428,35,550,400,150,0.7272727272727273,7,4,3,348.994296118081,0.39054621848739496,0.06244060725460665,0.20754457485891928,131908.37762188198,2207.0542800453386,134115.4319019273,495,0,273.1142857142857,34,1,17,34.221810174991305,0.6436887254901962,43.1845238095238,1027.261904761904,30.213585434173645,0
501,4,0,0,33,0.0,0.0,1.0,33,700,400,300,0.5714285714285714,10,4,6,368.87500532813567,0.383917297979798,0.07481806251491285,0.21789360779847994,131651.87225793273,3112.6170161207865,134764.4892740535,496,3,290.5151515151515,32,1,17,33.970277641076116,0.6458333333333335,43.434343434343425,1026.2626262626252,32.07070707070704,0
502,4,0,1,32,0.0,0.030303030303030304,0.9696969696969697,33,950,700,250,0.7368421052631579,12,7,5,368.49856457143363,0.3843907828282828,0.07329441466467035,0.2183367025445169,131768.1375552671,3111.2739090734176,134879.41146434052,497,4,291.5151515151515,33,0,17,33.862497015994265,0.6445707070707072,43.32107843137254,1026.715686274509,31.112596553773,0
503,4,0,0,32,0.0,0.0,1.0,32,1000,700,300,0.7,13,7,6,374.6655951517135,0.3841145833333333,0.07887819724544998,0.22206855829254601,131781.48275686146,3474.797533414946,135256.2802902764,498,5,299.96875,32,0,17,33.6907177406132,0.6471354166666667,43.3080808080808,1026.7676767676762,32.08648989898988,0
504,4,0,0,32,0.0,0.0,1.0,32,650,300,350,0.46153846153846156,10,3,7,379.622196987496,0.3831485215053763,0.0894865412979351,0.22577530662940526,131911.15702479324,3615.2806473829014,135526.43767217614,499,6,300.96875,32,0,17,33.43242994100295,0.6484375,43.18181818181817,1027.2727272727261,32.10227272727269,0
505,4,0,0,32,0.0,0.0,1.0,32,1150,800,350,0.6956521739130435,15,8,7,379.831317619983,0.3820144489247312,0.08612748710390572,0.22706215771379598,132105.78799357207,3635.583103764921,135741.371097337,500,7,301.96875,32,0,17,33.23047162859249,0.650390625,42.99242424242424,1028.030303030303,32.12594696969697,0
506,4,1,0,33,0.030303030303030304,0.0,1.0,33,1050,700,350,0.6666666666666666,14,7,7,365.9368182471177,0.38608743686868685,0.08903701940245168,0.2210090014445748,132492.61289227704,3096.7850406093826,135589.39793288644,501,0,293.7878787878788,33,0,19,33.19780879260406,0.6518308080808082,42.61642156862745,1029.5343137254904,31.198009506833042,0
507,4,0,0,33,0.0,0.0,1.0,33,850,600,250,0.7058823529411765,11,6,5,369.3737552956921,0.38569286616161613,0.09096678349415122,0.2236467607712534,132587.2561034218,3194.8505382545154,135782.1066416763,502,1,294.7878787878788,33,0,19,33.01404093288909,0.6527777777777778,42.52450980392157,1029.9019607843138,31.20915032679739,0
508,4,0,0,33,0.0,0.0,1.0,33,1150,800,350,0.6956521739130435,15,8,7,368.8985637242239,0.3843907828282828,0.08821716991535045,0.22429992930997816,132745.06987997398,3193.893124038823,135938.9630040128,503,2,295.7878787878788,33,0,17,32.867438656994494,0.6543560606060608,42.37132352941176,1030.5147058823525,31.227718360071286,0
509,4,0,0,33,0.0,0.0,1.0,33,1000,700,300,0.7,13,7,6,361.89014420746855,0.38450915404040403,-0.006165049247863763,0.21058175800818996,131077.01965590162,2887.09630911189,133964.1159650135,504,3,296.7878787878788,33,0,19,34.730532950374986,0.6376262626262625,43.99509803921569,1024.0196078431377,31.030897207367808,8
510,4,0,2,31,0.0,0.06060606060606061,0.9393939393939394,33,1000,900,100,0.9,11,9,2,362.4653739612184,0.38308869949494945,-0.0029578077424967653,0.21160688032931496,131202.54229142657,2911.2757112649174,134113.8180026915,505,4,297.7878787878788,33,0,19,34.58881578947368,0.6388888888888888,43.87254901960785,1024.5098039215702,31.045751633986978,0
511,4,0,0,31,0.0,0.0,1.0,31,850,600,250,0.7058823529411765,11,6,5,376.9750450299797,0.37298387096774194,0.02545221968939093,0.22003261530384882,131194.69536675356,3691.425238715282,134886.12060546884,506,13,317.35483870967744,31,0,19,34.225131333672245,0.6438172043010753,43.880208333333336,1024.4791666666672,33.04771505376346,0
512,4,0,0,31,0.0,0.0,1.0,31,850,700,150,0.8235294117647058,10,7,3,376.58168600108587,0.3733870967741935,0.0257048126851942,0.2203772825661372,131294.76123385952,3688.640509711362,134983.4017435709,507,14,318.35483870967744,31,0,20,34.13387223139796,0.6448252688172043,43.78255208333333,1024.869791666666,33.060315860215034,0
513,4,0,0,31,0.0,0.0,1.0,31,800,600,200,0.75,10,6,4,379.39624266345334,0.37307347670250895,0.028579153932501766,0.2226055152557399,131394.86524793826,3770.143636067699,135165.00888400595,508,15,319.35483870967744,31,0,20,33.96039708746084,0.6458333333333334,43.68489583333333,1025.2604166666658,33.07291666666664,0
514,4,0,0,31,0.0,0.0,1.0,31,600,300,300,0.5,9,3,6,379.01593541952093,0.3723566308243728,0.025426366749128126,0.22277085875851824,131461.62245008672,3765.2099609374964,135226.83241102422,509,16,320.35483870967744,31,0,21,33.90257321821568,0.646505376344086,43.619791666666664,1025.5208333333328,33.08131720430106,0
515,4,0,0,31,0.0,0.0,1.0,31,700,300,400,0.42857142857142855,11,3,8,378.8099526732336,0.37199820788530463,0.022540102462457412,0.2228443612551948,131495.0074089897,3762.323506673167,135257.33091566287,510,17,321.35483870967744,31,0,21,33.874069019508276,0.6468413978494624,43.58723958333333,1025.6510416666658,33.08551747311825,0
516,4,0,0,31,0.0,0.0,1.0,31,1100,800,300,0.7272727272727273,14,8,6,381.42698858512216,0.37222222222222223,0.025413459963975926,0.22497340344691322,131595.18771701382,3838.79123263888,135433.9789496527,511,18,322.35483870967744,31,0,19,33.70558375634519,0.6478494623655915,43.48958333333333,1026.041666666666,33.098118279569874,0
517,4,0,0,31,0.0,0.0,1.0,31,800,600,200,0.75,10,6,4,379.659941331817,0.37262544802867387,0.0254037884709033,0.22452057895864286,131695.40617201044,3799.8940361870427,135495.30020819747,512,19,323.35483870967744,31,0,19,33.6495464924521,0.6488575268817205,43.39192708333332,1026.4322916666652,33.110719086021454,0
518,4,0,0,31,0.0,0.0,1.0,31,900,600,300,0.6666666666666666,12,6,6,379.0890692898753,0.37231182795698925,0.029586597664000847,0.2245768077648885,131762.23966810433,3789.924960666229,135552.16462877055,513,20,324.35483870967744,31,0,19,33.59662333544704,0.6495295698924731,43.326822916666664,1026.692708333333,33.119119623655905,0
519,4,0,0,31,0.0,0.0,1.0,31,950,900,50,0.9473684210526315,10,9,1,379.4708062983187,0.37217741935483867,0.026958057972911176,0.2253965150663505,131862.52170138876,3807.595486111093,135670.11718749985,514,21,325.35483870967744,31,0,19,33.48546315077754,0.6505376344086022,43.22916666666666,1027.0833333333321,33.131720430107485,0
520,4,0,0,31,0.0,0.0,1.0,31,550,500,50,0.9090909090909091,6,5,1,379.4275575235972,0.37168458781362007,0.028779213558934202,0.2259670080316004,131962.841881646,3814.0677558051175,135776.9096374511,515,22,326.35483870967744,31,0,20,33.38521205592869,0.6515456989247312,43.131510416666664,1027.473958333333,33.14432123655913,0
521,4,0,0,31,0.0,0.0,1.0,31,900,800,100,0.8888888888888888,10,8,2,379.87872010768336,0.3721326164874552,0.02222721608204492,0.22703576799774094,132096.66146172408,3836.142137315528,135932.80359903962,516,23,327.35483870967744,31,0,20,33.2384684399409,0.6528897849462366,43.00130208333333,1027.9947916666658,33.16112231182793,0
522,4,0,0,31,0.0,0.0,1.0,31,200,100,100,0.5,3,1,2,382.01079752773023,0.37163978494623656,0.025097321563517738,0.22871412191633694,132163.5966830783,3897.584194607201,136061.1808776855,517,24,328.35483870967744,31,0,20,33.11608311173019,0.6535618279569892,42.936197916666664,1028.255208333333,33.16952284946235,0
523,4,0,0,31,0.0,0.0,1.0,31,1050,700,350,0.6666666666666666,14,7,7,384.33826144268266,0.36863799283154125,0.02846347812604577,0.23195254160044643,132465.01498752166,3982.274712456594,136447.28969997825,518,25,329.35483870967744,31,0,20,32.75202377940804,0.6565860215053764,42.643229166666664,1029.427083333333,33.20732526881719,0
524,4,0,0,31,0.0,0.0,1.0,31,1000,800,200,0.8,12,8,4,384.37591108787865,0.36854838709677423,0.027930613959596506,0.23259595109365194,132565.56404961477,3991.0018920898397,136556.5659417046,519,26,330.35483870967744,31,0,20,32.64964491929025,0.6575940860215055,42.545572916666664,1029.8177083333333,33.219926075268816,0
525,4,0,0,31,0.0,0.0,1.0,31,800,500,300,0.625,11,5,6,383.73315748356436,0.36863799283154125,0.035482647990444205,0.23303764199289678,132699.68880547426,3984.254116482212,136683.94292195648,520,27,331.35483870967744,31,0,18,32.53098803656428,0.6589381720430108,42.415364583333336,1030.3385416666672,33.236727150537654,0
526,4,0,0,31,0.0,0.0,1.0,31,550,300,250,0.5454545454545454,8,3,5,387.84862013528976,0.36778673835125447,0.06793076919912289,0.22117243858042224,130295.81917656785,3907.0107354058064,134202.82991197365,521,28,332.35483870967744,31,0,18,34.85963206223696,0.634744623655914,44.75911458333333,1020.963541666666,32.9343077956989,8
527,4,2,2,31,0.06060606060606061,0.06060606060606061,0.9393939393939394,33,750,500,250,0.6666666666666666,10,5,5,373.3599910403559,0.37665719696969696,0.052335987162871245,0.21567030070684073,130794.81336805547,3166.7100694444343,133961.5234374999,522,0,313.1515151515151,33,0,16,34.7229293957909,0.6347853535353536,44.27083333333333,1022.916666666666,30.997474747474726,0
528,4,0,0,31,0.0,0.0,1.0,31,1050,800,250,0.7619047619047619,13,8,5,392.1128757671508,0.3671146953405018,0.05124966462344971,0.21872677545469524,129433.15505981432,3950.4813300238575,133383.63638983818,523,30,334.35483870967744,31,0,16,35.63033162721263,0.6260080645161291,45.60546874999999,1017.578124999999,32.82510080645158,6
529,4,0,0,31,0.0,0.0,1.0,31,550,300,250,0.5454545454545454,8,3,5,391.82563171771574,0.36702508960573477,0.054391907223512614,0.2193045536435803,129565.68611992718,3953.431362575937,133519.11748250312,524,31,335.35483870967744,31,0,17,35.50232872916399,0.6273521505376345,45.47526041666666,1018.0989583333323,32.841901881720396,0
530,4,0,0,31,0.0,0.0,1.0,31,450,200,250,0.4444444444444444,7,2,5,391.6174134136487,0.368010752688172,0.05754564839905796,0.21955840790739384,129631.97708129871,3953.2279120551084,133585.2049933538,525,32,336.35483870967744,31,0,17,35.439974640924014,0.6280241935483872,45.41015624999999,1018.3593749999991,32.85030241935481,0
531,4,2,1,32,0.06060606060606061,0.030303030303030304,0.9696969696969697,33,1250,900,350,0.72,16,9,7,370.2729530189313,0.3803661616161616,0.047512473115931986,0.2104616300197022,130168.77710796318,3039.595498125706,133208.37260608887,526,0,316.90909090909093,33,0,19,35.437307353588714,0.6284722222222223,44.88357843137254,1020.4656862745089,30.923202614379058,0
532,4,0,0,32,0.0,0.0,1.0,32,1100,800,300,0.7272727272727273,14,8,6,382.90507610220993,0.373991935483871,0.04953268135677158,0.21690793862227564,130037.12153096613,3558.374783185376,133595.4963141515,527,1,327.8125,32,0,19,35.24903028802508,0.6295572916666667,45.012626262626256,1019.9494949494942,31.873421717171695,0
533,4,0,1,31,0.0,0.03125,0.96875,32,550,400,150,0.7272727272727273,7,4,3,382.90507610220993,0.373991935483871,0.04953268135677158,0.21690793862227564,130037.12153096613,3558.374783185376,133595.4963141515,528,2,328.8125,32,0,19,35.24903028802508,0.6295572916666667,45.012626262626256,1019.9494949494942,31.873421717171695,0
534,4,0,0,31,0.0,0.0,1.0,31,700,400,300,0.5714285714285714,10,4,6,389.53884485325665,0.37387992831541217,0.040330818148868186,0.22043845613372137,129996.88042534716,3927.7669270833244,133924.64735243047,529,3,324.258064516129,31,0,19,35.120871637725564,0.631720430107527,45.05208333333333,1019.7916666666661,32.89650537634407,0
535,4,2,1,32,0.06060606060606061,0.030303030303030304,0.9696969696969697,33,750,700,50,0.9333333333333333,8,7,1,369.2204291171932,0.38533775252525254,0.02793287966032687,0.2113888390879753,130450.3075740099,3032.983708189147,133483.29128219906,530,0,305.54545454545456,33,0,20,35.17824296225209,0.6313131313131313,44.607843137254896,1021.5686274509796,30.95662507427211,0
536,4,0,0,32,0.0,0.0,1.0,32,700,600,100,0.8571428571428571,8,6,2,375.8743187349977,0.3786122311827957,0.03059332509270707,0.21505114841344625,130423.7529971431,3404.5878609325523,133828.34085807565,531,1,316.09375,32,0,20,35.03528018129378,0.6334635416666667,44.63383838383838,1021.4646464646462,31.920770202020194,0
537,4,1,1,32,0.030303030303030304,0.030303030303030304,0.9696969696969697,33,950,700,250,0.7368421052631579,12,7,5,367.3868948610633,0.38419349747474746,0.033327161636734104,0.21221995926680234,130794.81336805549,3010.4600694444357,133805.2734374999,532,0,307.4848484848485,33,0,16,34.87567888662593,0.6347853535353536,44.27083333333333,1022.9166666666661,30.99747474747473,0
538,4,0,1,31,0.0,0.03125,0.96875,32,1050,700,350,0.6666666666666666,14,7,7,360.948832062114,0.3800823252688172,0.005631049888309647,0.20114285537735238,129394.01113406803,2940.9234389348107,132334.93457300283,533,1,318.03125,32,0,19,36.4629870935716,0.623046875,45.6439393939394,1017.4242424242431,31.794507575757596,7
539,4,2,1,32,0.06060606060606061,0.030303030303030304,0.9696969696969697,33,1050,900,150,0.8571428571428571,12,9,3,349.16609231183537,0.38750789141414144,0.017345168860320115,0.1967252861561803,129825.09731833899,2466.104382929624,132291.2017012686,534,0,309.3030303030303,33,0,18,36.32455507455507,0.625,45.22058823529411,1019.1176470588226,30.882352941176443,0
540,4,0,0,32,0.0,0.0,1.0,32,800,700,100,0.875,9,7,2,358.9257670730866,0.3807123655913978,0.02990982895389216,0.2016582930881381,129715.36705438222,2911.637524232225,132627.00457861446,535,1,319.96875,32,0,18,36.18745868451495,0.6263020833333334,45.32828282828283,1018.6868686868688,31.83396464646465,0
541,4,2,1,33,0.058823529411764705,0.029411764705882353,0.9705882352941176,34,700,500,200,0.7142857142857143,9,5,4,343.16421436504663,0.39072712418300654,0.02101330442360072,0.19521876640687075,130201.83000283435,2136.121740362793,132337.95174319713,536,0,302.0882352941176,34,0,19,36.09539639954896,0.6265318627450981,44.85119047619047,1020.5952380952372,30.017507002801093,0
542,4,1,0,34,0.029411764705882353,0.0,1.0,34,800,500,300,0.625,11,5,6,342.24037470860424,0.38992869875222813,0.02400120691783325,0.19545525527632535,130353.7485827664,2122.4631519274308,132476.21173469385,537,0,303.05882352941177,34,0,20,35.96506567187378,0.6280637254901962,44.70238095238095,1021.1904761904759,30.035014005602232,0
543,4,1,1,34,0.02857142857142857,0.02857142857142857,0.9714285714285714,35,800,600,200,0.75,10,6,4,333.49887040153,0.3959733893557423,0.019334487276962742,0.19161538871281136,130587.70743580667,1710.1705836333952,132297.87801944008,538,0,295.37142857142857,35,0,15,35.95159570452573,0.6282738095238096,44.473379629629626,1022.1064814814808,29.20304232804231,0
544,4,1,2,33,0.02857142857142857,0.05714285714285714,0.9428571428571428,35,600,400,200,0.6666666666666666,8,4,4,331.96606720261957,0.39285714285714285,0.010943487751636782,0.1913189956774391,130706.03358892734,1677.99358603393,132384.02717496126,539,0,296.34285714285716,35,0,15,35.87117996604412,0.6294642857142858,44.35763888888888,1022.5694444444434,29.216269841269813,0
545,4,0,0,33,0.0,0.0,1.0,33,550,400,150,0.7272727272727273,7,4,3,374.31947526616943,0.38237847222222227,0.10783547161499918,0.20104146182968313,127927.48169273842,2977.1495638696733,130904.6312566081,540,4,315.24242424242425,33,0,21,37.62252675146376,0.6057449494949495,47.08946078431373,1011.6421568627455,30.655822935234713,7
546,4,4,3,34,0.10810810810810811,0.08108108108108109,0.9189189189189189,37,350,100,250,0.2857142857142857,6,1,5,341.69208845441597,0.40381006006006004,0.09011734881628963,0.18710169151225806,128700.23108071688,1395.1701485072003,130095.40122922408,541,0,282.05405405405406,37,0,18,37.658940278077935,0.6052927927927929,46.3267543859649,1014.6929824561382,27.42413466097671,0
547,4,0,0,34,0.0,0.0,1.0,34,1150,900,250,0.782608695652174,14,9,5,364.2675095552911,0.38913027332144984,0.10488894112116642,0.19729804193545336,128265.09530895697,2544.561366213164,130809.65667517013,542,1,307.94117647058823,34,0,23,37.5310945273632,0.6069240196078431,46.75595238095239,1012.9761904761908,29.793417366946787,0
548,4,2,2,34,0.05555555555555555,0.05555555555555555,0.9444444444444444,36,1250,1100,150,0.88,14,11,3,349.3101897209026,0.39923941798941803,0.09098809259670082,0.19175895555080513,128800.98637488858,1798.2993973703594,130599.28577225894,543,0,291.77777777777777,36,0,18,37.36294467864802,0.6082175925925926,46.227477477477485,1015.0900900900916,28.19694694694699,0
549,4,1,1,34,0.02857142857142857,0.02857142857142857,0.9714285714285714,35,800,500,300,0.625,11,5,6,357.96528739880654,0.3947128851540616,0.06873564341918792,0.19631004410257283,128760.50407503887,2218.35816936732,130978.86224440619,544,0,301.0857142857143,35,0,17,37.18461341087924,0.6098214285714284,46.26736111111113,1014.9305555555579,28.99801587301594,2
550,4,2,2,34,0.05555555555555555,0.05555555555555555,0.9444444444444444,36,800,500,300,0.625,11,5,6,349.85614366340417,0.3998346560846561,0.06766792285524303,0.19317026487951275,129029.71172185725,1828.3674722019648,130858.07919405922,545,0,293.6666666666667,36,0,17,37.115984999630534,0.6105324074074072,46.00225225225227,1015.9909909909932,28.22197197197203,0
551,4,1,0,35,0.02857142857142857,0.0,1.0,35,900,700,200,0.7777777777777778,11,7,4,358.64376656548427,0.39261204481792716,0.09280343716433936,0.19799842659822828,129024.9445408954,2254.798418209917,131279.74295910532,546,0,303.0285714285714,35,0,19,36.89764183185236,0.6124999999999997,46.006944444444464,1015.972222222225,29.027777777777857,0
552,4,0,0,35,0.0,0.0,1.0,35,700,400,300,0.5714285714285714,10,4,6,357.84882638039426,0.3922268907563025,0.09138691357622908,0.19770640948983564,129054.34355977831,2236.3890764318003,131290.7326362101,547,1,304.0285714285714,35,0,19,36.88786213312071,0.6127976190476188,45.97800925925928,1016.087962962966,29.031084656084744,0
553,4,3,4,34,0.07894736842105263,0.10526315789473684,0.8947368421052632,38,1050,800,250,0.7619047619047619,13,8,5,336.97502699034715,0.40893195827406353,0.0757131555679651,0.1896113211572555,129774.47041636264,1146.318583230727,130920.78899959337,548,0,280.94736842105266,36,2,18,36.68651451517831,0.6180555555555554,45.27027027027029,1018.9189189189216,28.303303303303377,0
554,4,1,0,35,0.02857142857142857,0.0,1.0,35,700,400,300,0.5714285714285714,10,4,6,358.0871736802111,0.3924719887955182,0.09081866212332534,0.19936161158413357,129357.1752000432,2264.2290525278736,131621.40425257108,549,0,305.37142857142857,33,2,20,36.57327932377627,0.6202651515151515,45.68014705882353,1017.2794117647055,30.82664884135471,0
555,4,0,0,35,0.0,0.0,1.0,35,1200,900,300,0.75,15,9,6,359.5679615327878,0.39191176470588235,0.08745850176313774,0.20082124549628796,129481.87183114661,2311.5065419550124,131793.37837310162,550,1,306.37142857142857,33,2,18,36.408664459161145,0.6215277777777778,45.557598039215684,1017.7696078431368,30.84150326797384,0
556,4,1,2,34,0.027777777777777776,0.05555555555555555,0.9444444444444444,36,950,700,250,0.7368421052631579,12,7,5,350.2955453005373,0.397172619047619,0.08563003620226572,0.19773109785158216,129898.25857426297,1900.5562641723254,131798.8148384353,551,0,298.8333333333333,34,2,19,36.22148584997468,0.623468137254902,45.14880952380952,1019.4047619047614,29.982492997198865,0
557,4,1,1,34,0.02857142857142857,0.02857142857142857,0.9714285714285714,35,1300,800,500,0.6153846153846154,18,8,10,360.01263450271404,0.39243697478991596,0.08627424036826459,0.20299831058705559,129856.32216274976,2349.9833297289315,132206.30549247868,552,0,308.2857142857143,33,2,19,36.016467275860684,0.6253156565656567,45.18995098039215,1019.2401960784302,30.88606654783122,0
558,4,0,0,34,0.0,0.0,1.0,34,700,400,300,0.5714285714285714,10,4,6,368.29457051846623,0.3878490790255496,0.0992227828166472,0.2069220470016007,129715.36705438222,2754.6930797877817,132470.06013417,553,7,318.3529411764706,32,2,19,35.94886175838704,0.6263020833333334,45.32828282828283,1018.6868686868688,31.83396464646465,0
559,4,0,0,34,0.0,0.0,1.0,34,850,500,350,0.5882352941176471,12,5,7,371.9257418683253,0.38775623885918004,0.10523151151180343,0.20947750611439309,129811.85154894904,2856.0738381287542,132667.9253870778,554,8,319.3529411764706,32,2,19,35.758167100318005,0.6272786458333334,45.233585858585855,1019.0656565656561,31.845801767676754,0
560,4,0,0,34,0.0,0.0,1.0,34,1100,800,300,0.7272727272727273,14,8,6,372.4931706428701,0.3884618241235888,0.10177745401566196,0.21048861812044634,129940.5533395828,2880.3937417100424,132820.94708129283,555,9,320.3529411764706,32,2,19,35.61274509803921,0.6285807291666666,45.10732323232324,1019.5707070707078,31.86158459595962,0
561,4,1,0,35,0.02857142857142857,0.0,1.0,35,900,600,300,0.6666666666666666,12,6,6,361.34943773427733,0.39432773109243696,0.09166180758017495,0.20588514475557682,130262.58680555563,2414.062500000009,132676.64930555565,556,0,312.1714285714286,33,2,20,35.56972789115647,0.6294191919191918,44.79166666666667,1020.833333333334,30.934343434343457,0
562,4,0,0,35,0.0,0.0,1.0,35,800,300,500,0.375,13,3,10,362.6880848927942,0.3940826330532213,0.09286485930346244,0.20681412972223606,130293.86421388414,2451.206417003085,132745.07063088723,557,1,313.1714285714286,33,2,20,35.50381606849919,0.6297348484848484,44.76102941176471,1020.9558823529416,30.938057040998228,0
563,4,0,0,35,0.0,0.0,1.0,35,750,500,250,0.6666666666666666,10,5,5,362.00363171133085,0.3938375350140056,0.0938711834187651,0.2067564265284801,130356.43029423797,2437.900236687833,132794.3305309258,558,2,314.1714285714286,33,2,20,35.45779331173246,0.6303661616161615,44.699754901960794,1021.2009803921584,30.94548425430783,0
564,4,0,1,34,0.0,0.02857142857142857,0.9714285714285714,35,1000,800,200,0.8,12,8,4,364.1747037564714,0.39278711484593837,0.09052245583371876,0.20866835087406924,130481.6075097321,2503.6201521049907,132985.2276618371,559,3,315.1714285714286,33,2,20,35.27535384430851,0.6316287878787877,44.577205882352956,1021.6911764705903,30.96033868092698,0
565,4,0,0,34,0.0,0.0,1.0,34,550,300,250,0.5454545454545454,8,3,5,364.1747037564714,0.39271390374331555,0.06890262402190106,0.20866835087406924,130481.6075097321,2703.6201521049907,133185.2276618371,560,4,309.6470588235294,33,1,20,35.27535384430851,0.6316287878787877,44.577205882352956,1021.6911764705903,30.96033868092698,0
566,4,1,1,34,0.02857142857142857,0.02857142857142857,0.9714285714285714,35,950,700,250,0.7368421052631579,12,7,5,354.36313802801214,0.39716386554621846,0.0619646182495337,0.20461613453875582,130779.591836735,2268.6933106576244,133048.28514739263,561,0,301.77142857142854,34,1,15,35.224142613283654,0.6323529411764705,44.2857142857143,1022.8571428571453,30.08403361344545,0
567,4,1,2,33,0.02857142857142857,0.05714285714285714,0.9428571428571428,35,850,600,250,0.7058823529411765,11,6,5,357.9257263262454,0.3966736694677871,0.061631560572559696,0.20683629901287331,130810.03578514745,2364.055413832212,133174.09119897967,562,0,302.74285714285713,34,1,15,35.10221498118624,0.6326593137254901,44.25595238095239,1022.9761904761909,30.087535014005617,0
568,4,0,0,33,0.0,0.0,1.0,33,1250,800,450,0.64,17,8,9,374.98056106134686,0.3854166666666667,0.079183233371521,0.21525479866883288,130552.75769054188,3190.9492653810985,133743.70695592297,563,17,321.90909090909093,32,1,18,34.92710649864098,0.634765625,44.507575757575765,1021.9696969696977,31.936553030303052,0
569,4,0,0,33,0.0,0.0,1.0,33,1200,900,300,0.75,15,9,6,370.15017709259257,0.3857717803030303,0.07976698916296221,0.21329648326385334,130700.81218762034,3075.7857554786847,133776.597943099,564,18,322.90909090909093,33,0,18,34.90032758069672,0.6338383838383838,44.36274509803923,1022.5490196078447,30.986333927510444,0
570,4,0,0,33,0.0,0.0,1.0,33,900,600,300,0.6666666666666666,12,6,6,372.00535188423413,0.38569286616161613,0.08123899268297086,0.21453936845016855,130732.14215986658,3126.611309352195,133858.75346921876,565,19,323.90909090909093,33,0,18,34.821125424405835,0.6341540404040403,44.332107843137265,1022.6715686274524,30.990047534165225,0
571,4,1,0,34,0.029411764705882353,0.0,1.0,34,950,500,450,0.5263157894736842,14,5,9,366.90766471261645,0.3895944741532977,0.0887753985834221,0.21388032162515963,131145.15306122464,2823.632369614531,133968.78543083917,566,0,315.3529411764706,34,0,20,34.533114442894764,0.6360294117647057,43.92857142857144,1024.2857142857156,30.126050420168106,0
572,4,0,0,34,0.0,0.0,1.0,34,850,600,250,0.7058823529411765,11,6,5,369.6788585207646,0.38987299465240643,0.08673138052431928,0.21566688661499542,131175.6395266441,2898.572137188226,134074.21166383234,567,1,316.3529411764706,34,0,20,34.43128994770484,0.6363357843137254,43.89880952380953,1024.4047619047628,30.12955182072832,0
573,4,0,0,34,0.0,0.0,1.0,34,750,500,250,0.6666666666666666,10,5,5,370.22737267696607,0.3899472667855021,0.08910326068384822,0.2163304138921012,131236.62308673482,2917.4780328798342,134154.10111961464,568,2,317.3529411764706,34,0,21,34.35551489098019,0.6369485294117645,43.83928571428572,1024.6428571428582,30.136554621848774,0
574,4,0,0,34,0.0,0.0,1.0,34,950,700,250,0.7368421052631579,12,7,5,372.38931814516434,0.38987299465240643,0.09099574316891368,0.21794015227136115,131297.6208191611,2978.7662981859557,134276.38711734704,569,3,318.3529411764706,34,0,22,34.23839392883418,0.6375612745098038,43.77976190476191,1024.8809523809532,30.143557422969213,0
575,4,0,0,34,0.0,0.0,1.0,34,750,600,150,0.8,9,6,3,373.44812962386663,0.38909313725490197,0.08681480960585075,0.2189133569939487,131359.5300635575,3011.197705185043,134370.72776874254,570,4,319.3529411764706,33,1,22,34.14861028093245,0.6404671717171716,43.71936274509805,1025.1225490196096,31.064319667260897,0
576,4,0,0,34,0.0,0.0,1.0,34,750,600,150,0.8,9,6,3,375.8367572194513,0.3884618241235888,0.08259959102503744,0.22140249786657504,131548.03929077773,3088.117701124588,134636.1569919023,571,5,320.3529411764706,33,1,22,33.89666208736512,0.6423611111111109,43.535539215686285,1025.8578431372562,31.086601307189582,0
577,4,0,1,33,0.0,0.029411764705882353,0.9705882352941176,34,950,700,250,0.7368421052631579,12,7,5,363.60105569547846,0.38831327985739755,0.061886332199971195,0.21692936515681177,132030.6990504536,2801.300311791397,134831.999362245,572,6,321.3529411764706,34,0,19,33.7233097803004,0.6449142156862744,43.0654761904762,1027.738095238096,30.22759103641459,1
578,4,0,0,33,0.0,0.0,1.0,33,1150,900,250,0.782608695652174,14,9,5,369.88599422978393,0.38695549242424243,0.06411757055533895,0.2209831709116402,132082.88278546714,3171.121683967706,135254.00446943485,573,7,325.27272727272725,33,0,19,33.509179780639016,0.6477272727272727,43.01470588235294,1027.9411764705883,31.149732620320858,0
579,4,0,0,33,0.0,0.0,1.0,33,350,100,250,0.2857142857142857,6,1,5,370.6266576034516,0.38683712121212116,0.06779440609456078,0.2216099095249719,132114.37795859767,3193.022064830835,135307.40002342852,574,8,326.27272727272725,33,0,19,33.458373067906386,0.6480429292929293,42.98406862745098,1028.0637254901962,31.153446226975642,0
580,4,2,2,33,0.05714285714285714,0.05714285714285714,0.9428571428571428,35,1350,1000,350,0.7407407407407407,17,10,7,353.3611894642894,0.3933473389355742,0.05870287447638356,0.2144013597424429,132666.15125868047,2375.8138020833276,135041.9650607638,575,0,308.57142857142856,35,0,18,33.34702561509944,0.6491071428571429,42.447916666666664,1030.2083333333328,29.434523809523796,0
581,4,0,0,33,0.0,0.0,1.0,33,1050,900,150,0.8571428571428571,12,9,3,371.2566998311727,0.3843118686868687,0.0787633419212368,0.2236595240446332,132398.00347222213,3230.7291666666565,135628.7326388888,576,10,328.27272727272725,33,0,20,33.156207827260474,0.6508838383838385,42.70833333333333,1029.1666666666658,31.18686868686866,0
582,4,0,0,33,0.0,0.0,1.0,33,700,500,200,0.7142857142857143,9,5,4,368.2299230309405,0.38435132575757575,0.07260318937500232,0.22239393122810427,132492.61289227701,3157.5489294982704,135650.16182177528,577,11,329.27272727272725,33,0,21,33.13878804110622,0.6518308080808082,42.61642156862745,1029.5343137254902,31.198009506833035,0
583,4,0,0,33,0.0,0.0,1.0,33,600,400,200,0.6666666666666666,8,4,4,366.8197135071121,0.3847064393939394,0.065964897096636,0.22191404266380585,132555.70461180792,3124.8091178873506,135680.51372969526,578,12,330.27272727272725,33,0,21,33.11156233884726,0.6524621212121213,42.55514705882353,1029.7794117647056,31.205436720142593,0
584,4,0,0,33,0.0,0.0,1.0,33,1050,800,250,0.7619047619047619,13,8,5,368.46401045399796,0.38450915404040403,0.07108073719231078,0.22365898454056019,132681.93310565632,3177.703437379834,135859.63654303615,579,13,331.27272727272725,33,0,18,32.94216625034693,0.6537247474747476,42.43259803921568,1030.269607843136,31.2202911467617,0
585,4,0,0,33,0.0,0.0,1.0,33,800,700,100,0.875,9,7,2,369.29308324480303,0.38446969696969696,0.07251687004391805,0.2249184737995681,132808.22167255374,3209.03153234332,136017.25320489708,580,14,332.27272727272725,33,0,19,32.79373736773272,0.6549873737373737,42.31004901960784,1030.759803921568,31.235145573380848,0
586,4,0,0,33,0.0,0.0,1.0,33,1050,1000,50,0.9523809523809523,11,10,1,370.685721875439,0.3843907828282828,0.06805042585513021,0.22710570645905734,133029.371215398,3262.4176999231177,136291.7889153211,581,15,333.27272727272725,33,0,20,32.535439930308065,0.6571969696969696,42.09558823529412,1031.617647058824,31.261140819964368,0
587,4,1,2,32,0.029411764705882353,0.058823529411764705,0.9411764705882353,34,800,700,100,0.875,9,7,2,359.3672183228149,0.38833184789067143,0.06430857266834833,0.22207051183538046,133349.23469387754,2784.2687074829914,136133.50340136053,582,0,324.44117647058823,34,0,21,32.50633932687875,0.6580882352941178,41.785714285714285,1032.8571428571427,30.378151260504197,0
588,4,1,1,32,0.030303030303030304,0.030303030303030304,0.9696969696969697,33,900,700,200,0.7777777777777778,11,7,4,366.3784307337389,0.386758207070707,0.06310223900728351,0.22580382435491972,133250.70473195417,3164.036818771644,136414.74155072583,583,0,322.8787878787879,33,0,21,32.42420870425321,0.6594065656565655,41.8811274509804,1032.4754901960794,31.28713606654786,0
589,4,0,0,32,0.0,0.0,1.0,32,900,700,200,0.7777777777777778,11,7,4,376.0451140476388,0.3853956653225807,0.06723623853210992,0.23131443245594058,133178.82303145106,3616.249139118476,136795.07217056953,584,2,333.96875,32,0,21,32.24694189602447,0.6611328125,41.950757575757585,1032.196969696971,32.25615530303035,0
590,4,0,0,32,0.0,0.0,1.0,32,700,400,300,0.5714285714285714,10,4,6,375.33191693908105,0.38545866935483875,0.06910308143800448,0.23148298768686337,133276.58689164388,3604.5913682277533,136881.17825987164,585,3,334.96875,32,0,21,32.16709464416729,0.662109375,41.856060606060616,1032.5757575757589,32.267992424242465,0
591,4,0,0,32,0.0,0.0,1.0,32,800,500,300,0.625,11,5,6,377.7824304860504,0.38451360887096775,0.06996012101210125,0.23360831925974174,133374.386621901,3677.2999885216013,137051.68661042262,586,4,335.96875,32,0,21,32.005561667277846,0.6630859375,41.76136363636365,1032.9545454545469,32.27982954545459,0
592,4,0,0,32,0.0,0.0,1.0,32,850,600,250,0.7058823529411765,11,6,5,376.23569198751267,0.3836525537634408,0.0675403225806448,0.23326612903225807,133472.2222222223,3643.402777777788,137115.6250000001,587,5,336.96875,32,0,22,31.947244623655898,0.6640625,41.66666666666667,1033.3333333333342,32.29166666666669,0
593,4,0,0,32,0.0,0.0,1.0,32,900,700,200,0.7777777777777778,11,7,4,378.17419433064333,0.38421959005376344,0.0704126969585932,0.23508824062148656,133570.09369260797,3702.552513774116,137272.64620638208,588,6,337.96875,32,0,22,31.798888481739358,0.6650390625,41.5719696969697,1033.7121212121217,32.3035037878788,0
594,4,1,0,33,0.030303030303030304,0.0,1.0,33,600,600,0,1.0,6,6,0,371.2263484581911,0.386679292929293,0.0719809103468072,0.23273990443425588,133884.09994052778,3340.261107506738,137224.3610480345,589,0,328.6969696969697,33,0,18,31.663582987961313,0.6657196969696969,41.26838235294118,1034.926470588236,31.361408199643517,0
595,4,0,0,33,0.0,0.0,1.0,33,550,500,50,0.9090909090909091,6,5,1,373.82556061052344,0.3871133207070707,0.07635488303180948,0.2347735695522002,133947.52206182727,3414.6015054306117,137362.1235672579,590,1,329.6969696969697,33,0,18,31.532768043881457,0.6663510101010102,41.20710784313726,1035.1715686274515,31.368835412953075,0
596,4,0,0,33,0.0,0.0,1.0,33,650,500,150,0.7692307692307693,8,5,3,375.81969824978654,0.3871133207070707,0.10733116163481915,0.2206819789939636,131425.20732897156,3288.982926792701,134714.19025576426,591,2,330.6969696969697,32,1,21,34.02136436399459,0.6435546875,43.65530303030303,1025.378787878788,32.043087121212125,4
597,4,0,0,33,0.0,0.0,1.0,33,850,600,250,0.7058823529411765,11,6,5,375.2521345266908,0.3869160353535353,0.10095538668725901,0.2207221642838749,131489.94880943283,3268.3767919090014,134758.3256013418,592,3,331.6969696969697,32,1,21,33.97041322992326,0.6442057291666666,43.59217171717172,1025.631313131314,32.050978535353565,0
598,4,0,0,33,0.0,0.0,1.0,33,500,300,200,0.6,7,3,4,376.79832085945867,0.3871133207070707,0.1065342074448643,0.22219616511639792,131587.09092184482,3316.3589812264204,134903.44990307125,593,4,332.6969696969697,32,1,19,33.832502666338506,0.6451822916666666,43.497474747474755,1026.010101010102,32.06281565656569,0
599,4,0,0,33,0.0,0.0,1.0,33,650,500,150,0.7692307692307693,8,5,3,375.4685732027714,0.3870344065656566,0.10779050345979457,0.22178841300814864,131651.87225793285,3286.2281272319124,134938.10038516475,594,5,333.6969696969697,32,1,19,33.8011093339895,0.6458333333333334,43.43434343434343,1026.262626262626,32.070707070707066,0
600,4,0,1,32,0.0,0.030303030303030304,0.9696969696969697,33,900,600,300,0.6666666666666666,12,6,6,374.2866664746614,0.3868765782828283,0.1133443973200563,0.22231726093013035,131862.52170138896,3270.8767361111213,135133.3984375001,595,6,334.6969696969697,33,0,21,33.61857674104125,0.6455176767676767,43.22916666666667,1027.083333333334,31.12373737373739,0
601,4,0,0,32,0.0,0.0,1.0,32,700,400,300,0.5714285714285714,10,4,6,382.89944881419194,0.3873907930107527,0.11032802508607964,0.22694885697937395,131781.48275686166,3691.811422303863,135473.29417916553,596,7,333.09375,32,0,21,33.47936137071652,0.6471354166666665,43.30808080808082,1026.7676767676778,32.08648989898993,0
602,4,0,0,32,0.0,0.0,1.0,32,1150,1000,150,0.8695652173913043,13,10,3,386.59073722584316,0.3883358534946237,0.10430364384908453,0.23011622741819215,131943.58555568318,3801.633602438543,135745.21915812173,597,8,334.09375,32,0,21,33.22067920199911,0.6487630208333333,43.15025252525253,1027.3989898989907,32.10621843434346,0
603,4,0,0,32,0.0,0.0,1.0,32,600,500,100,0.8333333333333334,7,5,2,388.69509708969366,0.3874957997311828,0.11742645252425965,0.23216190648622162,132073.33953486907,3867.2519066932186,135940.59144156228,598,9,335.09375,32,0,21,33.035458379396474,0.6500651041666665,43.02398989898991,1027.9040404040418,32.122001262626306,0
604,4,0,0,32,0.0,0.0,1.0,32,550,200,350,0.36363636363636365,9,2,7,386.7307756011705,0.38743279569892475,0.11348563006632273,0.23118663545849727,132105.7879935722,3817.8747704316033,135923.6627640038,599,10,336.09375,32,0,21,33.053150331613864,0.650390625,42.99242424242425,1028.030303030304,32.125946969697,0
605,4,0,0,32,0.0,0.0,1.0,32,450,300,150,0.6666666666666666,6,3,3,386.3864607014792,0.3870547715053763,0.10737966601178783,0.23137730411418025,132170.69686766673,3813.793554229186,135984.49042189593,600,11,337.09375,32,0,21,32.99642886378521,0.6510416666666665,42.92929292929294,1028.2828282828298,32.13383838383843,0
606,4,0,0,32,0.0,0.0,1.0,32,750,700,50,0.9333333333333333,8,7,1,409.41322971592433,0.38730678763440857,0.0821391080290117,0.237109695824425,130894.72664727096,4395.0116147703975,135289.73826204136,601,12,338.09375,31,1,19,33.699288501505706,0.6407930107526882,44.17317708333333,1023.3072916666658,33.00991263440857,8
607,4,0,1,31,0.0,0.03125,0.96875,32,750,600,150,0.8,9,6,3,411.15850915296846,0.38661374327956993,0.08584211986681467,0.23900246241730616,131037.09323347104,4375.403179522493,135412.49641299353,602,13,339.09375,32,0,19,33.50983475151067,0.6396484375,44.03409090909091,1023.863636363636,31.995738636363626,0
608,4,2,2,31,0.06060606060606061,0.06060606060606061,0.9393939393939394,33,1000,700,300,0.7,13,7,6,400.67692617787856,0.38892834595959597,0.08302453102453078,0.23529685262123734,131428.24172973624,3932.698443003799,135360.94017274003,603,0,327.90909090909093,31,2,19,33.38108465608465,0.6461693548387097,43.65234374999999,1025.3906249999993,33.07711693548385,0
609,4,0,0,31,0.0,0.0,1.0,31,750,500,250,0.6666666666666666,10,5,5,418.65782602071147,0.37979390681003583,0.0997477595718066,0.24372641018896307,131094.6676466198,4776.761711968294,135871.4293585881,604,15,350.06451612903226,31,0,19,33.25929752066117,0.6428091397849464,43.97786458333332,1024.0885416666652,33.03511424731178,0
610,4,1,1,31,0.03125,0.03125,0.96875,32,1200,800,400,0.6666666666666666,16,8,8,405.2898127944191,0.3852276545698925,0.0925497045426571,0.23839023528812942,131489.94880943268,4258.307347464544,135748.25615689723,605,0,340.09375,32,0,19,33.20022364479462,0.6442057291666667,43.592171717171716,1025.631313131313,32.05097853535353,0
611,4,0,0,31,0.0,0.0,1.0,31,1100,800,300,0.7272727272727273,14,8,6,421.2758395041891,0.3780913978494624,0.10799652681072769,0.24760959044290987,131461.62245008675,4876.321072048608,136337.94352213535,606,17,352.06451612903226,31,0,19,32.81911291687828,0.646505376344086,43.619791666666664,1025.520833333333,33.081317204301065,0
612,4,0,0,31,0.0,0.0,1.0,31,800,600,200,0.75,10,6,4,419.0265144682936,0.37688172043010754,0.11370558375634543,0.24715036931213707,131595.18771701382,4828.3745659722135,136423.56228298604,607,18,353.06451612903226,31,0,17,32.74111675126905,0.6478494623655915,43.48958333333333,1026.041666666666,33.098118279569874,0
613,4,0,0,31,0.0,0.0,1.0,31,850,600,250,0.7058823529411765,11,6,5,425.7996592271577,0.37634408602150543,0.11628125856784544,0.251806355115355,131695.40617201055,5015.171813964836,136710.5779859754,608,19,354.06451612903226,31,0,17,32.46556408304791,0.6488575268817205,43.39192708333333,1026.432291666666,33.11071908602148,0
614,4,0,0,31,0.0,0.0,1.0,31,850,700,150,0.8235294117647058,10,7,3,425.8804885674631,0.37629928315412187,0.11571343254276711,0.2525183107400761,131795.66277397997,5025.840250651033,136821.503024631,609,20,355.06451612903226,31,0,18,32.36167469777666,0.6498655913978495,43.29427083333333,1026.822916666666,33.1233198924731,0
615,4,0,0,31,0.0,0.0,1.0,31,800,600,200,0.75,10,6,4,427.861567977208,0.3758512544802867,0.11910166586911108,0.2539160411313948,131829.0901184081,5080.920240614137,136910.0103590222,610,21,356.06451612903226,31,0,18,32.27687439246017,0.650201612903226,43.26171874999999,1026.953124999999,33.12752016129029,0
616,4,0,0,31,0.0,0.0,1.0,31,950,700,250,0.7368421052631579,12,7,5,427.19780784944624,0.37643369175627245,0.11568409343715236,0.25374520393949007,131862.5217013888,5066.276041666649,136928.79774305545,611,22,357.06451612903226,31,0,18,32.25997295469911,0.6505376344086022,43.22916666666666,1027.0833333333323,33.13172043010749,0
617,4,0,0,31,0.0,0.0,1.0,31,900,600,300,0.6666666666666666,12,6,6,425.1814798215645,0.37692652329749105,0.1083282227400959,0.2529925999843244,131929.3975830077,5018.78729926214,136948.18488226982,612,23,358.06451612903226,31,0,19,32.24387410223913,0.651209677419355,43.16406249999999,1027.343749999999,33.14012096774191,0
618,4,0,0,31,0.0,0.0,1.0,31,700,400,300,0.5714285714285714,10,4,6,424.0536702018022,0.37746415770609315,0.10567141975535699,0.25298984269862623,132029.7431945801,4997.539435492624,137027.28263007273,613,24,359.06451612903226,31,0,20,32.171042907217355,0.6522177419354838,43.06640625,1027.7343750000002,33.15272177419356,0
619,4,0,0,31,0.0,0.0,1.0,31,800,600,200,0.75,10,6,4,422.01364687120815,0.37697132616487455,0.1030427356015593,0.25199513830569725,132063.20020887585,4946.494547526039,137009.69475640188,614,25,360.06451612903226,31,0,20,32.18953213411028,0.6525537634408602,43.033854166666664,1027.8645833333333,33.15692204301075,0
620,4,0,1,30,0.0,0.03225806451612903,0.967741935483871,31,900,600,300,0.6666666666666666,12,6,6,421.3092723565036,0.3765681003584229,0.0990695888710087,0.2524659053923871,132197.07065158404,4939.170328776019,137136.24098036007,615,26,361.06451612903226,31,0,20,32.071938043386496,0.6538978494623657,42.90364583333332,1028.3854166666654,33.173723118279526,0
621,4,0,0,30,0.0,0.0,1.0,30,900,600,300,0.6666666666666666,12,6,6,429.2718622423225,0.3709530651340996,0.10788361862450402,0.2576641224894504,132259.71075052023,5355.0744667013405,137614.78521722156,616,27,373.0,30,0,20,31.803704429635438,0.6572916666666667,42.842741935483865,1028.629032258064,34.28763440860213,0
622,4,0,0,30,0.0,0.0,1.0,30,650,300,350,0.46153846153846156,10,3,7,425.7327193516566,0.3711206896551724,0.09931226603987109,0.2567134775429122,132432.58794369287,5276.177159209152,137708.76510290202,617,28,374.0,30,0,20,31.71955253765126,0.6590277777777779,42.674731182795696,1029.301075268817,34.3100358422939,0
623,4,0,0,30,0.0,0.0,1.0,30,700,500,200,0.7142857142857143,9,5,4,425.48793706412914,0.3710249042145594,0.09820713664055702,0.25703766545041223,132501.77043588844,5275.580992022187,137777.35142791062,618,29,375.0,30,0,20,31.655787641427327,0.6597222222222222,42.607526881720425,1029.5698924731175,34.318996415770584,0
624,4,0,0,30,0.0,0.0,1.0,30,800,500,300,0.625,11,5,6,423.8756110165661,0.3705699233716475,0.10156637514684763,0.256299215153742,132536.36845661345,5235.786832292743,137772.1552889062,619,30,376.0,30,0,20,31.662261236566156,0.6600694444444444,42.57392473118279,1029.7043010752684,34.32347670250895,0
625,4,0,0,30,0.0,0.0,1.0,30,750,600,150,0.8,9,6,3,426.83154383915684,0.36973180076628354,0.10274008350730668,0.2588003917708305,132640.18961729674,5323.003381893853,137963.1929991906,620,31,377.0,30,0,18,31.481058629088373,0.6611111111111112,42.47311827956989,1030.10752688172,34.336917562724004,0
626,4,0,0,30,0.0,0.0,1.0,30,800,700,100,0.875,9,7,2,426.8126015653026,0.3693726053639847,0.09935638182213502,0.2590276002373747,132674.80570369403,5325.455796912935,138000.26150060695,621,32,378.0,30,0,18,31.446510110893673,0.6614583333333334,42.439516129032256,1030.2419354838707,34.34139784946236,0
627,4,1,1,30,0.03225806451612903,0.03225806451612903,0.967741935483871,31,1050,800,250,0.7619047619047619,13,8,5,415.3700887834103,0.37634408602150543,0.0811262470248646,0.24728107154675916,131948.81633714875,4763.907496531382,136712.72383368012,622,0,366.7741935483871,30,1,17,32.476179574393875,0.6541666666666666,43.14516129032258,1027.419354838709,34.24731182795697,4
628,4,0,0,30,0.0,0.0,1.0,30,800,500,300,0.625,11,5,6,427.62533732501237,0.3699233716475096,0.08820346320346317,0.2532857767232767,131755.55555555562,5268.402777777783,137023.9583333334,623,34,380.0,29,1,17,32.35761634199134,0.6551724137931034,43.333333333333336,1026.6666666666672,35.40229885057473,0
629,4,0,0,30,0.0,0.0,1.0,30,800,400,400,0.5,12,4,8,427.1622040283131,0.3690613026819924,0.0836712625033793,0.2544400954429517,131969.53125,5274.479166666668,137244.01041666666,624,35,381.0,29,1,17,32.15227088402272,0.6573275862068966,43.125,1027.5,35.43103448275862,0
630,4,0,0,30,0.0,0.0,1.0,30,550,500,50,0.9090909090909091,6,5,1,427.02702702702715,0.3688218390804598,0.08108108108108136,0.2548387096774194,132040.8950617284,5277.00617283951,137317.90123456792,625,36,382.0,29,1,17,32.08333333333334,0.6580459770114943,43.05555555555556,1027.7777777777778,35.440613026819925,0
631,4,1,0,31,0.03225806451612903,0.0,1.0,31,800,500,300,0.625,11,5,6,417.0960741429091,0.37325268817204305,0.08351171114710554,0.22904246475661316,128813.3704668209,4593.735532407394,133407.10599922828,626,0,370.64516129032256,29,2,18,35.63001664614403,0.6253591954022989,46.21527777777777,1015.1388888888881,35.00478927203063,7
632,4,1,0,32,0.03125,0.0,1.0,32,800,500,300,0.625,11,5,6,405.4421647809823,0.3802293346774193,0.08268995503240317,0.2242537094300662,129098.92265363043,4068.4293343160975,133167.35198794655,627,0,360.03125,30,2,19,35.63323854869285,0.6253472222222223,45.93413978494623,1016.2634408602147,33.87544802867382,0
633,4,0,0,32,0.0,0.0,1.0,32,800,500,300,0.625,11,5,6,404.9021258521898,0.3802083333333333,0.08407167416027472,0.22414859997761785,129133.07354896521,4057.25119956064,133190.32474852586,628,1,361.03125,30,2,20,35.61199638543594,0.6256944444444444,45.9005376344086,1016.3978494623657,33.87992831541219,0
634,4,1,1,32,0.030303030303030304,0.030303030303030304,0.9696969696969697,33,1250,1000,250,0.8,15,10,5,392.5457864417834,0.3801688762626263,0.07724411685853694,0.21939108787628203,129509.0314812404,3567.6629884957524,133076.69446973616,629,0,351.06060606060606,30,3,18,35.54183722875126,0.6295138888888889,45.53091397849461,1017.8763440860198,33.929211469533996,0
635,4,2,2,32,0.058823529411764705,0.058823529411764705,0.9411764705882353,34,800,400,400,0.5,12,4,8,385.63415036612656,0.3868464052287582,0.07005109068779314,0.21719841085868838,129811.85154894892,3211.976615906518,133023.82816485543,630,0,341.6764705882353,32,2,18,35.40892289266096,0.6272786458333335,45.23358585858585,1019.0656565656552,31.845801767676726,0
636,4,0,0,32,0.0,0.0,1.0,32,900,700,200,0.7777777777777778,11,7,4,406.9000318809825,0.37869623655913975,0.09248705077375607,0.22774168570346454,129565.68611992718,4144.056362575937,133709.74248250312,631,4,364.03125,31,1,18,35.11864795157095,0.6273521505376345,45.47526041666666,1018.0989583333323,32.841901881720396,0
637,4,0,0,32,0.0,0.0,1.0,32,850,500,350,0.5882352941176471,12,5,7,409.02781241596443,0.37798219086021506,0.0938618782764351,0.2293194638641759,129631.97708129861,4204.616800943983,133836.5938822426,632,5,365.03125,31,1,18,34.99672356476153,0.6280241935483872,45.410156249999986,1018.3593749999983,32.85030241935478,0
638,4,0,0,32,0.0,0.0,1.0,32,950,600,350,0.631578947368421,13,6,7,408.767717044741,0.37722614247311825,0.0888445928671866,0.22956136758370468,129698.28499688026,4203.294372558571,133901.57936943884,633,6,366.03125,31,1,19,34.935579913929004,0.62869623655914,45.34505208333332,1018.6197916666653,32.858702956989205,0
639,4,0,0,32,0.0,0.0,1.0,32,1050,900,150,0.8571428571428571,12,9,3,413.80202050118254,0.37802419354838707,0.09082742430049828,0.23317699168198394,129830.95169067386,4344.862026638455,134175.81371731233,634,7,367.03125,31,1,19,34.67178250500403,0.6300403225806452,45.21484375,1019.1406250000002,32.87550403225807,0
640,4,1,1,32,0.030303030303030304,0.030303030303030304,0.9696969696969697,33,800,500,300,0.625,11,5,6,402.57388981472394,0.38257575757575757,0.05504050405040495,0.22842675770386034,130101.52025303549,3875.0950158147243,133976.6152688502,635,0,356.8787878787879,32,1,20,34.68182755775579,0.6302083333333333,44.949494949494955,1020.2020202020209,31.881313131313153,2
641,4,0,0,32,0.0,0.0,1.0,32,1050,800,250,0.7619047619047619,13,8,5,408.6032528715007,0.378885248655914,0.05477358548966227,0.2312745951957331,130004.92814827574,4224.087306142241,134229.01545441797,636,9,369.03125,32,0,20,34.62661466716191,0.6292317708333333,45.044191919191924,1019.8232323232327,31.86947601010102,0
642,4,1,1,32,0.030303030303030304,0.030303030303030304,0.9696969696969697,33,750,500,250,0.6666666666666666,10,5,5,398.0674743988237,0.386166351010101,0.04050894703713692,0.22737074385153147,130359.27456381998,3778.6125140291774,134137.88707784915,637,0,358.8181818181818,32,1,20,34.53418644906034,0.6328125,44.696969696969695,1021.2121212121209,31.91287878787878,0
643,4,1,1,32,0.030303030303030304,0.030303030303030304,0.9696969696969697,33,1050,800,250,0.7619047619047619,13,8,5,398.4138180870904,0.3847064393939394,0.057048927430739305,0.22851616086313412,130520.500538848,3800.234191664111,134320.7347305121,638,0,359.7878787878788,32,1,19,34.36122781004162,0.6344401041666667,44.53914141414141,1021.8434343434337,31.932607323232304,0
644,4,1,1,32,0.030303030303030304,0.030303030303030304,0.9696969696969697,33,1000,800,200,0.8,12,8,4,396.8391403870142,0.38328598484848486,0.05924395847833752,0.2285635390365603,130681.8261529434,3771.9327109478413,134453.75886389124,639,0,360.42424242424244,32,1,19,34.23736313493044,0.6360677083333335,44.38131313131312,1022.474747474746,31.952335858585812,0
645,4,1,0,33,0.030303030303030304,0.0,1.0,33,850,600,250,0.7058823529411765,11,6,5,404.66472303206956,0.3824179292929293,0.0811379097093381,0.23056478405315634,130262.58680555585,3942.5347222222604,134205.1215277781,640,0,361.3939393939394,32,1,22,34.464285714285715,0.6318359374999998,44.791666666666686,1020.8333333333358,31.901041666666742,1
646,4,1,1,33,0.029411764705882353,0.029411764705882353,0.9705882352941176,34,600,400,200,0.6666666666666666,8,4,4,399.07766062443307,0.3894273618538324,0.08022017948624804,0.22927847145172375,130585.01882779822,3622.712765279058,134207.73159307727,641,0,351.7352941176471,32,2,18,34.27861848877909,0.6350911458333333,44.476010101010104,1022.0959595959599,31.940498737373748,0
647,4,0,1,32,0.0,0.030303030303030304,0.9696969696969697,33,800,700,100,0.875,9,7,2,424.1584036476426,0.38202335858585856,0.16368089714783118,0.22001563765090817,126516.66964750257,4145.120451120103,130661.79009862267,642,2,363.3939393939394,30,3,18,37.81980627922512,0.5989583333333334,48.48790322580645,1006.0483870967739,33.53494623655913,6
648,4,3,2,33,0.08571428571428572,0.05714285714285714,0.9428571428571428,35,700,500,200,0.7142857142857143,9,5,4,403.3146900511804,0.3957282913165266,0.15909393737508304,0.21271094510429447,127193.6807181467,3262.426472713615,130456.10719086032,643,0,343.48571428571427,30,5,19,37.64490339773484,0.6059027777777778,47.81586021505377,1008.7365591397856,33.62455197132619,0
649,4,1,2,32,0.029411764705882353,0.058823529411764705,0.9411764705882353,34,1450,1100,350,0.7586206896551724,18,11,7,410.8775519610318,0.391506981580511,0.17561220523451726,0.2169051262678003,127232.0987654319,3655.3626543209607,130887.46141975286,644,0,354.55882352941177,29,5,21,37.41453285609398,0.6091954022988506,47.777777777777764,1008.8888888888873,34.78927203065129,0
650,4,2,1,33,0.058823529411764705,0.029411764705882353,0.9705882352941176,34,550,400,150,0.7272727272727273,7,4,3,398.2276164583144,0.4004567736185383,0.16555270325266846,0.211974416805998,127566.80685628398,3360.1250867152253,130926.9319429992,645,0,341.2352941176471,30,4,19,37.3888482348767,0.6097222222222223,47.446236559139784,1010.2150537634409,33.67383512544803,0
651,4,4,2,35,0.10810810810810811,0.05405405405405406,0.9459459459459459,37,1150,900,250,0.782608695652174,14,9,5,367.728893753286,0.41435185185185186,0.1697136273407458,0.2005513042402373,128540.34423828113,2056.2102075339126,130596.55444581504,646,0,314.4594594594595,31,6,17,37.16187296695771,0.6169354838709677,46.48437499999999,1014.0624999999991,32.71169354838707,0
652,4,3,2,36,0.07894736842105263,0.05263157894736842,0.9473684210526316,38,1000,600,400,0.6,14,6,8,360.3880570803887,0.4168296586059744,0.17570845318145145,0.19875293447367542,128983.44574502592,1696.8186815167228,130680.26442654265,647,0,307.10526315789474,33,5,18,36.89565991072505,0.6164772727272727,46.04779411764706,1015.8088235294116,30.782085561497322,0
653,4,2,2,36,0.05263157894736842,0.05263157894736842,0.9473684210526316,38,1200,900,300,0.75,15,9,6,363.0115543029673,0.4117028212422949,0.19001346176466782,0.20163414195559265,129265.58036169756,1785.163822707007,131050.74418440457,648,0,308.05263157894734,32,6,19,36.54136660872445,0.6217447916666667,45.77020202020201,1016.9191919191901,31.77872474747469,0
654,4,4,3,37,0.1,0.075,0.925,40,800,600,200,0.75,10,6,4,344.9605314874662,0.4171340811965812,0.17643107476635533,0.1942672466797834,129807.25623582749,955.6760204081401,130762.93225623562,649,0,293.475,34,6,18,36.44981503115264,0.6225490196078433,45.23809523809523,1019.0476190476177,29.97198879551817,0
655,4,1,1,37,0.02631578947368421,0.02631578947368421,0.9736842105263158,38,1150,900,250,0.782608695652174,14,9,5,358.720636692177,0.41096194879089615,0.18818530701754366,0.2008835565476189,129586.776859504,1697.0902203856579,131283.86707988966,650,0,309.89473684210526,32,6,18,36.32347470238096,0.625,45.454545454545446,1018.181818181817,31.81818181818178,0
656,4,1,0,38,0.02631578947368421,0.0,1.0,38,850,500,350,0.5882352941176471,12,5,7,357.3618917429558,0.41222143195827404,0.19534475673630625,0.2009444672107255,129747.52456700851,1673.364165646359,131420.8887326549,651,0,310.86842105263156,32,6,19,36.19459247325153,0.6266276041666667,45.29671717171717,1018.8131313131316,31.837910353535364,0
657,4,1,0,39,0.02564102564102564,0.0,1.0,39,1050,800,250,0.7619047619047619,13,8,5,347.5821565779352,0.41551394511920825,0.18704823174902518,0.19677406170350858,130012.50270328713,1238.0052143406292,131250.50791762775,652,0,303.87179487179486,33,6,21,36.17469758872066,0.6268939393939394,45.03676470588235,1019.85294117647,30.904634581105153,0
658,4,0,0,39,0.0,0.0,1.0,39,1150,800,350,0.6956521739130435,15,8,7,348.49018387757127,0.4150641025641026,0.19244475244475256,0.19776283440905112,130106.25608239608,1268.150621155311,131374.4067035514,653,1,304.87179487179486,33,6,22,36.05643143143143,0.6278409090909092,44.944852941176464,1020.2205882352932,30.915775401069492,0
659,4,0,0,39,0.0,0.0,1.0,39,350,300,50,0.8571428571428571,4,3,1,347.2659636839792,0.41438933873144396,0.19429535677884457,0.19738455150829287,130168.77710796305,1240.6371647923572,131409.4142727554,654,2,305.87179487179486,33,6,22,36.02425343260877,0.6284722222222223,44.883578431372534,1020.4656862745079,30.923202614379026,0
660,4,0,0,39,0.0,0.0,1.0,39,1250,1000,250,0.8,15,10,5,348.69640592326766,0.4143049932523617,0.19860408434580323,0.1989957845310045,130325.14537677809,1288.78195886197,131613.92733564007,655,3,306.87179487179486,33,6,23,35.82923267722836,0.630050505050505,44.73039215686274,1021.0784313725484,30.94177064765298,0
661,4,1,1,39,0.025,0.025,0.975,40,1200,1000,200,0.8333333333333334,14,10,4,340.0589445958021,0.4151442307692308,0.18934894013510362,0.19543146574963557,130597.00255102033,882.1357709750447,131479.1383219954,656,0,300.175,34,6,16,35.77456518363226,0.630514705882353,44.46428571428571,1022.1428571428565,30.063025210084017,0
662,4,1,2,38,0.025,0.05,0.95,40,1350,1100,250,0.8148148148148148,16,11,5,338.76490494817415,0.41631944444444446,0.19145716945996338,0.19560941285717165,130779.59183673478,860.7071995464987,131640.29903628127,657,0,301.15,34,6,17,35.62301171632528,0.6323529411764706,44.28571428571429,1022.8571428571435,30.084033613445396,0
663,4,1,0,39,0.02564102564102564,0.0,1.0,39,900,600,300,0.6666666666666666,12,6,6,356.08707336737484,0.4150641025641026,0.2356031946195889,0.197466467958271,129201.38888888856,1411.3414115645865,130612.73030045314,658,0,309.6923076923077,33,6,20,36.782786885245905,0.6186868686868688,45.833333333333314,1016.666666666664,30.808080808080728,3
664,4,1,1,39,0.025,0.025,0.975,40,1500,1100,400,0.7333333333333333,19,11,8,344.00913927771217,0.4173611111111111,0.22431802682427815,0.1927765864563891,129613.56122470838,917.649927126185,130531.21115183456,659,0,302.925,35,5,18,36.67073956202167,0.618452380952381,45.42824074074073,1018.287037037036,29.093915343915317,0
665,4,1,0,40,0.025,0.0,1.0,40,1050,600,450,0.5714285714285714,15,6,9,344.0620249687127,0.41792200854700856,0.2287900552486184,0.19388302154214515,129831.84831791249,934.0417275383452,130765.89004545084,660,0,303.9,36,4,21,36.44774401473296,0.6186342592592593,45.21396396396396,1019.1441441441441,28.30955955955956,0
666,4,0,1,39,0.0,0.025,0.975,40,1100,900,200,0.8181818181818182,13,9,4,344.6975786312729,0.418349358974359,0.23037765017667877,0.1950988295053004,130004.05811216615,962.4168087005876,130966.47492086673,661,1,304.9,36,4,21,36.25680948174323,0.6203703703703705,45.04504504504504,1019.8198198198193,28.32832832832831,0
667,4,0,0,39,0.0,0.0,1.0,39,600,400,200,0.6666666666666666,8,4,4,348.3540141800481,0.41483918128654973,0.23250967723158467,0.19698323908383938,129967.37423911154,1254.931305726994,131222.30554483854,662,2,313.3333333333333,35,4,21,36.20081346954219,0.6220238095238096,45.081018518518505,1019.6759259259238,29.133597883597822,0
668,4,0,0,39,0.0,0.0,1.0,39,950,700,250,0.7368421052631579,12,7,5,351.7248954341083,0.41458614484930273,0.2374231540236309,0.1993409326984435,130055.90284475735,1348.779765732165,131404.68261048952,663,3,314.3333333333333,35,4,21,36.02502458489353,0.6229166666666666,44.99421296296296,1020.0231481481479,29.143518518518512,0
669,4,3,2,40,0.07142857142857142,0.047619047619047616,0.9523809523809523,42,800,600,200,0.75,10,6,4,328.824541590041,0.42346593108788233,0.22554335339796872,0.1896689238967417,130738.73842191831,198.18524593809,130936.9236678564,664,0,292.8095238095238,37,5,16,35.91845806082698,0.6258445945945945,44.32565789473684,1022.6973684210529,27.640469416785216,0
670,4,0,0,40,0.0,0.0,1.0,40,1050,800,250,0.7619047619047619,13,8,5,343.61360822312497,0.41686698717948717,0.23793611236973256,0.1969753852853081,130498.99798525365,968.2463134430532,131467.2442986967,665,1,308.45,35,5,16,35.78292553994865,0.6273809523809524,44.560185185185176,1021.7592592592582,29.193121693121665,0
671,4,0,0,40,0.0,0.0,1.0,40,1150,800,350,0.6956521739130435,15,8,7,344.351028356303,0.4170673076923077,0.23779306829765545,0.19754874784651053,130528.56445312488,989.5290798610954,131518.09353298598,666,2,309.45,35,5,16,35.73415732246008,0.6276785714285715,44.53124999999999,1021.8749999999991,29.196428571428545,0
672,4,0,0,40,0.0,0.0,1.0,40,1150,800,350,0.6956521739130435,15,8,7,341.51996691871426,0.4166399572649573,0.234103260869565,0.19637398097826078,130617.2839506173,921.6820987654287,131538.96604938273,667,3,310.45,35,5,17,35.71671195652172,0.6285714285714286,44.44444444444444,1022.2222222222224,29.206349206349213,0
673,4,0,0,40,0.0,0.0,1.0,40,950,700,250,0.7368421052631579,12,7,5,342.9302038391443,0.416159188034188,0.24270031688546867,0.1977892481150574,130735.62349965704,966.6388031550038,131702.26230281204,668,4,311.45,35,5,18,35.56096272823298,0.6297619047619047,44.3287037037037,1022.685185185185,29.219576719576715,0
674,4,3,2,41,0.06976744186046512,0.046511627906976744,0.9534883720930233,43,950,700,250,0.7368421052631579,12,7,5,321.84858487251955,0.42243447766703585,0.2272803274279025,0.18891626110223667,131410.2692513149,-141.15816074950465,131269.1110905654,669,0,290.6511627906977,38,5,19,35.4199228925706,0.6307565789473684,43.669871794871796,1025.3205128205127,26.982118758434545,0
675,4,0,0,41,0.0,0.0,1.0,41,1100,800,300,0.7272727272727273,14,8,6,337.07735312402434,0.41562499999999997,0.24166052105820657,0.196394524449904,131126.20380092924,639.9347404837174,131766.13854141298,670,1,305.8292682926829,36,5,19,35.31610775151182,0.6316550925925927,43.94707207207207,1024.2117117117111,28.45032532532531,0
676,4,0,0,41,0.0,0.0,1.0,41,1100,700,400,0.6363636363636364,15,7,8,333.6448046655097,0.41534552845528455,0.2375438523220852,0.19484856592465755,131215.75869498297,555.8912357648419,131771.6499307478,671,2,306.8292682926829,37,4,20,35.31365938926942,0.6306306306306306,43.859649122807014,1024.561403508771,27.6908487434803,0
677,4,0,0,41,0.0,0.0,1.0,41,1400,900,500,0.6428571428571429,19,9,10,333.99940377441453,0.4156504065040651,0.2373112053651567,0.19577569688077884,131356.98356718203,574.6789303294026,131931.66249751142,672,3,307.8292682926829,36,5,20,35.16217181149069,0.6339699074074074,43.721846846846844,1025.1126126126126,28.47535035035035,0
678,4,0,0,41,0.0,0.0,1.0,41,1300,700,600,0.5384615384615384,19,7,12,331.0655072287147,0.41496443089430896,0.227515536764765,0.19493702038438018,131530.20154867697,509.02257832155937,132039.22412699854,673,4,308.8292682926829,36,5,22,35.06284992864201,0.6357060185185186,43.552927927927925,1025.7882882882877,28.494119119119105,0
679,4,0,1,40,0.0,0.024390243902439025,0.975609756097561,41,900,600,300,0.6666666666666666,12,6,6,334.4242673941146,0.4140243902439025,0.23331870061457427,0.1973623008092728,131616.85333982637,603.1739509780134,132220.02729080437,674,5,309.8292682926829,36,5,14,34.889431518876215,0.6365740740740741,43.46846846846847,1026.1261261261266,28.503503503503516,0
680,4,0,0,40,0.0,0.0,1.0,40,950,700,250,0.7368421052631579,12,7,5,347.2493493777216,0.41279380341880345,0.2363197969543145,0.20481473601021322,131595.18771701402,1139.268663194464,132734.4563802085,675,6,317.375,35,5,15,34.58227580372251,0.638392857142857,43.48958333333334,1026.0416666666679,29.315476190476225,0
681,4,0,0,40,0.0,0.0,1.0,40,1550,1200,350,0.7741935483870968,19,12,7,351.02573748530034,0.4122596153846154,0.24021592062239194,0.2076882765681876,131713.96933138306,1246.9986443330108,132960.96797571608,676,7,318.375,35,5,15,34.36560397639718,0.6395833333333332,43.3738425925926,1026.5046296296312,29.32870370370375,0
682,4,0,0,40,0.0,0.0,1.0,40,1250,600,650,0.48,19,6,13,354.61985031824827,0.41157852564102565,0.23727180527383318,0.21063564603240556,131862.5217013891,1352.2135416666897,133214.7352430558,677,8,319.375,35,5,15,34.12356321839081,0.6410714285714285,43.22916666666668,1027.083333333335,29.345238095238145,0
683,4,0,0,40,0.0,0.0,1.0,40,500,300,200,0.6,7,3,4,354.61985031824827,0.41157852564102565,0.23727180527383318,0.21063564603240556,131862.5217013891,1352.2135416666897,133214.7352430558,678,9,320.375,35,5,15,34.12356321839081,0.6410714285714285,43.22916666666668,1027.083333333335,29.345238095238145,0
684,4,1,1,40,0.024390243902439025,0.024390243902439025,0.975609756097561,41,900,600,300,0.6666666666666666,12,6,6,348.11585267391797,0.4139735772357724,0.2385624841470082,0.2090754973159925,132282.1316882764,1009.9014132375869,133292.03310151398,679,0,313.5365853658537,36,5,16,33.86813537675606,0.6432291666666665,42.82094594594596,1028.7162162162183,28.575450450450507,0
685,4,0,1,39,0.0,0.025,0.975,40,850,500,350,0.5882352941176471,12,5,7,356.60136998816415,0.41311431623931627,0.24551671732522795,0.21331245586564745,132130.12695312512,1423.5568576389028,133553.68381076402,680,1,322.125,35,5,16,33.802980412022976,0.6437499999999998,42.96875000000001,1028.125000000001,29.375000000000025,0
686,4,1,1,39,0.025,0.025,0.975,40,750,300,450,0.4,12,3,9,358.5137147966065,0.4100560897435897,0.24792370020256538,0.21496308162501004,132219.38898533973,1480.4928626543465,133699.88184799408,681,0,322.7,35,5,16,33.663909520594196,0.6446428571428571,42.88194444444446,1028.472222222224,29.384920634920686,0
687,4,0,0,39,0.0,0.0,1.0,39,1100,700,400,0.6363636363636364,15,7,8,363.9395063937444,0.4090755735492578,0.2507058354840388,0.2175310024084279,132100.37964034642,1815.309392146787,133915.68903249322,682,3,331.97435897435895,35,4,16,33.644355625609855,0.6434523809523809,42.99768518518519,1028.0092592592598,29.371693121693138,0
688,4,0,1,38,0.0,0.02564102564102564,0.9743589743589743,39,800,600,200,0.75,10,6,4,366.57079322165663,0.40797908232118757,0.25044360388120923,0.2199672275057976,132249.14969403725,1895.7351412465696,134144.88483528382,683,4,332.97435897435895,35,4,16,33.42675162221971,0.6449404761904761,42.85300925925926,1028.5879629629633,29.388227513227523,0
689,4,1,2,37,0.02564102564102564,0.05128205128205128,0.9487179487179487,39,1500,1200,300,0.8,18,12,6,361.80655852109646,0.4108468286099865,0.23143946808069016,0.2181436195936819,132428.6352040815,1782.7934750610523,134211.42867914255,684,0,317.4102564102564,34,5,18,33.36851337805537,0.6488970588235294,42.67857142857142,1029.2857142857133,30.27310924369745,0
690,4,1,1,37,0.02631578947368421,0.02631578947368421,0.9736842105263158,38,1350,1100,250,0.8148148148148148,16,11,5,358.0162545427886,0.41072486960644855,0.22743144268438087,0.21691573069357178,132612.49999999988,1895.4861111110947,134507.98611111098,685,0,320.36842105263156,34,4,18,33.281081445523185,0.6507352941176471,42.49999999999999,1029.999999999999,30.294117647058798,0
691,4,0,0,37,0.0,0.0,1.0,37,850,500,350,0.5882352941176471,12,5,7,365.7728771299724,0.40621871871871873,0.2340970194373342,0.22146651724785907,132587.25610342162,2299.364427143389,134886.620530565,686,7,330.02702702702703,33,4,18,33.106754719974624,0.6527777777777779,42.52450980392156,1029.9019607843125,31.209150326797346,0
692,4,0,0,37,0.0,0.0,1.0,37,1250,1100,150,0.88,14,11,3,362.14547153225465,0.4060935935935936,0.2301926093553115,0.22000860727190716,132713.49961553246,2212.3185793925345,134925.818194925,687,8,331.02702702702703,33,4,17,33.07316444655882,0.6540404040404041,42.40196078431372,1030.3921568627447,31.22400475341651,0
693,4,0,0,37,0.0,0.0,1.0,37,1100,900,200,0.8181818181818182,13,9,4,363.5942042355541,0.40581206206206205,0.22956908406266474,0.22163438014706394,132839.80320069205,2259.956507112652,135099.7597078047,688,9,332.02702702702703,33,4,17,32.908840545252815,0.6553030303030303,42.279411764705884,1030.8823529411766,31.238859180035654,0
694,4,0,0,37,0.0,0.0,1.0,37,1150,900,250,0.782608695652174,14,9,5,364.3628496213803,0.40593718718718713,0.23020977494067663,0.22304306220095677,132997.7671598663,2291.889087129933,135289.65624699622,689,10,333.02702702702703,33,4,17,32.730263157894726,0.6568813131313131,42.12622549019607,1031.4950980392148,31.25742721330954,0
695,4,0,0,37,0.0,0.0,1.0,37,1300,900,400,0.6923076923076923,17,9,8,367.8162851181738,0.4043731231231231,0.23652339111849963,0.2261130476835954,133155.82498317942,2395.3761774317495,135551.20116061118,690,11,334.02702702702703,33,4,17,32.482387398084384,0.658459595959596,41.97303921568627,1032.1078431372541,31.27599524658346,0
696,4,0,1,36,0.0,0.02702702702702703,0.972972972972973,37,900,600,300,0.6666666666666666,12,6,6,365.72698535691984,0.40396646646646645,0.23070976020530942,0.22540233003892074,133250.70473195394,2346.675707660503,135597.38043961444,691,12,335.02702702702703,33,4,17,32.44102373887242,0.6594065656565657,41.88112745098039,1032.4754901960775,31.287136066547806,0
697,4,0,0,36,0.0,0.0,1.0,36,1450,1000,450,0.6896551724137931,19,10,9,372.78560049053016,0.39914021164021163,0.23429301579534045,0.22910898484282657,133146.24304917874,2727.000433629236,135873.24348280797,692,13,344.0,32,4,17,32.363795775222265,0.6608072916666666,41.98232323232324,1032.0707070707076,32.25220959595961,0
698,4,0,0,36,0.0,0.0,1.0,36,1300,1000,300,0.7692307692307693,16,10,6,375.6575763725197,0.3992063492063492,0.23905600391293724,0.2316838355636855,133276.58689164388,2813.2719237833094,136089.8588154272,693,14,345.0,32,4,18,32.15868794326243,0.662109375,41.856060606060616,1032.5757575757589,32.267992424242465,0
699,4,0,0,36,0.0,0.0,1.0,36,1000,700,300,0.7,13,7,6,374.70119578732783,0.39932208994708995,0.2385059812348096,0.23211051363570817,133439.60636988573,2799.996014437307,136239.60238432305,694,15,346.0,32,4,18,32.01963420098578,0.6637369791666666,41.698232323232325,1033.207070707071,32.287720959595966,0
700,4,0,1,35,0.0,0.027777777777777776,0.9722222222222222,36,1200,900,300,0.75,15,9,6,374.83335317335167,0.39889219576719576,0.23797257856512566,0.23260128853099976,133504.84206012153,2808.413522854826,136313.25558297636,695,16,347.0,32,4,19,31.950722867033196,0.6643880208333333,41.63510101010102,1033.459595959597,32.295612373737406,0
701,4,0,0,35,0.0,0.0,1.0,35,1050,500,550,0.47619047619047616,16,5,11,381.06296333749543,0.3984943977591036,0.22546161321671532,0.23668840398850108,133539.50500488305,3177.391899956628,136716.89690483967,696,17,339.45714285714286,31,4,19,31.75495506844714,0.6673387096774193,41.601562500000014,1033.5937500000018,33.3417338709678,0
702,4,0,0,35,0.0,0.0,1.0,35,1000,700,300,0.7,13,7,6,381.06296333749543,0.3984943977591036,0.22546161321671532,0.23668840398850108,133539.50500488305,3177.391899956628,136716.89690483967,697,18,340.45714285714286,31,4,19,31.75495506844714,0.6673387096774193,41.601562500000014,1033.5937500000018,33.3417338709678,0
703,4,0,0,35,0.0,0.0,1.0,35,850,600,250,0.7058823529411765,11,6,5,380.33606849152494,0.39859943977591034,0.2251186879585667,0.23753063900131113,133741.45507812515,3173.339843750016,136914.79492187517,698,19,341.45714285714286,31,4,16,31.570996978851955,0.6693548387096774,41.40625000000001,1034.3750000000011,33.366935483871,0
704,4,0,0,35,0.0,0.0,1.0,35,1050,800,250,0.7619047619047619,13,8,5,380.50802789850184,0.3977941176470588,0.22443022503415055,0.23850771338622184,133876.17323133687,3188.1917317708435,137064.3649631077,699,20,342.45714285714286,31,4,17,31.431387351115582,0.6706989247311828,41.27604166666667,1034.895833333334,33.383736559139805,0
705,4,0,0,35,0.0,0.0,1.0,35,1150,800,350,0.6956521739130435,15,8,7,379.19226480342536,0.39663865546218485,0.22437534802680026,0.2387740365781189,134044.6662902832,3165.740119086371,137210.40640936958,700,21,343.45714285714286,31,4,18,31.296497128966013,0.6723790322580645,41.11328125,1035.546875,33.40473790322581,0
706,4,0,0,35,0.0,0.0,1.0,35,800,300,500,0.375,13,3,10,417.5642362226106,0.39663865546218485,0.2640765723329692,0.23521337585734253,129817.03990345691,3867.8434294542667,133684.88333291118,701,22,344.45714285714286,30,5,18,34.59014771828014,0.632638888888889,45.228494623655905,1019.0860215053752,33.96953405017918,7
707,4,1,1,35,0.027777777777777776,0.027777777777777776,0.9722222222222222,36,900,600,300,0.6666666666666666,12,6,6,408.8438714755054,0.40128968253968256,0.2568877340592266,0.23236822568671114,130165.93491735522,3443.508953168025,133609.44387052325,702,0,335.8611111111111,32,4,18,34.456198960653296,0.6308593750000002,44.886363636363626,1020.4545454545442,31.889204545454508,0
708,4,0,0,35,0.0,0.0,1.0,35,600,500,100,0.8333333333333334,7,5,2,401.3899044583293,0.39698879551820726,0.21309569934134043,0.21099538562259637,127059.1926574707,3200.0913103312064,130259.28396780191,703,24,346.45714285714286,31,4,17,37.83215484954152,0.6018145161290323,47.94921875,1008.203125,32.522681451612904,6
709,4,5,2,38,0.125,0.05,0.95,40,900,500,400,0.5555555555555556,13,5,8,354.26765927977846,0.42063301282051285,0.17417763157894717,0.19231672932330834,128355.55555555562,1099.0644666883782,129454.620022244,704,0,304.025,34,6,19,37.69188596491229,0.6078431372549019,46.66666666666667,1013.3333333333339,29.80392156862747,0
710,4,3,3,38,0.07317073170731707,0.07317073170731707,0.926829268292683,41,950,600,350,0.631578947368421,13,6,7,344.819110739333,0.4178607723577236,0.18465826122510265,0.18910061176192705,128760.50407503865,679.8165027006239,129440.32057773927,705,0,297.5365853658537,35,6,18,37.518174820390016,0.6098214285714285,46.267361111111114,1014.9305555555561,28.998015873015888,0
711,4,1,1,38,0.02564102564102564,0.02564102564102564,0.9743589743589743,39,1000,400,600,0.4,16,4,12,363.5742907193197,0.411521592442645,0.1944924787564386,0.19816954423001676,128517.04422577862,1545.0986399461901,130062.1428657248,706,0,313.71794871794873,33,6,18,37.29101200547904,0.6117424242424241,46.50735294117648,1013.9705882352947,30.726381461675597,0
712,4,1,1,38,0.02564102564102564,0.02564102564102564,0.9743589743589743,39,950,300,650,0.3157894736842105,16,3,13,362.8025300973886,0.41329284750337386,0.19065768068789235,0.1979031599575407,128548.11137843627,1527.5160094675273,130075.62738790379,707,0,314.6923076923077,33,6,18,37.27882678751259,0.6120580808080808,46.47671568627452,1014.0931372549028,30.73009506833039,0
713,4,0,0,38,0.0,0.0,1.0,38,1500,1200,300,0.8,18,12,6,377.8378023113368,0.40851706970128027,0.19999803393429394,0.20600240260436842,128528.34093778701,2112.573174931137,130640.91411271815,708,3,323.9736842105263,32,6,18,36.91788071224007,0.6142578125,46.496212121212125,1014.015151515152,31.6879734848485,0
714,4,1,0,39,0.02564102564102564,0.0,1.0,39,850,600,250,0.7058823529411765,11,6,5,366.2824519087586,0.4119714349977508,0.19502928985990775,0.20172728193890377,128929.21095521539,1644.9015022675692,130574.11245748296,709,0,316.64102564102564,34,5,19,36.8013226272809,0.6136642156862745,46.101190476190474,1015.5952380952378,29.8704481792717,0
715,4,1,1,39,0.025,0.025,0.975,40,500,300,200,0.6,7,3,4,356.75288904070345,0.41461004273504276,0.18360851742200035,0.19754122771471996,129142.56071030525,1214.3963263031674,130356.95703660841,710,0,309.7,35,5,19,36.82579898276781,0.613690476190476,45.89120370370371,1016.4351851851854,29.0410052910053,0
716,4,2,2,39,0.04878048780487805,0.04878048780487805,0.9512195121951219,41,1250,600,650,0.48,19,6,13,349.4393570022491,0.41445630081300816,0.1826896672242051,0.19508700102354148,129466.28146701399,848.1362257801882,130314.41769279417,711,0,303.0975609756098,35,6,17,36.68223302627089,0.6169642857142856,45.57291666666667,1017.7083333333342,29.077380952380977,0
717,4,3,1,41,0.07142857142857142,0.023809523809523808,0.9761904761904762,42,1400,1000,400,0.7142857142857143,18,10,8,343.3905505986634,0.41862659698025556,0.19032105387710008,0.19421620460155528,129975.34855379043,526.4613008278702,130501.8098546183,712,0,296.8095238095238,36,6,20,36.31925271489047,0.6200810185185185,45.073198198198206,1019.7072072072085,28.325200200200236,0
718,4,0,0,41,0.0,0.0,1.0,41,700,300,400,0.42857142857142855,11,3,8,351.51348662474305,0.41547256097560975,0.20309696284973766,0.198469922448124,129908.37191358018,932.9089506172764,130841.28086419746,713,1,305.0487804878049,35,6,20,36.18017711171662,0.6214285714285714,45.138888888888886,1019.4444444444439,29.126984126984112,0
719,4,0,0,41,0.0,0.0,1.0,41,1250,1100,150,0.88,14,11,3,359.7720466617286,0.41529471544715446,0.21838965423035628,0.19792950242518667,128886.73460200077,1097.5992602963481,129984.33386229712,714,2,306.0487804878049,36,5,17,37.009953421315295,0.6090856481481481,46.143018018018026,1015.427927927929,28.20633133133136,6
720,4,3,2,42,0.06818181818181818,0.045454545454545456,0.9545454545454546,44,1000,500,500,0.5,15,5,10,341.67322294074063,0.4228660147991543,0.2244299833643213,0.1919071487980341,129703.52055440148,64.01121574802727,129767.53177014951,715,0,286.1136363636364,37,7,15,36.63885898815932,0.6154279279279278,45.33991228070176,1018.6403508771939,27.530820293978213,0
721,4,1,1,42,0.023255813953488372,0.023255813953488372,0.9767441860465116,43,1300,1000,300,0.7692307692307693,16,10,6,346.7805321226236,0.41964285714285715,0.24185646153307183,0.19533201609379794,129815.2376211912,403.4794359803092,130218.71705717151,716,0,293.6046511627907,37,6,16,36.395344666810125,0.616554054054054,45.23026315789474,1019.0789473684216,27.542674253200584,0
722,4,1,1,42,0.023255813953488372,0.023255813953488372,0.9767441860465116,43,1050,800,250,0.7619047619047619,13,8,5,349.67077934057903,0.4179125138427464,0.26082762048148744,0.19798085762664083,130017.30974687698,492.6508053911815,130509.96055226817,717,0,294.3255813953488,38,5,18,36.11656714854389,0.6167763157894737,45.03205128205128,1019.8717948717942,26.838731443994586,0
723,4,0,1,41,0.0,0.023809523809523808,0.9761904761904762,42,850,700,150,0.8235294117647058,10,7,3,360.3671550924937,0.4154205381339528,0.26768747727121434,0.2034203667817189,129899.05698147493,962.2707227223591,130861.32770419729,718,1,302.04761904761904,37,5,18,35.96399824316089,0.6173986486486487,45.148026315789465,1019.4078947368411,27.551564722617325,0
724,4,0,1,40,0.0,0.024390243902439025,0.975609756097561,41,850,600,250,0.7058823529411765,11,6,5,369.4164573497786,0.41603150406504064,0.261478078971771,0.20786567824009924,129774.47041636225,1388.1650231312328,131162.6354394935,719,2,306.219512195122,36,5,18,35.86013483642793,0.6180555555555556,45.27027027027027,1018.9189189189184,28.303303303303288,0
725,4,1,0,41,0.024390243902439025,0.0,1.0,41,1300,700,600,0.5384615384615384,19,7,12,368.42650350776455,0.420020325203252,0.2654905370375853,0.2092985923688935,130147.65346004778,1389.9689808051153,131537.6224408529,720,0,305.4390243902439,36,5,20,35.50587683478644,0.6218171296296298,44.90427927927927,1020.382882882882,28.343968968968944,0
726,4,2,1,42,0.046511627906976744,0.023255813953488372,0.9767441860465116,43,1300,1000,300,0.7692307692307693,16,10,6,349.48707519615334,0.4252491694352159,0.25360478483086135,0.20109692258280168,130644.58832137121,531.7190125283139,131176.30733389952,721,0,292.1860465116279,38,5,18,35.48546521754277,0.6230811403508771,44.417735042735046,1022.3290598290602,26.903396311291058,0
727,4,0,1,41,0.0,0.023809523809523808,0.9761904761904762,42,850,500,350,0.5882352941176471,12,5,7,357.81785450569356,0.4231029810298103,0.26040820704555556,0.20579493260682183,130626.6245984342,948.1077110264775,131574.73230946067,722,1,300.14285714285717,37,5,18,35.29074600450499,0.6247184684684683,44.43530701754386,1022.258771929825,27.628615457562837,0
728,4,0,0,41,0.0,0.0,1.0,41,1200,800,400,0.6666666666666666,16,8,8,360.24244559197047,0.42253556910569107,0.2591863111536259,0.2070880733779809,130607.6912004911,1210.0868182371646,131817.77801872828,723,2,306.4146341463415,36,5,18,35.24797106239214,0.6264467592592593,44.45382882882883,1022.1846846846852,28.394019019019034,0
729,4,0,0,41,0.0,0.0,1.0,41,850,700,150,0.8235294117647058,10,7,3,361.4240658125897,0.42233231707317076,0.26351886825399795,0.20807667048272052,130665.25298524885,1245.1133988718582,131910.36638412072,724,3,307.4146341463415,36,5,19,35.15943385835445,0.6270254629629629,44.39752252252253,1022.4099099099107,28.400275275275295,0
730,4,0,0,41,0.0,0.0,1.0,41,800,500,300,0.625,11,5,6,363.2913481373384,0.42202743902439027,0.26733125292054494,0.20961956949068025,130751.61944038632,1300.1864195276335,132051.80585991396,725,4,308.4146341463415,36,5,19,35.02417786097041,0.6278935185185186,44.31306306306306,1022.7477477477477,28.409659659659656,0
731,4,0,0,41,0.0,0.0,1.0,41,1650,1300,350,0.7878787878787878,20,13,7,366.4348091821004,0.42123983739837395,0.27447412143319205,0.21222390765058943,130895.62694028499,1392.9428161269552,132288.56975641195,726,5,309.4146341463415,36,5,19,34.797879754961315,0.6293402777777777,44.172297297297305,1023.3108108108116,28.42530030030032,0
732,4,0,0,41,0.0,0.0,1.0,41,950,700,250,0.7368421052631579,12,7,5,361.72326720705524,0.42065548780487805,0.27644780187353124,0.21028055917177416,131039.71370018672,1280.0226747017355,132319.73637488845,727,6,310.4146341463415,36,5,20,34.77255645989148,0.630787037037037,44.031531531531535,1023.8738738738742,28.44094094094095,0
733,4,0,0,41,0.0,0.0,1.0,41,750,500,250,0.6666666666666666,10,5,5,360.68837126880135,0.4208587398373984,0.27434129174680044,0.20983617146175393,131068.54056336757,1254.9796840759836,132323.52024744355,728,7,311.4146341463415,36,5,20,34.76987792807654,0.6310763888888888,44.003378378378386,1023.9864864864877,28.4440690690691,0
734,4,1,1,41,0.023809523809523808,0.023809523809523808,0.9761904761904762,42,700,500,200,0.7142857142857143,9,5,4,353.68799466165535,0.42169957413859854,0.2679316511027223,0.20700824584236022,131300.02891514695,887.8487852031371,132187.87770035007,729,0,304.9761904761905,37,5,20,34.715126956955885,0.6314752252252251,43.77741228070175,1024.8903508771928,27.6997392128971,0
735,4,0,0,41,0.0,0.0,1.0,41,1150,600,550,0.5217391304347826,17,6,11,357.4978867286558,0.4205284552845528,0.262980434199946,0.20907652758552503,131270.4173768364,1185.7793604415333,132456.19673727793,730,9,313.4146341463415,36,5,21,34.6474358974359,0.6331018518518519,43.80630630630631,1024.7747747747756,28.46596596596599,0
736,4,0,0,41,0.0,0.0,1.0,41,1100,800,300,0.7272727272727273,14,8,6,356.17641639533394,0.4202997967479675,0.26138948045164123,0.20909002393807324,131414.71021274658,1161.3641090414744,132576.07432178804,731,10,314.4146341463415,36,5,21,34.535511623649995,0.6345486111111112,43.66554054054054,1025.3378378378382,28.481606606606615,0
737,4,1,1,41,0.023809523809523808,0.023809523809523808,0.9761904761904762,42,650,300,350,0.46153846153846156,10,3,7,348.85238114818833,0.4218810491676345,0.25265765353353586,0.20644475299047635,131721.78578985823,790.291724376716,132512.07751423496,732,0,307.9047619047619,37,5,17,34.41349782809943,0.6356981981981983,43.36622807017543,1026.5350877192968,27.744191559980994,0
738,4,0,0,41,0.0,0.0,1.0,41,1200,900,300,0.75,15,9,6,355.96556441587734,0.41905487804878044,0.25785730917772187,0.21023423127167154,131645.7436110097,1172.2702854881952,132818.0138964979,733,12,316.4146341463415,36,5,17,34.307674018800974,0.6368634259259258,43.44031531531532,1026.2387387387391,28.50663163163164,0
739,4,0,0,41,0.0,0.0,1.0,41,1200,800,400,0.6666666666666666,16,8,8,360.1835808989918,0.41847052845528454,0.2596774366164021,0.21320996905683184,131732.43344696058,1289.5719198928832,133022.00536685347,734,13,317.4146341463415,36,5,17,34.11195517039638,0.6377314814814814,43.355855855855864,1026.5765765765775,28.516016016016042,0
740,4,1,2,40,0.023809523809523808,0.047619047619047616,0.9523809523809523,42,1050,700,350,0.6666666666666666,14,7,7,352.4706558829563,0.4207196089818041,0.2529682522747705,0.21029328183265142,132031.50398439926,907.4461613188887,132938.95014571815,735,0,310.8333333333333,37,5,17,34.00847736405988,0.638795045045045,43.06469298245615,1027.7412280701772,27.776789947842627,0
741,4,1,1,40,0.024390243902439025,0.024390243902439025,0.975609756097561,41,1150,1000,150,0.8695652173913043,13,10,3,358.8280973119396,0.4176067073170732,0.25409378066158106,0.21354133932008026,131934.8206948505,1268.3841358250413,133203.20483067553,736,0,318.9024390243902,36,5,17,33.942599291168825,0.6397569444444443,43.1587837837838,1027.3648648648668,28.53791291291297,0
742,4,0,0,40,0.0,0.0,1.0,40,1000,800,200,0.8,12,8,4,367.15537453266455,0.4150774572649573,0.26112081595852565,0.21791101259052395,131832.80452942822,1680.6245445387576,133513.42907396698,737,16,327.875,35,5,17,33.83168507457079,0.6407738095238095,43.258101851851855,1026.967592592593,29.34193121693123,0
743,4,1,0,41,0.024390243902439025,0.0,1.0,41,950,500,450,0.5263157894736842,14,5,9,356.24703453835883,0.4160569105691057,0.26033887802741384,0.21346771124700092,132195.26113951797,1218.8339521954495,133414.09509171342,738,0,320.8536585365854,36,5,19,33.74648671338882,0.642361111111111,42.90540540540541,1028.378378378379,28.566066066066085,0
744,4,1,2,40,0.023809523809523808,0.047619047619047616,0.9523809523809523,42,1400,900,500,0.6428571428571429,19,9,10,348.230632816698,0.4163400116144019,0.2514698646050515,0.20994482660567418,132426.21678064414,822.973054208994,133249.18983485314,739,0,314.1904761904762,37,5,19,33.72028248286637,0.6427364864864864,42.68092105263158,1029.2763157894744,27.81827880512093,0
745,4,0,0,40,0.0,0.0,1.0,40,1150,700,450,0.6086956521739131,16,7,9,363.5390880984325,0.411872329059829,0.26026448362720433,0.21767051891323214,132166.3106307322,1609.52400880612,133775.8346395383,740,2,330.425,36,4,19,33.5881885883255,0.6420717592592593,42.933558558558566,1028.2657657657667,28.562937937937964,0
746,4,0,0,40,0.0,0.0,1.0,40,1000,700,300,0.7,13,7,6,345.073231515008,0.41173878205128206,0.17799893276414114,0.20542161240759998,131946.99931709754,1106.2754886118819,133053.27480570943,741,3,331.425,37,3,18,34.28361792956244,0.6379504504504505,43.146929824561404,1027.4122807017543,27.767899478425793,4
747,4,0,0,40,0.0,0.0,1.0,40,1250,1000,250,0.8,15,10,5,369.76315231862,0.41179220085470086,0.19104433444528146,0.20812895060550768,129787.30384589468,1657.6741160741508,131444.97796196883,742,4,332.425,37,3,16,35.83824294271673,0.6162725225225226,45.25767543859648,1018.9692982456124,27.53971076339493,8
748,4,1,1,40,0.024390243902439025,0.024390243902439025,0.975609756097561,41,1150,800,350,0.6956521739130435,15,8,7,357.3379164096217,0.41493902439024394,0.1755239702506941,0.203314420218053,130208.06081753573,1105.655430455085,131313.71624799081,743,0,325.2926829268293,38,3,18,35.727432918106004,0.6186951754385965,44.84508547008546,1020.6196581196562,26.858412055780423,0
749,4,3,1,42,0.06976744186046512,0.023255813953488372,0.9767441860465116,43,1600,1100,500,0.6875,21,11,10,343.1219021609474,0.42008121077888516,0.17775856121958244,0.19813323831658058,130781.15297866885,374.79842391699924,131155.95140258584,744,0,311.09302325581393,38,5,14,35.510018452754,0.624451754385965,44.28418803418803,1022.8632478632466,26.917453891138067,0
750,4,0,0,42,0.0,0.0,1.0,42,1000,600,400,0.6,14,6,8,343.10289849783,0.4169207317073171,0.17349212982309514,0.1978422255675438,130726.51855504415,571.6709127766762,131298.18946782083,745,1,319.5,38,4,15,35.56575602451595,0.6239035087719298,44.337606837606835,1022.6495726495723,26.91183085919927,1
751,4,0,0,42,0.0,0.0,1.0,42,1000,700,300,0.7,13,7,6,341.95497148484736,0.4166424699961286,0.171576308367283,0.19731976745174468,130753.83434007235,542.384738658781,131296.21907873114,746,2,320.5,38,4,15,35.56748145826806,0.6241776315789473,44.31089743589744,1022.7564102564105,26.914642375168697,0
752,4,1,3,40,0.023255813953488372,0.06976744186046512,0.9302325581395349,43,1400,1200,200,0.8571428571428571,16,12,4,339.710670121091,0.41938907345884086,0.16227253476305292,0.19745808259137826,131034.66932508687,302.7750651041707,131337.44439019103,747,0,314.0232558139535,39,4,16,35.34110370671822,0.625267094017094,44.036458333333336,1023.8541666666672,26.252670940170955,0
753,4,0,0,40,0.0,0.0,1.0,40,700,300,400,0.42857142857142855,11,3,8,361.57170200493783,0.4122195512820513,0.18130714993940722,0.20785220640271196,130607.6912004911,1444.8090404593859,132052.5002409505,748,4,338.275,36,4,17,35.21400242370828,0.6264467592592593,44.45382882882883,1022.1846846846852,28.394019019019034,0
754,4,0,0,40,0.0,0.0,1.0,40,1000,700,300,0.7,13,7,6,362.89488629948465,0.41292735042735046,0.18240939309457405,0.20916920331452368,130710.70545744844,1486.8493190212353,132197.55477646968,749,5,339.275,37,3,17,35.075773822288944,0.6255630630630631,44.353070175438596,1022.5877192982456,27.63750592697961,0
755,4,0,0,40,0.0,0.0,1.0,40,1000,700,300,0.7,13,7,6,364.99438821168366,0.41348824786324784,0.18746516613076136,0.2109911798026645,130822.85534972278,1549.921610495514,132372.7769602183,750,6,340.275,37,3,18,34.90844944623079,0.6266891891891893,44.24342105263157,1023.0263157894719,27.649359886201943,0
756,4,1,1,40,0.024390243902439025,0.024390243902439025,0.975609756097561,41,1300,800,500,0.6153846153846154,18,8,10,366.7659511811544,0.41501524390243905,0.19689245703470815,0.21390218612681913,131163.91354372117,1421.2915023011144,132585.20504602228,751,0,332.9512195121951,38,3,20,34.517756570713395,0.6282894736842106,43.91025641025641,1024.358974358974,26.95681511470984,0
757,4,0,0,40,0.0,0.0,1.0,40,1050,700,350,0.6666666666666666,14,7,7,372.39803153700643,0.41171207264957266,0.20667415970884218,0.21716244760416423,131159.59357686967,1768.7148930439998,132928.30846991367,752,1,341.525,37,3,20,34.377899093698716,0.6300675675675677,43.91447368421052,1024.3421052631568,27.684921763869102,0
758,4,1,3,38,0.024390243902439025,0.07317073170731707,0.926829268292683,41,800,400,400,0.5,12,4,8,365.9982980805,0.4138211382113821,0.19800693717998152,0.21503613534437832,131446.78605109715,1422.1846156841884,132868.97066678133,753,0,334.1707317073171,35,6,21,34.251316779533475,0.636904761904762,43.634259259259245,1025.462962962961,29.298941798941744,0
759,4,0,0,38,0.0,0.0,1.0,38,750,400,350,0.5333333333333333,11,4,7,388.0723054903867,0.4063240872451399,0.22731166675590297,0.22572489721718914,131061.33355034706,2572.254774305536,133633.5883246526,754,3,359.2894736842105,35,3,21,34.07616988809766,0.6330357142857144,44.01041666666666,1023.958333333332,29.255952380952344,0
760,4,1,0,39,0.02564102564102564,0.0,1.0,39,750,500,250,0.6666666666666666,10,5,5,380.30131174391016,0.4101158344579397,0.23113693190175022,0.22348043375512922,131453.76778162242,2199.221866289403,133652.98964791183,755,0,351.05128205128204,33,6,22,33.87756931166347,0.6414141414141414,43.627450980392155,1025.4901960784312,31.075460487225186,0
761,4,2,2,39,0.04878048780487805,0.04878048780487805,0.9512195121951219,41,1200,900,300,0.75,15,9,6,352.19826722875695,0.41580284552845526,0.1613888696649428,0.21038090199838852,132076.58420138905,1103.4288194444644,133180.01302083352,756,0,334.8780487804878,39,2,16,33.970071611944334,0.6356837606837606,43.02083333333334,1027.916666666668,26.356837606837644,1
762,4,1,2,38,0.025,0.05,0.95,40,950,800,150,0.8421052631578947,11,8,3,356.9151314419221,0.4124465811965812,0.17530668468655808,0.21284356164537194,132013.44515897805,1423.5192262035282,133436.96438518158,757,0,344.225,38,2,16,33.9124822400111,0.6367872807017543,43.08226495726496,1027.6709401709404,27.04397210976159,0
763,4,0,0,38,0.0,0.0,1.0,38,1200,800,400,0.6666666666666666,16,8,8,371.180064587612,0.4071686818397345,0.19027718451645637,0.22005330487060135,131790.2425229284,2183.582146335532,133973.82466926394,758,3,363.1842105263158,36,2,16,33.771340571762806,0.6383101851851851,43.29954954954955,1026.8018018018024,28.52227227227229,0
764,4,0,0,38,0.0,0.0,1.0,38,1400,900,500,0.6428571428571429,19,9,10,372.3110227059482,0.4060573731626363,0.19451189617880238,0.2219032058910373,131992.67415642014,2228.4655009739636,134221.1396573941,759,4,364.1842105263158,36,2,16,33.537899543378984,0.6403356481481481,43.102477477477485,1027.5900900900915,28.54416916916921,0
765,4,0,0,38,0.0,0.0,1.0,38,1500,1200,300,0.8,18,12,6,378.39254683867165,0.40444227121858706,0.19678780194998247,0.22727777685277958,132285.18029586025,2411.145256232682,134696.32555209292,760,5,365.1842105263158,37,1,17,33.08640659418744,0.6413288288288288,42.81798245614035,1028.7280701754385,27.80346135609293,0
766,4,0,0,38,0.0,0.0,1.0,38,700,600,100,0.8571428571428571,8,6,2,378.014874463329,0.4044867235656709,0.19785221873825543,0.22722060006978978,132313.38158135206,2403.2852656586765,134716.66684701073,761,6,366.1842105263158,37,1,17,33.06767114284699,0.6416103603603602,42.7905701754386,1028.8377192982464,27.80642484589855,0
767,4,1,0,39,0.02564102564102564,0.0,1.0,39,1200,600,600,0.5,18,6,12,343.26411546642817,0.4047177237966712,0.15457429656212573,0.20389061316258958,131862.52170138914,1252.7343750000248,133115.25607638917,762,0,357.7692307692308,39,0,16,34.41514536849223,0.6335470085470085,43.22916666666668,1027.0833333333353,26.335470085470135,3
768,4,0,0,39,0.0,0.0,1.0,39,1550,1300,250,0.8387096774193549,18,13,5,344.64004716329305,0.4044646873594242,0.1554883435710348,0.20586610081158463,132076.58420138896,1303.7760416666717,133380.36024305565,763,1,358.7692307692308,39,0,17,34.16430212133495,0.6356837606837606,43.020833333333336,1027.9166666666672,26.35683760683762,0
769,4,0,0,39,0.0,0.0,1.0,39,1600,1300,300,0.8125,19,13,6,351.0345715268897,0.40499887539361223,0.15895773594314977,0.21027993265251516,132183.6805555554,1480.208333333314,133663.8888888887,764,2,359.7692307692308,39,0,17,33.89215289032954,0.6367521367521368,42.91666666666666,1028.333333333332,26.36752136752133,0
770,4,0,0,39,0.0,0.0,1.0,39,1100,800,300,0.7272727272727273,14,8,6,354.45145904554727,0.40393049932523617,0.16135312349120867,0.2132321262150982,132344.40646701373,1581.933593749981,133926.3400607637,765,3,360.7692307692308,39,0,18,33.64252210298981,0.6383547008547009,42.76041666666666,1028.958333333332,26.383547008546973,0
771,4,0,0,39,0.0,0.0,1.0,39,1000,700,300,0.7,13,7,6,361.03149949671865,0.40393049932523617,0.21606715404024146,0.19965881530306873,129092.79348381891,1526.0981173866583,130618.89160120557,766,4,361.7692307692308,38,1,15,36.76781083543595,0.6074561403508772,45.94017094017093,1016.2393162393145,26.743139901034592,8
772,4,1,0,40,0.025,0.0,1.0,40,1600,1300,300,0.8125,19,13,6,359.4031235507417,0.4066773504273504,0.22013961788788605,0.20068429982088865,129473.07715136219,1306.6513258820714,130779.72847724427,767,0,353.7,38,2,14,36.42181048358877,0.611293859649123,45.566239316239304,1017.735042735041,26.78250112460634,0
773,4,0,0,40,0.0,0.0,1.0,40,1050,800,250,0.7619047619047619,13,8,5,357.41414083426696,0.40678418803418803,0.21465065044062137,0.20040421120189564,129636.227080137,1266.7641445685952,130902.9912247056,768,1,354.7,38,2,14,36.306432717862634,0.6129385964912282,45.40598290598289,1018.3760683760656,26.79937022042278,0
774,4,1,1,40,0.024390243902439025,0.024390243902439025,0.975609756097561,41,1350,1100,250,0.8148148148148148,16,11,5,345.57323798153936,0.40940040650406506,0.20294058288422323,0.1954255590179831,129970.32470703122,782.8531901041662,130753.17789713539,769,0,347.0243902439024,39,2,14,36.268707222392486,0.6145833333333334,45.078125,1019.6874999999998,26.14583333333333,0
775,4,0,0,40,0.0,0.0,1.0,40,1100,800,300,0.7272727272727273,14,8,6,338.11887171588904,0.407011217948718,0.2210924691223084,0.17233702269240497,125796.2200508811,513.8708620080249,126310.09091288912,770,3,356.7,37,3,20,40.72519309942796,0.5757319819819819,49.20504385964912,1003.179824561404,27.112968231389296,8
776,4,3,1,42,0.06976744186046512,0.023255813953488372,0.9767441860465116,43,1200,700,500,0.5833333333333334,17,7,10,320.101464277745,0.4164128829826504,0.22737573178631676,0.1659269909033917,126488.78173828141,-501.90768583841725,125986.87405244299,771,0,332.74418604651163,39,4,15,40.46557333195264,0.579326923076923,48.51562500000001,1005.9375000000013,25.793269230769262,0
777,4,2,0,44,0.045454545454545456,0.0,1.0,44,1250,1000,250,0.8,15,10,5,312.99011847806713,0.41955162085976044,0.22983312703433745,0.16393539486054082,126912.74957242723,-855.5126949897415,126057.23687743749,772,0,326.1363636363636,40,4,18,40.210119347789544,0.58203125,48.09451219512196,1007.621951219513,25.190548780487823,0
778,4,4,2,46,0.08333333333333333,0.041666666666666664,0.9583333333333334,48,950,800,150,0.8421052631578947,11,8,3,301.4938278147816,0.4293919917257683,0.2673372868065096,0.1623991568831255,128044.10450522782,-1878.7190123367036,126165.38549289112,773,0,299.875,41,7,17,39.34563484284128,0.5919715447154472,46.97420634920634,1012.103174603173,24.68544328300422,0
779,4,3,4,45,0.061224489795918366,0.08163265306122448,0.9183673469387755,49,1100,500,600,0.45454545454545453,17,5,12,298.46825273118594,0.43248653628117917,0.2682221590130087,0.1622138356669277,128401.90120174862,-2135.1430449925424,126266.75815675608,774,0,294.6734693877551,40,9,15,39.05837427721516,0.5971354166666665,46.62093495934961,1013.5162601626042,25.337906504065106,0
780,4,3,2,46,0.0625,0.041666666666666664,0.9583333333333334,48,1350,800,550,0.5925925925925926,19,8,11,307.21313844070124,0.430574024822695,0.2746678992056968,0.16765847061988076,128566.75347222254,-1700.5208333332976,126866.23263888924,775,0,301.6875,39,9,16,38.669200219118046,0.6004273504273503,46.45833333333335,1014.1666666666692,26.00427350427357,0
781,4,1,1,46,0.02127659574468085,0.02127659574468085,0.9787234042553191,47,1750,1300,450,0.7428571428571429,22,13,9,316.60134053068185,0.42763259327782915,0.2813789908639772,0.1728966490604182,128593.1654188372,-1257.44628906246,127335.71912977475,776,0,309.0851063829787,39,8,16,38.40430402930403,0.6006944444444443,46.432291666666686,1014.2708333333366,26.006944444444528,0
782,4,2,1,47,0.041666666666666664,0.020833333333333332,0.9791666666666666,48,1300,900,400,0.6923076923076923,17,9,8,310.5629359344694,0.4296690307328605,0.2858438406884818,0.1709892792723504,128917.41569378383,-1592.6057778107893,127324.80991597303,777,0,303.6041666666667,40,8,17,38.22800960672471,0.6023437499999998,46.1128048780488,1015.5487804878078,25.388719512195195,0
783,4,0,1,46,0.0,0.02127659574468085,0.9787234042553191,47,1100,700,400,0.6363636363636364,15,7,8,320.03155818540375,0.42805658341042246,0.29638843426077344,0.17628857018687544,128936.76757812548,-1147.2330729166238,127789.53450520885,778,1,311.06382978723406,39,8,17,37.9679487179487,0.6041666666666665,46.09375000000002,1015.6250000000039,26.041666666666767,0
784,4,3,1,48,0.061224489795918366,0.02040816326530612,0.9795918367346939,49,1550,900,650,0.5806451612903226,22,9,13,302.36019620428016,0.43353174603174605,0.25071177357226593,0.16639564345951682,128898.98667800461,-1960.9988396400095,126937.9878383646,779,0,299.18367346938777,41,8,16,38.45496287612349,0.600609756097561,46.13095238095239,1015.476190476191,24.76771196283393,3
785,4,2,2,48,0.04,0.04,0.96,50,1350,1000,350,0.7407407407407407,17,10,7,299.09037509816926,0.4326785714285714,0.2523019731198166,0.16575579108055424,129176.76150959975,-2272.8947892254123,126903.86672037434,780,0,294.16,42,8,17,38.25640231309374,0.6019345238095237,45.85755813953488,1016.5697674418602,24.20404208194905,0
786,4,1,0,49,0.02040816326530612,0.0,1.0,49,1500,1200,300,0.8,18,12,6,302.8466992949823,0.4321853741496599,0.2309250480111873,0.1664862389933278,128856.81918905124,-1995.227525389091,126861.59166366216,781,0,301.0816326530612,42,7,15,38.4853979767131,0.5987103174603174,46.17248062015504,1015.3100775193807,24.17404946474716,1
787,4,3,2,50,0.057692307692307696,0.038461538461538464,0.9615384615384616,52,1350,700,650,0.5185185185185185,20,7,13,294.5495867768593,0.4362823655103067,0.2564335664335662,0.16530844155844165,129672.49657064496,-2760.5438602299178,126911.95271041505,782,0,284.65384615384613,44,8,13,37.870265151515156,0.6041666666666665,45.37037037037038,1018.5185185185204,23.14814814814819,0
788,4,1,0,51,0.0196078431372549,0.0,1.0,51,1100,900,200,0.8181818181818182,13,9,4,305.0759386962591,0.4324019607843137,0.2750346235148342,0.17168499478931734,129779.68606519741,-2281.4680899908208,127498.21797520659,783,0,290.98039215686276,43,8,17,37.49380421313507,0.6065891472868217,45.265151515151516,1018.9393939393938,23.69626497533474,0
789,4,0,1,50,0.0,0.0196078431372549,0.9803921568627451,51,1750,1300,450,0.7428571428571429,22,13,9,304.9923702999885,0.43256535947712416,0.2762801914298283,0.1720994876797834,129884.77473422496,-2277.226937585735,127607.54779663924,784,1,291.98039215686276,44,7,18,37.38967360038757,0.6062973484848485,45.16203703703704,1019.3518518518518,23.167087542087543,0
790,4,0,0,50,0.0,0.0,1.0,50,1900,1500,400,0.7894736842105263,23,15,8,313.40882320958065,0.4309183673469388,0.2834516069106443,0.17702829961565275,129924.46212838605,-1856.1054436409677,128068.35668474509,785,2,298.76,43,7,18,37.13503932132021,0.6080426356589148,45.123106060606055,1019.5075757575751,23.709478505990116,0
791,4,0,0,50,0.0,0.0,1.0,50,1500,900,600,0.6,21,9,12,314.78679700383725,0.4309353741496598,0.2834561626429484,0.17859531047313454,130097.2265089161,-1809.4221536351356,128287.80435528095,786,3,299.76,44,6,18,36.925183033823444,0.6084280303030304,44.953703703703695,1020.1851851851834,23.186026936026895,0
792,4,0,0,50,0.0,0.0,1.0,50,1250,1000,250,0.8,15,10,5,313.737239873526,0.43073979591836736,0.28016690856313553,0.1786487258453381,130238.95747599438,-1827.8377914952116,128411.11968449916,787,4,300.76,44,6,18,36.80870524915338,0.6098484848484849,44.81481481481481,1020.7407407407396,23.198653198653172,0
793,4,2,2,50,0.038461538461538464,0.038461538461538464,0.9615384615384616,52,1700,1200,500,0.7058823529411765,22,12,10,299.99679107497013,0.4340749120160885,0.2655558794592434,0.1731255401747569,130757.64607182542,-2554.616580598949,128203.02949122648,788,0,290.15384615384613,42,10,13,36.636467708826785,0.6178075396825398,44.30717054263565,1022.7713178294558,24.35169804355847,0
794,4,0,0,50,0.0,0.0,1.0,50,1500,1100,400,0.7333333333333333,19,11,8,310.7747766050296,0.43014455782312927,0.26900159108989685,0.17837620739384558,130548.03688280775,-1885.7926003040598,128662.24428250369,789,6,302.76,40,10,13,36.57227857332273,0.6187500000000001,44.512195121951216,1021.9512195121943,25.548780487804855,0
795,4,1,0,51,0.0196078431372549,0.0,1.0,51,1100,700,400,0.6363636363636364,15,7,8,312.84889293837574,0.4326797385620915,0.25811329400309324,0.17595608600641363,129756.71315980065,-2076.503656095405,127680.20950370525,790,0,297.80392156862746,41,10,18,37.31905225576111,0.6092479674796749,45.2876984126984,1018.8492063492039,24.84998064266351,4
796,4,1,1,51,0.019230769230769232,0.019230769230769232,0.9807692307692307,52,1400,1000,400,0.7142857142857143,18,10,8,311.5075401720538,0.43333647561588734,0.27232932372586593,0.17647623077777355,130040.11646685876,-2298.3046391443017,127741.81182771445,791,0,293.0576923076923,42,10,19,37.066549496484896,0.6106150793650794,45.00968992248061,1019.9612403100759,24.28479143595419,0
797,4,0,1,50,0.0,0.0196078431372549,0.9803921568627451,51,1550,1100,450,0.7096774193548387,20,11,9,343.8198758772332,0.43217320261437914,0.32647265886139265,0.18330300406688094,127630.56593504194,-1402.2398272526218,126228.32610778933,792,1,299.62745098039215,40,11,17,38.69765999530657,0.5893229166666667,47.38313008130081,1010.4674796747966,25.261686991869915,5
798,4,4,1,53,0.07407407407407407,0.018518518518518517,0.9814814814814815,54,1250,800,450,0.64,17,8,9,331.0118625242712,0.43871564174237127,0.3690952436535475,0.18118270844180048,128684.7068704555,-2278.701530647949,126406.00533980755,793,0,281.462962962963,42,12,17,37.94567535733613,0.5969742063492063,46.34205426356589,1014.6317829457364,24.157899593946105,0
799,4,0,0,53,0.0,0.0,1.0,53,1300,1000,300,0.7692307692307693,16,10,6,342.41124802680326,0.43681966618287377,0.37786763675002377,0.1874829895512926,128697.58204207616,-1786.5000629881513,126911.081979088,794,1,287.7169811320755,41,12,20,37.64339721027246,0.5985772357723577,46.32936507936508,1014.6825396825403,24.748354626403422,0
800,4,0,1,52,0.0,0.018867924528301886,0.9811320754716981,53,1550,1100,450,0.7096774193548387,20,11,9,316.8911899963286,0.43686502177068215,0.2651241613176296,0.17004920320466096,127892.44746540874,-2431.512286999732,125460.93517840901,795,2,288.7169811320755,45,8,17,39.11067953195429,0.5849537037037038,47.12409420289854,1011.5036231884033,22.477858293075627,7
801,4,4,3,53,0.07142857142857142,0.05357142857142857,0.9464285714285714,56,1900,1400,500,0.7368421052631579,24,14,10,304.77987921169773,0.44070616883116887,0.2773507742257748,0.1663493233865371,128571.2489311401,-3362.3176727586692,125208.93125838143,796,0,273.75,46,10,12,38.72632575757576,0.5905797101449275,46.45390070921985,1014.1843971631191,22.047486894850415,0
802,4,3,3,53,0.05357142857142857,0.05357142857142857,0.9464285714285714,56,1550,1200,350,0.7741935483870968,19,12,7,305.9524487149205,0.4401244588744589,0.2758852098783926,0.16717802856714983,128616.20784291517,-3329.9112532066,125286.29658970857,797,0,274.69642857142856,46,10,12,38.6509133018703,0.5910326086956523,46.4095744680851,1014.3617021276582,22.051341350601266,0
803,4,3,3,53,0.05357142857142857,0.05357142857142857,0.9464285714285714,56,1850,1300,550,0.7027027027027027,24,13,11,301.9324422685187,0.4392992424242424,0.2543457432247467,0.16536120114046454,128707.64853395057,-3422.484206375156,125285.16432757542,798,0,275.64285714285717,44,12,15,38.66000547495211,0.5944602272727273,46.31944444444444,1014.722222222222,23.06186868686868,1
804,4,2,2,53,0.03636363636363636,0.03636363636363636,0.9636363636363636,55,1300,1000,300,0.7692307692307693,16,10,6,308.4266955610528,0.4386503928170595,0.22999557449980212,0.17075026847869343,129135.2081298828,-3033.305679132908,126101.90245074988,799,0,281.6181818181818,47,8,14,38.06126697412248,0.5950797872340425,45.8984375,1016.4062499999999,21.625664893617017,1
805,4,2,2,53,0.03636363636363636,0.03636363636363636,0.9636363636363636,55,1550,1200,350,0.7741935483870968,19,12,7,305.5925241111361,0.43973063973063975,0.2512292100231799,0.17050349242462465,129442.18911415298,-3088.6191235867095,126353.56999056626,800,0,280.4,43,12,14,37.822212916434026,0.6031976744186045,45.596590909090914,1017.613636363637,23.665433403805512,0
806,4,4,6,51,0.07017543859649122,0.10526315789473684,0.8947368421052632,57,1350,800,550,0.5925925925925926,19,8,11,300.8763115135784,0.4453059732664996,0.27124966693312014,0.1703150523545188,130008.42723594047,-3576.7087895137533,126431.71844642672,801,0,271.36842105263156,45,12,16,37.369641323977866,0.6062500000000001,45.04076086956522,1019.8369565217392,22.66304347826087,0
807,4,0,0,51,0.0,0.0,1.0,51,1150,700,450,0.6086956521739131,16,7,9,324.664690029429,0.43338235294117644,0.2890333029205594,0.18196806546769434,129620.41348363974,-1783.3657269695395,127837.0477566702,802,1,302.921568627451,42,9,16,37.15624702635835,0.6063988095238095,45.42151162790697,1018.3139534883716,24.245570321151703,0
808,4,0,0,51,0.0,0.0,1.0,51,1450,1000,450,0.6896551724137931,19,10,9,323.9571257092503,0.43331699346405234,0.2892203485921667,0.18214359463674099,129743.78511657944,-1793.7152589988686,127950.06985758057,803,2,303.921568627451,42,9,16,37.04921216156237,0.607638888888889,45.30038759689922,1018.7984496124024,24.257105943152435,0
809,4,0,0,51,0.0,0.0,1.0,51,1600,1100,500,0.6875,21,11,10,327.044527318061,0.43302287581699345,0.29563655136039824,0.18469326204580325,129916.60399202253,-1702.2971313322687,128214.30686069027,804,3,304.921568627451,42,9,16,36.795456705636354,0.609375,45.130813953488364,1019.476744186045,24.273255813953455,0
810,4,1,0,52,0.019230769230769232,0.0,1.0,52,1200,700,500,0.5833333333333334,17,7,10,321.52167098260765,0.4354182378079437,0.2995728156791224,0.18331188454747982,130287.90632282985,-2021.0027629944063,128266.90355983544,805,0,300.03846153846155,41,11,17,36.56056667638389,0.6145833333333335,44.76686507936507,1020.9325396825379,24.90079365079361,0
811,4,1,1,52,0.018867924528301886,0.018867924528301886,0.9811320754716981,53,1700,1000,700,0.5882352941176471,24,10,14,315.6722355756352,0.4359881470730527,0.3048624560311737,0.18170527864476396,130658.5591028933,-2350.944110179691,128307.61499271361,806,0,295.35849056603774,42,11,16,36.3356158973873,0.6168154761904763,44.404069767441854,1022.3837209302313,24.34246954595789,0
812,4,0,0,52,0.0,0.0,1.0,52,1650,1500,150,0.9090909090909091,18,15,3,323.8390657013489,0.43518256661639015,0.3139793976038514,0.1863295126774092,130642.6379145408,-1938.5620393990991,128704.0758751417,807,1,301.5769230769231,41,11,17,36.14295245026685,0.618140243902439,44.419642857142854,1022.3214285714284,24.934668989547035,0
813,4,1,1,52,0.018867924528301886,0.018867924528301886,0.9811320754716981,53,1500,1200,300,0.8,18,12,6,322.7091050866566,0.43662312530237063,0.31916288659056957,0.18695177503127747,130906.34694617245,-2151.065985367436,128755.28096080502,808,0,296.8679245283019,42,11,17,35.905690748982096,0.6192956349206348,44.16182170542637,1023.3527131782973,24.36554078995946,0
814,4,0,0,52,0.0,0.0,1.0,52,1400,1000,400,0.7142857142857143,18,10,8,330.31574822578307,0.4338549522373052,0.3267774306541702,0.1916049010713315,130955.9326832072,-1748.6386222282238,129207.29406097897,809,3,303.5769230769231,42,10,17,35.66103379721669,0.6197916666666666,44.11337209302326,1023.5465116279074,24.3701550387597,0
815,4,0,2,50,0.0,0.038461538461538464,0.9615384615384616,52,1400,1100,300,0.7857142857142857,17,11,6,334.20280386780564,0.4339413650075415,0.3280587952649283,0.194234698881586,131030.32889399672,-1641.859338381111,129388.46955561561,810,4,304.5769230769231,42,10,17,35.486466023092945,0.6205357142857143,44.0406976744186,1023.8372093023253,24.377076411960125,0
816,4,0,0,50,0.0,0.0,1.0,50,1200,700,500,0.5833333333333334,17,7,10,336.4048134126556,0.43362244897959185,0.31274418604651144,0.19547847265870522,131023.24263038543,-1184.6301020408257,129838.6125283446,811,5,303.64,41,9,17,35.43725775193799,0.6219512195121951,44.047619047619044,1023.8095238095233,24.970963995354225,0
817,4,2,2,50,0.038461538461538464,0.038461538461538464,0.9615384615384616,52,1800,1400,400,0.7777777777777778,22,14,8,321.88382702881506,0.4354103821015585,0.30300802613821975,0.1892509145886031,131473.7619447314,-1936.1444702708868,129537.61747446052,812,0,292.9230769230769,43,9,17,35.355109264389036,0.623546511627907,43.60795454545455,1025.568181818182,23.850422832980975,0
818,4,0,0,50,0.0,0.0,1.0,50,1300,900,400,0.6923076923076923,17,9,8,334.638659943789,0.43365646258503404,0.30855068254429274,0.19561305707749832,131251.87119118476,-1215.6099418934302,130036.26124929133,813,7,305.64,41,9,17,35.25177897182689,0.6242378048780488,43.82440476190476,1024.7023809523805,24.99274099883855,0
819,4,0,0,50,0.0,0.0,1.0,50,1600,1100,500,0.6875,21,11,10,333.001550383882,0.43357142857142855,0.3080030959752327,0.19556272867998867,131429.83119173584,-1246.732489292026,130183.0987024438,814,8,306.64,41,9,19,35.11432533539731,0.6260162601626016,43.650793650793645,1025.3968253968244,25.00967866821523,0
820,4,0,0,50,0.0,0.0,1.0,50,1450,800,650,0.5517241379310345,21,8,13,332.07950944483315,0.4331802721088435,0.29926499032882026,0.19554112344302826,131531.57675107085,-1264.2117031997923,130267.36504787106,815,9,307.64,41,9,19,35.0354609929078,0.6270325203252032,43.551587301587304,1025.793650793651,25.019357336430513,0
821,4,1,1,50,0.0196078431372549,0.0196078431372549,0.9803921568627451,51,1200,800,400,0.6666666666666666,16,8,8,328.81541207608853,0.43426470588235294,0.3010618987615803,0.19498919539845064,131800.32680014736,-1532.4042462892749,130267.9225538581,816,0,302.5882352941176,42,9,17,34.84869931741686,0.6282242063492063,43.28972868217055,1026.841085271319,24.448597268364736,0
822,4,0,0,50,0.0,0.0,1.0,50,1700,1300,400,0.7647058823529411,21,13,8,337.7689562336213,0.4348214285714285,0.30758887171561033,0.20049221530564496,131837.0496346688,-1093.907470395553,130743.14216427325,817,1,304.0,41,9,17,34.58188433797013,0.6300813008130081,43.25396825396826,1026.984126984128,25.04839334107629,0
823,4,0,0,50,0.0,0.0,1.0,50,1600,1300,300,0.8125,19,13,6,336.4134404674946,0.43396258503401364,0.31210810810810785,0.20076285963382728,132040.8950617283,-1115.9336419753195,130924.96141975299,818,2,305.0,41,9,17,34.41159909909909,0.6321138211382114,43.05555555555555,1027.7777777777771,25.06775067750676,0
824,4,0,0,50,0.0,0.0,1.0,50,2100,1500,600,0.7142857142857143,27,15,12,334.1746387844142,0.4326020408163265,0.3177995478522979,0.20065599351444255,132273.37599903863,-1159.5184709452456,131113.8575280934,819,3,306.0,42,8,17,34.235470045214775,0.6329365079365079,42.82945736434109,1028.6821705426364,24.492432631967535,0
825,4,0,0,50,0.0,0.0,1.0,50,1400,800,600,0.5714285714285714,20,8,12,334.48344003056087,0.43258503401360543,0.3161559468876538,0.20123964020875532,132348.14544085416,-1146.3474062556058,131201.79803459856,820,4,307.0,42,8,18,34.15242332925261,0.6336805555555554,42.75678294573645,1028.9728682170562,24.499354005168005,0
826,4,1,1,50,0.0196078431372549,0.0196078431372549,0.9803921568627451,51,1450,1100,350,0.7586206896551724,18,11,7,325.51520220583524,0.434624183006536,0.305440588054243,0.19138597393535284,131473.76194473155,-1622.4803650488304,129851.28157968272,821,0,301.96078431372547,43,8,16,35.262003693444136,0.623546511627907,43.607954545454554,1025.5681818181831,23.850422832981003,6
827,4,0,0,50,0.0,0.0,1.0,50,1750,1200,550,0.6857142857142857,23,12,11,333.16879283837477,0.4345663265306123,0.30720710506424775,0.1959032501889644,131477.1498107085,-1239.1833423472171,130237.9664683613,822,1,307.82,42,8,16,35.06235827664398,0.625,43.604651162790695,1025.5813953488373,24.41860465116279,0
828,4,0,0,50,0.0,0.0,1.0,50,700,500,200,0.7142857142857143,9,5,4,334.43712521437453,0.4345833333333333,0.30868694502172755,0.1969049726095309,131526.84352653072,-1202.50811249325,130324.33541403747,823,2,308.82,42,8,16,34.979768877133324,0.6254960317460319,43.55620155038759,1025.7751937984485,24.42321889996306,0
829,4,2,2,50,0.038461538461538464,0.038461538461538464,0.9615384615384616,52,1500,1200,300,0.8,18,12,6,319.9499801975817,0.43765711412770236,0.2972929450452597,0.19074264452661896,132002.1079884082,-1953.1856326139632,130048.92235579425,824,0,297.90384615384613,45,7,14,34.873567650947564,0.6261574074074074,43.09329710144927,1027.6268115942012,22.836151368760024,0
830,4,0,1,49,0.0,0.02,0.98,50,1500,1100,400,0.7333333333333333,19,11,8,330.14590033781184,0.4342091836734694,0.29869015773452645,0.19547305874179233,131740.9726257604,-1301.2515962178672,130439.72102954252,825,4,310.82,43,7,14,34.87426206069549,0.6262112403100775,43.347537878787875,1026.609848484848,23.874647639182513,0
831,4,1,0,50,0.02,0.0,1.0,50,1650,1300,350,0.7878787878787878,20,13,7,333.4763807178922,0.4342942176870748,0.3032549995392133,0.1987123672251426,131984.12682399273,-1197.282214904728,130786.844609088,826,0,310.96,43,7,16,34.54414723681383,0.6286337209302326,43.11079545454545,1027.5568181818178,23.896670190274833,0
832,4,0,1,49,0.0,0.02,0.98,50,1200,800,400,0.6666666666666666,16,8,8,339.78309193185737,0.43422619047619043,0.3078673422385996,0.20299094457459066,132081.4512758982,-1024.1912197256665,131057.26005617254,827,1,311.96,43,7,16,34.28422002149547,0.6296027131782946,43.016098484848484,1027.9356060606062,23.90547921071177,0
833,4,1,0,50,0.02,0.0,1.0,50,1400,1100,300,0.7857142857142857,17,11,6,338.1715792558687,0.43425170068027213,0.3083516897298315,0.20399754039949425,132447.8708930503,-1041.5999886500067,131406.2709044003,828,0,310.64,42,8,17,33.957372368132035,0.6346726190476191,42.65988372093023,1029.360465116279,24.50858250276855,0
834,4,0,0,50,0.0,0.0,1.0,50,1400,1000,400,0.7142857142857143,18,10,8,336.021341103216,0.4343197278911564,0.30565782044042966,0.2031036843323533,132522.68962952934,-1093.9096208160704,131428.78000871328,829,1,311.64,42,8,17,33.93759018759019,0.6354166666666667,42.587209302325576,1029.6511627906966,24.515503875968967,0
835,4,1,1,50,0.0196078431372549,0.0196078431372549,0.9803921568627451,51,1050,600,450,0.5714285714285714,15,6,9,330.68376265778807,0.43415032679738563,0.30336309459469213,0.2012954179400092,132788.1262913223,-1417.8245523415999,131370.3017389807,830,0,306.5098039215686,43,8,15,33.8088019110621,0.6366279069767442,42.32954545454545,1030.681818181818,23.96934460887949,0
836,4,0,0,50,0.0,0.0,1.0,50,1000,700,300,0.7,13,7,6,337.4063547952972,0.4337074829931973,0.30545146726862327,0.20475481530728287,132672.39048134108,-1047.0984691424976,131625.29201219857,831,3,313.64,42,8,15,33.75168516428393,0.636904761904762,42.44186046511627,1030.2325581395335,24.529346622369843,0
837,4,0,0,50,0.0,0.0,1.0,50,1600,800,800,0.5,24,8,16,340.35864614517993,0.43258503401360543,0.3122946904280721,0.20745488364705666,132836.9319975323,-957.5603334481062,131879.37166408417,832,4,314.64,43,7,15,33.51054871700654,0.6371124031007751,42.282196969696976,1030.8712121212134,23.973749119097985,0
838,4,0,1,49,0.0,0.02,0.98,50,1400,800,600,0.5714285714285714,20,8,12,348.3316799007149,0.43277210884353745,0.32373757455268426,0.20047006291768849,130651.9143697535,-825.6726900293079,129826.24167972419,833,5,315.64,40,10,14,35.507579522862834,0.6197916666666666,44.41056910569106,1022.3577235772361,25.558943089430905,6
839,4,2,1,50,0.0392156862745098,0.0196078431372549,0.9803921568627451,51,1350,900,450,0.6666666666666666,18,9,9,337.79999118586005,0.4355392156862745,0.3245509048703239,0.19645198166543668,131055.13232565655,-1345.915491106297,129709.21683455026,834,0,310.27450980392155,42,9,15,35.369349547332895,0.6207837301587301,44.01647286821706,1023.9341085271321,24.37938353636029,0
840,4,0,0,50,0.0,0.0,1.0,50,1300,1000,300,0.7692307692307693,16,10,6,339.78706839562165,0.4326785714285714,0.3251386391596478,0.19760759228049207,131055.13232565671,-1093.832157772947,129961.30016788376,835,1,317.48,42,8,15,35.31848364404909,0.62078373015873,44.016472868217065,1023.9341085271335,24.379383536360322,0
841,4,1,1,50,0.0196078431372549,0.0196078431372549,0.9803921568627451,51,1400,900,500,0.6428571428571429,19,9,10,332.89225845332334,0.4331862745098039,0.31999391274573163,0.1948562960108341,131303.8600224548,-1457.9922986971835,129845.86772375763,836,0,312.2352941176471,43,8,15,35.24409821676059,0.6218507751937984,43.77367424242425,1024.9053030303044,23.83500704721638,0
842,4,0,0,50,0.0,0.0,1.0,50,1750,1100,650,0.6285714285714286,24,11,13,338.79869668974834,0.4315986394557823,0.32477163120567343,0.19805396448281323,131253.64428407256,-1106.2872761552653,130147.3570079173,837,3,319.48,42,8,15,35.14342001576043,0.6227678571428571,43.822674418604656,1024.7093023255823,24.39784053156148,0
843,4,0,1,49,0.0,0.02,0.98,50,1400,900,500,0.6428571428571429,19,9,10,338.8300438536273,0.43133503401360546,0.3214265393212765,0.1987345227417995,131381.51584201373,-1096.7356662854747,130284.78017572826,838,4,320.48,39,11,15,35.01363205310574,0.6287393162393163,43.69791666666666,1025.208333333332,26.287393162393126,0
844,4,1,1,49,0.02,0.02,0.98,50,1400,1100,300,0.7857142857142857,17,11,6,335.57308200663647,0.43306122448979595,0.3136163298466541,0.19751273989954246,131515.04041883655,-1173.4185112847476,130341.6219075518,839,0,319.8,39,11,15,34.96253088927253,0.6300747863247864,43.56770833333332,1025.7291666666647,26.300747863247814,0
845,4,0,1,48,0.0,0.02040816326530612,0.9795918367346939,49,2050,1800,250,0.8780487804878049,23,18,5,341.5253906250002,0.4309630102040816,0.31785714285714284,0.20089728860294098,131492.43918474665,-818.398668639079,130674.04051610756,840,6,327.3265306122449,38,11,15,34.83268229166666,0.6315789473684212,43.58974358974358,1025.6410256410238,26.990553306342733,0
846,4,1,0,49,0.02040816326530612,0.0,1.0,49,1200,1000,200,0.8333333333333334,14,10,4,341.8839414708466,0.43227395124716556,0.3189638507635806,0.20212178619756416,131684.26890432072,-795.8526234568167,130888.41628086391,841,0,326.9387755102041,38,11,16,34.63013080739738,0.633497807017544,43.402777777777764,1026.3888888888869,27.010233918128602,0
847,4,0,0,49,0.0,0.0,1.0,49,1150,900,250,0.782608695652174,14,9,5,338.1904597569288,0.4322562358276644,0.31372501494659666,0.20053265289812233,131797.29327781062,-885.4825583317013,130911.81071947892,842,1,327.9387755102041,40,9,16,34.61108636843495,0.6312500000000001,43.29268292682926,1026.8292682926813,25.67073170731703,0
848,4,0,0,49,0.0,0.0,1.0,49,1300,600,700,0.46153846153846156,20,6,14,347.04762895987835,0.4317424886621315,0.3206235704292604,0.20649231790202494,131927.7662622279,-642.9563049441781,131284.80995728372,843,2,328.9387755102041,40,9,16,34.252275200316525,0.6325520833333336,43.16565040650405,1027.3373983739814,25.683434959349533,0
849,4,0,0,49,0.0,0.0,1.0,49,1000,600,400,0.6,14,6,8,347.9181884587296,0.4318310657596372,0.32305570876999523,0.2076285963382737,132040.8950617281,-612.1141975308893,131428.7808641972,844,3,329.9387755102041,41,8,17,34.11599099099099,0.6321138211382116,43.05555555555554,1027.7777777777756,25.06775067750672,0
850,4,0,0,49,0.0,0.0,1.0,49,1700,1100,600,0.6470588235294118,23,11,12,344.9058664459309,0.43172477324263037,0.31495207114107804,0.2063859353259595,132142.8768266562,-684.6293146888761,131458.24751196732,845,4,330.9387755102041,41,8,17,34.09076289720829,0.6331300813008132,42.95634920634919,1028.1746031746,25.07742934572195,0
851,4,1,0,50,0.02,0.0,1.0,50,900,600,300,0.6666666666666666,12,6,6,341.4044758527482,0.432219387755102,0.3189661615113146,0.2058254518376327,132425.49332493218,-956.8845823997212,131468.60874253247,846,0,325.3,38,12,18,33.89665940073352,0.6408991228070177,42.68162393162392,1029.273504273502,27.086144849302688,0
852,4,0,1,49,0.0,0.02,0.98,50,1300,1100,200,0.8461538461538461,15,11,4,341.34821433184504,0.4321768707482993,0.256506922257721,0.19425816561066828,130216.35751417775,-1110.1757771476546,129106.1817370301,847,1,326.3,45,5,14,36.12701159626079,0.6083333333333334,44.83695652173913,1020.652173913044,22.681159420289866,6
853,4,0,1,48,0.0,0.02040816326530612,0.9795918367346939,49,1050,700,350,0.6666666666666666,14,7,7,345.0229071220323,0.43126417233560094,0.25689296126613903,0.1965828191741813,130262.58680555565,-811.2847222222128,129451.30208333343,848,2,333.0,44,5,15,35.98639455782313,0.6100852272727272,44.79166666666667,1020.8333333333342,23.200757575757596,0
854,4,1,0,49,0.02040816326530612,0.0,1.0,49,1600,1200,400,0.75,20,12,8,348.8128299004966,0.4323625283446712,0.2738291904439505,0.20065296376500744,130633.79322907267,-686.6513806261735,129947.1418484465,849,0,332.85714285714283,42,7,14,35.51362559241706,0.6165674603174605,44.428294573643406,1022.2868217054255,24.34016242155775,0
855,4,0,1,48,0.0,0.02040816326530612,0.9795918367346939,49,1450,1000,450,0.6896551724137931,19,10,9,349.35296908285113,0.4318842120181406,0.27232544257984626,0.20205618190423563,130843.25140610643,-657.9043273645641,130185.34707874186,850,1,333.85714285714283,43,6,14,35.28785634950018,0.6172480620155039,44.223484848484844,1023.1060606060598,23.793164200140925,0
856,4,0,0,48,0.0,0.0,1.0,48,1500,1200,300,0.8,18,12,6,352.5451191636862,0.4293827570921986,0.2695469110079869,0.20397391305475948,130856.77059859675,-373.4168431885178,130483.35375540823,851,2,341.625,42,6,14,35.19252927991919,0.6187996031746033,44.21027131782945,1023.1589147286813,24.36092654115908,0
857,4,1,2,47,0.02040816326530612,0.04081632653061224,0.9591836734693877,49,1250,1000,250,0.8,15,10,5,345.1706411715234,0.43071499433106575,0.2711717949637096,0.20127821162007398,131158.31723664212,-745.5999088900237,130412.71732775209,852,0,335.6326530612245,43,6,14,35.07644217435518,0.6203972868217054,43.9157196969697,1024.3371212121222,23.82179351656098,0
858,4,0,0,47,0.0,0.0,1.0,47,950,700,250,0.7368421052631579,12,7,5,357.6267590294948,0.4282878507554733,0.2821299285279648,0.20712633460916563,130896.31287989739,-37.59517117031237,130858.71770872708,853,4,350.531914893617,41,6,14,35.02251979318145,0.620680894308943,44.17162698412699,1023.3134920634926,24.958865660085184,0
859,4,0,0,47,0.0,0.0,1.0,47,900,500,400,0.5555555555555556,13,5,8,359.01744712880947,0.42805658341042246,0.27921640106145884,0.2084806436084514,130997.85175933782,6.1028635991241345,131003.95462293694,854,5,351.531914893617,41,6,15,34.88417401556996,0.6216971544715448,44.072420634920626,1023.7103174603161,24.968544328300393,0
860,4,0,1,46,0.0,0.02127659574468085,0.9787234042553191,47,950,800,150,0.8421052631578947,11,8,3,359.9456812607533,0.42765186555658347,0.28080654436179553,0.20957243472390022,131099.43000637737,37.734729308374085,131137.16473568574,855,6,352.531914893617,41,6,15,34.75764070522136,0.6227134146341464,43.97321428571428,1024.1071428571413,24.97822299651564,0
861,4,1,3,44,0.02127659574468085,0.06382978723404255,0.9361702127659575,47,1050,700,350,0.6666666666666666,14,7,7,362.7282132052765,0.4283842121492445,0.2778957865047007,0.21175207788416564,131201.047621016,118.06431484630926,131319.1119358623,856,0,352.36170212765956,41,6,15,34.58359559084598,0.6237296747967479,43.87400793650794,1024.5039682539684,24.987901664730938,0
862,4,0,0,44,0.0,0.0,1.0,44,1350,1000,350,0.7407407407407407,17,10,7,373.96110695932134,0.425332540521494,0.26762155265663856,0.21797033578725603,131141.34250217024,1008.3523220486204,132149.69482421887,857,8,353.8181818181818,39,5,15,34.356355300179665,0.62633547008547,43.93229166666667,1024.2708333333342,26.263354700854723,0
863,4,1,0,45,0.022222222222222223,0.0,1.0,45,1050,700,350,0.6666666666666666,14,7,7,371.5647976784029,0.4266624579124579,0.26719039234276964,0.2182388942927328,131434.9175347224,767.4506293402965,132202.3681640627,858,0,346.93333333333334,39,6,16,34.12061492618178,0.6292735042735043,43.64583333333334,1025.416666666668,26.292735042735078,0
864,4,1,3,43,0.021739130434782608,0.06521739130434782,0.9347826086956522,46,1550,1100,450,0.7096774193548387,20,11,9,361.49242719083674,0.4285024154589372,0.25903573964298165,0.21414339605025606,131760.64819735783,326.0953050201804,132086.74350237803,859,0,340.3695652173913,41,5,14,34.049888072921725,0.6293191056910568,43.32837301587303,1026.6865079365093,25.041134339914862,0
865,4,1,1,43,0.022727272727272728,0.022727272727272728,0.9772727272727273,44,1350,1000,350,0.7407407407407407,17,10,7,372.3331040363682,0.42580602536997886,0.2636935739859003,0.21991761036968238,131648.63281250015,1003.4288194444591,132652.0616319446,860,0,353.52272727272725,39,5,14,33.884828799566925,0.6314102564102564,43.43750000000001,1026.2500000000011,26.314102564102594,0
866,4,1,1,43,0.022727272727272728,0.022727272727272728,0.9772727272727273,44,1000,600,400,0.6,14,6,8,371.695825430074,0.4259051268498943,0.266579221569585,0.22062306700271533,131835.77609592024,1000.5615234375057,132836.33761935774,861,0,354.5,39,5,15,33.712111606991904,0.6332799145299146,43.255208333333336,1026.9791666666674,26.332799145299166,0
867,4,1,0,44,0.022727272727272728,0.0,1.0,44,950,600,350,0.631578947368421,13,6,7,371.1212783614862,0.42749075052854124,0.2766637183633234,0.2215277467388254,132049.81689453125,1001.2993706597229,133051.11626519097,862,0,354.0681818181818,39,5,16,33.51079777710213,0.6354166666666667,43.046875,1027.8125,26.354166666666668,0
868,4,0,0,44,0.0,0.0,1.0,44,1050,600,450,0.5714285714285714,15,6,9,370.5209260405536,0.42752378435517974,0.2783687943262412,0.22163888121334926,132130.126953125,991.3953993055568,133121.52235243056,863,1,355.0681818181818,39,5,16,33.445204322863894,0.6362179487179487,42.96875,1028.125,26.362179487179485,0
869,4,0,0,44,0.0,0.0,1.0,44,900,600,300,0.6666666666666666,12,6,6,376.82455409703715,0.4266649048625793,0.28266613880346947,0.2260489457566308,132237.24500868045,1166.0481770833248,133403.29318576376,864,2,356.0681818181818,39,5,16,33.175089460536086,0.6372863247863249,42.86458333333333,1028.5416666666658,26.372863247863226,0
870,4,0,0,44,0.0,0.0,1.0,44,1700,1400,300,0.8235294117647058,20,14,6,373.85196683136763,0.42657681465821,0.2825457187612057,0.2253873497154814,132425.49332493235,1101.6038838780096,133527.09720881036,865,3,357.0681818181818,38,6,16,33.06172583212232,0.6408991228070176,42.681623931623925,1029.2735042735035,27.086144849302723,0
871,4,0,0,44,0.0,0.0,1.0,44,1200,1000,200,0.8333333333333334,14,10,4,369.9066820474856,0.4262464763918252,0.28091286307054,0.22398871953126628,132590.49236613332,1009.221820439758,133599.71418657308,866,4,358.0681818181818,38,6,16,32.99706085753803,0.6425438596491229,42.521367521367516,1029.914529914529,27.103013945119187,0
872,4,0,0,44,0.0,0.0,1.0,44,1800,1400,400,0.7777777777777778,22,14,8,370.0412868334428,0.42564085623678644,0.2794924360243185,0.22489276695075963,132728.0700402695,1022.9731673241255,133751.0432075936,867,5,359.0681818181818,38,6,14,32.85510627268015,0.6439144736842106,42.38782051282051,1030.4487179487173,27.117071524966246,0
873,4,0,0,44,0.0,0.0,1.0,44,1200,900,300,0.75,15,9,6,370.2801292047226,0.42549770965468636,0.28033129805517887,0.22553426051560374,132810.65088757395,1035.428994082837,133846.0798816568,868,6,360.0681818181818,38,6,14,32.76585820895522,0.6447368421052632,42.30769230769231,1030.7692307692307,27.125506072874494,0
874,4,0,0,44,0.0,0.0,1.0,44,1200,1000,200,0.8333333333333334,14,10,4,368.15511007780447,0.42550872093023256,0.27033232543024255,0.22473529205318754,132893.25741699556,985.0663625904157,133878.32377958597,869,7,361.0681818181818,38,6,14,32.73754015127966,0.6455592105263157,42.22756410256411,1031.0897435897448,27.133940620782756,0
875,4,0,1,43,0.0,0.022727272727272728,0.9772727272727273,44,1200,900,300,0.75,15,9,6,369.5457612767832,0.4251453488372093,0.27062263404712117,0.22608331935146167,132975.88962853389,1028.1352728468116,134004.0249013807,870,8,362.0681818181818,38,6,14,32.61860368759063,0.6463815789473684,42.1474358974359,1031.4102564102566,27.14237516869096,0
876,4,0,0,43,0.0,0.0,1.0,43,1300,900,400,0.6923076923076923,17,9,8,378.10087593689207,0.422203765227021,0.2776210689219558,0.2314115120324232,132991.11415291246,1456.811350607884,134447.92550352035,871,9,371.27906976744185,37,6,15,32.382689309379536,0.648367117117117,42.13267543859649,1031.4692982456143,27.877548601232817,0
877,4,1,0,44,0.022727272727272728,0.0,1.0,44,700,500,200,0.7142857142857143,9,5,4,345.6412727710821,0.4240111874559549,0.23211862764101543,0.20729636436015023,132228.78674207444,350.70622691596543,132579.4929689904,872,0,363.8181818181818,37,7,17,33.98542999289267,0.6407657657657657,42.872807017543856,1028.5087719298242,27.797534376481735,4
878,4,0,0,44,0.0,0.0,1.0,44,1250,800,450,0.64,17,8,9,343.78860382347636,0.42381298449612403,0.23018114011720847,0.20695677016570402,132369.79316953296,301.4452764312117,132671.23844596418,873,1,364.8181818181818,37,7,18,33.89129373113125,0.6421734234234234,42.73574561403509,1029.0570175438597,27.812351825509722,0
879,4,0,0,44,0.0,0.0,1.0,44,1000,700,300,0.7,13,7,6,342.5726012719824,0.42325140944326994,0.2278053220746017,0.20668840493196483,132454.4330947985,275.05193905817976,132729.48503385668,874,2,365.8181818181818,37,7,18,33.83752307910808,0.6430180180180181,42.65350877192983,1029.3859649122815,27.821242294926527,0
880,4,0,0,44,0.0,0.0,1.0,44,1300,1000,300,0.7692307692307693,16,10,6,344.18240164877267,0.4228550035236082,0.22037424048918286,0.20891071355890636,132680.27181440452,333.24292089875007,133013.51473530327,875,3,366.8181818181818,37,7,14,33.56924932595432,0.6452702702702702,42.434210526315795,1030.2631578947376,27.844950213371284,0
881,4,0,0,44,0.0,0.0,1.0,44,1600,1200,400,0.75,20,12,8,347.512861144156,0.4220071353065539,0.22965400199205122,0.21172834786884068,132821.5187004656,431.437197022168,133252.95589748776,876,4,367.8181818181818,37,7,16,33.34164361947311,0.6466779279279278,42.29714912280702,1030.8114035087724,27.859767662399253,0
882,4,0,0,44,0.0,0.0,1.0,44,1450,1200,250,0.8275862068965517,17,12,5,346.756109490943,0.42194106765327694,0.23009339379114957,0.21158648264395447,132878.0384950178,415.2543330640309,133293.29282808182,877,5,368.8181818181818,37,7,16,33.30441968875183,0.6472409909909909,42.242324561403514,1031.0307017543867,27.86569464201045,0
883,4,0,0,44,0.0,0.0,1.0,44,1050,800,250,0.7619047619047619,13,8,5,349.63635618055696,0.42166578576462294,0.23084394873678327,0.21382832030132112,132962.84072983998,497.72862803939984,133460.56935787937,878,6,369.8181818181818,37,7,16,33.14506697852435,0.6480855855855856,42.16008771929825,1031.3596491228072,27.874585111427223,0
884,4,0,1,43,0.0,0.022727272727272728,0.9772727272727273,44,1050,600,450,0.5714285714285714,15,6,9,357.04391172707255,0.4218199436222692,0.239798087141339,0.219021069710023,133075.9524565251,702.7917243767274,133778.74418090182,879,7,370.8181818181818,37,7,16,32.840506553312075,0.6492117117117117,42.050438596491226,1031.798245614035,27.886439070649597,0
885,4,0,0,43,0.0,0.0,1.0,43,1500,1200,300,0.8,18,12,6,359.49833659464,0.41971207087486156,0.24802816794145,0.2202919238490635,133036.20501836308,965.258882193017,134001.4639005561,880,18,380.27906976744185,36,7,16,32.817105119528435,0.6507523148148149,42.08896396396397,1031.6441441441452,28.656781781781813,0
886,4,0,1,42,0.0,0.023255813953488372,0.9767441860465116,43,1000,700,300,0.7,13,7,6,360.11487725863304,0.4194121447028423,0.24980647650180554,0.2210135713543775,133094.29943034257,985.8474606363146,134080.14689097888,881,19,381.27906976744185,36,7,16,32.74286987522282,0.6513310185185186,42.03265765765766,1031.8693693693697,28.663038038038046,0
887,4,0,0,42,0.0,0.0,1.0,42,1450,1100,350,0.7586206896551724,18,11,7,364.7038551888128,0.4151785714285714,0.2505899107077887,0.22365573770012745,133065.25063915274,1305.881979952932,134371.1326191057,882,20,390.5952380952381,36,6,16,32.65366914065342,0.6510416666666666,42.060810810810814,1031.7567567567573,28.659909909909928,0
888,4,1,1,42,0.023255813953488372,0.023255813953488372,0.9767441860465116,43,950,500,450,0.5263157894736842,14,5,9,358.6641657112283,0.416828165374677,0.23970351861773698,0.22152510012026608,133330.6296769197,964.1838113650211,134294.8134882847,883,0,382.48837209302326,37,6,16,32.54315302402943,0.6517454954954955,41.80372807017543,1032.7850877192973,27.913110478899927,0
889,4,0,0,42,0.0,0.0,1.0,42,850,600,250,0.7058823529411765,11,6,5,367.10249123422057,0.4153116531165311,0.24934937430846627,0.22600594608086677,133210.5262991034,1380.3832126045213,134590.90951170793,884,22,392.5952380952381,36,6,16,32.44586560488709,0.6524884259259258,41.92004504504506,1032.3198198198218,28.675550550550604,0
890,4,0,0,42,0.0,0.0,1.0,42,1200,600,600,0.5,18,6,12,368.58336177868483,0.41533584978706933,0.25077512737017615,0.22727241722587516,133268.6587558844,1424.1220527960547,134692.78080868046,885,23,393.5952380952381,36,6,16,32.34926564147309,0.6530671296296295,41.863738738738746,1032.545045045046,28.681806806806833,0
891,4,1,0,43,0.023255813953488372,0.0,1.0,43,1350,1100,250,0.8148148148148148,16,11,5,359.2738076604854,0.41777408637873753,0.24838789745356205,0.2238027206199849,133646.82883897412,1003.3163653518473,134650.14520432596,886,0,385.4186046511628,36,7,17,32.21043890219996,0.6568287037037037,41.49774774774775,1034.0090090090093,28.722472472472482,0
892,4,0,0,43,0.0,0.0,1.0,43,1050,900,150,0.8571428571428571,12,9,3,359.2738076604854,0.4175664451827243,0.24838789745356205,0.2238027206199849,133646.82883897412,1003.1610157454843,134649.9898547196,887,1,386.4186046511628,36,7,17,32.21043890219996,0.6568287037037037,41.49774774774775,1034.0090090090093,28.722472472472482,0
893,4,0,0,43,0.0,0.0,1.0,43,1600,1300,300,0.8125,19,13,6,359.0586381106358,0.41698966408268734,0.24856328386472826,0.2243750101826056,133763.29665814465,1005.7734254524839,134769.07008359715,888,2,387.4186046511628,36,7,16,32.09934501778068,0.6579861111111112,41.38513513513514,1034.4594594594598,28.734984984984994,0
894,4,0,0,43,0.0,0.0,1.0,43,1600,1100,500,0.6875,21,11,10,353.98661837370287,0.4170819490586932,0.23524948019689296,0.22260964222488538,133996.38447569194,886.5854029705446,134882.9698786625,889,3,388.4186046511628,36,7,16,31.997317090856374,0.6603009259259258,41.15990990990991,1035.3603603603606,28.760010010010017,0
895,4,0,0,43,0.0,0.0,1.0,43,1650,1200,450,0.7272727272727273,21,12,9,353.00052997106445,0.41717423403469917,0.231172751335458,0.22287246912860872,134142.16739966345,870.4512367097088,135012.61863637317,890,4,389.4186046511628,36,7,17,31.877106207196434,0.6617476851851851,41.01914414414416,1035.9234234234254,28.775650650650707,0
896,4,0,0,43,0.0,0.0,1.0,43,600,400,200,0.6666666666666666,8,4,4,352.608478867915,0.4169435215946844,0.2365010881021523,0.222979423646989,134200.50276205273,864.0470284473829,135064.5497905001,891,5,390.4186046511628,36,7,17,31.828967865811684,0.6623263888888888,40.962837837837846,1036.14864864865,28.78190690690694,0
897,4,1,0,44,0.022727272727272728,0.0,1.0,44,1200,1000,200,0.8333333333333334,14,10,4,346.3705679916664,0.4196397110641297,0.23819075438883042,0.2209718100990667,134522.34251163836,518.9160366651406,135041.2585483035,892,0,382.52272727272725,37,7,18,31.669375154141562,0.6635698198198197,40.65241228070176,1037.3903508771941,28.037577050734978,0
898,4,0,0,44,0.0,0.0,1.0,44,1150,900,250,0.782608695652174,14,9,5,346.31459599232534,0.41956263213530653,0.2381986705364667,0.2209405208334744,134523.0716725108,517.4606435824434,135040.53231609325,893,1,383.52272727272725,38,6,18,31.670099553724683,0.6617324561403508,40.651709401709404,1037.3931623931626,27.29982006297796,0
899,4,0,0,44,0.0,0.0,1.0,44,1150,800,350,0.6956521739130435,15,8,7,344.63385706027157,0.41899004580690624,0.2353321102291448,0.22020289603745768,134578.49368105776,476.06107093286175,135054.55475199062,894,2,384.52272727272725,38,6,18,31.658429434376714,0.6622807017543859,40.598290598290596,1037.6068376068374,27.305443094916775,0
900,4,0,0,44,0.0,0.0,1.0,44,1350,1200,150,0.8888888888888888,15,12,3,344.31687519379466,0.4184945384073291,0.24030284318953643,0.22084007104013892,134717.09863987513,477.07408777120673,135194.17272764634,895,3,385.52272727272725,38,6,18,31.5285067407636,0.6636513157894737,40.46474358974359,1038.141025641026,27.319500674763844,0
901,4,0,0,44,0.0,0.0,1.0,44,1250,900,350,0.72,16,9,7,344.22812211548205,0.41865970754052145,0.23932627364403447,0.22095171008707093,134744.82819234423,476.5918346847822,135221.420027029,896,4,386.52272727272725,38,6,19,31.503181381628586,0.6639254385964912,40.43803418803419,1038.2478632478633,27.322312190733243,0
902,4,0,0,44,0.0,0.0,1.0,44,1100,700,400,0.6363636363636364,15,7,8,352.8995732132918,0.4181752114164905,0.2303519972879826,0.2158993966920861,132975.88962853386,619.9551190737109,133595.84474760757,897,5,387.52272727272725,38,6,18,33.04782991506113,0.6463815789473684,42.1474358974359,1031.4102564102564,27.142375168690958,5
903,4,1,0,45,0.022222222222222223,0.0,1.0,45,1050,700,350,0.6666666666666666,14,7,7,345.50370947957816,0.41963383838383833,0.23355752847278244,0.21297467464935219,133257.03125000017,208.15972222223846,133465.19097222242,898,0,379.8888888888889,39,6,20,32.95668549905836,0.6474358974358974,41.87500000000001,1032.5000000000014,26.47435897435901,0
904,4,0,0,45,0.0,0.0,1.0,45,1050,400,650,0.38095238095238093,17,4,13,343.26068263096835,0.4181818181818182,0.23723049021176723,0.21267459902448163,133446.59514558152,161.39386889016282,133607.98901447168,899,1,380.8888888888889,41,4,20,32.82475196031364,0.6460873983739837,41.69146825396826,1033.2341269841281,25.20083236546654,0
905,4,0,0,45,0.0,0.0,1.0,45,1450,1300,150,0.896551724137931,16,13,3,343.3862400520271,0.41710858585858585,0.23642814770043552,0.21398588857479448,133660.6567382814,179.45099299848872,133840.1077312799,900,2,381.8888888888889,39,6,21,32.60730415365501,0.6514423076923077,41.48437500000001,1034.0625000000011,26.514423076923105,0
906,4,0,0,45,0.0,0.0,1.0,45,1300,900,400,0.6923076923076923,17,9,8,340.9871111881861,0.4169402356902357,0.22629517735257898,0.21295610151564104,133741.45507812515,120.82248263890438,133862.27756076405,901,3,382.8888888888889,39,6,17,32.588536421617995,0.6522435897435896,41.40625000000001,1034.3750000000011,26.522435897435926,0
907,4,1,0,46,0.021739130434782608,0.0,1.0,46,1500,1200,300,0.8,18,12,6,336.47993069948666,0.418377616747182,0.23427581735035163,0.21221556025304264,134103.04712803234,-175.4031991539309,133927.64392887842,902,0,375.54347826086956,40,6,19,32.343995290423855,0.6541666666666666,41.056910569105696,1035.772357723578,25.89430894308945,0
908,4,0,1,45,0.0,0.021739130434782608,0.9782608695652174,46,1650,1200,450,0.7272727272727273,21,12,9,337.3953853750826,0.41790458937198066,0.23039213595752317,0.21325145405449286,134182.0048107113,-145.52215529776504,134036.48265541354,903,1,376.54347826086956,40,6,20,32.24149910086643,0.6549479166666666,40.98069105691057,1036.0772357723586,25.901930894308965,0
909,4,0,0,45,0.0,0.0,1.0,45,1200,900,300,0.75,15,9,6,343.2983118623927,0.4158459595959596,0.23374684279934743,0.21629098964105886,134064.892578125,204.8502604166664,134269.74283854166,904,2,385.8,39,6,20,32.20554214443773,0.655448717948718,41.09375,1035.625,26.55448717948718,0
910,4,0,0,45,0.0,0.0,1.0,45,1450,1200,250,0.8275862068965517,17,12,5,342.3257126473012,0.4156144781144781,0.2331992491284527,0.21599536082263718,134118.8368055555,182.46527777777325,134301.30208333328,905,3,386.8,39,6,20,32.17685706623759,0.6559829059829061,41.041666666666664,1035.833333333333,26.559829059829053,0
911,4,1,0,46,0.021739130434782608,0.0,1.0,46,1500,1200,300,0.8,18,12,6,339.6992993270487,0.4184279388083736,0.24111601588464904,0.21610297071902757,134419.017284685,-67.59080243241871,134351.42648225257,906,0,379.3695652173913,40,6,21,31.945397229844517,0.6572916666666667,40.7520325203252,1036.9918699186987,25.92479674796747,0
912,4,0,0,46,0.0,0.0,1.0,46,1050,800,250,0.7619047619047619,13,8,5,340.87451641395916,0.4180656199677939,0.24388467142090287,0.21716387731091585,134471.71512492583,-32.4038270870324,134439.3112978388,907,1,380.3695652173913,40,6,21,31.862384871644128,0.6578124999999999,40.70121951219513,1037.195121951221,25.929878048780523,0
913,4,0,0,46,0.0,0.0,1.0,46,1400,1000,400,0.7142857142857143,18,10,8,340.11873081484833,0.41790458937198066,0.2439160876728026,0.21731796800485575,134578.49368105785,-45.42023153258694,134533.07344952525,908,2,381.3695652173913,38,8,22,31.775552580999463,0.6622807017543859,40.5982905982906,1037.606837606838,27.305443094916793,0
914,4,0,0,46,0.0,0.0,1.0,46,1200,700,500,0.5833333333333334,17,7,10,340.9863033976163,0.4174416264090177,0.2487713833015548,0.21820427873547094,134633.92710387916,-18.334976988805636,134615.59212689035,909,3,382.3695652173913,38,8,22,31.697807288449653,0.662828947368421,40.5448717948718,1037.820512820514,27.311066126855632,0
915,4,1,1,46,0.02127659574468085,0.02127659574468085,0.9787234042553191,47,1200,800,400,0.6666666666666666,16,8,8,334.89710295608194,0.41911424606845515,0.25140219016877463,0.215897143360117,134902.24745008702,-364.3256293402588,134537.92182074676,910,0,375.21276595744683,39,8,18,31.588727063070277,0.6637286324786325,40.28645833333334,1038.8541666666683,26.637286324786366,0
916,4,0,0,46,0.0,0.0,1.0,46,1400,800,600,0.5714285714285714,20,8,12,339.1894053039565,0.41707930756843803,0.25286017659550697,0.21888632824027723,134939.01495954793,-46.023152713845604,134892.9918068341,911,5,384.3695652173913,38,8,18,31.44065981148244,0.665844298245614,40.25106837606838,1038.9957264957272,27.341992802519137,0
917,4,0,0,46,0.0,0.0,1.0,46,1350,1000,350,0.7407407407407407,17,10,7,338.46106356940663,0.4170088566827697,0.25007844914751876,0.2186844281197154,134983.42013888908,-62.67361111109051,134920.74652777798,912,6,385.3695652173913,39,7,18,31.415396952686436,0.6645299145299144,40.20833333333334,1039.1666666666683,26.645299145299187,0
918,4,0,0,46,0.0,0.0,1.0,46,1400,1100,300,0.7857142857142857,17,11,6,337.33902453237016,0.4164049919484702,0.25201626286093615,0.21876936739475478,135117.47291509187,-83.92069790880117,135033.55221718308,913,7,386.3695652173913,41,5,19,31.31122773536896,0.6626016260162602,40.079365079365076,1039.6825396825388,25.358110723964362,0
919,4,0,0,46,0.0,0.0,1.0,46,1000,700,300,0.7,13,7,6,336.25392323548186,0.41610305958132043,0.24990667230780717,0.21837754791538547,135169.0493905896,-109.77536848072495,135059.27402210885,914,8,387.3695652173913,41,5,19,31.28816065636328,0.663109756097561,40.029761904761905,1039.8809523809525,25.362950058072013,0
920,4,0,0,46,0.0,0.0,1.0,46,1500,1000,500,0.6666666666666666,20,10,10,335.8137905877534,0.4153683574879227,0.24646456689648844,0.21887378632030913,135298.03363764504,-113.01089301459746,135185.02274463043,915,9,388.3695652173913,41,5,19,31.17143050125552,0.6643800813008129,39.905753968253975,1040.3769841269855,25.37504839334111,0
921,4,0,1,45,0.0,0.021739130434782608,0.9782608695652174,46,1350,1000,350,0.7407407407407407,17,10,7,333.9798542836931,0.41494565217391305,0.24522791993268322,0.21799095778355063,135349.64455979157,-159.189086514226,135190.45547327734,916,10,389.3695652173913,41,5,19,31.167870308577243,0.6648882113821137,39.8561507936508,1040.5753968253973,25.379887727448715,0
922,4,0,0,45,0.0,0.0,1.0,45,850,600,250,0.7058823529411765,11,6,5,339.62826964696956,0.4118265993265993,0.2528328504302719,0.22163504480021198,135342.72057183247,193.24279942496844,135535.96337125744,917,11,398.7111111111111,40,5,19,31.027810333040335,0.6664062499999999,39.86280487804879,1040.5487804878067,26.013719512195166,0
923,4,0,0,45,0.0,0.0,1.0,45,1300,1000,300,0.7692307692307693,16,10,6,339.2058004643178,0.411026936026936,0.25246509811578655,0.22201182199079944,135448.48805481216,188.98256246284342,135637.47061727502,918,12,399.7111111111111,40,5,21,30.933727098180878,0.6674479166666666,39.76117886178863,1040.9552845528472,26.02388211382118,0
924,4,0,0,45,0.0,0.0,1.0,45,1500,1000,500,0.6666666666666666,20,10,10,344.574452651563,0.4101851851851852,0.2668487982567398,0.22652620687786257,135607.2167381357,345.35649662902154,135952.5732347647,919,13,400.7111111111111,40,5,21,30.63632224282044,0.6690104166666665,39.60873983739839,1041.5650406504092,26.03912601626023,0
925,4,0,0,45,0.0,0.0,1.0,45,1200,800,400,0.6666666666666666,16,8,8,339.92857469892186,0.40957491582491584,0.2608570842731186,0.22433445991970816,135744.99255789325,228.72553246767956,135973.71809036093,920,14,401.7111111111111,38,7,21,30.62055737816963,0.6737938596491228,39.47649572649573,1042.0940170940175,27.42352676563204,0
926,4,1,0,46,0.021739130434782608,0.0,1.0,46,900,300,600,0.3333333333333333,15,3,12,336.11397482877214,0.41010466988727856,0.26670370884845074,0.22383760451362936,136068.05555555565,-53.124999999989654,136014.93055555565,921,0,393.95652173913044,39,7,18,30.399693823216182,0.6752136752136751,39.16666666666667,1043.3333333333342,26.752136752136774,0
927,4,0,0,46,0.0,0.0,1.0,46,1700,1200,500,0.7058823529411765,22,12,10,336.3605157785793,0.4097121578099839,0.2694120301861245,0.2245167226905788,136149.57817925359,-40.93153211804503,136108.64664713555,922,1,394.95652173913044,39,7,18,30.312510396912526,0.6760149572649572,39.08854166666667,1043.6458333333342,26.760149572649595,0
928,4,0,0,46,0.0,0.0,1.0,46,1150,600,550,0.5217391304347826,17,6,11,337.4890148876622,0.40970209339774555,0.27350698029552345,0.22578871209640516,136231.12521701385,-4.6983506944498,136226.4268663194,923,2,395.95652173913044,39,7,18,30.20230492915584,0.6768162393162394,39.010416666666664,1043.958333333333,26.768162393162385,0
929,4,0,0,46,0.0,0.0,1.0,46,1150,800,350,0.6956521739130435,15,8,7,340.6888963377222,0.4088365539452496,0.27743570620195057,0.22880693660939969,136367.09120008658,91.75075954858664,136458.84195963517,924,3,396.95652173913044,39,7,18,29.98414696984807,0.6781517094017095,38.88020833333332,1044.479166666665,26.78151709401705,0
930,4,0,0,46,0.0,0.0,1.0,46,1300,1000,300,0.7692307692307693,16,10,6,337.88178588355964,0.4084943639291465,0.27693497982341686,0.22762204124902508,136475.91281467,22.54503038192462,136498.45784505195,925,4,397.95652173913044,39,7,18,29.94975991094272,0.6792200854700856,38.77604166666666,1044.8958333333321,26.792200854700823,0
931,4,0,0,46,0.0,0.0,1.0,46,900,600,300,0.6666666666666666,12,6,6,337.31930231552514,0.408323268921095,0.2733860342555998,0.22741849736756342,136503.12499999974,9.027777777748668,136512.1527777775,926,5,398.95652173913044,39,7,18,29.937533227006917,0.6794871794871796,38.749999999999986,1044.999999999998,26.794871794871742,0
932,4,0,0,46,0.0,0.0,1.0,46,1100,900,200,0.8181818181818182,13,9,4,339.0797877582922,0.4082326892109501,0.27244860379974445,0.22913573536393655,136584.7778320311,62.62749565970961,136647.40532769082,927,6,399.95652173913044,39,7,18,29.81076648397277,0.6802884615384617,38.67187499999999,1045.3124999999989,26.802884615384585,0
933,4,1,0,47,0.02127659574468085,0.0,1.0,47,900,700,200,0.7777777777777778,11,7,4,332.5544874283846,0.4091119333950046,0.2825095014656225,0.2268929651539619,136921.67451763985,-293.01309206921485,136628.66142557064,928,0,392.4255319148936,37,10,19,29.64848524532914,0.6872184684684686,38.349780701754376,1046.600877192981,28.28651019440489,0
934,4,0,1,46,0.0,0.02127659574468085,0.9787234042553191,47,950,600,350,0.631578947368421,13,6,7,332.46807716680803,0.4085723095898859,0.27538585972018925,0.22757976120902146,137036.4574316135,-287.9504991920702,136748.5069324214,929,1,393.4255319148936,37,10,18,29.537451565608954,0.6883445945945947,38.24013157894736,1047.0394736842097,28.29836415362729,0
935,4,0,0,46,0.0,0.0,1.0,46,1050,700,350,0.6666666666666666,14,7,7,340.86431785662444,0.4076086956521739,0.26984490758063306,0.23299078667611633,136986.04009414828,138.7306225144156,137124.7707166627,930,2,396.95652173913044,36,10,18,29.36746987951807,0.6898148148148149,38.28828828828829,1046.8468468468475,29.079079079079097,0
936,4,0,0,46,0.0,0.0,1.0,46,1250,1000,250,0.8,15,10,5,344.60769975924114,0.40611916264090175,0.27437208715285366,0.23654584615946173,137133.43992218593,251.4478583313325,137384.88778051728,931,3,397.95652173913044,36,10,19,29.123884528545318,0.691261574074074,38.147522522522536,1047.4099099099117,29.09471971971977,0
937,4,0,0,46,0.0,0.0,1.0,46,1450,900,550,0.6206896551724138,20,9,11,340.18830706135566,0.40471014492753626,0.2667620316842312,0.23479133770393493,137323.6251178248,143.17830967221624,137466.803427497,932,4,398.95652173913044,37,9,19,29.0519187850891,0.6911599099099099,37.96600877192983,1048.1359649122812,28.327999051683275,0
938,4,0,1,45,0.0,0.021739130434782608,0.9782608695652174,46,1150,900,250,0.782608695652174,14,9,5,335.08985377586725,0.40424718196457327,0.2598524667337532,0.23216445684526194,137457.26047092013,12.106662326384651,137469.3671332465,933,5,399.95652173913044,39,7,19,29.053777192808177,0.6888354700854702,37.838541666666664,1048.6458333333333,26.8883547008547,0
939,4,0,0,45,0.0,0.0,1.0,45,1000,600,400,0.6,14,6,8,338.2713939450124,0.40157828282828284,0.25461445955935114,0.23510912411457668,137566.5161132811,306.9634331597087,137873.47954644082,934,6,399.4888888888889,39,6,19,28.86267914473901,0.6899038461538463,37.73437499999999,1049.0624999999989,26.89903846153843,0
940,4,0,0,45,0.0,0.0,1.0,45,1750,1300,450,0.7428571428571429,22,13,9,339.79806319956003,0.4005471380471381,0.25688862425986625,0.23729349153582552,137730.4809570311,360.11013454859653,138090.5910915797,935,7,400.4888888888889,39,6,20,28.661080513380313,0.6915064102564104,37.57812499999999,1049.6874999999989,26.915064102564074,0
941,4,0,0,45,0.0,0.0,1.0,45,1200,800,400,0.6666666666666666,16,8,8,335.48684099397553,0.39974747474747474,0.25292220598129944,0.23523374546415102,137870.07180093895,250.76779934693496,138120.8396002859,936,8,401.4888888888889,37,8,20,28.63680657061321,0.6965090090090089,37.4451754385965,1050.2192982456156,28.38430535798961,0
942,4,0,0,45,0.0,0.0,1.0,45,750,500,250,0.6666666666666666,10,5,5,336.1570076838927,0.3994739057239057,0.2536395267919278,0.2360985435199188,137927.6556248077,273.06959833795844,138200.72522314565,937,9,402.4888888888889,37,8,20,28.562543493389,0.697072072072072,37.390350877192986,1050.4385964912285,28.39023233760077,0
943,4,0,0,45,0.0,0.0,1.0,45,950,600,350,0.631578947368421,13,6,7,335.9967691229978,0.3991372053872054,0.2522476144097767,0.23658023795045469,138014.05390360494,274.4552410357029,138288.50914464064,938,10,403.4888888888889,37,8,20,28.481751539183964,0.6979166666666666,37.30811403508772,1050.767543859649,28.399122807017545,0
944,4,0,0,45,0.0,0.0,1.0,45,1450,1200,250,0.8275862068965517,17,12,5,352.9843563051785,0.3992845117845118,0.25309611370639074,0.24341162500249505,137293.4583875869,695.3771157351412,137988.83550332204,939,11,404.4888888888889,39,6,18,28.746417685452077,0.687232905982906,37.99479166666667,1048.0208333333342,26.87232905982908,2
945,4,0,0,45,0.0,0.0,1.0,45,1300,800,500,0.6153846153846154,18,8,10,354.02043772005413,0.3986321548821549,0.257092386504151,0.24470203881968608,137375.34722222242,726.7361111111353,138102.08333333355,940,12,405.4888888888889,39,6,18,28.638381028086922,0.688034188034188,37.91666666666668,1048.3333333333348,26.88034188034192,0
946,4,0,0,45,0.0,0.0,1.0,45,1000,600,400,0.6,14,6,8,355.992403406824,0.39831649831649835,0.2596906735565365,0.24190295795508346,136779.8134917013,740.5982418229185,137520.4117335242,941,13,406.4888888888889,36,9,18,29.17563785122188,0.6877893518518519,38.48536036036037,1046.0585585585595,29.05718218218221,1
947,4,0,0,45,0.0,0.0,1.0,45,1050,800,250,0.7619047619047619,13,8,5,355.80372195527224,0.3986111111111111,0.2611601483076187,0.24197778747909807,136809.26492370755,735.4491315640065,137544.71405527156,942,14,407.4888888888889,36,9,19,29.151417294581986,0.6880787037037037,38.45720720720721,1046.1711711711716,29.060310310310324,0
948,4,0,0,45,0.0,0.0,1.0,45,1650,1200,450,0.7272727272727273,21,12,9,352.108945339089,0.397706228956229,0.2569495253807714,0.2402716988238982,136927.10235573415,642.6515197630106,137569.75387549718,943,15,408.4888888888889,36,9,19,29.13147371063768,0.6892361111111112,38.3445945945946,1046.621621621622,29.07282282282283,0
949,4,0,1,44,0.0,0.022222222222222223,0.9777777777777777,45,1300,1100,200,0.8461538461538461,15,11,4,356.5630907263778,0.39699074074074076,0.2598702369430408,0.24433899636437645,137074.4704797704,775.1393707897181,137849.6098505601,944,16,409.4888888888889,36,9,16,28.869143635516366,0.6906828703703703,38.20382882882883,1047.1846846846852,29.088463463463476,0
950,4,0,0,44,0.0,0.0,1.0,44,750,600,150,0.8,9,6,3,365.0113364131122,0.3951726568005638,0.26657186501316477,0.2497649432067332,137023.70139960566,1203.0408736282616,138226.74227323392,945,17,416.4318181818182,35,9,16,28.698227577566506,0.6922619047619047,38.25231481481482,1046.990740740741,29.914021164021175,0
951,4,0,0,44,0.0,0.0,1.0,44,900,600,300,0.6666666666666666,12,6,6,366.8580295287256,0.3946551268498943,0.2682993600498298,0.25168296506485494,137114.6010829261,1260.318474579904,138374.919557506,946,18,417.4318181818182,35,9,16,28.559900725678716,0.6931547619047619,38.16550925925926,1047.3379629629628,29.923941798941794,0
952,4,0,0,44,0.0,0.0,1.0,44,1250,900,350,0.72,16,9,7,368.5294010188975,0.39358703312191684,0.2608554909813605,0.25459731388468,137357.14759355714,1324.0294656635824,138681.17705922073,947,19,418.4318181818182,35,9,17,28.276126200728715,0.6955357142857143,37.93402777777778,1048.2638888888891,29.950396825396833,0
953,4,0,0,44,0.0,0.0,1.0,44,900,700,200,0.7777777777777778,11,7,4,346.1381147226903,0.3933337737843552,0.21779745286266117,0.22918392721332462,135862.2124115113,614.882230055836,136477.09464156715,948,20,419.4318181818182,37,7,19,30.34243093535268,0.6768018018018017,39.3640350877193,1042.5438596491233,28.176861071597926,4
954,4,0,1,43,0.0,0.022727272727272728,0.9772727272727273,44,1000,700,300,0.7,13,7,6,348.9125506376434,0.3927832100070472,0.2137013533144736,0.23176369983695977,135976.55047706992,688.785010772547,136665.33548784247,949,21,420.4318181818182,37,7,14,30.15664423885617,0.6779279279279279,39.25438596491228,1042.9824561403511,28.1887150308203,0
955,4,0,0,43,0.0,0.0,1.0,43,1050,700,350,0.6666666666666666,14,7,7,352.2123068167507,0.3925341454411222,0.20875483449696097,0.2336307995073862,135927.10108757403,975.0395665936206,136902.14065416766,950,22,425.69767441860466,36,7,14,30.119690424766027,0.6793981481481481,39.3018018018018,1042.7927927927926,28.96646646646646,0
956,4,0,0,43,0.0,0.0,1.0,43,1000,700,300,0.7,13,7,6,350.7065915442621,0.39228036175710596,0.20874238641670662,0.23276834558112197,135947.96145208145,935.5692376500451,136883.5306897315,951,23,426.69767441860466,37,6,14,30.138239056531024,0.6776463963963963,39.281798245614034,1042.8728070175441,28.185751541014707,0
957,4,0,1,42,0.0,0.023255813953488372,0.9767441860465116,43,800,400,400,0.5,12,4,8,352.2166533187355,0.39234957548911037,0.21279570917642743,0.23414654248924727,136005.14250779073,980.6552256463403,136985.79773343707,952,24,427.69767441860466,37,6,14,30.042113423735948,0.6782094594594594,39.22697368421052,1043.092105263157,28.191678520625864,0
958,4,0,0,42,0.0,0.0,1.0,42,450,400,50,0.8888888888888888,5,4,1,353.02833628440914,0.3918287843592722,0.20565434421636475,0.2347524392679456,136015.18906998215,1203.4431813570318,137218.63225133918,953,25,431.6666666666667,36,6,14,30.01097556587139,0.6802662037037037,39.21734234234234,1043.1306306306308,28.975850850850854,0
959,4,0,0,42,0.0,0.0,1.0,42,1250,1100,150,0.88,14,11,3,353.7768561645523,0.39126016260162605,0.2009047418883494,0.23575214028444483,136090.93663434868,1229.1647429978102,137320.1013773465,954,26,432.6666666666667,37,5,14,29.916281350707592,0.6790540540540542,39.144736842105246,1043.4210526315762,28.2005689900426,0
960,4,0,0,42,0.0,0.0,1.0,42,1200,1000,200,0.8333333333333334,14,10,4,350.84739778264276,0.390534262485482,0.19523809523809588,0.23455528278727206,136205.37088334846,1157.4599876884927,137362.83087103695,955,27,433.6666666666667,37,5,14,29.879201680672278,0.6801801801801803,39.03508771929823,1043.859649122805,28.212422949264997,0
961,4,0,0,42,0.0,0.0,1.0,42,1000,700,300,0.7,13,7,6,350.890746254023,0.39026809910956256,0.1969105886236444,0.2347737733720696,136233.98695992987,1160.6490699061137,137394.636029836,956,28,434.6666666666667,37,5,15,29.849696285404203,0.6804617117117118,39.007675438596486,1043.9692982456131,28.215386439070624,0
962,4,0,0,42,0.0,0.0,1.0,42,1050,600,450,0.5714285714285714,15,6,9,350.1902937423536,0.39026809910956256,0.20884702777981312,0.2294959255224776,135494.60475792634,1089.7790881364858,136584.38384606282,957,29,435.6666666666667,38,4,16,30.602018128955013,0.6713267543859647,39.716880341880355,1041.1324786324808,27.39822312190739,1
963,4,0,1,41,0.0,0.023809523809523808,0.9761904761904762,42,1000,800,200,0.8,12,8,4,351.3991524741519,0.38978416569879987,0.20089239922043278,0.23100406860893546,135605.85968889276,1130.356833041152,136736.2165219339,958,30,436.6666666666667,38,4,16,30.459961705474072,0.6724232456140349,39.61004273504275,1041.5598290598307,27.409469185785017,0
964,4,0,0,41,0.0,0.0,1.0,41,800,400,400,0.5,12,4,8,348.33640841637475,0.3882621951219512,0.19344871479017867,0.2299020295548074,135747.92243767323,1257.1916039533053,137005.11404162654,959,31,440.7073170731707,37,4,17,30.398604096520778,0.6756756756756757,39.47368421052632,1042.1052631578955,28.165007112375555,0
965,4,0,0,41,0.0,0.0,1.0,41,1100,800,300,0.7272727272727273,14,8,6,347.8831446396887,0.3885416666666666,0.18858129269062185,0.23052409912047375,135890.79241930204,1254.8232388811884,137145.61565818323,960,32,441.7073170731707,37,4,14,30.26858327198794,0.6770833333333333,39.33662280701754,1042.6535087719294,28.179824561403496,0
966,4,0,0,41,0.0,0.0,1.0,41,700,400,300,0.5714285714285714,10,4,6,343.7055618201188,0.3882367886178862,0.18157580356547753,0.22867235770325955,136033.73754424442,1151.110437827028,137184.84798207146,961,33,442.7073170731707,37,4,15,30.23570527643473,0.6784909909909909,39.199561403508774,1043.2017543859652,28.19464201043149,0
967,4,0,1,40,0.0,0.024390243902439025,0.975609756097561,41,1100,800,300,0.7272727272727273,14,8,6,343.9915569788459,0.3880081300813008,0.18058819269466375,0.22933553153668196,136107.07188481643,1163.936714697951,137271.00859951437,962,34,443.7073170731707,38,3,15,30.155540766526762,0.6773574561403508,39.12927350427351,1043.4829059829071,27.4600764732344,0
968,4,0,0,40,0.0,0.0,1.0,40,950,500,450,0.5263157894736842,14,5,9,354.6479284720393,0.3847088675213675,0.18916184971098282,0.23614241003579126,136062.3355864305,1650.8450917590098,137713.18067818953,963,35,454.4,37,3,16,29.921943422665972,0.6787725225225225,39.17214912280702,1043.3114035087724,28.197605500237092,0
969,4,0,0,40,0.0,0.0,1.0,40,1100,1000,100,0.9090909090909091,12,10,2,355.1978642252295,0.3839209401709402,0.19019226728304295,0.2370808745929688,136148.14774738377,1671.9062596183421,137820.05400700212,964,36,455.4,37,3,17,29.82244168943055,0.679617117117117,39.08991228070175,1043.6403508771928,28.206495969653858,0
970,4,0,0,40,0.0,0.0,1.0,40,900,300,600,0.3333333333333333,15,3,12,355.1978642252295,0.3839209401709402,0.19019226728304295,0.2370808745929688,136148.14774738377,1671.9062596183421,137820.05400700212,965,37,456.4,37,3,17,29.82244168943055,0.679617117117117,39.08991228070175,1043.6403508771928,28.206495969653858,0
971,4,0,0,40,0.0,0.0,1.0,40,900,400,500,0.4444444444444444,14,4,10,353.4736502266876,0.3831997863247863,0.18511342155009491,0.23669311515179442,136262.6060422437,1633.0481494305855,137895.65419167426,966,38,457.4,37,3,17,29.753903241615912,0.6807432432432432,38.98026315789473,1044.0789473684204,28.218349928876226,0
972,4,0,0,40,0.0,0.0,1.0,40,1000,800,200,0.8,12,8,4,353.8345444766872,0.3828792735042735,0.1876627467450651,0.23731832405605394,136319.8532240688,1646.9346337334375,137966.78785780224,967,39,458.4,37,3,17,29.687718745625073,0.6813063063063063,38.92543859649122,1044.298245614034,28.224276908487404,0
973,4,0,0,40,0.0,0.0,1.0,40,1200,1000,200,0.8333333333333334,14,10,4,356.67908135533725,0.38234508547008544,0.19295759865659168,0.24000270389503184,136434.3836565096,1732.6581255770902,138167.0417820867,968,40,459.4,37,3,17,29.499895046179684,0.6824324324324325,38.815789473684205,1044.7368421052624,28.236130867709797,0
974,4,0,0,40,0.0,0.0,1.0,40,1150,700,450,0.6086956521739131,16,7,9,356.8259191333257,0.3816239316239316,0.1906240417049987,0.24091290316641287,136553.37000739624,1745.1563527284452,138298.5263601247,969,41,460.4,38,2,18,29.378130430338338,0.6817434210526316,38.701923076923066,1045.1923076923063,27.5050607287449,0
975,4,0,1,39,0.0,0.025,0.975,40,1000,800,200,0.8,12,8,4,355.7966144077813,0.3808226495726496,0.189570348421376,0.24098141627743594,136665.0586807836,1724.993037292691,138390.0517180763,970,42,461.4,38,2,18,29.29438711215557,0.6828399122807018,38.59508547008546,1045.6196581196562,27.51630679262253,0
976,4,0,0,39,0.0,0.0,1.0,39,800,600,200,0.75,10,6,4,355.3577662236056,0.3784581646423752,0.2059563144717631,0.2414717110790834,136779.81349170103,1921.1766259269136,138700.99011762795,971,43,469.6923076923077,36,3,19,29.19223454264901,0.6877893518518519,38.48536036036035,1046.0585585585575,29.057182182182153,0
977,4,0,0,39,0.0,0.0,1.0,39,1000,600,400,0.6,14,6,8,352.0148582010608,0.3787393162393162,0.20516131524417336,0.24000543486885217,136897.63824212708,1838.0005427724818,138735.63878489955,972,44,470.6923076923077,36,3,19,29.163079737436775,0.6889467592592593,38.37274774774774,1046.5090090090075,29.069694694694654,0
978,4,0,0,39,0.0,0.0,1.0,39,950,800,150,0.8421052631578947,11,8,3,353.0598771202572,0.37876743139901037,0.2072084002361605,0.24092059456355863,136927.10235573404,1868.6931864296623,138795.7955421637,973,45,471.6923076923077,36,3,19,29.10659206656624,0.6892361111111112,38.34459459459459,1046.621621621621,29.072822822822804,0
979,4,0,0,39,0.0,0.0,1.0,39,800,600,200,0.75,10,6,4,345.9821596597535,0.37876743139901037,0.188878401761837,0.23303757034933842,136469.63346482598,1643.2117028271077,138112.84516765308,974,46,472.6923076923077,38,1,17,29.744376278118615,0.6809210526315788,38.78205128205129,1044.8717948717965,27.49662618083675,1
980,4,0,0,39,0.0,0.0,1.0,39,1050,600,450,0.5714285714285714,15,6,9,347.2747788572601,0.3787393162393162,0.19107164859132952,0.23409335713320906,136497.54279211425,1680.4307975381857,138177.97358965245,975,47,473.6923076923077,38,1,17,29.682973792727402,0.6811951754385964,38.75534188034189,1044.9786324786337,27.49943769680615,0
981,4,0,0,39,0.0,0.0,1.0,39,1300,900,400,0.6923076923076923,17,9,8,348.879799280072,0.3782051282051282,0.19647897844769946,0.2355480383959246,136553.37000739665,1728.1424638396002,138281.51247123626,976,48,474.6923076923077,38,1,18,29.585761014003886,0.6817434210526314,38.70192307692309,1045.1923076923092,27.50506072874498,0
982,4,0,0,39,0.0,0.0,1.0,39,950,500,450,0.5263157894736842,14,5,9,354.5262742580237,0.37798020692757534,0.2031999538896443,0.24012101357531337,136665.0586807839,1890.270815070499,138555.32949585438,977,49,475.6923076923077,38,1,18,29.327594427982692,0.6828399122807017,38.59508547008547,1045.6196581196584,27.51630679262259,0
983,4,0,0,39,0.0,0.0,1.0,39,1350,1100,250,0.8148148148148148,16,11,5,354.2568215772641,0.3778115159694107,0.1995496294385417,0.24110688954994672,136835.6188923515,1895.0016997466907,138730.6205920982,978,50,476.6923076923077,37,2,18,29.165793334730658,0.6863738738738738,38.43201754385965,1046.2719298245615,28.27761972498815,0
984,4,0,0,39,0.0,0.0,1.0,39,800,500,300,0.625,11,5,6,350.7004300552839,0.3774741340530814,0.19778350137680523,0.23923825994579112,136916.5251296661,1803.3368489297918,138719.86197859587,979,51,477.6923076923077,38,1,18,29.17878896148087,0.6853070175438596,38.35470085470085,1046.581196581196,27.541610436347266,0
985,4,0,0,39,0.0,0.0,1.0,39,800,600,200,0.75,10,6,4,347.9783423573509,0.3770242914979757,0.19143380429094714,0.23814160300991896,137028.36218861866,1736.580466067651,138764.9426546863,980,52,478.6923076923077,38,1,16,29.139455782312933,0.6864035087719298,38.24786324786325,1047.0085470085476,27.552856500224937,0
986,4,0,0,39,0.0,0.0,1.0,39,800,400,400,0.5,12,4,8,345.3755245318373,0.3769961763382816,0.17348403011785973,0.23506228638251012,136835.6188923515,1654.1719276669194,138489.79082001842,981,53,479.6923076923077,37,2,18,29.398099629707254,0.6863738738738738,38.43201754385965,1046.2719298245615,28.27761972498815,1
987,4,0,0,39,0.0,0.0,1.0,39,1000,800,200,0.8,12,8,4,344.91709064147346,0.37705240665766987,0.17590092812722435,0.23532763618104813,136921.67451764003,1645.325124076633,138566.99964171665,982,54,480.6923076923077,37,2,18,29.32501746114894,0.6872184684684685,38.34978070175438,1046.6008771929824,28.28651019440493,0
988,4,0,0,39,0.0,0.0,1.0,39,1050,700,350,0.6666666666666666,14,7,7,348.6608263369901,0.3768556005398111,0.15553937825231245,0.2312248576335268,135919.37543282544,1680.8408596875922,137600.21629251304,983,55,481.6923076923077,37,2,19,30.219943918682098,0.6773648648648649,39.30921052631579,1042.7631578947364,28.182788051209094,5
989,4,0,0,39,0.0,0.0,1.0,39,1150,800,350,0.6956521739130435,15,8,7,349.66364527933484,0.37688371569950513,0.15627198408655407,0.23244935412594764,136005.14250779073,1711.2107812018971,137716.35328899263,984,56,482.6923076923077,37,2,19,30.108688987000253,0.6782094594594594,39.22697368421052,1043.092105263157,28.191678520625864,0
990,4,0,0,39,0.0,0.0,1.0,39,1150,700,450,0.6086956521739131,16,7,9,348.5032572958389,0.3767150247413405,0.1537383958060572,0.23261248267474022,136148.14774738377,1689.6145929516763,137837.76234033544,985,57,483.6923076923077,37,2,20,29.997110737549903,0.679617117117117,39.08991228070175,1043.6403508771928,28.206495969653858,0
991,4,0,0,39,0.0,0.0,1.0,39,1550,1300,250,0.8387096774193549,18,13,5,347.44854499233315,0.3756185335132704,0.15448159247382232,0.23284676241815522,136291.22813029002,1670.8377818174763,137962.0659121075,986,58,484.6923076923077,37,2,20,29.882805663481392,0.6810247747747749,38.95285087719298,1044.1885964912276,28.221313418681827,0
992,4,0,0,39,0.0,0.0,1.0,39,1400,1100,300,0.7857142857142857,17,11,6,348.1138662063216,0.37485942420152946,0.1537815533196596,0.2338598511623004,136377.11242882424,1694.9527739304403,138072.0652027547,987,59,485.6923076923077,37,2,20,29.780338022254895,0.6818693693693694,38.87061403508772,1044.517543859649,28.230203888098625,0
993,4,0,0,39,0.0,0.0,1.0,39,350,200,150,0.5714285714285714,5,2,3,359.8720318581506,0.3748875393612236,0.13142304151816275,0.24181916532488934,136385.92260437217,2016.2958168967814,138402.21842126895,988,60,486.6923076923077,38,1,18,29.464559680883703,0.6800986842105263,38.86217948717949,1044.5512820512824,27.488191632928487,2
994,4,0,0,39,0.0,0.0,1.0,39,1200,900,300,0.75,15,9,6,358.7316147923316,0.3744939271255061,0.12399016508605532,0.24200776937231636,136525.45497297103,1995.1993845423278,138520.65435751335,989,61,487.6923076923077,38,1,18,29.356002521638374,0.6814692982456141,38.72863247863248,1045.0854700854702,27.50224921277553,0
995,4,0,0,39,0.0,0.0,1.0,39,700,400,300,0.5714285714285714,10,4,6,360.9504545943818,0.3744376968061178,0.130217833406713,0.24389083202703243,136581.28789539036,2059.81559098545,138641.1034863758,990,62,488.6923076923077,38,1,18,29.242683633142548,0.6820175438596492,38.67521367521367,1045.2991452991446,27.50787224471433,0
996,4,0,0,39,0.0,0.0,1.0,39,850,500,350,0.5882352941176471,12,5,7,359.3222365112488,0.3744376968061178,0.13419484664119863,0.24317616919080776,136637.1322320841,2019.3519888231353,138656.48422090724,991,63,489.6923076923077,38,1,18,29.229894747598596,0.6825657894736843,38.62179487179487,1045.51282051282,27.51349527665316,0
997,4,0,0,39,0.0,0.0,1.0,39,700,500,200,0.7142857142857143,9,5,4,358.97246478217386,0.37404408457040034,0.13597839101057674,0.2431324230327427,136665.05868078375,2011.798592848261,138676.85727363202,992,64,490.6923076923077,38,1,18,29.21136882258778,0.6828399122807018,38.595085470085465,1045.6196581196573,27.51630679262256,0
998,4,0,0,39,0.0,0.0,1.0,39,1050,900,150,0.8571428571428571,12,9,3,357.18331180207656,0.37289136302294196,0.1320678133761264,0.24250331752882603,136749.5903186556,1968.945725793146,138718.53604444873,993,65,491.6923076923077,37,2,19,29.17441992521927,0.6855292792792793,38.514254385964904,1045.9429824561394,28.268729255571333,0
999,4,0,0,39,0.0,0.0,1.0,39,950,600,350,0.631578947368421,13,6,7,355.02898193192743,0.37283513270355373,0.1314166391202347,0.24143489070652266,136806.93969538674,1914.0857042551274,138721.02539964186,994,66,492.6923076923077,37,2,19,29.173981588233236,0.6860923423423424,38.45942982456139,1046.162280701752,28.274656235182487,0
1000,4,0,0,39,0.0,0.0,1.0,39,1000,800,200,0.8,12,8,4,355.34070007390744,0.3720479082321188,0.1299089464854497,0.24259741035707785,136944.4801140512,1932.3894869968328,138876.86960104803,995,67,493.6923076923077,38,1,19,29.029719982307498,0.6855811403508774,38.32799145299144,1046.6880341880324,27.54442195231664,0
1001,4,0,0,39,0.0,0.0,1.0,39,1250,900,350,0.72,16,9,7,356.8033561502859,0.3716824111560954,0.1329901903440902,0.22653322046341587,134346.39665002836,1792.5336010553353,136138.9302510837,996,68,494.6923076923077,36,3,20,31.574516619595908,0.6637731481481481,40.82207207207207,1036.7117117117111,28.79754754754753,6
1002,4,0,0,39,0.0,0.0,1.0,39,1000,600,400,0.6,14,6,8,367.4618643703576,0.37156995051731895,0.0899855942858292,0.23250078245284847,134220.7610623497,2070.340114087252,136291.10117643693,997,69,495.6923076923077,35,4,17,31.423940764734365,0.6645833333333334,40.943287037037024,1036.2268518518497,29.60648148148142,6
1003,4,0,0,39,0.0,0.0,1.0,39,700,400,300,0.5714285714285714,10,4,6,366.69540578408134,0.37176675663517766,0.0889560889560892,0.23220584606723202,134250.74615269186,2045.826367455395,136296.57252014725,998,70,496.6923076923077,35,4,17,31.41380016380015,0.6648809523809525,40.91435185185184,1036.3425925925912,29.609788359788322,0
1004,4,0,0,39,0.0,0.0,1.0,39,450,300,150,0.6666666666666666,6,3,3,368.04417846686766,0.3716824111560954,0.09060821566404464,0.2334421857187864,134310.72638031535,2086.456189986267,136397.1825703016,999,71,497.6923076923077,35,4,17,31.31885514366533,0.6654761904761906,40.856481481481474,1036.5740740740728,29.616402116402078,0
1005,4,0,0,39,0.0,0.0,1.0,39,950,600,350,0.631578947368421,13,6,7,369.03181581024046,0.37159806567701303,0.08958043519329562,0.23445297915093116,134370.7200038578,2117.4141589505957,136488.1341628084,1000,72,498.6923076923077,35,4,17,31.233255190890834,0.6660714285714286,40.7986111111111,1036.8055555555538,29.623015873015824,0
1006,4,0,0,39,0.0,0.0,1.0,39,950,500,450,0.5263157894736842,14,5,9,372.18465268889804,0.37016419253261357,0.09494217751303236,0.237234627126451,134490.74743870008,2211.0784250685656,136701.82586376864,1001,73,499.6923076923077,35,4,18,31.0314847876218,0.6672619047619048,40.68287037037036,1037.268518518517,29.636243386243347,0
1007,4,0,1,38,0.0,0.02564102564102564,0.9743589743589743,39,900,400,500,0.4444444444444444,14,4,10,373.70364994113015,0.3695456590193433,0.0990629183400269,0.23859540727010586,134550.78124999977,2256.4236111110818,136807.20486111086,1002,74,500.6923076923077,35,4,18,30.932061579651943,0.6678571428571429,40.624999999999986,1037.4999999999982,29.642857142857093,0
1008,4,0,0,38,0.0,0.0,1.0,38,900,500,400,0.5555555555555556,13,5,8,371.86878761646386,0.368421052631579,0.08775941526990994,0.2376196493928434,134580.8031791193,2409.2800229337895,136990.0832020531,1003,75,493.8157894736842,35,3,18,30.949642126789378,0.668154761904762,40.5960648148148,1037.615740740739,29.646164021163973,0
1009,4,0,0,38,0.0,0.0,1.0,38,1000,600,400,0.6,14,6,8,370.82587628447607,0.3678728070175439,0.09009812667261374,0.23754046132279838,134670.88906035645,2387.8900891632097,137058.77914951966,1004,76,494.8157894736842,35,3,18,30.886671126969954,0.6690476190476191,40.509259259259245,1037.9629629629612,29.656084656084605,0
1010,4,0,0,38,0.0,0.0,1.0,38,900,600,300,0.6666666666666666,12,6,6,371.2119696837117,0.36733937885253676,0.08791979391001736,0.23798428563925728,134700.92438539516,2400.519091863845,137101.44347725902,1005,77,495.8157894736842,35,3,18,30.846643066859915,0.6693452380952382,40.48032407407407,1038.0787037037032,29.65939153439152,0
1011,4,0,0,38,0.0,0.0,1.0,38,1200,1000,200,0.8333333333333334,14,10,4,375.90608390686,0.3669541251778094,0.08499340272687306,0.24219361831041386,134881.2066642017,2540.533237954374,137421.73990215606,1006,78,496.8157894736842,35,3,17,30.544684308263694,0.6711309523809523,40.306712962962955,1038.7731481481471,29.679232804232775,0
1012,4,0,0,38,0.0,0.0,1.0,38,1200,800,400,0.6666666666666666,16,8,8,373.87711370479326,0.3671022996680891,0.08002578830148876,0.24188879546606928,135031.53399348413,2497.0400377228952,137528.57403120704,1007,79,497.8157894736842,35,3,17,30.44729027468448,0.6726190476190477,40.16203703703703,1039.351851851851,29.69576719576717,0
1013,4,0,0,38,0.0,0.0,1.0,38,650,400,250,0.6153846153846154,9,4,5,373.8707528685818,0.36690967283072545,0.07991389157367546,0.24289433944498964,135181.94504726073,2508.11511381172,137690.06016107244,1008,80,498.8157894736842,35,3,17,30.297370617696163,0.6741071428571428,40.01736111111111,1039.930555555555,29.71230158730157,0
1014,4,0,0,38,0.0,0.0,1.0,38,1300,1000,300,0.7692307692307693,16,10,6,373.45676428486405,0.36650960170697017,0.080271064931414,0.24282796554730737,135212.0373049554,2499.169988854591,137711.20729380997,1009,81,499.8157894736842,35,3,17,30.27811781289413,0.674404761904762,39.988425925925924,1040.046296296296,29.715608465608458,0
1015,4,0,0,38,0.0,0.0,1.0,38,750,500,250,0.6666666666666666,10,5,5,371.19854811731994,0.3660798956851588,0.08218524395313542,0.2419654640338352,135302.33417191778,2444.80600030006,137747.14017221786,1010,82,500.8157894736842,35,3,17,30.24680628175177,0.675297619047619,39.90162037037037,1040.393518518518,29.725529100529087,0
1016,4,0,1,37,0.0,0.02631578947368421,0.9736842105263158,38,500,300,200,0.6,7,3,4,370.2902101300502,0.3663466097676624,0.0843738475317426,0.24177772543785608,135362.54882812485,2424.685329861096,137787.23415798595,1011,83,501.8157894736842,35,3,18,30.210418752085427,0.6758928571428573,39.84374999999999,1040.6249999999989,29.732142857142826,0
1017,4,0,0,37,0.0,0.0,1.0,37,1700,1400,300,0.8235294117647058,20,14,6,370.2882306611572,0.3644894894894895,0.10973664047594034,0.24258868425324906,135483.0183282965,2633.553428283609,138116.5717565801,1012,91,514.1351351351351,35,2,18,30.09044376505466,0.6770833333333333,39.72800925925926,1041.087962962963,29.745370370370374,0
1018,4,0,0,37,0.0,0.0,1.0,37,350,200,150,0.5714285714285714,5,2,3,370.2882306611572,0.3644894894894895,0.10973664047594034,0.24258868425324906,135483.0183282965,2633.553428283609,138116.5717565801,1013,92,515.1351351351351,35,2,18,30.09044376505466,0.6770833333333333,39.72800925925926,1041.087962962963,29.745370370370374,0
1019,4,0,0,37,0.0,0.0,1.0,37,1300,1000,300,0.7692307692307693,16,10,6,365.53197603579486,0.36411411411411415,0.10220486012064756,0.24068422211398605,135663.82304794661,2517.893063057264,138181.7161110039,1014,93,516.1351351351351,35,2,19,30.034278598674216,0.6788690476190476,39.554398148148145,1041.782407407407,29.76521164021163,0
1020,4,0,0,37,0.0,0.0,1.0,37,950,900,50,0.9473684210526315,10,9,1,364.65519696652365,0.36377002002002,0.10127479178801102,0.24030937650751433,135693.96888931756,2496.3021905006844,138190.27107981825,1015,94,517.1351351351351,35,2,19,30.027123602162476,0.6791666666666667,39.52546296296296,1041.898148148148,29.768518518518515,0
1021,4,0,0,37,0.0,0.0,1.0,37,950,800,150,0.8421052631578947,11,8,3,368.63028051504233,0.36389514514514515,0.10027975554408264,0.24333922622855134,135754.27061899856,2608.6269718792773,138362.89759087784,1016,95,518.1351351351351,35,2,19,29.863579150007407,0.6797619047619048,39.46759259259259,1042.129629629629,29.77513227513226,0
1022,4,0,0,37,0.0,0.0,1.0,37,650,300,350,0.46153846153846156,10,3,7,365.28020090292745,0.36336336336336333,0.10066727473477033,0.24194441542158596,135874.9142661179,2526.4831961591144,138401.39746227703,1017,96,519.1351351351351,35,2,14,29.83089105979869,0.680952380952381,39.35185185185185,1042.5925925925922,29.788359788359777,0
1023,4,0,0,37,0.0,0.0,1.0,37,750,500,250,0.6666666666666666,10,5,5,367.22447989100795,0.36270645645645644,0.10377658457569705,0.24364451869057283,135935.2561835561,2583.7507501714526,138519.00693372756,1018,97,520.1351351351351,35,2,14,29.720218275989637,0.6815476190476191,39.293981481481474,1042.824074074073,29.794973544973516,0
1024,4,0,0,37,0.0,0.0,1.0,37,850,500,350,0.5882352941176471,12,5,7,366.25821585422767,0.36214339339339335,0.1088278691474438,0.2434158585013491,135995.61149691336,2561.902006172818,138557.51350308617,1019,98,521.1351351351351,35,2,14,29.68541944074568,0.6821428571428572,39.2361111111111,1043.0555555555538,29.80158730158725,0
1025,4,0,0,37,0.0,0.0,1.0,37,800,500,300,0.625,11,5,6,367.60809717889583,0.36123623623623624,0.124184064303825,0.2455622089155022,136176.75781249988,2611.9357638888746,138788.69357638876,1020,99,522.1351351351351,35,2,16,29.47022621423819,0.6839285714285714,39.06249999999999,1043.749999999999,29.821428571428545,0
1026,4,0,0,37,0.0,0.0,1.0,37,850,600,250,0.7058823529411765,11,6,5,372.0391657212125,0.3607982982982983,0.12412900597338683,0.24937127437866094,136297.58900248614,2741.60826045952,139039.19726294567,1021,100,523.1351351351351,35,2,17,29.234556269858874,0.6851190476190476,38.94675925925925,1044.212962962962,29.834656084656054,0
1027,4,0,0,37,0.0,0.0,1.0,37,1050,800,250,0.7619047619047619,13,8,5,371.3635101019792,0.35985985985985985,0.12198547578049013,0.24955738486004173,136388.2475592635,2729.923670053152,139118.17122931665,1022,101,524.1351351351351,35,2,19,29.162165281625114,0.6860119047619048,38.8599537037037,1044.5601851851848,29.844576719576708,0
1028,4,0,0,37,0.0,0.0,1.0,37,650,400,250,0.6153846153846154,9,4,5,372.18083671815157,0.3600788288288288,0.12321162287924947,0.25032073265410104,136418.47377614884,2754.4683427640616,139172.9421189129,1023,102,525.1351351351351,35,2,19,29.110809513257994,0.6863095238095238,38.83101851851852,1044.675925925926,29.8478835978836,0
1029,4,0,0,37,0.0,0.0,1.0,37,900,400,500,0.4444444444444444,14,4,10,372.18083671815157,0.3600788288288288,0.12321162287924947,0.25032073265410104,136418.47377614884,2754.4683427640616,139172.9421189129,1024,103,526.1351351351351,35,2,19,29.110809513257994,0.6863095238095238,38.83101851851852,1044.675925925926,29.8478835978836,0
1030,4,0,0,37,0.0,0.0,1.0,37,850,600,250,0.7058823529411765,11,6,5,371.7145971397145,0.36020395395395394,0.11977621657541948,0.25065056740660807,136509.1725206833,2748.4904138803126,139257.66293456362,1025,104,527.1351351351351,35,2,19,29.032954000073836,0.6872023809523808,38.74421296296296,1045.023148148148,29.85780423280423,0
1031,4,0,0,37,0.0,0.0,1.0,37,950,700,250,0.7368421052631579,12,7,5,373.8258070899342,0.3600788288288288,0.12166201405656785,0.25294146183096433,136630.1510657793,2815.175298996912,139445.3263647762,1026,105,528.1351351351351,35,2,19,28.85772999003654,0.6883928571428571,38.62847222222222,1045.4861111111109,29.87103174603174,0
1032,4,0,0,37,0.0,0.0,1.0,37,1050,600,450,0.5714285714285714,15,6,9,373.3347577442951,0.35923423423423423,0.1266830043483067,0.2530501138987975,136691.4782180831,2806.335981251537,139497.81419933462,1027,106,529.1351351351351,36,1,21,28.809722521358314,0.6869212962962963,38.56981981981983,1045.7207207207218,29.047797797797827,0
1033,4,0,0,37,0.0,0.0,1.0,37,1000,600,400,0.6,14,6,8,371.73379384459247,0.3588588588588589,0.12606233141749867,0.2526112803584532,136781.44959919408,2769.260607814399,139550.71020700847,1028,107,530.1351351351351,35,2,21,28.762355240834992,0.6898809523809524,38.4837962962963,1046.0648148148148,29.887566137566136,0
1034,4,0,0,37,0.0,0.0,1.0,37,1100,1000,100,0.9090909090909091,12,10,2,373.75283890672705,0.3589527027027027,0.13023200191341777,0.2544221132316879,136841.99245541848,2829.016632373125,139671.0090877916,1029,108,531.1351351351351,35,2,21,28.64952064896755,0.6904761904761905,38.42592592592593,1046.296296296297,29.894179894179914,0
1035,4,0,0,37,0.0,0.0,1.0,37,700,600,100,0.8571428571428571,8,6,2,373.66498941174245,0.3596721721721721,0.10394875394875358,0.24383223885342536,135340.57706355015,2717.8364143673316,138058.4134779175,1030,109,532.1351351351351,36,1,18,30.144525613275604,0.6736111111111112,39.86486486486487,1040.5405405405415,28.90390390390393,7
1036,4,0,0,37,0.0,0.0,1.0,37,600,500,100,0.8333333333333334,7,5,2,376.0660001108175,0.3596721721721721,0.11725797458696463,0.23952751459340454,134463.1688276114,2713.4052126450783,137176.57404025647,1031,110,533.1351351351351,36,1,19,30.95842381469417,0.6649305555555556,40.70945945945946,1037.1621621621623,28.810060060060064,1
1037,4,0,0,37,0.0,0.0,1.0,37,1050,800,250,0.7619047619047619,13,8,5,377.0808865854709,0.35992242242242245,0.11730879815986239,0.2405588038244709,134521.57393880372,2745.10287314342,137266.67681194714,1032,111,534.1351351351351,36,1,19,30.873679258937624,0.6655092592592593,40.653153153153156,1037.3873873873877,28.816316316316325,0
1038,4,0,0,37,0.0,0.0,1.0,37,850,600,250,0.7058823529411765,11,6,5,373.0925554349677,0.3594219219219219,0.1150602185480567,0.2384072370360103,134581.66099773257,2642.2895040655817,137223.95050179816,1033,112,535.1351351351351,34,3,19,30.9170395441334,0.6703431372549018,40.5952380952381,1037.6190476190486,30.518207282913195,0
1039,4,0,0,37,0.0,0.0,1.0,37,950,500,450,0.5263157894736842,14,5,9,375.7114826193082,0.35857732732732733,0.11551574510290163,0.24089736238532108,134705.2154195011,2722.0592403628107,137427.2746598639,1034,113,536.1351351351351,34,3,19,30.725582951070336,0.6715686274509804,40.476190476190474,1038.0952380952378,30.532212885154053,0
1040,4,0,0,37,0.0,0.0,1.0,37,650,500,150,0.7692307692307693,8,5,3,374.0312436749027,0.3590465465465465,0.11249539118391572,0.24043290630627695,134797.91843820873,2683.7266156462692,137481.645053855,1035,114,537.1351351351351,34,3,17,30.67656387328518,0.6724877450980392,40.386904761904766,1038.4523809523819,30.54271708683476,0
1041,4,0,0,37,0.0,0.0,1.0,37,1100,800,300,0.7272727272727273,14,8,6,378.22948950709963,0.35870245245245247,0.1229283820942848,0.24417063494215718,134952.4943310657,2808.6026077097426,137761.09693877544,1036,115,538.1351351351351,34,3,17,30.413133974946525,0.6740196078431373,40.238095238095234,1039.0476190476186,30.56022408963584,0
1042,4,0,0,37,0.0,0.0,1.0,37,1100,800,300,0.7272727272727273,14,8,6,378.05566440642644,0.3578578578578579,0.11853367844459162,0.24459220939263032,135031.53399348416,2809.8872599451192,137841.4212534293,1037,116,539.1351351351351,35,2,18,30.338715664439487,0.6726190476190477,40.16203703703703,1039.3518518518513,29.69576719576718,0
1043,4,0,0,37,0.0,0.0,1.0,37,950,500,450,0.5263157894736842,14,5,9,379.6500009754711,0.3568255755755756,0.1252357532824977,0.2466489702649752,135181.94504726076,2864.365113811721,138046.31016107247,1038,117,540.1351351351351,35,2,18,30.14712020033388,0.6741071428571428,40.01736111111111,1039.9305555555552,29.712301587301578,0
1044,4,0,0,37,0.0,0.0,1.0,37,800,500,300,0.625,11,5,6,377.29343763142066,0.35660660660660665,0.1251800248351589,0.24593841268084402,135302.33417191778,2809.736555855618,138112.0707277734,1039,118,541.1351351351351,35,2,18,30.088279193087853,0.675297619047619,39.90162037037037,1040.393518518518,29.725529100529087,0
1045,4,1,1,37,0.02631578947368421,0.02631578947368421,0.9736842105263158,38,700,300,400,0.42857142857142855,11,3,8,361.4157092335996,0.3625533428165007,0.11936069948333583,0.2417260912406544,136220.83865960562,2253.8680996162957,138474.7067592219,1040,0,527.8684210526316,36,2,16,29.588052858683934,0.6822916666666667,39.020270270270274,1043.9189189189194,28.997747747747763,5
1046,4,0,1,36,0.0,0.02702702702702703,0.972972972972973,37,700,300,400,0.42857142857142855,11,3,8,368.09089675831467,0.35623123123123124,0.12694158384674226,0.24525790349417634,136086.16958429772,2618.4160397376418,138704.58562403536,1041,120,543.1351351351351,35,2,16,29.547628951747086,0.6830357142857142,39.14930555555555,1043.402777777777,29.811507936507912,0
1047,4,0,0,36,0.0,0.0,1.0,36,950,700,250,0.7368421052631579,12,7,5,372.4980955148519,0.3537037037037037,0.11641947138239228,0.24828485225761807,136099.10891439905,2939.3317743764114,139038.44068877547,1042,121,540.4722222222222,34,2,17,29.419804145274764,0.6853553921568627,39.13690476190476,1043.4523809523807,30.68977591036414,0
1048,4,0,0,36,0.0,0.0,1.0,36,850,600,250,0.7058823529411765,11,6,5,372.4980955148519,0.3537037037037037,0.11641947138239228,0.24828485225761807,136099.10891439905,2939.3317743764114,139038.44068877547,1043,122,541.4722222222222,34,2,17,29.419804145274764,0.6853553921568627,39.13690476190476,1043.4523809523807,30.68977591036414,0
1049,4,0,0,36,0.0,0.0,1.0,36,650,500,150,0.7692307692307693,8,5,3,371.9373212348968,0.353505291005291,0.11882628036956788,0.24834535379027717,136161.2262613378,2928.688350340129,139089.91461167793,1044,123,542.4722222222222,34,2,17,29.37269495456446,0.685968137254902,39.07738095238095,1043.6904761904757,30.69677871148458,0
1050,4,0,0,36,0.0,0.0,1.0,36,950,500,450,0.5263157894736842,14,5,9,373.09736078083165,0.35294312169312164,0.11766755352844349,0.24977586672121305,136254.42885487515,2967.2335600906936,139221.66241496583,1045,124,543.4722222222222,34,2,17,29.24980995819081,0.6868872549019608,38.988095238095234,1044.0476190476181,30.70728291316524,0
1051,4,0,0,36,0.0,0.0,1.0,36,1350,1000,350,0.7407407407407407,17,10,7,376.0814792814591,0.3524966931216931,0.12116405131907282,0.2524378590463838,136347.66333616755,3055.5661848072305,139403.22952097477,1046,125,544.4722222222222,34,2,17,29.079277328165976,0.6878063725490197,38.89880952380951,1044.4047619047599,30.71778711484588,0
1052,4,0,0,36,0.0,0.0,1.0,36,600,500,100,0.8333333333333334,7,5,2,375.160014176394,0.35264550264550265,0.11845437050541907,0.252484991135892,136440.92970521533,3037.436224489783,139478.36592970512,1047,126,545.4722222222222,34,2,19,29.01070153448799,0.6887254901960784,38.8095238095238,1044.761904761904,30.728291316526587,0
1053,4,0,0,36,0.0,0.0,1.0,36,650,600,50,0.9230769230769231,7,6,1,373.12179971459716,0.3529761904761905,0.11421229842282421,0.251556310130164,136503.12500000006,2986.4583333333335,139489.5833333334,1048,127,546.4722222222222,34,2,20,29.002192982456116,0.6893382352941176,38.75,1045.0000000000005,30.735294117647072,0
1054,4,1,0,37,0.02702702702702703,0.0,1.0,37,750,500,250,0.6666666666666666,10,5,5,366.08593649225986,0.3562625125125125,0.10794664561674217,0.24898801956008532,136811.7193528163,2616.9692804783876,139428.6886332947,1049,0,532.6756756756756,35,2,22,28.880061400597405,0.6901785714285714,38.45486111111111,1046.180555555555,29.890873015872998,0
1055,4,0,0,37,0.0,0.0,1.0,37,850,700,150,0.8235294117647058,10,7,3,366.18628350164477,0.3561061061061061,0.10532798034180635,0.24948682661178373,136872.26890700014,2624.1494930984227,139496.41840009857,1050,1,533.6756756756756,35,2,22,28.817447369391296,0.6907738095238095,38.39699074074074,1046.412037037037,29.89748677248677,0
1056,4,0,0,37,0.0,0.0,1.0,37,1150,800,350,0.6956521739130435,15,8,7,371.0047693910217,0.35557432432432434,0.10959649243404623,0.25320725506437786,136932.83185710298,2760.546741040802,139693.37859814378,1051,2,534.6756756756756,35,2,22,28.631376939806103,0.6913690476190476,38.33912037037037,1046.643518518518,29.904100529100514,0
1057,4,0,0,37,0.0,0.0,1.0,37,950,800,150,0.8421052631578947,11,8,3,372.60326612644644,0.35476101101101104,0.11533164644693383,0.2551810559156669,137053.99794506593,2813.353454003766,139867.3513990697,1052,3,535.6756756756756,35,2,17,28.469497255075353,0.6925595238095239,38.223379629629626,1047.1064814814808,29.917328042328023,0
1058,4,0,1,36,0.0,0.02702702702702703,0.972972972972973,37,700,300,400,0.42857142857142855,11,3,8,374.16712986090107,0.3546671671671671,0.11154921499749104,0.25647455992283585,137084.29783950612,2858.4876543209857,139942.7854938271,1053,4,536.6756756756756,35,2,17,28.398541114058357,0.6928571428571428,38.19444444444444,1047.222222222222,29.920634920634914,0
1059,4,0,1,35,0.0,0.027777777777777776,0.9722222222222222,36,900,400,500,0.4444444444444444,14,4,10,379.23053727423417,0.35383597883597884,0.11924388857305313,0.2595589552783574,137032.35721371893,3193.370890022694,140225.72810374163,1054,5,547.9444444444445,34,2,18,28.317462573431882,0.6945465686274509,38.24404761904763,1047.0238095238105,30.794817927170897,0
1060,4,0,1,34,0.0,0.02857142857142857,0.9714285714285714,35,800,600,200,0.75,10,6,4,386.5293274205882,0.3494397759103642,0.12424455375966215,0.2631728387174629,136849.11602508667,3579.2393550557686,140428.35538014243,1055,134,564.4571428571429,33,2,21,28.308249394862187,0.6950757575757576,38.41911764705883,1046.323529411766,31.706773618538364,0
1061,4,0,0,34,0.0,0.0,1.0,34,800,600,200,0.75,10,6,4,396.69906823486906,0.35089869281045755,0.12196031098015592,0.26961868583477366,136786.95294166417,4052.6513557290136,140839.60429739318,1056,135,565.5294117647059,32,2,21,28.104003218668286,0.6969401041666666,38.47853535353536,1046.085858585859,32.69018308080809,0
1062,4,0,0,34,0.0,0.0,1.0,34,750,700,50,0.9333333333333333,8,7,1,397.64952190532654,0.3512700534759358,0.11982978300527392,0.270774164998311,136853.0016866903,4083.9061384042625,140936.90782509456,1057,136,566.5294117647059,32,2,21,28.0135050882909,0.6975911458333333,38.41540404040405,1046.338383838385,32.69807449494953,0
1063,4,0,0,34,0.0,0.0,1.0,34,650,400,250,0.6153846153846154,9,4,5,398.24242821975747,0.3506387403446227,0.12027634072087023,0.271689834363257,136919.06637396707,4105.39629247017,141024.46266643723,1058,137,567.5294117647059,32,2,21,27.93235010254555,0.6982421875,38.352272727272734,1046.5909090909101,32.70596590909094,0
1064,4,0,0,34,0.0,0.0,1.0,34,950,800,150,0.8421052631578947,11,8,3,400.7298673354936,0.34881907308377896,0.11248803318795897,0.27494245240264026,137117.35608930213,4189.403983011942,141306.76007231406,1059,138,568.5294117647059,32,2,19,27.670283303194694,0.7001953125,38.16287878787879,1047.3484848484852,32.72964015151516,0
1065,4,0,0,34,0.0,0.0,1.0,34,900,800,100,0.8888888888888888,10,8,2,400.21275937729916,0.3482248960190137,0.10919255010670037,0.2751089697227385,137183.4845455822,4180.516178196116,141364.00072377833,1060,139,569.5294117647059,32,2,19,27.618165200273182,0.7008463541666666,38.09974747474748,1047.601010101011,32.737531565656596,0
1066,4,0,0,34,0.0,0.0,1.0,34,1200,900,300,0.75,15,9,6,396.34821057419913,0.348150623885918,0.05881661387809367,0.26215691128648005,135825.23098087255,3966.8174500192063,139792.04843089177,1061,140,570.5294117647059,33,1,18,29.070656007524107,0.6849747474747476,39.39950980392156,1042.4019607843122,31.587938205585218,4
1067,4,0,0,34,0.0,0.0,1.0,34,850,700,150,0.8235294117647058,10,7,3,397.19756438971586,0.347946375519905,0.06261625374259294,0.2629540607208803,135857.16919273834,3992.42734164744,139849.59653438578,1062,141,571.5294117647059,33,1,18,29.0166676462521,0.6852904040404041,39.368872549019606,1042.5245098039213,31.59165181224004,0
1068,4,0,0,34,0.0,0.0,1.0,34,1000,800,200,0.8,12,8,4,395.21569288084413,0.3482991681521093,0.06625423377341577,0.26234676649110616,135953.0063557285,3946.1523212225993,139899.15867695108,1063,142,572.5294117647059,33,1,17,28.97277712495104,0.6862373737373737,39.27696078431372,1042.8921568627445,31.60279263220438,0
1069,4,0,0,34,0.0,0.0,1.0,34,1100,600,500,0.5454545454545454,16,6,10,394.7491231740148,0.3481320558526441,0.06793630388355609,0.2622724268020327,135984.9595858563,3935.9887122741184,139920.94829813042,1064,143,573.5294117647059,33,1,17,28.953095014295222,0.6865530303030304,39.24632352941176,1043.0147058823522,31.606506238859158,0
1070,4,0,0,34,0.0,0.0,1.0,34,750,600,150,0.8,9,6,3,393.954002134095,0.3480020796197267,0.0670333923042905,0.2619794114191729,136016.91657054957,3916.8817281814436,139933.798298731,1065,144,574.5294117647059,33,1,17,28.941983865914786,0.686868686868687,39.21568627450979,1043.137254901959,31.61021984551391,0
1071,4,0,0,34,0.0,0.0,1.0,34,600,400,200,0.6666666666666666,8,4,4,393.29272313522614,0.348150623885918,0.0666376487169924,0.26201050428586187,136080.8418036331,3903.9209678969514,139984.76277153008,1066,145,575.5294117647059,33,1,17,28.895544593219014,0.6875,39.15441176470588,1043.3823529411757,31.617647058823504,0
1072,4,0,0,34,0.0,0.0,1.0,34,800,600,200,0.75,10,6,4,381.69363817793504,0.348150623885918,0.058565958927950135,0.24033615816717954,134042.68340301796,3432.6478998462026,137475.33130286416,1067,146,576.5294117647059,33,1,19,31.23372781065089,0.6672979797979799,41.11519607843137,1035.5392156862738,31.379976232917386,4
1073,4,0,0,34,0.0,0.0,1.0,34,1200,800,400,0.6666666666666666,16,8,8,382.34377968944716,0.3476492869875223,0.05134619800836493,0.24137057279424146,134137.8785352988,3457.3566957420076,137595.2352310408,1068,147,577.5294117647059,33,1,19,31.121470681020547,0.6682449494949496,41.02328431372548,1035.906862745097,31.391117052881725,0
1074,4,0,0,34,0.0,0.0,1.0,34,550,500,50,0.9090909090909091,6,5,1,381.785864178533,0.3475564468211527,0.050675628661684735,0.2412270325684094,134169.6177551903,3444.812692233756,137614.43044742406,1069,148,578.5294117647059,33,1,19,31.104112451699397,0.6685606060606061,40.99264705882353,1036.0294117647059,31.39483065953654,0
1075,4,0,0,34,0.0,0.0,1.0,34,300,100,200,0.3333333333333333,5,1,4,381.785864178533,0.3475564468211527,0.050675628661684735,0.2412270325684094,134169.6177551903,3444.812692233756,137614.43044742406,1070,149,579.5294117647059,33,1,19,31.104112451699397,0.6685606060606061,40.99264705882353,1036.0294117647059,31.39483065953654,0
1076,4,0,0,34,0.0,0.0,1.0,34,1150,1000,150,0.8695652173913043,13,10,3,381.785864178533,0.3475564468211527,0.050675628661684735,0.2412270325684094,134169.6177551903,3444.812692233756,137614.43044742406,1071,150,580.5294117647059,33,1,19,31.104112451699397,0.6685606060606061,40.99264705882353,1036.0294117647059,31.39483065953654,0
1077,4,0,0,34,0.0,0.0,1.0,34,550,400,150,0.7272727272727273,7,4,3,374.1957752555716,0.3475564468211527,0.013925641473206296,0.23062175614690483,133250.70473195397,3172.370152104948,136423.0748840589,1072,151,581.5294117647059,33,1,19,32.22242828882295,0.6594065656565657,41.88112745098039,1032.4754901960778,31.287136066547813,3
1078,4,1,0,35,0.02857142857142857,0.0,1.0,35,450,300,150,0.6666666666666666,6,3,3,363.7798631150669,0.3526960784313726,0.014535299764377507,0.22574209094744696,133504.84206012153,2713.6425813900055,136218.48464151155,1073,0,565.8857142857142,32,3,20,32.23630625127266,0.6643880208333333,41.63510101010102,1033.459595959597,32.295612373737406,0
1079,4,0,0,35,0.0,0.0,1.0,35,1050,700,350,0.6666666666666666,14,7,7,366.80116029116573,0.35217086834733896,0.010888342145212837,0.22801830670491824,133570.0936926079,2798.7330693296567,136368.82676193755,1074,1,566.8857142857142,32,3,20,32.092799560278486,0.6650390625,41.571969696969695,1033.712121212121,32.30350378787878,0
1080,4,0,0,35,0.0,0.0,1.0,35,750,500,250,0.6666666666666666,10,5,5,366.8558358600987,0.3522058823529412,0.008855084346597764,0.22845493839226982,133635.3612673452,2804.982431639636,136440.34369898483,1075,2,567.8857142857142,32,3,20,32.02593926812392,0.6656901041666666,41.50883838383839,1033.9646464646466,32.31139520202021,0
1081,4,0,0,35,0.0,0.0,1.0,35,850,700,150,0.8235294117647058,10,7,3,366.8558358600987,0.35189075630252103,0.008855084346597764,0.22845493839226982,133635.3612673452,2804.982431639636,136440.34369898483,1076,3,568.8857142857142,32,3,20,32.02593926812392,0.6656901041666666,41.50883838383839,1033.9646464646466,32.31139520202021,0
1082,4,0,0,35,0.0,0.0,1.0,35,1000,700,300,0.7,13,7,6,366.69939756393467,0.35175070028011207,0.01144670758928612,0.2289635262838225,133733.29252117124,2807.9835603509796,136541.27608152223,1077,4,569.8857142857142,32,3,16,31.93181355794272,0.6666666666666667,41.41414141414141,1034.3434343434337,32.323232323232304,0
1083,4,0,0,35,0.0,0.0,1.0,35,650,500,150,0.7692307692307693,8,5,3,366.9770572763524,0.35203081232493,0.013326824505735857,0.22954274865056734,133798.59995153558,2820.203295582089,136618.80324711767,1078,5,570.8857142857142,32,3,17,31.85918558294688,0.6673177083333333,41.351010101010104,1034.5959595959598,32.331123737373744,0
1084,4,1,2,34,0.027777777777777776,0.05555555555555555,0.9444444444444444,36,1100,900,200,0.8181818181818182,13,9,4,358.0077046388048,0.3561342592592593,0.001130032586986074,0.226595295690549,134233.10745866984,2411.297337562487,136644.40479623232,1079,0,556.0,33,3,17,31.656516083254495,0.6691919191919191,40.93137254901961,1036.2745098039222,31.40225787284613,0
1085,4,0,0,34,0.0,0.0,1.0,34,750,400,350,0.5333333333333333,11,4,7,370.5586103279652,0.3465723410576352,0.03598843483395453,0.22729168264065608,133072.72002550997,3062.2484410430598,136134.96846655302,1080,159,589.5294117647059,34,0,16,32.4951444175224,0.6553308823529413,42.053571428571416,1031.7857142857126,30.346638655462137,4
1086,4,0,0,34,0.0,0.0,1.0,34,600,300,300,0.5,9,3,6,371.05407517085706,0.3462566844919786,0.03396536279486417,0.22778305407797342,133103.4297052151,3077.7140022675344,136181.14370748264,1081,160,590.5294117647059,34,0,16,32.45149784648515,0.6556372549019609,42.023809523809504,1031.9047619047594,30.350140056022337,0
1087,4,0,0,34,0.0,0.0,1.0,34,800,500,300,0.625,11,5,6,372.48158210223596,0.3466837492572787,0.033122578982002215,0.2292255357280686,133195.58000283438,3122.580073696133,136318.1600765305,1082,161,591.5294117647059,34,0,17,32.32206012378425,0.6565563725490197,41.9345238095238,1032.2619047619041,30.36064425770306,0
1088,4,0,0,34,0.0,0.0,1.0,34,900,600,300,0.6666666666666666,12,6,6,374.2477721764986,0.34627525252525254,0.038803186980844284,0.23107469207338951,133318.496669501,3178.830073696129,136497.32674319713,1083,162,592.5294117647059,34,0,17,32.15297790585974,0.6577818627450981,41.81547619047618,1032.7380952380943,30.37464985994395,0
1089,4,0,0,34,0.0,0.0,1.0,34,900,600,300,0.6666666666666666,12,6,6,374.2477721764986,0.34627525252525254,0.038803186980844284,0.23107469207338951,133318.496669501,3178.830073696129,136497.32674319713,1084,163,593.5294117647059,34,0,17,32.15297790585974,0.6577818627450981,41.81547619047618,1032.7380952380943,30.37464985994395,0
1090,4,0,0,34,0.0,0.0,1.0,34,900,600,300,0.6666666666666666,12,6,6,372.5576346319404,0.34716651812240046,0.034852132667361646,0.2311891007932094,133504.8420601214,3147.8267881609336,136652.6688482823,1085,164,594.5294117647059,32,2,17,32.009519446141326,0.6643880208333334,41.63510101010101,1033.4595959595958,32.29561237373737,0
1091,4,0,0,34,0.0,0.0,1.0,34,850,700,150,0.8235294117647058,10,7,3,372.97509305545344,0.3467580213903743,0.03458495893777047,0.23185627083105523,133570.09369260792,3163.663624885213,136733.75731749312,1086,165,595.5294117647059,32,2,18,31.93324783192866,0.6650390625,41.571969696969695,1033.7121212121212,32.30350378787879,0
1092,4,0,0,34,0.0,0.0,1.0,34,950,700,250,0.7368421052631579,12,7,5,374.17381153644885,0.34621954842543073,0.03216979099332051,0.23321792362888263,133668.00103305795,3203.013085399463,136871.01411845742,1087,166,596.5294117647059,32,2,18,31.804029304029314,0.666015625,41.477272727272734,1034.09090909091,32.315340909090935,0
1093,4,1,0,35,0.02857142857142857,0.0,1.0,35,800,500,300,0.625,11,5,6,365.84179165417197,0.3497899159663866,0.049564820604688364,0.23095299961558735,134137.87853529892,2814.6483624086895,136952.5268977076,1088,0,580.4571428571429,33,2,17,31.54883374738752,0.6682449494949495,41.02328431372549,1035.906862745098,31.391117052881754,0
1094,4,0,0,35,0.0,0.0,1.0,35,1000,800,200,0.8,12,8,4,365.2387010586466,0.3508403361344538,0.051616390230719844,0.23157338332488991,134296.61218041132,2810.0640378700446,137106.67621828135,1089,1,581.4571428571429,33,2,17,31.405671159454556,0.6698232323232323,40.870098039215684,1036.5196078431368,31.409685086155662,0
1095,4,0,0,35,0.0,0.0,1.0,35,800,400,400,0.5,12,4,8,363.3787703502507,0.35070028011204485,0.051104356636271886,0.23079462441164583,134360.13192041524,2764.723904267597,137124.85582468283,1090,2,582.4571428571429,33,2,18,31.39036643026005,0.6704545454545454,40.80882352941177,1036.7647058823532,31.41711229946525,0
1096,4,0,0,35,0.0,0.0,1.0,35,650,400,250,0.6153846153846154,9,4,5,364.3725227959382,0.3505602240896359,0.049355868100697364,0.23162704097493866,134391.8974222655,2793.742941416768,137185.64036368227,1091,3,583.4571428571429,33,2,18,31.332855651420246,0.670770202020202,40.77818627450981,1036.8872549019611,31.420825906120033,0
1097,4,0,0,35,0.0,0.0,1.0,35,1000,700,300,0.7,13,7,6,364.18372303045464,0.3509103641456583,0.04906204906204903,0.23192752887728973,134458.16326530627,2793.4948979592,137251.65816326547,1092,4,584.4571428571429,34,1,19,31.271522038567493,0.6691176470588235,40.71428571428572,1037.1428571428582,30.504201680672303,0
1098,4,0,0,35,0.0,0.0,1.0,35,650,400,250,0.6153846153846154,9,4,5,364.99411299817723,0.3507352941176471,0.049569707401032614,0.23303470291422101,134550.78125000015,2822.048611111126,137372.82986111127,1093,5,585.4571428571429,34,1,19,31.157965194109767,0.6700367647058822,40.62500000000001,1037.5000000000011,30.514705882352974,0
1099,4,0,0,35,0.0,0.0,1.0,35,950,600,350,0.631578947368421,13,6,7,362.79254834325326,0.3500350140056023,0.04244396849756282,0.2326431246794627,134709.7589418734,2774.339346645531,137484.09828851896,1094,6,586.4571428571429,33,2,19,31.056324518947,0.6739267676767677,40.4718137254902,1038.11274509804,31.457961972667878,0
1100,4,0,0,35,0.0,0.0,1.0,35,1100,600,500,0.5454545454545454,16,6,10,366.2671922451073,0.34880952380952385,0.039133586177834134,0.23569585833540538,134837.00867755205,2877.2745158112452,137714.28319336328,1095,7,587.4571428571429,33,2,17,30.83911012782694,0.6751893939393938,40.34926470588236,1038.6029411764719,31.472816399287026,0
1101,4,0,0,35,0.0,0.0,1.0,35,1000,900,100,0.9,11,9,2,364.0826813657517,0.34793417366946783,0.039313099310739785,0.23470181672528342,134900.65607278454,2822.998516195696,137723.65458898022,1096,8,588.4571428571429,33,2,18,30.8323257048484,0.6758207070707071,40.28799019607843,1038.8480392156866,31.480243612596563,0
1102,4,0,0,35,0.0,0.0,1.0,35,800,700,100,0.875,9,7,2,363.95180669277306,0.34796918767507007,0.03935309973045831,0.2352371433502071,134996.15532487506,2826.418925413302,137822.57425028837,1097,9,589.4571428571429,33,2,18,30.74046776729559,0.6767676767676767,40.19607843137255,1039.2156862745098,31.491384432560903,0
1103,4,0,1,34,0.0,0.02857142857142857,0.9714285714285714,35,1000,700,300,0.7,13,7,6,362.8918155505186,0.3485994397759104,0.03902471879841074,0.23538028770111605,135123.54022491345,2807.0453671664686,137930.5855920799,1098,10,590.4571428571429,33,2,19,30.641010529624403,0.678030303030303,40.0735294117647,1039.7058823529408,31.506238859180023,0
1104,4,0,0,34,0.0,0.0,1.0,34,1350,1000,350,0.7407407407407407,17,10,7,365.42165198297386,0.34465983363042185,0.033225260481757335,0.23756733602081737,135206.56573627688,3081.4813220589676,138288.04705833585,1099,11,595.8823529411765,32,2,20,30.492493221642178,0.6813151041666667,39.993686868686865,1040.0252525252522,32.50078914141413,0
1105,4,0,1,33,0.0,0.029411764705882353,0.9705882352941176,34,1150,800,350,0.6956521739130435,15,8,7,365.74901027429524,0.34441844919786097,0.030097087378640808,0.2384313168243824,135305.07091113148,3097.5391541679364,138402.6100652994,1100,12,596.8823529411765,32,2,20,30.385821197410998,0.6822916666666667,39.898989898989896,1040.4040404040402,32.512626262626256,0
1106,4,0,0,33,0.0,0.0,1.0,33,650,400,250,0.6153846153846154,9,4,5,364.76897920476904,0.3435921717171717,0.02382764668894999,0.23800959284453693,135337.91394054177,3273.4145431588613,138611.32848370064,1101,13,600.4848484848485,32,1,20,30.378594830724424,0.6826171875,39.86742424242424,1040.530303030303,32.51657196969697,0
1107,4,0,0,33,0.0,0.0,1.0,33,650,500,150,0.7692307692307693,8,5,3,364.06246281571396,0.34311868686868685,0.020388281700910227,0.23798309920618002,135403.6119560504,3259.074488572591,138662.686444623,1102,14,601.4848484848485,32,1,20,30.331543936269156,0.6832682291666667,39.80429292929293,1040.7828282828282,32.52446338383838,0
1108,4,0,0,33,0.0,0.0,1.0,33,600,600,0,1.0,6,6,0,372.0450164965498,0.34311868686868685,-0.0007319225884225844,0.23345410173327352,133915.8091238948,3364.541882929665,137280.35100682447,1103,15,602.4848484848485,33,0,18,31.610624358670776,0.6660353535353534,41.23774509803923,1035.0490196078445,31.365121806298315,5
1109,4,0,0,33,0.0,0.0,1.0,33,1100,900,200,0.8181818181818182,13,9,4,375.5414726375128,0.34296085858585856,-0.004145597991751737,0.23646240266669027,134042.68340301808,3467.717344290662,137510.40074730874,1104,16,603.4848484848485,33,0,18,31.392998027613416,0.6672979797979798,41.115196078431374,1035.5392156862747,31.379976232917414,0
1110,4,0,0,33,0.0,0.0,1.0,33,650,500,150,0.7692307692307693,8,5,3,376.6328143805071,0.34272411616161613,-0.004145107446491991,0.2373545051699974,134074.41135921283,3499.36457732603,137573.77593653885,1105,17,604.4848484848485,33,0,18,31.33295369384293,0.6676136363636364,41.08455882352941,1035.6617647058824,31.383689839572195,0
1111,4,1,1,33,0.029411764705882353,0.029411764705882353,0.9705882352941176,34,850,600,250,0.7058823529411765,11,6,5,368.999493388199,0.34863339275103983,-0.005437866464913732,0.23420171927291814,134334.72222222228,3113.8888888888946,137448.61111111118,1106,0,587.6764705882352,34,0,19,31.2700964630225,0.6678921568627452,40.833333333333336,1036.666666666667,30.49019607843138,0
1112,4,0,0,33,0.0,0.0,1.0,33,300,100,200,0.3333333333333333,5,1,4,377.81382218956753,0.3424873737373737,-0.0009750886362740463,0.23851084682363055,134137.87853529892,3535.828917964244,137673.70745326317,1107,19,606.4848484848485,33,0,19,31.238786032572264,0.6682449494949495,41.02328431372549,1035.906862745098,31.391117052881754,0
1113,4,0,0,33,0.0,0.0,1.0,33,900,500,400,0.5555555555555556,13,5,8,375.46800220899723,0.3417376893939394,-0.007554255898626794,0.23764651397300013,134233.10745866984,3480.0473375624865,137713.15479623232,1108,20,607.4848484848485,33,0,20,31.204174550614955,0.6691919191919191,40.93137254901961,1036.2745098039222,31.40225787284613,0
1114,4,0,0,33,0.0,0.0,1.0,33,500,100,400,0.2,9,1,8,378.85334154448935,0.3421717171717172,-0.009987569273536723,0.2404141347430487,134328.3701731307,3578.1503808631523,137906.52055399385,1109,21,608.4848484848485,33,0,20,31.021077156480274,0.6701388888888888,40.83946078431374,1036.6421568627466,31.413398692810503,0
1115,4,0,0,33,0.0,0.0,1.0,33,950,700,250,0.7368421052631579,12,7,5,376.328656272669,0.3416982323232323,-0.018259151056882583,0.23985284237137577,134487.21645520956,3522.278690888121,138009.49514609767,1110,22,609.4848484848485,33,0,20,30.927555923125386,0.6717171717171717,40.68627450980392,1037.2549019607845,31.43196672608438,0
1116,4,0,0,33,0.0,0.0,1.0,33,600,500,100,0.8333333333333334,7,5,2,374.67137626812473,0.3421717171717172,-0.02287939637337222,0.2392132633096488,134550.78125,3482.465277777776,138033.24652777778,1111,23,610.4848484848485,33,0,20,30.90696117804551,0.6723484848484849,40.625,1037.5,31.439393939393938,0
1117,4,0,0,33,0.0,0.0,1.0,33,650,300,350,0.46153846153846156,10,3,7,374.78927640996966,0.3417376893939394,-0.012164144395549581,0.24012595848656898,134677.95589436757,3495.1707276047628,138173.12662197233,1112,24,611.4848484848485,33,0,20,30.776761117670198,0.6736111111111112,40.502450980392155,1037.9901960784314,31.454248366013072,0
1118,4,0,0,33,0.0,0.0,1.0,33,500,300,200,0.6,7,3,4,377.52757291474387,0.3416193181818182,-0.008026440037771865,0.242304060434372,134741.5657439446,3573.7312572087576,138315.29700115338,1113,25,612.4848484848485,33,0,20,30.64211520302171,0.6742424242424242,40.44117647058823,1038.2352941176468,31.46167557932263,0
1119,4,0,0,33,0.0,0.0,1.0,33,1100,700,400,0.6363636363636364,15,7,8,378.0521455689452,0.34122474747474746,-0.005348434796287549,0.2434931600184177,134868.83049788536,3597.4901480199796,138466.32064590533,1114,26,613.4848484848485,33,0,17,30.501317445335843,0.6755050505050505,40.31862745098039,1038.7254901960778,31.47653000594175,0
1120,4,0,0,33,0.0,0.0,1.0,33,900,700,200,0.7777777777777778,11,7,4,379.96226499853987,0.340948547979798,-0.012939824788166021,0.23719537844583424,133725.61034217622,3562.1371587850995,137287.74750096133,1115,27,614.4848484848485,33,0,18,31.59656398104266,0.6641414141414141,41.42156862745099,1034.3137254901972,31.342840166369612,2
1121,4,0,0,33,0.0,0.0,1.0,33,1050,900,150,0.8571428571428571,12,9,3,377.8554103261413,0.34063289141414144,-0.01268966309231545,0.236692216972844,133852.39451172634,3515.370290272983,137367.76480199932,1116,28,615.4848484848485,33,0,18,31.523863098057795,0.6654040404040404,41.29901960784314,1034.803921568628,31.35769459298873,0
1122,4,0,0,33,0.0,0.0,1.0,33,650,400,250,0.6153846153846154,9,4,5,376.9065908761986,0.34067234848484845,-0.013174606591608518,0.23650468547848252,133915.80912389472,3494.7502162629844,137410.55934015772,1117,29,616.4848484848485,33,0,18,31.484825163785608,0.6660353535353535,41.23774509803922,1035.0490196078438,31.365121806298298,0
1123,4,0,0,33,0.0,0.0,1.0,33,750,400,350,0.5333333333333333,11,4,7,376.05917193300667,0.3405539772727273,-0.008048289738430414,0.23658406133000534,134010.95920138882,3479.210069444435,137490.16927083326,1118,30,617.4848484848485,33,0,18,31.411384976525813,0.6669823232323233,41.14583333333333,1035.416666666666,31.37626262626261,0
1124,4,0,0,33,0.0,0.0,1.0,33,900,800,100,0.8888888888888888,10,8,2,377.71383021159664,0.33956755050505055,-0.010971045045820027,0.23824158902600112,134106.14306997307,3530.748990772782,137636.89206074586,1119,31,618.4848484848485,33,0,18,31.27317005836882,0.6679292929292929,41.05392156862745,1035.7843137254902,31.387403446226976,0
1125,4,0,0,33,0.0,0.0,1.0,33,700,600,100,0.8571428571428571,8,6,2,381.93477908684656,0.3390940656565657,-0.010965855336716013,0.24173955778131537,134233.1074586697,3653.6584486735837,137886.76590734327,1120,32,619.4848484848485,33,0,18,31.036640649637352,0.6691919191919192,40.931372549019606,1036.274509803921,31.402257872846093,0
1126,4,0,0,33,0.0,0.0,1.0,33,1050,900,150,0.8571428571428571,12,9,3,381.43821785747343,0.338738952020202,-0.009256771521814589,0.24205445497797198,134328.37017313048,3647.5948253075676,137975.96499843805,1121,33,620.4848484848485,33,0,19,30.95408736257241,0.670138888888889,40.83946078431372,1036.6421568627445,31.41339869281044,0
1127,4,0,0,33,0.0,0.0,1.0,33,550,400,150,0.7272727272727273,7,4,3,381.1455940624496,0.3383443813131313,-0.00657640232108303,0.24207895839101512,134360.13192041512,3642.154459823136,138002.28638023825,1122,34,621.4848484848485,33,0,20,30.929866036249017,0.6704545454545455,40.80882352941176,1036.7647058823522,31.41711229946522,0
1128,4,0,0,33,0.0,0.0,1.0,33,1050,800,250,0.7619047619047619,13,8,5,380.18315924401566,0.3385811237373737,-0.012171329359752292,0.24252075681993895,134518.99697532188,3628.3714496827997,138147.36842500468,1123,35,622.4848484848485,33,0,20,30.79580133884622,0.6720328282828283,40.655637254901954,1037.3774509803911,31.435680332739125,0
1129,4,0,0,33,0.0,0.0,1.0,33,700,400,300,0.5714285714285714,10,4,6,379.187432460767,0.3382654671717172,-0.011196300352926514,0.2420965914941818,134550.78124999985,3603.993055555541,138154.7743055554,1124,36,623.4848484848485,33,0,20,30.789825970548872,0.6723484848484849,40.62499999999999,1037.4999999999989,31.439393939393906,0
1130,4,0,0,33,0.0,0.0,1.0,33,1050,600,450,0.5714285714285714,15,6,9,381.359572250551,0.3381076388888889,-0.006083508681524741,0.243908826119159,134614.36106305264,3667.295030757397,138281.65609381004,1125,37,624.4848484848485,33,0,20,30.66987482286254,0.6729797979797979,40.56372549019608,1037.7450980392155,31.4468211527035,0
1131,4,0,0,33,0.0,0.0,1.0,33,750,700,50,0.9333333333333333,8,7,1,381.94669700408735,0.3383838383838384,-0.002189804527742867,0.24449785161962348,134646.1566014274,3685.530955642072,138331.6875570695,1126,38,625.4848484848485,33,0,20,30.622835242256066,0.6732954545454545,40.53308823529412,1037.8676470588243,31.450534759358312,0
1132,4,1,0,34,0.029411764705882353,0.0,1.0,34,1050,700,350,0.6666666666666666,14,7,7,373.3161673019256,0.3450497623291741,0.0024765319118826845,0.241204798251555,134983.42013888882,3278.2986111111013,138261.7187499999,1127,0,608.0588235294117,34,0,17,30.509890403635396,0.6743259803921569,40.20833333333333,1039.166666666666,30.56372549019606,0
1133,4,0,0,34,0.0,0.0,1.0,34,550,300,250,0.5454545454545454,8,3,5,372.1455549712009,0.3444927213309566,-0.001061127692401298,0.2408601067793592,135045.28238378692,3251.300311791387,138296.5826955783,1128,1,609.0588235294117,34,0,17,30.478562974840596,0.6749387254901961,40.148809523809526,1039.4047619047624,30.57072829131654,0
1134,4,0,0,34,0.0,0.0,1.0,34,1100,1000,100,0.9090909090909091,12,10,2,378.50896165429475,0.34443701723113485,0.0018849379990040216,0.24645389768518816,135261.9118480724,3439.5691609977157,138701.48100907012,1129,2,610.0588235294117,34,0,18,30.096990157930886,0.6770833333333334,39.94047619047618,1040.238095238094,30.59523809523806,0
1135,4,0,0,34,0.0,0.0,1.0,34,900,600,300,0.6666666666666666,12,6,6,379.95924868472093,0.3440285204991087,-0.00070652832169249,0.24825140149490493,135385.77806122435,3488.2157029478262,138873.9937641722,1130,3,611.0588235294117,34,0,18,29.935703119042163,0.6783088235294118,39.82142857142856,1040.7142857142846,30.60924369747896,0
1136,4,0,0,34,0.0,0.0,1.0,34,600,300,300,0.5,9,3,6,377.5826623552194,0.34362002376708256,-0.0037672891663522723,0.24712446105045172,135447.73242630364,3428.543083900206,138876.27551020385,1131,4,612.0588235294117,34,0,18,29.93576547727967,0.6789215686274511,39.76190476190475,1040.9523809523794,30.616246498599395,0
1137,4,0,0,34,0.0,0.0,1.0,34,750,400,350,0.5333333333333333,11,4,7,377.5826623552194,0.34362002376708256,-0.0037672891663522723,0.24712446105045172,135447.73242630364,3428.543083900206,138876.27551020385,1132,5,613.0588235294117,34,0,18,29.93576547727967,0.6789215686274511,39.76190476190475,1040.9523809523794,30.616246498599395,0
1138,4,0,0,34,0.0,0.0,1.0,34,950,700,250,0.7368421052631579,12,7,5,374.7923473764172,0.3441027926322044,-0.08249573363981466,0.23497560308788726,133884.09994052764,3241.7031426541134,137125.80308318176,1133,6,614.0588235294117,33,1,20,31.571319321097295,0.665719696969697,41.268382352941174,1034.926470588235,31.36140819964348,6
1139,4,0,1,33,0.0,0.029411764705882353,0.9705882352941176,34,900,600,300,0.6666666666666666,12,6,6,373.34143633112285,0.3437128639334522,-0.08274714100653291,0.2342675907319958,133915.8091238946,3199.2641051518594,137115.07322904648,1134,7,615.0588235294117,33,1,20,31.577077906701398,0.6660353535353536,41.23774509803921,1035.0490196078429,31.36512180629827,0
1140,4,0,0,33,0.0,0.0,1.0,33,1100,800,300,0.7272727272727273,14,8,6,373.13310892148377,0.34307922979797983,-0.07079698336862117,0.23484763056524088,134027.3015030354,3402.0047380369356,137429.30624107234,1135,8,624.3030303030303,32,1,20,31.4707555989107,0.6695963541666666,41.130050505050505,1035.4797979797981,32.35874368686869,0
1141,4,0,0,33,0.0,0.0,1.0,33,1200,1100,100,0.9166666666666666,13,11,2,371.9821262060967,0.34327651515151514,-0.07184089524126103,0.2349586871070843,134158.07578627186,3380.8812557392175,137538.95704201108,1136,9,625.3030303030303,32,1,20,31.369591712370507,0.6708984375,41.00378787878788,1035.984848484849,32.37452651515153,0
1142,4,0,0,33,0.0,0.0,1.0,33,650,500,150,0.7692307692307693,8,5,3,370.69913533483304,0.3435527146464647,-0.07319847266227975,0.23435724996591997,134190.77932098764,3348.881172839505,137539.66049382713,1137,10,626.3030303030303,32,1,20,31.37008489722967,0.6712239583333334,40.97222222222222,1036.111111111111,32.37847222222222,0
1143,4,0,0,33,0.0,0.0,1.0,33,650,500,150,0.7692307692307693,8,5,3,371.023473009345,0.3435921717171717,-0.0750431080637004,0.23477175350714663,134223.4868412661,3360.0128494541264,137583.49969072023,1138,11,627.3030303030303,32,1,20,31.328946834003496,0.6715494791666667,40.94065656565656,1036.237373737373,32.382417929292906,0
1144,4,0,0,33,0.0,0.0,1.0,33,850,700,150,0.8235294117647058,10,7,3,390.3884253718469,0.3424479166666667,-0.0552824550867127,0.2399274427811638,133146.2430491788,3795.7504336292363,136941.99348280803,1139,12,628.3030303030303,32,1,18,31.909611777179677,0.6608072916666666,41.98232323232324,1032.070707070708,32.25220959595963,2
1145,4,0,0,33,0.0,0.0,1.0,33,950,500,450,0.5263157894736842,14,5,9,391.99978171039464,0.3422900883838384,-0.05263001838344328,0.24133962464338762,133211.4069992859,3843.7684930109267,137055.1754922968,1140,13,629.3030303030303,32,1,18,31.802429876060017,0.6614583333333333,41.919191919191924,1032.323232323233,32.26010101010103,0
1146,4,0,0,33,0.0,0.0,1.0,33,650,400,250,0.6153846153846154,9,4,5,391.1896748584716,0.34150094696969696,-0.05906497740238592,0.24168667223129137,133341.78272625248,3832.385725946334,137174.16845219882,1141,14,630.3030303030303,32,1,20,31.69213528932356,0.6627604166666666,41.792929292929294,1032.8282828282831,32.27588383838385,0
1147,4,0,0,33,0.0,0.0,1.0,33,450,300,150,0.6666666666666666,6,3,3,389.66322866565866,0.34165877525252525,-0.05728802135987732,0.24137881908940864,133439.60636988585,3799.3015699928783,137238.90793987873,1142,15,631.3030303030303,32,1,20,31.633162246934702,0.6637369791666665,41.69823232323233,1033.2070707070718,32.287720959595994,0
1148,4,0,0,33,0.0,0.0,1.0,33,800,500,300,0.625,11,5,6,392.5979109333694,0.34154040404040403,-0.05502372861278315,0.24383964331567246,133537.46588358335,3885.306027446186,137422.77191102953,1143,16,632.3030303030303,32,1,20,31.458944132258328,0.6647135416666666,41.60353535353536,1033.585858585859,32.29955808080809,0
1149,4,0,0,33,0.0,0.0,1.0,33,400,200,200,0.5,6,2,4,393.4465543265129,0.34122474747474746,-0.05296645457876681,0.24458215188087795,133570.093692608,3910.538624885228,137480.63231749323,1144,17,633.3030303030303,32,1,20,31.404207890558208,0.6650390625,41.5719696969697,1033.712121212122,32.30350378787881,0
1150,4,0,0,33,0.0,0.0,1.0,33,1150,900,250,0.782608695652174,14,9,5,392.6820432314939,0.34051452020202017,-0.05461205461205487,0.2447538762607254,133668.00103305772,3897.804752066099,137565.8057851238,1145,18,634.3030303030303,32,1,21,31.325549450549453,0.666015625,41.47727272727272,1034.090909090908,32.31534090909088,0
1151,4,0,0,33,0.0,0.0,1.0,33,700,400,300,0.5714285714285714,10,4,6,395.3965221045213,0.34086963383838387,-0.055768227866360376,0.24710020637699037,133765.9442435721,3978.117825987144,137744.06206955924,1146,19,635.3030303030303,32,1,17,31.15693274746736,0.6669921875,41.38257575757576,1034.469696969697,32.32717803030303,0
1152,4,0,0,33,0.0,0.0,1.0,33,850,700,150,0.8235294117647058,10,7,3,391.62841453508923,0.34122474747474746,-0.04974473292150472,0.24561423978149402,133896.59098880214,3887.5419281195727,137784.13291692172,1147,20,636.3030303030303,32,1,18,31.123175145378386,0.6682942708333334,41.25631313131313,1034.9747474747471,32.34296085858585,0
1153,4,0,0,33,0.0,0.0,1.0,33,1200,800,400,0.6666666666666666,16,8,8,397.1420605568929,0.34122474747474746,-0.05142869810024153,0.25018119667339783,134059.9890955006,4048.172061524354,138108.16115702497,1148,21,637.3030303030303,32,1,18,30.81641672762741,0.669921875,41.09848484848486,1035.6060606060619,32.362689393939434,0
1154,4,0,0,33,0.0,0.0,1.0,33,600,400,200,0.6666666666666666,8,4,4,399.7907098866757,0.34051452020202017,-0.054393274529793034,0.2522986910700223,134125.37623711876,4124.415875931043,138249.7921130498,1149,22,638.3030303030303,32,1,19,30.68218755078825,0.6705729166666665,41.03535353535354,1035.8585858585866,32.37058080808083,0
1155,4,0,0,33,0.0,0.0,1.0,33,600,400,200,0.6666666666666666,8,4,4,399.4812990250959,0.3407118055555556,-0.054290621018226126,0.25232825700545924,134158.07578627198,4118.728477961454,138276.80426423342,1150,23,639.3030303030303,32,1,20,30.65737355271177,0.6708984375,41.00378787878789,1035.9848484848499,32.37452651515156,0
1156,4,0,0,33,0.0,0.0,1.0,33,650,600,50,0.9230769230769231,7,6,1,402.69602185287755,0.3405539772727273,-0.05788144603934098,0.2550408138401559,134256.19834710754,4212.887396694225,138469.08574380176,1151,24,640.3030303030303,32,1,20,30.47560307017542,0.671875,40.909090909090914,1036.3636363636372,32.38636363636366,0
1157,4,0,0,33,0.0,0.0,1.0,33,400,300,100,0.75,5,3,2,402.69602185287755,0.3405539772727273,-0.05788144603934098,0.2550408138401559,134256.19834710754,4212.887396694225,138469.08574380176,1152,25,641.3030303030303,32,1,20,30.47560307017542,0.671875,40.909090909090914,1036.3636363636372,32.38636363636366,0
1158,4,0,0,33,0.0,0.0,1.0,33,500,400,100,0.8,6,4,2,402.90774377136603,0.339804292929293,-0.05684170901562191,0.2558604396060856,134354.35677800732,4226.48215105601,138580.83892906332,1153,26,642.3030303030303,32,1,20,30.371605163804645,0.6728515625,40.81439393939394,1036.742424242424,32.39820075757575,0
1159,4,0,0,33,0.0,0.0,1.0,33,650,500,150,0.7692307692307693,8,5,3,402.90774377136603,0.339804292929293,-0.05684170901562191,0.2558604396060856,134354.35677800732,4226.48215105601,138580.83892906332,1154,27,643.3030303030303,32,1,20,30.371605163804645,0.6728515625,40.81439393939394,1036.742424242424,32.39820075757575,0
1160,4,0,0,33,0.0,0.0,1.0,33,850,800,50,0.9411764705882353,9,8,1,402.1978038908572,0.3387784090909091,-0.061439615237083633,0.25655723266826724,134518.03387409446,4220.571561575343,138738.6054356698,1155,28,644.3030303030303,32,1,20,30.225829681921454,0.6744791666666667,40.656565656565654,1037.3737373737372,32.41792929292929,0
1161,4,0,0,33,0.0,0.0,1.0,33,1000,900,100,0.9,11,9,2,401.6502485417898,0.33866003787878785,-0.06196302278073962,0.2566688757788825,134583.5326114682,4211.101864605658,138794.63447607384,1156,29,645.3030303030303,32,1,20,30.174363186501186,0.6751302083333333,40.593434343434346,1037.6262626262626,32.425820707070706,0
1162,4,0,0,33,0.0,0.0,1.0,33,650,500,150,0.7692307692307693,8,5,3,401.6502485417898,0.33846275252525254,-0.06196302278073962,0.2566688757788825,134583.5326114682,4211.101864605658,138794.63447607384,1157,30,646.3030303030303,32,1,20,30.174363186501186,0.6751302083333333,40.593434343434346,1037.6262626262626,32.425820707070706,0
1163,4,0,0,33,0.0,0.0,1.0,33,950,700,250,0.7368421052631579,12,7,5,400.27097200687354,0.3383838383838384,-0.06359913451508103,0.256479162967148,134681.8106092491,4181.8438488419615,138863.65445809107,1158,31,647.3030303030303,32,1,21,30.111655110894866,0.6761067708333333,40.49873737373738,1038.0050505050508,32.43765782828284,0
1164,4,0,0,33,0.0,0.0,1.0,33,550,400,150,0.7272727272727273,7,4,3,400.27097200687354,0.3383838383838384,-0.06359913451508103,0.256479162967148,134681.8106092491,4181.8438488419615,138863.65445809107,1159,32,648.3030303030303,32,1,21,30.111655110894866,0.6761067708333333,40.49873737373738,1038.0050505050508,32.43765782828284,0
1165,4,0,0,33,0.0,0.0,1.0,33,900,700,200,0.7777777777777778,11,7,4,395.6379106650896,0.33830492424242425,-0.061033330754979076,0.2548874777636407,134878.47421500355,4072.60754642383,138951.08176142737,1160,33,649.3030303030303,32,1,16,30.03499655605527,0.6780598958333334,40.30934343434343,1038.762626262626,32.461332070707066,0
1166,4,0,0,33,0.0,0.0,1.0,33,750,400,350,0.5333333333333333,11,4,7,393.5821695895952,0.33830492424242425,-0.08993733873940268,0.23467877496627967,132008.45457415067,3803.733515712695,135812.18808986337,1161,34,650.3030303030303,32,1,17,32.97548838923701,0.6494140625,43.08712121212122,1027.651515151516,32.11410984848487,5
1167,4,0,0,33,0.0,0.0,1.0,33,650,500,150,0.7692307692307693,8,5,3,393.63023358235836,0.3385811237373737,-0.08327192336035372,0.23531111320319825,132105.78799357207,3800.166437098254,135905.95443067033,1162,35,651.3030303030303,32,1,17,32.875829034635224,0.650390625,42.99242424242424,1028.030303030303,32.12594696969697,0
1168,4,0,0,33,0.0,0.0,1.0,33,800,600,200,0.75,10,6,4,402.3268905986114,0.3385811237373737,-0.06982150269821485,0.21917808219178087,128496.33487654322,3739.5061728395062,132235.84104938273,1163,36,652.3030303030303,32,1,16,36.329908675799096,0.6139322916666666,46.52777777777778,1013.8888888888889,31.68402777777778,8
1169,4,1,1,33,0.029411764705882353,0.029411764705882353,0.9705882352941176,34,350,200,150,0.5714285714285714,5,2,3,396.89860222379684,0.34480837789661317,-0.0672116709518864,0.21768968368327715,128765.68657487506,3421.384203191088,132187.07077806615,1164,0,634.0882352941177,33,1,16,36.19143926587782,0.6142676767676767,46.26225490196079,1014.9509803921569,30.756090314913845,0
1170,4,2,1,34,0.05714285714285714,0.02857142857142857,0.9714285714285714,35,800,500,300,0.625,11,5,6,384.641225477022,0.3563375350140056,-0.05433255269320847,0.21330104321907603,129201.38888888907,2939.2361111111304,132140.6250000002,1165,0,616.9142857142857,34,1,17,36.05703551912568,0.6164215686274509,45.83333333333334,1016.6666666666681,29.90196078431377,0
1171,4,1,0,35,0.02857142857142857,0.0,1.0,35,750,300,450,0.4,12,3,9,385.86613685086473,0.3532212885154062,-0.05013294092072029,0.21447328608438118,129292.1786422903,2977.894699546489,132270.07334183677,1166,0,617.8857142857142,34,1,18,35.93317140739006,0.6173406862745099,45.74404761904762,1017.0238095238099,29.912464985994408,0
1172,4,2,2,35,0.05405405405405406,0.05405405405405406,0.9459459459459459,37,400,0,400,0.0,8,0,8,368.44416801681183,0.3660222722722723,-0.038875431957540396,0.20747052124356768,129803.15778193748,2165.043294984191,131968.20107692166,1167,0,585.4324324324324,36,1,15,35.8557114966663,0.6183449074074073,45.242117117117125,1019.0315315315327,28.306431431431463,0
1173,4,1,0,36,0.027777777777777776,0.0,1.0,36,950,700,250,0.7368421052631579,12,7,5,378.41941672059875,0.35844907407407406,-0.03269922392579938,0.2131786925287826,129819.89354263115,2625.273678626542,132445.1672212577,1168,0,602.6388888888889,35,1,16,35.58454003407155,0.6205357142857143,45.22569444444444,1019.0972222222221,29.117063492063487,0
1174,4,0,0,36,0.0,0.0,1.0,36,850,600,250,0.7058823529411765,11,6,5,388.8235358189285,0.358234126984127,0.038458012467913694,0.20669040588269358,127512.49999999999,2724.6829185956794,130237.18291859566,1169,1,603.6388888888889,34,2,14,37.682205720572064,0.599264705882353,47.5,1009.9999999999999,29.705882352941174,4
1175,4,3,1,38,0.07692307692307693,0.02564102564102564,0.9743589743589743,39,700,500,200,0.7142857142857143,9,5,4,368.03269639446876,0.37466261808367074,0.058216490377294594,0.19990659364950175,128379.01341735253,1652.659893689987,130031.67331104251,1170,0,558.1282051282051,35,4,13,37.319171615654035,0.605952380952381,46.64351851851852,1013.4259259259259,28.955026455026452,0
1176,4,1,1,38,0.02564102564102564,0.02564102564102564,0.9743589743589743,39,900,600,300,0.6666666666666666,12,6,6,367.83664904297,0.374746963562753,0.053589487207974296,0.20005424036469943,128429.74044568236,1648.233072599651,130077.97351828201,1171,0,559.1025641025641,36,3,13,37.27224752805245,0.6044560185185184,46.59346846846848,1013.6261261261276,28.156281281281323,0
1177,4,2,1,39,0.05,0.025,0.975,40,1000,600,400,0.6,14,6,8,368.25565190898226,0.3800480769230769,0.080841071042971,0.2027814416159928,128922.84765504797,1495.3134618344393,130418.1611168824,1172,0,546.075,37,3,14,36.75771971496437,0.6075450450450448,46.10745614035089,1015.5701754385987,27.447842579421586,0
1178,4,0,0,39,0.0,0.0,1.0,39,850,700,150,0.8235294117647058,10,7,3,364.54985213589447,0.37741790373369316,0.03414752703852253,0.20388438718250862,129536.03512619266,1644.7690635580198,131180.80418975066,1173,1,561.0769230769231,37,2,17,36.226752118339796,0.6137387387387387,45.50438596491228,1017.9824561403507,27.513039355144613,4
1179,4,0,1,38,0.0,0.02564102564102564,0.9743589743589743,39,900,600,300,0.6666666666666666,12,6,6,361.5311811708334,0.37741790373369316,0.03370941643610226,0.20248362776552234,129591.85157933214,1570.299034318257,131162.1506136504,1174,2,562.0769230769231,37,2,17,36.24676933017446,0.6143018018018017,45.449561403508774,1018.2017543859652,27.518966334755817,0
1180,4,0,0,38,0.0,0.0,1.0,38,1350,900,450,0.6666666666666666,18,9,9,365.1047389309282,0.37129563774300617,0.04268203961191275,0.20468953218551666,129631.0811444891,1865.784407718533,131496.86555220763,1175,3,577.7631578947369,36,2,18,36.115872313760185,0.6166087962962963,45.41103603603604,1018.3558558558559,28.287662662662665,0
1181,4,3,1,40,0.07317073170731707,0.024390243902439025,0.975609756097561,41,950,500,450,0.5263157894736842,14,5,9,348.2835650798389,0.3865599593495935,0.065921784858606,0.1989983621397597,130371.67302441735,882.7966869362757,131254.46971135362,1176,0,536.4146341463414,38,3,20,35.79262126442793,0.6203399122807018,44.684829059829056,1021.2606837606832,26.875281151596926,0
1182,4,0,0,40,0.0,0.0,1.0,40,850,400,450,0.47058823529411764,13,4,9,354.95552260904066,0.38064903846153847,0.0684324991945009,0.20238768346679611,130290.57167830499,1249.4715922206958,131540.04327052567,1177,1,550.825,37,3,20,35.7045206386711,0.6213400900900901,44.76425438596492,1020.9429824561414,27.593053579895713,0
1183,4,0,0,40,0.0,0.0,1.0,40,800,400,400,0.5,12,4,8,352.1383216838993,0.380715811965812,0.06509449157092217,0.2010707657781825,130346.55044100122,1180.00310191599,131526.55354291722,1178,2,551.825,37,3,20,35.71967053223093,0.621903153153153,44.70942982456141,1021.1622807017557,27.59898055950691,0
1184,4,1,1,40,0.024390243902439025,0.024390243902439025,0.975609756097561,41,1000,600,400,0.6,14,6,8,344.95362712665377,0.384984756097561,0.05706521739130421,0.19834833559782614,130617.28395061742,811.3811728395182,131428.66512345694,1179,0,539.3414634146342,38,3,16,35.62896286231883,0.6228070175438596,44.44444444444445,1022.2222222222233,26.900584795321667,0
1185,4,1,1,40,0.024390243902439025,0.024390243902439025,0.975609756097561,41,1300,1000,300,0.7692307692307693,16,10,6,343.12190216094683,0.3834095528455284,0.05441566845164969,0.19813323831658056,130781.15297866905,774.7755953685444,131555.9285740376,1180,0,540.3170731707318,38,3,16,35.510018452753975,0.6244517543859649,44.284188034188034,1022.8632478632483,26.917453891138113,0
1186,4,0,1,39,0.0,0.025,0.975,40,1350,1000,350,0.7407407407407407,17,10,7,349.4919307547849,0.38003472222222223,0.06342031936555603,0.20217664016570971,130850.90033712289,1146.2667599645988,131997.16709708748,1181,5,554.825,37,3,17,35.27656467688352,0.6269707207207207,44.21600877192982,1023.1359649122801,27.65232337600757,0
1187,4,1,0,40,0.025,0.0,1.0,40,1150,1000,150,0.8695652173913043,13,10,3,355.374100846705,0.382678952991453,0.06552811631387634,0.2090672540452877,131496.76462950124,1372.1054795706198,132868.87010907187,1182,0,555.675,37,3,18,34.47322001282873,0.633445945945946,43.585526315789465,1025.657894736841,27.72048364153624,4
1188,4,0,0,40,0.0,0.0,1.0,40,1150,900,250,0.782608695652174,14,9,5,354.8200544638824,0.3825053418803419,0.06930433853387519,0.20935725533877725,131609.25116381937,1339.520333179416,132948.7714969988,1183,1,556.675,37,3,16,34.37388687041391,0.6345720720720722,43.475877192982445,1026.096491228068,27.732337600758598,0
1189,4,0,2,38,0.0,0.05,0.95,40,900,600,300,0.6666666666666666,12,6,6,350.82940161678505,0.38146367521367525,0.06272698141422794,0.2076147192121578,131721.7857898581,1242.375057710034,132964.16084756816,1184,2,557.675,37,3,16,34.36276080609557,0.6356981981981983,43.366228070175424,1026.535087719296,27.74419155998097,0
1190,4,0,0,38,0.0,0.0,1.0,38,800,500,300,0.625,11,5,6,363.3216274513119,0.3771040777619725,0.11211066434615646,0.19939491068510687,128789.87295310374,1769.9832839710666,130559.85623707481,1185,9,580.2894736842105,35,3,17,37.01871911820601,0.6101190476190474,46.23842592592594,1015.0462962962977,29.00132275132279,7
1191,4,2,1,39,0.05,0.025,0.975,40,1250,800,450,0.64,17,8,9,347.69997003128435,0.38425480769230774,0.11930421786781809,0.19351656372720863,129344.54038075259,995.2749628538934,130339.81534360647,1186,0,552.225,36,4,19,36.850298904018594,0.6137152777777777,45.69256756756758,1017.2297297297315,28.25638138138143,0
1192,4,0,0,39,0.0,0.0,1.0,39,1050,600,450,0.5714285714285714,15,6,9,354.71192529513655,0.37975146198830406,0.12605135209278195,0.1969974068042396,129260.23046339171,1370.0290423525512,130630.25950574427,1187,1,567.3846153846154,35,4,20,36.75781546399577,0.6148809523809522,45.77546296296297,1016.8981481481487,29.05423280423282,0
1193,4,0,0,39,0.0,0.0,1.0,39,950,600,350,0.631578947368421,13,6,7,356.4269677442669,0.3798076923076923,0.1213627914236659,0.19866240922698666,129401.82317029878,1424.4598906338902,130826.28306093268,1188,2,568.3846153846154,36,3,20,36.57005165098692,0.6142939814814814,45.63626126126127,1017.4549549549558,28.262637637637663,0
1194,4,2,2,39,0.04878048780487805,0.04878048780487805,0.9512195121951219,41,1200,900,300,0.75,15,9,6,338.0384218977006,0.3878810975609756,0.11228253118746179,0.19099471048962444,129935.60209155166,584.645175871141,130520.24726742279,1189,0,541.609756097561,38,3,17,36.49599182646967,0.615953947368421,45.11217948717949,1019.5512820512824,26.83029689608638,0
1195,4,0,0,39,0.0,0.0,1.0,39,1500,1200,300,0.8,18,12,6,353.87328452021546,0.3807073774179037,0.11969780725999635,0.19868304521945088,129688.42734203818,1378.6539495576874,131067.08129159587,1190,4,570.3846153846154,36,3,18,36.34351391192188,0.6171875,45.35472972972974,1018.5810810810826,28.293918918918962,0
1196,4,1,1,39,0.025,0.025,0.975,40,1050,900,150,0.8571428571428571,12,9,3,344.098622849883,0.3841746794871795,0.10895526400688271,0.1945150816948974,129954.95158366038,943.463974492154,130898.41555815254,1191,0,557.1,37,3,18,36.3218939312471,0.6179617117117117,45.093201754385966,1019.6271929824563,27.55749170222855,0
1197,4,1,0,40,0.025,0.0,1.0,40,1050,900,150,0.8571428571428571,12,9,3,341.5571559689755,0.3872061965811966,0.08793267201350807,0.18431637869943107,128117.4894075534,751.889062385847,128869.37846993924,1192,0,558.075,38,2,19,38.256956169973265,0.5975877192982457,46.9017094017094,1012.3931623931616,26.64192532613583,8
1198,4,2,2,40,0.047619047619047616,0.047619047619047616,0.9523809523809523,42,400,200,200,0.5,6,2,4,326.89059861137184,0.39602690669763846,0.08493150684931527,0.17808219178082182,128496.33487654309,0.854472569203125,128497.18934911229,1193,0,532.452380952381,38,4,17,38.24200913242009,0.6014254385964912,46.52777777777777,1013.8888888888879,26.681286549707576,0
1199,4,1,0,41,0.024390243902439025,0.0,1.0,41,1250,600,650,0.48,19,6,13,337.0862116731566,0.3932672764227642,0.09177864653403245,0.18355118451884575,128477.80687326849,461.619440597088,128939.42631386558,1194,0,546.4146341463414,37,4,18,38.0024695363761,0.6030405405405406,46.54605263157894,1013.8157894736826,27.400426742531963,0
1200,4,0,0,41,0.0,0.0,1.0,41,950,600,350,0.631578947368421,13,6,7,336.04213407591726,0.3930640243902439,0.09269979859331667,0.18375069884576728,128644.60699445965,446.00165435516556,129090.60864881481,1195,1,547.4146341463414,37,4,18,37.85893140221934,0.6047297297297298,46.38157894736841,1014.4736842105249,27.418207681365537,0
1201,4,2,1,42,0.046511627906976744,0.023255813953488372,0.9767441860465116,43,850,500,350,0.5882352941176471,12,5,7,323.61018517074234,0.4005398671096345,0.09778218596067889,0.17873690521831387,129042.5835503473,-248.10112847221734,128794.48242187509,1196,0,522.9069767441861,39,4,19,37.76954753605358,0.6052350427350428,45.989583333333336,1016.0416666666673,26.052350427350444,0
1202,4,2,1,43,0.045454545454545456,0.022727272727272728,0.9772727272727273,44,1050,800,250,0.7619047619047619,13,8,5,321.40622199861787,0.40801180408738547,0.09686202595274906,0.17895400023024507,129360.29188368047,-484.46180555556487,128875.83007812491,1197,0,511.97727272727275,39,5,21,37.50298655198308,0.608440170940171,45.67708333333333,1017.291666666666,26.084401709401693,0
1203,4,1,1,43,0.022727272727272728,0.022727272727272728,0.9772727272727273,44,900,500,400,0.5555555555555556,13,5,8,322.31826170430173,0.40648123678646936,0.10925509055561244,0.18031003844511376,129545.80213758665,-449.00444878474104,129096.7976888019,1198,0,512.9545454545455,39,5,14,37.29162403219755,0.6103098290598292,45.49479166666666,1018.0208333333321,26.10309829059826,0
1204,4,1,0,44,0.022727272727272728,0.0,1.0,44,1050,700,350,0.6666666666666666,14,7,7,326.922188673185,0.4041688689217759,0.12188223372904883,0.1836284941433126,129704.91672091997,-319.31694878474167,129385.59977213522,1199,0,513.9090909090909,39,5,16,37.01309353376282,0.6119123931623933,45.33854166666666,1018.6458333333319,26.119123931623896,0
1205,4,1,1,44,0.022222222222222223,0.022222222222222223,0.9777777777777777,45,1400,900,500,0.6428571428571429,19,9,10,321.70818717163246,0.4073232323232323,0.12834440017706972,0.1826894909051576,130132.9400489126,-627.0335531099283,129505.90649580267,1200,0,503.46666666666664,40,5,18,36.71252490039841,0.6145833333333334,44.918699186991866,1020.3252032520318,25.508130081300795,0
1206,4,1,1,44,0.022222222222222223,0.022222222222222223,0.9777777777777777,45,600,400,200,0.6666666666666666,8,4,4,323.12782606235976,0.4030934343434343,0.1314835097967626,0.18386247915831608,130210.72035701308,-585.0586002049001,129625.66175680819,1201,0,504.35555555555555,40,5,19,36.5976301901822,0.6153645833333332,44.84247967479675,1020.6300813008135,25.515752032520336,0
1207,4,1,1,44,0.022222222222222223,0.022222222222222223,0.9777777777777777,45,800,500,300,0.625,11,5,6,321.0339404424596,0.40178872053872056,0.12910097204781157,0.1830429794074074,130289.85407991838,-634.486293315771,129655.36778660261,1202,0,505.1777777777778,38,7,20,36.57104611413422,0.619517543859649,44.764957264957275,1020.9401709401726,26.866846603688753,0
1208,4,0,1,43,0.0,0.022727272727272728,0.9772727272727273,44,1100,500,600,0.45454545454545453,17,5,12,325.69768723364245,0.39821176885130377,0.13202081509950903,0.1857020942246237,130289.85407991848,-312.9791712323393,129976.87490868615,1203,2,517.6590909090909,38,6,21,36.45201095297894,0.619517543859649,44.76495726495728,1020.9401709401734,26.866846603688774,0
1209,4,0,0,43,0.0,0.0,1.0,43,1300,900,400,0.6923076923076923,17,9,8,332.694710537276,0.39264950166112955,0.14010441385856653,0.18955861414333194,130262.58680555577,67.53472222224832,130330.12152777801,1204,3,530.4418604651163,38,5,21,36.30102040816327,0.6192434210526314,44.79166666666668,1020.8333333333351,26.864035087719344,0
1210,4,0,0,43,0.0,0.0,1.0,43,700,200,500,0.2857142857142857,12,2,10,335.4893280469627,0.3925110741971207,0.14236164001807938,0.19156420061933563,130346.55044100109,145.9753241381988,130492.52576513929,1205,4,531.4418604651163,37,6,22,36.144703640073004,0.6219031531531531,44.709429824561404,1021.1622807017544,27.598980559506877,0
1211,4,0,1,42,0.0,0.023255813953488372,0.9767441860465116,43,900,700,200,0.7777777777777778,11,7,4,337.42051242275227,0.3935262089331857,0.14815129133791416,0.19322353498726377,130458.54403518388,203.87775565558104,130662.42179083946,1206,5,532.4418604651163,37,6,22,35.982053414904634,0.6230292792792793,44.59978070175438,1021.6008771929822,27.61083451872925,0
1212,4,0,0,42,0.0,0.0,1.0,42,850,500,350,0.5882352941176471,12,5,7,340.1447907786387,0.3934741579558653,0.1275424982580724,0.18546255313602492,128530.68300118974,346.6969645793356,128877.37996576907,1207,6,534.4761904761905,40,2,15,37.87102458742565,0.5984375000000001,46.49390243902439,1014.0243902439022,25.350609756097555,7
1213,4,0,0,42,0.0,0.0,1.0,42,950,600,350,0.631578947368421,13,6,7,340.80063935486186,0.3935467479674797,0.1322597576104585,0.18606074293006136,128582.21379469898,364.18013417939414,128946.39392887837,1208,7,535.4761904761905,40,2,15,37.80185370741482,0.5989583333333333,46.44308943089431,1014.2276422764232,25.35569105691058,0
1214,4,2,1,43,0.045454545454545456,0.022727272727272728,0.9772727272727273,44,1550,1300,250,0.8387096774193549,18,13,5,329.63428910218676,0.40247313248766736,0.13524547534844977,0.1823420054907036,129102.89345592231,-288.6518989243257,128814.241556998,1209,0,512.0909090909091,42,2,17,37.555221840833966,0.601190476190476,45.930232558139544,1016.2790697674434,24.197120708748653,0
1215,4,1,0,44,0.022727272727272728,0.0,1.0,44,1300,1000,300,0.7692307692307693,16,10,6,338.96310196195014,0.4002928999295278,0.16527233542319753,0.18903711455570288,129424.43828870416,-25.790396400213922,129398.64789230394,1210,0,513.0681818181819,37,7,21,36.991289511494244,0.6126126126126126,45.614035087719294,1017.5438596491223,27.501185395922224,0
1216,4,0,0,44,0.0,0.0,1.0,44,1150,900,250,0.782608695652174,14,9,5,339.23573012764916,0.4000506518675124,0.16137759149177877,0.18959213020920906,129508.13140822163,-13.24289685289341,129494.88851136873,1211,1,514.0681818181819,37,7,15,36.899327623972134,0.6134572072072072,45.53179824561403,1017.8728070175428,27.510075865338994,0
1217,4,2,3,43,0.043478260869565216,0.06521739130434782,0.9347826086956522,46,900,500,400,0.5555555555555556,13,5,8,323.01414484564,0.403743961352657,0.15621530399253913,0.1827923975744979,129996.88042534715,-801.8337673611205,129195.04665798602,1212,0,492.67391304347825,39,7,17,36.816905005107245,0.6148504273504274,45.05208333333333,1019.791666666666,26.148504273504255,0
1218,4,3,2,44,0.06521739130434782,0.043478260869565216,0.9565217391304348,46,1150,900,250,0.782608695652174,14,9,5,326.5635150305616,0.4064210950080515,0.17101538024619067,0.1858112264964833,130209.423828125,-695.670572916666,129513.75325520833,1213,0,493.54347826086956,39,7,19,36.51127781179834,0.6169871794871795,44.84375,1020.625,26.169871794871796,0
1219,4,1,1,44,0.022222222222222223,0.022222222222222223,0.9777777777777777,45,1150,800,350,0.6956521739130435,15,8,7,333.2272589932434,0.40578703703703706,0.17370034642671373,0.18910505670057495,130107.01844346951,-328.95897365985644,129778.05946980965,1214,0,505.22222222222223,40,5,20,36.44494803599298,0.6143229166666667,44.94410569105691,1020.2235772357725,25.50558943089431,0
1220,4,1,0,45,0.022222222222222223,0.0,1.0,45,1100,900,200,0.8181818181818182,13,9,4,331.46100662897817,0.4063341750841751,0.17351610297941056,0.18860412972095347,130210.72035701304,-368.0447113160127,129842.67564569702,1215,0,506.2,40,5,21,36.38500282120217,0.6153645833333332,44.84247967479675,1020.6300813008131,25.51575203252033,0
1221,4,0,0,45,0.0,0.0,1.0,45,900,400,500,0.4444444444444444,14,4,10,333.4863062779816,0.40669191919191916,0.17680315591840223,0.1898889054233652,130237.85848957379,-313.49152695152145,129924.36696262227,1216,1,507.2,42,3,21,36.30585089551293,0.6125992063492064,44.81589147286821,1020.7364341085258,24.303248431155378,0
1222,4,0,1,44,0.0,0.022222222222222223,0.9777777777777777,45,1000,700,300,0.7,13,7,6,336.30722070698886,0.4059974747474748,0.18044405234524352,0.1920424356027063,130348.82010388775,-232.5360334955919,130116.28407039215,1217,2,508.2,36,9,21,36.12152624614027,0.6238425925925926,44.70720720720721,1021.1711711711717,28.36586586586588,0
1223,4,2,0,46,0.043478260869565216,0.0,1.0,46,800,600,200,0.75,10,6,4,327.24172203731825,0.4088365539452496,0.2035404106132639,0.18929141306540284,130848.09570312497,-636.2087673611127,130211.88693576386,1218,0,497.7391304347826,39,7,18,35.848520328514226,0.6233974358974359,44.21875,1023.1249999999998,26.233974358974354,0
1224,4,1,2,45,0.02127659574468085,0.0425531914893617,0.9574468085106383,47,1000,800,200,0.8,12,8,4,320.5486331171854,0.41057662658032684,0.20533367959586268,0.1866341533936097,131099.43000637737,-995.2513818027373,130104.17862457463,1219,0,488.1276595744681,41,6,18,35.766310665504236,0.6227134146341464,43.97321428571428,1024.1071428571413,24.97822299651564,0
1225,4,2,2,45,0.0425531914893617,0.0425531914893617,0.9574468085106383,47,1050,500,550,0.47619047619047616,16,5,11,321.0366468549333,0.4079748689485045,0.21257686791291452,0.18791392439317253,131303.29574732587,-969.3660424553783,130333.92970487049,1220,0,489.0,42,5,19,35.54843843559926,0.6232638888888888,43.77422480620155,1024.9031007751937,24.402454780361754,0
1226,4,0,0,45,0.0,0.0,1.0,45,1600,1200,400,0.75,20,12,8,332.38657022479293,0.40311447811447815,0.21115000893598634,0.19355336973585885,131104.7462310709,-284.5086120124979,130820.2376190584,1221,1,511.5777777777778,42,3,19,35.457864194026556,0.6212797619047619,43.968023255813954,1024.1279069767445,24.383997785160584,0
1227,4,0,0,45,0.0,0.0,1.0,45,1400,700,700,0.5,21,7,14,334.1691956027251,0.40286195286195287,0.21467822432361428,0.1953476640961203,131253.64428407242,-227.81505393306173,131025.82923013935,1222,2,512.5777777777778,42,3,19,35.26201733648541,0.6227678571428572,43.82267441860465,1024.7093023255811,24.397840531561457,0
1228,4,1,1,45,0.021739130434782608,0.021739130434782608,0.9782608695652174,46,1250,800,450,0.64,17,8,9,327.5401919017549,0.4051328502415459,0.22222852890352018,0.19299675922826487,131557.0192920919,-581.9154784401114,130975.10381365177,1223,0,502.4130434782609,41,5,16,35.12625713180543,0.6272865853658536,43.526785714285715,1025.8928571428576,25.02177700348433,0
1229,4,0,0,45,0.0,0.0,1.0,45,1350,1000,350,0.7407407407407407,17,10,7,332.7355237537473,0.40366161616161617,0.2129169280204244,0.1963547973899232,131614.73954202188,-241.42014095446194,131373.31940106742,1224,1,487.93333333333334,40,5,16,34.93488164801427,0.6294270833333333,43.47052845528455,1026.1178861788615,25.652947154471537,0
1230,4,0,1,44,0.0,0.022222222222222223,0.9777777777777777,45,850,600,250,0.7058823529411765,11,6,5,337.1163665118946,0.4039562289562289,0.21670800184666228,0.19970333583466482,131760.6481973576,-116.26580609096197,131644.38239126664,1225,2,488.93333333333334,41,4,17,34.675552388314486,0.6293191056910569,43.32837301587301,1026.6865079365075,25.041134339914816,0
1231,4,1,0,45,0.022222222222222223,0.0,1.0,45,1400,1000,400,0.7142857142857143,18,10,8,337.3995617238863,0.40446127946127947,0.2215015015015016,0.20135135135135138,132040.89506172825,-89.89197530865226,131951.0030864196,1226,0,488.64444444444445,41,4,18,34.386261261261254,0.6321138211382114,43.05555555555555,1027.7777777777767,25.067750677506748,0
1232,4,0,0,45,0.0,0.0,1.0,45,1200,900,300,0.75,15,9,6,336.6945313327418,0.40418771043771046,0.2199837042754833,0.20147240893374904,132142.87682665652,-101.64320357773641,132041.2336230788,1227,1,489.64444444444445,41,4,18,34.30183005274667,0.633130081300813,42.9563492063492,1028.1746031746027,25.077429345722017,0
1233,4,0,1,44,0.0,0.022222222222222223,0.9777777777777777,45,1150,1000,150,0.8695652173913043,13,10,3,341.3054587167828,0.40364057239057244,0.21998521518336456,0.20519877752763765,132321.43964356557,32.40593112243465,132353.845574688,1228,2,490.64444444444445,41,4,19,34.00377253881016,0.634908536585366,42.78273809523809,1028.8690476190461,25.094367015098687,0
1234,4,0,0,44,0.0,0.0,1.0,44,1550,1200,350,0.7741935483870968,19,12,7,352.2750138503811,0.40077739605355883,0.2246013074243023,0.21178338718653544,132319.57250974944,522.5758477096906,132842.14835745914,1229,3,502.5681818181818,40,4,19,33.723495324641114,0.6364583333333333,42.78455284552845,1028.8617886178856,25.72154471544714,0
1235,4,1,1,44,0.022222222222222223,0.022222222222222223,0.9777777777777777,45,1100,700,400,0.6363636363636364,15,7,8,347.0480193515149,0.40298821548821545,0.23158768018251608,0.21060944308411944,132673.03040990932,208.85219799293486,132881.88260790225,1230,0,492.3777777777778,38,7,18,33.50271354004632,0.6433662280701755,42.44123931623931,1030.235042735042,27.11144849302742,0
1236,4,0,0,44,0.0,0.0,1.0,44,1200,800,400,0.6666666666666666,16,8,8,354.48259961859645,0.40183447850599013,0.24035270211427795,0.21500090532063984,132652.03145438974,604.5673909279733,133256.59884531773,1231,1,503.5681818181818,37,7,18,33.33233546212526,0.6449887387387387,42.46162280701754,1030.1535087719292,27.841986723565654,0
1237,4,0,0,44,0.0,0.0,1.0,44,1100,600,500,0.5454545454545454,16,6,10,351.1771364756521,0.4015922304439747,0.2324159243246382,0.21363844050062486,132765.0109288435,524.807272429981,133289.81820127348,1232,2,504.5681818181818,37,7,19,33.3039640741923,0.6461148648648649,42.35197368421053,1030.592105263158,27.853840682788054,0
1238,4,0,0,44,0.0,0.0,1.0,44,1100,700,400,0.6363636363636364,15,7,8,351.6673199280518,0.4010967230443974,0.22926990108337297,0.21451261929871687,132865.7190536197,544.9062659799889,133410.62531959967,1233,3,505.5681818181818,38,6,19,33.190198618307434,0.6452850877192982,42.254273504273506,1030.982905982906,27.131129104813315,0
1239,4,0,0,44,0.0,0.0,1.0,44,1750,1400,350,0.8,21,14,7,347.8014278737628,0.4013940274841437,0.22132903347300004,0.21293739924674573,133003.43940618378,451.75722751844205,133455.19663370223,1234,4,506.5681818181818,38,6,19,33.151648541343,0.6466557017543859,42.120726495726494,1031.517094017094,27.14518668466037,0
1240,4,0,0,44,0.0,0.0,1.0,44,900,400,500,0.4444444444444444,14,4,10,349.19001755279004,0.40126189217758984,0.22357151596720914,0.21441998598489478,133113.66705246904,496.39274691357423,133610.0597993826,1235,5,507.5681818181818,38,6,19,33.005271422162394,0.6477521929824561,42.013888888888886,1031.944444444444,27.156432748538,0
1241,4,1,0,45,0.022222222222222223,0.0,1.0,45,1350,1100,250,0.8148148148148148,16,11,5,344.6069415812399,0.40437710437710433,0.2369914529914534,0.2138196461094919,133500.54974848012,202.00773582040733,133702.55748430052,1236,0,497.26666666666665,37,8,21,32.73596374889479,0.6534346846846848,41.639254385964904,1033.442982456139,27.930891417733484,0
1242,4,1,1,45,0.021739130434782608,0.021739130434782608,0.9782608695652174,46,1150,800,350,0.6956521739130435,15,8,7,335.3468101819721,0.406652576489533,0.23583848430194898,0.20973957926494624,133795.33420138882,-226.43229166667106,133568.90190972216,1237,0,487.4347826086956,39,7,15,32.68056114914753,0.6527777777777778,41.354166666666664,1034.5833333333328,26.527777777777764,0
1243,4,0,0,45,0.0,0.0,1.0,45,900,700,200,0.7777777777777778,11,7,4,338.2762942322435,0.40366161616161617,0.2302241503976865,0.2111446037693325,133720.73522764613,46.91095496382499,133767.64618260995,1238,2,499.26666666666665,38,7,15,32.679346141927496,0.6537828947368423,41.426282051282044,1034.2948717948707,27.21828609986502,0
1244,4,0,1,44,0.0,0.022222222222222223,0.9777777777777777,45,1200,700,500,0.5833333333333334,17,7,10,337.28650639002933,0.40317760942760944,0.22811510395153567,0.21100016329980878,133803.6242603549,26.03139381984309,133829.65565417474,1239,3,500.26666666666665,38,7,16,32.62210863279638,0.6546052631578948,41.34615384615384,1034.6153846153834,27.22672064777325,0
1245,4,0,0,44,0.0,0.0,1.0,44,1300,1000,300,0.7692307692307693,16,10,6,344.4089059243577,0.39850907329105006,0.23454005705914094,0.2148455556004326,133698.92659279777,409.42020621729455,134108.34679901507,1240,10,512.5681818181819,37,7,20,32.54258552445576,0.6554054054054055,41.44736842105263,1034.2105263157891,27.951635846372678,0
1246,4,0,0,44,0.0,0.0,1.0,44,1200,800,400,0.6666666666666666,16,8,8,346.46014058708886,0.3983218816067653,0.24401774446809954,0.21695715638489416,133840.71451071478,474.0945531317235,134314.8090638465,1241,11,513.5681818181819,37,7,18,32.347740277630606,0.6568130630630631,41.310307017543856,1034.758771929824,27.966453295400648,0
1247,4,0,0,44,0.0,0.0,1.0,44,1300,1200,100,0.9230769230769231,14,12,2,343.19573330351216,0.3982888477801268,0.23773083852563603,0.21534198602619323,133914.18292059307,391.75524143471375,134305.93816202777,1242,12,514.5681818181819,38,6,18,32.35875997797963,0.655701754385965,41.23931623931623,1035.0427350427342,27.2379667116509,0
1248,4,0,0,44,0.0,0.0,1.0,44,1150,900,250,0.782608695652174,14,9,5,340.86279190226986,0.39877334390415786,0.23252072937380408,0.21452221942316851,134024.78723792807,336.8126324055622,134361.59987033362,1243,13,515.5681818181819,38,6,18,32.30864802586326,0.6567982456140352,41.13247863247862,1035.470085470084,27.24921277552853,0
1249,4,0,0,44,0.0,0.0,1.0,44,1100,800,300,0.7272727272727273,14,8,6,339.69224744694657,0.39821176885130377,0.2292071129118487,0.213946520760445,134052.44545118322,307.3152942143088,134359.76074539754,1244,14,516.5681818181819,38,6,18,32.31133292066439,0.6570723684210528,41.10576923076922,1035.5769230769213,27.25202429149793,0
1250,4,0,0,44,0.0,0.0,1.0,44,1450,1200,250,0.8275862068965517,17,12,5,342.0469130823591,0.3980355884425652,0.22839069252908573,0.21608005968466676,134163.10683988963,378.01530882459224,134541.12214871423,1245,15,517.5681818181819,38,6,19,32.13988003162488,0.6581688596491229,40.99893162393162,1036.004273504273,27.263270355375607,0
1251,4,0,0,44,0.0,0.0,1.0,44,1050,700,350,0.6666666666666666,14,7,7,338.1199929218548,0.39810165609584214,0.22282379511015749,0.21424572510352125,134273.81388569268,280.1322001241573,134553.94608581683,1246,16,518.5681818181819,38,6,19,32.13113768340031,0.6592653508771931,40.892094017094,1036.4316239316222,27.274516419253217,0
1252,4,0,1,43,0.0,0.022727272727272728,0.9772727272727273,44,950,500,450,0.5263157894736842,14,5,9,339.4867764356036,0.3975951374207188,0.22330179114565785,0.21562934817253082,134361.7201063366,322.8054470485919,134684.5255533852,1247,17,519.5681818181819,39,5,20,32.00804196389699,0.6583867521367522,40.80729166666666,1036.7708333333317,26.583867521367477,0
1253,4,0,0,43,0.0,0.0,1.0,43,850,800,50,0.9411764705882353,9,8,1,345.70757754594496,0.39830195644149136,0.21899324630271644,0.22005137411399908,134439.96006145436,695.3825836437895,135135.34264509814,1248,18,506.5581395348837,38,5,20,31.768740771264735,0.6609100877192983,40.7318376068376,1037.0726495726487,27.291385515069702,0
1254,4,0,0,43,0.0,0.0,1.0,43,1650,1300,350,0.7878787878787878,20,13,7,347.54286403777144,0.3980712440014766,0.22101192745493115,0.22244231704687373,134640.85708429807,758.8307888062759,135399.68787310435,1249,19,507.5581395348837,35,8,21,31.52078454332553,0.6687499999999998,40.53819444444446,1037.847222222224,29.65277777777783,0
1255,4,0,0,43,0.0,0.0,1.0,43,1150,600,550,0.5217391304347826,17,6,11,354.1473474555545,0.39777131782945735,0.2351317106359485,0.22126000502620496,133755.63274276673,877.4875475840587,134633.12029035078,1250,20,508.5581395348837,37,6,18,32.234029397215735,0.6559684684684686,41.39254385964911,1034.4298245614013,27.95756282598382,2
1256,4,0,0,43,0.0,0.0,1.0,43,1250,900,350,0.72,16,9,7,354.1548774814616,0.39710225175341457,0.23510570936515252,0.22211746767757581,133897.45071800935,884.0870508233281,134781.53776883267,1251,21,509.5581395348837,37,6,19,32.0919191651658,0.6573761261261262,41.25548245614035,1034.9780701754382,27.972380275011844,0
1257,4,0,0,43,0.0,0.0,1.0,43,1200,800,400,0.6666666666666666,16,8,8,356.38669532863247,0.39694075304540416,0.23340541765392664,0.22403483204347177,133982.5775719451,949.9216104955251,134932.4991824406,1252,22,510.5581395348837,37,6,19,31.949004448210136,0.6582207207207207,41.17324561403508,1035.3070175438586,27.98127074442861,0
1258,4,0,0,43,0.0,0.0,1.0,43,1150,800,350,0.6956521739130435,15,8,7,354.15638554031045,0.3965254706533776,0.22743922184775256,0.22339272334504265,134107.77043839925,899.0246502666209,135006.79508866588,1253,23,511.5581395348837,38,5,19,31.881554065669608,0.6576206140350878,41.05235042735042,1035.7905982905968,27.257647323436757,0
1259,4,1,1,43,0.022727272727272728,0.022727272727272728,0.9772727272727273,44,1200,800,400,0.6666666666666666,16,8,8,349.1776566379617,0.3988834566596195,0.22105486696564758,0.22178463411088917,134361.72010633675,583.222113715273,134944.94222005203,1254,0,500.90909090909093,39,5,19,31.756861415318667,0.6583867521367521,40.807291666666664,1036.770833333333,26.583867521367512,0
1260,4,1,0,44,0.022727272727272728,0.0,1.0,44,1450,700,750,0.4827586206896552,22,7,15,350.0631705991281,0.3973969344608879,0.22844367142348476,0.22300569351602811,134469.73876953125,614.5806206597226,135084.31939019097,1255,0,501.8863636363636,39,5,20,31.626096381105413,0.6594551282051282,40.703125,1037.1875,26.59455128205128,0
1261,4,0,0,44,0.0,0.0,1.0,44,650,400,250,0.6153846153846154,9,4,5,350.0631705991281,0.39747401338971106,0.22844367142348476,0.22300569351602811,134469.73876953125,614.5806206597226,135084.31939019097,1256,1,502.8863636363636,39,5,20,31.626096381105413,0.6594551282051282,40.703125,1037.1875,26.59455128205128,0
1262,4,0,0,44,0.0,0.0,1.0,44,1250,800,450,0.64,17,8,9,347.4802539396333,0.3971216525722339,0.22922530813791542,0.22202603936737006,134579.22299409437,552.7733443222933,135131.99633841665,1257,2,503.8863636363636,37,7,20,31.583866110113078,0.6641328828828829,40.59758771929825,1037.6096491228072,28.043504030346142,0
1263,4,0,0,44,0.0,0.0,1.0,44,1250,900,350,0.72,16,9,7,351.5610148209897,0.39663715644820297,0.23545972983611607,0.22569025419253913,134749.93657904354,674.5648901585093,135424.50146920205,1258,3,504.8863636363636,37,7,21,31.307754250712836,0.665822072072072,40.43311403508772,1038.267543859649,28.061284969179706,0
1264,4,0,0,44,0.0,0.0,1.0,44,1150,800,350,0.6956521739130435,15,8,7,352.3534157573958,0.3968683932346723,0.23301213144963118,0.22673176318301996,134835.3339489074,701.9380963373403,135537.27204524475,1259,4,505.8863636363636,37,7,18,31.202051661036027,0.6666666666666666,40.35087719298246,1038.5964912280706,28.070175438596504,0
1265,4,0,1,43,0.0,0.022727272727272728,0.9772727272727273,44,750,400,350,0.5333333333333333,11,4,7,355.5345208626643,0.39602052501761803,0.23883900735752572,0.22967966286404018,134977.72301333104,797.8480157356128,135775.57102906666,1260,5,506.8863636363636,37,7,19,30.97752013647075,0.6680743243243243,40.213815789473685,1039.1447368421054,28.08499288762447,0
1266,4,0,0,43,0.0,0.0,1.0,43,1050,600,450,0.5714285714285714,15,6,9,358.3640442236822,0.39467977113325947,0.23921106858993246,0.23205540568582692,135063.19252077554,1080.3583795013785,136143.55090027692,1261,6,509.09302325581393,37,6,19,30.818829113924043,0.668918918918919,40.13157894736842,1039.4736842105258,28.09388335704124,0
1267,4,0,0,43,0.0,0.0,1.0,43,1150,700,450,0.6086956521739131,16,7,9,357.07430133855587,0.3942875599852344,0.2372503954013978,0.23202678566285073,135188.8891171744,1054.4956260501167,136243.3847432245,1262,7,510.09302325581393,38,5,20,30.72713341551949,0.6683114035087719,40.01068376068376,1039.9572649572654,27.367296446243824,0
1268,4,0,0,43,0.0,0.0,1.0,43,900,500,400,0.5555555555555556,13,5,8,359.1639327548851,0.3937799926172019,0.24453478817526886,0.23374465570197592,135244.44809701215,1114.9855723573608,136359.43366936952,1263,8,511.09302325581393,38,5,20,30.617467817036427,0.668859649122807,39.957264957264954,1040.1709401709397,27.372919478182624,0
1269,4,0,0,43,0.0,0.0,1.0,43,1300,900,400,0.6923076923076923,17,9,8,358.77276597008756,0.3933185677371724,0.2448972940001446,0.2340810685352843,135335.45057508672,1110.9347873263841,136446.3853624131,1264,9,512.0930232558139,39,4,21,30.537028231054155,0.6680021367521367,39.869791666666664,1040.5208333333328,26.680021367521356,0
1270,4,0,0,43,0.0,0.0,1.0,43,1150,800,350,0.6956521739130435,15,8,7,357.99250788599943,0.3932954964931709,0.2417632820624609,0.23413532987026858,135422.04231112433,1096.0153100006671,136518.057621125,1265,10,513.0930232558139,40,3,21,30.471140076807927,0.6671875,39.78658536585366,1040.8536585365855,26.021341463414636,0
1271,4,0,0,43,0.0,0.0,1.0,43,1150,800,350,0.6956521739130435,15,8,7,363.8648527884929,0.3934339239571798,0.2465579307182837,0.23867857116971156,135527.8407776455,1262.7635666600486,136790.60434430555,1266,11,514.0930232558139,40,3,21,30.213009955104425,0.6682291666666667,39.68495934959349,1041.2601626016253,26.031504065040632,0
1272,4,0,0,43,0.0,0.0,1.0,43,1450,1200,250,0.8275862068965517,17,12,5,367.705531892067,0.3924649317091178,0.2476846499934895,0.242121227207485,135664.68431122438,1377.1788490579565,137041.86316028234,1267,12,515.0930232558139,34,9,21,29.976812173846795,0.6810661764705883,39.55357142857142,1041.7857142857135,30.640756302520987,0
1273,4,0,0,43,0.0,0.0,1.0,43,1100,900,200,0.8181818181818182,13,9,4,368.04533469839333,0.3921650055370986,0.2497144162668492,0.24297653544115663,135757.71683673473,1392.9988662131545,137150.7157029479,1268,13,516.0930232558139,34,9,21,29.87539029776864,0.6819852941176471,39.464285714285715,1042.1428571428576,30.651260504201694,0
1274,4,0,0,43,0.0,0.0,1.0,43,1000,800,200,0.8,12,8,4,369.34090955711923,0.39202657807308966,0.21504293230582672,0.24533315165553904,135976.55047706983,1444.340566328101,137420.89104339795,1269,14,517.0930232558139,37,6,19,29.6239837398374,0.6779279279279279,39.25438596491228,1042.9824561403507,28.188715030820287,3
1275,4,0,0,43,0.0,0.0,1.0,43,1050,800,250,0.7619047619047619,13,8,5,368.91121672855087,0.39202657807308966,0.21649368617117482,0.2454420500668136,136033.73754424442,1436.8743267159161,137470.61187096033,1270,15,518.0930232558139,37,6,19,29.57834069091164,0.6784909909909909,39.199561403508774,1043.2017543859652,28.19464201043149,0
1276,4,0,0,43,0.0,0.0,1.0,43,1050,700,350,0.6666666666666666,14,7,7,365.0803792162346,0.3912421557770395,0.21530808211613706,0.24367707218654425,136148.1477473838,1341.0034818405638,137489.15122922437,1271,16,519.0930232558139,37,6,19,29.564596904111504,0.679617117117117,39.08991228070175,1043.640350877193,28.206495969653865,0
1277,4,0,0,43,0.0,0.0,1.0,43,1250,900,350,0.72,16,9,7,365.50561401030996,0.3915651531930602,0.2119308188391631,0.24435487678217355,136205.37088334875,1356.7655432440768,137562.13642659283,1272,17,520.0930232558139,37,6,19,29.49667366946779,0.6801801801801801,39.03508771929825,1043.8596491228072,28.21242294926506,0
1278,4,0,0,43,0.0,0.0,1.0,43,450,200,250,0.4444444444444444,7,2,5,365.22729356930057,0.39151901070505724,0.21312007972584435,0.2443660619868806,136233.98695993004,1351.2740699061292,137585.26102983617,1273,18,521.0930232558139,37,6,19,29.4755234044043,0.6804617117117118,39.00767543859649,1043.9692982456145,28.215386439070663,0
1279,4,0,0,43,0.0,0.0,1.0,43,600,300,300,0.5,9,3,6,363.6663870987408,0.3915420819490587,0.20892620760735214,0.24351837819649869,136262.60604224383,1310.825927208378,137573.4319694522,1274,19,522.0930232558139,37,6,19,29.487852692011483,0.6807432432432432,38.98026315789474,1044.0789473684215,28.218349928876258,0
1280,4,0,0,43,0.0,0.0,1.0,43,950,700,250,0.7368421052631579,12,7,5,363.6973751926827,0.3909422296050203,0.2094902858705121,0.24452680970082508,136405.74653980086,1322.0823955448,137727.82893534566,1275,20,523.0930232558139,37,6,19,29.344997550820473,0.6821509009009008,38.84320175438597,1044.6271929824575,28.233167377904255,0
1281,4,0,0,43,0.0,0.0,1.0,43,1500,1100,400,0.7333333333333333,19,11,8,362.02283835548866,0.3903654485049834,0.2091607896727592,0.24399417606278703,136491.66690712533,1282.6201331178909,137774.28704024322,1276,21,524.0930232558139,37,6,19,29.303515215110192,0.6829954954954954,38.760964912280706,1044.9561403508776,28.242057847321018,0
1282,4,0,0,43,0.0,0.0,1.0,43,1450,900,550,0.6206896551724138,20,9,11,361.22645580718586,0.38999630860095974,0.21291035546046921,0.24405186415378471,136577.61432604262,1267.0895131194206,137844.70383916204,1277,22,525.0930232558139,37,6,19,29.239112381551813,0.6838400900900901,38.67872807017544,1045.2850877192982,28.250948316737787,0
1283,4,0,0,43,0.0,0.0,1.0,43,1200,1000,200,0.8333333333333334,14,10,4,360.78792400120625,0.3880813953488372,0.22014268507365853,0.24475072682244,136720.92013888896,1265.4513888888976,137986.37152777787,1278,23,526.0930232558139,38,5,20,29.108565737051798,0.6833881578947367,38.54166666666667,1045.833333333334,27.52192982456142,0
1284,4,0,0,43,0.0,0.0,1.0,43,1350,900,450,0.6666666666666666,18,9,9,357.8842829924562,0.38743540051679587,0.2139944377143439,0.2433766175360672,136806.93969538694,1192.210704255142,137999.1503996421,1279,24,527.0930232558139,37,6,20,29.099303881493896,0.6860923423423424,38.4594298245614,1046.1622807017536,28.27465623518253,0
1285,4,0,0,43,0.0,0.0,1.0,43,1500,1300,200,0.8666666666666667,17,13,4,357.428713379202,0.38729697305278704,0.21571217579075097,0.2432656763954597,136835.61889235143,1181.7958410279969,138017.4147333794,1280,25,528.0930232558139,37,6,20,29.08282680081044,0.6863738738738739,38.432017543859644,1046.2719298245609,28.27761972498813,0
1286,4,0,1,42,0.0,0.023255813953488372,0.9767441860465116,43,750,400,350,0.5333333333333333,11,4,7,323.14056021309875,0.38674326319675156,0.1680585377668271,0.21035734252203414,135254.17209201396,144.6964150027031,135398.86850701665,1281,26,529.0930232558139,39,4,21,31.544579077375,0.6672008547008547,39.94791666666667,1040.208333333334,26.672008547008563,7
1287,4,0,0,42,0.0,0.0,1.0,42,1100,800,300,0.7272727272727273,14,8,6,347.44254504956666,0.38524728997289975,0.13069970097353822,0.2021302023119454,131068.54056336729,731.4879306037324,131800.028493971,1282,27,540.1904761904761,36,6,22,35.108966604347664,0.631076388888889,44.00337837837837,1023.9864864864855,28.444069069069045,8
1288,4,0,0,42,0.0,0.0,1.0,42,1000,800,200,0.8,12,8,4,349.56261321096474,0.3852593883081688,0.12909994767137656,0.20443571852312203,131270.4173768363,777.4460271081848,132047.86340394447,1283,28,541.1904761904761,36,6,22,34.850732600732584,0.6331018518518519,43.806306306306304,1024.7747747747746,28.465965965965964,0
1289,4,1,1,42,0.023255813953488372,0.023255813953488372,0.9767441860465116,43,1150,1000,150,0.8695652173913043,13,10,3,341.4881921970434,0.3866509782207457,0.11641698037072423,0.20061880504169521,131443.5782911289,377.32403011118686,131820.9023212401,1284,0,529.5813953488372,36,7,22,34.88290687458819,0.634837962962963,43.637387387387385,1025.45045045045,28.484734734734722,2
1290,4,0,0,42,0.0,0.0,1.0,42,1050,500,550,0.47619047619047616,16,5,11,350.4570359838725,0.3846423732094464,0.11817663725759053,0.20542673512304144,131357.78523930462,807.0520136745432,132164.83725297917,1285,30,543.1904761904761,35,7,22,34.739589213804535,0.6360119047619048,43.72106481481481,1025.11574074074,29.289021164021143,0
1291,4,1,1,42,0.023255813953488372,0.023255813953488372,0.9767441860465116,43,1350,900,450,0.6666666666666666,18,9,9,340.1587558875491,0.3895118124769288,0.1279796750767157,0.2015092512947877,131761.33639974432,363.9544527635728,132125.2908525079,1286,0,531.5348837209302,36,7,22,34.59676977075792,0.6380208333333335,43.3277027027027,1026.6891891891892,28.519144144144143,0
1292,4,0,0,42,0.0,0.0,1.0,42,1150,900,250,0.782608695652174,14,9,5,337.68996229609127,0.39023180410375535,0.12818504594820368,0.20050341511330408,131848.0642804967,504.75357113870393,132352.81785163542,1287,1,535.0952380952381,36,6,22,34.57282529239766,0.638888888888889,43.24324324324324,1027.0270270270269,28.528528528528525,0
1293,4,0,0,42,0.0,0.0,1.0,42,700,400,300,0.5714285714285714,10,4,6,341.39261507831037,0.39009872241579563,0.12841692634524038,0.20316535077360878,131934.82069485015,608.3146913805667,132543.13538623072,1288,2,536.0952380952381,36,6,22,34.390414337389025,0.6397569444444444,43.15878378378378,1027.364864864864,28.53791291291289,0
1294,4,0,0,42,0.0,0.0,1.0,42,800,500,300,0.625,11,5,6,341.07244135860384,0.38928813395276807,0.1262544031311157,0.2032845217111208,131992.67415641982,603.8127231961558,132596.486879616,1289,3,537.0952380952381,36,6,22,34.3404109589041,0.6403356481481483,43.10247747747747,1027.5900900900892,28.544169169169145,0
1295,4,0,0,42,0.0,0.0,1.0,42,1050,800,250,0.7619047619047619,13,8,5,344.00972201190467,0.38876790553619817,0.13443645376239255,0.20570377254997552,132116.0357032932,689.8401431209442,132805.87584641413,1290,4,538.0952380952381,37,5,22,34.14080275881682,0.6396396396396398,42.98245614035087,1028.0701754385955,27.785680417259336,0
1296,4,1,1,42,0.023255813953488372,0.023255813953488372,0.9767441860465116,43,700,400,300,0.5714285714285714,10,4,6,337.8327613192186,0.39320321151716503,0.13144569498204683,0.2032271907723542,132343.03232750733,341.96241051207346,132684.9947380194,1291,0,526.5581395348837,38,5,22,34.07140137749629,0.640076754385965,42.76175213675213,1028.9529914529903,27.077710301394482,0
1297,4,0,0,42,0.0,0.0,1.0,42,850,500,350,0.5882352941176471,12,5,7,344.02368869774494,0.38760646535036775,0.13800027696994888,0.20650000466221216,132260.59701219943,700.1556907005449,132960.75270289998,1292,6,540.0952380952381,38,4,22,33.9950318515441,0.6392543859649124,42.841880341880334,1028.6324786324774,27.06927575348625,0
1298,4,0,0,42,0.0,0.0,1.0,42,1000,700,300,0.7,13,7,6,344.0457463752776,0.3874491869918699,0.13470963211330922,0.20666353660932904,132288.07259706676,702.6297346409308,132990.7023317077,1293,7,541.0952380952381,38,4,23,33.96683629314226,0.63952850877193,42.81517094017093,1028.7393162393143,27.07208726945564,0
1299,4,0,0,42,0.0,0.0,1.0,42,1000,400,600,0.4,16,4,12,344.8304377711758,0.38668699186991873,0.13887059377894873,0.20790353105756387,132427.7842747986,733.1631361999489,133160.94741099857,1294,8,542.0952380952381,35,7,24,33.80620056973649,0.6467261904761905,42.67939814814815,1029.282407407408,29.408068783068803,0
1300,4,0,0,42,0.0,0.0,1.0,42,1200,1000,200,0.8333333333333334,14,10,4,344.20532500229893,0.3861788617886179,0.13981652140410072,0.2084835697000681,132600.90115453303,728.387255498757,133329.2884100318,1295,9,543.0952380952381,36,6,24,33.64836176106131,0.646412037037037,42.51126126126127,1029.9549549549558,28.609859859859885,0
1301,4,0,0,42,0.0,0.0,1.0,42,1200,800,400,0.6666666666666666,16,8,8,343.68524015894,0.38665069686411146,0.13710180187029586,0.20845208723649072,132652.03145438977,718.1090575946396,133370.1405119844,1296,10,544.0952380952381,37,5,20,33.61040890544617,0.6449887387387387,42.46162280701754,1030.1535087719294,27.84198672356566,0
1302,4,0,0,42,0.0,0.0,1.0,42,950,800,150,0.8421052631578947,11,8,3,344.9657651812995,0.3863845334881921,0.1342265387908539,0.20985975578893448,132765.01092884367,759.87671687444,133524.88764571812,1297,11,545.0952380952381,37,5,21,33.46399882966272,0.6461148648648647,42.351973684210535,1030.5921052631593,27.85384068278809,0
1303,4,0,0,42,0.0,0.0,1.0,42,900,600,300,0.6666666666666666,12,6,6,347.9555848595171,0.3861546651180798,0.13240850477608634,0.21215813286959692,132849.77709487555,845.1643775007933,133694.94147237635,1298,12,546.0952380952381,37,5,21,33.30186839679501,0.6469594594594594,42.269736842105274,1030.9210526315806,27.86273115220488,0
1304,4,0,0,42,0.0,0.0,1.0,42,1000,800,200,0.8,12,8,4,347.3082919954296,0.38611837011227257,0.16070753851302522,0.19818588305198426,130321.66950660138,655.2688383581352,130976.93834495952,1299,13,547.0952380952381,35,7,19,35.86818937504723,0.6255952380952381,44.73379629629629,1021.0648148148139,29.173280423280396,7
1305,4,0,0,42,0.0,0.0,1.0,42,1000,700,300,0.7,13,7,6,350.33630830842077,0.387461285327139,0.17035580797048722,0.2009824084506202,130528.56445312487,745.7790798610977,131274.34353298598,1300,14,548.0952380952381,35,7,17,35.581252123683335,0.6276785714285715,44.53124999999999,1021.874999999999,29.19642857142854,0
1306,4,0,0,42,0.0,0.0,1.0,42,1100,700,400,0.6363636363636364,15,7,8,344.877436639621,0.3873161053039102,0.1621551051172312,0.2002915907470415,131002.0834003127,638.373949759919,131640.45735007263,1301,15,549.0952380952381,35,7,17,35.24177972489165,0.6324404761904763,44.068287037037024,1023.7268518518499,29.24933862433857,2
1307,4,1,0,43,0.023255813953488372,0.0,1.0,43,850,700,150,0.8235294117647058,10,7,3,336.8590788918651,0.3905500184569952,0.1625453076832628,0.19671013477266927,131212.72243527306,240.03936368800382,131452.76179896106,1302,0,537.3023255813954,36,7,18,35.234392174104194,0.6325231481481483,43.86261261261261,1024.549549549549,28.459709709709696,0
1308,4,0,0,43,0.0,0.0,1.0,43,900,600,300,0.6666666666666666,12,6,6,338.4215545691537,0.39059616094499816,0.1625121084095622,0.1977712090574648,131241.5683208545,282.9951150474658,131524.56343590198,1303,1,538.3023255813954,36,7,18,35.16526541378174,0.6328125000000002,43.83445945945945,1024.6621621621612,28.46283783783781,0
1309,4,1,1,43,0.022727272727272728,0.022727272727272728,0.9772727272727273,44,1050,700,350,0.6666666666666666,14,7,7,335.11908247660915,0.3930364693446089,0.16460084543996856,0.19729635094831194,131524.88175448205,15.299539281302515,131540.18129376334,1304,0,527.0454545454545,37,7,18,34.964257081774434,0.6337274774774775,43.55811403508771,1025.7675438596484,27.72344713134185,0
1310,4,0,0,43,0.0,0.0,1.0,43,1300,1000,300,0.7692307692307693,16,10,6,340.0781231134212,0.3906653746770026,0.17126544253685316,0.19977453563798445,131440.5393967373,340.0103878116141,131780.5497845489,1305,3,540.3023255813954,37,6,18,34.922120045623025,0.632882882882883,43.64035087719297,1025.438596491227,27.71455666192505,0
1311,4,1,2,42,0.022727272727272728,0.045454545454545456,0.9545454545454546,44,1000,700,300,0.7,13,7,6,329.3592445630182,0.39347692036645526,0.16561077623323905,0.19471718538565624,131684.26890432084,-125.713734567915,131558.55516975292,1306,0,529.0,38,6,15,34.951511050969785,0.6334978070175439,43.40277777777777,1026.3888888888878,27.010233918128627,0
1312,4,0,0,42,0.0,0.0,1.0,42,1300,800,500,0.6153846153846154,18,8,10,348.07966819480805,0.38950590398761126,0.1815776815776815,0.20480036291461962,131501.32395909424,754.5874421719008,132255.91140126614,1307,5,553.1428571428571,36,6,19,34.65565985946419,0.6354166666666667,43.58108108108108,1025.6756756756758,28.490990990990994,0
1313,4,2,1,43,0.045454545454545456,0.022727272727272728,0.9772727272727273,44,1400,1000,400,0.7142857142857143,18,10,8,341.83838020829575,0.3955470401691332,0.1844577138679011,0.1968896167660505,130682.67549871115,149.1307529536227,130831.80625166478,1308,0,528.9545454545455,37,7,17,35.64242627345844,0.6252815315315314,44.38048245614035,1022.4780701754387,27.63454243717402,3
1314,4,0,0,43,0.0,0.0,1.0,43,850,400,450,0.47058823529411764,13,4,9,349.0490175989802,0.39327242524916944,0.1799987186879366,0.200355460766018,130550.14209733382,513.6797692963265,131063.82186663015,1309,1,542.2558139534884,36,7,18,35.59228650137741,0.6258680555555556,44.51013513513514,1021.9594594594595,28.387762762762762,0
1315,4,0,0,43,0.0,0.0,1.0,43,900,600,300,0.6666666666666666,12,6,6,337.3593177255062,0.393687707641196,0.11881425291945269,0.19360768726611552,130542.57079101252,207.95052323790563,130750.52131425042,1310,2,543.2558139534884,37,6,15,35.898605150214586,0.6238738738738739,44.517543859649116,1021.9298245614027,27.619724988146018,8
1316,4,0,0,43,0.0,0.0,1.0,43,1150,600,550,0.5217391304347826,17,6,11,340.0733316491129,0.393687707641196,0.09962619898999758,0.1872035522443369,128910.32036675372,180.88539712943003,129091.20576388315,1311,3,544.2558139534884,39,4,18,37.48600283789789,0.6038995726495726,46.11979166666668,1015.5208333333353,26.038995726495777,5
1317,4,2,1,44,0.044444444444444446,0.022222222222222223,0.9777777777777777,45,1000,700,300,0.7,13,7,6,324.08653901557705,0.40031565656565654,0.10981462527010133,0.18093288492469672,129466.28146701412,-607.6877170138638,128858.59375000026,1312,0,521.0222222222222,39,6,11,37.32727737973389,0.6095085470085468,45.57291666666668,1017.7083333333353,26.09508547008552,0
1318,4,0,0,44,0.0,0.0,1.0,44,850,600,250,0.7058823529411765,11,6,5,331.84992282522745,0.3986962649753347,0.10418357506373477,0.18466061456569188,129337.19735051866,-215.892208159838,129121.30514235882,1313,1,533.8636363636364,38,6,19,37.260835696530485,0.6099232456140351,45.699786324786324,1017.2008547008546,26.768443544759332,0
1319,4,1,1,44,0.022222222222222223,0.022222222222222223,0.9777777777777777,45,1250,900,350,0.72,16,9,7,323.48836524063717,0.4026725589225589,0.0993998908892526,0.1813315515247978,129625.34722222247,-613.5416666666404,129011.80555555582,1314,0,522.9777777777778,39,6,12,37.18119203491545,0.6111111111111109,45.41666666666668,1018.3333333333353,26.11111111111116,0
1320,4,0,0,44,0.0,0.0,1.0,44,1500,1000,500,0.6666666666666666,20,10,10,333.9915762280632,0.3989715468639887,0.10359047500930152,0.1868823094466951,129554.63927469146,-145.96836419752208,129408.67091049394,1315,3,535.8636363636364,38,6,12,36.98556161891768,0.6121162280701754,45.486111111111114,1018.0555555555565,26.790935672514642,0
1321,4,2,0,46,0.043478260869565216,0.0,1.0,46,1200,1000,200,0.8333333333333334,14,10,4,322.7210598530127,0.40574677938808373,0.11311364640453214,0.1830211298759628,130081.09941998812,-804.0179456672616,129277.08147432086,1316,0,513.5217391304348,40,6,15,36.73914126319983,0.6140625000000001,44.96951219512195,1020.1219512195123,25.50304878048781,0
1322,4,2,3,45,0.041666666666666664,0.0625,0.9375,48,1200,800,400,0.6666666666666666,16,8,8,309.7269014166525,0.4130651595744681,0.1116899794531383,0.17760033580416512,130509.99907044334,-1515.5084768042861,128994.49059363906,1317,0,493.0833333333333,42,6,12,36.63742690058481,0.6153273809523809,44.54941860465116,1021.8023255813943,24.328626799557007,0
1323,4,0,1,44,0.0,0.022222222222222223,0.9777777777777777,45,1050,800,250,0.7619047619047619,13,8,5,375.7060465720217,0.40366161616161617,0.10277777777777763,0.20395471099624068,128355.55555555578,706.3959122048192,129061.9514677606,1318,2,526.6222222222223,39,6,19,37.148780153508774,0.5982905982905982,46.66666666666668,1013.3333333333352,25.98290598290603,8
1324,4,2,2,44,0.043478260869565216,0.043478260869565216,0.9565217391304348,46,1450,1200,250,0.8275862068965517,17,12,5,363.25809596636645,0.4098731884057971,0.11441349637681153,0.19883601042369559,128685.30636525895,149.195873818513,128834.50223907745,1319,0,516.0869565217391,40,6,17,37.12711171207266,0.5999999999999999,46.341463414634156,1014.6341463414648,25.36585365853662,0
1325,4,0,0,44,0.0,0.0,1.0,44,1300,800,500,0.6153846153846154,18,8,10,382.6056266001345,0.4019886363636364,0.11846767474598519,0.20885998926481159,128577.58881446772,1038.9017870187624,129616.49060148648,1320,4,540.5454545454545,38,6,18,36.74659398153025,0.6022478070175439,46.44764957264957,1014.2094017094008,26.689721097615813,0
1326,4,1,1,44,0.022222222222222223,0.022222222222222223,0.9777777777777777,45,950,600,350,0.631578947368421,13,6,7,378.13467429569204,0.405513468013468,0.12625651197519483,0.2078780975950429,128857.43408203126,745.0927734374999,129602.52685546876,1321,0,529.5111111111111,39,6,18,36.57375346260387,0.6033653846153846,46.171875,1015.3125000000001,26.03365384615385,0
1327,4,0,0,44,0.0,0.0,1.0,44,1250,700,550,0.56,18,7,11,386.1166318395963,0.4014600951374207,0.1299582862937949,0.21207400206588709,128821.50472094386,1148.0251022719058,129969.52982321577,1322,6,542.5454545454545,38,6,18,36.40790535325897,0.6047149122807017,46.20726495726496,1015.1709401709405,26.71502474134054,0
1328,4,1,0,45,0.022222222222222223,0.0,1.0,45,1000,600,400,0.6,14,6,8,383.61137788907325,0.4052188552188552,0.13887804243134205,0.21218763256456075,129100.54878432857,904.8878810783604,130005.43666540693,1323,0,531.4666666666667,41,4,19,36.18622282962385,0.6026422764227641,45.932539682539684,1016.2698412698414,24.787069299264424,0
1329,4,2,1,46,0.0425531914893617,0.02127659574468085,0.9787234042553191,47,1050,900,150,0.8571428571428571,12,9,3,369.993593710815,0.4100177304964539,0.14933701037374325,0.20766589075406408,129675.59880203521,196.06436906672198,129871.66317110193,1324,0,509.8085106382979,37,10,18,35.94607869523092,0.6151463963963963,45.36732456140351,1018.5307017543857,27.527856804172586,0
1330,4,0,1,45,0.0,0.021739130434782608,0.9782608695652174,46,900,500,400,0.5555555555555556,13,5,8,378.55034654240706,0.40759863123993556,0.14841766063870687,0.21176331266976273,129545.08562616698,607.8674113302823,130152.95303749727,1325,1,521.8913043478261,36,10,19,35.86121865781711,0.6157407407407407,45.49549549549551,1018.0180180180203,28.27827827827834,0
1331,4,1,1,45,0.021739130434782608,0.021739130434782608,0.9782608695652174,46,900,500,400,0.5555555555555556,13,5,8,369.67930029154473,0.40939009661835746,0.13247559893522576,0.21063122923588048,130262.58680555581,443.2634069880944,130705.8502125439,1326,0,519.5,40,6,18,35.357142857142854,0.6158854166666665,44.79166666666668,1020.8333333333354,25.520833333333385,2
1332,4,1,3,43,0.021739130434782608,0.06521739130434782,0.9347826086956522,46,1350,800,550,0.5925925925925926,19,8,11,370.4451078807355,0.4085144927536232,0.12494907325303273,0.21200678697704442,130435.08193582106,463.8075998295693,130898.88953565063,1327,0,520.4782608695652,36,10,18,35.162422371660604,0.6247106481481481,44.62274774774775,1021.5090090090098,28.37525025025027,0
1333,4,1,1,43,0.022727272727272728,0.022727272727272728,0.9772727272727273,44,1350,1000,350,0.7407407407407407,17,10,7,388.0049979175341,0.40238504228329813,0.1414656771799625,0.22107261509254866,130262.58680555565,1308.5069444444557,131571.09375000012,1328,0,544.9545454545455,38,6,19,34.88945578231293,0.6192434210526315,44.79166666666667,1020.8333333333342,26.86403508771932,0
1334,4,1,0,44,0.022727272727272728,0.0,1.0,44,1000,700,300,0.7,13,7,6,389.80272787322383,0.39992952783650454,0.14396589186725617,0.22244431117555796,130323.35778061207,1360.0800736961255,131683.4378543082,1329,0,545.6590909090909,34,10,20,34.78173215187906,0.6277573529411765,44.73214285714285,1021.0714285714271,30.03151260504197,0
1335,4,3,0,47,0.06382978723404255,0.0,1.0,47,1100,1000,100,0.9090909090909091,12,10,2,366.31055845382616,0.4080326857847672,0.24958959667814762,0.20058212472968662,128700.231080717,32.70912243011844,128732.94020314713,1330,0,511.7659574468085,37,10,16,37.03443555939774,0.6052927927927929,46.326754385964904,1014.6929824561391,27.424134660976733,4
1336,4,2,3,46,0.04081632653061224,0.061224489795918366,0.9387755102040817,49,700,300,400,0.42857142857142855,11,3,8,354.3268299897985,0.4138676303854875,0.24537913576501835,0.19583332728331387,129069.04432508702,-653.4749348958101,128415.5693901912,1331,0,491.83673469387753,39,10,16,36.96234836835813,0.6055021367521367,45.96354166666668,1016.1458333333351,26.055021367521412,0
1337,4,0,0,46,0.0,0.0,1.0,46,850,500,350,0.5882352941176471,12,5,7,378.8290480056074,0.4058977455716586,0.24879602374173615,0.20736632579164785,128686.69979100727,550.0519945621375,129236.7517855694,1332,2,524.8478260869565,36,10,16,36.73071587125416,0.6070601851851851,46.340090090090094,1014.63963963964,28.184434434434444,0
1338,4,0,0,46,0.0,0.0,1.0,46,1150,900,250,0.782608695652174,14,9,5,378.9443577615718,0.4051932367149758,0.2546490817611273,0.2078773887099847,128772.40997331799,559.5156389497671,129331.92561226776,1333,3,525.8478260869565,36,10,17,36.64013092200154,0.6079282407407407,46.255630630630634,1014.9774774774781,28.193818818818837,0
1339,4,0,0,46,0.0,0.0,1.0,46,1200,700,500,0.5833333333333334,17,7,10,381.33306734985194,0.4048309178743961,0.2553238686779056,0.2096401789772112,128858.1486892297,627.5746185374487,129485.72330776714,1334,4,526.8478260869565,36,10,17,36.49183858325939,0.6087962962962964,46.17117117117117,1015.3153153153148,28.203203203203188,0
1340,4,3,4,45,0.061224489795918366,0.08163265306122448,0.9183673469387755,49,1100,700,400,0.6363636363636364,15,7,8,360.68440479829155,0.41335388321995464,0.2486660936053835,0.20157936964133288,129508.13140822174,-456.7742660599248,129051.35714216183,1335,0,495.53061224489795,37,12,16,36.35352705662681,0.6134572072072071,45.531798245614034,1017.8728070175437,27.51007586533902,0
1341,4,1,1,45,0.021739130434782608,0.021739130434782608,0.9782608695652174,46,850,500,350,0.5882352941176471,12,5,7,368.04931818188584,0.41036634460547505,0.2496550325678928,0.20516940749124662,129407.39300679443,325.66055276920747,129733.05355956363,1336,0,519.804347826087,35,11,18,36.2687454972889,0.6163690476190475,45.63078703703704,1017.4768518518521,29.070767195767203,0
1342,4,2,2,45,0.0425531914893617,0.0425531914893617,0.9574468085106383,47,1450,1000,450,0.6896551724137931,19,10,9,356.38656570601455,0.4152405180388529,0.24993875509134078,0.20059965809242847,129787.30384589493,-149.10970202369523,129638.19414387124,1337,0,509.70212765957444,37,10,17,36.17900121955593,0.6162725225225224,45.25767543859649,1018.9692982456144,27.539710763394982,0
1343,4,0,0,45,0.0,0.0,1.0,45,1000,800,200,0.8,12,8,4,369.7247025620841,0.4085648148148148,0.2588929453848141,0.2066754227865604,129516.42679419302,577.0844746774033,130093.51126887042,1338,3,533.3555555555556,36,9,17,36.115029317402396,0.6154513888888888,45.52364864864866,1017.9054054054068,28.27515015015019,0
1344,4,0,0,45,0.0,0.0,1.0,45,1250,1000,250,0.8,15,10,5,373.67660581099466,0.4083543771043771,0.2632765863365021,0.20995519106622754,129717.1051964129,694.449517084684,130411.55471349758,1339,4,534.3555555555556,36,9,17,35.81002653106346,0.6174768518518517,45.32657657657659,1018.6936936936959,28.29704704704711,0
1345,4,0,0,45,0.0,0.0,1.0,45,850,500,350,0.5882352941176471,12,5,7,374.1490186502239,0.4082070707070707,0.26185880908532844,0.2108373984299212,129831.84831791284,715.2917275383898,130547.14004545123,1340,5,535.3555555555556,36,9,17,35.68116942909762,0.6186342592592591,45.213963963963984,1019.1441441441468,28.309559559559634,0
1346,4,0,1,44,0.0,0.022222222222222223,0.9777777777777777,45,850,300,550,0.35294117647058826,14,3,11,374.8286709957116,0.40803872053872053,0.2646386525736868,0.21137534586804935,129860.54202428812,735.0908763493592,130595.63290063749,1341,6,536.3555555555556,36,9,17,35.63464442234744,0.6189236111111109,45.18581081081083,1019.2567567567594,28.31268768768776,0
1347,4,0,0,44,0.0,0.0,1.0,44,1300,1100,200,0.8461538461538461,15,11,4,380.3752412321433,0.4093441684284707,0.25514112278818124,0.2144420214014249,129849.3829839679,1078.2980752743624,130927.68105924226,1342,7,521.0909090909091,35,9,18,35.504674842910134,0.6208333333333332,45.19675925925927,1019.2129629629641,29.120370370370402,0
1348,4,1,0,45,0.022222222222222223,0.0,1.0,45,900,600,300,0.6666666666666666,12,6,6,383.7305382831638,0.4109638047138047,0.2800105784124822,0.21913621613413317,130351.2158805943,1004.6048471793756,131355.82072777368,1343,0,510.4888888888889,35,10,19,34.90840700442028,0.625892857142857,44.70486111111112,1021.1805555555569,29.17658730158734,0
1349,4,2,1,46,0.0425531914893617,0.02127659574468085,0.9787234042553191,47,1550,1300,250,0.8387096774193549,18,13,5,368.3120636791502,0.41620413197656486,0.2696312512827528,0.21290901822344963,130822.85534972319,236.7271660511137,131059.58251577431,1344,0,489.72340425531917,37,10,19,34.8235977134691,0.626689189189189,44.24342105263159,1023.0263157894752,27.649359886202035,0
1350,4,0,0,46,0.0,0.0,1.0,46,1100,900,200,0.8181818181818182,13,9,4,376.94854415447554,0.412932769726248,0.2746722257059291,0.21766202330293097,130780.41459956596,659.4973774450341,131439.911977011,1345,1,501.3695652173913,36,10,19,34.64576681713093,0.6281828703703702,44.28490990990992,1022.8603603603618,28.412787787787828,0
1351,4,0,0,46,0.0,0.0,1.0,46,950,500,450,0.5263157894736842,14,5,9,377.03507593858524,0.412962962962963,0.2712869297246596,0.21820004458458525,130866.819099505,668.2762154046003,131535.0953149096,1346,2,502.3695652173913,36,10,19,34.55591019150341,0.6290509259259258,44.200450450450454,1023.198198198199,28.422172172172193,0
1352,4,0,0,46,0.0,0.0,1.0,46,1350,1100,250,0.8148148148148148,16,11,5,373.36695252531024,0.4127012882447665,0.2680942114355698,0.21693386656682162,131019.233381906,583.6503780009291,131602.88375990692,1347,3,503.3695652173913,37,9,19,34.495265252936356,0.6286599099099099,44.0515350877193,1023.793859649123,27.67010431484116,0
1353,4,1,1,46,0.02127659574468085,0.02127659574468085,0.9787234042553191,47,950,700,250,0.7368421052631579,12,7,5,368.16752959574916,0.41367946345975953,0.2625999108206498,0.21517945011290876,131246.0064308022,264.1035913872583,131510.11002218944,1348,0,493.63829787234044,38,9,19,34.398785319570436,0.629111842105263,43.83012820512821,1024.679487179488,26.965249662618106,0
1354,4,0,0,46,0.0,0.0,1.0,46,1100,800,300,0.7272727272727273,14,8,6,375.0229303149035,0.412097423510467,0.26175606941258067,0.21885316914004635,131187.67463306017,639.677232417671,131827.35186547786,1349,5,505.3695652173913,37,9,20,34.28223893110708,0.6303490990990991,43.887061403508774,1024.451754385965,27.68788525367473,0
1355,4,0,0,46,0.0,0.0,1.0,46,1300,900,400,0.6923076923076923,17,9,8,385.0100478702367,0.41186594202898547,0.3081248950814168,0.22374477190663916,131027.14913662433,889.4289355918039,131916.57807221613,1350,6,506.3695652173913,38,8,18,34.1892326689624,0.6269188596491228,44.04380341880342,1023.8247863247865,26.942757534862803,2
1356,4,0,0,46,0.0,0.0,1.0,46,900,600,300,0.6666666666666666,12,6,6,386.201337065333,0.41139291465378425,0.3097633323959761,0.22491652594825537,131109.19922017682,926.9096080794853,132036.1088282563,1351,7,507.3695652173913,38,8,18,34.07551811669797,0.6277412280701754,43.96367521367522,1024.1452991452995,26.95119208277104,0
1357,4,0,0,46,0.0,0.0,1.0,46,1400,800,600,0.5714285714285714,20,8,12,388.65780634807044,0.41161433172302736,0.3178401414516927,0.2269932011496953,131218.63928154,999.8296990284208,132218.46898056843,1352,8,508.3695652173913,38,8,18,33.901633646159176,0.6288377192982456,43.85683760683761,1024.57264957265,26.962438146648687,0
1358,4,0,0,46,0.0,0.0,1.0,46,1150,700,450,0.6086956521739131,16,7,9,388.34445371142635,0.4115438808373591,0.314451354389528,0.2271341463414635,131273.37643363277,995.8575315947064,132269.23396522747,1353,9,509.3695652173913,38,8,18,33.85416666666668,0.6293859649122808,43.8034188034188,1024.7863247863243,26.96806117858748,0
1359,4,1,0,47,0.02127659574468085,0.0,1.0,47,1350,1000,350,0.7407407407407407,17,10,7,381.4998821309024,0.4123496762257169,0.32126864400040933,0.22626639620999994,131806.218319579,656.8341791563413,132463.05249873534,1354,0,499.51063829787233,37,10,17,33.49027851930949,0.6365427927927929,43.28399122807017,1026.8640350877185,27.7530820293978,0
1360,4,0,0,47,0.0,0.0,1.0,47,1200,900,300,0.75,15,9,6,382.6800357129634,0.4120220474868948,0.3262699063484529,0.22730272000782029,131862.52170138885,692.2309027777741,132554.75260416663,1355,1,500.51063829787233,37,10,18,33.40305949966193,0.6371058558558559,43.229166666666664,1027.083333333333,27.759009009009002,0
1361,4,0,0,47,0.0,0.0,1.0,47,1400,1000,400,0.7142857142857143,18,10,8,385.30605508658226,0.41223404255319146,0.32375296265017584,0.22971299925390867,132003.33275623253,772.336680517059,132775.6694367496,1356,2,501.51063829787233,37,10,18,33.19328851899272,0.6385135135135136,43.09210526315788,1027.631578947367,27.773826458036943,0
1362,4,0,0,47,0.0,0.0,1.0,47,1400,1000,400,0.7142857142857143,18,10,8,391.30937259812436,0.41213768115942034,0.3251158210932785,0.23433584267083063,132172.40521121875,944.0601915974064,133116.46540281616,1357,3,502.51063829787233,37,10,18,32.868148859031784,0.6402027027027027,42.92763157894736,1028.2894736842097,27.791607396870532,0
1363,4,0,0,47,0.0,0.0,1.0,47,900,600,300,0.6666666666666666,12,6,6,390.2041495934581,0.4118678692568609,0.3235530236714037,0.23437230035120504,132285.18029586025,923.645256232684,133208.82555209292,1358,4,503.51063829787233,37,10,18,32.78263341149718,0.6413288288288288,42.81798245614035,1028.7280701754385,27.80346135609293,0
1364,4,0,0,47,0.0,0.0,1.0,47,1550,1000,550,0.6451612903225806,21,10,11,394.2837176839115,0.41152096823928463,0.32690463505594125,0.23735424570003244,132369.79316953282,1038.2508319867534,133408.04400151956,1359,5,504.51063829787233,37,10,18,32.59223494938732,0.6421734234234234,42.73574561403508,1029.0570175438586,27.81235182550969,0
1365,4,0,0,47,0.0,0.0,1.0,47,1400,900,500,0.6428571428571429,19,9,10,392.0501463527916,0.41086571076164047,0.333104552733928,0.23695609474530363,132520.55165816328,990.9493516647208,133511.501009828,1360,6,505.51063829787233,34,13,18,32.49749489343661,0.6498161764705883,42.589285714285715,1029.6428571428573,30.28361344537816,0
1366,4,0,0,47,0.0,0.0,1.0,47,1600,1100,500,0.6875,21,11,10,387.4377062426439,0.4102104532839963,0.3288040572892217,0.2361254835516085,132832.97444403853,892.9005863971968,133725.8750304357,1361,7,506.51063829787233,36,11,18,32.301225329546284,0.6487268518518519,42.28603603603603,1030.855855855855,28.634884884884862,0
1367,4,0,2,45,0.0,0.0425531914893617,0.9574468085106383,47,800,400,400,0.5,12,4,8,387.8434211829669,0.4105573543015726,0.3304100090162947,0.23673962429008297,132891.02447041633,908.1819150231241,133799.20638543947,1362,8,507.51063829787233,36,11,18,32.232279379641746,0.6493055555555556,42.229729729729726,1031.0810810810808,28.641141141141134,0
1368,4,1,0,46,0.021739130434782608,0.0,1.0,46,1100,700,400,0.6363636363636364,15,7,8,376.85589504688414,0.4119061996779388,0.33625490397754776,0.22436953590417114,131951.6933111497,746.6228571969978,132698.31616834668,1363,0,504.2173913043478,35,11,20,33.462529570800925,0.6419642857142858,43.14236111111111,1027.4305555555554,29.355158730158728,2
1369,4,0,1,45,0.0,0.021739130434782608,0.9782608695652174,46,1150,700,450,0.6086956521739131,16,7,9,378.1728511280426,0.4121980676328503,0.3397556091901126,0.22586100140337223,132070.63567654742,789.1057688185783,132859.741445366,1364,1,505.2173913043478,35,11,20,33.30858480651579,0.643154761904762,43.02662037037037,1027.893518518518,29.36838624338623,0
1370,4,0,0,45,0.0,0.0,1.0,45,1600,900,700,0.5625,23,9,14,385.11632191566093,0.41012205387205386,0.34214332675871106,0.22971055907204727,132021.60564280508,1168.7350357113974,133190.34067851648,1365,2,516.2888888888889,36,9,20,33.179697202133106,0.640625,43.07432432432433,1027.7027027027036,28.547297297297323,0
1371,4,0,0,45,0.0,0.0,1.0,45,950,600,350,0.631578947368421,13,6,7,381.60082233604305,0.40951178451178455,0.3421944779079811,0.2284850563115024,132166.31063073222,1086.954564361673,133253.26519509387,1366,3,517.2888888888889,36,9,20,33.12388201365313,0.6420717592592593,42.933558558558566,1028.265765765767,28.56293793793797,0
1372,4,0,0,45,0.0,0.0,1.0,45,1300,900,400,0.6923076923076923,17,9,8,383.59138693246746,0.40883838383838383,0.34711949506791306,0.23057258062699157,132313.3815813518,1150.8547101030927,133464.2362914549,1367,4,518.2888888888889,37,8,20,32.92423798358734,0.6416103603603605,42.79057017543859,1028.8377192982443,27.806424845898494,0
1373,4,0,0,45,0.0,0.0,1.0,45,1250,900,350,0.72,16,9,7,385.9073477095175,0.40845959595959597,0.35019863578442423,0.2328534566165838,132457.56842635444,1223.3238862788571,133680.8923126333,1368,5,519.2888888888889,35,10,20,32.71915523573945,0.6470238095238096,42.650462962962955,1029.398148148147,29.411375661375626,0
1374,4,0,0,45,0.0,0.0,1.0,45,1600,1400,200,0.875,18,14,4,387.55706958021466,0.4085858585858586,0.35477635423690734,0.23459066701528888,132576.7385223764,1276.2104552468977,133852.9489776233,1369,6,520.2888888888889,35,10,20,32.556473364801086,0.6482142857142857,42.534722222222214,1029.86111111111,29.424603174603142,0
1375,4,0,0,45,0.0,0.0,1.0,45,900,500,400,0.5555555555555556,13,5,8,387.7347804801341,0.4087962962962963,0.3547151479821722,0.23539386241624044,132687.90486009646,1289.5431326596718,133977.44799275612,1370,7,521.2888888888889,36,9,18,32.43979305570736,0.6472800925925927,42.426801801801794,1030.2927927927917,28.619244244244214,0
1376,4,0,0,45,0.0,0.0,1.0,45,1000,600,400,0.6,14,6,8,387.1702350025384,0.4089225589225589,0.3551523982999394,0.2352329117047292,132716.91243608456,1276.807635338021,133993.72007142258,1371,8,522.2888888888889,36,9,18,32.42509107468123,0.6475694444444446,42.39864864864864,1030.405405405404,28.622372372372336,0
1377,4,0,1,44,0.0,0.022222222222222223,0.9777777777777777,45,1150,800,350,0.6956521739130435,15,8,7,386.4040483753805,0.40852272727272726,0.3562839141993521,0.2353131240705159,132803.95418644976,1263.1971075805336,134067.15129403028,1372,9,523.2888888888889,36,9,18,32.35710513857025,0.6484375000000002,42.31418918918918,1030.7432432432415,28.631756756756708,0
1378,4,1,0,45,0.022222222222222223,0.0,1.0,45,1500,1000,500,0.6666666666666666,20,10,10,386.7768595041324,0.4087121212121212,0.3608529741863076,0.2363636363636363,132934.57031249988,1283.203124999985,134217.77343749985,1373,0,524.0666666666667,37,8,19,32.215909090909086,0.6478040540540542,42.18749999999999,1031.249999999999,27.871621621621596,0
1379,4,0,0,45,0.0,0.0,1.0,45,1600,1100,500,0.6875,21,11,10,383.1738744647196,0.40848063973063975,0.360262249827467,0.23546180835427433,133141.23109796192,1203.2482741617393,134344.47937212366,1374,1,525.0666666666667,38,7,19,32.10080227743271,0.6480263157894737,41.98717948717949,1032.0512820512824,27.159244264507432,0
1380,4,0,2,43,0.0,0.044444444444444446,0.9555555555555556,45,1400,1000,400,0.7142857142857143,18,10,8,376.57522877760385,0.4087121212121212,0.34946714950853597,0.23226544901949844,133279.09412895388,1037.9210725765165,134317.0152015304,1375,2,526.0666666666667,38,7,19,32.132479737885845,0.6493969298245614,41.85363247863248,1032.5854700854698,27.173301844354466,0
1381,4,0,0,43,0.0,0.0,1.0,43,750,400,350,0.5333333333333333,11,4,7,379.6033302740464,0.40836101882613507,0.32762199627062594,0.23450261804779876,133337.70751953125,1523.0875651041665,134860.7950846354,1358,3,497.3953488372093,39,4,19,31.995398386283405,0.6482371794871795,41.796875,1032.8125,26.482371794871796,0
1382,4,0,0,43,0.0,0.0,1.0,43,1000,600,400,0.6,14,6,8,358.5174870071309,0.4079918789221115,0.25025167529311276,0.21748792912077144,132658.90045450858,976.4653054395237,133635.3657599481,1359,4,498.3953488372093,36,7,17,33.22151472088617,0.6469907407407407,42.45495495495496,1030.1801801801803,28.616116116116117,3
1383,4,0,0,43,0.0,0.0,1.0,43,1300,1000,300,0.7692307692307693,16,10,6,358.8051420716646,0.40743816906607605,0.2540731347190419,0.2181678309035087,132745.92318247314,925.9839653843212,133671.90714785745,1360,5,499.3953488372093,36,7,17,33.12661639893637,0.6478587962962963,42.370495495495504,1030.5180180180191,28.625500500500532,0
1384,4,0,0,43,0.0,0.0,1.0,43,1250,700,550,0.56,18,7,11,359.7169896143337,0.40706902916205245,0.2557793245375797,0.2193293862745763,132849.77709487543,957.6643775007775,133807.4414723762,1361,6,500.3953488372093,37,6,17,32.99874140253847,0.6469594594594594,42.26973684210527,1030.9210526315796,27.862731152204855,0
1385,4,0,0,43,0.0,0.0,1.0,43,1000,600,400,0.6,14,6,8,358.9375526600173,0.40653839055001845,0.2554578457459964,0.2191849834555066,132906.30290089257,941.0126192674652,133847.31552016002,1362,7,501.3953488372093,37,6,17,32.962037430880486,0.6475225225225225,42.21491228070175,1031.1403508771928,27.86865813181602,0
1386,4,0,0,43,0.0,0.0,1.0,43,950,400,550,0.42105263157894735,15,4,11,355.85252637024973,0.40669988925802875,0.2525412340969675,0.21818843474015887,133058.5475221894,869.8440581854069,133928.3915803748,1363,8,502.3953488372093,38,5,19,32.88870767319044,0.647203947368421,42.06730769230769,1031.7307692307695,27.1508097165992,0
1387,4,0,0,43,0.0,0.0,1.0,43,1150,800,350,0.6956521739130435,15,8,7,359.19551336274003,0.40663067552602433,0.2517607906366537,0.22093534090076944,133176.3793945314,967.2715928819597,134143.65098741336,1364,9,503.3953488372093,39,4,19,32.684197026272415,0.6466346153846153,41.95312500000001,1032.1875000000011,26.46634615384618,0
1388,4,0,0,43,0.0,0.0,1.0,43,850,700,150,0.8235294117647058,10,7,3,356.4921093032579,0.4059154669619786,0.2539727216221599,0.22022549929855487,133337.70751953142,906.7681206597375,134244.47564019117,1365,10,504.3953488372093,39,4,19,32.592137334005706,0.6482371794871794,41.79687500000001,1032.8125000000014,26.48237179487183,0
1389,4,1,1,43,0.022727272727272728,0.022727272727272728,0.9772727272727273,44,1150,900,250,0.782608695652174,14,9,5,349.39672507900013,0.4089587737843552,0.25477282122590106,0.21727266785760974,133582.64391116964,534.8032956719439,134117.44720684158,1366,0,493.90909090909093,38,6,19,32.530014124293785,0.6524122807017543,41.55982905982906,1033.7606837606843,27.204228520018006,0
1390,4,0,0,43,0.0,0.0,1.0,43,1600,1200,400,0.75,20,12,8,364.9107943537265,0.4061231081579919,0.20537771098723234,0.22112539084627755,132618.0021938235,1155.1181605668776,133773.12035439035,1367,12,506.3953488372093,38,5,17,33.098010234069775,0.6428179824561404,42.49465811965812,1030.0213675213674,27.105825461088617,4
1391,4,0,0,43,0.0,0.0,1.0,43,1150,700,450,0.6086956521739131,16,7,9,365.910486311443,0.40586932447397567,0.20765773152122535,0.22221918954581604,132700.54879830533,1111.3044689166634,133811.853267222,1368,13,507.3953488372093,38,5,16,32.98920745195632,0.6436403508771928,42.41452991452992,1030.3418803418813,27.114260008996876,0
1392,4,0,0,43,0.0,0.0,1.0,43,1100,700,400,0.6363636363636364,15,7,8,364.01192222634984,0.40547711332595054,0.20448516447360854,0.22175212775626862,132816.69439693654,1069.3720462357255,133886.06644317225,1369,14,508.3953488372093,40,3,16,32.92130862006638,0.64140625,42.30182926829269,1030.7926829268308,25.76981707317077,0
1393,4,0,0,43,0.0,0.0,1.0,43,950,500,450,0.5263157894736842,14,5,9,359.9969588451752,0.4061461794019934,0.11722362374245932,0.21580145565746303,132210.46142578128,922.3002604037574,133132.76168618503,1370,15,509.3953488372093,39,4,19,33.63476569094162,0.6370192307692308,42.890625,1028.4375000000002,26.370192307692314,6
1394,4,0,0,43,0.0,0.0,1.0,43,1100,800,300,0.7272727272727273,14,8,6,360.4935106553438,0.405984680693983,0.11975272299087414,0.216405678888846,132264.03130425332,936.0649956597035,133200.096299913,1371,16,510.3953488372093,39,4,19,33.56803797468353,0.6375534188034189,42.83854166666666,1028.6458333333321,26.375534188034155,0
1395,4,0,0,43,0.0,0.0,1.0,43,950,700,250,0.7368421052631579,12,7,5,360.67766173860963,0.40603082318198597,0.11985264734117607,0.21713567198365985,132371.8572361027,948.7143895829068,133320.5716256856,1372,17,511.3953488372093,40,3,19,33.45472052142998,0.6369791666666667,42.73373983739837,1029.0650406504053,25.726626016260134,0
1396,4,0,0,43,0.0,0.0,1.0,43,1350,900,450,0.6666666666666666,18,9,9,361.1513399478167,0.40490033222591365,0.12118585083484645,0.21806108879550162,132482.65241468523,969.2652337662687,133451.9176484515,1373,18,512.3953488372093,37,6,19,33.331003479248764,0.6432995495495495,42.62609649122807,1029.4956140350873,27.82420578473209,0
1397,4,2,0,45,0.044444444444444446,0.0,1.0,45,800,500,300,0.625,11,5,6,348.70472296859026,0.40639730639730637,0.1330640274691981,0.2134038422024093,132988.2866753473,274.72873263889835,133263.0154079862,1374,0,490.5777777777778,39,6,18,33.143556857200565,0.6447649572649572,42.13541666666667,1031.4583333333342,26.447649572649595,0
1398,4,0,0,45,0.0,0.0,1.0,45,1550,1200,350,0.7741935483870968,19,12,7,346.0882792902993,0.4064604377104377,0.13270520672095465,0.21241328963133257,133095.75195312515,212.5759548611258,133308.32790798627,1375,1,491.5777777777778,39,6,18,33.10325392018305,0.6458333333333333,42.03125000000001,1031.8750000000011,26.458333333333364,0
1399,4,1,1,45,0.021739130434782608,0.021739130434782608,0.9782608695652174,46,1000,600,400,0.6,14,6,8,339.2381408077121,0.4090378421900161,0.13232223688386302,0.2097474775587824,133369.72867850834,-151.1802406147722,133218.54843789357,1376,0,481.8695652173913,41,5,18,33.00558650275323,0.6453252032520325,41.76587301587301,1032.9365079365073,25.193573364305056,0
1400,4,0,1,44,0.0,0.022222222222222223,0.9777777777777777,45,750,300,450,0.4,12,3,9,348.21212298234974,0.4062710437710438,0.13514891010707508,0.21452316297014526,133236.04630387027,278.88130824907853,133514.92761211935,1377,3,493.5777777777778,40,5,18,32.907807526987575,0.6455729166666666,41.89532520325204,1032.4186991869935,25.810467479674838,0
1401,4,0,1,43,0.0,0.022727272727272728,0.9772727272727273,44,1150,900,250,0.782608695652174,14,9,5,353.5625179125947,0.40606280831571534,0.12651858983175157,0.21841572368245363,133337.7075195314,628.6431206597372,133966.35064019114,1378,4,476.79545454545456,39,5,18,32.66778029920995,0.6482371794871794,41.79687500000001,1032.8125000000011,26.482371794871824,0
1402,4,0,0,43,0.0,0.0,1.0,43,1450,1200,250,0.8275862068965517,17,12,5,356.5553716974907,0.4038851974898487,0.1319736953197559,0.22042413128131672,133364.6050347223,910.3732638888944,134274.9782986112,1379,5,484.86046511627904,39,4,18,32.56353368293668,0.6485042735042735,41.770833333333336,1032.9166666666672,26.48504273504275,0
1403,4,1,1,43,0.022727272727272728,0.022727272727272728,0.9772727272727273,44,1000,700,300,0.7,13,7,6,348.5568181208952,0.40491763565891475,0.13099740599196075,0.2171267777466799,133646.82883897415,516.8762935232626,134163.70513249742,1380,0,474.8181818181818,36,8,20,32.487475495534746,0.6568287037037037,41.49774774774775,1034.0090090090096,28.72247247247249,0
1404,4,0,0,43,0.0,0.0,1.0,43,1450,1200,250,0.8275862068965517,17,12,5,351.4991099604126,0.4024317091177556,0.1408869364864349,0.2194778602981912,133734.1749477519,801.4886930849854,134535.66364083686,1381,7,486.86046511627904,36,7,17,32.32398838686264,0.6576967592592593,41.41328828828829,1034.3468468468475,28.731856856856876,0
1405,4,1,0,44,0.022727272727272728,0.0,1.0,44,1500,1300,200,0.8666666666666667,17,13,4,342.60621890554415,0.4051048273431994,0.14545876593230367,0.21578181155629894,134052.44545118348,385.4402942143373,134437.88574539783,1382,0,476.77272727272725,38,6,19,32.23589188073868,0.6570723684210527,41.10576923076923,1035.5769230769233,27.252024291497982,0
1406,4,0,1,43,0.0,0.022727272727272728,0.9772727272727273,44,1050,700,350,0.6666666666666666,14,7,7,342.18166720349717,0.40436707188160675,0.148926344413709,0.21583937954052745,134107.77043839952,377.8440947110929,134485.6145331106,1383,1,477.77272727272725,38,6,19,32.1916365824308,0.6576206140350876,41.05235042735043,1035.790598290599,27.257647323436817,0
1407,4,1,2,42,0.022727272727272728,0.045454545454545456,0.9545454545454546,44,1100,800,300,0.7272727272727273,14,8,6,334.0707822590303,0.4059416842847075,0.13162821707125483,0.21234614090717688,134388.72070312515,179.06901041668067,134567.78971354183,1384,0,455.70454545454544,39,5,20,32.12150894112921,0.658653846153846,40.78125000000001,1036.8750000000011,26.586538461538492,0
1408,4,0,0,42,0.0,0.0,1.0,42,550,400,150,0.7272727272727273,7,4,3,336.22197951820243,0.4029108594657375,0.07780320366132698,0.19977985853448665,131876.23844875424,493.74093991979856,132369.97938867405,1385,3,478.1666666666667,38,4,21,34.58216316482906,0.6354166666666667,43.21581196581195,1027.1367521367504,27.029914529914482,8
1409,4,1,1,42,0.023255813953488372,0.023255813953488372,0.9767441860465116,43,900,600,300,0.6666666666666666,12,6,6,328.80331852070833,0.4044619785898856,0.07954572229683543,0.19668416689693283,132130.12695312503,88.96484375000134,132219.09179687503,1386,0,468.0232558139535,39,4,21,34.517477203647424,0.6362179487179487,42.96875,1028.1250000000002,26.362179487179493,0
1410,4,0,0,42,0.0,0.0,1.0,42,700,300,400,0.42857142857142855,11,3,8,337.28999269539827,0.40199138598528844,0.08880308880308907,0.2012859633827376,132040.89506172828,507.2145061728298,132548.10956790112,1387,5,480.1666666666667,38,4,22,34.389076576576585,0.637061403508772,43.05555555555555,1027.777777777777,27.04678362573097,0
1411,4,0,1,41,0.0,0.023809523809523808,0.9761904761904762,42,1200,800,400,0.6666666666666666,16,8,8,332.7411705177939,0.4009872241579559,0.08011131725417431,0.19929270480608377,132178.18737900868,396.22495708232634,132574.41233609102,1388,6,481.1666666666667,38,4,22,34.36796536796536,0.6384320175438596,42.922008547008545,1028.3119658119658,27.060841205578047,0
1412,4,0,0,41,0.0,0.0,1.0,41,1400,1100,300,0.7857142857142857,17,11,6,332.25609402765986,0.40152439024390246,0.0951249898711608,0.20001816860465105,132370.5164730804,596.1821535539289,132966.69862663434,1389,7,490.219512195122,38,3,22,34.18725775193797,0.6403508771929826,42.735042735042725,1029.0598290598277,27.080521817363888,0
1413,4,0,0,41,0.0,0.0,1.0,41,1050,700,350,0.6666666666666666,14,7,7,331.54476751184757,0.4011941056910569,0.09729770779804348,0.20002716562158102,132452.9860312111,582.8188919935677,133035.80492320468,1390,8,491.219512195122,38,3,22,34.122772876664946,0.6411732456140351,42.65491452991453,1029.3803418803411,27.088956365272136,0
1414,4,1,2,40,0.023809523809523808,0.047619047619047616,0.9523809523809523,42,1000,600,400,0.6,14,6,8,324.2638776178602,0.40367305458768876,0.09374578784202692,0.19702814971719135,132719.81336805565,207.2482638888937,132927.06163194455,1391,0,480.5,39,3,18,34.042660735948225,0.642094017094017,42.395833333333336,1030.4166666666674,26.42094017094019,0
1415,4,0,0,40,0.0,0.0,1.0,40,1150,600,550,0.5217391304347826,17,6,11,338.6587100768391,0.4009481837606838,0.09221328931956174,0.2047871182441464,132539.10007165652,977.1041330024483,133516.20420465898,1392,10,484.45,37,3,22,33.853223831327874,0.6438626126126126,42.571271929824555,1029.7149122807007,27.83013276434326,0
1416,4,0,0,40,0.0,0.0,1.0,40,900,700,200,0.7777777777777778,11,7,4,341.3948911826493,0.4004540598290598,0.09084353379457166,0.20706294400651962,132652.03145438977,1057.34516870575,133709.3766230955,1393,11,485.45,37,3,19,33.66939418130213,0.6449887387387387,42.46162280701754,1030.1535087719294,27.84198672356566,0
1417,4,0,0,40,0.0,0.0,1.0,40,1500,1200,300,0.8,18,12,6,341.7270295260525,0.4001068376068376,0.09218101521762279,0.2075765285362841,132708.5151801516,1070.0173370652494,133778.53251721684,1394,12,486.45,37,3,19,33.6041422794509,0.6455518018018017,42.406798245614034,1030.372807017544,27.84791370317686,0
1418,4,0,0,40,0.0,0.0,1.0,40,950,500,450,0.5263157894736842,14,5,9,340.1973743775466,0.4002537393162393,0.09206382978723426,0.20711498181016416,132793.26331178812,1035.183902739294,133828.4472145274,1395,13,487.45,37,3,20,33.55851063829788,0.6463963963963963,42.32456140350877,1030.701754385964,27.856804172593623,0
1419,4,0,0,40,0.0,0.0,1.0,40,1200,900,300,0.75,15,9,6,337.78142211357937,0.3994524572649573,0.09038700652782139,0.2061940863262589,132893.2574169954,977.7746959237337,133871.0321129191,1396,14,488.45,38,2,20,33.52049010465237,0.6455592105263158,42.2275641025641,1031.0897435897434,27.13394062078272,0
1420,4,0,0,40,0.0,0.0,1.0,40,950,700,250,0.7368421052631579,12,7,5,338.0769663717618,0.3993055555555556,0.09431523878586989,0.2066787179472206,132948.3427044524,989.3544771349164,133937.6971815873,1397,15,489.45,38,2,20,33.45764701819816,0.6461074561403508,42.174145299145295,1031.303418803418,27.139563652721527,0
1421,4,1,0,41,0.024390243902439025,0.0,1.0,41,900,700,200,0.7777777777777778,11,7,4,329.44187019900414,0.4014481707317073,0.0941550531437112,0.2029271830666456,133230.14458550335,578.3175998263835,133808.46218532973,1398,0,478.4878048780488,39,2,21,33.398181313691865,0.6471688034188035,41.901041666666664,1032.3958333333326,26.471688034188016,0
1422,4,0,0,41,0.0,0.0,1.0,41,1100,800,300,0.7272727272727273,14,8,6,324.5921141604802,0.400609756097561,0.09077155824508343,0.20051905370100695,133337.70751953122,456.0736762152774,133793.7811957465,1399,1,479.4878048780488,39,2,21,33.41580517734074,0.6482371794871795,41.796875,1032.8124999999998,26.48237179487179,0
1423,4,0,0,41,0.0,0.0,1.0,41,900,600,300,0.6666666666666666,12,6,6,337.56419491189,0.4008384146341464,0.0024771139031907197,0.20754355105849906,133160.81781173052,801.0511798101361,133961.86899154066,1400,2,480.4878048780488,37,4,18,33.25797213074119,0.6500563063063063,41.968201754385966,1032.127192982456,27.89532954006638,4
1424,4,0,0,41,0.0,0.0,1.0,41,950,600,350,0.631578947368421,13,6,7,337.08179238602327,0.4013719512195122,0.0069664776126190375,0.2075985570316216,133223.94035585143,781.4729207758107,134005.41327662725,1401,3,481.4878048780488,38,3,18,33.20720790644728,0.6488486842105262,41.907051282051285,1032.371794871795,27.167678812415655,0
1425,4,0,2,39,0.0,0.04878048780487805,0.9512195121951219,41,850,600,250,0.7058823529411765,11,6,5,338.5422738420453,0.4011941056910569,-0.015726897299480846,0.21022604799203595,133530.41174620567,841.6001220315158,134372.0118682372,1402,4,482.4878048780488,36,5,20,32.862778746277336,0.6556712962962963,41.61036036036036,1033.5585585585586,28.70995995995996,1
1426,4,0,0,39,0.0,0.0,1.0,39,950,600,350,0.631578947368421,13,6,7,348.7654837558095,0.3943432298695457,0.003617475706442441,0.21555775047225645,133355.8812190569,1501.9856850093352,134857.86690406624,1403,29,507.61538461538464,36,3,20,32.77343182148568,0.6539351851851851,41.77927927927928,1032.882882882883,28.691191191191194,0
1427,4,0,0,39,0.0,0.0,1.0,39,1150,800,350,0.6956521739130435,15,8,7,349.52964349910405,0.3948774179037337,0.02786413933741172,0.22156135253207673,134288.02958363772,1587.5801477152831,135875.609731353,1404,30,508.61538461538464,36,3,19,31.821309575546845,0.6631944444444444,40.87837837837838,1036.4864864864867,28.791291291291298,3
1428,4,0,0,39,0.0,0.0,1.0,39,550,200,350,0.36363636363636365,9,2,7,322.38054659858614,0.3951866846603689,0.010443864229764843,0.18628809497172366,130808.47447083423,634.0214999269447,131442.49597076117,1405,31,509.61538461538464,38,1,14,36.012837249782415,0.6247258771929824,44.25747863247863,1022.9700854700853,26.920265407107507,8
1429,4,0,0,39,0.0,0.0,1.0,39,800,500,300,0.625,11,5,6,324.1541430056461,0.3952429149797571,0.008978910002087837,0.1877115103813833,130890.45606874136,685.736722916207,131576.19279165758,1406,32,510.61538461538464,38,1,14,35.88475325398482,0.6255482456140351,44.177350427350426,1023.2905982905986,26.92869995501575,0
1430,4,0,0,39,0.0,0.0,1.0,39,1000,800,200,0.8,12,8,4,326.6142802977876,0.3954397210976159,0.0020872469213106815,0.1896738202311151,130999.80481591052,757.2813938198494,131757.08620973036,1407,33,511.61538461538464,38,1,14,35.71149029430182,0.6266447368421053,44.07051282051282,1023.7179487179483,26.939946018893377,0
1431,4,0,0,39,0.0,0.0,1.0,39,950,700,250,0.7368421052631579,12,7,5,327.93777558891395,0.39538349077822765,0.0010431879824746026,0.1909849038150259,131109.19922017664,799.1318303016933,131908.33105047833,1408,34,512.6153846153846,38,1,15,35.56727693163642,0.6277412280701755,43.96367521367521,1024.1452991452982,26.951192082771005,0
1432,4,0,0,39,0.0,0.0,1.0,39,1150,800,350,0.6956521739130435,15,8,7,328.09313771066456,0.3949898785425101,0.0002085723224529712,0.19148418122383204,131191.27498584622,808.5914100737746,131999.86639592,1409,35,513.6153846153846,38,1,15,35.48054194041785,0.6285635964912281,43.883547008547005,1024.4658119658113,26.959626630679246,0
1433,4,0,0,39,0.0,0.0,1.0,39,1000,600,400,0.6,14,6,8,327.18619869125536,0.39527103013945114,0.004169272461955975,0.19163763066202089,131328.12499999997,793.7499999999997,132121.87499999997,1410,36,514.6153846153846,38,1,17,35.365853658536594,0.6299342105263158,43.75,1024.9999999999998,26.97368421052631,0
1434,4,0,0,39,0.0,0.0,1.0,39,800,500,300,0.625,11,5,6,327.7937062427977,0.3948774179037337,0.004376367614879806,0.19240588371939635,131410.26925131504,815.0918392505082,132225.36109056554,1411,37,515.6153846153846,38,1,17,35.26753152026676,0.6307565789473684,43.6698717948718,1025.3205128205138,26.982118758434574,0
1435,4,0,0,39,0.0,0.0,1.0,39,1650,1300,350,0.7878787878787878,20,13,7,328.8508117776091,0.39341542959964015,0.01541345553009732,0.19371935550236846,131547.23340821112,851.882898677778,132399.1163068889,1412,38,516.6153846153846,38,1,19,35.102496007776146,0.6321271929824561,43.53632478632479,1025.8547008547018,26.99617633828163,0
1436,4,0,0,39,0.0,0.0,1.0,39,1000,800,200,0.8,12,8,4,327.3816608407293,0.3941464237516869,0.018528156552513275,0.19354803788903924,131684.268904321,822.2029320987665,132506.47183641978,1413,39,517.6153846153846,38,1,13,35.002255299954896,0.6334978070175439,43.40277777777778,1026.3888888888891,27.010233918128662,0
1437,4,0,0,39,0.0,0.0,1.0,39,1000,700,300,0.7,13,7,6,326.8000486197329,0.3937528115159694,0.019148714746592077,0.19348254264861448,131739.10307774492,810.4690581854113,132549.57213593033,1414,40,518.6153846153846,38,1,13,34.96201477781247,0.634046052631579,43.34935897435898,1026.6025641025644,27.015856950067484,0
1438,4,0,0,39,0.0,0.0,1.0,39,1300,1100,200,0.8461538461538461,15,11,4,326.3484545477481,0.39307804768331084,0.016018306636155444,0.19391310519295743,131876.23844875448,807.52132186427,132683.75977061875,1415,41,519.6153846153846,38,1,14,34.83569967408639,0.6354166666666666,43.215811965811966,1027.1367521367522,27.02991452991453,0
1439,4,0,0,39,0.0,0.0,1.0,39,950,700,250,0.7368421052631579,12,7,5,321.4073845275451,0.3923470535312641,0.012891152926499672,0.19166879304218556,132013.44515897793,686.019226203513,132699.46438518146,1416,42,520.6153846153846,38,1,14,34.82473923138233,0.6367872807017544,43.082264957264954,1027.6709401709395,27.043972109761565,0
1440,4,0,0,39,0.0,0.0,1.0,39,1100,900,200,0.8181818181818182,13,9,4,323.54693202900984,0.3925157444894287,0.007480519480519643,0.19378588803853278,132178.18737900877,753.1694015267842,132931.35678053554,1417,43,521.6153846153846,38,1,14,34.604329004329,0.6384320175438596,42.92200854700855,1028.3119658119665,27.060841205578065,0
1441,4,0,0,39,0.0,0.0,1.0,39,1050,600,450,0.5714285714285714,15,6,9,324.7056996729457,0.39164417453891137,0.004984423676012373,0.19518825766856848,132315.55103550298,792.7227153188721,133108.27375082186,1418,44,522.6153846153846,38,1,15,34.43665628245067,0.6398026315789473,42.78846153846154,1028.846153846154,27.074898785425106,0
1442,4,0,0,39,0.0,0.0,1.0,39,950,600,350,0.631578947368421,13,6,7,325.0425457500469,0.3917847503373819,0.009136212624584639,0.19567561254152813,132370.51647308053,805.2099313317204,133175.72640441224,1419,45,523.6153846153846,38,1,15,34.37283707087485,0.6403508771929824,42.73504273504273,1029.0598290598286,27.080521817363913,0
1443,4,0,0,39,0.0,0.0,1.0,39,1050,900,150,0.8571428571428571,12,9,3,322.2563901845342,0.39119433198380565,0.01078299629641788,0.19443078348665854,132454.43309479835,736.8603481822802,133191.29344298065,1420,46,524.6153846153846,37,2,16,34.36035364294844,0.6430180180180181,42.65350877192982,1029.3859649122803,27.821242294926495,0
1444,4,0,0,39,0.0,0.0,1.0,39,1650,1200,450,0.7272727272727273,21,12,9,326.01683377041155,0.3908007197480882,0.01799647930568593,0.19773583946242837,132652.0314543898,849.3590575946386,133501.39051198444,1421,47,525.6153846153846,37,2,14,34.06543817633493,0.6449887387387387,42.46162280701754,1030.1535087719296,27.841986723565665,0
1445,4,0,0,39,0.0,0.0,1.0,39,900,700,200,0.7777777777777778,11,7,4,325.2092636178797,0.3906320287899235,0.01487812598923699,0.1973944600099222,132680.2718144044,829.7706986765118,133510.04251308093,1422,48,526.6153846153846,37,2,14,34.05793245352631,0.6452702702702702,42.43421052631579,1030.2631578947367,27.84495021337126,0
1446,4,0,0,39,0.0,0.0,1.0,39,1050,900,150,0.8571428571428571,12,9,3,326.8384769055878,0.3905757984705353,0.01569346451236231,0.19868227722889484,132736.76155163127,876.6961949830718,133613.45774661432,1423,49,527.6153846153846,37,2,14,33.959353053841234,0.6458333333333333,42.37938596491228,1030.482456140351,27.850877192982455,0
1447,4,0,0,39,0.0,0.0,1.0,39,1250,1000,250,0.8,15,10,5,324.6385974392208,0.3908850652271705,0.00800242200093293,0.19779179873792055,132821.51870046544,823.798308133263,133645.3170085987,1424,50,528.6153846153846,37,2,14,33.93111991632095,0.646677927927928,42.297149122807014,1030.8114035087713,27.859767662399225,0
1448,4,0,0,39,0.0,0.0,1.0,39,1150,700,450,0.6086956521739131,16,7,9,323.10988674625037,0.3900416104363473,0.006734006734006925,0.19745604190048632,132934.5703125,790.4947916666657,133725.06510416666,1425,51,529.6153846153846,37,2,14,33.85732323232323,0.6478040540540541,42.1875,1031.25,27.87162162162162,0
1449,4,0,0,39,0.0,0.0,1.0,39,850,500,350,0.5882352941176471,12,5,7,322.3618848049423,0.3897604588394062,0.005886970172684469,0.1974466544430273,133019.3905817175,776.076292705454,133795.46687442297,1426,52,530.6153846153846,37,2,14,33.79171981292516,0.6486486486486486,42.10526315789474,1031.5789473684215,27.88051209103842,0
1450,4,0,0,39,0.0,0.0,1.0,39,800,600,200,0.75,10,6,4,324.144157613879,0.3893106162843005,0.011045448724759988,0.19899025879349128,133104.23790252797,828.9922139504725,133933.23011647843,1427,53,531.6153846153846,37,2,16,33.66085343392484,0.6494932432432431,42.02302631578949,1031.9078947368441,27.889402560455245,0
1451,4,0,2,37,0.0,0.05128205128205128,0.9487179487179487,39,1250,1000,250,0.8,15,10,5,321.94103882207366,0.3886077372919478,0.00874218718084907,0.1982390373126113,133217.40974386354,777.6302564250595,133995.0400002886,1428,54,532.6153846153846,37,2,17,33.604509647725266,0.6506193693693694,41.91337719298246,1032.3464912280706,27.901256519677585,0
1452,4,0,0,37,0.0,0.0,1.0,37,700,500,200,0.7142857142857143,9,5,4,334.6948741172413,0.3867304804804805,0.00904944441748734,0.2048626866849487,132994.25582990394,1502.4991426611718,134496.7549725651,1429,55,541.081081081081,35,2,17,33.498840514661886,0.6523809523809523,42.129629629629626,1031.481481481481,29.470899470899457,0
1453,4,0,0,37,0.0,0.0,1.0,37,900,600,300,0.6666666666666666,12,6,6,333.7566049390544,0.3868556056056056,0.0022552835473426125,0.2049431053468738,133113.66705246907,1485.5131172839435,134599.180169753,1430,56,542.081081081081,35,2,18,33.403432032301474,0.6535714285714285,42.013888888888886,1031.9444444444441,29.484126984126974,0
1454,4,0,0,37,0.0,0.0,1.0,37,1350,900,450,0.6666666666666666,18,9,9,334.29990548774344,0.38710585585585583,4.847897224569131e-05,0.2059361296236653,133233.13185871064,1507.9646776406116,134741.09653635125,1431,57,543.081081081081,35,2,19,33.269805680119575,0.6547619047619048,41.89814814814815,1032.407407407408,29.497354497354518,0
1455,4,0,0,37,0.0,0.0,1.0,37,1250,700,550,0.56,18,7,11,333.6869377706379,0.38691816816816815,-0.0021803117845853315,0.2063998840303484,133384.9617142483,1501.7638838162734,134886.72559806457,1432,58,544.081081081081,36,1,20,33.13369853555726,0.654224537037037,41.75112612612614,1032.9954954954974,28.694319319319373,0
1456,4,0,0,37,0.0,0.0,1.0,37,700,400,300,0.5714285714285714,10,4,6,332.56596973599557,0.3855417917917918,0.00521775975303429,0.20652392974564962,133532.02830289782,1481.6702302746965,135013.69853317252,1433,59,545.081081081081,35,2,22,33.01558417319896,0.6577380952380951,41.6087962962963,1033.564814814815,29.530423280423285,0
1457,4,0,0,37,0.0,0.0,1.0,37,750,400,350,0.5333333333333333,11,4,7,330.5670361753339,0.3851976976976977,-0.0024264721454916316,0.20578085952294498,133621.76254125955,1434.1900023576952,135055.95254361726,1434,60,546.081081081081,35,2,22,32.97755979700736,0.6586309523809523,41.52199074074075,1033.912037037038,29.540343915343946,0
1458,4,0,0,37,0.0,0.0,1.0,37,1100,700,400,0.6363636363636364,15,7,8,330.82935727646947,0.3847284784784785,0.0037012845634660785,0.20673459020011228,133763.29665814483,1450.5650921191648,135213.86175026398,1435,61,547.081081081081,36,1,17,32.829396182596696,0.657986111111111,41.385135135135144,1034.459459459461,28.734984984985026,0
1459,4,1,1,37,0.02631578947368421,0.02631578947368421,0.9736842105263158,38,450,100,350,0.2222222222222222,8,1,7,322.69657702601154,0.3868984115694642,0.0037625837523271866,0.20285626366708415,133982.57757194538,1047.1438327177768,135029.72140466317,1436,0,533.6578947368421,37,1,17,32.82099484572479,0.6582207207207207,41.173245614035096,1035.3070175438609,27.981270744428674,0
1460,4,0,0,37,0.0,0.0,1.0,37,600,400,200,0.6666666666666666,8,4,4,331.402715144337,0.3846346346346346,0.010447273914463429,0.20758415470083946,133850.680811724,1471.6958089846785,135322.3766207087,1437,63,549.081081081081,36,1,17,32.72730982696704,0.6588541666666665,41.300675675675684,1034.7972972972982,28.744369369369394,0
1461,4,0,0,37,0.0,0.0,1.0,37,950,600,350,0.631578947368421,13,6,7,333.83860677275635,0.38416541541541543,0.009355961705831417,0.20960686294092756,133938.09349890446,1542.7413054947006,135480.83480439917,1438,64,550.081081081081,36,1,17,32.57701443284016,0.6597222222222221,41.216216216216225,1035.1351351351364,28.753753753753788,0
1462,4,0,1,36,0.0,0.02702702702702703,0.972972972972973,37,600,500,100,0.8333333333333334,7,5,2,333.2279469683376,0.3839777277277277,0.010007614489284888,0.2093892355762086,133967.2374020983,1528.3254961042392,135495.56289820254,1439,65,551.081081081081,36,1,17,32.56372602342362,0.660011574074074,41.188063063063076,1035.2477477477498,28.756881881881938,0
1463,4,0,0,36,0.0,0.0,1.0,36,900,600,300,0.6666666666666666,12,6,6,341.1616580772361,0.3820601851851852,0.020623742454728422,0.2146295494485904,134010.95920138902,1943.8802083333526,135954.83940972236,1440,66,565.0555555555555,35,1,18,32.314721663313215,0.6624999999999999,41.14583333333334,1035.4166666666679,29.583333333333368,0
1464,4,0,0,36,0.0,0.0,1.0,36,700,400,300,0.5714285714285714,10,4,6,342.6040669166847,0.3819444444444444,0.018056021156926505,0.21606510182081848,134100.85419077944,1988.699604552486,136089.5537953319,1441,67,566.0555555555555,35,1,18,32.18760476030842,0.663392857142857,41.059027777777786,1035.7638888888898,29.593253968253993,0
1465,4,0,0,36,0.0,0.0,1.0,36,600,200,400,0.3333333333333333,10,2,8,343.6379187660372,0.3814649470899471,0.02263926124515958,0.2172490571181899,134190.77932098787,2022.6080246913866,136213.38734567925,1442,68,567.0555555555555,35,1,19,32.07104557640751,0.6642857142857141,40.972222222222236,1036.111111111113,29.603174603174654,0
1466,4,0,0,36,0.0,0.0,1.0,36,1400,1200,200,0.8571428571428571,16,12,4,357.47313491100147,0.381547619047619,0.090950392452539,0.211225215631785,131663.90483276645,2220.9778124212717,133884.88264518772,1443,69,568.0555555555555,34,2,17,34.25066697598888,0.6412377450980392,43.42261904761905,1026.3095238095239,30.185574229691877,6
1467,4,0,0,36,0.0,0.0,1.0,36,550,300,250,0.5454545454545454,8,3,5,358.75249351335447,0.3812996031746032,0.09215443697002512,0.2121511659171564,131694.4515306122,2249.1425736961364,133943.59410430831,1444,70,569.0555555555555,34,2,17,34.18701190752339,0.6415441176470589,43.39285714285714,1026.4285714285709,30.189075630252084,0
1468,4,0,0,36,0.0,0.0,1.0,36,1000,700,300,0.7,13,7,6,357.51107853152536,0.38172949735449735,0.08592240513177263,0.21209701261436983,131816.67375283447,2225.184240362815,134041.85799319728,1445,71,570.0555555555555,34,2,17,34.095563799366246,0.6427696078431373,43.273809523809526,1026.904761904762,30.203081232493,0
1469,4,0,0,36,0.0,0.0,1.0,36,650,400,250,0.6153846153846154,9,4,5,355.4754907128302,0.3804232804232804,0.08646877698922362,0.21164023682480132,131951.69331114946,2181.1185860339274,134132.8118971834,1446,72,571.0555555555555,35,1,19,34.01170158837447,0.6419642857142858,43.1423611111111,1027.4305555555536,29.355158730158674,0
1470,4,0,0,36,0.0,0.0,1.0,36,1100,900,200,0.8181818181818182,13,9,4,359.22925077681595,0.3807208994708995,0.0844027918496002,0.21488440637376802,132130.12695312488,2293.001302083319,134423.1282552082,1447,73,572.0555555555555,35,1,19,33.73543566362714,0.64375,42.96874999999999,1028.124999999999,29.374999999999975,0
1471,4,1,0,37,0.02702702702702703,0.0,1.0,37,600,200,400,0.3333333333333333,10,2,8,349.50515316783424,0.3833208208208208,0.08335156420914536,0.21104201520874083,132484.9405993829,1860.833891323731,134345.77449070665,1448,0,557.5675675675676,36,1,20,33.628445635528344,0.6452546296296298,42.62387387387386,1029.5045045045026,28.597347347347295,0
1472,4,0,0,37,0.0,0.0,1.0,37,700,600,100,0.8571428571428571,8,6,2,349.44242700083777,0.3831644144144144,0.08987535534659985,0.2116556581026264,132600.90115453277,1867.276144387615,134468.17729892037,1449,1,558.5675675675676,36,1,20,33.513512282236306,0.6464120370370372,42.511261261261254,1029.9549549549538,28.609859859859828,0
1473,4,2,3,36,0.05128205128205128,0.07692307692307693,0.9230769230769231,39,550,300,250,0.5454545454545454,8,3,5,332.79032901277435,0.3900697255960414,0.08419179646523034,0.20374702768664116,133003.43940618343,1052.451671962857,134055.8910781463,1450,0,530.8717948717949,38,1,16,33.538753668220274,0.6466557017543861,42.12072649572648,1031.5170940170913,27.145186684660295,0
1474,4,0,0,36,0.0,0.0,1.0,36,1050,500,550,0.47619047619047616,16,5,11,357.7656233446355,0.38010912698412697,0.0882408031767441,0.21655772221228353,132576.73852237663,2286.27989969137,134863.018422068,1451,77,576.0555555555555,35,1,19,33.32349966284559,0.6482142857142856,42.53472222222223,1029.8611111111118,29.42460317460319,0
1475,4,0,0,36,0.0,0.0,1.0,36,1100,600,500,0.5454545454545454,16,6,10,360.55866298750334,0.38005952380952385,0.0919278732726656,0.2187684157635834,132666.15125868065,2366.786024305564,135032.9372829862,1452,78,577.0555555555555,35,1,18,33.16165318503539,0.6491071428571428,42.44791666666667,1030.2083333333342,29.434523809523835,0
1476,4,0,0,36,0.0,0.0,1.0,36,1100,800,300,0.7272727272727273,14,8,6,363.2757110987131,0.3796130952380952,0.09784290241285554,0.22129503987996846,132815.2394654492,2449.7101123113835,135264.9495777606,1453,79,578.0555555555555,35,1,18,32.94174339396661,0.6505952380952381,42.30324074074074,1030.7870370370367,29.451058201058192,0
1477,4,0,0,36,0.0,0.0,1.0,36,850,700,150,0.8235294117647058,10,7,3,358.192129547557,0.37862103174603173,0.0971224815479752,0.21924507270108698,132994.25582990394,2327.4991426611714,135321.7549725651,1454,80,579.0555555555555,35,1,19,32.89291591861162,0.6523809523809523,42.129629629629626,1031.481481481481,29.470899470899457,0
1478,4,0,0,36,0.0,0.0,1.0,36,1050,700,350,0.6666666666666666,14,7,7,359.7407962374503,0.37946428571428575,0.09742003414202594,0.22107571881801122,133143.5282305598,2379.431771905004,135522.96000246482,1455,81,580.0555555555555,35,1,19,32.70309988411648,0.6538690476190476,41.9849537037037,1032.060185185185,29.487433862433857,0
1479,4,0,0,36,0.0,0.0,1.0,36,950,500,450,0.5263157894736842,14,5,9,359.3838605240404,0.3793154761904762,0.09392127553562557,0.22138840026757178,133233.1318587105,2376.3674554183754,135609.49931412886,1456,82,581.0555555555555,35,1,20,32.6223841554559,0.6547619047619049,41.898148148148145,1032.407407407407,29.497354497354483,0
1480,4,0,0,36,0.0,0.0,1.0,36,700,500,200,0.7142857142857143,9,5,4,363.6605823849226,0.37838955026455023,0.09411574281587765,0.22474425465395054,133352.6502486281,2499.020490397785,135851.6707390259,1457,83,582.0555555555555,35,1,20,32.39205139698191,0.6559523809523811,41.7824074074074,1032.870370370369,29.510582010581974,0
1481,4,0,0,36,0.0,0.0,1.0,36,1200,900,300,0.75,15,9,6,366.805411030177,0.37761243386243387,0.09005376344086002,0.22741935483870956,133472.22222222207,2591.720250342916,136063.942472565,1458,84,583.0555555555555,34,2,20,32.19086021505376,0.6593137254901962,41.66666666666666,1033.3333333333321,30.39215686274506,0
1482,4,0,0,36,0.0,0.0,1.0,36,900,600,300,0.6666666666666666,12,6,6,364.96314737274764,0.37729828042328045,0.09055689917719212,0.22684144657391314,133564.5000708616,2549.2240646258433,136113.72413548746,1459,85,584.0555555555555,34,2,20,32.14590771238818,0.6602328431372548,41.57738095238095,1033.6904761904757,30.402661064425757,0
1483,4,0,0,36,0.0,0.0,1.0,36,650,300,350,0.46153846153846156,10,3,7,364.33822566783635,0.37743055555555555,0.08745922087890978,0.2268299275932011,133626.03635204068,2537.014597505646,136163.05094954633,1460,86,585.0555555555555,34,2,20,32.10036461331797,0.6608455882352942,41.51785714285713,1033.9285714285702,30.409663865546182,0
1484,4,0,0,36,0.0,0.0,1.0,36,750,700,50,0.9333333333333333,8,7,1,367.22531066749445,0.37840608465608466,0.09042485164722769,0.22919924562350494,133718.36734693867,2620.9537981859307,136339.3211451246,1461,87,586.0555555555555,34,2,16,31.933174109883357,0.661764705882353,41.42857142857142,1034.2857142857135,30.420168067226868,0
1485,4,0,0,36,0.0,0.0,1.0,36,850,700,150,0.8235294117647058,10,7,3,365.4815008459626,0.37908399470899473,0.09047993454275827,0.22868248551852122,133810.73022959175,2581.069302721076,136391.7995323128,1462,88,587.0555555555555,34,2,16,31.885715107582552,0.6626838235294118,41.33928571428571,1034.6428571428564,30.430672268907543,0
1486,4,1,1,36,0.02702702702702703,0.02702702702702703,0.972972972972973,37,750,600,150,0.8,9,6,3,357.88759332468607,0.3829767267267267,0.08508016286290787,0.22551959049783724,134070.88584533596,2196.4613340191877,136267.34717935516,1463,0,572.1621621621622,35,2,16,31.821822381165244,0.6630952380952382,41.087962962962955,1035.6481481481471,29.58994708994706,0
1487,4,0,0,36,0.0,0.0,1.0,36,500,400,100,0.8,6,4,2,366.3259419971473,0.37888558201058203,0.08917455935171303,0.22959418989049754,133872.3232001133,2608.1809807256104,136480.5041808389,1464,90,589.0555555555555,34,2,16,31.802168411365464,0.663296568627451,41.2797619047619,1034.8809523809518,30.437675070027996,0
1488,4,0,0,36,0.0,0.0,1.0,36,750,400,350,0.5333333333333333,11,4,7,367.13350214480954,0.37807539682539687,0.08546664622774092,0.2310656441140053,134026.36763038547,2641.1139455782286,136667.4815759637,1465,91,590.0555555555555,34,2,17,31.627002376025153,0.664828431372549,41.13095238095238,1035.4761904761904,30.45518207282913,0
1489,4,0,0,36,0.0,0.0,1.0,36,800,600,200,0.75,10,6,4,364.85403077307217,0.37817460317460316,0.08319677219118593,0.2302851604667837,134130.8258852022,2587.6344950274256,136718.46038022963,1466,92,591.0555555555555,35,1,17,31.581471135940404,0.6636904761904763,41.03009259259259,1035.8796296296289,29.596560846560823,0
1490,4,0,0,36,0.0,0.0,1.0,36,750,600,150,0.8,9,6,3,362.8213243715546,0.37799272486772484,0.0821851065678576,0.2291893912808598,134160.80092860502,2535.2798943329854,136696.080822938,1467,93,592.0555555555555,35,1,17,31.604127099392993,0.6639880952380952,41.001157407407405,1035.9953703703695,29.5998677248677,0
1491,4,0,0,36,0.0,0.0,1.0,36,1200,900,300,0.75,15,9,6,363.65748339688395,0.37782738095238094,0.08640424343941966,0.2304708254649041,134280.73459201385,2566.4388020833285,136847.1733940972,1468,94,593.0555555555555,35,1,17,31.46252093802345,0.6651785714285714,40.885416666666664,1036.458333333333,29.61309523809523,0
1492,4,0,1,35,0.0,0.027777777777777776,0.9722222222222222,36,800,600,200,0.75,10,6,4,365.478731064234,0.37817460317460316,0.09408722185011542,0.23219563637400062,134370.720003858,2621.928047839499,136992.6480516975,1469,95,594.0555555555555,35,1,18,31.32535164099129,0.6660714285714285,40.79861111111111,1036.8055555555552,29.623015873015863,0
1493,4,0,0,35,0.0,0.0,1.0,35,650,300,350,0.46153846153846156,10,3,7,371.5473126584214,0.3767156862745098,0.09045704439156554,0.23522322594120426,134242.17864229027,2975.4641439909374,137217.6427862812,1470,96,603.0285714285715,34,1,18,31.296668581275146,0.6669730392156863,40.92261904761905,1036.3095238095239,30.479691876750703,0
1494,4,0,0,35,0.0,0.0,1.0,35,650,400,250,0.6153846153846154,9,4,5,370.2918704314469,0.3764705882352941,0.09274230592558541,0.23502198306975527,134334.7222222223,2948.611111111116,137283.33333333343,1471,97,604.0285714285715,34,1,18,31.236602357984992,0.6678921568627452,40.833333333333336,1036.6666666666672,30.49019607843139,0
1495,4,0,0,35,0.0,0.0,1.0,35,900,500,400,0.5555555555555556,13,5,8,370.48485383732236,0.3757002801120448,0.0883713301623752,0.2355418304323414,134396.43565759627,2958.3687641723236,137354.8044217686,1472,98,605.0285714285715,34,1,18,31.16987179487179,0.6685049019607843,40.77380952380952,1036.904761904761,30.497198879551796,0
1496,4,0,0,35,0.0,0.0,1.0,35,300,100,200,0.3333333333333333,5,1,4,372.1813905127178,0.37556022408963585,0.08951571904160582,0.2368204596607952,134427.29768990932,3006.2677154195035,137433.56540532882,1473,99,606.0285714285715,34,1,18,31.09502353346344,0.6688112745098038,40.74404761904762,1037.0238095238096,30.50070028011205,0
1497,4,0,0,35,0.0,0.0,1.0,35,1300,1000,300,0.7692307692307693,16,10,6,371.12304640247726,0.37556022408963585,0.09110728628800935,0.23694779116465878,134550.78125000012,2986.9791666666806,137537.7604166668,1474,100,607.0285714285715,34,1,19,30.99899598393574,0.6700367647058822,40.62500000000001,1037.500000000001,30.514705882352967,0
1498,4,0,0,35,0.0,0.0,1.0,35,800,500,300,0.625,11,5,6,373.88802327858053,0.3753501400560224,0.08899684563871602,0.23933920401710507,134646.15660142738,3068.517066753183,137714.67366818056,1475,101,608.0285714285715,33,2,19,30.831931160703743,0.6732954545454545,40.53308823529412,1037.867647058824,31.450534759358305,0
1499,4,0,0,35,0.0,0.0,1.0,35,1100,800,300,0.7272727272727273,14,8,6,372.13619623812275,0.3752801120448179,0.08285073443850477,0.23863480078222096,134709.75894187336,3026.0754577566413,137735.83439963,1476,102,609.0285714285715,33,2,20,30.813830519812708,0.6739267676767677,40.4718137254902,1038.1127450980396,31.457961972667867,0
1500,4,0,0,35,0.0,0.0,1.0,35,1250,900,350,0.72,16,9,7,377.0045836801114,0.37514005602240896,0.08143228025220028,0.24239278012938273,134805.19061178397,3164.4349529027354,137969.6255646867,1477,103,610.0285714285715,33,2,14,30.592105263157908,0.6748737373737373,40.379901960784316,1038.480392156863,31.469102792632214,0
1501,4,0,1,34,0.0,0.02857142857142857,0.9714285714285714,35,700,500,200,0.7142857142857143,9,5,4,375.79944238079685,0.37461484593837535,0.07872985909795749,0.24204225483431843,134868.83049788533,3136.7262591310923,138005.55675701643,1478,104,611.0285714285715,33,2,15,30.55981595092024,0.6755050505050505,40.31862745098039,1038.7254901960775,31.476530005941743,0
1502,4,0,0,34,0.0,0.0,1.0,34,700,500,200,0.7142857142857143,9,5,4,384.4854061868893,0.37433155080213903,0.07731184411013592,0.246809016008961,134747.3492022498,3561.677858126725,138309.02706037654,1479,105,621.2352941176471,32,2,20,30.455733917061906,0.6767578125,40.43560606060606,1038.257575757576,32.44554924242425,0
1503,4,0,0,34,0.0,0.0,1.0,34,1100,1000,100,0.9090909090909091,12,10,2,381.55968268138116,0.3740530303030303,0.09169042066165667,0.23409202153695552,133081.09504132232,3355.6760789715354,136436.77112029385,1480,106,622.2352941176471,32,2,18,32.20294909446892,0.66015625,42.04545454545455,1031.818181818182,32.24431818181819,3
1504,4,1,1,34,0.02857142857142857,0.02857142857142857,0.9714285714285714,35,850,600,250,0.7058823529411765,11,6,5,375.2472265139619,0.37906162464985993,0.0854803437929108,0.23166361742367425,133313.97667063138,3005.1400002402784,136319.11667087165,1481,0,605.4285714285714,33,2,18,32.131714528697444,0.6600378787878789,41.819852941176464,1032.7205882352932,31.29456327985737,0
1505,4,0,0,34,0.0,0.0,1.0,34,750,500,250,0.6666666666666666,10,5,5,381.55159758796947,0.3734402852049911,0.08684689480537244,0.23511284201031082,133243.99495268328,3367.8918286399203,136611.8867813232,1482,108,624.2352941176471,32,2,18,32.039307406954464,0.6617838541666667,41.887626262626256,1032.449494949494,32.26404671717169,0
1506,4,0,0,34,0.0,0.0,1.0,34,600,400,200,0.6666666666666666,8,4,4,381.55159758796947,0.3734402852049911,0.08684689480537244,0.23511284201031082,133243.99495268328,3367.8918286399203,136611.8867813232,1483,109,625.2352941176471,32,2,18,32.039307406954464,0.6617838541666667,41.887626262626256,1032.449494949494,32.26404671717169,0
1507,4,0,0,34,0.0,0.0,1.0,34,400,100,300,0.25,7,1,6,380.8681273075394,0.37280897207367797,0.08521427646627266,0.2348974015928398,133276.58689164364,3352.160812672167,136628.7477043158,1484,110,626.2352941176471,32,2,18,32.02418072878454,0.662109375,41.8560606060606,1032.575757575757,32.26799242424241,0
1508,4,0,0,34,0.0,0.0,1.0,34,650,500,150,0.7692307692307693,8,5,3,379.84923502423703,0.37301322043969104,0.08737944376919349,0.23447448251043276,133309.18281616672,3327.4782228854165,136636.66103905212,1485,111,627.2352941176471,32,2,18,32.0177181399519,0.6624348958333334,41.82449494949495,1032.70202020202,32.27193813131313,0
1509,4,0,0,34,0.0,0.0,1.0,34,850,600,250,0.7058823529411765,11,6,5,383.96542257819476,0.3726047237076649,0.08696261783041082,0.23743167967590412,133374.38662190078,3442.230544077127,136816.6171659779,1486,112,628.2352941176471,32,2,18,31.84589292262559,0.6630859375,41.76136363636363,1032.954545454545,32.27982954545453,0
1510,4,0,0,34,0.0,0.0,1.0,34,500,200,300,0.4,8,2,6,383.89203670755796,0.3724376114081997,0.08960127683437125,0.23759490501824782,133406.99450311178,3442.776566166702,136849.77106927847,1487,113,629.2352941176471,32,2,18,31.815010592357204,0.6634114583333335,41.72979797979797,1033.080808080807,32.28377525252522,0
1511,4,0,0,34,0.0,0.0,1.0,34,800,400,400,0.5,12,4,8,382.7234079464343,0.37182486631016043,0.08452783825146049,0.2379162141881135,133570.09369260777,3424.080291551865,136994.17398415963,1488,114,630.2352941176471,32,2,19,31.68132405032368,0.6650390625,41.57196969696969,1033.71212121212,32.30350378787875,0
1512,4,0,0,34,0.0,0.0,1.0,34,550,500,50,0.9090909090909091,6,5,1,381.64204537830943,0.3721776589423648,0.07868993751346709,0.23787278170839818,133668.0010330578,3402.6658631772243,137070.66689623502,1489,115,631.2352941176471,32,2,20,31.61095848595849,0.666015625,41.47727272727273,1034.0909090909088,32.3153409090909,0
1513,4,0,0,34,0.0,0.0,1.0,34,750,500,250,0.6666666666666666,10,5,5,380.2770012932066,0.3711378490790256,0.0683857628968112,0.2378618128699643,133798.5999515355,3376.106073359852,137174.70602489533,1490,116,632.2352941176471,32,2,14,31.515183874379616,0.6673177083333334,41.3510101010101,1034.5959595959591,32.33112373737372,0
1514,4,0,0,34,0.0,0.0,1.0,34,750,300,450,0.4,12,3,9,380.07296968605016,0.37100787284610814,0.07078562968811708,0.23794484236647692,133831.2596450618,3373.128858024702,137204.3885030865,1491,117,633.2352941176471,32,2,15,31.48769574944071,0.6676432291666666,41.31944444444445,1034.7222222222229,32.335069444444464,0
1515,4,0,0,34,0.0,0.0,1.0,34,350,200,150,0.5714285714285714,5,2,3,380.07296968605016,0.37100787284610814,0.07078562968811708,0.23794484236647692,133831.2596450618,3373.128858024702,137204.3885030865,1492,118,634.2352941176471,32,2,15,31.48769574944071,0.6676432291666666,41.31944444444445,1034.7222222222229,32.335069444444464,0
1516,4,0,0,34,0.0,0.0,1.0,34,900,600,300,0.6666666666666666,12,6,6,385.66015674651936,0.37150920974450385,0.05559293052460457,0.23156161342848955,132271.91014273363,3402.4011197616387,135674.31126249526,1493,119,635.2352941176471,33,1,18,32.9128941307283,0.649621212121212,42.83088235294118,1028.6764705882358,31.17201426024957,5
1517,4,0,0,34,0.0,0.0,1.0,34,750,600,150,0.8,9,6,3,389.2974360416606,0.3711192810457516,0.05762912524781272,0.23433194053346423,132366.4745080018,3505.985828767787,135872.46033676958,1494,120,636.2352941176471,33,1,19,32.72386467389148,0.6505681818181819,42.7389705882353,1029.0441176470592,31.183155080213915,0
1518,4,0,0,34,0.0,0.0,1.0,34,800,300,500,0.375,13,3,10,389.89115646258534,0.3701351752822341,0.04966386554621849,0.235279146141215,132461.07266435976,3529.080161476343,135990.1528258361,1495,121,637.2352941176471,33,1,20,32.61309523809525,0.6515151515151516,42.647058823529406,1029.4117647058815,31.19429590017823,0
1519,4,0,0,34,0.0,0.0,1.0,34,450,300,150,0.6666666666666666,6,3,3,389.89115646258534,0.3703394236482472,0.04966386554621849,0.235279146141215,132461.07266435976,3529.080161476343,135990.1528258361,1496,122,638.2352941176471,33,1,20,32.61309523809525,0.6515151515151516,42.647058823529406,1029.4117647058815,31.19429590017823,0
1520,4,0,1,33,0.0,0.029411764705882353,0.9705882352941176,34,700,400,300,0.5714285714285714,10,4,6,390.72213843146,0.36972667855020797,0.05170072313109486,0.23637423536641866,132555.70461180783,3558.489673442892,136114.19428525073,1497,123,639.2352941176471,33,1,20,32.49620671188862,0.6524621212121213,42.55514705882352,1029.779411764705,31.205436720142576,0
1521,4,0,0,33,0.0,0.0,1.0,33,450,300,150,0.6666666666666666,6,3,3,401.54581380047244,0.3675031565656566,0.07856813400681717,0.22803174429526477,130133.72559241408,3854.0881388076464,133987.81373122171,1498,124,649.0,32,1,19,34.675215526131254,0.6305338541666666,44.917929292929294,1020.3282828282831,31.885258838383848,8
1522,4,2,1,34,0.05714285714285714,0.02857142857142857,0.9714285714285714,35,550,400,150,0.7272727272727273,7,4,3,385.1758359548501,0.3783263305322129,0.075959811032005,0.2217084503472018,130657.8514739228,3065.249433106563,133723.10090702935,1499,0,612.8571428571429,34,1,15,34.55985095482068,0.6311274509803921,44.4047619047619,1022.3809523809515,30.070028011204457,0
1523,4,1,2,33,0.02857142857142857,0.05714285714285714,0.9428571428571428,35,750,400,350,0.5333333333333333,11,4,7,389.11493200624534,0.37822128851540615,0.06780269654702376,0.22485975862338026,130810.03578514735,3180.027636054419,133990.06342120178,1500,0,613.8285714285714,34,1,15,34.30456961092362,0.6326593137254901,44.25595238095238,1022.9761904761901,30.087535014005592,0
1524,4,0,0,33,0.0,0.0,1.0,33,600,600,0,1.0,6,6,0,404.263354093476,0.3721590909090909,0.10863294009361413,0.23303408575110776,130714.10323245086,3968.584360014296,134682.68759246514,1501,2,648.2121212121212,32,1,16,34.01474461867721,0.6363932291666666,44.34974747474748,1022.6010101010108,31.95628156565659,0
1525,4,0,0,33,0.0,0.0,1.0,33,950,800,150,0.8421052631578947,11,8,3,409.1982981001121,0.3721590909090909,0.10708915868135827,0.2364710849648437,130810.95838434855,4105.524308744006,134916.48269309255,1502,3,649.2121212121212,32,1,16,33.79001069694724,0.6373697916666667,44.255050505050505,1022.9797979797981,31.968118686868692,0
1526,4,1,1,33,0.029411764705882353,0.029411764705882353,0.9705882352941176,34,500,300,200,0.6,7,3,4,399.3071826918957,0.37659685086155675,0.09548615999774746,0.23235451382823682,131077.01965590162,3667.9990868896675,134745.0187427913,1503,0,631.0882352941177,33,1,18,33.772638423488125,0.6376262626262625,43.99509803921569,1024.0196078431377,31.030897207367808,0
1527,4,0,0,33,0.0,0.0,1.0,33,600,400,200,0.6666666666666666,8,4,4,408.72782849711956,0.37121212121212116,0.10529975884695153,0.2367933559663441,130907.84940631052,4101.136204213843,135008.98561052437,1504,5,651.2121212121212,32,1,18,33.70347522105696,0.6383463541666667,44.16035353535353,1023.3585858585853,31.979955808080792,0
1528,4,0,0,33,0.0,0.0,1.0,33,850,700,150,0.8235294117647058,10,7,3,412.47183739789125,0.3712515782828283,0.10745840247566929,0.23956458865487837,131004.77629833682,4207.156157534934,135211.93245587175,1505,6,652.2121212121212,32,1,18,33.509085676697914,0.6393229166666667,44.06565656565656,1023.737373737373,31.991792929292906,0
1529,4,0,0,33,0.0,0.0,1.0,33,1200,1000,200,0.8333333333333334,14,10,4,413.4489557438467,0.371133207070707,0.10729334767796317,0.24094094317486237,131134.06795224984,4243.4486914600675,135377.5166437099,1506,7,653.2121212121212,32,1,18,33.35259492110455,0.640625,43.939393939393945,1024.2424242424247,32.00757575757577,0
1530,4,0,0,33,0.0,0.0,1.0,33,650,400,250,0.6153846153846154,9,4,5,413.0880026637182,0.3714488636363636,0.10571137232051808,0.24093335482464048,131166.40082963486,4236.65330706052,135403.05413669537,1507,8,654.2121212121212,32,1,19,33.32896791158223,0.6409505208333333,43.90782828282829,1024.368686868688,32.0115214646465,0
1531,4,0,0,33,0.0,0.0,1.0,33,950,700,250,0.7368421052631579,12,7,5,413.11388723643336,0.3701862373737374,0.11160384331116036,0.24196670538133958,131328.1250000001,4250.694444444459,135578.81944444455,1508,9,655.2121212121212,32,1,19,33.1639566395664,0.642578125,43.75000000000001,1025.0000000000007,32.03125000000002,0
1532,4,0,0,33,0.0,0.0,1.0,33,800,600,200,0.75,10,6,4,413.2260216679265,0.37010732323232326,0.1095526695526694,0.2426662878922387,131428.24172973633,4261.9138929578985,135690.15562269423,1509,10,656.2121212121212,31,2,20,33.059391534391544,0.6461693548387097,43.65234375,1025.390625,33.07711693548387,0
1533,4,1,0,34,0.029411764705882353,0.0,1.0,34,1100,700,400,0.6363636363636364,15,7,8,401.8012117358958,0.3752970885323827,0.10441965695043698,0.23945296093855625,131988.41979346887,3806.6214016243803,135795.04119509325,1510,0,637.8823529411765,33,1,16,32.784610415424375,0.646780303030303,43.106617647058826,1027.5735294117649,31.13859180035651,0
1534,4,0,0,34,0.0,0.0,1.0,34,550,400,150,0.7272727272727273,7,4,3,406.2759638586856,0.3752970885323827,0.10827330813093106,0.2425221714507327,132051.39136690204,3929.861261293722,135981.25262819577,1511,1,638.8823529411765,33,1,16,32.60589304876594,0.6474116161616161,43.045343137254896,1027.8186274509796,31.14601901366605,0
1535,4,0,0,34,0.0,0.0,1.0,34,1050,700,350,0.6666666666666666,14,7,7,402.41717680848524,0.3738302139037433,0.11058487234817704,0.2420268349916934,132334.9492983467,3850.7713379469355,136185.72063629364,1512,2,639.8823529411765,33,1,17,32.418215023026846,0.6502525252525253,42.76960784313725,1028.9215686274504,31.179441473559102,0
1536,4,0,0,34,0.0,0.0,1.0,34,800,500,300,0.625,11,5,6,404.3665688668888,0.37277183600713015,0.11443200762086292,0.24360620124419868,132398.00347222213,3907.4802960399743,136305.48376826211,1513,3,640.8823529411765,32,2,17,32.30431848852903,0.6533203125,42.70833333333333,1029.1666666666658,32.16145833333331,0
1537,4,0,0,34,0.0,0.0,1.0,34,1150,900,250,0.782608695652174,14,9,5,402.5193749089931,0.372140522875817,0.10881956118642755,0.24291195141621155,132462.98408644515,3863.7835106111493,136326.7675970563,1514,4,641.8823529411765,32,2,18,32.28617277893618,0.6539713541666667,42.645202020202014,1029.419191919191,32.16934974747472,0
1538,4,0,0,34,0.0,0.0,1.0,34,850,600,250,0.7058823529411765,11,6,5,411.80117141156285,0.372140522875817,0.10973973995629893,0.24937358242049887,132592.9931416438,4120.389979338851,136713.38312098265,1515,5,642.8823529411765,32,2,18,31.91583915655266,0.6552734375,42.5189393939394,1029.924242424243,32.18513257575759,0
1539,4,1,0,35,0.02857142857142857,0.0,1.0,35,1200,900,300,0.75,15,9,6,403.0906737698335,0.3772408963585434,0.10674494765241893,0.24716827257598148,133060.97902549486,3727.1279375720696,136788.10696306694,1516,0,625.4857142857143,33,2,15,31.66782971057528,0.6575126262626263,42.06495098039215,1031.7401960784302,31.2648544266191,0
1540,4,0,0,35,0.0,0.0,1.0,35,950,700,250,0.7368421052631579,12,7,5,419.4663708550123,0.37710084033613445,0.2120460340431396,0.23188100980865092,129076.8274221454,3829.3121936274606,132906.13961577287,1517,1,626.4857142857143,33,2,17,35.29958594629362,0.6174242424242424,45.95588235294118,1016.1764705882359,30.793226381461693,7
1541,4,2,0,37,0.05405405405405406,0.0,1.0,37,800,400,400,0.5,12,4,8,408.93433032908035,0.3901088588588589,0.22228537685950966,0.23011630067630504,129776.92920918373,3214.1084007132326,132991.03760989697,1518,0,593.5675675675676,34,3,17,34.850985317599395,0.6222426470588235,45.267857142857146,1018.9285714285718,29.968487394957993,0
1542,4,0,0,37,0.0,0.0,1.0,37,900,700,200,0.7777777777777778,11,7,4,411.39419004998103,0.3902027027027027,0.22067826882179098,0.23210433259258056,129878.87577428416,3286.2829807527473,133165.15875503691,1519,1,594.5675675675676,35,2,17,34.684176412702016,0.6211309523809523,45.167824074074076,1019.3287037037039,29.123677248677254,0
1543,4,0,1,36,0.0,0.02702702702702703,0.972972972972973,37,1000,600,400,0.6,14,6,8,409.7928736507369,0.3894519519519519,0.22108003839536838,0.23225109938803512,130055.90284475745,3259.1964323988464,133315.0992771563,1520,2,595.5675675675676,35,2,17,34.54425753621546,0.6229166666666666,44.99421296296297,1020.0231481481487,29.143518518518533,0
1544,4,1,0,37,0.02702702702702703,0.0,1.0,37,1150,800,350,0.6956521739130435,15,8,7,411.7833104956846,0.38795045045045046,0.23473210881395556,0.23498772149843566,130323.35778061229,3333.160840371393,133656.5186209837,1521,0,596.2702702702703,34,3,18,34.22063852940033,0.6277573529411764,44.73214285714286,1021.071428571429,30.03151260504203,0
1545,4,2,1,38,0.05128205128205128,0.02564102564102564,0.9743589743589743,39,900,600,300,0.6666666666666666,12,6,6,395.5335560081055,0.3945681511470985,0.22727721835946002,0.2283935975347504,130780.41459956583,2545.6084885561304,133326.02308812196,1522,0,566.6410256410256,36,3,19,34.17052001908327,0.6281828703703705,44.28490990990991,1022.8603603603608,28.4127877877878,0
1546,4,0,0,38,0.0,0.0,1.0,38,1150,800,350,0.6956521739130435,15,8,7,402.328981568998,0.3923215979137032,0.2296195652173909,0.23133916440217384,130617.28395061727,2910.2237654320948,133527.50771604938,1523,1,582.5526315789474,35,3,19,34.16270380434782,0.6285714285714286,44.44444444444444,1022.2222222222222,29.206349206349206,0
1547,4,0,0,38,0.0,0.0,1.0,38,1100,700,400,0.6363636363636364,15,7,8,404.3039476358571,0.3926475817923187,0.22483653124665026,0.23354498622259484,130794.81336805537,2976.1718749999754,133770.98524305536,1524,2,583.5526315789474,35,3,19,33.93160217243718,0.6303571428571428,44.27083333333332,1022.9166666666652,29.226190476190432,0
1548,4,0,0,38,0.0,0.0,1.0,38,1200,1000,200,0.8333333333333334,14,10,4,403.51995183681277,0.3920993361782836,0.22829728362738333,0.23434891490457038,131002.08340031285,2972.3908768432666,133974.4742771561,1525,3,584.5526315789474,35,3,19,33.74093178820424,0.6324404761904763,44.06828703703703,1023.7268518518513,29.24933862433861,0
1549,4,1,0,39,0.02564102564102564,0.0,1.0,39,900,500,400,0.5555555555555556,13,5,8,395.0682207862997,0.3962269455690508,0.22744753323810585,0.23122288600489463,131299.269603218,2574.4337665367984,133873.7033697548,1526,0,570.5384615384615,36,3,20,33.655642237116794,0.6333912037037037,43.77815315315315,1024.8873873873868,28.469094094094075,0
1550,4,0,1,38,0.0,0.02564102564102564,0.9743589743589743,39,1100,800,300,0.7272727272727273,14,8,6,395.7956418386456,0.3960582546108862,0.22623033766388434,0.23274945081501236,131480.69905045346,2607.903874813863,134088.60292526733,1527,1,571.5384615384615,34,5,20,33.45303733797641,0.6393995098039216,43.601190476190474,1025.5952380952376,30.164565826330517,0
1551,4,0,0,38,0.0,0.0,1.0,38,900,700,200,0.7777777777777778,11,7,4,395.96301268261476,0.3952110004741584,0.2131953045916668,0.233258717745684,131548.0392907776,2817.6315900134628,134365.67088079106,1528,2,567.1052631578947,33,5,21,33.38049516186836,0.642361111111111,43.53553921568628,1025.8578431372553,31.086601307189554,0
1552,4,0,0,38,0.0,0.0,1.0,38,600,300,300,0.5,9,3,6,396.87041805905915,0.3953591749644381,0.21296552417833858,0.23398585492890453,131579.4706362938,2843.9999038831284,134423.4705401769,1529,3,568.1052631578947,33,5,17,33.32537028189201,0.6426767676767677,43.504901960784316,1025.9803921568632,31.090314913844338,0
1553,4,0,0,38,0.0,0.0,1.0,38,1050,800,250,0.7619047619047619,13,8,5,394.43155452436207,0.3953888098624941,0.20942728049822934,0.23287671232876722,131633.36167800456,2784.0702947845884,134417.43197278914,1530,4,569.1052631578947,34,4,17,33.33333333333334,0.6409313725490196,43.452380952380956,1026.1904761904764,30.18207282913166,0
1554,4,0,0,38,0.0,0.0,1.0,38,950,500,450,0.5263157894736842,14,5,9,396.26605629241425,0.39608522996680895,0.20946123281065976,0.23452314367944313,131725.00177154187,2839.6293934240275,134564.6311649659,1531,5,570.1052631578947,34,4,17,33.193445823186046,0.6418504901960784,43.363095238095234,1026.5476190476184,30.192577030812306,0
1555,4,0,1,37,0.0,0.02631578947368421,0.9736842105263158,38,900,800,100,0.8888888888888888,10,8,2,399.23088342917146,0.3957592460881934,0.20957764179778327,0.23703818522666598,131847.23816609953,2927.4978741496343,134774.73604024918,1532,6,571.1052631578947,34,4,18,32.993557049573035,0.643075980392157,43.244047619047606,1027.0238095238076,30.206582633053163,0
1556,4,0,0,37,0.0,0.0,1.0,37,850,800,50,0.9411764705882353,9,8,1,403.41387414169697,0.3905467967967968,0.2178065789834478,0.2390570793260514,131773.38023244584,3231.841965663565,135005.2221981094,1533,11,587.3783783783783,35,2,18,32.960982414609404,0.6401785714285715,43.315972222222214,1026.73611111111,29.335317460317427,0
1557,4,0,0,37,0.0,0.0,1.0,37,600,300,300,0.5,9,3,6,404.35790471015275,0.39048423423423423,0.21755035775096698,0.2399911497319853,131832.80452942796,3261.5273223165086,135094.33185174447,1534,12,588.3783783783783,35,2,19,32.876540253202585,0.6407738095238096,43.25810185185184,1026.967592592591,29.341931216931172,0
1558,4,0,0,37,0.0,0.0,1.0,37,1000,500,500,0.5,15,5,10,403.42565621710736,0.38957707707707706,0.21822543426508334,0.2403767097916424,131981.42387902917,3248.9385073730828,135230.36238640227,1535,13,589.3783783783783,35,2,19,32.749962454006145,0.6422619047619049,43.11342592592591,1027.5462962962938,29.358465608465536,0
1559,4,0,0,37,0.0,0.0,1.0,37,950,800,150,0.8421052631578947,11,8,3,403.1489640558983,0.38942067067067065,0.22572938888669114,0.24077780428920167,132070.6356765473,3248.8279910407887,135319.4636675881,1536,14,590.3783783783783,35,2,19,32.666765191607546,0.643154761904762,43.02662037037036,1027.893518518517,29.368386243386205,0
1560,4,0,0,37,0.0,0.0,1.0,37,1000,800,200,0.8,12,8,4,403.9625946368422,0.38826326326326327,0.23178451383291043,0.24202344257237618,132189.6316256214,3279.9333151148635,135469.56494073628,1537,15,591.3783783783783,35,2,19,32.52544081785779,0.6443452380952381,42.91087962962962,1028.3564814814802,29.381613756613717,0
1561,4,0,0,37,0.0,0.0,1.0,37,900,600,300,0.6666666666666666,12,6,6,402.4708947377084,0.3876689189189189,0.23179399872313344,0.24208161395251834,132338.45191400862,3252.4750300068276,135590.92694401546,1538,16,592.3783783783783,35,2,19,32.41329208848894,0.6458333333333335,42.76620370370369,1028.935185185183,29.398148148148085,0
1562,4,1,0,38,0.02631578947368421,0.0,1.0,38,850,600,250,0.7058823529411765,11,6,5,397.8855407550433,0.39103247984826933,0.2339923612671313,0.24160825946803494,132695.96220207462,2959.5743312757045,135655.53653335033,1539,0,577.7631578947369,35,3,17,32.170205197333935,0.649404761904762,42.418981481481474,1030.324074074073,29.437830687830658,0
1563,4,0,0,38,0.0,0.0,1.0,38,1050,700,350,0.6666666666666666,14,7,7,395.9547756040099,0.38989153627311524,0.22876948715827328,0.24120199942060902,132815.23946544886,2917.765667866899,135733.00513331575,1540,1,578.7631578947369,35,3,17,32.09961449210269,0.6505952380952382,42.30324074074072,1030.787037037034,29.451058201058114,0
1564,4,1,0,39,0.02564102564102564,0.0,1.0,39,550,200,350,0.36363636363636365,9,2,7,385.1409770854331,0.3913067926225821,0.2240238865823232,0.23661533135300847,133132.52635426258,2454.958256386552,135587.48461064912,1541,0,564.8974358974359,37,2,18,32.05880790480238,0.6497747747747749,41.995614035087705,1032.017543859647,27.89236605026073,0
1565,4,0,1,38,0.0,0.02564102564102564,0.9743589743589743,39,550,300,250,0.5454545454545454,8,3,5,385.3994562537343,0.3909131803868646,0.2222258522959315,0.2378566237875271,133302.32018505665,2474.9283433363807,135777.24852839304,1542,1,565.8974358974359,37,2,19,31.88132653783535,0.6514639639639641,41.83114035087718,1032.675438596489,27.910146989094294,0
1566,4,0,0,38,0.0,0.0,1.0,38,1000,600,400,0.6,14,6,8,388.875890190993,0.3890913940256045,0.20846671944740858,0.24072519680244003,133414.045379839,2776.3011322132566,136190.34651205226,1542,2,541.2105263157895,36,2,20,31.679202092871137,0.6545138888888891,41.722972972972954,1033.1081081081056,28.697447447447377,0
1567,4,0,0,38,0.0,0.0,1.0,38,900,700,200,0.7777777777777778,11,7,4,388.08823289207027,0.3891062114746325,0.20737415746450627,0.24042603219343273,133443.13221583044,2757.541874644887,136200.67409047534,1543,3,542.2105263157895,36,2,20,31.670299727520426,0.6548032407407409,41.694819819819806,1033.2207207207189,28.700575575575524,0
1568,4,0,0,38,0.0,0.0,1.0,38,900,600,300,0.6666666666666666,12,6,6,388.6850403615046,0.38857278330962547,0.20715917976445208,0.24158569831488494,133564.5000708616,2782.9109609816596,136347.41103184325,1544,4,543.2105263157895,34,4,21,31.532880340895996,0.6602328431372548,41.57738095238095,1033.6904761904757,30.402661064425757,0
1569,4,0,0,38,0.0,0.0,1.0,38,850,600,250,0.7058823529411765,11,6,5,388.6850403615046,0.38857278330962547,0.20715917976445208,0.24158569831488494,133564.5000708616,2782.9046201814,136347.404691043,1545,5,544.2105263157895,34,4,21,31.532880340895996,0.6602328431372548,41.57738095238095,1033.6904761904757,30.402661064425757,0
1570,4,0,0,38,0.0,0.0,1.0,38,1100,700,400,0.6363636363636364,15,7,8,387.96273118322125,0.38830606922712185,0.20382395163879363,0.24234422510790846,133749.15143140577,2777.9372165532773,136527.08864795906,1546,6,545.2105263157895,34,4,18,31.36604710937201,0.6620710784313726,41.39880952380952,1034.404761904761,30.42366946778709,0
1571,4,0,0,38,0.0,0.0,1.0,38,1000,700,300,0.7,13,7,6,386.3032348111902,0.38765410146989093,0.204955949081022,0.2424357774678224,133921.09435281617,2746.8303915894853,136667.92474440567,1547,7,546.2105263157895,35,3,18,31.236372022811132,0.6616071428571428,41.23263888888888,1035.069444444443,29.573412698412657,0
1572,4,0,0,38,0.0,0.0,1.0,38,550,300,250,0.5454545454545454,8,3,5,385.9065445907089,0.3871206733048838,0.21025859786414003,0.2425814505526275,133981.00090288484,2740.829019847381,136721.82992273223,1548,8,547.2105263157895,35,3,18,31.186533445127626,0.662202380952381,41.17476851851851,1035.3009259259252,29.580026455026434,0
1573,4,0,0,38,0.0,0.0,1.0,38,850,600,250,0.7058823529411765,11,6,5,383.20657587797456,0.38694286391654814,0.20666439206320208,0.24127721564955937,134040.92084887257,2673.0724612054128,136713.993310078,1549,9,548.2105263157895,35,3,18,31.19632744681643,0.662797619047619,41.116898148148145,1035.5324074074072,29.586640211640205,0
1574,4,0,0,38,0.0,0.0,1.0,38,1150,1000,150,0.8695652173913043,13,10,3,379.7755405278681,0.38620199146514933,0.20656507587848005,0.24015908923690124,134200.5027620525,2593.21369511402,136793.7164571665,1550,10,549.2105263157895,36,2,19,31.125240010143813,0.662326388888889,40.96283783783783,1036.1486486486478,28.781906906906883,0
1575,4,0,0,38,0.0,0.0,1.0,38,800,600,200,0.75,10,6,4,372.5860890257594,0.38620199146514933,0.1855795044417714,0.2225243481262787,132070.63567654727,2265.441141353263,134336.07681790052,1551,11,550.2105263157895,35,3,18,33.452149720376845,0.643154761904762,43.02662037037036,1027.8935185185169,29.368386243386198,7
1576,4,0,0,38,0.0,0.0,1.0,38,950,400,550,0.42105263157894735,15,4,11,374.33956531156304,0.38661688003793265,0.18916973284274508,0.22392312179546214,132130.12695312488,2292.306857638874,134422.43381076376,1552,12,551.2105263157895,35,3,19,33.347053360351225,0.64375,42.96874999999999,1028.124999999999,29.374999999999975,0
1577,4,0,0,38,0.0,0.0,1.0,38,1600,1300,300,0.8125,19,13,6,387.7104603823451,0.3868391417733523,0.16024093667516426,0.22444876031563527,130878.9483302553,2548.6274622960727,133427.57579255136,1553,13,552.2105263157895,37,1,15,34.27052078868409,0.6272522522522523,44.18859649122806,1023.2456140350864,27.655286865813146,3
1578,4,1,1,38,0.02564102564102564,0.02564102564102564,0.9743589743589743,39,1200,1000,200,0.8333333333333334,14,10,4,384.02707025588234,0.3909131803868646,0.1577551402368924,0.22428864821887393,131218.63928153983,2278.301921250627,133496.94120279045,1554,0,539.025641025641,38,1,16,34.02024678484532,0.6288377192982457,43.8568376068376,1024.5726495726487,26.96243814664865,0
1579,4,0,0,38,0.0,0.0,1.0,38,950,600,350,0.631578947368421,13,6,7,393.5502467137497,0.38543148411569467,0.16446030521020516,0.2296652064363871,131187.67463305994,2725.788343528753,133913.4629765887,1555,15,554.2105263157895,37,1,17,33.80773038638552,0.6303490990990992,43.88706140350876,1024.451754385963,27.68788525367468,0
1580,4,0,0,38,0.0,0.0,1.0,38,350,100,250,0.2857142857142857,6,1,5,392.36372871866604,0.38599454717875775,0.15659682532532226,0.22964456933834484,131300.02891514683,2703.4737852031226,134003.50270034996,1556,16,555.2105263157895,37,1,17,33.724167290752824,0.6314752252252254,43.777412280701746,1024.8903508771918,27.69973921289708,0
1581,4,0,0,38,0.0,0.0,1.0,38,900,500,400,0.5555555555555556,13,5,8,390.0277132317043,0.3860982693219535,0.1435375171951403,0.22913499075405794,131443.5782911289,2653.330657708828,134096.90894883775,1557,17,556.2105263157895,36,2,18,33.638535031847134,0.634837962962963,43.637387387387385,1025.45045045045,28.484734734734722,0
1582,4,0,0,38,0.0,0.0,1.0,38,900,600,300,0.6666666666666666,12,6,6,388.34647866841226,0.3856241109530583,0.13999838198922832,0.22849223047234493,131501.32395909424,2613.615219949678,134114.93917904393,1558,18,557.2105263157895,36,2,18,33.62314265846873,0.6354166666666666,43.58108108108108,1025.6756756756758,28.490990990990994,0
1583,4,1,1,38,0.02564102564102564,0.02564102564102564,0.9743589743589743,39,1150,900,250,0.782608695652174,14,9,5,382.91855969460573,0.3900134952766532,0.13493921792544028,0.22677207301838023,131749.92696069932,2289.898454332089,134039.8254150314,1559,0,543.8974358974359,37,2,14,33.51078269073303,0.6359797297297298,43.33881578947368,1026.6447368421043,27.747155049786603,0
1584,4,0,0,38,0.0,0.0,1.0,38,750,400,350,0.5333333333333333,11,4,7,388.50590948577866,0.38546111901375063,0.1391224989603066,0.22927887611621867,131616.85333982628,2626.78506208911,134243.63840191538,1560,20,559.2105263157895,36,2,14,33.502066871524725,0.6365740740740742,43.468468468468465,1026.1261261261259,28.503503503503495,0
1585,4,0,0,38,0.0,0.0,1.0,38,750,400,350,0.5333333333333333,11,4,7,389.6842419639677,0.385224039829303,0.13109963849716477,0.23032309865496764,131674.6370525931,2662.3062251440615,134336.94327773718,1561,21,560.2105263157895,36,2,15,33.41333845366104,0.6371527777777778,43.41216216216216,1026.3513513513512,28.509759759759756,0
1586,4,0,0,38,0.0,0.0,1.0,38,900,600,300,0.6666666666666666,12,6,6,393.9039901934526,0.3852833096254149,0.12382101338012763,0.23352513540857614,131790.24252292837,2782.5404796688663,134572.78300259722,1562,22,561.2105263157895,36,2,15,33.18801637786065,0.6383101851851851,43.29954954954955,1026.8018018018022,28.522272272272282,0
1587,4,0,0,38,0.0,0.0,1.0,38,650,500,150,0.7692307692307693,8,5,3,393.9039901934526,0.3852833096254149,0.12382101338012763,0.23352513540857614,131790.24252292837,2782.5404796688663,134572.78300259722,1563,23,562.2105263157895,36,2,15,33.18801637786065,0.6383101851851851,43.29954954954955,1026.8018018018022,28.522272272272282,0
1588,4,0,0,38,0.0,0.0,1.0,38,550,400,150,0.7272727272727273,7,4,3,394.27637839125344,0.3854166666666667,0.11970668528982276,0.2339236366005101,131819.1518165125,2794.635556164276,134613.78737267677,1564,24,563.2105263157895,36,2,15,33.14919399056914,0.638599537037037,43.2713963963964,1026.9144144144148,28.52540040040041,0
1589,4,0,0,38,0.0,0.0,1.0,38,1200,900,300,0.75,15,9,6,396.65658650910495,0.38599454717875775,0.1232665728327833,0.23623333520294226,131963.7458404351,2868.8577936044226,134832.60363403952,1565,25,564.2105263157895,36,2,15,32.94173790735057,0.6400462962962963,43.130630630630634,1027.477477477478,28.541041041041055,0
1590,4,0,0,38,0.0,0.0,1.0,38,1200,900,300,0.75,15,9,6,415.9090337568983,0.38578710289236606,0.12979772100627063,0.2471393349348843,131877.8061224491,3404.125231478047,135281.93135392715,1566,26,565.2105263157895,34,4,15,32.534335883171074,0.6433823529411764,43.21428571428572,1027.1428571428582,30.210084033613477,6
1591,4,0,0,38,0.0,0.0,1.0,38,1250,1000,250,0.8,15,10,5,416.8557157901972,0.38488323850165956,0.12309253964286371,0.24870182407856067,132030.6990504535,3407.5503117913822,135438.24936224488,1567,27,566.2105263157895,34,4,16,32.35501370709293,0.6449142156862745,43.06547619047619,1027.7380952380952,30.227591036414566,0
1592,4,0,0,38,0.0,0.0,1.0,38,950,700,250,0.7368421052631579,12,7,5,418.00174914920945,0.38469061166429586,0.12102702900405982,0.24958693652519184,132061.2882653061,3440.369897959181,135501.65816326527,1568,28,567.2105263157895,34,4,16,32.29456219596942,0.6452205882352942,43.035714285714285,1027.8571428571427,30.231092436974784,0
1593,4,0,0,38,0.0,0.0,1.0,38,1300,600,700,0.46153846153846156,20,6,14,415.91692956717924,0.38415718349928873,0.11639512070289126,0.24914635489606768,132183.68055555565,3395.486111111121,135579.16666666677,1569,29,568.2105263157895,34,4,16,32.224135602377096,0.6464460784313726,42.91666666666667,1028.3333333333342,30.245098039215712,0
1594,4,1,0,39,0.02564102564102564,0.0,1.0,39,950,600,350,0.631578947368421,13,6,7,404.8055685582525,0.3882984705353127,0.11738300244313216,0.2444663796712128,132489.9092970522,2926.7042233560114,135416.6135204082,1570,0,554.6153846153846,34,5,17,32.20012334258403,0.6495098039215685,42.61904761904762,1029.5238095238096,30.28011204481793,0
1595,4,0,0,39,0.0,0.0,1.0,39,1000,700,300,0.7,13,7,6,404.50399278291945,0.38827035537561855,0.11356158292574503,0.24468248514491292,132551.19756235828,2923.497732426305,135474.6952947846,1571,1,555.6153846153846,34,5,17,32.14595375722543,0.6501225490196079,42.55952380952381,1029.7619047619048,30.287114845938376,0
1596,4,0,0,39,0.0,0.0,1.0,39,1050,800,250,0.7619047619047619,13,8,5,403.7861811044629,0.38827035537561855,0.11774605488495049,0.24504667680771544,132673.8166099773,2914.3707482993177,135588.18735827663,1572,2,556.6153846153846,34,5,15,32.04057853786303,0.6513480392156863,42.44047619047619,1030.2380952380952,30.30112044817927,0
1597,4,2,2,39,0.04878048780487805,0.04878048780487805,0.9512195121951219,41,650,400,250,0.6153846153846154,9,4,5,385.6742843354542,0.39832317073170737,0.12087897468916897,0.23743963495655548,133210.52629910322,2075.1748792711737,135285.7011783744,1573,0,530.4146341463414,36,5,17,31.966564852187204,0.6524884259259258,41.92004504504505,1032.3198198198204,28.675550550550568,0
1598,4,0,0,39,0.0,0.0,1.0,39,950,700,250,0.7368421052631579,12,7,5,401.38761350882544,0.38914192532613584,0.1287749287749287,0.2452924304776157,132934.57031250012,2871.6579861111254,135806.22829861124,1574,1,558.5384615384615,35,4,18,31.83922558922559,0.6517857142857142,42.18750000000001,1031.250000000001,29.46428571428574,0
1599,4,0,0,39,0.0,0.0,1.0,39,1200,800,400,0.6666666666666666,16,8,8,400.8716142049007,0.3889732343679712,0.12422649716490208,0.2455648589284041,133024.1036120756,2865.1174286265395,135889.22104070213,1575,2,559.5384615384615,35,4,18,31.762243352406596,0.6526785714285714,42.10069444444444,1031.597222222222,29.47420634920634,0
1600,4,0,0,39,0.0,0.0,1.0,39,850,500,350,0.5882352941176471,12,5,7,399.48504013295036,0.388663967611336,0.12133031877254452,0.24491125500310318,133053.95474322705,2830.612890089163,135884.5676333162,1576,3,560.5384615384615,35,4,18,31.767911898885647,0.6529761904761904,42.07175925925926,1031.712962962963,29.47751322751323,0
1601,4,0,0,39,0.0,0.0,1.0,39,900,600,300,0.6666666666666666,12,6,6,406.2502351514443,0.3885796221322537,0.12237041546959948,0.2316600424142862,130294.81207274766,2796.144858198994,133090.95693094665,1577,4,561.5384615384615,32,7,17,34.390974111633284,0.6321614583333334,44.76010101010101,1020.9595959595958,31.90498737373737,5
1602,4,3,3,39,0.07142857142857142,0.07142857142857142,0.9285714285714286,42,900,500,400,0.5555555555555556,13,5,8,379.8996389965214,0.4011203058459156,0.11280037914283558,0.22012271349981885,130913.23329260941,1546.7780135459152,132460.01130615533,1578,0,522.3571428571429,35,7,16,34.43555379627534,0.6315476190476192,44.155092592592574,1023.3796296296271,29.239417989417916,0
1603,4,0,1,38,0.0,0.02564102564102564,0.9743589743589743,39,700,500,200,0.7142857142857143,9,5,4,403.36362970212747,0.3881860098965362,0.13055341642660911,0.2309706389186065,130455.99819214862,2724.240989439837,133180.23918158846,1579,6,563.5384615384615,32,7,19,34.3004572982326,0.6337890625,44.60227272727272,1021.590909090908,31.924715909090875,0
1604,4,0,0,38,0.0,0.0,1.0,38,350,0,350,0.0,7,0,7,406.7499647609984,0.3848091512565197,0.13585924658683046,0.2327464240372015,130428.79104614258,3010.381232367622,133439.1722785102,1580,7,577.7368421052631,31,7,19,34.241687911620986,0.6360887096774194,44.62890625,1021.484375,32.951108870967744,0
1605,4,0,0,38,0.0,0.0,1.0,38,650,200,450,0.3076923076923077,11,2,9,407.07177452120357,0.38482396870554764,0.13554911744192277,0.23353064959374314,130528.564453125,3026.8988715277783,133555.46332465278,1581,8,578.7368421052631,31,7,17,34.131838260278634,0.6370967741935484,44.53125,1021.875,32.96370967741935,0
1606,4,1,1,38,0.02564102564102564,0.02564102564102564,0.9743589743589743,39,1100,700,400,0.6363636363636364,15,7,8,399.44436854197363,0.389704228520018,0.12735411822395148,0.23141505411241572,130907.84940631059,2658.080648658303,133565.9300549689,1582,0,564.8717948717949,32,7,18,33.940982932346294,0.6383463541666666,44.160353535353536,1023.3585858585859,31.97995580808081,0
1607,4,0,0,38,0.0,0.0,1.0,38,1350,1100,250,0.8148148148148148,16,11,5,410.1628500044062,0.3843201754385965,0.12413399650761803,0.23731459699839144,130857.49959450695,3134.5769956266845,133992.07659013363,1583,10,580.7368421052631,33,5,18,33.71798518784685,0.6354166666666666,44.20955882352941,1023.1617647058827,31.004901960784323,0
1608,4,0,0,38,0.0,0.0,1.0,38,550,300,250,0.5454545454545454,8,3,5,409.1255349901403,0.3841868183973447,0.12416949879060613,0.23679690055489927,130870.93431122448,3108.5282029478426,133979.46251417234,1584,11,581.7368421052631,34,4,18,33.73085127011828,0.6332720588235294,44.19642857142857,1023.2142857142856,30.094537815126046,0
1609,4,0,0,38,0.0,0.0,1.0,38,1300,1000,300,0.7692307692307693,16,10,6,386.2991278870147,0.384601706970128,0.09008280194156293,0.22486675549633586,131090.96364883397,2528.86218016013,133619.8258289941,1585,12,582.7368421052631,35,3,17,34.09150843881858,0.6333333333333333,43.98148148148148,1024.0740740740737,29.25925925925925,3
1610,4,0,1,37,0.0,0.02631578947368421,0.9736842105263158,38,650,300,350,0.46153846153846156,10,3,7,384.07935780190815,0.38442389758179235,0.08866352246752074,0.22377974114083002,131126.2038009294,2472.5736293726222,133598.777430302,1586,13,583.7368421052631,36,2,17,34.112607659886386,0.6316550925925926,43.947072072072075,1024.2117117117123,28.45032532532534,0
1611,4,0,0,37,0.0,0.0,1.0,37,950,600,350,0.631578947368421,13,6,7,392.7926462644353,0.3798485985985986,0.10742395689847384,0.22882304982185575,131120.5970963006,2900.6412626457504,134021.23835894634,1587,47,600.1621621621622,35,2,17,33.89519060534147,0.6336309523809524,43.9525462962963,1024.189814814815,29.262566137566143,0
1612,4,2,1,38,0.05128205128205128,0.02564102564102564,0.9743589743589743,39,1100,600,500,0.5454545454545454,16,6,10,378.3847388451681,0.39071637426900585,0.10132608530501686,0.223475056713935,131645.74361100968,2162.712163274547,133808.45577428423,1588,0,570.3333333333334,36,3,17,33.73248838655401,0.6368634259259259,43.44031531531532,1026.238738738739,28.506631631631635,0
1613,4,0,1,37,0.0,0.02631578947368421,0.9736842105263158,38,950,700,250,0.7368421052631579,12,7,5,384.0734118487919,0.3855796586059744,0.10267700731010643,0.22618223582829503,131535.81700370787,2503.8820033864727,134039.69900709434,1589,1,586.3421052631579,35,3,19,33.69779326037082,0.6377976190476191,43.547453703703695,1025.810185185184,29.3088624338624,0
1614,4,1,1,37,0.02631578947368421,0.02631578947368421,0.9736842105263158,38,1100,900,200,0.8181818181818182,13,9,4,375.5950964299333,0.3905879563774301,0.07535281967250951,0.2233493135354533,131905.89871966562,2308.641749857969,134214.5404695236,1590,0,569.2368421052631,36,2,17,33.54116421837317,0.6394675925925927,43.18693693693694,1027.2522522522524,28.53478478478479,0
1615,4,0,0,37,0.0,0.0,1.0,37,950,700,250,0.7368421052631579,12,7,5,383.4209303834995,0.38441566566566565,0.08507397234980485,0.22791162917719676,131890.67790089242,2713.929285934117,134604.60718682653,1591,3,585.6216216216217,37,0,17,33.35557216054653,0.6373873873873874,43.201754385964904,1027.1929824561391,27.761972498814572,0
1616,4,0,0,37,0.0,0.0,1.0,37,1150,900,250,0.782608695652174,14,9,5,382.5725054073665,0.3840715715715716,0.08615189362254472,0.22774487774250451,131946.99931709742,2695.858821945201,134642.85813904263,1592,4,586.6216216216217,37,0,17,33.32043756670224,0.6379504504504505,43.1469298245614,1027.4122807017534,27.767899478425768,0
1617,4,0,0,37,0.0,0.0,1.0,37,850,500,350,0.5882352941176471,12,5,7,383.0718260755013,0.383008008008008,0.08523864167132755,0.22872071959437876,132059.6782182978,2717.668417205274,134777.34663550308,1593,5,587.6216216216217,37,0,17,33.19376289026385,0.6390765765765766,43.037280701754376,1027.8508771929812,27.77975343764814,0
1618,4,1,1,37,0.02631578947368421,0.02631578947368421,0.9736842105263158,38,800,700,100,0.875,9,7,2,378.1714294967428,0.3891802987197724,0.07320931859292079,0.22749338147927084,132343.03232750733,2409.6707438454077,134752.70307135273,1594,0,573.1315789473684,38,0,18,33.03373654518394,0.640076754385965,42.76175213675213,1028.9529914529903,27.077710301394482,0
1619,4,0,0,37,0.0,0.0,1.0,37,850,600,250,0.7058823529411765,11,6,5,381.05869856197614,0.3834146646646646,0.0766356378764439,0.2287083590025522,132256.98201610078,2679.534688557983,134936.51670465877,1595,7,589.6216216216217,37,0,18,33.04629481576236,0.6410472972972974,42.84539473684209,1028.618421052629,27.80049786628727,0
1620,4,0,0,37,0.0,0.0,1.0,37,1250,900,350,0.72,16,9,7,373.73533031041586,0.383445945945946,0.07528535099651101,0.22532591814229544,132426.97934420893,2498.603316757027,134925.58266096594,1596,8,590.6216216216217,36,1,18,33.06322939460249,0.644675925925926,42.68018018018017,1029.2792792792782,28.59109109109106,0
1621,4,1,1,37,0.02631578947368421,0.02631578947368421,0.9736842105263158,38,600,400,200,0.6666666666666666,8,4,4,365.105599454696,0.38941737790422004,0.0697925887744697,0.22127754846951017,132623.79410010742,2084.337969375156,134708.13206948258,1597,0,576.0526315789474,37,1,18,33.08716556667376,0.6447072072072073,42.48903508771928,1030.0438596491203,27.83902323376001,0
1622,4,0,0,37,0.0,0.0,1.0,37,1100,700,400,0.6363636363636364,15,7,8,372.5527697406556,0.38310185185185186,0.07661548919066696,0.22547948903231588,132571.9062601452,2478.0061734031233,135049.9124335483,1598,10,592.6216216216217,36,1,18,32.94764898851831,0.6461226851851853,42.53941441441441,1029.8423423423417,28.606731731731713,0
1623,4,0,0,37,0.0,0.0,1.0,37,900,500,400,0.5555555555555556,13,5,8,372.4749681803387,0.3830705705705706,0.07705967692848681,0.22578055228267427,132629.89921932048,2480.2634982955738,135110.16271761604,1599,11,593.6216216216217,36,1,15,32.89124849677489,0.6467013888888891,42.4831081081081,1030.0675675675661,28.61298798798795,0
1624,4,0,0,37,0.0,0.0,1.0,37,850,600,250,0.7058823529411765,11,6,5,367.5642521020858,0.38247622622622623,0.0730077741890025,0.22327092934733658,132708.51518015144,2355.7812259541233,135064.29640610557,1600,12,594.6216216216217,37,0,15,32.93859299067078,0.6455518018018018,42.40679824561403,1030.3728070175428,27.847913703176832,0
1625,4,0,0,37,0.0,0.0,1.0,37,550,400,150,0.7272727272727273,7,4,3,365.7495554582055,0.3826013513513513,0.07081437683693514,0.22233598461812482,132736.761551631,2309.6823060941547,135046.44385772516,1601,13,595.6216216216217,37,0,15,32.956923458891964,0.6458333333333335,42.37938596491227,1030.4824561403489,27.850877192982402,0
1626,4,0,0,37,0.0,0.0,1.0,37,800,500,300,0.625,11,5,6,365.0375735626984,0.38272647647647645,0.06774008050603819,0.2222379010031969,132793.263311788,2294.906124961502,135088.1694367495,1602,14,596.6216216216217,37,0,16,32.918439716312044,0.6463963963963965,42.32456140350876,1030.701754385963,27.8568041725936,0
1627,4,1,1,37,0.02631578947368421,0.02631578947368421,0.9736842105263158,38,1150,700,450,0.6086956521739131,16,7,9,355.13869063693545,0.38469061166429586,0.06735861392611975,0.2182340808875823,133141.23109796178,1856.7204963839476,134997.95159434574,1603,0,581.8947368421053,38,0,16,32.82414596273293,0.6480263157894738,41.98717948717948,1032.0512820512813,27.159244264507404,0
1628,4,0,0,37,0.0,0.0,1.0,37,850,500,350,0.5882352941176471,12,5,7,364.12689012679925,0.3818506006006006,0.0681191395477112,0.22302772020266437,133019.39058171725,2287.1874038165356,135306.57798553378,1604,16,598.6216216216217,37,0,17,32.71462230725623,0.6486486486486487,42.105263157894726,1031.5789473684194,27.880512091038362,0
1629,4,0,0,37,0.0,0.0,1.0,37,950,800,150,0.8421052631578947,11,8,3,363.9502085121058,0.38166291291291293,0.06438014725307561,0.22359656413289397,133132.5263542627,2290.7221452754543,135423.24849953814,1605,17,599.6216216216217,37,0,17,32.60553902819097,0.6497747747747749,41.99561403508771,1032.017543859648,27.892366050260755,0
1630,4,0,0,37,0.0,0.0,1.0,37,700,400,300,0.5714285714285714,10,4,6,364.29148478787823,0.38141266266266266,0.06197294713177004,0.22397620811941849,133160.81781173055,2301.8704072406917,135462.68821897125,1606,18,600.6216216216217,37,0,17,32.56832306384787,0.6500563063063063,41.968201754385966,1032.1271929824563,27.89532954006639,0
1631,4,1,0,38,0.02631578947368421,0.0,1.0,38,900,700,200,0.7777777777777778,11,7,4,377.8133769306641,0.3857426505452821,0.028122312580441955,0.22415616032730817,131819.1518165125,2463.217475601025,134282.36929211352,1607,0,585.7894736842105,36,2,16,33.571846328179255,0.638599537037037,43.2713963963964,1026.9144144144148,28.52540040040041,6
1632,4,0,0,38,0.0,0.0,1.0,38,1200,800,400,0.6666666666666666,16,8,8,380.8694222386059,0.3850165955429113,0.030711368513347992,0.22683111021573377,131963.74584043512,2452.191126937756,134415.93696737287,1608,1,586.7894736842105,36,2,17,33.34726180037994,0.6400462962962963,43.130630630630634,1027.4774774774783,28.541041041041062,0
1633,4,0,1,37,0.0,0.02631578947368421,0.9736842105263158,38,800,400,400,0.5,12,4,8,380.5137503446644,0.38477951635846375,0.033282581865577754,0.22696526049969995,132021.60564280508,2447.2072579336204,134468.8129007387,1609,2,587.7894736842105,36,2,17,33.297949083205495,0.640625,43.07432432432433,1027.7027027027036,28.547297297297323,0
1634,4,0,1,36,0.0,0.02702702702702703,0.972972972972973,37,950,800,150,0.8421052631578947,11,8,3,380.3507568059755,0.3809121621621621,0.046671205707350616,0.22756241216504294,132137.36329234642,2651.709226118016,134789.07251846444,1610,3,602.1891891891892,36,1,17,33.18524096385543,0.6417824074074073,42.961711711711715,1028.1531531531532,28.55980980980981,0
1635,4,0,0,36,0.0,0.0,1.0,36,1300,1000,300,0.7692307692307693,16,10,6,386.889058560757,0.3765376984126984,0.07346026386544158,0.23179428761377774,132189.6316256215,3028.5444262259866,135218.1760518475,1611,4,619.3055555555555,35,1,18,32.96438285499906,0.6443452380952381,42.910879629629626,1028.3564814814808,29.38161375661374,0
1636,4,0,0,36,0.0,0.0,1.0,36,800,400,400,0.5,12,4,8,388.23129795806227,0.37650462962962966,0.0737750521985916,0.23296499290704273,132249.1496940374,3068.6518079132516,135317.80150195066,1612,5,620.3055555555555,35,1,18,32.869758261130485,0.644940476190476,42.85300925925927,1028.5879629629642,29.388227513227548,0
1637,4,0,0,36,0.0,0.0,1.0,36,300,0,300,0.0,6,0,6,388.067609641252,0.37665343915343913,0.07078207820782056,0.23305033206023298,132278.91375171475,3066.632373113859,135345.5461248286,1613,6,621.3055555555555,35,1,19,32.8439093909391,0.6452380952380952,42.824074074074076,1028.7037037037042,29.391534391534403,0
1638,4,0,0,36,0.0,0.0,1.0,36,900,700,200,0.7777777777777778,11,7,4,385.5533950772169,0.3763723544973545,0.06923043277221641,0.2320890477746472,132368.2260186258,3007.003788365928,135375.22980699173,1614,7,622.3055555555555,35,1,19,32.81841656356615,0.6461309523809522,42.737268518518526,1029.050925925927,29.401455026455057,0
1639,4,0,0,36,0.0,0.0,1.0,36,900,500,400,0.5555555555555556,13,5,8,387.5457130476937,0.3768187830687831,0.0665554805986559,0.2338420333681269,132457.56842635464,3066.6725608710685,135524.2409872257,1615,8,623.3055555555555,35,1,19,32.676991979611735,0.6470238095238094,42.65046296296297,1029.3981481481487,29.41137566137568,0
1640,4,0,0,36,0.0,0.0,1.0,36,650,500,150,0.7692307692307693,8,5,3,386.423774649345,0.37671957671957673,0.06597222222222188,0.2335343681576479,132517.14677640618,3041.555212620046,135558.70198902622,1616,9,624.3055555555555,35,1,19,32.64575839328538,0.6476190476190475,42.5925925925926,1029.629629629631,29.417989417989457,0
1641,4,0,0,36,0.0,0.0,1.0,36,1000,600,400,0.6,14,6,8,388.2729563230595,0.37624007936507936,0.06577205928256546,0.23521041785697164,132606.53941883173,3097.506617584049,135704.0460364158,1617,10,625.3055555555555,35,1,19,32.50798310671612,0.6485119047619046,42.50578703703705,1029.9768518518542,29.42791005291012,0
1642,4,1,1,36,0.02702702702702703,0.02702702702702703,0.972972972972973,37,900,700,200,0.7777777777777778,11,7,4,382.9083497660439,0.3789727227227227,0.058429155534562405,0.23354603211912983,132861.99787202768,2774.793670359575,135636.79154238725,1618,0,609.3783783783783,36,1,17,32.3887220098307,0.6490162037037036,42.257882882882896,1030.9684684684705,28.63801301301307,0
1643,4,0,0,36,0.0,0.0,1.0,36,850,700,150,0.8235294117647058,10,7,3,390.9843465174553,0.3766699735449735,0.06024603977081244,0.23722915258022298,132666.15125868062,3174.077690972231,135840.22894965284,1619,12,627.3055555555555,35,1,17,32.378033367037425,0.6491071428571428,42.44791666666667,1030.208333333334,29.434523809523828,0
1644,4,0,0,36,0.0,0.0,1.0,36,750,400,350,0.5333333333333333,11,4,7,393.0018957423341,0.3766203703703704,0.055171789783718284,0.23883248312587055,132725.77649444886,3232.2963552383576,135958.07284968722,1620,13,628.3055555555555,35,1,17,32.26592627953125,0.6497023809523809,42.390046296296305,1030.439814814816,29.4411375661376,0
1645,4,0,0,36,0.0,0.0,1.0,36,1100,900,200,0.8181818181818182,13,9,4,389.07829541163056,0.3762896825396826,0.057604505819393026,0.23720194231563244,132845.0671537422,3137.4264564043087,135982.49361014648,1621,14,629.3055555555555,35,1,17,32.24675816773325,0.6508928571428572,42.27430555555555,1030.902777777777,29.454365079365054,0
1646,4,0,1,35,0.0,0.027777777777777776,0.9722222222222222,36,800,500,300,0.625,11,5,6,389.07829541163056,0.3762896825396826,0.057604505819393026,0.23720194231563244,132845.0671537422,3137.4264564043087,135982.49361014648,1622,15,630.3055555555555,35,1,17,32.24675816773325,0.6508928571428572,42.27430555555555,1030.902777777777,29.454365079365054,0
1647,4,0,0,35,0.0,0.0,1.0,35,600,400,200,0.6666666666666666,8,4,4,394.15761567734717,0.3767156862745098,0.06023861779897377,0.23979075747848166,132765.81809807252,3466.1316609977293,136231.94975907024,1623,16,640.5714285714286,34,1,17,32.195766431789295,0.6522671568627452,42.351190476190474,1030.5952380952378,30.311624649859937,0
1648,4,0,0,35,0.0,0.0,1.0,35,850,600,250,0.7058823529411765,11,6,5,397.5233213681869,0.37556022408963585,0.06083800725833077,0.2424332368344014,132857.85147392296,3562.818877551029,136420.670351474,1624,17,641.5714285714286,34,1,17,32.01621439568899,0.6531862745098038,42.261904761904766,1030.9523809523814,30.32212885154063,0
1649,4,0,1,34,0.0,0.02857142857142857,0.9714285714285714,35,1150,900,250,0.782608695652174,14,9,5,389.6843766303716,0.37538515406162465,0.06859527397373699,0.23137007000620907,131847.23816609985,3275.761763038565,135122.9999291384,1625,18,642.5714285714286,34,1,15,33.23866929407675,0.6430759803921567,43.24404761904763,1027.0238095238103,30.206582633053245,4
1650,4,0,0,34,0.0,0.0,1.0,34,800,500,300,0.625,11,5,6,390.5637746996338,0.37416443850267384,0.06680281275001065,0.23217769925761225,131893.9905925606,3502.602965205698,135396.59355776632,1626,19,647.2647058823529,33,1,17,33.168794241628895,0.6458333333333333,43.19852941176471,1027.2058823529417,31.127450980392172,0
1651,4,0,0,34,0.0,0.0,1.0,34,700,500,200,0.7142857142857143,9,5,4,388.8575021123477,0.373458853238265,0.06736921867983847,0.2315469671668981,131956.93963860057,3462.4891868512173,135419.4288254518,1627,20,648.2647058823529,33,1,17,33.14895435750636,0.6464646464646464,43.13725490196079,1027.4509803921571,31.13487819370173,0
1652,4,1,0,35,0.02857142857142857,0.0,1.0,35,800,600,200,0.75,10,6,4,377.5962465081619,0.3767156862745098,0.07438093034019899,0.22692536594739482,132306.12953514745,2991.6595804988733,135297.78911564633,1628,0,630.7142857142857,34,1,19,33.0857536835609,0.647671568627451,42.79761904761905,1028.8095238095243,30.259103641456598,0
1653,4,1,1,35,0.027777777777777776,0.027777777777777776,0.9722222222222222,36,900,600,300,0.6666666666666666,12,6,6,370.047487190104,0.38301917989417994,0.0715427657873704,0.22363739443228028,132517.14677640607,2607.5274348422554,135124.67421124832,1629,0,614.1666666666666,35,1,19,33.06729616306954,0.6476190476190475,42.592592592592595,1029.62962962963,29.41798941798943,0
1654,4,0,0,35,0.0,0.0,1.0,35,700,600,100,0.8571428571428571,8,6,2,379.0620869175304,0.3769607843137255,0.08093475242943104,0.22817637042584482,132367.37528344666,3035.0907029478376,135402.4659863945,1630,2,632.7142857142857,34,1,19,32.98627178775258,0.6482843137254901,42.738095238095234,1029.0476190476186,30.266106442577016,0
1655,4,1,1,35,0.027777777777777776,0.027777777777777776,0.9722222222222222,36,1500,1300,200,0.8666666666666667,17,13,4,369.4571097743225,0.3824404761904762,0.07996992274763848,0.2245240032983475,132725.7764944486,2607.2963552383285,135333.07284968693,1631,0,616.1111111111111,35,1,15,32.87246340184957,0.649702380952381,42.39004629629629,1030.4398148148139,29.441137566137538,0
1656,4,0,0,35,0.0,0.0,1.0,35,900,800,100,0.8888888888888888,10,8,2,378.620818229096,0.3772408963585434,0.07872414191609822,0.22958696146715962,132643.15653344675,3044.2920918367336,135687.4486252835,1632,4,634.7142857142857,34,1,15,32.71962517816557,0.6510416666666667,42.470238095238095,1030.1190476190477,30.29761904761905,0
1657,4,0,0,35,0.0,0.0,1.0,35,450,200,250,0.4444444444444444,7,2,5,378.620818229096,0.3772408963585434,0.07872414191609822,0.22958696146715962,132643.15653344675,3044.2920918367336,135687.4486252835,1633,5,635.7142857142857,34,1,15,32.71962517816557,0.6510416666666667,42.470238095238095,1030.1190476190477,30.29761904761905,0
1658,4,0,0,35,0.0,0.0,1.0,35,400,200,200,0.5,6,2,4,378.56252968183753,0.3771358543417367,0.07856730213749308,0.2299269259225475,132704.4802295917,3047.3887471655153,135751.8689767572,1634,6,636.7142857142857,34,1,15,32.65934912382052,0.651654411764706,42.41071428571428,1030.3571428571418,30.304621848739462,0
1659,4,1,0,36,0.027777777777777776,0.0,1.0,36,1100,900,200,0.8181818181818182,13,9,4,370.69474934485976,0.38133267195767195,0.07451548576057876,0.2274427866764915,133083.80922335808,2666.6938603823637,135750.50308374045,1635,0,620.0,35,1,16,32.48048700691719,0.6532738095238095,42.04282407407407,1031.8287037037028,29.48082010582008,0
1660,4,0,2,34,0.0,0.05555555555555555,0.9444444444444444,36,900,600,300,0.6666666666666666,12,6,6,371.43718956745573,0.3815806878306878,0.07030393622321873,0.2288135173302282,133233.1318587105,2697.54801097393,135930.67986968442,1636,1,621.0,35,1,17,32.31128550074738,0.6547619047619049,41.898148148148145,1032.407407407407,29.497354497354483,0
1661,4,0,0,34,0.0,0.0,1.0,34,1200,900,300,0.75,15,9,6,387.73127231852425,0.3746472073677956,0.07829624245135336,0.23714726655760904,132966.16685890048,3511.028210303742,136477.19506920423,1637,2,657.4411764705883,33,1,17,32.15947797845375,0.6565656565656566,42.156862745098046,1031.3725490196084,31.2537136066548,0
1662,4,0,1,33,0.0,0.029411764705882353,0.9705882352941176,34,1100,1000,100,0.9090909090909091,12,10,2,388.51216899826045,0.3749257278669043,0.08154714897720994,0.23782595828788067,132997.7671598665,3534.250198241073,136532.01735810755,1638,3,658.4411764705883,33,1,17,32.10751554393887,0.6568813131313129,42.126225490196084,1031.4950980392164,31.257427213309587,0
1663,4,0,0,33,0.0,0.0,1.0,33,300,200,100,0.6666666666666666,4,2,2,396.26249141963956,0.37511837121212116,0.08473611801398784,0.24195592182908923,132902.97752066524,3932.8929978854435,136835.87051855068,1639,4,669.4545454545455,33,0,17,32.00320893748515,0.6559343434343433,42.21813725490197,1031.1274509803932,31.246286393345247,0
1664,4,0,0,33,0.0,0.0,1.0,33,850,500,350,0.5882352941176471,12,5,7,391.56665781010616,0.3740924873737374,0.07882099685378363,0.23989869908627917,133029.371215398,3817.9732554786733,136847.34447087665,1640,5,670.4545454545455,33,0,17,31.996911380375384,0.6571969696969696,42.09558823529412,1031.617647058824,31.261140819964368,0
1665,4,0,0,33,0.0,0.0,1.0,33,650,300,350,0.46153846153846156,10,3,7,394.70664236830015,0.3740924873737374,0.07978118476930751,0.24223250209483177,133092.59059015787,3906.5059111880278,136999.0965013459,1641,6,671.4545454545455,33,0,17,31.85223673792557,0.6578282828282828,42.03431372549021,1031.8627450980412,31.268568033273976,0
1666,4,0,0,33,0.0,0.0,1.0,33,1000,800,200,0.8,12,8,4,399.1079440988672,0.3739346590909091,0.07804955275864756,0.24534942373727484,133155.82498317974,4028.709510765111,137184.53449394484,1642,7,672.4545454545455,33,0,17,31.674978231615604,0.6584595959595958,41.973039215686285,1032.1078431372566,31.275995246583534,0
1667,4,0,0,33,0.0,0.0,1.0,33,650,500,150,0.7692307692307693,8,5,3,399.1079440988672,0.3739346590909091,0.07804955275864756,0.24534942373727484,133155.82498317974,4028.709510765111,137184.53449394484,1643,8,673.4545454545455,33,0,17,31.674978231615604,0.6584595959595958,41.973039215686285,1032.1078431372566,31.275995246583534,0
1668,4,0,0,33,0.0,0.0,1.0,33,700,600,100,0.8571428571428571,8,6,2,395.7754667302178,0.37432922979797983,0.07383756885417969,0.24454513442831957,133345.61827181865,3954.984861591709,137300.60313341036,1644,9,674.4545454545455,33,0,17,31.569866318620477,0.6603535353535352,41.78921568627452,1032.843137254903,31.298276886512213,0
1669,4,0,0,33,0.0,0.0,1.0,33,650,400,250,0.6153846153846154,9,4,5,397.4074402412442,0.37456597222222227,0.08041985693231224,0.2459724464929287,133408.91273788924,4003.5389033064175,137412.45164119566,1645,10,675.4545454545455,33,0,17,31.464017398181092,0.6609848484848485,41.72794117647059,1033.0882352941176,31.305704099821746,0
1670,4,0,0,33,0.0,0.0,1.0,33,950,600,350,0.631578947368421,13,6,7,397.9482979588081,0.373855744949495,0.08502382132925179,0.2471499223110888,133535.5467248173,4028.0487072279825,137563.5954320453,1646,11,676.4545454545455,33,0,18,31.32262271757173,0.6622474747474747,41.60539215686274,1033.5784313725485,31.320558526440863,0
1671,4,0,0,33,0.0,0.0,1.0,33,750,600,150,0.8,9,6,3,400.1870571940542,0.37417140151515155,0.08106662070401871,0.24960669443167952,133693.92368620244,4100.515576941562,137794.439263144,1647,12,677.4545454545455,33,0,20,31.105457795157403,0.6638257575757576,41.45220588235294,1034.1911764705883,31.339126559714796,0
1672,4,0,0,33,0.0,0.0,1.0,33,750,500,250,0.6666666666666666,10,5,5,399.00039411663784,0.3741319444444444,0.07738563217771843,0.2492940286260945,133757.30075271518,4073.843143262191,137831.14389597738,1648,13,678.4545454545455,33,0,17,31.072419342100076,0.6644570707070707,41.39093137254901,1034.4362745098028,31.34655377302433,0
1673,4,0,0,33,0.0,0.0,1.0,33,550,300,250,0.5454545454545454,8,3,5,398.42420167742824,0.3736584595959596,0.07980790972618546,0.2493621597303577,133820.69283749035,4063.4805423394814,137884.17337982982,1649,14,679.4545454545455,33,0,17,31.023604366536386,0.6650883838383839,41.3296568627451,1034.6813725490192,31.353980986333916,0
1674,4,0,0,33,0.0,0.0,1.0,33,850,700,150,0.8235294117647058,10,7,3,396.67699335343735,0.37318497474747475,0.07685187178438446,0.24891039270899923,133915.80912389458,4024.264105151858,137940.07322904642,1650,15,680.4545454545455,33,0,17,30.973241771252667,0.6660353535353536,41.23774509803921,1035.0490196078426,31.365121806298262,0
1675,4,0,0,33,0.0,0.0,1.0,33,450,300,150,0.6666666666666666,6,3,3,395.8594798906922,0.37290877525252525,0.07733066428461277,0.2486115261439908,133947.5220618271,4004.879283208374,137952.40134503547,1651,16,681.4545454545455,33,0,17,30.96254587427489,0.6663510101010102,41.20710784313725,1035.1715686274504,31.368835412953043,0
1676,4,0,0,33,0.0,0.0,1.0,33,1200,800,400,0.6666666666666666,16,8,8,392.9251434956656,0.37275094696969696,0.06753287728204915,0.24783606812129605,134106.1430699731,3938.735101883893,138044.87817185698,1652,17,682.4545454545455,33,0,17,30.879279066098746,0.6679292929292928,41.05392156862745,1035.7843137254904,31.387403446226983,0
1677,4,0,0,33,0.0,0.0,1.0,33,350,100,250,0.2857142857142857,6,1,5,390.19665226232456,0.37188289141414144,0.06678567076012065,0.24654129284198,134169.6177551904,3870.507136678215,138040.12489186862,1653,18,683.4545454545455,33,0,17,30.886266855926195,0.668560606060606,40.992647058823536,1036.0294117647068,31.39483065953657,0
1678,4,0,0,33,0.0,0.0,1.0,33,1000,700,300,0.7,13,7,6,390.6649278719427,0.3723958333333333,0.06750093173934268,0.2472651669225409,134233.10745866972,3888.033448673584,138121.1409073433,1654,19,684.4545454545455,33,0,17,30.810469883317563,0.6691919191919191,40.931372549019606,1036.2745098039213,31.4022578728461,0
1679,4,1,1,33,0.029411764705882353,0.029411764705882353,0.9705882352941176,34,950,700,250,0.7368421052631579,12,7,5,379.79057441037185,0.3777109328579917,0.0623742726376757,0.24227635910775852,134519.90504535148,3417.878401360547,137937.783446712,1655,0,665.2941176470588,34,0,17,30.805074210083397,0.6697303921568627,40.654761904761905,1037.3809523809525,30.51120448179272,0
1680,4,0,0,33,0.0,0.0,1.0,33,950,700,250,0.7368421052631579,12,7,5,387.31153949962174,0.372198547979798,0.06817555204651948,0.24663789005156525,134455.43968966277,3815.22866806038,138270.66835772316,1656,21,686.4545454545455,33,0,18,30.67457855764308,0.6714015151515151,40.71691176470589,1037.1323529411777,31.428253119429627,0
1681,4,0,0,33,0.0,0.0,1.0,33,900,700,200,0.7777777777777778,11,7,4,386.8153891868818,0.3721590909090909,0.07281872017817514,0.24718887001071507,134583.53261146825,3811.8301001400678,138395.36271160832,1657,22,687.4545454545455,32,1,19,30.559189178226656,0.6751302083333333,40.593434343434346,1037.626262626263,32.42582070707072,0
1682,4,0,0,33,0.0,0.0,1.0,33,400,200,200,0.5,6,2,4,399.2623988241169,0.3721590909090909,0.05981690033774578,0.23520236034881653,131548.03929077752,3904.4371455690043,135452.47643634654,1658,23,688.4545454545455,33,0,20,33.2958776330984,0.6423611111111112,43.53553921568627,1025.8578431372546,31.086601307189532,6
1683,4,0,0,33,0.0,0.0,1.0,33,1050,800,250,0.7619047619047619,13,8,5,402.37308761376715,0.371685606060606,0.05781308789904771,0.23801391114780457,131705.23356401385,3998.9282968089196,135704.16186082276,1659,24,689.4545454545455,33,0,18,33.0567494428526,0.6439393939393939,43.38235294117647,1026.4705882352941,31.10516934046346,0
1684,4,0,0,33,0.0,0.0,1.0,33,550,300,250,0.5454545454545454,8,3,5,389.4752743129782,0.371685606060606,0.03985303067871859,0.21846366916609733,129651.06398581761,3510.9510597393096,133162.01504555694,1660,25,690.4545454545455,32,1,13,35.475039259442916,0.6256510416666667,45.39141414141413,1018.4343434343422,31.826073232323193,5
1685,4,0,0,33,0.0,0.0,1.0,33,950,700,250,0.7368421052631579,12,7,5,389.98071891420955,0.37133049242424243,0.03649429495049605,0.21964650260687954,129811.85154894894,3524.823838128738,133336.67538707767,1661,26,691.4545454545455,32,1,15,35.29818692437945,0.6272786458333335,45.23358585858585,1019.0656565656553,31.84580176767673,0
1686,4,1,0,34,0.029411764705882353,0.0,1.0,34,1100,900,200,0.8181818181818182,13,9,4,376.9416455797868,0.37512997623291744,0.04474812622298785,0.21425208755924108,130168.77710796308,3013.2066092368004,133181.98371719988,1662,0,672.0882352941177,33,1,18,35.26717805532203,0.6284722222222223,44.883578431372534,1020.4656862745081,30.923202614379033,0
1687,4,0,0,34,0.0,0.0,1.0,34,1000,500,500,0.5,15,5,10,376.3457801313648,0.3757984254307784,0.042467184929427804,0.21460210090858292,130293.86421388388,3007.1091947808322,133300.97340866472,1663,1,673.0882352941177,33,1,18,35.155218461169135,0.6297348484848486,44.761029411764696,1020.9558823529395,30.938057040998167,0
1688,4,0,1,33,0.0,0.029411764705882353,0.9705882352941176,34,600,500,100,0.8333333333333334,7,5,2,377.67041286375434,0.3760769459298871,0.04087712857586667,0.21553081369731486,130325.14537677806,3043.9902921953008,133369.13566897335,1664,2,674.0882352941177,33,1,18,35.08961433829414,0.630050505050505,44.73039215686274,1021.0784313725482,30.941770647652973,0
1689,4,0,0,33,0.0,0.0,1.0,33,1050,800,250,0.7619047619047619,13,8,5,381.86440859245704,0.3767755681818182,0.055017417687380776,0.218478293176307,130423.7529971433,3360.83786093258,133784.59085807588,1665,3,685.2121212121212,32,1,19,34.88231355583025,0.6334635416666665,44.633838383838395,1021.4646464646477,31.92077020202024,0
1690,4,0,1,32,0.0,0.030303030303030304,0.9696969696969697,33,1150,600,550,0.5217391304347826,17,6,11,380.9647318580439,0.3772885101010101,0.05341779544892988,0.21868996735170274,130552.75769054188,3347.1992653810976,133899.95695592297,1666,4,686.2121212121212,32,1,16,34.774215468248094,0.634765625,44.507575757575765,1021.9696969696977,31.936553030303052,0
1691,4,1,1,32,0.030303030303030304,0.030303030303030304,0.9696969696969697,33,650,300,350,0.46153846153846156,10,3,7,379.900735623095,0.3768939393939394,0.055524371898785896,0.21880769253739848,130681.8261529436,3329.224377614536,134011.05053055813,1667,0,686.2424242424242,32,1,18,34.67034041327077,0.6360677083333333,44.381313131313135,1022.4747474747477,31.952335858585865,0
1692,4,0,0,32,0.0,0.0,1.0,32,400,200,200,0.5,6,2,4,389.3474747362213,0.371072748655914,0.0651084809481326,0.22317090096823441,130495.30241224506,3761.6032918294313,134256.90570407448,1668,6,708.6875,31,1,18,34.61845822182575,0.636760752688172,44.563802083333336,1021.7447916666671,32.959509408602166,0
1693,4,0,0,32,0.0,0.0,1.0,32,1000,700,300,0.7,13,7,6,389.3474747362213,0.371072748655914,0.0651084809481326,0.22317090096823441,130495.30241224506,3761.6032918294313,134256.90570407448,1669,7,709.6875,31,1,18,34.61845822182575,0.636760752688172,44.563802083333336,1021.7447916666671,32.959509408602166,0
1694,4,0,0,32,0.0,0.0,1.0,32,600,300,300,0.5,9,3,6,389.5386485008371,0.371072748655914,0.06301360045865723,0.22366414426357484,130561.83073255744,3771.7758178710887,134333.60655042852,1670,8,710.6875,31,1,18,34.54593472629211,0.6374327956989247,44.498697916666664,1022.0052083333328,32.96790994623654,0
1695,4,0,0,32,0.0,0.0,1.0,32,1100,900,200,0.8181818181818182,13,9,4,391.1202031457665,0.3709047379032258,0.06264723672481831,0.22534607155566444,130694.93823581276,3823.4861585829044,134518.42439439567,1671,9,711.6875,31,1,18,34.37022475487074,0.63877688172043,44.368489583333336,1022.5260416666671,32.98471102150539,0
1696,4,1,1,32,0.030303030303030304,0.030303030303030304,0.9696969696969697,33,750,600,150,0.8,9,6,3,384.6604990358196,0.3759075126262626,0.056928889337324096,0.22359942556856377,131037.09323347129,3480.9587350780757,134518.05196854935,1672,0,691.0909090909091,32,1,19,34.18809347638426,0.6396484375,44.03409090909092,1023.8636363636381,31.99573863636369,0
1697,4,0,0,32,0.0,0.0,1.0,32,800,500,300,0.625,11,5,6,395.7488949689248,0.370106686827957,0.06267888945426758,0.2295927722030051,130961.35669284406,3965.5624389648524,134926.9191318089,1673,1,713.375,31,1,19,33.981178179196874,0.6414650537634408,44.10807291666667,1023.567708333334,33.01831317204304,0
1698,4,0,0,32,0.0,0.0,1.0,32,1150,1000,150,0.8695652173913043,13,10,3,398.02209134935333,0.3696026545698925,0.062202154022112266,0.2325193642782524,131228.0464172363,4046.3322957356772,135274.378712972,1674,2,714.375,31,1,20,33.65222709365868,0.6441532258064516,43.84765625,1024.6093749999998,33.05191532258064,0
1699,4,1,1,32,0.030303030303030304,0.030303030303030304,0.9696969696969697,33,750,400,350,0.5333333333333333,11,4,7,387.79534083629153,0.3771701388888889,0.04789990263337529,0.22810004008784918,131489.9488094327,3598.2379030200977,135088.18671245282,1675,0,693.6969696969697,32,1,20,33.64879560096844,0.6442057291666667,43.592171717171716,1025.6313131313132,32.050978535353536,0
1700,4,0,0,32,0.0,0.0,1.0,32,950,800,150,0.8421052631578947,11,8,3,398.2991461017511,0.3696026545698925,0.09447052807735212,0.2235963264859308,129683.21352731864,3930.5426423324143,133613.75616965105,1676,4,716.375,32,0,19,35.21755299367795,0.6259765625,45.359848484848484,1018.5606060606061,31.83001893939394,7
1701,4,3,2,33,0.08571428571428572,0.05714285714285714,0.9428571428571428,35,600,500,100,0.8333333333333334,7,5,2,368.21137058308926,0.38658963585434175,0.07285747593511616,0.21028742588959648,130353.74858276639,2600.837807574814,132954.5863903412,1677,0,655.8857142857142,34,1,20,35.30203233076864,0.6280637254901962,44.70238095238095,1021.1904761904758,30.03501400560223,0
1702,4,1,1,33,0.029411764705882353,0.029411764705882353,0.9705882352941176,34,850,700,150,0.8235294117647058,10,7,3,375.08462526453565,0.3765225787284611,0.08210327041264276,0.21387804164020321,130292.9705215419,2974.1780045351416,133267.14852607704,1678,0,676.1470588235294,34,0,20,35.18831623134329,0.6274509803921569,44.76190476190476,1020.9523809523805,30.02801120448178,0
1703,4,1,1,33,0.029411764705882353,0.029411764705882353,0.9705882352941176,34,1000,700,300,0.7,13,7,6,376.57983456650055,0.3777295008912656,0.08147459939798285,0.2152350700030651,130384.14292800447,3020.0077947845734,133404.15072278905,1679,0,677.1176470588235,34,0,20,35.0575047596845,0.6283700980392157,44.672619047619044,1021.3095238095233,30.03851540616245,0
1704,4,1,0,34,0.029411764705882353,0.0,1.0,34,1100,900,200,0.8181818181818182,13,9,4,380.27224205689356,0.37752525252525254,0.09375727929187039,0.218541999350769,130597.00255102044,3132.4829931972818,133729.48554421772,1680,0,678.0882352941177,34,0,16,34.74697181458187,0.630514705882353,44.464285714285715,1022.1428571428575,30.063025210084042,0
1705,4,0,0,34,0.0,0.0,1.0,34,900,600,300,0.6666666666666666,12,6,6,382.656764087112,0.37732100415923947,0.09214499441960466,0.22077933245617049,130749.15143140589,3206.4094387755085,133955.5608701814,1681,1,679.0882352941177,34,0,17,34.53153493966554,0.632046568627451,44.31547619047619,1022.7380952380952,30.080532212885153,0
1706,4,0,1,33,0.0,0.029411764705882353,0.9705882352941176,34,1050,700,350,0.6666666666666666,14,7,7,381.04854640672676,0.3772653000594177,0.0900765239770569,0.2203722212529884,130840.48327664383,3171.315192743746,134011.79846938758,1682,2,680.0882352941177,34,0,17,34.479966643394604,0.6329656862745099,44.22619047619047,1023.0952380952369,30.091036414565792,0
1707,4,0,0,33,0.0,0.0,1.0,33,1050,600,450,0.5714285714285714,15,6,9,390.1135694305403,0.3728298611111111,0.09233964374151293,0.22516513488708778,130763.47588667825,3602.52126585929,134365.99715253754,1683,3,701.5454545454545,33,0,19,34.32632398753894,0.6344696969696969,44.3014705882353,1022.7941176470592,30.993761140819977,0
1708,4,0,0,33,0.0,0.0,1.0,33,1100,900,200,0.8181818181818182,13,9,4,392.5208434779743,0.3727114898989899,0.09006361060007295,0.22747686078310653,130920.20083922052,3677.78153234333,134597.98237156385,1684,4,702.5454545454545,33,0,20,34.10557118907916,0.6360479797979798,44.14828431372549,1023.4068627450982,31.012329174093885,0
1709,4,0,0,33,0.0,0.0,1.0,33,1000,700,300,0.7,13,7,6,395.0025676450147,0.37330334595959597,0.09074952492855792,0.22984968351265622,131077.01965590162,3755.151864667445,134832.17152056907,1685,5,703.5454545454545,33,0,21,33.882838678793696,0.6376262626262625,43.99509803921569,1024.0196078431377,31.030897207367808,0
1710,4,0,0,33,0.0,0.0,1.0,33,1100,800,300,0.7272727272727273,14,8,6,395.17720759217,0.37227746212121215,0.08948438808469894,0.2305154416094173,131171.15600069688,3767.170228998466,134938.32622969535,1686,6,704.5454545454545,33,0,21,33.78282390238066,0.6385732323232323,43.90318627450981,1024.3872549019611,31.042038027332154,0
1711,4,0,0,33,0.0,0.0,1.0,33,800,600,200,0.75,10,6,4,395.5740998013614,0.37247474747474746,0.0906952553884739,0.23112474133048116,131233.93233672154,3782.5489294982867,135016.48126621984,1687,7,705.5454545454545,33,0,21,33.70896124865448,0.6392045454545454,43.84191176470589,1024.6323529411773,31.049465240641734,0
1712,4,0,0,33,0.0,0.0,1.0,33,400,200,200,0.5,6,2,4,393.93879934632145,0.37247474747474746,0.08698803389068877,0.23035777903034552,131265.3261365821,3742.10099480969,135007.42713139177,1688,8,706.5454545454545,33,0,21,33.71900661723671,0.639520202020202,43.81127450980392,1024.7549019607843,31.053178847296493,0
1713,4,1,1,33,0.029411764705882353,0.029411764705882353,0.9705882352941176,34,700,400,300,0.5714285714285714,10,4,6,384.54409035410436,0.37620692216280455,0.07998355274718372,0.22615948644929723,131485.18786344194,3312.3854106593694,134797.5732741013,1689,0,686.7352941176471,33,1,22,33.736980722507674,0.6417297979797979,43.5968137254902,1025.6127450980393,31.07917409387998,0
1714,4,1,1,33,0.029411764705882353,0.029411764705882353,0.9705882352941176,34,850,600,250,0.7058823529411765,11,6,5,380.1906215224043,0.3791221033868093,0.07962320347293472,0.2245215983518062,131642.3445910226,3209.8369617454696,134852.18155276804,1690,0,687.7058823529412,33,1,15,33.68959477748587,0.6433080808080809,43.44362745098039,1026.2254901960775,31.097742127153865,0
1715,4,0,0,33,0.0,0.0,1.0,33,700,300,400,0.42857142857142855,11,3,8,391.9482511471019,0.37208017676767674,0.08618683138624061,0.23073823132746774,131522.32552800735,3709.9890955004616,135232.31462350782,1691,11,709.5454545454545,32,1,23,33.509508862629254,0.64453125,43.56060606060606,1025.7575757575758,32.05492424242424,0
1716,4,0,0,33,0.0,0.0,1.0,33,950,600,350,0.631578947368421,13,6,7,395.5789552204106,0.37211963383838387,0.09731418515867318,0.23366756889763782,131651.87225793282,3815.7420161208,135467.61427405363,1692,12,710.5454545454545,32,1,16,33.28514599737533,0.6458333333333334,43.43434343434343,1026.2626262626259,32.07070707070706,0
1717,4,0,0,33,0.0,0.0,1.0,33,900,600,300,0.6666666666666666,12,6,6,396.83555507141745,0.3720407196969697,0.09303365760930293,0.23480881097020584,131716.669536272,3853.971533517008,135570.641069789,1693,13,711.5454545454545,32,1,16,33.187269372693706,0.646484375,43.37121212121213,1026.515151515153,32.078598484848534,0
1718,4,0,0,33,0.0,0.0,1.0,33,750,600,150,0.8,9,6,3,425.30128975459047,0.3720407196969697,0.037186202615139496,0.2362448842804662,129267.58660210513,4425.700985126487,133693.2875872316,1694,14,712.5454545454545,31,2,16,34.955719163465645,0.6243279569892473,45.76822916666667,1016.9270833333342,32.80409946236562,7
1719,4,2,1,34,0.05714285714285714,0.02857142857142857,0.9714285714285714,35,850,500,350,0.5882352941176471,12,5,7,405.8525388446285,0.3824579831932773,0.02586719354007405,0.22848096550393265,129793.87622849383,3535.4348387639347,133329.31106725777,1695,0,672.7714285714286,33,2,17,34.9121817999599,0.6246843434343434,45.25122549019608,1018.9950980392155,30.87863933452168,0
1720,4,0,0,34,0.0,0.0,1.0,34,550,400,150,0.7272727272727273,7,4,3,412.37618351102014,0.3764668746286393,0.030416690256468426,0.2315993809015946,129700.23548635142,3897.057622068437,133597.29310841986,1696,1,693.5588235294117,33,1,17,34.84169473853065,0.6237373737373737,45.34313725490196,1018.6274509803923,30.86749851455734,0
1721,4,3,1,36,0.08108108108108109,0.02702702702702703,0.972972972972973,37,450,200,250,0.4444444444444444,7,2,5,383.93618813199254,0.3921734234234234,0.02702702702702675,0.21961149961149934,130414.54081632636,2616.605294078394,133031.14611040475,1697,0,638.2432432432432,34,3,19,34.83877233877233,0.6286764705882353,44.64285714285713,1021.4285714285701,30.04201680672265,0
1722,4,1,0,37,0.02702702702702703,0.0,1.0,37,850,700,150,0.8235294117647058,10,7,3,384.30525136453525,0.388231981981982,0.026145231691724113,0.2201674010153832,130475.34722222213,2628.4722222222126,133103.81944444435,1698,0,639.2162162162163,34,3,20,34.76753670473083,0.6292892156862746,44.58333333333333,1021.6666666666658,30.049019607843114,0
1723,4,1,3,35,0.02631578947368421,0.07894736842105263,0.9210526315789473,38,450,100,350,0.2222222222222222,8,1,7,378.12297324174676,0.39267721669037453,0.02729872218747209,0.2179201871226896,130706.03358892741,2284.5908082561637,132990.62439718356,1699,0,623.3684210526316,35,3,14,34.69121392190152,0.6294642857142857,44.357638888888886,1022.569444444444,29.216269841269828,0
1724,4,0,0,35,0.0,0.0,1.0,35,1000,600,400,0.6,14,6,8,404.297098143516,0.3817927170868347,0.03002816807507047,0.22963753665924955,130141.08737244908,3523.1327947845916,133664.22016723367,1700,3,677.7142857142857,34,1,18,34.5975284875355,0.6259191176470588,44.91071428571429,1020.3571428571436,30.010504201680693,0
1725,4,1,1,35,0.027777777777777776,0.027777777777777776,0.9722222222222222,36,800,500,300,0.625,11,5,6,396.8885407081752,0.38683862433862437,0.02803772578817587,0.22704639579976937,130419.01139285372,3152.4756011473255,133571.48699400105,1701,0,659.8611111111111,33,3,19,34.50347430513899,0.6309974747474747,44.638480392156865,1021.4460784313726,30.95291146761735,0
1726,4,1,1,35,0.027777777777777776,0.027777777777777776,0.9722222222222222,36,500,400,100,0.8,6,4,2,394.93934022829603,0.38556547619047615,0.02485141591889084,0.22608235346891342,130444.94224773257,3103.5678854875487,133548.51013322012,1702,0,660.8333333333334,34,2,19,34.526861671133915,0.6289828431372548,44.61309523809525,1021.5476190476202,30.045518207282946,0
1727,4,0,0,35,0.0,0.0,1.0,35,800,600,200,0.75,10,6,4,401.5075191401208,0.3811974789915966,0.0246411084834961,0.22930302923994403,130353.74858276662,3467.6020408163486,133821.35062358298,1703,6,680.7142857142857,34,1,19,34.45198958576203,0.628063725490196,44.70238095238096,1021.1904761904776,30.03501400560228,0
1728,4,0,0,35,0.0,0.0,1.0,35,450,200,250,0.4444444444444444,7,2,5,401.5075191401208,0.3811974789915966,0.0246411084834961,0.22930302923994403,130353.74858276662,3467.6020408163486,133821.35062358298,1704,7,681.7142857142857,34,1,19,34.45198958576203,0.628063725490196,44.70238095238096,1021.1904761904776,30.03501400560228,0
1729,4,0,0,35,0.0,0.0,1.0,35,550,200,350,0.36363636363636365,9,2,7,398.91247059079234,0.38053221288515404,0.021245421245421614,0.22817793317793322,130414.54081632655,3404.7973356009124,133819.33815192746,1705,8,682.7142857142857,34,1,19,34.456342268842285,0.6286764705882353,44.642857142857146,1021.4285714285716,30.042016806722692,0
1730,4,1,0,36,0.027777777777777776,0.0,1.0,36,1050,800,250,0.7619047619047619,13,8,5,390.69856189413514,0.3853339947089947,0.026985743380855354,0.22568587516472988,130794.81336805559,3020.2690972222263,133815.0824652778,1706,0,664.7222222222222,35,1,17,34.2795315682281,0.6303571428571428,44.270833333333336,1022.916666666667,29.226190476190485,0
1731,4,0,0,36,0.0,0.0,1.0,36,800,500,300,0.625,11,5,6,386.86194762192997,0.38566468253968256,0.022638166327376696,0.22415683754083263,130913.23329260977,2929.069680212624,133842.3029728224,1707,1,665.7222222222222,35,1,18,34.257426675714385,0.631547619047619,44.155092592592595,1023.37962962963,29.239417989418,0
1732,4,0,1,35,0.0,0.027777777777777776,0.9722222222222222,36,1050,600,450,0.5714285714285714,15,6,9,387.2923949262449,0.385135582010582,0.02629596142254398,0.22544494146759303,131090.963648834,2954.1066529492437,134045.07030178324,1708,2,666.7222222222222,35,1,19,34.06607896323086,0.6333333333333333,43.98148148148148,1024.074074074074,29.259259259259256,0
1733,4,0,1,34,0.0,0.02857142857142857,0.9714285714285714,35,650,500,150,0.7692307692307693,8,5,3,395.297305548379,0.38172268907563023,0.03825694017576797,0.22951799665162137,130992.77388038556,3356.218112244904,134348.99199263047,1709,3,685.7428571428571,34,1,19,33.96082877854013,0.6344975490196079,44.077380952380956,1023.6904761904768,30.108543417366967,0
1734,4,0,0,34,0.0,0.0,1.0,34,750,600,150,0.8,9,6,3,404.5242949005059,0.3780080213903743,0.039944903581267344,0.23405220638422242,130857.49959450714,3787.0075511822683,134644.50714568942,1710,4,706.5,33,1,19,33.8622140376093,0.6354166666666665,44.20955882352943,1023.1617647058841,31.004901960784366,0
1735,4,0,0,34,0.0,0.0,1.0,34,550,400,150,0.7272727272727273,7,4,3,404.5242949005059,0.3780080213903743,0.039944903581267344,0.23405220638422242,130857.49959450714,3787.0075511822683,134644.50714568942,1711,5,707.5,33,1,19,33.8622140376093,0.6354166666666665,44.20955882352943,1023.1617647058841,31.004901960784366,0
1736,4,1,1,34,0.02857142857142857,0.02857142857142857,0.9714285714285714,35,700,500,200,0.7142857142857143,9,5,4,394.7076500588631,0.38466386554621845,0.03478116490668781,0.23008567893675227,131145.15306122464,3352.799036281197,134497.95209750583,1712,0,688.2571428571429,34,1,19,33.821236246706945,0.6360294117647057,43.92857142857144,1024.2857142857156,30.126050420168106,0
1737,4,2,1,35,0.05555555555555555,0.027777777777777776,0.9722222222222222,36,1300,1200,100,0.9230769230769231,14,12,2,383.88389769692253,0.3857969576719577,0.023728442267096916,0.2257712115126879,131485.18786344212,2895.264383326883,134380.452246769,1713,0,670.0833333333334,33,3,20,33.75390827259331,0.6417297979797979,43.59681372549021,1025.6127450980407,31.07917409388002,0
1738,4,0,0,35,0.0,0.0,1.0,35,850,500,350,0.5882352941176471,12,5,7,396.171094639609,0.3819327731092437,0.03041894673869061,0.23223921425119043,131360.48179076132,3408.2451726864792,134768.72696344779,1714,1,690.2285714285714,32,3,20,33.56529950322289,0.6429036458333333,43.71843434343435,1025.126262626264,32.03519570707075,0
1739,4,0,0,35,0.0,0.0,1.0,35,850,600,250,0.7058823529411765,11,6,5,397.39437986847486,0.3821428571428571,0.03249824067558049,0.23315335003844082,131392.8425670852,3442.955438220614,134835.7980053058,1715,2,691.2285714285714,32,3,20,33.501128899835784,0.6432291666666665,43.6868686868687,1025.252525252527,32.03914141414147,0
1740,4,1,1,35,0.027777777777777776,0.027777777777777776,0.9722222222222222,36,1000,700,300,0.7,13,7,6,386.0516999210646,0.38506944444444446,0.027687579728632672,0.22847795527929618,131725.00177154224,2970.532171201848,134695.53394274408,1716,0,673.0,34,2,16,33.45558390351387,0.6418504901960782,43.363095238095255,1026.5476190476213,30.19257703081239,0
1741,4,1,1,35,0.027777777777777776,0.027777777777777776,0.9722222222222222,36,1000,900,100,0.9,11,9,2,392.02525508034824,0.3860449735449736,0.04318556276387575,0.23369903327718,132000.11337868485,3149.4756235827654,135149.5890022676,1717,0,673.9722222222222,34,2,18,33.02392261353103,0.6446078431372548,43.095238095238095,1027.619047619048,30.22408963585435,0
1742,4,0,0,35,0.0,0.0,1.0,35,600,300,300,0.5,9,3,6,400.133287005656,0.3822128851540616,0.04376406409819311,0.23747287146652968,131831.05656478286,3549.9987985390353,135381.0553633219,1718,1,694.1142857142858,33,2,18,32.98677406523467,0.6452020202020201,43.25980392156863,1026.9607843137262,31.120023767082614,0
1743,4,0,0,35,0.0,0.0,1.0,35,900,600,300,0.6666666666666666,12,6,6,401.5592299526223,0.38175770308123247,0.03359860943065063,0.23891206704704263,131925.4632382977,3595.1774858227536,135520.64072412046,1719,2,695.1142857142858,33,2,18,32.854561811602835,0.6461489898989898,43.16789215686274,1027.3284313725485,31.131164587046925,0
1744,4,0,0,35,0.0,0.0,1.0,35,650,600,50,0.9230769230769231,7,6,1,399.499347338096,0.3813375350140056,0.030687452082801103,0.238081167550102,131988.41979346887,3545.8575127354916,135534.27730620437,1720,3,696.1142857142858,33,2,18,32.84374378851123,0.646780303030303,43.106617647058826,1027.5735294117649,31.13859180035651,0
1745,4,1,2,34,0.027777777777777776,0.05555555555555555,0.9444444444444444,36,450,300,150,0.6666666666666666,6,3,3,390.172430883081,0.3865244708994709,0.02692740574001129,0.23376143279812361,132189.6316256215,3115.349981781543,135304.98160740302,1721,0,677.75,35,1,18,32.879970924779585,0.6443452380952381,42.910879629629626,1028.3564814814808,29.38161375661374,0
1746,4,0,0,34,0.0,0.0,1.0,34,650,400,250,0.6153846153846154,9,4,5,401.80121173589583,0.3811460190136661,0.03453295450559479,0.23945296093855625,131988.41979346887,3806.6214016243803,135795.04119509325,1722,5,706.5588235294117,33,1,18,32.784610415424375,0.646780303030303,43.106617647058826,1027.5735294117649,31.13859180035651,0
1747,4,0,0,34,0.0,0.0,1.0,34,550,300,250,0.5454545454545454,8,3,5,399.04498278967094,0.38107174688057044,0.04007252119877425,0.23820571321401918,132051.39136690213,3738.8890390715137,135790.28040597364,1723,6,707.5588235294117,33,1,18,32.79169647470291,0.6474116161616161,43.0453431372549,1027.8186274509803,31.14601901366607,0
1748,4,0,0,34,0.0,0.0,1.0,34,950,800,150,0.8421052631578947,11,8,3,397.3613783181697,0.37988339275103983,0.04184805849404527,0.2379913865430239,132177.37956855545,3704.4371455690252,135881.81671412446,1724,7,708.5588235294117,33,1,18,32.7075388312875,0.6486742424242424,42.922794117647065,1028.3088235294124,31.160873440285226,0
1749,4,0,0,34,0.0,0.0,1.0,34,900,800,100,0.8888888888888888,10,8,2,395.8046660189227,0.37943775995246587,0.04619045282833745,0.23745450764094497,132240.39619677534,3668.273170174945,135908.6693669503,1725,8,709.5588235294117,33,1,18,32.683858572620046,0.6493055555555556,42.86151960784314,1028.553921568628,31.16830065359479,0
1750,4,0,0,34,0.0,0.0,1.0,34,650,500,150,0.7692307692307693,8,5,3,393.54849284531804,0.377636660724896,0.049416527744700955,0.2370889700799842,132398.00347222216,3621.100808583228,136019.1042808054,1726,9,710.5588235294117,32,2,19,32.58265856950068,0.6533203125,42.70833333333333,1029.166666666666,32.161458333333314,0
1751,4,0,0,34,0.0,0.0,1.0,34,950,800,150,0.8421052631578947,11,8,3,393.54849284531804,0.377636660724896,0.049416527744700955,0.2370889700799842,132398.00347222216,3621.0069444444352,136019.0104166666,1727,10,711.5588235294117,32,2,19,32.58265856950068,0.6533203125,42.70833333333333,1029.166666666666,32.161458333333314,0
1752,4,0,0,34,0.0,0.0,1.0,34,900,600,300,0.6666666666666666,12,6,6,392.36192510978674,0.37767379679144386,0.0474275077380395,0.2367821447387187,132462.98408644518,3594.686288388928,136057.67037483412,1728,11,712.5588235294117,32,2,19,32.54757962304264,0.6539713541666667,42.645202020202014,1029.4191919191912,32.169349747474726,0
1753,4,0,0,34,0.0,0.0,1.0,34,650,500,150,0.7692307692307693,8,5,3,382.258349475952,0.37767379679144386,0.07659956914886346,0.21762835912395823,130232.20663265292,3156.4696712017953,133388.6763038547,1729,12,713.5588235294117,34,0,21,35.067014617836875,0.6268382352941178,44.82142857142856,1020.7142857142845,30.02100840336131,5
1754,4,2,2,34,0.05555555555555555,0.05555555555555555,0.9444444444444444,36,800,600,200,0.75,10,6,4,363.89203148812635,0.3879464285714285,0.06891524882179079,0.21003062896264893,130763.47588667826,2316.7680062221025,133080.24389290035,1730,0,674.8611111111111,33,3,19,34.996804856617935,0.634469696969697,44.3014705882353,1022.7941176470594,30.99376114081998,0
1755,4,1,0,35,0.02857142857142857,0.0,1.0,35,950,800,150,0.8421052631578947,11,8,3,373.517659340405,0.3834033613445378,0.08376296600595667,0.2155863336690885,130763.47588667825,2768.493488081513,133531.96937475976,1731,0,695.1142857142858,33,2,20,34.75067896796868,0.6344696969696969,44.3014705882353,1022.7941176470592,30.993761140819977,0
1756,4,0,0,35,0.0,0.0,1.0,35,950,800,150,0.8421052631578947,11,8,3,374.4851375094123,0.38319327731092434,0.08109495295124036,0.21684818988929208,130888.84833958093,2803.185673779317,133692.03401336024,1732,1,696.1142857142858,33,2,20,34.59880239520958,0.6357323232323232,44.17892156862745,1023.2843137254903,31.0086155674391,0
1757,4,0,0,35,0.0,0.0,1.0,35,650,400,250,0.6153846153846154,9,4,5,369.93353480074376,0.3820378151260504,0.0779982055627555,0.2146213584491764,130962.30867346934,2689.4699546485194,133651.77862811784,1733,2,697.1142857142858,34,1,20,34.640807939830964,0.6341911764705883,44.107142857142854,1023.5714285714282,30.105042016806713,0
1758,4,1,1,35,0.027777777777777776,0.027777777777777776,0.9722222222222222,36,800,500,300,0.625,11,5,6,365.43316024634686,0.3863095238095238,0.07883394383394382,0.21371733664792775,131270.41737683633,2394.1126937748527,133664.5300706112,1734,0,678.7222222222222,36,0,20,34.444139194139176,0.6331018518518519,43.806306306306304,1024.7747747747749,28.465965965965967,0
1759,4,0,0,35,0.0,0.0,1.0,35,800,600,200,0.75,10,6,4,373.00418297228157,0.38123249299719886,0.09015829984992974,0.21796739484182234,131239.16437596444,2790.5514564043106,134029.71583236873,1735,4,699.1142857142858,35,0,20,34.28181125042357,0.6348214285714285,43.83680555555555,1024.6527777777771,29.275793650793634,0
1760,4,0,0,35,0.0,0.0,1.0,35,500,300,200,0.6,7,3,4,373.00418297228157,0.38123249299719886,0.09015829984992974,0.21796739484182234,131239.16437596444,2790.5514564043106,134029.71583236873,1736,5,700.1142857142858,35,0,20,34.28181125042357,0.6348214285714285,43.83680555555555,1024.6527777777771,29.275793650793634,0
1761,4,0,0,35,0.0,0.0,1.0,35,1100,800,300,0.7272727272727273,14,8,6,376.42183849608205,0.3822128851540616,0.08330629322858885,0.22065652971406627,131359.53006355735,2889.3794437369306,134248.90950729427,1737,6,701.1142857142858,33,2,20,34.072399880454284,0.6404671717171717,43.719362745098046,1025.1225490196084,31.06431966726086,0
1762,4,0,0,35,0.0,0.0,1.0,35,1350,1200,150,0.8888888888888888,15,12,3,377.2819711251095,0.3819677871148459,0.08691258556236514,0.22188846214659458,131485.18786344194,2921.398170174942,134406.58603361688,1738,7,702.1142857142858,33,2,20,33.923183773449644,0.6417297979797979,43.5968137254902,1025.6127450980393,31.07917409387998,0
1763,4,0,0,35,0.0,0.0,1.0,35,1050,600,450,0.5714285714285714,15,6,9,375.797193138784,0.38235294117647056,0.08176034115138653,0.22211019707391078,131673.78720023544,2896.527927960402,134570.31512819586,1739,8,703.1142857142858,33,2,19,33.77052238805973,0.6436237373737373,43.41299019607843,1026.348039215686,31.101455733808667,0
1764,4,0,0,35,0.0,0.0,1.0,35,950,700,250,0.7368421052631579,12,7,5,373.9514620637948,0.3821428571428571,0.08513119533527713,0.22175083514738392,131799.59518274214,2857.330263600536,134656.92544634268,1740,9,704.1142857142858,33,2,19,33.69074969168957,0.6448863636363636,43.29044117647059,1026.838235294117,31.11631016042779,0
1765,4,1,0,36,0.027777777777777776,0.0,1.0,36,1250,900,350,0.72,16,9,7,364.25196598281127,0.3866898148148148,0.08820849461936509,0.21143826767577645,130982.91710219628,2354.0589857266427,133336.97608792293,1741,0,685.5277777777778,33,3,22,34.7653288239754,0.6366792929292929,44.08700980392157,1023.6519607843138,31.019756387403447,3
1766,4,0,1,35,0.0,0.027777777777777776,0.9722222222222222,36,800,500,300,0.625,11,5,6,342.1223624363052,0.3864748677248677,0.08677712800519832,0.19118602606734708,129504.14540816336,1668.8558297093477,131173.0012378727,1742,1,686.5277777777778,34,2,17,36.82992202729046,0.619485294117647,45.53571428571429,1017.8571428571436,29.936974789915986,7
1767,4,1,1,35,0.027777777777777776,0.027777777777777776,0.9722222222222222,36,1500,1400,100,0.9333333333333333,16,14,2,337.6732013258024,0.39155092592592594,0.07617342879872724,0.1893681643381603,129643.02722318674,1555.3952064043244,131198.42242959107,1743,0,675.5277777777778,35,1,17,36.80212240027276,0.6187499999999999,45.39930555555556,1018.4027777777778,29.097222222222225,0
1768,4,0,0,35,0.0,0.0,1.0,35,550,300,250,0.5454545454545454,8,3,5,344.4615350130263,0.38648459383753503,0.08668660307065212,0.19264163413318433,129534.44054705222,1923.9264455782431,131458.36699263047,1744,3,695.8285714285714,34,1,17,36.73961135149885,0.6197916666666666,45.50595238095239,1017.9761904761909,29.940476190476204,0
1769,4,0,0,35,0.0,0.0,1.0,35,650,400,250,0.6153846153846154,9,4,5,345.14171914436594,0.3853991596638655,0.08577437986178316,0.1940685172429361,129746.60572562377,1956.193310657617,131702.7990362814,1745,4,696.8285714285714,34,1,17,36.50677728441225,0.6219362745098038,45.29761904761906,1018.8095238095253,29.964985994397804,0
1770,4,0,0,35,0.0,0.0,1.0,35,550,500,50,0.9090909090909091,6,5,1,346.2979845401343,0.3855042016806723,0.0862483311081439,0.1950204439252336,129807.25623582774,1990.3982426303912,131797.65447845813,1746,5,697.8285714285714,34,1,17,36.4157418224299,0.6225490196078431,45.23809523809524,1019.0476190476196,29.971988795518225,0
1771,4,0,1,34,0.0,0.02857142857142857,0.9714285714285714,35,800,400,400,0.5,12,4,8,348.75067393879414,0.385609243697479,0.08695565121633786,0.19670640779077458,129867.92091836738,2058.304988662136,131926.22590702953,1747,6,698.8285714285714,34,1,17,36.2916569337382,0.6231617647058822,45.17857142857143,1019.2857142857147,29.978991596638668,0
1772,4,0,0,34,0.0,0.0,1.0,34,850,500,350,0.5882352941176471,12,5,7,357.6992655037716,0.3796977124183007,0.09570584698100548,0.20137233531915102,129793.87622849383,2485.4348387639347,132279.31106725777,1748,7,719.9117647058823,33,1,19,36.13888053718179,0.6246843434343434,45.25122549019608,1018.9950980392155,30.87863933452168,0
1773,4,1,0,35,0.02857142857142857,0.0,1.0,35,1050,800,250,0.7619047619047619,13,8,5,349.16451405348437,0.3849789915966386,0.09748879372115149,0.19863220829333242,130201.83000283442,2092.3717403628084,132294.20174319722,1749,0,700.3142857142857,34,1,20,35.94229946731988,0.626531862745098,44.851190476190474,1020.5952380952377,30.01750700280111,0
1774,4,1,0,36,0.027777777777777776,0.0,1.0,36,400,300,100,0.75,5,3,2,341.2030163947606,0.38936838624338627,0.10293229107662105,0.195444453323592,130469.43486636234,1703.3129447445203,132172.74781110685,1750,0,681.8333333333334,35,1,21,35.8744241154035,0.6270833333333332,44.589120370370374,1021.6435185185188,29.189814814814824,0
1775,4,1,1,36,0.02702702702702703,0.02702702702702703,0.972972972972973,37,950,600,350,0.631578947368421,13,6,7,330.760414750609,0.394237987987988,0.09853764797609799,0.19084917959117106,130751.61944038639,1249.491975083203,132001.11141546958,1751,0,664.3783783783783,36,1,17,35.85595133230567,0.6278935185185185,44.31306306306307,1022.7477477477482,28.409659659659674,0
1776,4,0,0,36,0.0,0.0,1.0,36,1150,900,250,0.782608695652174,14,9,5,339.61031469065307,0.3888888888888889,0.10234646144560178,0.19587446087510504,130735.62349965701,1679.8332475994484,132415.45674725645,1752,2,683.8333333333334,35,1,17,35.645842764448474,0.6297619047619047,44.3287037037037,1022.6851851851848,29.219576719576708,0
1777,4,0,0,36,0.0,0.0,1.0,36,550,300,250,0.5454545454545454,8,3,5,340.6033421694709,0.3892361111111111,0.10630493002904529,0.1965977619040896,130765.21675936627,1707.813973551083,132473.03073291737,1753,3,684.8333333333334,35,1,17,35.59053317490853,0.6300595238095239,44.29976851851851,1022.8009259259247,29.222883597883563,0
1778,4,0,0,36,0.0,0.0,1.0,36,800,600,200,0.75,10,6,4,342.154905191352,0.38897156084656087,0.10742563058477561,0.19810029579546445,130883.62328800155,1756.494743441359,132640.1180314429,1754,4,685.8333333333334,35,1,17,35.431158805564976,0.63125,44.18402777777778,1023.2638888888889,29.23611111111111,0
1779,4,1,1,36,0.02702702702702703,0.02702702702702703,0.972972972972973,37,950,700,250,0.7368421052631579,12,7,5,333.37355707013415,0.39164164164164167,0.10330647269961268,0.19438242789166263,131155.0401753103,1344.7244541838993,132499.7646294942,1755,0,668.2702702702703,36,1,17,35.3818528290824,0.6319444444444444,43.91891891891891,1024.3243243243232,28.453453453453424,0
1780,4,0,0,36,0.0,0.0,1.0,36,1050,900,150,0.8571428571428571,12,9,3,341.6021111216481,0.38733465608465606,0.10412899336950021,0.19884838678975914,131090.96364883386,1756.1899862825624,132847.1536351164,1756,6,687.8333333333334,35,1,18,35.235834840265234,0.6333333333333333,43.981481481481474,1024.0740740740728,29.25925925925922,0
1781,4,1,1,36,0.02702702702702703,0.02702702702702703,0.972972972972973,37,850,600,250,0.7058823529411765,11,6,5,335.5882941240594,0.39076576576576577,0.10142534992935848,0.19671115294882813,131357.78523930468,1416.6413483796334,132774.4265876843,1757,0,670.2162162162163,35,2,18,35.12064374694217,0.6360119047619047,43.72106481481482,1025.1157407407406,29.28902116402116,0
1782,4,0,0,36,0.0,0.0,1.0,36,1200,900,300,0.75,15,9,6,344.0412452905017,0.3875661375661376,0.09891598915989164,0.2015098722415796,131328.125,1836.4583333333335,133164.58333333334,1758,8,689.8333333333334,34,2,19,34.9339430894309,0.6378676470588236,43.75,1025.0,30.147058823529413,0
1783,4,0,0,36,0.0,0.0,1.0,36,600,200,400,0.3333333333333333,10,2,8,345.825201185052,0.3873677248677249,0.09851241162202595,0.20287783600856038,131389.1439909297,1887.5354308390015,133276.6794217687,1759,9,690.8333333333334,34,2,19,34.82664692676885,0.6384803921568627,43.69047619047619,1025.2380952380952,30.15406162464986,0
1784,4,1,0,37,0.02702702702702703,0.0,1.0,37,700,500,200,0.7142857142857143,9,5,4,338.52462148777,0.3903903903903904,0.10445251383033205,0.20076139317108946,131803.0907064473,1523.718278463667,133326.80898491098,1760,0,673.1351351351351,35,2,18,34.59667117523295,0.6404761904761904,43.287037037037045,1026.8518518518529,29.338624338624367,0
1785,4,1,1,37,0.02631578947368421,0.02631578947368421,0.9736842105263158,38,250,100,150,0.4,4,1,3,330.5499718521294,0.393655168326221,0.10068637346791554,0.197012964934728,131992.67415642017,1126.0349454184088,133118.70910183858,1761,0,656.3947368421053,36,2,18,34.6107305936073,0.6403356481481481,43.102477477477485,1027.5900900900917,28.544169169169216,0
1786,4,0,0,37,0.0,0.0,1.0,37,1200,1000,200,0.8333333333333334,14,10,4,339.5592412416454,0.39064064064064064,0.11367849435199351,0.2024812963723688,132011.1577958892,1565.121715320659,133576.27951120984,1762,2,675.1351351351351,35,2,18,34.360687202012244,0.6425595238095237,43.08449074074075,1027.662037037038,29.361772486772516,0
1787,4,0,0,37,0.0,0.0,1.0,37,750,300,450,0.4,12,3,9,343.7904511434874,0.3897647647647648,0.11528245570798767,0.20564919713855895,132130.12695312512,1685.0151909722374,133815.14214409736,1763,3,676.1351351351351,35,2,18,34.13226106045256,0.6437499999999999,42.96875000000001,1028.125000000001,29.375000000000025,0
1788,4,2,3,36,0.05128205128205128,0.07692307692307693,0.9230769230769231,39,1050,800,250,0.7619047619047619,13,8,5,328.62382860731657,0.39600202429149794,0.09880779182189459,0.19919961300670175,132629.89921932088,917.3403212122835,133547.23954053316,1764,0,642.4102564102565,36,3,16,34.02048941365111,0.6467013888888888,42.48310810810812,1030.0675675675693,28.612987987988035,0
1789,4,0,0,36,0.0,0.0,1.0,36,1000,600,400,0.6,14,6,8,342.66559327234876,0.38878968253968255,0.09973520489485299,0.20626750614527725,132367.37528344666,1871.5490362811706,134238.92431972784,1765,5,681.4722222222222,34,2,19,33.92261491593397,0.6482843137254901,42.738095238095234,1029.0476190476186,30.266106442577016,0
1790,4,0,0,36,0.0,0.0,1.0,36,1100,800,300,0.7272727272727273,14,8,6,341.6352033145109,0.38930224867724866,0.09691714836223486,0.20665346214479136,132551.19756235808,1856.8310657596098,134408.0286281177,1766,6,682.4722222222222,34,2,22,33.76445086705201,0.6501225490196079,42.559523809523796,1029.7619047619032,30.28711484593833,0
1791,4,0,0,36,0.0,0.0,1.0,36,950,700,250,0.7368421052631579,12,7,5,340.9911389083554,0.3890542328042328,0.09854321558354884,0.20676918885592127,132643.15653344657,1846.0282029478312,134489.1847363944,1767,7,683.4722222222222,34,2,16,33.68870141376788,0.6510416666666667,42.47023809523809,1030.1190476190463,30.29761904761901,0
1792,4,1,1,36,0.02702702702702703,0.02702702702702703,0.972972972972973,37,800,400,400,0.5,12,4,8,333.47617590041824,0.39329954954954954,0.09238329238329213,0.20379099638358886,132934.5703124999,1466.1024305555422,134400.67274305545,1768,0,665.972972972973,35,2,17,33.59006734006733,0.6517857142857144,42.18749999999999,1031.2499999999993,29.464285714285694,0
1793,4,0,0,36,0.0,0.0,1.0,36,1150,900,250,0.782608695652174,14,9,5,341.0799722122198,0.3879133597883598,0.09505524117488595,0.20784035745148552,132827.17013888876,1860.9374999999823,134688.10763888873,1769,9,685.4722222222222,34,2,18,33.501751549447604,0.6528799019607844,42.29166666666666,1030.8333333333321,30.318627450980358,0
1794,4,0,0,36,0.0,0.0,1.0,36,1050,700,350,0.6666666666666666,14,7,7,341.3822771527752,0.38654100529100527,0.09984031705721708,0.2087081628069506,132949.91673752823,1877.349064625844,134827.26580215408,1770,10,686.4722222222222,34,2,19,33.37084920543307,0.6541053921568627,42.172619047619044,1031.309523809523,30.33263305322126,0
1795,4,0,0,36,0.0,0.0,1.0,36,850,500,350,0.5882352941176471,12,5,7,341.670994699356,0.38700396825396827,0.10168730928020064,0.2094003422959421,133042.01388888896,1891.31944444445,134933.3333333334,1771,11,687.4722222222222,34,2,19,33.271068928379094,0.6550245098039216,42.083333333333336,1031.6666666666672,30.343137254901976,0
1796,4,0,0,36,0.0,0.0,1.0,36,900,700,200,0.7777777777777778,11,7,4,337.94068784473495,0.3864087301587302,0.09369994489934563,0.20796903508173842,133195.58000283432,1802.4411848072432,134998.02118764157,1772,12,688.4722222222222,34,2,21,33.21344135624497,0.6565563725490196,41.9345238095238,1032.2619047619037,30.36064425770305,0
1797,4,0,0,36,0.0,0.0,1.0,36,1200,900,300,0.75,15,9,6,337.55645320466596,0.386276455026455,0.09126984126984117,0.2080758435425777,133257.03125,1796.3541666666672,135053.38541666666,1773,13,689.4722222222222,34,2,21,33.161824051654555,0.6571691176470589,41.875,1032.5,30.36764705882353,0
1798,4,0,0,36,0.0,0.0,1.0,36,1200,900,300,0.75,15,9,6,337.8025376713703,0.3861111111111111,0.09406805699581411,0.20926397033903082,133441.47002551015,1815.3734410430802,135256.84346655323,1774,14,690.4722222222222,34,2,22,32.970868379613634,0.6590073529411764,41.69642857142857,1033.2142857142853,30.38865546218486,0
1799,4,0,1,35,0.0,0.027777777777777776,0.9722222222222222,36,1100,800,300,0.7272727272727273,14,8,6,349.12451604283245,0.3861111111111111,0.09781238341502352,0.20896662820942064,132153.07716836708,2027.5758219954325,134180.65299036252,1775,15,691.4722222222222,34,2,19,33.97205819922039,0.646139705882353,42.946428571428555,1028.2142857142835,30.2415966386554,3
1800,4,0,0,35,0.0,0.0,1.0,35,1100,700,400,0.6363636363636364,15,7,8,356.6451392486306,0.38224789915966384,0.10745882232707071,0.21289557173510756,132051.39136690195,2419.097372404819,134470.48873930678,1776,16,711.4857142857143,33,2,20,33.88118019951511,0.6474116161616162,43.04534313725489,1027.818627450979,31.14601901366603,0
1801,4,0,0,35,0.0,0.0,1.0,35,1250,1000,250,0.8,15,10,5,358.3885903796447,0.38242296918767504,0.11152150601691901,0.21500753674455714,132240.39619677502,2478.6898368415673,134719.0860336166,1777,17,712.4857142857143,33,2,20,33.645969855832234,0.6493055555555557,42.86151960784312,1028.5539215686254,31.16830065359471,0
1802,4,0,0,35,0.0,0.0,1.0,35,1350,900,450,0.6666666666666666,18,9,9,357.4523809523812,0.3818627450980392,0.1046122448979594,0.21570402298850563,132461.07266435964,2469.7051614763295,134930.77782583598,1778,18,713.4857142857143,33,2,21,33.44791666666668,0.6515151515151516,42.6470588235294,1029.4117647058806,31.1942959001782,0
1803,4,0,0,35,0.0,0.0,1.0,35,950,800,150,0.8421052631578947,11,8,3,357.90512388396854,0.3818627450980392,0.12702822925577428,0.20724741916998193,130888.84833958105,2369.1578960015545,133258.0062355826,1779,19,714.4857142857143,33,2,17,35.02295409181637,0.6357323232323231,44.17892156862746,1023.2843137254912,31.008615567439126,6
1804,4,0,0,35,0.0,0.0,1.0,35,900,700,200,0.7777777777777778,11,7,4,357.50722978229896,0.38207282913165264,0.1256704980842911,0.20735419327373367,130951.55709342584,2363.2256824298634,133314.7827758557,1780,20,715.4857142857143,33,2,19,34.96966794380587,0.6363636363636362,44.11764705882354,1023.5294117647078,31.01604278074872,0
1805,4,0,0,35,0.0,0.0,1.0,35,900,500,400,0.5555555555555556,13,5,8,356.1734105329733,0.3818627450980392,0.12351885098743298,0.20708621050821108,131045.64838343434,2334.9951040465317,133380.64348748088,1781,21,716.4857142857143,33,2,19,34.90861260722123,0.637310606060606,44.02573529411765,1023.8970588235301,31.027183600713034,0
1806,4,0,0,35,0.0,0.0,1.0,35,600,400,200,0.6666666666666666,8,4,4,356.3385787880428,0.381547619047619,0.12495256329168036,0.2075206622252039,131108.39468293462,2343.795805699755,133452.19048863437,1782,22,717.4857142857143,33,2,19,34.84092676797894,0.6379419191919191,43.96446078431374,1024.1421568627466,31.034610814022624,0
1807,4,0,0,35,0.0,0.0,1.0,35,800,700,100,0.875,9,7,2,355.74412588701534,0.3816176470588235,0.12113629371346524,0.20734375203372912,131139.77346453295,2330.4408160323037,133470.21428056524,1783,23,718.4857142857143,33,2,19,34.8244197176358,0.6382575757575757,43.93382352941177,1024.2647058823536,31.038324420677384,0
1808,4,0,0,35,0.0,0.0,1.0,35,1000,1000,0,1.0,10,10,0,355.9141389782743,0.38165266106442575,0.11772986640243266,0.20812265945009317,131265.32613658224,2343.8371059208175,133609.16324250307,1784,24,719.4857142857143,33,2,20,34.693155544925446,0.639520202020202,43.81127450980393,1024.7549019607854,31.05317884729653,0
1809,4,1,1,35,0.027777777777777776,0.027777777777777776,0.9722222222222222,36,600,500,100,0.8333333333333334,7,5,2,348.295226476871,0.38523478835978836,0.09725123127304602,0.20530836263869182,131572.2859977324,1965.1998299319678,133537.48582766438,1785,0,700.4722222222222,34,2,17,34.578546839947386,0.6403186274509804,43.51190476190476,1025.9523809523807,30.1750700280112,0
1810,4,1,1,35,0.027777777777777776,0.027777777777777776,0.9722222222222222,36,300,200,100,0.6666666666666666,4,2,2,348.295226476871,0.3864914021164021,0.09725123127304602,0.20530836263869182,131572.2859977324,1965.1998299319678,133537.48582766438,1786,0,701.4444444444445,34,2,17,34.578546839947386,0.6403186274509804,43.51190476190476,1025.9523809523807,30.1750700280112,0
1811,4,0,0,35,0.0,0.0,1.0,35,650,500,150,0.7692307692307693,8,5,3,356.7631453861076,0.38095238095238093,0.10280252602833251,0.20999349696777211,131516.61169982693,2384.05601211072,133900.66771193765,1787,27,722.4857142857143,33,2,21,34.41756272401433,0.6420454545454546,43.56617647058823,1025.7352941176466,31.082887700534744,0
1812,4,0,0,35,0.0,0.0,1.0,35,700,500,200,0.7142857142857143,9,5,4,358.2768215394568,0.3810924369747899,0.10447068459490838,0.2112319401357982,131579.47063629387,2428.374903883142,134007.84554017702,1788,28,723.4857142857143,33,2,17,34.31527711419017,0.6426767676767676,43.50490196078432,1025.980392156864,31.09031491384436,0
1813,4,0,0,35,0.0,0.0,1.0,35,1050,700,350,0.6666666666666666,14,7,7,363.7429806279209,0.3810924369747899,0.11127783569463245,0.21217917481289494,131171.15600069656,2542.517451220647,133713.67345191722,1789,29,724.4857142857143,33,2,21,34.58784443912748,0.6385732323232325,43.903186274509785,1024.3872549019584,31.042038027332072,1
1814,4,0,0,35,0.0,0.0,1.0,35,1300,1000,300,0.7692307692307693,16,10,6,368.4506490515499,0.3811624649859944,0.12514470112175413,0.21633870741153108,131422.35145436847,2684.530138648594,134106.88159301705,1790,30,725.4857142857143,33,2,21,34.21315385841202,0.6410984848484849,43.658088235294116,1025.3676470588234,31.071746880570405,0
1815,4,0,0,35,0.0,0.0,1.0,35,400,100,300,0.25,7,1,6,367.4244778433,0.3816176470588235,0.12249385413821368,0.21591348529443352,131453.76778162242,2659.866397539404,134113.63417916183,1791,31,726.4857142857143,33,2,21,34.20769598470364,0.6414141414141414,43.627450980392155,1025.4901960784312,31.075460487225186,0
1816,4,0,0,35,0.0,0.0,1.0,35,750,500,250,0.6666666666666666,10,5,5,367.91823047984633,0.38182773109243695,0.1291670222025023,0.21673775561905664,131548.03929077758,2679.7843677912415,134227.8236585688,1792,32,727.4857142857143,33,2,21,34.09974415641304,0.642361111111111,43.53553921568628,1025.857843137255,31.086601307189547,0
1817,4,1,0,36,0.027777777777777776,0.0,1.0,36,900,700,200,0.7777777777777778,11,7,4,357.22022887539873,0.3870701058201058,0.13147203873244018,0.2124364820789671,131908.37762188195,2224.0681689342277,134132.4457908162,1793,0,708.25,34,2,20,34.01055549117319,0.6436887254901962,43.1845238095238,1027.2619047619037,30.213585434173638,0
1818,4,0,0,36,0.0,0.0,1.0,36,600,500,100,0.8333333333333334,7,5,2,357.76193692272375,0.3869212962962963,0.13216170979786313,0.21293003556159357,131938.95266439908,2240.547052154196,134179.49971655328,1794,1,709.25,34,2,20,33.965816917728866,0.6439950980392157,43.154761904761905,1027.3809523809523,30.21708683473389,0
1819,4,2,1,37,0.05263157894736842,0.02631578947368421,0.9736842105263158,38,750,600,150,0.8,9,6,3,342.1253585882581,0.39218824087245135,0.13947282054825272,0.20642692428087572,132455.95838659603,1463.3084520331095,133919.26683862915,1795,0,672.8684210526316,36,2,22,33.84750027349306,0.6449652777777779,42.652027027027025,1029.3918918918916,28.594219219219212,0
1820,4,0,0,37,0.0,0.0,1.0,37,1000,600,400,0.6,14,6,8,352.10818343926456,0.3919544544544544,0.1436679058993766,0.21195625314546365,132368.2260186255,1921.5871216992314,134289.81314032472,1796,1,660.5405405405405,35,2,22,33.67883721366178,0.6461309523809524,42.73726851851851,1029.0509259259245,29.401455026454986,0
1821,4,0,0,37,0.0,0.0,1.0,37,1150,700,450,0.6086956521739131,16,7,9,350.5186564049038,0.3918918918918919,0.14072043710001902,0.21150019878325732,132457.56842635456,1885.7697830932757,134343.33820944783,1797,2,661.5405405405405,35,2,22,33.62988156809834,0.6470238095238094,42.65046296296296,1029.3981481481478,29.41137566137565,0
1822,4,0,0,37,0.0,0.0,1.0,37,1600,1200,400,0.75,20,12,8,345.18224227881865,0.3918918918918919,0.13713005219577612,0.2094387960820561,132666.15125868042,1758.799913194439,134424.95117187485,1798,3,662.5405405405405,35,2,17,33.55767610380858,0.6491071428571429,42.447916666666664,1030.2083333333323,29.434523809523782,0
1823,4,0,0,37,0.0,0.0,1.0,37,600,300,300,0.5,9,3,6,343.58953210830475,0.39157907907907913,0.1376793553832425,0.20863806376726649,132695.96220207462,1718.588713134414,134414.55091520902,1799,4,663.5405405405405,35,2,17,33.568767318205644,0.6494047619047618,42.418981481481474,1030.324074074073,29.437830687830658,0
1824,4,0,0,37,0.0,0.0,1.0,37,900,800,100,0.8888888888888888,10,8,2,343.6232473927533,0.39154779779779775,0.1353871000057676,0.20882442126537087,132725.77649444877,1721.5324663494537,134447.30896079823,1800,5,664.5405405405405,35,2,18,33.53796941105993,0.649702380952381,42.3900462962963,1030.4398148148152,29.441137566137577,0
1825,4,0,1,36,0.0,0.02702702702702703,0.972972972972973,37,350,100,250,0.2857142857142857,6,1,5,347.5897601361711,0.39142267267267267,0.13790884978848172,0.2117396993004608,132815.23946544906,1833.0434456447026,134648.28291109376,1801,6,665.5405405405405,35,2,18,33.34596526686129,0.6505952380952382,42.30324074074073,1030.7870370370358,29.451058201058167,0
1826,4,0,0,36,0.0,0.0,1.0,36,950,800,150,0.8421052631578947,11,8,3,354.359838484081,0.3873181216931217,0.14501893574683855,0.21522697558454196,132704.48022959183,2205.0276360544194,134909.50786564624,1802,7,684.8055555555555,34,2,18,33.282784517619874,0.6516544117647058,42.410714285714285,1030.357142857143,30.304621848739497,0
1827,4,0,0,36,0.0,0.0,1.0,36,500,300,200,0.6,7,3,4,354.359838484081,0.3873181216931217,0.14501893574683855,0.21522697558454196,132704.48022959183,2205.0276360544194,134909.50786564624,1803,8,685.8055555555555,34,2,18,33.282784517619874,0.6516544117647058,42.410714285714285,1030.357142857143,30.304621848739497,0
1828,4,0,0,36,0.0,0.0,1.0,36,850,600,250,0.7058823529411765,11,6,5,355.70753484204414,0.38740079365079366,0.14100590197587892,0.21693149660085218,132857.85147392284,2251.7077664399035,135109.55924036275,1804,9,686.8055555555555,34,2,18,33.093966512702075,0.6531862745098038,42.26190476190476,1030.9523809523805,30.322128851540604,0
1829,4,0,0,36,0.0,0.0,1.0,36,650,400,250,0.6153846153846154,9,4,5,353.56622324192335,0.3873677248677249,0.13989584135047073,0.21597959278713275,132919.22477324272,2199.149659863953,135118.37443310668,1805,10,687.8055555555555,34,2,18,33.08752789963825,0.6537990196078431,42.202380952380956,1031.1904761904768,30.329131652661083,0
1830,4,0,0,36,0.0,0.0,1.0,36,650,400,250,0.6153846153846154,9,4,5,364.1762822083416,0.38695436507936504,0.13487077909828393,0.20988241704570754,130706.03358892738,2320.007474922832,133026.04106385022,1806,11,688.8055555555555,35,1,18,35.047750424448225,0.6294642857142857,44.357638888888886,1022.5694444444438,29.21626984126982,6
1831,4,0,0,36,0.0,0.0,1.0,36,350,200,150,0.5714285714285714,5,2,3,363.81962908731947,0.3871031746031746,0.1405861054537232,0.2101593386845573,130794.81336805546,2317.1440972222117,133111.95746527766,1807,12,689.8055555555555,35,1,19,34.96690427698574,0.6303571428571428,44.27083333333333,1022.9166666666658,29.226190476190453,0
1832,4,0,0,36,0.0,0.0,1.0,36,600,300,300,0.5,9,3,6,360.93756555819806,0.38655753968253964,0.13494980335984552,0.20929645194958302,130942.84664619755,2252.4384591477856,133195.28510534533,1808,13,690.8055555555555,35,1,19,34.89070922386821,0.6318452380952382,44.1261574074074,1023.4953703703691,29.24272486772483,0
1833,4,0,0,36,0.0,0.0,1.0,36,750,500,250,0.6666666666666666,10,5,5,359.7865506728051,0.3862103174603175,0.1324257270271969,0.2089502324820065,131002.08340031283,2226.5575435099327,133228.64094382277,1809,14,691.8055555555555,35,1,19,34.86020821556435,0.6324404761904763,44.06828703703703,1023.726851851851,29.249338624338602,0
1834,4,0,0,36,0.0,0.0,1.0,36,800,600,200,0.75,10,6,4,373.7761028348849,0.3862103174603175,0.08585714466892469,0.20377426489959083,128525.67361379018,2408.37030606995,130934.04391986012,1810,15,692.8055555555555,35,1,16,37.023575124605266,0.6074404761904761,46.49884259259259,1014.0046296296287,28.97156084656082,5
1835,4,1,0,37,0.02702702702702703,0.0,1.0,37,1100,800,300,0.7272727272727273,14,8,6,367.1828151084852,0.39192317317317316,0.08853112680067765,0.20171560500932326,128829.56594685902,2060.8005387143876,130890.36648557341,1811,0,675.0540540540541,36,1,18,36.88019966722129,0.6085069444444444,46.19932432432432,1015.2027027027027,28.200075075075077,0
1836,4,0,0,37,0.0,0.0,1.0,37,750,500,250,0.6666666666666666,10,5,5,369.75554741826534,0.39182932932932935,0.09235507539464982,0.20401007909848132,129001.10995708543,2139.775205949189,131140.8851630346,1812,1,676.0540540540541,36,1,18,36.639738757713495,0.6102430555555556,46.0304054054054,1015.8783783783781,28.218843843843835,0
1837,4,3,1,39,0.075,0.025,0.975,40,650,500,150,0.7692307692307693,8,5,3,348.0920789204895,0.4021233974358975,0.10119572057898063,0.19544816728079736,129690.63321827716,1029.0117762992982,130719.64499457646,1813,0,626.275,38,2,16,36.488488567233055,0.6134868421052633,45.35256410256409,1018.5897435897413,26.804993252361612,0
1838,4,0,0,39,0.0,0.0,1.0,39,1200,900,300,0.75,15,9,6,356.3969730290915,0.39951641925326137,0.10155943805028866,0.20017701810400582,129703.52055440123,1445.1884233610183,131148.70897776226,1814,1,643.3333333333334,37,2,16,36.263903839253665,0.615427927927928,45.339912280701746,1018.640350877192,27.53082029397816,0
1839,4,0,0,39,0.0,0.0,1.0,39,850,500,350,0.5882352941176471,12,5,7,356.14212788015766,0.39909469185784974,0.1043187498965421,0.20060514766776874,129815.23762119106,1446.5349915358495,131261.7726127269,1815,2,644.3333333333334,37,2,16,36.15683953805323,0.6165540540540541,45.23026315789473,1019.0789473684205,27.542674253200552,0
1840,4,1,1,39,0.025,0.025,0.975,40,1200,900,300,0.75,15,9,6,349.0172911343513,0.4032451923076923,0.11168097132091281,0.19871938018460025,130235.32238476149,1090.8758857476814,131326.19827050917,1816,0,629.2,38,2,18,35.91209615518806,0.6189692982456141,44.81837606837607,1020.7264957264957,26.86122357174989,0
1841,4,1,1,39,0.025,0.025,0.975,40,900,500,400,0.5555555555555556,13,5,8,346.8900934093833,0.4004273504273504,0.1126932989690721,0.1979314062394718,130318.55955678683,1041.2463130945807,131359.8058698814,1817,0,630.05,37,3,19,35.88201603665522,0.6216216216216215,44.736842105263165,1021.0526315789484,27.596017069701308,0
1842,4,1,0,40,0.025,0.0,1.0,40,1100,700,400,0.6363636363636364,15,7,8,345.47657159796506,0.40252403846153845,0.12373457435682877,0.19781119626465546,130453.5176510339,1013.7268061947784,131467.24445722866,1818,0,631.025,38,2,20,35.78139161960537,0.6211622807017543,44.604700854700866,1021.5811965811984,26.88371569950522,0
1843,4,0,0,40,0.0,0.0,1.0,40,750,400,350,0.5333333333333333,11,4,7,348.4870824255655,0.40239049145299144,0.131078820823751,0.20009768490293894,130562.68376981534,1099.8817481189474,131662.5655179343,1819,1,632.025,38,2,16,35.593943828838256,0.6222587719298245,44.49786324786326,1022.0085470085482,26.89496176338285,0
1844,4,0,1,39,0.0,0.025,0.975,40,1050,800,250,0.7619047619047619,13,8,5,348.4870824255655,0.40239049145299144,0.131078820823751,0.20009768490293894,130562.68376981534,1099.8817481189474,131662.5655179343,1820,2,633.025,38,2,16,35.593943828838256,0.6222587719298245,44.49786324786326,1022.0085470085482,26.89496176338285,0
1845,4,0,0,39,0.0,0.0,1.0,39,1400,1100,300,0.7857142857142857,17,11,6,357.1670211555864,0.3991790373369321,0.12510046129625363,0.20438378188485545,130430.54112803958,1517.097568482632,131947.63869652222,1821,3,650.0769230769231,37,2,19,35.5061185057965,0.6227477477477477,44.62719298245615,1021.4912280701769,27.6078710289237,0
1846,4,0,0,39,0.0,0.0,1.0,39,950,600,350,0.631578947368421,13,6,7,356.99232231960696,0.3981950067476383,0.12900280010342224,0.20517154307419078,130598.60365689437,1524.539762234524,132123.1434191289,1822,4,651.0769230769231,37,2,16,35.340234570549946,0.6244369369369369,44.46271929824561,1022.1491228070171,27.625651967757218,0
1847,4,0,1,38,0.0,0.02564102564102564,0.9743589743589743,39,1500,1000,500,0.6666666666666666,20,10,10,351.18450435289213,0.39825123706702653,0.12245458943572207,0.20271343172053047,130766.7743921204,1384.6529701446336,132151.42736226504,1823,5,652.0769230769231,37,2,16,35.3183962264151,0.6261261261261262,44.298245614035075,1022.8070175438576,27.643432906590746,0
1848,4,0,0,38,0.0,0.0,1.0,38,800,500,300,0.625,11,5,6,356.6849901524189,0.39666311047889996,0.12361289873725956,0.2051955855895852,130636.47050766963,1719.213639314964,132355.6841469846,1824,6,669.5,36,2,16,35.3097231401924,0.6267361111111112,44.42567567567566,1022.2972972972957,28.397147147147102,0
1849,4,1,0,39,0.02564102564102564,0.0,1.0,39,1150,800,350,0.6956521739130435,15,8,7,355.86162242285894,0.39943207377417905,0.13625071713070924,0.20736764909868496,131131.51552641168,1532.9347731994167,132664.45029961108,1825,0,653.3076923076923,37,2,19,34.82976037540591,0.6297860360360361,43.94188596491227,1024.2324561403486,27.681958274063476,0
1850,4,0,0,39,0.0,0.0,1.0,39,1050,700,350,0.6666666666666666,14,7,7,355.47589692015424,0.39937584345479077,0.14007068844397663,0.20759792380136977,131215.75869498285,1528.8079024314943,132744.56659741435,1826,1,654.3076923076923,37,2,19,34.75447702625571,0.6306306306306307,43.85964912280701,1024.5614035087701,27.690848743480274,0
1851,4,1,1,39,0.025,0.025,0.975,40,900,600,300,0.6666666666666666,12,6,6,346.0814332725665,0.401963141025641,0.1312545568169985,0.2037233501440779,131519.83486969466,1103.3145910950382,132623.1494607897,1827,0,638.925,38,2,21,34.68822692080685,0.6318530701754386,43.56303418803419,1025.7478632478633,26.99336482231219,0
1852,4,0,1,38,0.0,0.02564102564102564,0.9743589743589743,39,1550,1200,350,0.7741935483870968,19,12,7,350.62892767353185,0.3978295096716149,0.13496142197371475,0.20642754048998668,131524.88175448202,1423.2856503924127,132948.16740487443,1828,3,656.3076923076923,37,2,21,34.56651968644217,0.6337274774774775,43.55811403508771,1025.7675438596482,27.723447131341842,0
1853,4,0,1,37,0.0,0.02631578947368421,0.9736842105263158,38,850,500,350,0.5882352941176471,12,5,7,355.08367688398647,0.39813003793266954,0.12007752341010547,0.20939594693139166,131587.9662390431,1744.94777716906,133332.91401621216,1829,4,634.5,36,2,16,34.38860534884571,0.6362847222222222,43.49662162162162,1026.0135135135135,28.500375375375377,0
1854,4,0,0,37,0.0,0.0,1.0,37,1000,800,200,0.8,12,8,4,360.77198587956383,0.39617742742742745,0.1177664974619288,0.21279066233016197,131595.18771701396,2095.171440972227,133690.35915798618,1830,5,643.7027027027027,35,2,17,34.23540609137056,0.6383928571428571,43.489583333333336,1026.0416666666672,29.315476190476204,0
1855,4,0,0,37,0.0,0.0,1.0,37,600,400,200,0.6666666666666666,8,4,4,359.9019264961428,0.3966153653653654,0.12112789379365863,0.21277401894451975,131684.2689043211,2078.684413580264,133762.95331790135,1831,6,644.7027027027027,35,2,18,34.16779431664413,0.6392857142857142,43.402777777777786,1026.3888888888898,29.32539682539685,0
1856,4,0,1,36,0.0,0.02702702702702703,0.972972972972973,37,900,700,200,0.7777777777777778,11,7,4,361.5585337095027,0.39720970970970976,0.12197343291674412,0.21458922204711825,131832.80452942822,2133.055100094314,133965.85962952254,1832,7,645.7027027027027,35,2,19,33.97537942822795,0.6407738095238094,43.258101851851855,1026.967592592593,29.34193121693123,0
1857,4,1,1,36,0.02702702702702703,0.02702702702702703,0.972972972972973,37,1050,800,250,0.7619047619047619,13,8,5,356.92985508674565,0.3975538038038038,0.12037569484377997,0.21350894967916254,132130.12695312512,2032.2374131944594,134162.36436631958,1833,0,642.5675675675676,35,2,20,33.7945373184735,0.6437499999999999,42.96875000000001,1028.125000000001,29.375000000000025,0
1858,4,0,0,36,0.0,0.0,1.0,36,800,300,500,0.375,13,3,10,364.9218498797497,0.39489087301587306,0.13036415106478816,0.21806921617381592,132091.8810232427,2440.642715419513,134532.52373866222,1834,9,661.4166666666666,34,2,20,33.627678054429666,0.6455269607843137,43.00595238095239,1027.976190476191,30.23459383753503,0
1859,4,0,0,36,0.0,0.0,1.0,36,650,400,250,0.6153846153846154,9,4,5,366.992479425463,0.395353835978836,0.1352872321267784,0.21983918427719476,132183.68055555547,2502.0833333333285,134685.76388888882,1835,10,662.4166666666666,34,2,20,33.48190167477039,0.6464460784313726,42.916666666666664,1028.3333333333328,30.24509803921567,0
1860,4,0,0,36,0.0,0.0,1.0,36,750,600,150,0.8,9,6,3,367.5572273662551,0.3951554232804233,0.13496656378600846,0.22053433641975315,132244.8979591837,2521.5136054421846,134766.4115646259,1836,11,663.4166666666666,34,2,20,33.40567129629629,0.6470588235294117,42.85714285714286,1028.571428571429,30.252100840336144,0
1861,4,0,1,35,0.0,0.027777777777777776,0.9722222222222222,36,1000,700,300,0.7,13,7,6,366.9950335196447,0.39581679894179894,0.12786774628879916,0.22109212994963953,132398.00347222216,2517.97052154194,134915.9739937641,1837,12,664.4166666666666,33,3,20,33.26585695006748,0.6508838383838385,42.70833333333333,1029.166666666666,31.186868686868667,0
1862,4,0,0,35,0.0,0.0,1.0,35,800,500,300,0.625,11,5,6,365.6092318494286,0.39516806722689074,0.12918190011393205,0.220811154332642,132492.61289227704,2688.104485053826,135180.71737733088,1838,13,668.1142857142858,33,2,20,33.20624032853232,0.6518308080808082,42.61642156862745,1029.5343137254904,31.198009506833042,0
1863,4,0,0,35,0.0,0.0,1.0,35,850,600,250,0.7058823529411765,11,6,5,366.8197135071119,0.39464285714285713,0.1321704833307833,0.2219140426638057,132555.70461180795,2724.809117887349,135280.5137296953,1839,14,669.1142857142858,33,2,20,33.11156233884724,0.6524621212121213,42.55514705882353,1029.7794117647059,31.2054367201426,0
1864,4,0,0,35,0.0,0.0,1.0,35,850,700,150,0.8235294117647058,10,7,3,368.0322125364724,0.3929971988795518,0.13778714149789328,0.22358488750048142,132713.49961553264,2768.5685793925622,135482.0681949252,1840,15,670.1142857142858,33,2,20,32.92152315255313,0.654040404040404,42.40196078431374,1030.3921568627463,31.224004753416555,0
1865,4,0,0,35,0.0,0.0,1.0,35,900,700,200,0.7777777777777778,11,7,4,368.6394674184454,0.39215686274509803,0.1399527829203253,0.22452038815760655,132808.22167255398,2791.6704212322365,135599.8920937862,1841,16,671.1142857142858,33,2,20,32.81058039075813,0.6549873737373737,42.31004901960785,1030.7598039215698,31.2351455733809,0
1866,4,0,0,35,0.0,0.0,1.0,35,500,100,400,0.2,9,1,8,368.16842727901104,0.3923669467787115,0.13590109367570125,0.22442266741094521,132839.80320069217,2781.4842848904436,135621.2874855826,1842,17,672.1142857142858,33,2,20,32.7909533999049,0.6553030303030303,42.27941176470589,1030.8823529411775,31.238859180035682,0
1867,4,0,0,35,0.0,0.0,1.0,35,500,100,400,0.2,9,1,8,372.0959481602448,0.3919467787114846,0.14304051071343693,0.22719994976925256,132902.9775206651,2890.531886774318,135793.50940743941,1843,18,673.1142857142858,33,2,20,32.62617859123684,0.6559343434343434,42.21813725490196,1031.127450980392,31.246286393345212,0
1868,4,0,0,35,0.0,0.0,1.0,35,1100,700,400,0.6363636363636364,15,7,8,371.4102867614101,0.39191176470588235,0.13678707224334574,0.2271648963215139,132966.16685890066,2877.000432525979,135843.16729142662,1844,19,674.1142857142858,33,2,20,32.580303390367554,0.6565656565656565,42.15686274509805,1031.3725490196098,31.25371360665484,0
1869,4,0,0,35,0.0,0.0,1.0,35,850,700,150,0.8235294117647058,10,7,3,371.64526156687714,0.3910014005602241,0.12762651195141395,0.22827313987269682,133124.20590938587,2894.996065215309,136019.20197460116,1845,20,675.1142857142858,33,2,21,32.41536535645015,0.6581439393939392,42.00367647058824,1031.9852941176475,31.272281639928714,0
1870,4,0,0,35,0.0,0.0,1.0,35,850,600,250,0.7058823529411765,11,6,5,373.49196299813536,0.3905112044817927,0.12910052910052872,0.2299924193199047,133219.07439446385,2951.2507208766046,136170.32511534047,1846,21,676.1142857142858,33,2,21,32.27237654320987,0.659090909090909,41.91176470588236,1032.352941176472,31.283422459893092,0
1871,4,0,0,35,0.0,0.0,1.0,35,1050,700,350,0.6666666666666666,14,7,7,376.20111453462766,0.38960084033613446,0.13220255249073642,0.23228075933009928,133318.49666950115,3030.9134070294767,136349.41007653062,1847,22,677.1142857142858,34,1,21,32.10254562920267,0.657781862745098,41.81547619047619,1032.7380952380954,30.374649859943982,0
1872,4,0,0,35,0.0,0.0,1.0,35,700,400,300,0.5714285714285714,10,4,6,377.0964460943985,0.3900560224089636,0.12841010107661432,0.23341247925871536,133410.72137188204,3061.7417800453472,136472.4631519274,1848,23,678.1142857142858,34,1,21,31.986776907121456,0.6587009803921569,41.726190476190474,1033.0952380952378,30.385154061624643,0
1873,4,0,0,35,0.0,0.0,1.0,35,800,300,500,0.375,13,3,10,379.43543900626605,0.3897058823529412,0.1322930554869719,0.23505497324306812,133441.47002551032,3126.4845521542047,136567.95457766452,1849,24,679.1142857142858,34,1,21,31.895475669239925,0.6590073529411764,41.69642857142858,1033.2142857142865,30.388655462184897,0
1874,4,0,1,34,0.0,0.02857142857142857,0.9714285714285714,35,850,500,350,0.5882352941176471,12,5,7,380.2470283953303,0.38907563025210085,0.1376356846183382,0.2361686020063865,133537.46588358335,3155.452002502874,136692.91788608622,1850,25,680.1142857142858,32,3,21,31.778086570567627,0.6647135416666666,41.60353535353536,1033.585858585859,32.29955808080809,0
1875,4,0,0,34,0.0,0.0,1.0,34,650,400,250,0.6153846153846154,9,4,5,391.98428712160944,0.3880718954248366,0.15243943110821268,0.24325092157030592,133505.86149427618,3666.4399888780285,137172.3014831542,1851,26,697.9117647058823,31,3,21,31.50657784217379,0.667002688172043,41.63411458333333,1033.463541666666,33.337533602150515,0
1876,4,0,0,34,0.0,0.0,1.0,34,700,300,400,0.42857142857142855,11,3,8,391.98428712160944,0.3880718954248366,0.15243943110821268,0.24325092157030592,133505.86149427618,3666.4399888780285,137172.3014831542,1852,27,698.9117647058823,31,3,21,31.50657784217379,0.667002688172043,41.63411458333333,1033.463541666666,33.337533602150515,0
1877,4,0,0,34,0.0,0.0,1.0,34,1050,800,250,0.7619047619047619,13,8,5,393.6399571090483,0.38775623885918004,0.1531634316194994,0.24494523976848312,133606.80474175353,3718.5953776041715,137325.40011935768,1853,28,699.9117647058823,31,3,21,31.362300587741395,0.668010752688172,41.536458333333336,1033.854166666667,33.35013440860216,0
1878,4,1,1,34,0.02857142857142857,0.02857142857142857,0.9714285714285714,35,600,400,200,0.6666666666666666,8,4,4,385.4695364659176,0.39089635854341737,0.1428954844106729,0.24175162895264934,133896.5909888022,3322.6113725640316,137219.20236136625,1854,0,680.8857142857142,32,3,18,31.282532227237617,0.6682942708333333,41.256313131313135,1034.9747474747478,32.34296085858587,0
1879,4,0,0,34,0.0,0.0,1.0,34,750,200,550,0.26666666666666666,13,2,11,392.1518414032251,0.38751485442661915,0.14867426282120277,0.24507246656114604,133765.94424357222,3691.312270431604,137457.25651400382,1855,30,701.9117647058823,32,2,18,31.240845844013187,0.6669921875,41.382575757575765,1034.469696969698,32.32717803030306,0
1880,4,0,0,34,0.0,0.0,1.0,34,850,500,350,0.5882352941176471,12,5,7,394.7323636015777,0.38771910279263216,0.15059687147414036,0.24769015921091572,133915.8091238947,3772.18077181854,137687.98989571322,1856,31,702.9117647058823,33,1,18,31.02356144920674,0.6660353535353535,41.23774509803922,1035.0490196078435,31.36512180629829,0
1881,4,0,0,34,0.0,0.0,1.0,34,850,600,250,0.7058823529411765,11,6,5,395.73238649817284,0.3872549019607843,0.14840916842420304,0.24939108115556013,134074.41135921294,3811.517355103824,137885.92871431677,1857,32,703.9117647058823,33,1,18,30.838436279730214,0.6676136363636362,41.08455882352942,1035.6617647058833,31.383689839572224,0
1882,4,0,0,34,0.0,0.0,1.0,34,1000,900,100,0.9,11,9,2,397.22792576047914,0.3867349970291147,0.14715624804281124,0.25076681526910616,134137.878535299,3856.662251297593,137994.5407865966,1858,33,704.9117647058823,33,1,19,30.736005954493486,0.6682449494949494,41.0232843137255,1035.9068627450988,31.391117052881782,0
1883,4,0,0,34,0.0,0.0,1.0,34,1100,900,200,0.8181818181818182,13,9,4,400.1785711266042,0.3855837789661319,0.14411034540308565,0.2539467766811665,134328.37017313074,3951.067047529819,138279.43722066056,1859,34,705.9117647058823,33,1,19,30.468411356740347,0.6701388888888888,40.83946078431374,1036.6421568627468,31.41339869281051,0
1884,4,0,0,34,0.0,0.0,1.0,34,1000,700,300,0.7,13,7,6,401.1787050503678,0.38419117647058826,0.14736461692427438,0.2556910059899333,134487.21645520956,3990.681468665901,138477.89792387545,1860,35,706.9117647058823,33,1,19,30.283160050409574,0.6717171717171717,40.68627450980392,1037.2549019607845,31.43196672608438,0
1885,4,0,0,34,0.0,0.0,1.0,34,1150,900,250,0.782608695652174,14,9,5,402.09028886630864,0.3838755199049317,0.15178360500826837,0.25671918443002784,134550.78125,4020.3425365244143,138571.1237865244,1861,36,707.9117647058823,31,3,19,30.195783132530128,0.6774193548387096,40.625,1037.5,33.46774193548387,0
1886,4,0,0,34,0.0,0.0,1.0,34,550,300,250,0.5454545454545454,8,3,5,404.91050976922554,0.38339275103980985,0.15777548158535692,0.25899974019749017,134618.33530002175,4101.675754123269,138720.01105414503,1862,37,708.9117647058823,31,3,19,30.054893350062724,0.6780913978494623,40.559895833333336,1037.760416666667,33.47614247311829,0
1887,4,0,0,34,0.0,0.0,1.0,34,1100,700,400,0.6363636363636364,15,7,8,401.40243490049687,0.3829842543077837,0.15221715054301943,0.2574361013847024,134714.57791296806,4014.951918171614,138729.52983113966,1863,38,709.9117647058823,32,2,19,30.049460796237742,0.6764322916666667,40.467171717171716,1038.1313131313132,32.441603535353536,0
1888,4,0,0,34,0.0,0.0,1.0,34,600,300,300,0.5,9,3,6,397.32833214770733,0.38259432560903145,0.15502592526372228,0.25551411508325983,134812.90373750127,3912.9972388021633,138725.90097630344,1864,39,710.9117647058823,32,2,17,30.056737588652474,0.6774088541666667,40.37247474747475,1038.5101010101012,32.45344065656566,0
1889,4,0,0,34,0.0,0.0,1.0,34,950,600,350,0.631578947368421,13,6,7,398.1869961880771,0.3822786690433749,0.15316531236772213,0.25668678073660267,134900.6560727843,3943.137405084556,138843.79347786887,1865,40,711.9117647058823,33,1,17,29.94659569029924,0.6758207070707072,40.28799019607842,1038.8480392156846,31.480243612596503,0
1890,4,0,0,34,0.0,0.0,1.0,34,950,500,450,0.5263157894736842,14,5,9,394.77360298777717,0.38177733214497916,0.14839036298320352,0.2556083740872003,135059.84026576302,3863.6119521337773,138923.4522178968,1866,41,712.9117647058823,33,1,18,29.876011946867866,0.67739898989899,40.13480392156862,1039.4607843137244,31.498811645870436,0
1891,4,0,0,34,0.0,0.0,1.0,34,700,600,100,0.8571428571428571,8,6,2,394.47518915316977,0.3814616755793226,0.14981801795556193,0.25609196480219143,135155.39583633683,3863.0900675220855,139018.4859038589,1867,42,713.9117647058823,33,1,18,29.78822922804949,0.6783459595959597,40.042892156862735,1039.8284313725478,31.509952465834782,0
1892,4,0,0,34,0.0,0.0,1.0,34,700,600,100,0.8571428571428571,8,6,2,393.0509041413486,0.38116458704694,0.1530472210092948,0.2556186224864081,135219.11832288056,3829.599342800837,139048.71766568138,1868,43,714.9117647058823,33,1,18,29.761571619339378,0.6789772727272728,39.98161764705882,1040.0735294117642,31.51737967914437,0
1893,4,0,0,34,0.0,0.0,1.0,34,1000,800,200,0.8,12,8,4,389.7214349036699,0.38088606654783125,0.1565925310053351,0.25412711077819927,135314.73021193763,3747.010164359849,139061.74037629747,1869,44,715.9117647058823,33,1,18,29.752650176678447,0.6799242424242424,39.889705882352935,1040.4411764705874,31.52852049910871,0
1894,4,0,0,34,0.0,0.0,1.0,34,550,400,150,0.7272727272727273,7,4,3,387.27081315564953,0.3805704099821747,0.15095130245669441,0.25320177183455966,135410.37589208464,3688.09727628795,139098.47316837258,1870,45,716.9117647058823,33,1,19,29.720922131951802,0.6808712121212122,39.79779411764705,1040.8088235294108,31.539661319073055,0
1895,4,0,0,34,0.0,0.0,1.0,34,650,400,250,0.6153846153846154,9,4,5,387.28855682769847,0.380718954248366,0.14939874973173972,0.2541151248930465,135537.95602953184,3698.4598772106824,139236.4159067425,1871,46,717.9117647058823,33,1,20,29.59316523478875,0.6821338383838385,39.67524509803921,1041.2990196078426,31.5545157456922,0
1896,4,0,0,34,0.0,0.0,1.0,34,400,200,200,0.5,6,2,4,389.1596584779856,0.38053327391562686,0.1500349522089106,0.25579798433135353,135601.76862564884,3754.147593473671,139355.9162191225,1872,47,718.9117647058823,33,1,20,29.480796760403184,0.6827651515151516,39.6139705882353,1041.5441176470592,31.561942959001794,0
1897,4,0,0,34,0.0,0.0,1.0,34,700,400,300,0.5714285714285714,10,4,6,389.1596584779856,0.38053327391562686,0.1500349522089106,0.25579798433135353,135601.76862564884,3754.147593473671,139355.9162191225,1873,48,719.9117647058823,33,1,20,29.480796760403184,0.6827651515151516,39.6139705882353,1041.5441176470592,31.561942959001794,0
1898,4,0,0,34,0.0,0.0,1.0,34,850,700,150,0.8235294117647058,10,7,3,393.3407997097725,0.3804775698158051,0.15321775826181216,0.25925305744449206,135699.4503111926,3875.229815681751,139574.68012687436,1874,49,720.9117647058823,32,2,20,29.274468815640653,0.6861979166666667,39.520202020202014,1041.919191919191,32.55997474747472,0
1899,4,0,0,34,0.0,0.0,1.0,34,700,400,300,0.5714285714285714,10,4,6,393.3407997097725,0.3804775698158051,0.15321775826181216,0.25925305744449206,135699.4503111926,3875.226061116199,139574.6763723088,1875,50,721.9117647058823,32,2,20,29.274468815640653,0.6861979166666667,39.520202020202014,1041.919191919191,32.55997474747472,0
1900,4,0,0,34,0.0,0.0,1.0,34,1000,800,200,0.8,12,8,4,395.43444293989177,0.38038472964943554,0.1532796522606621,0.26135398930895176,135798.13483636873,3939.851960259161,139737.9867966279,1876,51,722.9117647058823,32,2,20,29.121492025035337,0.6871744791666666,39.42550505050505,1042.29797979798,32.57181186868687,0
1901,4,0,0,34,0.0,0.0,1.0,34,1150,1000,150,0.8695652173913043,13,10,3,378.45966788122985,0.3804775698158051,0.12015141348623803,0.2344504966125047,133441.47002551003,3300.4428854875105,136741.91291099755,1877,52,723.9117647058823,34,0,18,31.920680185889307,0.6590073529411765,41.69642857142856,1033.2142857142844,30.388655462184836,5
1902,4,0,0,34,0.0,0.0,1.0,34,750,700,50,0.9333333333333333,8,7,1,379.16233090530716,0.38023618538324416,0.11883301707779914,0.23508064516129037,133472.22222222213,3321.527777777774,136793.7499999999,1878,53,724.9117647058823,34,0,18,31.871639784946254,0.6593137254901962,41.666666666666664,1033.3333333333328,30.392156862745082,0
1903,4,0,0,34,0.0,0.0,1.0,34,800,500,300,0.625,11,5,6,379.88793523085366,0.3794191919191919,0.12497120479152302,0.23592182072062,133533.73724489778,3345.5711451246957,136879.3083900225,1879,54,725.9117647058823,34,0,18,31.791109959302776,0.6599264705882353,41.60714285714285,1033.571428571427,30.399159663865504,0
1904,4,0,0,34,0.0,0.0,1.0,34,750,700,50,0.9333333333333333,8,7,1,381.5492884832329,0.3790849673202614,0.12873574118730913,0.2373477092541828,133595.26643990923,3394.63577097505,136989.9022108843,1880,55,726.9117647058823,34,0,19,31.68638684170122,0.6605392156862746,41.547619047619044,1033.8095238095232,30.406162464985975,0
1905,4,0,0,34,0.0,0.0,1.0,34,900,700,200,0.7777777777777778,11,7,4,381.2225007474161,0.3791221033868093,0.12586176538310445,0.23753935735237128,133656.80980725618,3390.5966553287894,137047.40646258497,1881,56,727.9117647058823,34,0,20,31.633039757464125,0.6611519607843137,41.488095238095234,1034.0476190476186,30.41316526610643,0
1906,4,0,0,34,0.0,0.0,1.0,34,900,500,400,0.5555555555555556,13,5,8,377.8071607741737,0.37824940582293526,0.12306510453680963,0.23639467489476917,133810.73022959186,3310.9304138322027,137121.66064342405,1882,57,728.9117647058823,34,0,15,31.56689870747516,0.6626838235294117,41.339285714285715,1034.6428571428573,30.430672268907568,0
1907,4,0,0,34,0.0,0.0,1.0,34,800,600,200,0.75,10,6,4,375.64729891271935,0.37730243612596553,0.12266742445770595,0.23563330568161492,133903.125,3260.0694444444457,137163.19444444444,1883,58,729.9117647058823,34,0,15,31.530126140633396,0.6636029411764706,41.25,1035.0,30.441176470588236,0
1908,4,0,0,34,0.0,0.0,1.0,34,900,600,300,0.6666666666666666,12,6,6,377.7252428762096,0.37752525252525254,0.12950511391309094,0.2373337219690403,133964.73922902482,3320.372732426289,137285.11196145113,1884,59,730.9117647058823,34,0,15,31.414587166513343,0.6642156862745099,41.19047619047618,1035.2380952380943,30.448179271708653,0
1909,4,0,0,34,0.0,0.0,1.0,34,800,500,300,0.625,11,5,6,377.6155123689532,0.37724673202614384,0.1293718591265418,0.23746363782160396,133995.55165816314,3319.759778911549,137315.31143707468,1885,60,731.9117647058823,34,0,16,31.386541336092897,0.6645220588235294,41.16071428571428,1035.3571428571418,30.451680672268875,0
1910,4,0,0,34,0.0,0.0,1.0,34,800,400,400,0.5,12,4,8,376.9057999735766,0.3771167557932264,0.12613252197430724,0.23761452607029815,134088.0102040816,3307.7097505668908,137395.7199546485,1886,61,732.9117647058823,34,0,17,31.312260536398465,0.6654411764705883,41.07142857142857,1035.7142857142853,30.462184873949568,0
1911,4,0,0,34,0.0,0.0,1.0,34,850,600,250,0.7058823529411765,11,6,5,374.2628284746391,0.3760026737967914,0.12722801043229182,0.23714208040030615,134273.0229591836,3250.6802721088357,137523.70323129246,1887,62,733.9117647058823,34,0,17,31.19543992648748,0.6672794117647058,40.89285714285714,1036.4285714285709,30.483193277310907,0
1912,4,0,0,34,0.0,0.0,1.0,34,1200,900,300,0.75,15,9,6,372.181390512718,0.37605837789661317,0.12467333391857505,0.23682045966079524,134427.29768990932,3206.267715419505,137633.56540532882,1888,63,734.9117647058823,34,0,17,31.095023533463436,0.6688112745098038,40.74404761904762,1037.0238095238096,30.50070028011205,0
1913,4,0,0,34,0.0,0.0,1.0,34,1150,1000,150,0.8695652173913043,13,10,3,371.99368689511493,0.37538992869875226,0.11991885012928649,0.23710175522436983,134489.03238378675,3205.8142006802595,137694.846584467,1889,64,735.9117647058823,34,0,17,31.038151803818057,0.6694240196078431,40.6845238095238,1037.261904761904,30.507703081232467,0
1914,4,0,0,34,0.0,0.0,1.0,34,850,600,250,0.7058823529411765,11,6,5,372.69991393091993,0.375,0.11639305539152,0.2381622770757057,134582.56927924367,3231.7965697308473,137814.36584897453,1890,65,736.9117647058823,33,1,18,30.926316877288293,0.6726641414141414,40.594362745098046,1037.6225490196089,31.443107546048754,0
1915,4,0,0,34,0.0,0.0,1.0,34,950,600,350,0.631578947368421,13,6,7,373.70925963923906,0.3747957516339869,0.11624103957758725,0.24022593012771443,134797.91843820873,3275.046060090712,138072.96449829944,1891,66,737.9117647058823,34,0,15,30.684923000496756,0.6724877450980392,40.386904761904766,1038.4523809523819,30.54271708683476,0
1916,4,0,0,34,0.0,0.0,1.0,34,800,500,300,0.625,11,5,6,374.82499681812396,0.3741458704693999,0.11319991914291494,0.24238683127572005,135014.34948979583,3321.3506235827563,138335.70011337858,1892,67,738.9117647058823,34,0,16,30.439814814814817,0.6746323529411765,40.17857142857142,1039.2857142857138,30.567226890756288,0
1917,4,0,0,34,0.0,0.0,1.0,34,600,400,200,0.6666666666666666,8,4,4,372.9924148392748,0.3734402852049911,0.11623912047640883,0.24161496783208794,135076.2188208616,3276.4810090702845,138352.6998299319,1893,68,739.9117647058823,34,0,16,30.42568521911743,0.6752450980392157,40.11904761904761,1039.5238095238087,30.574229691876727,0
1918,4,0,0,34,0.0,0.0,1.0,34,800,600,200,0.75,10,6,4,373.8684912134924,0.3737188057040998,0.11183878245058732,0.24280604243493362,135169.0493905896,3307.0897108843546,138476.13910147393,1894,69,740.9117647058823,34,0,16,30.310293837053997,0.6761642156862745,40.029761904761905,1039.8809523809525,30.584733893557427,0
1919,4,0,0,34,0.0,0.0,1.0,34,200,0,200,0.0,4,0,4,369.376401066198,0.3737188057040998,0.09390422072457238,0.24030093939801725,135230.95415249432,3190.2246315192733,138421.17878401358,1895,70,741.9117647058823,34,0,18,30.365352332989975,0.6767769607843137,39.970238095238095,1040.1190476190475,30.591736694677866,1
1920,4,0,0,34,0.0,0.0,1.0,34,1250,900,350,0.72,16,9,7,369.4709612554919,0.3729203802733214,0.09281195315654855,0.2409832986099251,135323.83786848062,3199.645691609959,138523.4835600906,1896,71,742.9117647058823,34,0,18,30.270308924485125,0.6776960784313726,39.88095238095237,1040.4761904761895,30.602240896358513,0
1921,4,0,0,34,0.0,0.0,1.0,34,750,500,250,0.6666666666666666,10,5,5,367.9871761408121,0.37297608437314317,0.09079927589386072,0.24022224844263146,135354.8061933105,3161.766581632634,138516.57277494314,1897,72,743.9117647058823,34,0,18,30.278047896884416,0.6780024509803921,39.85119047619047,1040.595238095237,30.605742296918734,0
1922,4,0,0,34,0.0,0.0,1.0,34,900,400,500,0.4444444444444444,14,4,10,366.1740529930404,0.3728832442067736,0.09184868182001726,0.2392446615295333,135385.77806122432,3114.9518140589375,138500.72987528326,1898,73,744.9117647058823,34,0,18,30.294364371234646,0.6783088235294118,39.82142857142856,1040.7142857142844,30.609243697478952,0
1923,4,0,0,34,0.0,0.0,1.0,34,1050,700,350,0.6666666666666666,14,7,7,367.0904324647165,0.3719362745098039,0.09664346012847691,0.2404648563223928,135478.71492346935,3146.5880102040746,138625.30293367343,1899,74,745.9117647058823,34,0,18,30.177958833619208,0.6792279411764706,39.732142857142854,1041.0714285714282,30.619747899159652,0
1924,4,0,0,34,0.0,0.0,1.0,34,950,600,350,0.631578947368421,13,6,7,365.7859706739882,0.3713420974450386,0.08951918100116263,0.24085726330835755,135664.68431122453,3124.8476473922938,138789.53195861683,1900,75,746.9117647058823,34,0,18,30.026806460214065,0.6810661764705882,39.55357142857143,1041.7857142857147,30.64075630252102,0
1925,4,0,0,34,0.0,0.0,1.0,34,950,700,250,0.7368421052631579,12,7,5,364.2032513226541,0.3709521687462864,0.09056753414345664,0.2400231065945684,135695.69160997734,3084.162414965989,138779.8540249433,1901,76,747.9117647058823,34,0,18,30.03718197745279,0.6813725490196079,39.523809523809526,1041.904761904762,30.644257703081234,0
1926,4,0,0,34,0.0,0.0,1.0,34,850,700,150,0.8235294117647058,10,7,3,365.16796603676704,0.3708778966131907,0.08819497641414364,0.24107695133377519,135757.71683673467,3114.873866213153,138872.59070294784,1902,77,748.9117647058823,34,0,18,29.95035602772067,0.6819852941176471,39.464285714285715,1042.142857142857,30.65126050420168,0
1927,4,0,0,34,0.0,0.0,1.0,34,1150,800,350,0.6956521739130435,15,8,7,366.41375823008053,0.3701351752822341,0.08817483137613191,0.24232015612255167,135819.75623582755,3153.245464852593,138973.00170068015,1903,78,749.9117647058823,34,0,19,29.856193848028017,0.6825980392156863,39.4047619047619,1042.3809523809516,30.658263305322105,0
1928,4,0,0,34,0.0,0.0,1.0,34,550,400,150,0.7272727272727273,7,4,3,367.6611069258102,0.3700794711824124,0.09086848168524009,0.24335663744136957,135850.78125,3189.4097222222217,139040.19097222222,1904,79,750.9117647058823,34,0,19,29.792832400746075,0.6829044117647058,39.375,1042.5,30.66176470588235,0
1929,4,0,0,34,0.0,0.0,1.0,34,750,400,350,0.5333333333333333,11,4,7,369.1084944017016,0.36983808674985147,0.09330513027128662,0.24495381901203803,135943.87755102027,3235.6079931972613,139179.48554421752,1905,80,751.9117647058823,34,0,17,29.66252853881278,0.6838235294117647,39.28571428571428,1042.8571428571418,30.672268907562994,0
1930,4,0,0,34,0.0,0.0,1.0,34,800,500,300,0.625,11,5,6,370.15037693171405,0.36981951871657753,0.09667989071698546,0.2462891232386186,136037.0057397957,3270.8297902494132,139307.83553004512,1906,81,752.9117647058823,34,0,17,29.542774544486285,0.6847426470588236,39.19642857142856,1043.2142857142842,30.68277310924365,0
1931,4,0,0,34,0.0,0.0,1.0,34,900,400,500,0.4444444444444444,14,4,10,370.02476012027535,0.369485294117647,0.09874932064761621,0.2470683223133624,136161.22626133764,3276.605017006781,139437.8312783444,1907,82,753.9117647058823,34,0,17,29.422598000076054,0.685968137254902,39.07738095238094,1043.6904761904746,30.696778711484544,0
1932,4,0,0,34,0.0,0.0,1.0,34,550,400,150,0.7272727272727273,7,4,3,369.2593167872985,0.36939245395127746,0.09482041790724471,0.24764088125827094,136316.58163265313,3267.2335600907063,139583.81519274384,1908,83,754.9117647058823,34,0,18,29.28826569387444,0.6875,38.92857142857143,1044.285714285715,30.714285714285733,0
1933,4,0,0,34,0.0,0.0,1.0,34,600,200,400,0.3333333333333333,10,2,8,370.2794620173536,0.36896538918597743,0.08716272833919891,0.24898101756339305,136409.837372449,3301.9522392290264,139711.78961167802,1909,84,755.9117647058823,34,0,18,29.169040835707495,0.6884191176470589,38.839285714285715,1044.6428571428573,30.724789915966394,0
1934,4,0,0,34,0.0,0.0,1.0,34,1000,800,200,0.8,12,8,4,370.8960671942288,0.36872400475341655,0.08678112393282666,0.2500557356244963,136503.125,3325.6944444444443,139828.81944444444,1910,85,756.9117647058823,34,0,18,29.060340244550773,0.6893382352941176,38.75,1045.0,30.735294117647058,0
1935,4,0,0,34,0.0,0.0,1.0,34,750,600,150,0.8,9,6,3,370.8960671942288,0.36872400475341655,0.08678112393282666,0.2500557356244963,136503.125,3325.6944444444443,139828.81944444444,1911,86,757.9117647058823,34,0,18,29.060340244550773,0.6893382352941176,38.75,1045.0,30.735294117647058,0
1936,4,0,0,34,0.0,0.0,1.0,34,600,500,100,0.8333333333333334,7,5,2,370.7922141065074,0.36829693998811647,0.08710317061570128,0.2506486860715349,136596.44451530598,3329.7796201813894,139926.22413548737,1912,87,758.9117647058823,34,0,18,28.970457047412978,0.6902573529411765,38.66071428571428,1045.3571428571418,30.745798319327697,0
1937,4,0,0,34,0.0,0.0,1.0,34,900,700,200,0.7777777777777778,11,7,4,371.2394886712391,0.36760992275698157,0.08320609664630929,0.25161787565495064,136689.79591836716,3348.929988662112,140038.72590702926,1913,88,759.9117647058823,34,0,19,28.866167653309045,0.6911764705882353,38.57142857142856,1045.7142857142842,30.756302521008358,0
1938,4,0,0,34,0.0,0.0,1.0,34,1000,600,400,0.6,14,6,8,371.4627457972803,0.36703431372549017,0.07796736314019515,0.2524527068571327,136785.01057285667,3362.1106653445763,140147.12123820125,1914,89,760.9117647058823,33,1,19,28.765912995938773,0.6944444444444444,38.48039215686275,1046.0784313725496,31.699346405228777,0
1939,4,0,0,34,0.0,0.0,1.0,34,950,700,250,0.7368421052631579,12,7,5,369.71995890555473,0.36718285799168154,0.07965083433232678,0.2517279911591411,136849.11602508658,3319.1699106113083,140168.2859356979,1915,90,761.9117647058823,33,1,20,28.74795033965799,0.6950757575757576,38.419117647058826,1046.3235294117653,31.706773618538342,0
1940,4,0,0,34,0.0,0.0,1.0,34,750,400,350,0.5333333333333333,11,4,7,371.5299727471296,0.3670528817587641,0.08295157857029745,0.2531918944363719,136881.1743830498,3371.091797625917,140252.2661806757,1916,91,762.9117647058823,33,1,20,28.668828317133165,0.6953914141414141,38.388480392156865,1046.4460784313726,31.71048722519311,0
1941,4,0,0,34,0.0,0.0,1.0,34,750,700,50,0.9333333333333333,8,7,1,370.47644642377236,0.3669971776589424,0.0829728612756575,0.25270517990886715,136913.23649557866,3344.6258650519067,140257.86236063056,1917,92,763.9117647058823,33,1,20,28.66461748633879,0.6957070707070707,38.3578431372549,1046.5686274509808,31.714200831847904,0
1942,4,0,0,34,0.0,0.0,1.0,34,650,300,350,0.46153846153846156,10,3,7,370.47644642377236,0.3669971776589424,0.0829728612756575,0.25270517990886715,136913.23649557866,3344.6258650519067,140257.86236063056,1918,93,764.9117647058823,33,1,20,28.66461748633879,0.6957070707070707,38.3578431372549,1046.5686274509808,31.714200831847904,0
1943,4,0,0,34,0.0,0.0,1.0,34,600,500,100,0.8333333333333334,7,5,2,371.8275327042417,0.3671457219251337,0.08605919539438345,0.2540920627487709,136977.3719843331,3386.3916522491504,140363.76363658224,1919,94,765.9117647058823,33,1,17,28.5657145087021,0.6963383838383839,38.29656862745099,1046.8137254901972,31.72162804515749,0
1944,4,0,0,34,0.0,0.0,1.0,34,650,500,150,0.7692307692307693,8,5,3,370.2885438146135,0.3665144087938206,0.08469651905706077,0.25350523384231244,137041.5224913495,3348.981161091886,140390.50365244137,1920,95,766.9117647058823,33,1,17,28.54244694132333,0.6969696969696969,38.23529411764706,1047.058823529412,31.729055258467028,0
1945,4,0,0,34,0.0,0.0,1.0,34,600,300,300,0.5,9,3,6,371.08838657833553,0.36608734402852044,0.08331325508553333,0.2542863082046415,137073.6033767062,3373.284463908124,140446.8878406143,1921,96,767.9117647058823,33,1,17,28.489735712892525,0.6972853535353535,38.204656862745104,1047.1813725490204,31.73276886512183,0
1946,4,0,0,34,0.0,0.0,1.0,34,700,400,300,0.5714285714285714,10,4,6,374.37737709089294,0.365548871063577,0.08407883509042358,0.2572490208499159,137169.8685601692,3470.6591214917426,140640.52768166095,1922,97,768.9117647058823,33,1,17,28.308278739666196,0.6982323232323231,38.11274509803922,1047.5490196078435,31.74390968508617,0
1947,4,0,0,34,0.0,0.0,1.0,34,650,400,250,0.6153846153846154,9,4,5,371.88400412633547,0.3649361259655377,0.08297275172494434,0.2562433617473243,137266.16753472228,3409.4184027777833,140675.58593750006,1923,98,769.9117647058823,33,1,18,28.278247183565277,0.6991792929292928,38.020833333333336,1047.916666666667,31.755050505050516,0
1948,4,0,0,34,0.0,0.0,1.0,34,600,300,300,0.5,9,3,6,370.1758031492247,0.3641934046345811,0.08137839492163046,0.2555378244015596,137330.38562391893,3367.277159025408,140697.66278294433,1924,99,770.9117647058823,33,1,18,28.25945574652169,0.699810606060606,37.95955882352943,1048.1617647058845,31.762477718360135,0
1949,4,0,0,34,0.0,0.0,1.0,34,1000,800,200,0.8,12,8,4,369.9398815780851,0.3640634284016637,0.08186744419535441,0.25561112657665097,137362.50030036524,3363.1734188773567,140725.6737192426,1925,100,771.9117647058823,33,1,19,28.233867196633163,0.7001262626262625,37.92892156862745,1048.2843137254902,31.766191325014855,0
1950,4,0,0,34,0.0,0.0,1.0,34,650,500,150,0.7692307692307693,8,5,3,365.58821299607644,0.36350638740344626,0.08285309810154073,0.2533805325163211,137468.96435657612,3251.4066043084135,140720.37096088452,1926,101,772.9117647058823,34,0,19,28.24265902296894,0.6988357843137254,37.82738095238096,1048.6904761904775,30.843837535014046,0
1951,4,0,0,34,0.0,0.0,1.0,34,800,600,200,0.75,10,6,4,364.6254983043179,0.3628565062388592,0.08107260153266949,0.253397467749026,137562.61337868482,3231.76729024944,140794.38066893426,1927,102,773.9117647058823,34,0,19,28.175357467090326,0.6997549019607843,37.73809523809524,1049.0476190476193,30.854341736694685,0
1952,4,0,0,34,0.0,0.0,1.0,34,1300,900,400,0.6923076923076923,17,9,8,364.8418087948241,0.3623923054070113,0.081395348837209,0.25423561616809287,137656.29428854882,3244.554280045355,140900.84856859417,1928,103,774.9117647058823,34,0,19,28.077141236528643,0.700674019607843,37.648809523809526,1049.4047619047624,30.864845938375364,0
1953,4,0,0,34,0.0,0.0,1.0,34,1300,900,400,0.6923076923076923,17,9,8,365.1973111815798,0.36088829471182415,0.08920996636694367,0.2561162812460014,137876.8457444252,3270.539245109807,141147.384989535,1929,104,775.9117647058823,33,1,20,27.85005834305719,0.7051767676767676,37.43872549019608,1050.2450980392155,31.82560903149138,0
1954,4,0,0,34,0.0,0.0,1.0,34,700,500,200,0.7142857142857143,9,5,4,364.50078894378515,0.35984848484848486,0.08066109578891067,0.25658700857175804,138005.5822880622,3260.62872452902,141266.21101259123,1930,105,776.9117647058823,33,1,20,27.74133037866418,0.7064393939393939,37.31617647058823,1050.7352941176464,31.840463458110495,0
1955,4,0,0,34,0.0,0.0,1.0,34,850,500,350,0.5882352941176471,12,5,7,364.91002347799747,0.35958853238265004,0.07818221716291984,0.257841695337254,138134.37890474824,3281.3238898500613,141415.7027945983,1931,106,777.9117647058823,33,1,16,27.60355949327737,0.7077020202020202,37.193627450980394,1051.225490196079,31.855317884729665,0
1956,4,0,0,34,0.0,0.0,1.0,34,800,600,200,0.75,10,6,4,365.35201658928304,0.35905005941770646,0.07871357376419841,0.25888403421574224,138231.0157902009,3300.59607482699,141531.6118650279,1932,107,778.9117647058823,33,1,17,27.49667385308627,0.70864898989899,37.10171568627451,1051.5931372549023,31.86645870469401,0
1957,4,0,0,34,0.0,0.0,1.0,34,900,800,100,0.8888888888888888,10,8,2,365.2849343897989,0.35867869875222813,0.079688988492985,0.25932511098987954,138295.45915333045,3303.4495446462874,141598.90869797673,1933,108,779.9117647058823,33,1,17,27.434924657268237,0.7092803030303031,37.04044117647059,1051.8382352941178,31.87388591800357,0
1958,4,0,0,34,0.0,0.0,1.0,34,900,700,200,0.7777777777777778,11,7,4,365.89719210396134,0.35810308972073673,0.079520697167756,0.26049695616953644,138392.15235726628,3327.45999134946,141719.61234861574,1934,109,780.9117647058823,33,1,17,27.323549965059385,0.7102272727272728,36.948529411764696,1052.20588235294,31.88502673796788,0
1959,4,0,0,34,0.0,0.0,1.0,34,700,200,500,0.2857142857142857,12,2,10,365.534822010595,0.356951871657754,0.0784427857289598,0.2612266323686365,138521.12919309875,3326.8592608611966,141847.98845395996,1935,110,781.9117647058823,33,1,19,27.206053550640277,0.711489898989899,36.82598039215686,1052.6960784313721,31.899881164587036,0
1960,4,0,0,34,0.0,0.0,1.0,34,900,600,300,0.6666666666666666,12,6,6,364.69417670173374,0.3571561200237671,0.07105989143009706,0.26136922939099244,138617.9012429115,3310.6282739811763,141928.52951689268,1936,111,782.9117647058823,33,1,19,27.13291341789829,0.7124368686868687,36.73406862745099,1053.063725490197,31.91102198455142,0
1961,4,0,0,34,0.0,0.0,1.0,34,700,400,300,0.5714285714285714,10,4,6,364.3999362428133,0.3576388888888889,0.07762036751873524,0.2616555933172081,138682.43471561416,3307.1740736735846,141989.60878928774,1937,112,783.9117647058823,33,1,19,27.07715241419429,0.7130681818181819,36.67279411764706,1053.3088235294117,31.918449197860962,0
1962,4,0,0,34,0.0,0.0,1.0,34,1100,900,200,0.8181818181818182,13,9,4,364.9492531395993,0.35630199049316696,0.0804984163685245,0.2630510165756421,138811.54671580624,3331.834060217203,142143.38077602343,1938,113,784.9117647058823,33,1,20,26.93566596891112,0.7143308080808082,36.550245098039206,1053.7990196078417,31.933303624480054,0
1963,4,0,1,33,0.0,0.029411764705882353,0.9705882352941176,34,650,500,150,0.7692307692307693,8,5,3,366.72933867827754,0.3560049019607843,0.08007618813133921,0.2648395501235822,138876.12524329574,3385.989913735092,142262.11515703084,1939,114,785.9117647058823,33,1,20,26.82524803317444,0.7149621212121213,36.48897058823529,1054.044117647058,31.94073083778964,0
1964,4,0,0,33,0.0,0.0,1.0,33,800,500,300,0.625,11,5,6,372.9841783551549,0.354324494949495,0.07742413349889987,0.2688191668870569,138808.61168503205,3754.683195592275,142563.29488062434,1940,115,798.5757575757576,32,1,21,26.726875149772344,0.716796875,36.5530303030303,1053.787878787878,32.93087121212119,0
1965,4,0,0,33,0.0,0.0,1.0,33,1050,800,250,0.7619047619047619,13,8,5,374.64434006239014,0.35392992424242425,0.07344583560152373,0.2710814765616079,138941.6975946331,3810.744120497889,142752.441715131,1941,116,799.5757575757576,32,1,21,26.552145708582817,0.7180989583333334,36.42676767676767,1054.2929292929284,32.94665404040401,0
1966,4,0,0,33,0.0,0.0,1.0,33,900,700,200,0.7777777777777778,11,7,4,372.0881861057361,0.3538510101010101,0.07593531677802723,0.2702978005849839,139074.8472732373,3749.6215309662152,142824.46880420353,1942,117,800.5757575757576,32,1,22,26.488558375229438,0.7194010416666667,36.300505050505045,1054.7979797979788,32.96243686868684,0
1967,4,0,0,33,0.0,0.0,1.0,33,800,500,300,0.625,11,5,6,372.51755847722336,0.3534564393939394,0.0727272727272732,0.2708776502242993,139108.14465679516,3764.04528236914,142872.1899391643,1943,118,801.5757575757576,32,1,22,26.444494314781565,0.7197265625,36.26893939393939,1054.9242424242418,32.96638257575756,0
1968,4,0,0,33,0.0,0.0,1.0,33,1450,1200,250,0.8275862068965517,17,12,5,369.9495691291699,0.35392992424242425,0.07779783001021912,0.27088601550421354,139341.3379374553,3709.8535863687257,143051.19152382403,1944,119,802.5757575757576,32,1,19,26.283086183528656,0.7220052083333334,36.04797979797979,1055.8080808080804,32.99400252525251,0
1969,4,0,0,33,0.0,0.0,1.0,33,750,600,150,0.8,9,6,3,355.5334707746755,0.354324494949495,0.03773698306982043,0.24961605820185456,137915.05813598633,3263.123411597579,141178.1815475839,1945,120,803.5757575757576,31,2,24,28.06611813561422,0.7106854838709677,37.40234375,1050.390625,33.883568548387096,5
1970,4,0,0,33,0.0,0.0,1.0,33,700,400,300,0.5714285714285714,10,4,6,352.60179296821843,0.3547190656565657,0.03561634855950424,0.24801348430165254,137978.26951650367,3130.2770444342686,141108.54656093795,1946,121,804.5757575757576,32,1,24,28.080809598205338,0.7086588541666666,37.34217171717173,1050.631313131315,32.83222853535359,0
1971,4,0,0,33,0.0,0.0,1.0,33,1400,1100,300,0.7857142857142857,17,11,6,354.2665000124572,0.3531802398989899,0.03137280586848301,0.2508785214373935,138210.5142332417,3192.6710284665055,141403.18526170822,1947,122,805.5757575757576,32,1,22,27.808297310278583,0.7109375,37.12121212121213,1051.515151515153,32.859848484848534,0
1972,4,0,0,33,0.0,0.0,1.0,33,250,100,150,0.4,4,1,3,354.6440138786926,0.3530618686868687,0.030321221580676738,0.2513897865187771,138243.70799216925,3205.460699163363,141449.16869133263,1948,123,806.5757575757576,32,1,22,27.765688157842078,0.7112630208333333,37.08964646464647,1051.6414141414148,32.86379419191921,0
1973,4,0,0,33,0.0,0.0,1.0,33,650,500,150,0.7692307692307693,8,5,3,355.42691358440356,0.3520754419191919,0.028037485135769202,0.2529267695045975,138376.52288350693,3236.5480882053043,141613.07097171224,1949,124,807.5757575757576,32,1,23,27.61435457418297,0.7125651041666666,36.96338383838385,1052.1464646464658,32.879577020202056,0
1974,4,0,0,33,0.0,0.0,1.0,33,900,700,200,0.7777777777777778,11,7,4,356.06827479719567,0.3523121843434343,0.03154656718371651,0.2536301711247716,138409.73657024786,3256.663223140491,141666.39979338835,1950,125,808.5757575757576,32,1,23,27.56479481641469,0.712890625,36.93181818181818,1052.2727272727268,32.88352272727271,0
1975,4,0,0,33,0.0,0.0,1.0,33,1200,900,300,0.75,15,9,6,357.90616885151167,0.35132575757575757,0.02734468697529424,0.25593667546174165,138542.63117283964,3317.0524691358214,141859.68364197545,1951,126,809.5757575757576,32,1,23,27.385664028144237,0.7141927083333333,36.805555555555564,1052.7777777777787,32.899305555555586,0
1976,4,0,0,33,0.0,0.0,1.0,33,750,500,250,0.6666666666666666,10,5,5,358.45194348118645,0.3512073863636364,0.03100065402223695,0.2568289698138398,138609.10238751143,3336.940426997245,141946.0428145087,1952,127,810.5757575757576,32,1,23,27.305905275779374,0.71484375,36.74242424242424,1053.0303030303028,32.90719696969696,0
1977,4,0,0,33,0.0,0.0,1.0,33,700,500,200,0.7142857142857143,9,5,4,356.2962897424184,0.3506155303030303,0.03183561405037927,0.2562876070354086,138742.09264360784,3286.658568003272,142028.75121161112,1953,128,811.5757575757576,32,1,24,27.23189317673379,0.7161458333333333,36.61616161616162,1053.5353535353538,32.92297979797981,0
1978,4,0,0,33,0.0,0.0,1.0,33,900,600,300,0.6666666666666666,12,6,6,356.82822957386315,0.350418244949495,0.03414129309875258,0.2569224828122423,138775.35017153862,3303.7925020406037,142079.14267357922,1954,129,812.5757575757576,32,1,24,27.185190732973826,0.7164713541666667,36.58459595959596,1053.6616161616162,32.926925505050505,0
1979,4,0,0,33,0.0,0.0,1.0,33,800,600,200,0.75,10,6,4,359.11245727128534,0.3499447601010101,0.030604354313471527,0.2590762040486963,138841.87718408828,3371.969537547182,142213.84672163546,1955,130,813.5757575757576,32,1,24,27.05962221955993,0.7171223958333334,36.52146464646464,1053.9141414141409,32.9348169191919,0
1980,4,0,1,32,0.0,0.030303030303030304,0.9696969696969697,33,650,400,250,0.6153846153846154,9,4,5,356.5308668489931,0.3489188762626263,0.02282643675580176,0.25824570301817035,138977.05925835492,3309.9382241518124,142286.99748250673,1956,131,814.5757575757576,31,2,25,26.994834115419437,0.7211021505376345,36.39322916666666,1054.4270833333323,34.013776881720396,0
1981,4,0,0,32,0.0,0.0,1.0,32,1100,900,200,0.8181818181818182,13,9,4,364.3794486489001,0.345724126344086,0.029736720197652833,0.2631268186273724,138874.1069369845,3720.574103461352,142594.68104044584,1957,132,836.0,31,1,25,26.889154828083164,0.7200940860215055,36.49088541666666,1054.0364583333323,34.00117607526879,0
1982,4,0,0,32,0.0,0.0,1.0,32,750,300,450,0.4,12,3,9,365.10952931661535,0.3453671034946237,0.025402326322498503,0.26447684741355915,138979.2737057751,3748.535680048627,142727.80938582373,1958,133,837.0,30,2,26,26.766517951986415,0.7239583333333334,36.39112903225806,1054.4354838709667,35.147849462365556,0
1983,4,0,0,32,0.0,0.0,1.0,32,800,600,200,0.75,10,6,4,362.57542357534317,0.3453461021505377,0.02400200713648548,0.2631942043289286,139050.14533833385,3683.233068851884,142733.37840718572,1959,134,838.0,30,2,26,26.763678263455244,0.7246527777777778,36.32392473118279,1054.7043010752684,35.15681003584228,0
1984,4,0,0,32,0.0,0.0,1.0,32,600,300,300,0.5,9,3,6,362.8540251527233,0.345724126344086,0.025277140672782528,0.263673924944312,139085.58792924028,3693.5530841715627,142779.14101341183,1960,135,839.0,30,2,26,26.72151078831123,0.7250000000000001,36.29032258064515,1054.8387096774186,35.16129032258062,0
1985,4,0,0,32,0.0,0.0,1.0,32,750,600,150,0.8,9,6,3,360.81493907505285,0.3458711357526882,0.02551067637620341,0.2624167537150876,139114.38835991747,3638.909912109365,142753.29827202685,1961,136,840.0,31,1,26,26.746996626347414,0.7224462365591399,36.26302083333333,1054.947916666666,34.03057795698923,0
1986,4,0,0,32,0.0,0.0,1.0,32,850,600,250,0.7058823529411765,11,6,5,357.75952651066103,0.3451780913978495,0.027826187538556812,0.26099378599180073,139217.42969089077,3561.2723456488607,142778.70203653965,1962,137,841.0,31,1,22,26.726429158955376,0.723454301075269,36.16536458333333,1055.338541666666,34.04317876344084,0
1987,4,0,0,32,0.0,0.0,1.0,32,500,100,400,0.2,9,1,8,359.93348431851155,0.34496807795698925,0.026161804613296757,0.2631181927295015,139286.14510430218,3626.749504937045,142912.8946092392,1963,138,842.0,31,1,22,26.601625138768956,0.7241263440860216,36.10026041666666,1055.5989583333323,34.051579301075236,0
1988,4,0,0,32,0.0,0.0,1.0,32,950,700,250,0.7368421052631579,12,7,5,360.19637543902746,0.34484206989247307,0.019072172894314843,0.26385116607362863,139354.8774719236,3639.0243530273133,142993.9018249509,1964,139,843.0,31,1,23,26.52723825379208,0.7247983870967742,36.035156249999986,1055.8593749999982,34.059979838709616,0
1989,4,0,0,32,0.0,0.0,1.0,32,1050,800,250,0.7619047619047619,13,8,5,361.04143773482235,0.34429603494623656,0.013712088521760535,0.2650142173273432,139423.62679375536,3667.5413343641394,143091.1681281195,1965,140,844.0,31,1,23,26.43747688324498,0.725470430107527,35.97005208333333,1056.119791666666,34.06838037634407,0
1990,4,0,0,32,0.0,0.0,1.0,32,1000,500,500,0.5,15,5,10,359.0884369836,0.3419228830645162,0.015601897486446692,0.2649419776871721,139595.57427300332,3625.4313151041465,143221.00558810748,1966,141,845.0,31,1,23,26.320436996878595,0.7271505376344087,35.80729166666666,1056.7708333333321,34.08938172043007,0
1991,4,0,0,32,0.0,0.0,1.0,32,700,600,100,0.8571428571428571,8,6,2,359.2900121299485,0.3414818548387097,0.01637381421707551,0.26536460677514,139629.97648451052,3633.5311889648324,143263.50767347537,1967,142,846.0,31,1,23,26.281389881319047,0.727486559139785,35.77473958333333,1056.9010416666658,34.093581989247284,0
1992,4,0,0,32,0.0,0.0,1.0,32,1000,800,200,0.8,12,8,4,357.0385110048777,0.34024277553763443,0.014993842364532384,0.2645212326058034,139733.20855034713,3578.02734374999,143311.23589409713,1968,143,847.0,31,1,24,26.239737274220047,0.728494623655914,35.67708333333333,1057.2916666666658,34.1061827956989,0
1993,4,0,1,31,0.0,0.03125,0.96875,32,850,600,250,0.7058823529411765,11,6,5,357.51085421595815,0.34055779569892475,0.011332502154906887,0.26514572119523255,139767.62771606445,3593.6887953016485,143361.3165113661,1969,144,848.0,31,1,24,26.193536305052742,0.7288306451612904,35.64453125,1057.421875,34.11038306451613,0
1994,4,0,0,31,0.0,0.0,1.0,31,850,600,250,0.7058823529411765,11,6,5,362.49715372274983,0.33749999999999997,0.018588976171343585,0.26906864202741454,139795.38819516703,3935.0860648629887,143730.47426003002,1970,145,862.516129032258,30,1,25,26.034517454668702,0.7319444444444445,35.61827956989247,1057.5268817204299,35.25089605734766,0
1995,4,0,0,31,0.0,0.0,1.0,31,600,300,300,0.5,9,3,6,361.4046090464489,0.33700716845878137,0.01577042717038024,0.2691216346078143,139902.0140514798,3912.2465386171625,143814.26059009696,1971,146,863.516129032258,30,1,25,25.958952695549055,0.7329861111111111,35.51747311827956,1057.9301075268806,35.26433691756269,0
1996,4,0,0,31,0.0,0.0,1.0,31,900,800,100,0.8888888888888888,10,8,2,361.4046090464489,0.3372311827956989,0.01577042717038024,0.2691216346078143,139902.0140514798,3912.2465386171625,143814.26059009696,1972,147,864.516129032258,30,1,25,25.958952695549055,0.7329861111111111,35.51747311827956,1057.9301075268806,35.26433691756269,0
1997,4,0,0,31,0.0,0.0,1.0,31,950,800,150,0.8421052631578947,11,8,3,363.3182766439909,0.33637992831541214,0.009306707629288535,0.2717123863790531,140044.24508975027,3976.1267559833504,144020.3718457336,1973,148,865.516129032258,30,1,26,25.76904761904762,0.734375,35.38306451612903,1058.467741935484,35.28225806451613,0
1998,4,0,0,31,0.0,0.0,1.0,31,600,400,200,0.6666666666666666,8,4,4,363.61534201659475,0.33593189964157705,0.012262651747243503,0.2722276077683177,140079.81414036307,3987.033905653837,144066.8480460169,1974,149,866.516129032258,30,1,26,25.726362789910265,0.7347222222222222,35.3494623655914,1058.6021505376348,35.28673835125449,0
1999,4,0,0,31,0.0,0.0,1.0,31,1200,1000,200,0.8333333333333334,14,10,4,363.9019300957502,0.33584229390681003,0.011663192553247992,0.27273601364074473,140115.387707394,3997.6520045670113,144113.039711961,1975,150,867.516129032258,30,1,26,25.683953281706245,0.7350694444444444,35.31586021505377,1058.7365591397854,35.29121863799285,0
2000,4,0,0,31,0.0,0.0,1.0,31,750,600,150,0.8,9,6,3,391.95883573414704,0.33584229390681003,0.0609909777898725,0.2469372714089619,134063.15262241306,4309.447443346064,138372.60006575912,1976,151,868.516129032258,30,1,23,30.947436729396504,0.6753472222222222,41.09543010752689,1035.618279569893,34.520609318996435,8
2001,4,0,0,31,0.0,0.0,1.0,31,800,700,100,0.875,9,7,2,389.7496355465664,0.33521505376344085,0.058974455564065886,0.24601150214229212,134132.75965790843,4255.638838304998,138388.39849621343,1977,152,869.516129032258,30,1,23,30.934810345573265,0.6760416666666667,41.02822580645161,1035.8870967741934,34.52956989247311,0
2002,4,0,0,31,0.0,0.0,1.0,31,1050,800,250,0.7619047619047619,13,8,5,388.4698366433537,0.33534946236559143,0.05592123157264828,0.24566972688134664,134202.38475907626,4226.715696901377,138429.10045597763,1978,153,870.516129032258,30,1,23,30.89813853936957,0.6767361111111111,40.961021505376344,1036.155913978495,34.53853046594983,0
2003,4,0,0,31,0.0,0.0,1.0,31,1000,900,100,0.9,11,9,2,387.9320360090035,0.3349462365591398,0.05584429159785098,0.24673500888783712,134411.36845661356,4228.495165626098,138639.86362223967,1979,154,871.516129032258,30,1,23,30.70263555843595,0.6788194444444444,40.75940860215054,1036.9623655913983,34.565412186379945,0
2004,4,0,0,31,0.0,0.0,1.0,31,900,700,200,0.7777777777777778,11,7,4,386.28409219206117,0.33436379928315413,0.05674310143800998,0.24662753578416255,134550.78125000023,4194.965277777809,138745.74652777804,1980,155,872.516129032258,30,1,23,30.6057563587684,0.6802083333333332,40.625000000000014,1037.5000000000018,34.58333333333339,0
2005,4,0,0,31,0.0,0.0,1.0,31,750,500,250,0.6666666666666666,10,5,5,388.1184974941422,0.33449820788530465,0.05223803274158989,0.24828950456132126,134622.839506173,4249.922839506193,138872.7623456792,1981,156,873.516129032258,29,2,23,30.486036759457523,0.6839080459770114,40.555555555555564,1037.777777777779,35.785440613026864,0
2006,4,0,0,31,0.0,0.0,1.0,31,650,300,350,0.46153846153846156,10,3,7,387.56166038411175,0.33342293906810033,0.05558312655086861,0.24867153745675877,134730.96305941377,4243.311149691382,138974.27420910515,1982,157,874.516129032258,29,2,24,30.39227982162764,0.6849856321839081,40.4513888888889,1038.194444444446,35.799808429118826,0
2007,4,0,0,31,0.0,0.0,1.0,31,600,500,100,0.8333333333333334,7,5,2,387.994003240717,0.3328853046594982,0.0565174060667768,0.24944378007143964,134803.06954089514,4260.556520061742,139063.62606095689,1983,158,875.516129032258,29,2,22,30.30891957558736,0.6857040229885056,40.38194444444445,1038.4722222222229,35.8093869731801,0
2008,4,0,0,31,0.0,0.0,1.0,31,350,200,150,0.5714285714285714,5,2,3,387.994003240717,0.3328853046594982,0.0565174060667768,0.24944378007143964,134803.06954089514,4260.556520061742,139063.62606095689,1984,159,876.516129032258,29,2,22,30.30891957558736,0.6857040229885056,40.38194444444445,1038.4722222222229,35.8093869731801,0
2009,4,0,0,31,0.0,0.0,1.0,31,900,700,200,0.7777777777777778,11,7,4,388.2356950988709,0.33198924731182794,0.06337791344387833,0.25084451387994416,134983.420138889,4281.076388888911,139264.4965277779,1985,160,877.516129032258,29,2,22,30.122293504410592,0.6875,40.20833333333334,1039.1666666666677,35.833333333333364,0
2010,4,0,0,31,0.0,0.0,1.0,31,550,300,250,0.5454545454545454,8,3,5,389.6651020052776,0.332168458781362,0.06630081949192368,0.2520193568111922,135019.5047260803,4322.477816358033,139341.98254243835,1986,161,878.516129032258,29,2,22,30.04908347810594,0.6878591954022988,40.173611111111114,1039.3055555555559,35.838122605364,0
2011,4,0,0,31,0.0,0.0,1.0,31,750,600,150,0.8,9,6,3,389.67888108302884,0.332168458781362,0.07171914135386381,0.23891174849786967,133055.88073765746,4169.8133454734525,137225.69408313092,1987,162,879.516129032258,30,1,19,32.01890090324822,0.6652777777777779,42.06989247311827,1031.7204301075262,34.390681003584206,7
2012,4,0,0,31,0.0,0.0,1.0,31,650,400,250,0.6153846153846154,9,4,5,388.9014882059287,0.3322132616487455,0.06412125234720611,0.23910124322924933,133159.90513715448,4157.217055439922,137317.1221925944,1988,163,880.516129032258,30,1,21,31.934225376568136,0.6663194444444445,41.96908602150537,1032.1236559139775,34.40412186379925,0
2013,4,1,0,32,0.03125,0.0,1.0,32,850,800,50,0.9411764705882353,9,8,1,380.60578130007036,0.33946572580645157,0.05773985762882705,0.2361898425471975,133505.86149427606,3762.620544433569,137268.48203870963,1989,0,853.96875,31,1,22,31.800559615303854,0.6670026881720431,41.63411458333332,1033.4635416666652,33.337533602150486,0
2014,4,1,1,32,0.030303030303030304,0.030303030303030304,0.9696969696969697,33,450,300,150,0.6666666666666666,6,3,3,371.8921542167666,0.34497316919191917,0.04811789772727293,0.2322058328768103,133733.29252117124,3346.8724492398687,137080.1649704111,1990,0,829.060606060606,32,1,19,31.79753621419272,0.6666666666666667,41.41414141414141,1034.3434343434337,32.323232323232304,0
2015,4,0,0,32,0.0,0.0,1.0,32,1100,1000,100,0.9090909090909091,12,10,2,381.07116676079227,0.33915070564516125,0.052311579146203435,0.23734008903901566,133640.46096801746,3785.305277506497,137425.76624552396,1991,2,855.96875,31,1,22,31.653365445158038,0.6683467741935485,41.50390624999999,1033.984374999999,33.354334677419324,0
2016,4,0,0,32,0.0,0.0,1.0,32,650,400,250,0.6153846153846154,9,4,5,381.07116676079227,0.33915070564516125,0.052311579146203435,0.23734008903901566,133640.46096801746,3785.305277506497,137425.76624552396,1992,3,856.96875,31,1,22,31.653365445158038,0.6683467741935485,41.50390624999999,1033.984374999999,33.354334677419324,0
2017,4,1,1,32,0.030303030303030304,0.030303030303030304,0.9696969696969697,33,850,500,350,0.5882352941176471,12,5,7,370.0025967454325,0.3467092803030303,0.037303998758011936,0.2322573727503103,133929.2626390163,3310.8349913274005,137240.0976303437,1993,0,831.969696969697,32,1,21,31.649995933967634,0.6686197916666667,41.22474747474747,1035.101010101009,32.34690656565653,0
2018,4,0,1,31,0.0,0.03125,0.96875,32,950,800,150,0.8421052631578947,11,8,3,378.21078676684766,0.3394867271505377,0.04770274946520692,0.23685115228023162,133842.4873352051,3724.1344875759564,137566.62182278108,1994,5,858.96875,31,1,21,31.52460572123651,0.6703629032258065,41.30859375,1034.7656250000002,33.37953629032259,0
2019,4,1,1,31,0.03125,0.03125,0.96875,32,600,400,200,0.6666666666666666,8,4,4,379.2283430469701,0.34137684811827956,0.048013114857215156,0.23792313329758188,133909.86336602093,3756.4831203884455,137666.34648640937,1995,0,859.78125,31,1,21,31.4307093135405,0.6710349462365592,41.24348958333333,1035.0260416666656,33.387936827956956,0
2020,4,0,0,31,0.0,0.0,1.0,31,900,600,300,0.6666666666666666,12,6,6,387.51015111200223,0.3311827956989247,0.031053718835464483,0.24623173852372215,134376.52654931217,4214.453621805995,138590.98017111816,1996,171,888.516129032258,30,1,21,30.748476795436854,0.6784722222222221,40.793010752688176,1036.8279569892482,34.5609318996416,1
2021,4,0,0,31,0.0,0.0,1.0,31,650,400,250,0.6153846153846154,9,4,5,387.28621596749724,0.3308691756272401,0.032513118558317844,0.24632425030414198,134411.3684566136,4211.134054514986,138622.50251112858,1997,172,889.516129032258,30,1,21,30.719377835385608,0.6788194444444444,40.75940860215054,1036.9623655913986,34.56541218637995,0
2022,4,0,0,31,0.0,0.0,1.0,31,900,600,300,0.6666666666666666,12,6,6,404.07753704665845,0.33010752688172046,-0.015963874312712845,0.25700397348021203,134411.3684566136,4662.522943403875,139073.89140001746,1998,173,890.516129032258,30,1,21,30.284078634694325,0.6788194444444444,40.75940860215054,1036.9623655913986,34.56541218637995,2
2023,4,0,0,31,0.0,0.0,1.0,31,1000,700,300,0.7,13,7,6,400.424902670119,0.3288082437275986,-0.015456118499695082,0.2554115205626433,134515.92127702644,4572.704936986959,139088.6262140134,1999,174,891.516129032258,30,1,21,30.27392675131726,0.679861111111111,40.65860215053765,1037.3655913978512,34.578853046595036,0
2024,4,0,0,31,0.0,0.0,1.0,31,1150,1000,150,0.8695652173913043,13,10,3,401.1225625393134,0.3288530465949821,-0.018137064386579027,0.256101328390485,134550.78125000006,4594.270833333334,139145.0520833334,2000,175,892.516129032258,30,1,21,30.220883534136533,0.6802083333333333,40.625,1037.5000000000005,34.58333333333335,0
2025,4,0,0,31,0.0,0.0,1.0,31,1050,900,150,0.8571428571428571,12,9,3,399.8741576955084,0.3285394265232975,-0.01719037272271451,0.2555487166729575,134585.64573939188,4563.464345589092,139149.110084981,2001,176,893.516129032258,30,1,21,30.2183182210708,0.6805555555555556,40.59139784946237,1037.634408602151,34.58781362007171,0
2026,4,0,0,31,0.0,0.0,1.0,31,850,700,150,0.8235294117647058,10,7,3,399.60332242124497,0.32844982078853047,-0.020736730414149696,0.25586541092345405,134655.3882674299,4561.748106717554,139217.13637414743,2002,177,894.516129032258,30,1,21,30.155454113787442,0.6812499999999999,40.5241935483871,1037.9032258064526,34.59677419354842,0
2027,4,0,0,31,0.0,0.0,1.0,31,750,500,250,0.6666666666666666,10,5,5,400.57973940999904,0.32813620071684585,-0.017977302819813135,0.256736707673313,134690.26630607585,4590.8383555902465,139281.1046616661,2003,178,895.516129032258,30,1,21,30.095170270620233,0.6815972222222222,40.490591397849464,1038.0376344086021,34.601254480286734,0
2028,4,0,0,31,0.0,0.0,1.0,31,800,600,200,0.75,10,6,4,395.1506274762785,0.32813620071684585,0.004589715513154458,0.2452230165185717,133506.9467026534,4351.070752399107,137858.0174550525,2004,179,896.516129032258,30,1,22,31.423678848571534,0.6697916666666668,41.633064516129025,1033.4677419354832,34.44892473118277,3
2029,4,0,0,31,0.0,0.0,1.0,31,800,600,200,0.75,10,6,4,396.6602579555007,0.32813620071684585,0.0046796738852263875,0.247049341837226,133640.46096801758,4401.971944173176,138042.43291219076,2005,180,897.516129032258,31,0,22,31.250393527263572,0.6683467741935484,41.50390625,1033.984375,33.35433467741935,0
2030,4,0,0,31,0.0,0.0,1.0,31,800,500,300,0.625,11,5,6,394.8742558575755,0.3270609318996416,0.0036388298887639614,0.2463854056776686,133707.78613620327,4359.552510579417,138067.33864678268,2006,181,898.516129032258,31,0,20,31.228886021234622,0.6690188172043011,41.43880208333333,1034.244791666666,33.362735215053746,0
2031,4,0,0,31,0.0,0.0,1.0,31,550,300,250,0.5454545454545454,8,3,5,394.0663156142878,0.32692652329749106,-0.006235638950009337,0.24655519243079757,133808.8056776258,4345.908610026032,138154.71428765182,2007,182,899.516129032258,31,0,21,31.148271667086167,0.6700268817204302,41.34114583333333,1034.635416666666,33.375336021505355,0
2032,4,0,0,31,0.0,0.0,1.0,31,600,500,100,0.8333333333333334,7,5,2,396.0825492100771,0.3272849462365591,-0.004674964187014519,0.2484972520655802,133909.863366021,4407.872009277335,138317.73537529833,2008,183,900.516129032258,31,0,21,30.99459575627962,0.6710349462365592,41.24348958333333,1035.026041666666,33.38793682795697,0
2033,4,0,0,31,0.0,0.0,1.0,31,750,500,250,0.6666666666666666,10,5,5,396.0825492100771,0.3272849462365591,-0.004674964187014519,0.2484972520655802,133909.863366021,4407.872009277335,138317.73537529833,2009,184,901.516129032258,31,0,21,30.99459575627962,0.6710349462365592,41.24348958333333,1035.026041666666,33.38793682795697,0
2034,4,0,0,31,0.0,0.0,1.0,31,850,600,250,0.7058823529411765,11,6,5,397.6723143601037,0.3272849462365591,-0.0910893369861212,0.22696843444046103,130329.05578613286,4165.651448567711,134494.70723470056,2010,185,902.516129032258,31,0,19,34.575044631471556,0.6350806451612903,44.7265625,1021.0937500000003,32.93850806451614,7
2035,4,0,0,31,0.0,0.0,1.0,31,600,300,300,0.5,9,3,6,397.8855263074964,0.3271505376344086,-0.09577923412793077,0.22786933134369453,130462.04460991742,4181.7918565538,134643.83646647123,2011,186,903.516129032258,31,0,20,34.434212762341744,0.6364247311827957,44.59635416666666,1021.6145833333323,32.955309139784916,0
2036,4,1,1,31,0.03125,0.03125,0.96875,32,750,600,150,0.8,9,6,3,390.7599451303155,0.33505544354838707,-0.10567129629629635,0.2254384298828744,130746.3842975207,3818.0899908172687,134564.47428833795,2012,0,876.25,32,0,18,34.327160493827165,0.63671875,44.31818181818182,1022.727272727273,31.96022727272728,0
2037,4,0,0,31,0.0,0.0,1.0,31,850,600,250,0.7058823529411765,11,6,5,398.65780638211714,0.32764336917562725,-0.09466638726934318,0.22929395149494503,130628.37600707995,4215.204366048165,134843.58037312812,2013,188,905.516129032258,31,0,19,34.2452394599414,0.6381048387096775,44.43359374999999,1022.265624999999,32.97631048387093,0
2038,4,3,1,33,0.08823529411764706,0.029411764705882353,0.9705882352941176,34,650,400,250,0.6153846153846154,9,4,5,368.2325020885894,0.35013740344622696,-0.09456099243785299,0.21585092413103107,131358.63272392304,2874.103599773258,134232.7363236963,2014,0,826.5294117647059,34,0,21,34.28318429915224,0.638174019607843,43.7202380952381,1025.1190476190486,30.150560224089666,0
2039,4,0,0,33,0.0,0.0,1.0,33,850,600,250,0.7058823529411765,11,6,5,375.4379007204705,0.3453282828282828,-0.09263365360926346,0.2198993418505613,131328.12500000003,3261.1111111111113,134589.23611111115,2015,1,852.5757575757576,33,0,21,34.12940379403793,0.6401515151515151,43.75,1025.0000000000002,31.060606060606066,0
2040,4,0,0,33,0.0,0.0,1.0,33,500,400,100,0.8,6,4,2,376.091426399169,0.3457623106060606,-0.09656396602003303,0.2204628438562754,131359.53006355738,3280.6386065455717,134640.16867010295,2016,2,853.5757575757576,33,0,21,34.08086770272962,0.6404671717171717,43.719362745098046,1025.1225490196086,31.064319667260868,0
2041,4,1,1,33,0.029411764705882353,0.029411764705882353,0.9705882352941176,34,550,200,350,0.36363636363636365,9,2,7,367.7457804586178,0.35191993464052285,-0.09423435228598931,0.21694735672640852,131602.8220663266,2879.2765022675812,134482.09856859417,2017,0,829.4411764705883,34,0,16,34.04880689948563,0.640625,43.48214285714286,1026.0714285714291,30.178571428571445,0
2042,4,0,0,33,0.0,0.0,1.0,33,300,200,100,0.6666666666666666,4,2,2,379.6409612874686,0.3448153409090909,-0.09825308534677568,0.2230923851161191,131453.76778162242,3381.0469530949586,134834.81473471737,2018,4,855.5757575757576,33,0,21,33.894498884639894,0.6414141414141414,43.627450980392155,1025.4901960784312,31.075460487225186,0
2043,4,0,0,33,0.0,0.0,1.0,33,950,700,250,0.7368421052631579,12,7,5,377.6120674536998,0.34477588383838387,-0.09873378304493152,0.22208259961489918,131485.1878634419,3330.0787257304837,134815.2665891724,2019,5,856.5757575757576,33,0,21,33.91471999840682,0.641729797979798,43.59681372549019,1025.6127450980389,31.079174093879967,0
2044,4,0,0,33,0.0,0.0,1.0,33,850,700,150,0.8235294117647058,10,7,3,379.46608197510375,0.3450915404040404,-0.10043331414732659,0.22354050473002082,131548.0392907776,3383.6038122356863,134931.6431030133,2020,6,857.5757575757576,33,0,21,33.803582805718165,0.642361111111111,43.53553921568628,1025.8578431372553,31.086601307189554,0
2045,4,0,0,33,0.0,0.0,1.0,33,650,500,150,0.7692307692307693,8,5,3,372.6890498250014,0.3450915404040404,-0.05642503342938365,0.20550263234010563,128976.8442792829,3027.6222471925566,132004.46652647544,2021,7,858.5757575757576,32,1,21,36.590014501760926,0.6188151041666665,46.05429292929294,1015.7828282828298,31.74321338383843,5
2046,4,2,2,33,0.05714285714285714,0.05714285714285714,0.9428571428571428,35,650,400,250,0.6153846153846154,9,4,5,354.15580870126314,0.3624299719887955,-0.06280566280566247,0.19745399197454,129413.2812500001,2166.4930555555698,131579.77430555568,2022,0,810.4571428571429,34,1,21,36.61616161616162,0.6185661764705882,45.62500000000001,1017.5000000000008,29.92647058823532,0
2047,4,1,1,33,0.029411764705882353,0.029411764705882353,0.9705882352941176,34,850,600,250,0.7058823529411765,11,6,5,363.83058824117006,0.35572638146167557,-0.05550278913830853,0.2022391193445058,129294.84941188486,2608.2842236159163,131903.13363550077,2023,0,835.2647058823529,33,1,21,36.490716753022454,0.6196338383838383,45.74142156862745,1017.0343137254903,30.81922162804516,0
2048,4,1,1,33,0.029411764705882353,0.029411764705882353,0.9705882352941176,34,1200,800,400,0.6666666666666666,16,8,8,362.24958960405183,0.3511586452762923,-0.04910932464496898,0.2023189537095933,129481.87183114672,2580.9509863994695,132062.8228175462,2024,0,836.2352941176471,33,1,18,36.34043247039936,0.6215277777777777,45.55759803921569,1017.7696078431377,30.84150326797387,0
2049,4,0,0,33,0.0,0.0,1.0,33,1050,700,350,0.6666666666666666,14,7,7,374.4810406565644,0.34544665404040403,-0.053339651949556144,0.20851373493918038,129361.89746263137,3088.715596622797,132450.61305925416,2025,11,862.5757575757576,32,1,21,36.15153489719086,0.6227213541666666,45.67550505050505,1017.2979797979799,31.790561868686872,0
2050,4,1,0,34,0.029411764705882353,0.0,1.0,34,750,500,250,0.6666666666666666,10,5,5,363.0062181606365,0.3551693404634581,-0.040523526483764116,0.19871375811572722,128688.43102744623,2578.1565656565726,131266.5875931028,2026,0,838.1764705882352,32,2,18,37.13030944084951,0.6158854166666666,46.33838383838384,1014.646464646465,31.70770202020203,6
2051,4,1,0,35,0.02857142857142857,0.0,1.0,35,700,500,200,0.7142857142857143,9,5,4,356.43915307730504,0.36162464985994397,-0.029446837842495355,0.19672973229100243,129014.56921616683,2197.1687572087644,131211.7379733756,2027,0,815.2,33,2,19,36.9642139123442,0.6167929292929293,46.0171568627451,1015.9313725490193,30.7857991681521,0
2052,4,0,0,35,0.0,0.0,1.0,35,650,300,350,0.46153846153846156,10,3,7,356.58661461572996,0.36162464985994397,-0.03485631589828431,0.19712108055957536,129076.82742214522,2205.413783160305,131282.24120530553,2028,1,816.2,33,2,20,36.89700916546068,0.6174242424242424,45.95588235294117,1016.1764705882343,30.793226381461647,0
2053,4,1,1,35,0.027777777777777776,0.027777777777777776,0.9722222222222222,36,600,400,200,0.6666666666666666,8,4,4,348.32962045336586,0.36946097883597884,-0.03536594881398247,0.1937583513771846,129322.44897959175,1809.367913832188,131131.81689342394,2029,0,794.5,34,2,20,36.85676107990011,0.6176470588235294,45.71428571428571,1017.1428571428564,29.9159663865546,0
2054,4,1,0,36,0.027777777777777776,0.0,1.0,36,800,600,200,0.75,10,6,4,355.1354379920255,0.36855158730158727,-0.028485781467191718,0.1989177079990698,129595.04145408176,2004.7583616780162,131599.79981575976,2030,0,795.4722222222222,34,2,17,36.406329163256544,0.6204044117647058,45.44642857142858,1018.2142857142868,29.94747899159667,0
2055,4,0,0,36,0.0,0.0,1.0,36,800,600,200,0.75,10,6,4,355.25554534660625,0.3687830687830688,-0.025154843987378772,0.19960089964090033,129716.28578514747,2016.4859693877636,131732.77175453524,2031,1,796.4722222222222,34,2,17,36.2799949359199,0.6216299019607843,45.327380952380956,1018.6904761904768,29.961484593837554,0
2056,4,1,0,37,0.02702702702702703,0.0,1.0,37,1000,900,100,0.9,11,9,2,389.93989930652106,0.3729667167167167,0.05095994311448182,0.20038446226238874,126133.51048752827,2517.9386337868364,128651.4491213151,2032,0,775.918918918919,34,3,16,39.07644979062968,0.585171568627451,48.86904761904761,1004.523809523809,29.54481792717085,8
2057,4,4,1,40,0.0975609756097561,0.024390243902439025,0.975609756097561,41,1100,1000,100,0.9090909090909091,12,10,2,358.58206406666244,0.39720528455284554,0.06611570247933884,0.18864534674811334,127092.0138888886,914.5833333332996,128006.5972222219,2033,0,701.1219512195122,38,3,15,38.87741046831955,0.587171052631579,47.91666666666665,1008.333333333331,26.535087719298183,0
2058,4,2,2,40,0.047619047619047616,0.047619047619047616,0.9523809523809523,42,800,600,200,0.75,10,6,4,350.06784451223774,0.4014469608981804,0.06752706241923079,0.18548427999825554,127381.02349175338,518.4000651041565,127899.42355685754,2034,0,685.3809523809524,39,3,12,38.7955534344581,0.5884081196581197,47.63020833333333,1009.4791666666658,25.884081196581175,0
2059,4,1,1,40,0.024390243902439025,0.024390243902439025,0.975609756097561,41,800,500,300,0.625,11,5,6,353.66870840960183,0.396239837398374,0.06606820593452056,0.18717693492131685,127334.5172789282,806.8468523997218,128141.36413132792,2035,0,703.0731707317074,38,3,13,38.75238170847888,0.589638157894737,47.676282051282044,1009.2948717948706,26.56039136302291,0
2060,4,2,2,40,0.047619047619047616,0.047619047619047616,0.9523809523809523,42,1050,800,250,0.7619047619047619,13,8,5,352.87545136536096,0.40041860240030974,0.09490440858948679,0.18856296145646834,127723.00347222232,614.0625000000102,128337.06597222234,2036,0,687.2857142857143,39,3,15,38.37420994778785,0.5918803418803419,47.29166666666667,1010.8333333333342,25.91880341880344,0
2061,4,1,1,40,0.024390243902439025,0.024390243902439025,0.975609756097561,41,1150,800,350,0.6956521739130435,15,8,7,357.6240794071004,0.3963160569105691,0.08882917545605995,0.19066564504128264,127631.22420374017,928.799811892756,128560.02401563292,2037,0,704.8780487804878,38,3,15,38.3482677803623,0.5926535087719298,47.38247863247863,1010.470085470085,26.59131803868645,0
2062,4,1,1,40,0.024390243902439025,0.024390243902439025,0.975609756097561,41,900,500,400,0.5555555555555556,13,5,8,359.33741267336836,0.3938770325203252,0.085082246171299,0.19183588735271245,127685.20801373365,976.4144568631765,128661.62247059682,2038,0,705.8536585365854,38,3,15,38.249647639182534,0.5932017543859649,47.32905982905983,1010.6837606837605,26.596941070625277,0
2063,4,3,1,42,0.06976744186046512,0.023255813953488372,0.9767441860465116,43,900,600,300,0.6666666666666666,12,6,6,348.87086055198705,0.40185492801771866,0.1058721946762533,0.1887630148662756,128223.64501953138,347.5233575287555,128571.16837706014,2039,0,673.953488372093,39,4,17,37.96335578867978,0.5969551282051282,46.79687500000001,1012.812500000001,25.96955128205131,0
2064,4,1,0,43,0.023255813953488372,0.0,1.0,43,650,400,250,0.6153846153846154,9,4,5,349.33074359418265,0.40250092284976,0.12140452876376973,0.1896366893796993,128355.55555555563,367.7083333333428,128723.26388888898,2040,0,674.9302325581396,39,4,18,37.816954495614034,0.5982905982905983,46.66666666666667,1013.333333333334,25.982905982906,0
2065,4,1,1,43,0.022727272727272728,0.022727272727272728,0.9772727272727273,44,1350,800,550,0.5925925925925926,19,8,11,338.0916604057102,0.406668428470754,0.07193839218632636,0.17786561264822134,127092.01388888883,-189.40972222222717,126902.6041666666,2041,0,660.5681818181819,39,5,15,39.3939393939394,0.5854700854700855,47.916666666666664,1008.3333333333328,25.85470085470084,8
2066,4,1,2,42,0.022727272727272728,0.045454545454545456,0.9545454545454546,44,1100,700,400,0.6363636363636364,15,7,8,337.11757281348184,0.4069547216349542,0.07643945649726036,0.17827483872363586,127302.17013888879,-216.84027777778812,127085.32986111101,2042,0,661.5,39,5,16,39.20313790255988,0.5876068376068377,47.70833333333333,1009.1666666666658,25.876068376068353,0
2067,4,3,4,41,0.06666666666666667,0.08888888888888889,0.9111111111111111,45,700,500,200,0.7142857142857143,9,5,4,330.65462458775596,0.4127314814814815,0.07747028501783504,0.17561277415972898,127476.5777335745,-569.8560091546127,126906.72172441988,2043,0,647.4888888888889,40,5,15,39.187715943779146,0.5877604166666668,47.53556910569105,1009.857723577235,25.246443089430876,0
2068,4,3,2,42,0.06818181818181818,0.045454545454545456,0.9545454545454546,44,1100,800,300,0.7272727272727273,14,8,6,339.88251761242776,0.40791270260747003,0.10066274208365411,0.18091002501675735,127565.10959201367,-128.5698784722428,127436.53971354142,2044,0,662.9772727272727,39,5,17,38.86411287550698,0.5902777777777779,47.44791666666666,1010.2083333333316,25.902777777777732,0
2069,4,3,3,42,0.06666666666666667,0.06666666666666667,0.9333333333333333,45,800,600,200,0.75,10,6,4,334.57001195594,0.4106902356902357,0.10121843624708315,0.17905524738836157,127784.64708713374,-449.41781925443604,127335.2292678793,2045,0,649.1777777777778,40,5,17,38.77378798539219,0.5908854166666668,47.23069105691056,1011.0772357723557,25.276930894308894,0
2070,4,5,4,43,0.10638297872340426,0.0851063829787234,0.9148936170212766,47,1050,600,450,0.5714285714285714,15,6,9,321.3839996609233,0.41529833487511564,0.10323120681261044,0.17365890307057655,128170.25662634641,-1160.6139285478628,127009.64269779855,2046,0,622.4468085106383,40,7,18,38.71374448012845,0.5947916666666668,46.84959349593494,1012.6016260162573,25.315040650406434,0
2071,4,1,0,44,0.022727272727272728,0.0,1.0,44,1050,800,250,0.7619047619047619,13,8,5,343.0868315560636,0.4081219168428471,0.11685637262243498,0.18429531571197388,127933.68055555547,-21.527777777789453,127912.15277777768,2047,0,665.8636363636364,39,5,19,38.406095551894566,0.5940170940170941,47.08333333333333,1011.666666666666,25.940170940170923,0
2072,4,1,0,45,0.022222222222222223,0.0,1.0,45,800,500,300,0.625,11,5,6,339.87309117229285,0.41037457912457914,0.1337364362886415,0.18415295145689575,128279.78326576058,-279.8834830886341,127999.89978267194,2048,0,652.0444444444445,38,7,20,38.13387646769319,0.599232456140351,46.74145299145298,1013.034188034186,26.658794421952262,0
2073,4,4,3,46,0.08163265306122448,0.061224489795918366,0.9387755102040817,49,850,600,250,0.7058823529411765,11,6,5,319.6936389552537,0.42144982993197283,0.149604093305578,0.17706368915737117,129152.13647767558,-1542.1767021212704,127609.9597755543,2049,0,599.734693877551,42,7,19,37.7577851922466,0.6016865079365079,45.88178294573643,1016.4728682170539,24.201734957548904,0
2074,4,3,2,47,0.061224489795918366,0.04081632653061224,0.9591836734693877,49,1150,800,350,0.6956521739130435,15,8,7,323.6811031654655,0.42090065192743764,0.15737982821089846,0.18053273926961258,129428.4230619329,-1421.2836590096408,128007.13940292326,2050,0,600.265306122449,41,8,15,37.375999317539225,0.6059451219512195,45.61011904761904,1017.5595238095221,24.818524970963956,0
2075,4,3,5,45,0.06,0.1,0.9,50,900,400,500,0.4444444444444444,14,4,10,319.25327578043846,0.42509353741496597,0.17419438766028628,0.17988501329576342,129827.93578541107,-1710.4012425390085,128117.53454287206,2051,0,589.2,43,7,17,37.08379793099177,0.6070736434108527,45.21780303030304,1019.128787878789,23.700669485553234,0
2076,4,0,0,45,0.0,0.0,1.0,45,1150,800,350,0.6956521739130435,15,8,7,357.680328841979,0.4121632996632996,0.18053097345132696,0.19289330941655697,128091.8023003474,163.1835937500185,128254.98589409741,2052,1,655.3333333333334,39,6,23,37.87516292790012,0.595619658119658,46.92708333333334,1012.2916666666681,25.956196581196618,2
2077,4,2,2,45,0.0425531914893617,0.0425531914893617,0.9574468085106383,47,950,500,450,0.5263157894736842,14,5,9,343.90528080603355,0.41884443416589573,0.17396508594023175,0.18760626008108464,128550.50131492448,-558.1281974235628,127992.37311750092,2053,0,628.4042553191489,38,9,17,37.75547829751368,0.6019736842105262,46.47435897435898,1014.1025641025648,26.686909581646443,0
2078,4,2,2,45,0.0425531914893617,0.0425531914893617,0.9574468085106383,47,1050,700,350,0.6666666666666666,14,7,7,339.7526855992803,0.4183048103607771,0.1785731445768921,0.18615695518043832,128725.26584201408,-653.0490451388705,128072.2167968752,2054,0,629.3617021276596,39,8,18,37.68262848148908,0.6020299145299145,46.30208333333334,1014.7916666666682,26.020299145299184,0
2079,4,3,2,46,0.0625,0.041666666666666664,0.9583333333333334,48,1200,1000,200,0.8333333333333334,14,10,4,335.5415883269187,0.4215702570921986,0.18549186747991886,0.1857084352439134,129123.91067031864,-934.7115845396186,128189.19908577902,2055,0,616.875,40,8,20,37.383761623837614,0.6044270833333333,45.90955284552846,1016.3617886178865,25.409044715447163,0
2080,4,2,1,47,0.041666666666666664,0.020833333333333332,0.9791666666666666,48,1250,800,450,0.64,17,8,9,333.92284120321614,0.419566341607565,0.18816109768484468,0.1853028384682802,129228.54487407762,-969.4809509058305,128259.0639231718,2056,0,617.75,38,10,21,37.318526496444946,0.6088267543859649,45.806623931623925,1016.7735042735035,26.757197480881672,0
2081,4,0,0,47,0.0,0.0,1.0,47,1300,1100,200,0.8461538461538461,15,11,4,349.0107133321465,0.4157223250077089,0.20616720192693672,0.18497567806603793,127392.29024943337,-482.5852674238337,126909.70498200954,2057,1,631.8936170212766,34,13,17,38.81068199685534,0.5980392156862744,47.619047619047635,1009.5238095238117,29.691876750700345,4
2082,4,1,1,47,0.020833333333333332,0.020833333333333332,0.9791666666666666,48,1600,1200,400,0.75,20,12,8,340.40257736816756,0.41935394503546103,0.21930215293244215,0.18238753847053396,127831.16731596485,-897.1882355328046,126933.97908043205,2058,0,619.7083333333334,36,12,18,38.57878619153674,0.5983796296296295,47.1846846846847,1011.2612612612631,28.090590590590644,0
2083,4,2,1,48,0.04081632653061224,0.02040816326530612,0.9795918367346939,49,900,600,300,0.6666666666666666,12,6,6,333.6028945729578,0.41996173469387754,0.23140912175634765,0.18054167782362124,128232.43694540902,-1243.4903345420194,126988.946610867,2059,0,607.9591836734694,35,14,20,38.34097531710661,0.6044642857142857,46.78819444444445,1012.8472222222229,28.93849206349208,0
2084,4,2,3,47,0.04,0.06,0.94,50,1150,700,450,0.6086956521739131,16,7,9,328.0236672540619,0.42295068027210886,0.23292758773878242,0.17878481234597932,128515.36502718955,-1568.7837330573586,126946.5812941322,2060,0,596.66,36,14,14,38.19390456093588,0.605324074074074,46.50900900900902,1013.9639639639655,28.16566566566571,0
2085,4,0,0,47,0.0,0.0,1.0,47,800,800,0,1.0,8,8,0,353.61955412036764,0.41618485969781066,0.24408556083913457,0.19068303371253667,128087.5274556652,-341.1491305494593,127746.37832511574,2061,2,635.7234042553191,36,11,20,37.98230244372751,0.6009837962962963,46.93130630630631,1012.2747747747754,28.118743743743764,0
2086,4,3,3,47,0.06,0.06,0.94,50,1100,700,400,0.6363636363636364,15,7,8,328.3465415447449,0.42545918367346935,0.2261473590767864,0.1799914253285427,128743.83674214767,-1545.4432473013435,127198.39349484633,2062,0,598.52,36,14,15,37.95309957094244,0.6076388888888888,46.28378378378379,1014.8648648648659,28.19069069069072,0
2087,4,3,1,49,0.06,0.02,0.98,50,1300,800,500,0.6153846153846154,18,8,10,333.1002948912536,0.4222193877551021,0.25001551074673145,0.18445173384591754,129144.15048494443,-1396.409077996915,127747.74140694752,2063,0,599.46,36,14,19,37.425216042543745,0.6116898148148149,45.88963963963964,1016.4414414414417,28.234484484484494,0
2088,4,3,2,50,0.057692307692307696,0.038461538461538464,0.9615384615384616,52,1900,1300,600,0.6842105263157895,25,13,12,323.358199757681,0.427460407239819,0.27056269345556183,0.1742690863585904,128065.44189453122,-2112.975672964983,125952.46622156624,2064,0,577.3461538461538,39,13,18,38.7706468045693,0.5953525641025641,46.953125,1012.1874999999998,25.953525641025635,7
2089,4,2,3,49,0.038461538461538464,0.057692307692307696,0.9423076923076923,52,650,400,250,0.6153846153846154,9,4,5,321.95480645954314,0.4311054550025138,0.2633182917525603,0.17397307044604052,128171.57594601512,-2146.8846004747097,126024.69134554041,2065,0,577.5,38,14,18,38.697949637757624,0.5981359649122806,46.8482905982906,1012.6068376068381,26.647548358074687,0
2090,4,4,3,50,0.07547169811320754,0.05660377358490566,0.9433962264150944,53,1200,800,400,0.6666666666666666,16,8,8,315.5160586288673,0.4328434929850024,0.2752957679892425,0.17241837143254277,128619.58007812515,-2483.6914062499877,126135.88867187516,2066,0,567.3584905660377,39,14,15,38.40495995070857,0.6009615384615383,46.40625000000001,1014.3750000000011,26.009615384615415,0
2091,4,2,2,50,0.038461538461538464,0.038461538461538464,0.9615384615384616,52,1650,1200,450,0.7272727272727273,21,12,9,320.56053589115146,0.42867018602312723,0.26689000218876946,0.17451514200063875,128469.25593770537,-2163.5652942143415,126305.69064349103,2067,0,579.2307692307693,38,14,15,38.430024238592054,0.6011513157894737,46.554487179487175,1013.7820512820506,26.678475033738174,0
2092,4,1,1,50,0.0196078431372549,0.0196078431372549,0.9803921568627451,51,950,600,350,0.631578947368421,13,6,7,330.17983356194827,0.4274673202614379,0.28395006753647745,0.17991590577179348,128505.59937913585,-1714.0085170437083,126791.59086209214,2068,0,591.5686274509804,37,14,17,38.14919703687684,0.603322072072072,46.51864035087719,1013.925438596491,27.403390232337593,0
2093,4,2,1,51,0.038461538461538464,0.019230769230769232,0.9807692307692307,52,1350,900,450,0.6666666666666666,18,9,9,325.84339868188636,0.42946361236802416,0.2923420871606037,0.1793365086549699,128902.86138733652,-1999.5707091460354,126903.29067819049,2069,0,580.8076923076923,38,14,19,37.85485709275819,0.6055372807017544,46.12713675213675,1015.4914529914528,26.72345928924876,0
2094,4,1,1,51,0.019230769230769232,0.019230769230769232,0.9807692307692307,52,1200,900,300,0.75,15,9,6,328.0637917145876,0.42980926344896936,0.28454912601754323,0.18095464348420007,128989.67013888883,-1936.6319444444475,127053.03819444438,2070,0,581.6923076923077,39,13,19,37.710213289581624,0.6047008547008548,46.041666666666664,1015.8333333333328,26.047008547008534,0
2095,4,1,0,52,0.019230769230769232,0.0,1.0,52,1700,1400,300,0.8235294117647058,20,14,6,328.09565603828736,0.4292515082956259,0.2816544127043632,0.18207594827103224,129230.0128464612,-1919.5179977274704,127310.49484873374,2071,0,582.6730769230769,36,16,20,37.465158563148364,0.6125578703703705,45.80518018018017,1016.7792792792783,28.24386886886884,0
2096,4,0,0,52,0.0,0.0,1.0,52,1200,800,400,0.6666666666666666,16,8,8,328.2980965961933,0.4295578808446456,0.2763718958207151,0.18318918395306033,129445.89548405648,-1900.631780078898,127545.26370397759,2072,1,583.6730769230769,38,14,15,37.24081364829398,0.6110197368421053,45.592948717948715,1017.6282051282047,26.779689608636968,0
2097,4,0,0,52,0.0,0.0,1.0,52,1350,900,450,0.6666666666666666,18,9,9,325.28118014699714,0.42969142785319253,0.27434673103158747,0.18200847713568624,129554.63927469144,-1971.6628086419696,127582.97646604947,2073,2,584.6730769230769,38,14,15,37.207253296953155,0.6121162280701754,45.486111111111114,1018.0555555555562,26.79093567251464,0
2098,4,1,1,52,0.018867924528301886,0.018867924528301886,0.9811320754716981,53,1600,1300,300,0.8125,19,13,6,315.63872867344264,0.43302491533623605,0.2719881516222089,0.17789224201272835,129837.58680555563,-2403.6458333333294,127433.9409722223,2074,0,574.622641509434,39,14,16,37.166121559007884,0.6132478632478633,45.208333333333336,1019.1666666666673,26.132478632478648,0
2099,4,0,0,52,0.0,0.0,1.0,52,850,700,150,0.8235294117647058,10,7,3,321.5156162536843,0.43105046505781797,0.267155854526097,0.18090232638415266,129772.26382725181,-2055.2381245890856,127717.02570266272,2075,1,586.6153846153846,38,14,16,37.08254692251232,0.6143092105263158,45.2724358974359,1018.9102564102565,26.813427800269906,0
2100,4,0,2,50,0.0,0.038461538461538464,0.9615384615384616,52,1100,700,400,0.6363636363636364,15,7,8,321.15683441719347,0.43127828054298645,0.266539388905465,0.18095186317221557,129826.69850107757,-2061.053697311702,127765.64480376587,2076,2,587.6153846153846,38,14,16,37.03655170003845,0.6148574561403508,45.2190170940171,1019.1239316239321,26.819050832208738,0
2101,4,0,1,49,0.0,0.02,0.98,50,1150,600,550,0.5217391304347826,17,6,11,353.1798309868447,0.428562925170068,0.27255611105201516,0.18133498586058597,126097.48389445915,-1067.7682582730567,125029.71563618608,2077,3,611.84,38,12,16,40.03674254511932,0.5770285087719298,48.904914529914535,1004.3803418803427,26.431061628430072,8
2102,4,2,2,49,0.0392156862745098,0.0392156862745098,0.9607843137254902,51,1000,600,400,0.6,14,6,8,336.97558941208695,0.43107843137254903,0.17191902031570772,0.1722181517844059,125907.43803822713,-1714.4533711405254,124192.98466708661,2078,0,600.3725490196078,45,6,15,40.6392900120337,0.5648148148148149,49.09420289855072,1003.6231884057961,22.3027375201288,7
2103,4,4,1,52,0.07547169811320754,0.018867924528301886,0.9811320754716981,53,1500,1100,400,0.7333333333333333,19,11,8,335.26283664579927,0.4369708514755684,0.2228257019387443,0.1743803246990443,126628.33067611608,-2108.8761207855696,124519.4545553305,2079,0,578.377358490566,42,11,15,39.94095183081414,0.576140873015873,48.37693798449612,1006.4922480620144,23.964101144333675,0
2104,4,1,0,53,0.018867924528301886,0.0,1.0,53,1500,1000,500,0.6666666666666666,20,10,10,334.0195415503138,0.43654753265602325,0.2263352224251287,0.1744622670790938,126799.06274412617,-2129.327038639482,124669.73570548669,2080,0,579.3584905660377,42,11,16,39.79699826823168,0.5778769841269842,48.20736434108528,1007.1705426356607,23.98025101513478,0
2105,4,4,2,55,0.07017543859649122,0.03508771929824561,0.9649122807017544,57,1000,500,500,0.5,15,5,10,317.3726727741684,0.44256474519632416,0.25942770155938377,0.16924519777574704,127640.61187250595,-3297.7335505468454,124342.8783219591,2081,0,539.6315789473684,45,12,12,39.35550376479025,0.5824074074074075,47.37318840579711,1010.5072463768131,22.455716586151404,0
2106,4,0,3,52,0.0,0.05454545454545454,0.9454545454545454,55,1200,700,500,0.5833333333333334,17,7,10,330.3562567082172,0.4394500561167228,0.2668484791668444,0.1757561192172846,127545.97757582946,-2572.8776579717455,124973.0999178577,2082,1,560.2545454545455,43,12,12,39.12426564794851,0.5840600775193798,47.46685606060607,1010.1325757575769,23.491455250176205,0
2107,4,2,2,52,0.037037037037037035,0.037037037037037035,0.962962962962963,54,1450,1100,350,0.7586206896551724,18,11,7,326.1903444671883,0.4390504891684137,0.2741150028095143,0.1746770560792698,127809.16856778022,-2461.9766557621588,125347.19191201805,2083,0,570.1666666666666,43,11,13,38.96055753262158,0.5867248062015504,47.2064393939394,1011.1742424242436,23.515680056377757,0
2108,4,3,1,54,0.05454545454545454,0.01818181818181818,0.9818181818181818,55,1800,1000,800,0.5555555555555556,26,10,16,322.12986530841323,0.4416105499438833,0.2939657645596254,0.1748060197991736,128340.82729591057,-2730.6385013447702,125610.1887945658,2084,0,560.6545454545454,42,13,17,38.52104650792134,0.5935019841269842,46.68120155038759,1013.2751937984485,24.125599852344013,0
2109,4,2,1,55,0.03571428571428571,0.017857142857142856,0.9821428571428571,56,1400,1000,400,0.7142857142857143,18,10,8,317.02234608052845,0.4422957251082251,0.30407995618839,0.17331820477336685,128637.19135802475,-3043.827160493822,125593.36419753093,2085,0,551.6071428571429,44,12,16,38.34884994523551,0.59375,46.38888888888889,1014.4444444444449,23.055555555555568,0
2110,4,3,2,56,0.05172413793103448,0.034482758620689655,0.9655172413793104,58,1250,1000,250,0.8,15,10,5,309.950723346851,0.4452006452913894,0.31504838894001463,0.17168574849734275,129156.32780669995,-3593.580554298058,125562.7472524019,2086,0,532.948275862069,46,12,18,38.00111925111927,0.5964673913043477,45.87765957446809,1016.4893617021283,22.097594819611487,0
2111,4,1,0,57,0.017543859649122806,0.0,1.0,57,1100,600,500,0.5454545454545454,16,6,10,316.9960352324125,0.4439614661654135,0.32920861192340456,0.17589843456867799,129226.01861554278,-3207.149312212776,126018.86930333001,2087,0,543.1929824561404,42,15,20,37.751358048222635,0.6024305555555556,45.80910852713178,1016.7635658914716,24.208656330749324,0
2112,4,1,0,58,0.017241379310344827,0.0,1.0,58,1450,1000,450,0.6896551724137931,19,10,9,311.4988749261076,0.4459316394434362,0.33299766601415515,0.17398351794653324,129483.95061728396,-3533.179012345676,125950.77160493829,2088,0,534.8103448275862,44,14,15,37.629639737991276,0.6022727272727272,45.55555555555556,1017.7777777777778,23.13131313131313,0
2113,4,1,1,58,0.01694915254237288,0.01694915254237288,0.9830508474576272,59,1750,1000,750,0.5714285714285714,25,10,15,303.756034590298,0.44696084161309174,0.31666994914095814,0.16769625607758662,129024.94454089466,-3948.538773148182,125076.40576774649,2089,0,526.728813559322,47,12,14,38.29175210754158,0.593971631205674,46.00694444444443,1015.972222222219,21.616430260047213,3
2114,4,1,2,57,0.01694915254237288,0.03389830508474576,0.9661016949152542,59,900,500,400,0.5555555555555556,13,5,8,303.2541142322222,0.44659555815312685,0.319470756886544,0.16807425138540197,129179.32675208536,-3965.167537736336,125214.15921434901,2090,0,527.6949152542373,47,12,15,38.14798408903311,0.5955230496453903,45.85503472222221,1016.5798611111079,21.62935874704485,0
2115,4,0,0,57,0.0,0.0,1.0,57,1900,1600,300,0.8421052631578947,22,16,6,318.0660988516471,0.4429171888053467,0.3277532571290984,0.17607398595038626,129132.33109017265,-3185.476642905914,125946.85444726674,2091,1,546.7368421052631,45,12,16,37.81924887859073,0.5974537037037038,45.901268115942024,1016.3949275362311,22.58655394524958,0
2116,4,0,1,56,0.0,0.017543859649122806,0.9824561403508771,57,850,500,350,0.5882352941176471,12,5,7,318.96963317453196,0.44269527986633245,0.32254691487519316,0.17709906520310886,129249.53099890958,-3154.6279807819924,126094.90301812759,2092,2,547.7368421052631,43,14,17,37.677329732414485,0.6012596899224807,45.78598484848485,1016.8560606060609,23.64781536293165,0
2117,4,0,1,55,0.0,0.017857142857142856,0.9821428571428571,56,1200,800,400,0.6666666666666666,16,8,8,323.0864515877421,0.4410511363636364,0.3199334078420417,0.179275412439152,129225.45882295989,-2849.8010108183926,126375.6578121415,2093,3,558.3571428571429,43,13,17,37.59711356368945,0.601017441860465,45.8096590909091,1016.761363636365,23.64561310782244,0
2118,4,3,1,57,0.05172413793103448,0.017241379310344827,0.9827586206896551,58,1500,1300,200,0.8666666666666667,17,13,4,322.1563357357992,0.44321561806815896,0.3589631281357013,0.1822530667192776,129985.33412754665,-3224.880211615217,126760.45391593143,2094,0,539.948275862069,45,13,16,36.85046189376443,0.6060185185185185,45.063405797101446,1019.7463768115936,22.66103059581319,0
2119,4,1,1,57,0.017241379310344827,0.017241379310344827,0.9827586206896551,58,1900,1500,400,0.7894736842105263,23,15,8,349.7687813935943,0.44291943940310546,0.38067771933736494,0.19690409556397384,129793.15020130984,-2506.0905886274886,127287.05961268235,2095,0,540.9310344827586,42,16,17,36.34164606314189,0.6081349206349207,45.25193798449612,1018.992248062014,24.261720191952715,2
2120,4,0,1,56,0.0,0.017543859649122806,0.9824561403508771,57,1350,1000,350,0.7407407407407407,17,10,7,357.2842060441963,0.44078947368421056,0.3814559763895722,0.2012074212985734,129807.25623582743,-2124.3835034013828,127682.87273242604,2096,1,551.3157894736842,41,16,17,36.1358547507788,0.6097560975609757,45.23809523809523,1019.0476190476172,24.85481997677115,0
2121,4,0,2,54,0.0,0.03571428571428571,0.9642857142857143,56,1400,1000,400,0.7142857142857143,18,10,8,358.29557241423385,0.43920454545454546,0.38080815634659526,0.20198686316707962,129847.94439693615,-1895.2112870976487,127952.7331098385,2097,2,561.2857142857143,40,16,17,36.068734004719644,0.6117187500000001,45.19817073170731,1019.2073170731691,25.480182926829226,0
2122,4,2,1,55,0.03571428571428571,0.017857142857142856,0.9821428571428571,56,1050,700,350,0.6666666666666666,14,7,7,359.53744909291913,0.4407535173160173,0.3986530226073104,0.2043076132621391,130158.8642363176,-1840.6027951285653,128318.26144118904,2098,0,561.6964285714286,40,16,19,35.721251203399405,0.6148437500000001,44.89329268292683,1020.4268292682921,25.5106707317073,0
2123,4,1,1,55,0.017857142857142856,0.017857142857142856,0.9821428571428571,56,1350,1000,350,0.7407407407407407,17,10,7,361.83133572798044,0.43992830086580087,0.3946692649522836,0.20686625345847537,130395.54172092032,-1763.7200818404258,128631.82163907989,2099,0,561.9642857142857,39,17,20,35.42250977392489,0.6188568376068375,44.66145833333334,1021.3541666666681,26.188568376068414,0
2124,4,0,0,55,0.0,0.0,1.0,55,1650,1100,550,0.6666666666666666,22,11,11,363.55477845275766,0.4387485970819304,0.391536705971852,0.207869837440692,130398.95171305457,-1518.5675998976958,128880.38411315688,2100,2,573.1818181818181,38,17,20,35.375043584379355,0.6206140350877192,44.65811965811967,1021.3675213675238,26.878092667566413,0
2125,4,1,2,54,0.017857142857142856,0.03571428571428571,0.9642857142857143,56,1650,1000,650,0.6060606060606061,23,10,13,354.9165071512108,0.44111877705627706,0.378784680776733,0.20417060968241418,130635.03146701407,-1927.0941840277583,128707.93728298631,2101,0,563.9285714285714,39,17,18,35.35637864275526,0.6212606837606837,44.42708333333334,1022.2916666666681,26.212606837606874,0
2126,4,0,0,54,0.0,0.0,1.0,54,2050,1700,350,0.8292682926829268,24,17,7,368.09140918951135,0.4375655136268344,0.3895584894121835,0.2118019659972601,130644.58832137121,-1182.1698763605764,129462.41844501063,2102,4,584.6111111111111,38,16,18,35.00997143553838,0.6230811403508771,44.417735042735046,1022.3290598290602,26.903396311291058,0
2127,4,1,0,55,0.01818181818181818,0.0,1.0,55,1500,1100,400,0.7333333333333333,19,11,8,374.7936944336561,0.439337822671156,0.43552163050107184,0.2035160589868304,128366.66690712544,-1292.0896018883054,127074.57730523714,2103,0,574.9636363636364,37,18,19,37.160517204068384,0.6019144144144143,46.65570175438597,1013.3771929824576,27.388572783309666,7
2128,4,2,2,55,0.03508771929824561,0.03508771929824561,0.9649122807017544,57,1350,900,450,0.6666666666666666,18,9,9,358.0521462403335,0.44185985797827904,0.4207224768628268,0.1967514268944413,128840.02267995285,-2173.7106715578957,126666.31200839495,2104,0,555.7543859649123,40,17,16,37.10126793460127,0.6015624999999998,46.18902439024392,1015.2439024390279,25.381097560975697,0
2129,4,1,1,55,0.017857142857142856,0.017857142857142856,0.9821428571428571,56,1550,1000,550,0.6451612903225806,21,10,11,372.5104320747925,0.4393262987012987,0.44725057540278157,0.20509623954398948,128917.4156937838,-1595.3835555885669,127322.03213819524,2105,0,566.6607142857143,40,16,17,36.65524200273526,0.6023437499999998,46.1128048780488,1015.5487804878076,25.388719512195188,0
2130,4,0,0,55,0.0,0.0,1.0,55,2150,1800,350,0.8372093023255814,25,18,7,374.73630372447167,0.43755611672278344,0.43829413486874214,0.20767565734259943,129176.17517203647,-1318.5995173532306,127857.57565468324,2106,1,576.3090909090909,41,14,18,36.33451660648645,0.6034044715447153,45.858134920634924,1016.5674603174609,24.794328300425875,0
2131,4,1,0,56,0.017857142857142856,0.0,1.0,56,1350,900,450,0.6666666666666666,18,9,9,367.93385847254933,0.438967803030303,0.44154821878373585,0.20573203072338309,129527.44904667976,-1668.4833369299977,127858.96570974975,2107,0,567.0,38,18,16,36.14937552476912,0.6118421052631579,45.51282051282051,1017.9487179487174,26.788124156545194,0
2132,4,0,1,55,0.0,0.017857142857142856,0.9821428571428571,56,1850,1300,550,0.7027027027027027,24,13,11,367.3442226621265,0.4393330627705628,0.4348846355532252,0.20640112923296255,129717.84056770032,-1669.7801382496978,128048.06042945062,2108,1,568.0,38,18,16,35.970547107149095,0.6137609649122808,45.3258547008547,1018.6965811965811,26.80780476833108,0
2133,4,1,0,56,0.017857142857142856,0.0,1.0,56,1100,800,300,0.7272727272727273,14,8,6,367.641847263751,0.43972537878787876,0.43254718358171984,0.20762324057532183,129917.22140842004,-1647.3985460069543,128269.82286241309,2109,0,568.5892857142857,39,17,18,35.76012823132727,0.6140491452991453,45.13020833333333,1019.4791666666658,26.14049145299143,0
2134,4,1,0,57,0.017543859649122806,0.0,1.0,57,1400,700,700,0.5,21,7,14,365.6154565628052,0.440593671679198,0.4438327049500026,0.20846573888893313,130290.57167830481,-1871.3753044807108,128419.1963738241,2110,0,559.5964912280701,37,20,20,35.432441019582576,0.6213400900900901,44.76425438596491,1020.9429824561399,27.593053579895674,0
2135,4,0,1,56,0.0,0.017543859649122806,0.9824561403508771,57,1050,400,650,0.38095238095238093,17,4,13,320.2732784682171,0.44052840434419377,0.3843639274517867,0.17996152245696254,129719.65449245549,-3052.471996072385,126667.1824963831,2111,1,560.5964912280701,44,13,16,37.16748469975154,0.6046401515151515,45.324074074074076,1018.7037037037043,23.152356902356914,6
2136,4,0,0,56,0.0,0.0,1.0,56,1400,900,500,0.6428571428571429,19,9,10,329.3311754300124,0.438961038961039,0.3955229330996204,0.18510683308652418,129731.44531249988,-2655.0781250000114,127076.36718749987,2112,2,571.5714285714286,43,13,17,36.92484662576684,0.6061046511627908,45.31249999999999,1018.7499999999991,23.691860465116257,0
2137,4,1,0,57,0.017543859649122806,0.0,1.0,57,2100,1800,300,0.8571428571428571,24,18,6,322.9886834359201,0.44078947368421056,0.3947399582437454,0.18294027039680355,130031.52239550493,-3000.257955261514,127031.26444024341,2113,0,562.5263157894736,45,12,19,36.78248963883955,0.6064814814814815,45.01811594202898,1019.9275362318823,22.665056360708494,0
2138,4,0,0,57,0.0,0.0,1.0,57,1900,1100,800,0.5789473684210527,27,11,16,322.33011813459325,0.44013680033416874,0.39822241322664187,0.18332627163162302,130193.24594524485,-3006.959130828643,127186.2868144162,2114,1,563.5263157894736,45,12,19,36.63565796869915,0.608101851851852,44.859601449275345,1020.5615942028955,22.679146537842122,0
2139,4,0,2,55,0.0,0.03508771929824561,0.9649122807017544,57,1500,1200,300,0.8,18,12,6,324.7908596737386,0.43918389724310775,0.4068297701269976,0.18552687642826704,130361.52354313123,-2931.8983583933755,127429.62518473786,2115,2,564.5263157894736,42,15,19,36.40268684568428,0.6138392857142858,44.694767441860456,1021.2209302325566,24.31478405315611,0
2140,4,0,0,55,0.0,0.0,1.0,55,1700,1300,400,0.7647058823529411,21,13,8,324.0451443469367,0.43656004489337824,0.4031285863097869,0.18559604541072053,130465.21183704963,-2544.6763196019133,127920.53551744772,2116,3,585.1454545454545,41,14,20,36.31692237975012,0.6163617886178862,44.59325396825397,1021.6269841269841,24.917731320170343,0
2141,4,0,0,55,0.0,0.0,1.0,55,1500,1100,400,0.7333333333333333,19,11,8,320.424967981469,0.4369248035914703,0.4026541254533107,0.18412372811562044,130591.93244716866,-2631.0168453955657,127960.91560177309,2117,4,586.1454545454545,41,14,16,36.2814026658902,0.6176321138211381,44.46924603174603,1022.1230158730157,24.929829655439406,0
2142,4,0,0,55,0.0,0.0,1.0,55,2000,1500,500,0.75,25,15,10,320.26166820937226,0.4370510662177329,0.3989205206900197,0.18463407583345698,130718.71456916105,-2627.1612811791388,128091.55328798191,2118,5,587.1454545454545,41,14,16,36.15759604190916,0.6189024390243902,44.345238095238095,1022.619047619048,24.94192799070849,0
2143,4,0,0,55,0.0,0.0,1.0,55,1200,800,400,0.6666666666666666,16,8,8,320.26580277997823,0.43691077441077436,0.39866691353452977,0.18500059901761118,130794.81336805577,-2622.1788194444252,128172.63454861134,2119,6,588.1454545454545,41,14,16,36.08070264765784,0.6196646341463413,44.27083333333334,1022.9166666666683,24.949186991869958,0
2144,4,0,1,54,0.0,0.01818181818181818,0.9818181818181818,55,1500,900,600,0.6,21,9,12,319.4174715740125,0.4364618406285073,0.3989773778487926,0.18544054069361351,130988.6193253562,-2631.9892820247555,128356.63004333143,2120,7,589.1454545454545,43,12,18,35.90695343817455,0.6187015503875968,44.08143939393941,1023.6742424242453,23.806377730796402,0
2145,4,1,0,55,0.01818181818181818,0.0,1.0,55,1200,800,400,0.6666666666666666,16,8,8,320.3633905594456,0.4354096520763187,0.40940897995413805,0.18660028767656828,131114.67013888908,-2599.1319444444275,128515.53819444466,2121,0,590.0,44,11,19,35.75569568755086,0.6186079545454545,43.95833333333334,1024.1666666666683,23.276515151515188,0
2146,4,0,0,55,0.0,0.0,1.0,55,1100,600,500,0.5454545454545454,16,6,10,320.0555236903731,0.4351571268237935,0.40838023251037203,0.186882024782796,131209.51753257916,-2601.1338305898203,128608.38370198934,2122,1,591.0,44,11,19,35.66802229251395,0.6195549242424241,43.865740740740755,1024.5370370370395,23.284932659932714,0
2147,4,1,0,56,0.017857142857142856,0.0,1.0,56,1250,700,550,0.56,18,7,11,319.13216006596383,0.43654626623376624,0.41832849891225465,0.18823064530836808,131595.18771701408,-2800.6415305641112,128794.54618644997,2123,0,581.4285714285714,43,13,18,35.303510998307935,0.6247577519379843,43.48958333333334,1026.0416666666683,23.86143410852717,0
2148,4,2,1,57,0.034482758620689655,0.017241379310344827,0.9827586206896551,58,1500,1000,500,0.6666666666666666,20,10,10,309.9672493545444,0.4377583686227062,0.4256160674399734,0.1850183260613369,132048.65316011608,-3413.8484397973093,128634.80472031877,2124,0,562.3448275862069,45,13,19,35.08333700537587,0.6266203703703703,43.04800724637681,1027.807971014493,22.8401771336554,0
2149,4,0,1,56,0.0,0.017543859649122806,0.9824561403508771,57,1650,1200,450,0.7272727272727273,21,12,9,314.79701552335433,0.4366906850459482,0.4290375153466257,0.18778585373964113,132025.37954867657,-3087.7609089477146,128937.61863972885,2125,1,573.2105263157895,45,12,19,34.98259298431167,0.6263888888888889,43.07065217391304,1027.7173913043466,22.838164251207704,0
2150,4,0,0,56,0.0,0.0,1.0,56,1550,1100,450,0.7096774193548387,20,11,9,319.5068045141947,0.43576839826839825,0.4321353012290954,0.19036161714333122,131978.83847931112,-2766.372610796051,129212.46586851506,2126,2,583.9642857142857,45,11,20,34.908321579689705,0.625925925925926,43.11594202898551,1027.5362318840582,22.834138486312405,0
2151,4,0,0,56,0.0,0.0,1.0,56,1050,600,450,0.5714285714285714,15,6,9,323.77213583419893,0.43561282467532464,0.43999830036888277,0.19325841269387967,132048.65316011594,-2649.2651064639886,129399.38805365194,2127,3,584.9642857142857,45,11,20,34.728617696307374,0.6266203703703703,43.048007246376805,1027.8079710144918,22.840177133655374,0
2152,4,0,0,56,0.0,0.0,1.0,56,1600,900,700,0.5625,23,9,14,323.3487027974594,0.4354369588744589,0.4398367131283658,0.1940775829264243,132258.20796576331,-2646.896003990766,129611.31196177255,2128,4,585.9642857142857,45,11,21,34.52910355759069,0.6287037037037038,42.84420289855072,1028.6231884057959,22.85829307568435,0
2153,4,0,0,56,0.0,0.0,1.0,56,1650,1200,450,0.7272727272727273,21,12,9,325.2984617250297,0.43507169913419913,0.4421329441568458,0.19623818830575013,132449.05832703423,-2582.6096452373895,129866.44868179684,2129,5,586.9642857142857,41,15,21,34.28745823695707,0.636178861788618,42.658730158730144,1029.365079365077,25.10646535036773,0
2154,4,0,0,56,0.0,0.0,1.0,56,1650,1300,350,0.7878787878787878,20,13,7,327.20821690965886,0.4347808441558441,0.44442647989652406,0.19819578226114792,132602.2819428696,-2522.288753464367,130079.99318940523,2130,6,587.9642857142857,41,15,21,34.084633660823215,0.6377032520325204,42.509920634920626,1029.9603174603162,25.12098335269064,0
2155,4,0,0,56,0.0,0.0,1.0,56,1300,900,400,0.6923076923076923,17,9,8,325.7638222604039,0.4340909090909091,0.4409502029025385,0.19772397978809403,132678.9269671986,-2555.6011235513015,130123.32584364731,2131,7,588.9642857142857,41,15,18,34.04499679024234,0.6384654471544717,42.43551587301586,1030.2579365079341,25.128242353852052,0
2156,4,1,0,57,0.017543859649122806,0.0,1.0,57,2100,1400,700,0.6666666666666666,28,14,14,320.069870015274,0.43371449456975775,0.4372550764474592,0.1960566073752936,133022.0210999938,-2884.7317994712066,130137.2893005226,2132,0,579.6140350877193,42,15,20,33.84819807126306,0.6403769841269842,42.102713178294564,1031.5891472868202,24.56164636397191,0
2157,4,0,0,57,0.0,0.0,1.0,57,1500,800,700,0.5333333333333333,22,8,14,322.4332351550576,0.43387113617376777,0.4335126749568943,0.19843334801310347,133197.0089406433,-2810.5714988582704,130386.43744178503,2133,1,580.6140350877193,42,15,20,33.612206264276104,0.6421130952380953,41.93313953488371,1032.267441860463,24.577796234772926,0
2158,4,0,1,56,0.0,0.017543859649122806,0.9824561403508771,57,1600,1200,400,0.75,20,12,8,323.00381945933316,0.4338319757727653,0.4340460576581273,0.19960355007608732,133349.93332651767,-2785.4924421774926,130564.44088434018,2134,2,581.6140350877193,43,14,20,33.444595978118,0.642199612403101,41.78503787878786,1032.8598484848458,24.01999647639176,0
2159,4,0,0,56,0.0,0.0,1.0,56,1550,1100,450,0.7096774193548387,20,11,9,326.8021385445378,0.4323119588744589,0.43216832187420473,0.20193530404325927,133347.0900655758,-2484.3771595757653,130862.71290600002,2135,3,592.1071428571429,42,14,20,33.349360477843454,0.6436011904761906,41.78779069767441,1032.8488372093007,24.591638981173826,0
2160,4,0,1,55,0.0,0.017857142857142856,0.9821428571428571,56,1600,1200,400,0.75,20,12,8,325.0009681215242,0.432224025974026,0.42865683739499794,0.20136463236954147,133447.19109616303,-2525.9067401298025,130921.28435603323,2136,4,593.1071428571429,42,14,20,33.29582043827567,0.644593253968254,41.690891472868216,1033.2364341085267,24.600867478774447,0
2161,4,0,0,55,0.0,0.0,1.0,55,1950,1500,450,0.7692307692307693,24,15,9,327.861732840475,0.4311868686868687,0.42055802394085373,0.2034183014798533,133498.47690073715,-2246.189258987083,131252.28764175007,2137,5,602.9636363636364,40,15,20,33.17066574884453,0.6481770833333333,41.64126016260163,1033.4349593495947,25.835873983739866,0
2162,4,0,1,54,0.0,0.01818181818181818,0.9818181818181818,55,1500,1000,500,0.6666666666666666,20,10,10,332.70590223907163,0.4308080808080808,0.42381594817958446,0.20730450430389213,133656.05919302354,-2106.3680472932533,131549.6911457303,2138,6,603.9636363636364,40,15,20,32.88800163800163,0.6497395833333333,41.48882113821139,1034.044715447156,25.8511178861789,0
2163,4,0,0,54,0.0,0.0,1.0,54,1350,1100,250,0.8148148148148148,16,11,5,341.15564466496187,0.4289832285115304,0.429788226513667,0.21228650616299374,133606.80474175364,-1683.856879340262,131922.9478624134,2139,7,615.574074074074,39,15,20,32.71882871536524,0.6509081196581196,41.53645833333334,1033.854166666668,26.509081196581235,0
2164,4,0,0,54,0.0,0.0,1.0,54,1900,1500,400,0.7894736842105263,23,15,8,342.8752542173461,0.42933263452131376,0.4297336809168446,0.21429163937271659,133768.39328342027,-1626.82562934026,132141.56765408002,2140,8,616.574074074074,39,15,19,32.512775651998794,0.6525106837606837,41.38020833333334,1034.4791666666679,26.52510683760687,0
2165,4,0,0,54,0.0,0.0,1.0,54,1150,900,250,0.782608695652174,14,9,5,343.29696593449916,0.42901962497088286,0.42650008575114295,0.21502598105884732,133849.22417534736,-1609.9934895833153,132239.23068576405,2141,9,617.574074074074,39,15,19,32.421062344809094,0.6533119658119657,41.30208333333334,1034.7916666666679,26.533119658119688,0
2166,4,0,0,54,0.0,0.0,1.0,54,1200,800,400,0.6666666666666666,16,8,8,342.3470855217496,0.4291069764733287,0.4263992784169901,0.21490227345733603,133930.07948133693,-1629.8855251735918,132300.19395616333,2142,10,618.574074074074,39,15,19,32.364835966589524,0.6541132478632479,41.22395833333334,1035.1041666666679,26.54113247863251,0
2167,4,0,2,52,0.0,0.037037037037037035,0.962962962962963,54,1250,900,350,0.72,16,9,7,343.29831186239244,0.42846639878872583,0.4289136249506391,0.21629098964105894,134064.89257812515,-1595.1497395833214,132469.74283854183,2143,11,619.574074074074,39,15,19,32.20554214443774,0.6554487179487178,41.09375000000001,1035.6250000000011,26.554487179487207,0
2168,4,0,0,52,0.0,0.0,1.0,52,1400,1100,300,0.7857142857142857,17,11,6,355.1273086487005,0.42567716189039717,0.43625381838378274,0.22400515662648987,134107.7704383994,-874.9336830666981,133232.8367553327,2144,20,642.6538461538462,38,14,20,31.85641223998625,0.6576206140350876,41.052350427350426,1035.790598290598,27.25764732343679,0
2169,4,0,0,52,0.0,0.0,1.0,52,1200,900,300,0.75,15,9,6,354.489815580109,0.4249151583710407,0.4355266601632213,0.22427897725449938,134218.45465565412,-884.1849523339988,133334.2697033201,2145,21,643.6538461538462,38,14,20,31.76229508196722,0.6587171052631579,40.94551282051282,1036.2179487179483,27.268893387314428,0
2170,4,0,1,51,0.0,0.019230769230769232,0.9807692307692307,52,1500,1000,500,0.6666666666666666,20,10,10,356.9757994085784,0.4240588863750629,0.4358551588559838,0.22670766737309167,134356.874132515,-807.5694901015536,133549.30464241342,2146,22,644.6538461538462,38,14,20,31.559580241824676,0.6600877192982457,40.811965811965806,1036.7521367521356,27.28295096716146,0
2171,4,0,0,51,0.0,0.0,1.0,51,1400,1100,300,0.7857142857142857,17,11,6,362.2678516965869,0.42544117647058827,0.4332810568154468,0.22950105457346778,134266.52912434592,-471.91058787319747,133794.61853647273,2147,23,645.9215686274509,37,14,21,31.51273099167725,0.661036036036036,40.89912280701754,1036.4035087719296,28.010905642484584,0
2172,4,0,0,51,0.0,0.0,1.0,51,1450,800,650,0.5517241379310345,21,8,13,361.5258303583421,0.4252450980392157,0.4351139178110979,0.22994559039699014,134412.2618982395,-481.2990813792012,133930.9628168603,2148,24,646.9215686274509,38,13,21,31.38629885294321,0.6606359649122806,40.75854700854701,1036.9658119658122,27.288573999100322,0
2173,4,0,0,51,0.0,0.0,1.0,51,1150,800,350,0.6956521739130435,15,8,7,361.682885297005,0.42501633986928106,0.4345194138718056,0.2304079647410288,134469.73876953128,-472.9193793402769,133996.819390191,2149,25,647.9215686274509,39,12,21,31.324800810150304,0.6594551282051282,40.703125,1037.1875000000002,26.594551282051288,0
2174,4,0,0,51,0.0,0.0,1.0,51,1200,900,300,0.75,15,9,6,365.11094406601245,0.4244607843137255,0.4396516002850843,0.23347364693518538,134607.66774392125,-370.60464217354695,134237.0631017477,2150,26,648.9215686274509,37,14,21,31.098108622147077,0.6644144144144144,40.57017543859649,1037.7192982456145,28.046467520151744,0
2175,4,0,1,50,0.0,0.0196078431372549,0.9803921568627451,51,1150,700,450,0.6086956521739131,16,7,9,363.9036128679918,0.42423202614379085,0.43863900937514266,0.23306573744305872,134664.5662607725,-399.01556248077054,134265.5506982917,2151,27,649.9215686274509,37,14,21,31.07261074723572,0.6649774774774775,40.51535087719298,1037.9385964912276,28.052394499762908,0
2176,4,0,0,50,0.0,0.0,1.0,50,1650,1200,450,0.7272727272727273,21,12,9,365.551097972973,0.4236734693877551,0.4295185810810809,0.23522418478260862,134835.3339489073,-142.15912588489658,134693.1748230224,2152,28,637.44,37,13,19,30.859374999999986,0.6666666666666667,40.35087719298245,1038.5964912280697,28.07017543859648,0
2177,4,0,0,50,0.0,0.0,1.0,50,1450,1000,450,0.6896551724137931,19,10,9,367.5245137382599,0.4232482993197279,0.43156362101709256,0.23761236979612715,135006.20984341326,-76.3816751308193,134929.82816828243,2153,29,638.44,37,13,19,30.63761693746922,0.6683558558558559,40.186403508771924,1039.2543859649115,28.087956377430043,0
2178,4,0,0,50,0.0,0.0,1.0,50,1500,1000,500,0.6666666666666666,20,10,10,371.10694190539755,0.42273809523809525,0.4371320118093631,0.24106700253635532,135177.1939442904,33.03901200368114,135210.2329562941,2154,30,639.44,37,13,19,30.37396316603402,0.670045045045045,40.0219298245614,1039.9122807017534,28.105737316263607,0
2179,4,0,0,50,0.0,0.0,1.0,50,1250,900,350,0.72,16,9,7,369.5703655222152,0.42240646258503406,0.43434503108862876,0.24102083838077643,135319.76335266608,2.034880924882941,135321.79823359096,2155,31,640.44,37,13,20,30.271783995503558,0.6714527027027027,39.88486842105262,1040.4605263157885,28.12055476529158,0
2180,4,0,0,50,0.0,0.0,1.0,50,750,400,350,0.5333333333333333,11,4,7,366.21845673355335,0.42183673469387756,0.42803876132294083,0.23978469160195548,135462.40790435515,-78.23320637119843,135384.17469798395,2156,32,641.44,37,13,20,30.216891369988062,0.6728603603603605,39.747807017543856,1041.0087719298242,28.135372214319574,0
2181,4,0,0,50,0.0,0.0,1.0,50,1100,800,300,0.7272727272727273,14,8,6,364.92540279960986,0.4216836734693878,0.426185736275013,0.2391525252375383,135494.60475792596,-110.91535630799916,135383.68940161797,2157,33,642.44,38,12,20,30.218488113562504,0.671326754385965,39.716880341880334,1041.1324786324776,27.398223121907307,0
2182,4,0,0,50,0.0,0.0,1.0,50,1200,700,500,0.5833333333333334,17,7,10,366.5184754955223,0.42181972789115646,0.42952595936794635,0.24038284402283686,135522.41421031466,-65.70626963256984,135456.7079406821,2158,34,643.44,38,12,20,30.149334769820094,0.6716008771929826,39.69017094017093,1041.2393162393146,27.4010346378767,0
2183,4,0,0,50,0.0,0.0,1.0,50,1550,1000,550,0.6451612903225806,21,10,11,367.33904439446275,0.4210289115646258,0.4332900994379594,0.24206701130609481,135692.3392987583,-30.889835875096537,135661.4494628832,2159,35,644.44,36,14,22,29.95883772877936,0.6770833333333334,39.52702702702703,1041.8918918918926,28.94144144144146,0
2184,4,0,1,49,0.0,0.02,0.98,50,900,600,300,0.6666666666666666,12,6,6,366.7615531021092,0.42030612244897964,0.4345045921123716,0.24228252490792454,135780.3511915633,-40.197503246477254,135740.15368831682,2160,36,645.44,36,14,23,29.88632270844588,0.6779513888888888,39.44256756756757,1042.2297297297305,28.950825825825845,0
2185,4,0,0,49,0.0,0.0,1.0,49,1050,500,550,0.47619047619047616,16,5,11,367.60400997965166,0.4193062641723356,0.42224469962912314,0.2440416298510074,135956.46057797657,195.62801822091993,136152.0885961975,2161,37,617.5714285714286,36,13,18,29.68924342223663,0.6796875,39.273648648648646,1042.905405405405,28.969594594594582,0
2186,4,1,1,49,0.02,0.02,0.98,50,1150,900,250,0.782608695652174,14,9,5,358.4951627709909,0.41965136054421764,0.41064705882352937,0.2396681144367857,136205.3708833485,-234.20667897817202,135971.16420437035,2162,0,606.2,37,13,19,29.67962184873949,0.6801801801801803,39.03508771929823,1043.8596491228054,28.21242294926501,0
2187,4,0,0,49,0.0,0.0,1.0,49,1350,900,450,0.6666666666666666,18,9,9,362.7040885516217,0.41863307823129253,0.4181416659877888,0.2423867481459974,136191.45063560194,79.43919426184351,136270.8898298638,2163,39,619.5714285714286,36,13,21,29.58360304959183,0.6820023148148149,39.04842342342343,1043.806306306307,28.99461961961964,0
2188,4,0,0,49,0.0,0.0,1.0,49,1300,900,400,0.6923076923076923,17,9,8,367.58059008580284,0.41753472222222227,0.42675174652071046,0.2468725541669678,136367.8263356264,225.23321463358081,136593.05955025996,2164,40,620.5714285714286,36,13,21,29.281221922731362,0.6837384259259258,38.87950450450452,1044.4819819819836,29.013388388388435,0
2189,4,0,0,49,0.0,0.0,1.0,49,1750,1400,350,0.8,21,14,7,370.11787280768584,0.41751700680272114,0.4316175872224086,0.2494062267089704,136485.4735436453,303.1426274247567,136788.61617107005,2165,41,621.5714285714286,36,13,22,29.09818766390057,0.6848958333333333,38.76689189189191,1044.9324324324348,29.025900900900965,0
2190,4,0,0,49,0.0,0.0,1.0,49,1200,800,400,0.6666666666666666,16,8,8,371.07789535495147,0.4169501133786848,0.4325383148119204,0.25070769499778567,136577.61432604276,336.18673534165856,136913.8010613844,2166,42,622.5714285714286,37,12,23,28.98167331025561,0.6838400900900901,38.678728070175445,1045.2850877192993,28.25094831673782,0
2191,4,0,0,49,0.0,0.0,1.0,49,1250,700,550,0.56,18,7,11,371.91382582092456,0.41618835034013607,0.43285468068401944,0.2525220149662013,136752.04790249444,372.2208947926015,137124.26879728705,2167,43,623.5714285714286,34,15,23,28.786800971242123,0.6917892156862745,38.511904761904766,1045.9523809523816,30.763305322128872,0
2192,4,0,0,49,0.0,0.0,1.0,49,1200,1000,200,0.8333333333333334,14,10,4,374.06782080736593,0.4156923185941043,0.4319120436253219,0.25511483419065567,136907.73986677994,442.55598072561247,137350.29584750556,2168,44,624.5714285714286,34,15,24,28.57610055738824,0.6933210784313726,38.363095238095234,1046.5476190476184,30.78081232492995,0
2193,4,0,0,49,0.0,0.0,1.0,49,1350,1000,350,0.7407407407407407,17,10,7,372.3911459454328,0.4156037414965987,0.42877335171530184,0.25442388083125034,136970.0414540817,401.28613945578877,137371.32759353748,2169,45,625.5714285714286,34,15,18,28.55822813601728,0.6939338235294118,38.30357142857143,1046.7857142857147,30.787815126050432,0
2194,4,0,0,49,0.0,0.0,1.0,49,1200,800,400,0.6666666666666666,16,8,8,374.31263349993674,0.41530257936507936,0.4304575075454762,0.2566506809741965,137094.6871456915,463.2546768707357,137557.94182256225,2170,46,626.5714285714286,34,15,20,28.3844397711341,0.6951593137254902,38.1845238095238,1047.261904761904,30.80182072829129,0
2195,4,0,0,49,0.0,0.0,1.0,49,1700,1300,400,0.7647058823529411,21,13,8,372.66885293203643,0.4151785714285714,0.4320092336061785,0.25656054187024546,137235.84754640356,428.7051772548176,137664.5527236584,2171,47,627.5714285714286,35,14,21,28.287699289370014,0.694345238095238,38.049768518518526,1047.8009259259268,29.937169312169335,0
2196,4,0,0,49,0.0,0.0,1.0,49,1400,1000,400,0.7142857142857143,18,10,8,334.5726661169189,0.415125425170068,0.30148182833529824,0.21304993935051794,134454.73358196163,-803.0242626886086,133651.709319273,2172,48,628.5714285714286,44,5,18,32.042711960241654,0.6517518939393939,40.717592592592595,1037.12962962963,23.571127946127955,8
2197,4,0,0,49,0.0,0.0,1.0,49,1550,1000,550,0.6451612903225806,21,10,11,337.37822326421394,0.41381448412698413,0.2994443685863435,0.21605994983598106,134661.64809564225,-713.412723415426,133948.23537222683,2173,49,629.5714285714286,38,11,18,31.763810259049567,0.6631030701754387,40.51816239316238,1037.9273504273485,27.313877642824963,0
2198,4,0,0,49,0.0,0.0,1.0,49,800,500,300,0.625,11,5,6,327.25278624538277,0.4137436224489796,0.2535857716580605,0.20893831737205254,134550.7812500003,-990.0807674044552,133560.70048259583,2174,50,630.5714285714286,43,6,16,32.136880856760385,0.6540697674418604,40.625000000000014,1037.5000000000023,24.12790697674424,6
2199,4,0,0,49,0.0,0.0,1.0,49,1050,700,350,0.6666666666666666,14,7,7,328.12535416719953,0.41340702947845803,0.2550122917235722,0.209791638422305,134602.24946460078,-966.717844545217,133635.53162005555,2175,51,631.5714285714286,41,8,17,32.06301784576162,0.657520325203252,40.57539682539683,1037.6984126984137,25.309717382888138,0
2200,4,0,0,49,0.0,0.0,1.0,49,1650,1500,150,0.9090909090909091,18,15,3,332.94254548138053,0.41259212018140584,0.25258245432092075,0.2142332826456403,134833.97822381248,-821.6064145565817,134012.37180925588,2176,52,632.5714285714286,41,8,13,31.70740201229025,0.6598069105691058,40.35218253968253,1038.5912698412683,25.3314943863724,0
2201,4,0,0,49,0.0,0.0,1.0,49,1300,1000,300,0.7692307692307693,16,10,6,335.91062535811506,0.4120075113378685,0.26099766747145714,0.21675859392332325,134937.0327558105,-734.6433886054581,134202.38936720506,2177,53,633.5714285714286,41,8,13,31.527797670199558,0.6608231707317074,40.25297619047618,1038.988095238094,25.34117305458766,0
2202,4,0,0,49,0.0,0.0,1.0,49,1100,700,400,0.6363636363636364,15,7,8,334.736271566489,0.41193664965986393,0.26103340711459433,0.21609735340201444,134953.21349565824,-765.2528957094003,134187.96059994886,2178,54,634.5714285714286,42,7,13,31.542206782927654,0.6594742063492064,40.23740310077519,1039.0503875968986,24.7392949427833,0
2203,4,0,0,49,0.0,0.0,1.0,49,1700,1200,500,0.7058823529411765,22,12,10,337.4685242227943,0.4118480725623583,0.26207517074966225,0.21869713452879783,135091.6883680555,-682.1614583333389,134409.52690972216,2179,55,635.5714285714286,43,6,13,31.333500334001318,0.6593992248062015,40.104166666666664,1039.583333333333,24.17635658914728,0
2204,4,0,0,49,0.0,0.0,1.0,49,1550,1100,450,0.7096774193548387,20,11,9,335.980298179345,0.4114051870748299,0.26435128939615127,0.21892524055743123,135288.65089101266,-709.1357466712288,134579.51514434142,2180,56,636.5714285714286,43,6,14,31.17642150615937,0.6613372093023255,39.91477272727274,1040.3409090909113,24.19397463002119,0
2205,4,0,0,49,0.0,0.0,1.0,49,1350,900,450,0.6666666666666666,18,9,9,338.0553518775884,0.41170634920634924,0.2707967000829987,0.22103309770889837,135411.82532892883,-644.6615480084638,134767.16378092035,2181,57,637.5714285714286,43,6,14,31.000079610590483,0.662548449612403,39.79640151515153,1040.8143939393965,24.20498590556736,0
2206,4,0,0,49,0.0,0.0,1.0,49,1400,1000,400,0.7142857142857143,18,10,8,338.50438340869505,0.41128117913832196,0.272178145407699,0.22178290769935624,135485.75689422654,-627.4954803718837,134858.26141385466,2182,58,638.5714285714286,43,6,14,30.914968770844702,0.6632751937984496,39.725378787878796,1041.0984848484864,24.21159267089503,0
2207,4,0,0,49,0.0,0.0,1.0,49,900,400,500,0.4444444444444444,14,4,10,341.4472929612377,0.41082057823129253,0.2702926401077841,0.22417288839968572,135559.7086364356,-542.7008902949776,135017.00774614062,2183,59,639.5714285714286,43,6,14,30.764924524870423,0.6640019379844961,39.65435606060607,1041.3825757575773,24.21819943622273,0
2208,4,0,0,49,0.0,0.0,1.0,49,1050,800,250,0.7619047619047619,13,8,5,343.8838594319134,0.4104662698412698,0.2690721689551847,0.2265663922053922,135685.35545005035,-467.958906066828,135217.39654398352,2184,60,640.5714285714286,41,8,14,30.576715546245165,0.6681910569105691,39.53373015873016,1041.865079365079,25.41134339914827,0
2209,4,0,0,49,0.0,0.0,1.0,49,1300,900,400,0.6923076923076923,17,9,8,345.85426282544927,0.4097576530612245,0.2756257732939942,0.22869041784184996,135814.58574459876,-405.5893132716053,135408.99643132716,2185,61,641.5714285714286,41,8,15,30.397096380190973,0.6694613821138211,39.40972222222222,1042.361111111111,25.423441734417345,0
2210,4,0,0,49,0.0,0.0,1.0,49,1300,700,600,0.5384615384615384,19,7,12,344.94645731155026,0.40972222222222227,0.27171523348585747,0.22825550210514914,135840.43918493317,-428.4643487024482,135411.97483623071,2186,62,642.5714285714286,41,8,15,30.395095800025384,0.6697154471544715,39.38492063492063,1042.460317460317,25.425861401471145,0
2211,4,0,0,49,0.0,0.0,1.0,49,900,600,300,0.6666666666666666,12,6,6,343.7472897453471,0.4096336451247165,0.26944212508980736,0.22779218254877648,135892.15344702685,-457.48811098514676,135434.6653360417,2187,63,643.5714285714286,41,8,11,30.37503964478274,0.6702235772357723,39.335317460317455,1042.6587301587294,25.430700735578768,0
2212,4,0,0,49,0.0,0.0,1.0,49,1150,800,350,0.6956521739130435,15,8,7,345.08393439207344,0.40904903628117917,0.27320887453240617,0.22917671524092628,135969.74329372932,-415.8052051839469,135553.93808854537,2188,64,644.5714285714286,41,8,11,30.263225688829714,0.6709857723577237,39.26091269841269,1042.9563492063476,25.437959736740183,0
2213,4,0,0,49,0.0,0.0,1.0,49,750,400,350,0.5333333333333333,11,4,7,344.1270978284541,0.40860615079365076,0.2658825584442053,0.22887390472271926,136021.48216057243,-438.264420351484,135583.21774022095,2189,65,645.5714285714286,41,8,11,30.23686400380411,0.6714939024390245,39.21130952380952,1043.1547619047608,25.442799070847823,0
2214,4,0,0,49,0.0,0.0,1.0,49,1150,800,350,0.6956521739130435,15,8,7,342.79431007198514,0.40860615079365076,0.2650849272966467,0.2284860933673723,136099.10891439888,-469.19997165534704,135629.90894274352,2190,66,646.5714285714286,41,8,11,30.19466628636623,0.6722560975609757,39.13690476190475,1043.4523809523794,25.450058072009252,0
2215,4,0,0,49,0.0,0.0,1.0,49,1150,1000,150,0.8695652173913043,13,10,3,344.3018263268658,0.40754322562358275,0.2664288138058071,0.23066688237366392,136280.3241232835,-415.68710238726294,135864.63702089625,2191,67,647.5714285714286,41,8,12,29.975752177355492,0.6740345528455285,38.963293650793645,1044.1468253968246,25.466995741385965,0
2216,4,0,0,49,0.0,0.0,1.0,49,1100,800,300,0.7272727272727273,14,8,6,345.3705732908016,0.40710034013605445,0.2578289435432295,0.23223193721277996,136409.8373724487,-377.61125283449326,136032.2261196142,2192,68,648.5714285714286,41,8,13,29.819563152896478,0.6753048780487806,38.8392857142857,1044.642857142855,25.479094076655002,0
2217,4,0,0,49,0.0,0.0,1.0,49,1400,1000,400,0.7142857142857143,18,10,8,344.0207858158155,0.4064448696145125,0.25914166890564894,0.23220326632098762,136543.631880596,-405.2304924583957,136138.4013881376,2193,69,649.5714285714286,42,7,13,29.72236386674084,0.6750992063492064,38.711240310077514,1045.155038759689,24.884643779992594,0
2218,4,0,0,49,0.0,0.0,1.0,49,1450,1000,450,0.6896551724137931,19,10,9,342.535609036274,0.40623228458049887,0.25780862854873265,0.23186695241539457,136644.9253725735,-438.8494531578865,136206.0759194156,2194,70,650.5714285714286,42,7,14,29.660951498300896,0.67609126984127,38.614341085271306,1045.5426356589126,24.893872277593157,0
2219,4,0,0,49,0.0,0.0,1.0,49,1500,1300,200,0.8666666666666667,17,13,4,343.7688351518207,0.40534651360544216,0.25607874228202654,0.2330410832769518,136696.1619479593,-401.6239274851135,136294.5380204742,2195,71,651.5714285714286,43,6,14,29.57803208669143,0.6751453488372094,38.56534090909089,1045.738636363633,24.31950317124728,0
2220,4,0,0,49,0.0,0.0,1.0,49,1600,1400,200,0.875,18,14,4,343.03584139116356,0.40500992063492064,0.2637850892300788,0.2333971602136264,136824.69312956659,-412.8407700842438,136411.85235948235,2196,72,652.5714285714286,41,8,16,29.470099247740055,0.6793699186991871,38.442460317460316,1046.2301587301583,25.517808749516057,0
2221,4,0,0,49,0.0,0.0,1.0,49,1350,900,450,0.6666666666666666,18,9,9,345.1563082590243,0.40477962018140584,0.26218396363284713,0.23553680802928198,136928.50548784298,-347.6525100781349,136580.85297776485,2197,73,653.5714285714286,41,8,17,29.312006319115323,0.6803861788617886,38.343253968253954,1046.6269841269818,25.527487417731265,0
2222,4,0,0,49,0.0,0.0,1.0,49,1000,600,400,0.6,14,6,8,344.60424024756134,0.4048681972789116,0.26220225605640723,0.23568428693016913,137006.39059153732,-357.4033722285437,136648.98721930876,2198,74,654.5714285714286,41,8,12,29.249482769512618,0.68114837398374,38.268849206349195,1046.9246031746015,25.53474641889272,0
2223,4,0,0,49,0.0,0.0,1.0,49,750,600,150,0.8,9,6,3,344.61651035327077,0.4046378968253968,0.2688789043468851,0.23621895346033267,137084.297839506,-351.6975308642134,136732.6003086418,2199,75,655.5714285714286,41,8,12,29.17219274977894,0.681910569105691,38.194444444444436,1047.222222222221,25.54200542005417,0
2224,4,0,0,49,0.0,0.0,1.0,49,1100,800,300,0.7272727272727273,14,8,6,345.79028925619843,0.40472647392290245,0.26906307977736565,0.23773082386363636,137188.20861678003,-312.3299319727903,136875.87868480725,2200,76,656.5714285714286,41,8,13,29.038825757575758,0.6829268292682926,38.095238095238095,1047.6190476190475,25.55168408826945,0
2225,4,0,0,49,0.0,0.0,1.0,49,1100,900,200,0.8181818181818182,13,9,4,345.0074898521396,0.4040532879818594,0.27118919138231834,0.2377243388981182,137266.16753472228,-328.42881944444014,136937.73871527784,2201,77,657.5714285714286,41,8,14,28.98235586481114,0.6836890243902438,38.020833333333336,1047.916666666667,25.5589430894309,0
2226,4,0,2,47,0.0,0.04081632653061224,0.9591836734693877,49,1400,900,500,0.6428571428571429,19,9,10,343.65596567645105,0.40373441043083896,0.2713775896429731,0.23768038254376547,137396.1482741245,-356.59879692617176,137039.54947719834,2202,78,658.5714285714286,41,8,15,28.889493439313647,0.6849593495934958,37.8968253968254,1048.4126984126988,25.57104142469997,0
2227,4,0,0,47,0.0,0.0,1.0,47,950,700,250,0.7368421052631579,12,7,5,355.99524127600216,0.40207755164970704,0.28002199568546193,0.24529535118058785,137266.16753472225,373.2204861111161,137639.38802083337,2203,79,681.8936170212766,39,8,16,28.69449966865475,0.686965811965812,38.020833333333336,1047.9166666666667,26.869658119658123,0
2228,4,0,0,47,0.0,0.0,1.0,47,1400,1000,400,0.7142857142857143,18,10,8,354.3363807087736,0.4014222941720629,0.27690017927815136,0.2449204213910097,137375.34722222234,335.4166666666756,137710.76388888902,2204,80,682.8936170212766,39,8,16,28.63010068892422,0.688034188034188,37.91666666666667,1048.3333333333342,26.880341880341902,0
2229,4,0,0,47,0.0,0.0,1.0,47,1150,700,450,0.6086956521739131,16,7,9,354.24888365439006,0.4009212149244527,0.27441016947719543,0.24524547887655374,137429.95334201393,336.8815104166741,137766.83485243062,2205,81,683.8936170212766,39,8,16,28.57846546128883,0.6885683760683761,37.864583333333336,1048.541666666667,26.88568376068377,0
2230,4,0,0,47,0.0,0.0,1.0,47,1200,800,400,0.6666666666666666,16,8,8,354.2925440486604,0.4004201356768424,0.27450400388768004,0.24605006334965587,137539.1981336805,345.8224826388846,137885.02061631938,2206,82,684.8936170212766,39,8,17,28.469463753723936,0.6896367521367521,37.760416666666664,1048.958333333333,26.896367521367512,0
2231,4,0,0,47,0.0,0.0,1.0,47,650,100,550,0.15384615384615385,12,1,11,352.8463214182745,0.4001695960530373,0.27184695722711383,0.24543288324066712,137593.83680555547,309.895833333323,137903.7326388888,2207,83,685.8936170212766,39,8,17,28.453468361133176,0.6901709401709402,37.70833333333333,1049.166666666666,26.901709401709386,0
2232,4,0,0,47,0.0,0.0,1.0,47,1100,700,400,0.6363636363636364,15,7,8,353.6134081239341,0.39993832870798646,0.27107333298136305,0.24655052504142796,137675.81515842007,336.8028428819356,138012.618001302,2208,84,686.8936170212766,39,8,17,28.352460711331677,0.6909722222222223,37.63020833333333,1049.479166666666,26.909722222222207,0
2233,4,0,0,47,0.0,0.0,1.0,47,1050,700,350,0.6666666666666666,14,7,7,351.4766335334725,0.39916743755781686,0.2701551361267269,0.24583851418347438,137785.15760633664,285.6526692708121,138070.81027560745,2209,85,687.8936170212766,39,8,17,28.30069534014617,0.6920405982905984,37.52604166666666,1049.895833333332,26.920405982905947,0
2234,4,0,0,47,0.0,0.0,1.0,47,950,700,250,0.7368421052631579,12,7,5,352.10380448475706,0.39899398704902866,0.2720364741641339,0.2464726631393297,137812.49999999985,304.8611111110974,138117.36111111095,2210,86,688.8936170212766,39,8,17,28.257275132275122,0.6923076923076923,37.49999999999999,1049.9999999999989,26.923076923076895,0
2235,4,0,0,47,0.0,0.0,1.0,47,1400,1100,300,0.7857142857142857,17,11,6,352.7226509219376,0.39868563058896084,0.27509935480058356,0.24710194884948253,137839.84510633684,323.84711371528215,138163.69222005212,2211,87,689.8936170212766,39,8,17,28.21407019806236,0.6925747863247864,37.473958333333336,1050.104166666667,26.92574786324787,0
2236,4,0,0,47,0.0,0.0,1.0,47,900,600,300,0.6666666666666666,12,6,6,350.0192244634733,0.39706675917360473,0.27230255656676694,0.24615637704104662,137972.607450922,258.61301143498565,138231.22046235699,2212,88,690.8936170212766,40,7,18,28.154220674534074,0.6921875000000001,37.34756097560975,1050.6097560975604,26.26524390243901,0
2237,4,0,0,47,0.0,0.0,1.0,47,1150,700,450,0.6086956521739131,16,7,9,346.35239137304916,0.3961995066296639,0.26975791471288213,0.24447725427031655,138099.10719206644,166.19120449103755,138265.29839655748,2213,89,691.8936170212766,41,6,13,28.12598316816109,0.691819105691057,37.22718253968253,1051.0912698412683,25.636372435152886,0
2238,4,0,0,47,0.0,0.0,1.0,47,850,400,450,0.47058823529411764,13,4,9,346.98037405630714,0.39604532839962997,0.26745827301584835,0.2452935973231942,138151.24957679803,187.15445090070574,138338.40402769874,2214,90,692.8936170212766,41,6,15,28.0581571828505,0.6923272357723578,37.17757936507935,1051.2896825396804,25.641211769260497,0
2239,4,0,0,47,0.0,0.0,1.0,47,1100,900,200,0.8181818181818182,13,9,4,347.4726394641881,0.39564061054579097,0.2639887295452086,0.24657998149928512,138281.64859693867,209.81788548751769,138491.46648242619,2215,91,693.8936170212766,41,6,15,27.91690247123184,0.6935975609756098,37.05357142857142,1051.7857142857135,25.6533101045296,0
2240,4,0,0,47,0.0,0.0,1.0,47,1250,900,350,0.72,16,9,7,349.49514753455566,0.39492753623188404,0.2656835896355594,0.2485845767675358,138359.91753472204,271.2239583333145,138631.14149305536,2216,92,694.8936170212766,41,6,15,27.786716171617147,0.6943597560975612,36.97916666666666,1052.083333333332,25.66056910569102,0
2241,4,0,0,47,0.0,0.0,1.0,47,1050,700,350,0.6666666666666666,14,7,7,348.5286801086884,0.39415664508171444,0.26580803532929753,0.24865775166597628,138464.3105650822,251.756680681498,138716.0672457637,2217,93,695.8936170212766,41,6,15,27.709472303390196,0.6953760162601628,36.8799603174603,1052.4801587301563,25.67024777390625,0
2242,4,0,0,47,0.0,0.0,1.0,47,1500,1200,300,0.8,18,12,6,348.73117676463227,0.3934435707678076,0.26801495274651477,0.24995148152306346,138620.97392487084,268.2910722159185,138889.26499708675,2218,94,696.8936170212766,41,6,15,27.550145234730728,0.696900406504065,36.73115079365079,1053.0753968253964,25.68476577622918,0
2243,4,0,0,47,0.0,0.0,1.0,47,1300,700,600,0.5384615384615384,19,7,12,346.65645248810984,0.3932508479802652,0.2645510277677605,0.2494235450829085,138751.59438775518,219.82709750567705,138971.42148526086,2219,95,697.8936170212766,41,6,16,27.476459510357817,0.698170731707317,36.60714285714286,1053.5714285714294,25.696864111498275,0
2244,4,0,0,47,0.0,0.0,1.0,47,1000,700,300,0.7,13,7,6,346.0722862317014,0.39276904101140914,0.2657381314330005,0.2495808483801336,138829.99619118497,209.04283588436854,139039.03902706935,2220,96,698.8936170212766,41,6,16,27.414866327779354,0.6989329268292682,36.5327380952381,1053.8690476190488,25.70412311265973,0
2245,4,0,0,47,0.0,0.0,1.0,47,1350,900,450,0.6666666666666666,18,9,9,341.43423914626527,0.3923835954363244,0.25688577568529647,0.24739676434229413,138988.7798268228,91.12780228219512,139079.907629105,2221,97,699.8936170212766,40,7,17,27.38129658185557,0.7020833333333332,36.38211382113822,1054.4715447154483,26.36178861788621,0
2246,4,0,0,47,0.0,0.0,1.0,47,2000,1600,400,0.8,24,16,8,341.9619908742399,0.3922294172062905,0.25353636570416915,0.2491643053506829,139176.37613399758,118.60613308876708,139294.98226708634,2222,98,700.8936170212766,40,7,14,27.18345693280684,0.70390625,36.204268292682926,1055.182926829268,26.379573170731696,0
2247,4,0,0,47,0.0,0.0,1.0,47,750,600,150,0.8,9,6,3,341.9169974667677,0.3919017884674684,0.2564665770579946,0.24933048466958674,139203.18593429835,119.18707449269442,139322.37300879104,2223,99,701.8936170212766,40,7,14,27.158368644067806,0.7041666666666666,36.17886178861789,1055.2845528455284,26.382113821138212,0
2248,4,0,0,47,0.0,0.0,1.0,47,1050,800,250,0.7619047619047619,13,8,5,338.73174832405266,0.3918054270736972,0.2527379256911866,0.24102335329202199,138373.28273721013,-23.391437801553934,138349.89129940857,2224,100,702.8936170212766,40,7,14,28.05668244309218,0.69609375,36.966463414634156,1052.1341463414647,26.303353658536615,2
2249,4,0,0,47,0.0,0.0,1.0,47,950,600,350,0.631578947368421,13,6,7,338.60876824429096,0.391709065679926,0.24909275477870607,0.24112484088042593,138400.0150786571,-27.308273844911298,138372.7068048122,2225,101,703.8936170212766,40,7,14,28.033650441053386,0.6963541666666666,36.94105691056912,1052.2357723577252,26.30589430894313,0
2250,4,0,0,47,0.0,0.0,1.0,47,1300,1200,100,0.9230769230769231,14,12,2,337.0809171002218,0.3908610854147394,0.24576111065472728,0.24117115339491038,138560.46334853608,-58.78238812874545,138501.68096040734,2226,102,704.8936170212766,40,7,16,27.916264478764482,0.6979166666666666,36.78861788617887,1052.8455284552858,26.321138211382145,0
2251,4,0,0,47,0.0,0.0,1.0,47,1700,1400,300,0.8235294117647058,20,14,6,339.7435278924138,0.3898011100832563,0.2573058128390209,0.24442200927554866,138747.7704759899,27.731405743946738,138775.50188173386,2227,103,705.8936170212766,40,7,16,27.662293816919085,0.6997395833333333,36.61077235772358,1053.5569105691063,26.338922764227657,0
2252,4,0,0,47,0.0,0.0,1.0,47,1250,700,550,0.56,18,7,11,337.59272900658664,0.388413506012951,0.25634503360402916,0.2442298792191325,138935.87375217013,-19.158893993432002,138916.71485817668,2228,104,706.8936170212766,39,8,17,27.534437473240445,0.7032585470085471,36.432291666666664,1054.2708333333333,27.03258547008547,0
2253,4,0,0,47,0.0,0.0,1.0,47,1150,1000,150,0.8695652173913043,13,10,3,339.9942647168783,0.38812442183163737,0.2572358078969712,0.24656890658980518,139018.25086805577,53.08159722224508,139071.332465278,2229,105,707.8936170212766,39,8,17,27.390359541683136,0.704059829059829,36.35416666666668,1054.583333333335,27.040598290598336,0
2254,4,0,1,46,0.0,0.02127659574468085,0.9787234042553191,47,800,400,400,0.5,12,4,8,340.2578875171466,0.3878353376503238,0.25792487522983953,0.24696136997212273,139045.7153320314,62.280273437515774,139107.99560546892,2230,106,708.8936170212766,39,8,17,27.356481481481474,0.704326923076923,36.32812500000001,1054.6875000000011,27.04326923076926,0
2255,4,0,0,46,0.0,0.0,1.0,46,1200,900,300,0.75,15,9,6,343.8810565870714,0.3864432367149759,0.26158010655973474,0.24999881263871304,139100.65239800356,366.81586371528573,139467.46826171884,2231,107,721.9130434782609,39,7,18,27.207074322767536,0.7048611111111112,36.27604166666667,1054.895833333334,27.048611111111125,0
2256,4,0,0,46,0.0,0.0,1.0,46,1050,600,450,0.5714285714285714,15,6,9,345.9915295902807,0.38602053140096615,0.2635826636444809,0.25173866463292843,139128.125,427.430555555555,139555.55555555556,2232,108,722.9130434782609,39,7,18,27.124473407056342,0.7051282051282051,36.25,1055.0,27.05128205128205,0
2257,4,0,0,46,0.0,0.0,1.0,46,900,600,300,0.6666666666666666,12,6,6,346.13206986373604,0.3858192431561997,0.257285720417185,0.25225308400860746,139183.07834201385,435.145399305551,139618.2237413194,2233,109,723.9130434782609,39,7,13,27.066880552813423,0.7056623931623932,36.197916666666664,1055.208333333333,27.056623931623925,0
2258,4,0,0,46,0.0,0.0,1.0,46,1000,700,300,0.7,13,7,6,345.81524327061936,0.3854166666666667,0.2622619165104114,0.2526420951738419,139265.52870008687,432.0285373263994,139697.55723741328,2234,110,724.9130434782609,39,7,13,26.99441182275733,0.7064636752136753,36.11979166666667,1055.520833333334,27.064636752136767,0
2259,4,0,0,46,0.0,0.0,1.0,46,1400,1200,200,0.8571428571428571,16,12,4,346.92497670915634,0.3842793880837359,0.2600250357960441,0.2553347687796998,139513.0262586805,480.1106770833279,139993.13693576382,2235,111,725.9130434782609,39,7,14,26.72262209952014,0.7088675213675214,35.885416666666664,1056.458333333333,27.088675213675206,0
2260,4,0,0,46,0.0,0.0,1.0,46,1200,600,600,0.5,18,6,12,348.2803736451164,0.38374597423510465,0.2539660093075873,0.2571799614995161,139623.095703125,525.5967881944446,140148.69249131944,2236,112,726.9130434782609,39,7,15,26.57902950259545,0.7099358974358975,35.78125,1056.875,27.099358974358974,0
2261,4,0,0,46,0.0,0.0,1.0,46,850,700,150,0.8235294117647058,10,7,3,348.79224156418263,0.38318236714975845,0.2555612215042258,0.2580467209637712,139686.2038551786,544.2928316478095,140230.49668682643,2237,113,727.9130434782609,40,6,15,26.50371723386528,0.7088541666666668,35.721544715447145,1057.11382113821,26.427845528455247,0
2262,4,0,0,46,0.0,0.0,1.0,46,1100,700,400,0.6363636363636364,15,7,8,346.6352742750885,0.38315217391304346,0.2508931742682241,0.2570734161676616,139766.78817378866,489.619790633874,140256.40796442254,2238,114,728.9130434782609,40,6,15,26.48185968284478,0.7096354166666667,35.64532520325203,1057.418699186991,26.435467479674777,0
2263,4,0,0,46,0.0,0.0,1.0,46,1400,1200,200,0.8571428571428571,16,12,4,347.5145279365902,0.38246779388083735,0.2539351000902317,0.25835222905457333,139847.3957300547,519.8003420582851,140367.196072113,2239,115,729.9130434782609,40,6,15,26.37974795029465,0.7104166666666667,35.569105691056905,1057.7235772357712,26.443089430894283,0
2264,4,0,0,46,0.0,0.0,1.0,46,1150,800,350,0.6956521739130435,15,8,7,348.2681711684528,0.3822262479871175,0.25681827674059243,0.25933273690011394,139901.14701070788,544.6233227576126,140445.77033346548,2240,116,730.9130434782609,40,6,16,26.30723663144412,0.7109375,35.51829268292683,1057.9268292682923,26.448170731707307,0
2265,4,0,1,45,0.0,0.021739130434782608,0.9782608695652174,46,800,700,100,0.875,9,7,2,350.6107012214022,0.38121980676328504,0.25522081478945524,0.26192681797128303,140008.68055555565,617.7083333333437,140626.388888889,2241,117,731.9130434782609,40,6,17,26.140091863517057,0.7119791666666666,35.41666666666667,1058.3333333333342,26.458333333333353,0
2266,4,0,0,45,0.0,0.0,1.0,45,1000,500,500,0.5,15,5,10,358.60392770598185,0.37960858585858587,0.26384513595424064,0.2674630440741177,139954.90861920817,1037.6759865159654,140992.58460572414,2242,118,746.5555555555555,40,5,18,25.981239595338714,0.7114583333333333,35.46747967479675,1058.1300813008133,26.453252032520332,0
2267,4,0,1,44,0.0,0.022222222222222223,0.9777777777777777,45,1300,800,500,0.6153846153846154,18,8,10,357.9291888109751,0.3789351851851852,0.26275389838310637,0.2680997919293998,140095.7280725799,1028.9010445218307,141124.62911710172,2243,119,747.5555555555555,37,8,18,25.861276540652504,0.7181869369369369,35.3344298245614,1058.6622807017534,28.61249407302036,0
2268,4,0,0,44,0.0,0.0,1.0,44,700,400,300,0.5714285714285714,10,4,6,358.99344233013517,0.37766472868217055,0.2878102909748479,0.2689161236131952,140098.08108361738,1258.8584784108361,141356.93956202822,2244,123,762.8409090909091,36,8,18,25.830807006346838,0.7201967592592593,35.332207207207205,1058.671171171171,29.407532532532528,0
2269,4,0,1,43,0.0,0.022727272727272728,0.9772727272727273,44,650,500,150,0.7692307692307693,8,5,3,358.7739776295293,0.3775656272022551,0.28633656282028963,0.26899465212702034,140127.88760043832,1254.847922246575,141382.7355226849,2245,124,763.8409090909091,36,8,19,25.807452315110258,0.7204861111111112,35.304054054054056,1058.7837837837842,29.41066066066067,0
2270,4,0,0,43,0.0,0.0,1.0,43,1000,800,200,0.8,12,8,4,359.82922469554944,0.3761304909560723,0.27906976744186096,0.27071264100926845,140240.86738227145,1492.5525161588148,141733.41989843026,2246,125,758.0930232558139,37,6,19,25.668995859213258,0.7195945945945945,35.19736842105263,1059.2105263157891,28.627311522048355,0
2271,4,0,0,43,0.0,0.0,1.0,43,700,400,300,0.5714285714285714,10,4,6,363.8362586311766,0.3756921373200443,0.28099030345913123,0.27445353373560183,140327.9870368767,1611.2819569482954,141939.26899382498,2247,126,759.0930232558139,37,6,14,25.477659629514655,0.7204391891891893,35.11513157894737,1059.5394736842104,28.636201991465146,0
2272,4,0,0,43,0.0,0.0,1.0,43,900,700,200,0.7777777777777778,11,7,4,366.9960127273949,0.3756921373200443,0.2634309882659187,0.25362775667997944,137369.4445078526,1516.8866764519616,138886.33118430455,2248,127,760.0930232558139,36,7,17,28.30415010563254,0.6935763888888888,37.922297297297305,1048.310810810812,29.11974474474478,6
2273,4,0,0,43,0.0,0.0,1.0,43,1200,1200,0,1.0,12,12,0,366.74449914730417,0.3747231450719823,0.262954813455063,0.25438079291834387,137496.0700047129,1485.1854657202155,138981.25547043313,2249,128,761.0930232558139,37,6,18,28.18555061857467,0.6928490990990992,37.801535087719294,1048.7938596491222,28.345779990516814,0
2274,4,0,0,43,0.0,0.0,1.0,43,450,0,450,0.0,9,0,9,366.94832132750196,0.3748154300479882,0.2663626818075757,0.2551570885509839,137582.3330255463,1497.121229609109,139079.4542551554,2250,129,762.0930232558139,37,6,18,28.094951923076923,0.6936936936936937,37.719298245614034,1049.1228070175437,28.35467045993361,0
2275,4,0,1,42,0.0,0.023255813953488372,0.9767441860465116,43,1550,1200,350,0.7741935483870968,19,12,7,365.19887644696456,0.37495385751199706,0.2616989243239145,0.25480921606640516,137700.34334136915,1457.6021349258713,139157.94547629502,2251,130,763.0930232558139,38,5,18,28.024268797502714,0.6929824561403508,37.606837606837615,1049.572649572651,27.620332883490818,0
2276,4,0,0,42,0.0,0.0,1.0,42,1400,1000,400,0.7142857142857143,18,10,8,371.723383898119,0.3731368563685637,0.25580562354486314,0.25933937541346913,137697.39246691295,1837.0681363496533,139534.4606032626,2252,131,771.952380952381,37,5,18,27.855986209778518,0.6948198198198197,37.60964912280702,1049.5614035087724,28.36652441915601,0
2277,4,0,0,42,0.0,0.0,1.0,42,700,400,300,0.5714285714285714,10,4,6,370.52292989918993,0.3727255129694154,0.2532679025808797,0.25873402887416797,137728.37822567398,1806.3044460881138,139534.6826717621,2253,132,772.952380952381,38,4,18,27.85687022900763,0.6932565789473684,37.58012820512821,1049.679487179488,27.62314439946021,0
2278,4,0,0,42,0.0,0.0,1.0,42,1150,900,250,0.782608695652174,14,9,5,368.8544702150497,0.37248354626403407,0.24970319867032975,0.2579881052529037,137784.4565549896,1764.482545291861,139548.93910028145,2254,133,773.952380952381,38,4,18,27.845264746786064,0.6938048245614035,37.52670940170941,1049.893162393164,27.62876743139905,0
2279,4,0,0,42,0.0,0.0,1.0,42,1000,700,300,0.7,13,7,6,368.9835393757256,0.37219318621757647,0.25294765840220346,0.2589733658031484,137903.66090374227,1776.8447393322167,139680.5056430745,2255,134,774.952380952381,35,7,18,27.724173553719005,0.7008928571428572,37.41319444444444,1050.3472222222222,30.009920634920633,0
2280,4,0,0,42,0.0,0.0,1.0,42,1300,900,400,0.6923076923076923,17,9,8,372.88905276640315,0.3719996128532714,0.25514998951122303,0.26287520179494905,138055.66272290822,1895.889060356669,139951.5517832649,2256,135,775.952380952381,35,7,14,27.471549192364172,0.7023809523809523,37.268518518518526,1050.925925925927,30.026455026455057,0
2281,4,0,0,42,0.0,0.0,1.0,42,1250,1000,250,0.8,15,10,5,373.144355892777,0.3711043360433604,0.25555136189218075,0.26399091346806747,138177.32445987657,1912.0177469135813,140089.34220679014,2257,136,776.952380952381,35,7,14,27.3447820343461,0.7035714285714285,37.15277777777778,1051.3888888888891,30.03968253968255,0
2282,4,0,0,42,0.0,0.0,1.0,42,950,700,250,0.7368421052631579,12,7,5,374.94484309662806,0.3710801393728223,0.2589593618649313,0.2657370393428989,138238.17542223944,1966.3381987311489,140204.5136209706,2258,137,777.952380952381,35,7,14,27.237416538264004,0.7041666666666666,37.09490740740741,1051.620370370371,30.046296296296312,0
2283,4,0,0,42,0.0,0.0,1.0,42,1550,1300,250,0.8387096774193549,18,13,5,372.39261409525545,0.3707534843205575,0.2444377599868366,0.24722064509936653,135956.46057797672,1748.3682874253216,137704.82886540203,2259,138,778.952380952381,36,6,16,29.56439189432387,0.6796875,39.27364864864865,1042.905405405406,28.969594594594614,5
2284,4,0,0,42,0.0,0.0,1.0,42,950,700,250,0.7368421052631579,12,7,5,374.6817437395905,0.3706204026325977,0.24617227586348767,0.2489456463784855,135985.82323877935,1790.281074993917,137776.10431377328,2260,139,779.952380952381,36,6,16,29.47550025192542,0.6799768518518519,39.2454954954955,1043.0180180180182,28.97272272272273,0
2285,4,0,0,42,0.0,0.0,1.0,42,800,500,300,0.625,11,5,6,376.38659497921856,0.3698824041811846,0.25061290571274353,0.25069890743942924,136073.93024358823,1843.2806539647781,137917.210897553,2261,140,780.952380952381,36,6,16,29.34340708760568,0.6808449074074074,39.16103603603604,1043.3558558558561,28.982107107107115,0
2286,4,0,0,42,0.0,0.0,1.0,42,750,600,150,0.8,9,6,3,374.5019244843652,0.37029374758033295,0.24780454968218035,0.24985668352747395,136132.6840987948,1796.3904360441602,137929.07453483896,2262,141,781.952380952381,36,6,17,29.334151649221266,0.6814236111111112,39.10472972972973,1043.5810810810815,28.988363363363376,0
2287,4,0,0,42,0.0,0.0,1.0,42,1000,700,300,0.7,13,7,6,382.6555749081366,0.3689629307007356,0.2564870874479417,0.25657014794816724,136309.0217540176,2031.88141688987,138340.90317090746,2263,142,782.952380952381,36,6,17,28.94604407059923,0.6831597222222222,38.935810810810814,1044.2567567567573,29.00713213213215,0
2288,4,0,0,42,0.0,0.0,1.0,42,1200,800,400,0.6666666666666666,16,8,8,383.4230453900796,0.36905971738288806,0.2614889422780755,0.257726968770897,136397.23338203074,2059.5685212239327,138456.80190325467,2264,143,783.952380952381,36,6,18,28.838310334914482,0.6840277777777778,38.851351351351354,1044.594594594595,29.01651651651653,0
2289,4,0,0,42,0.0,0.0,1.0,42,1000,600,400,0.6,14,6,8,383.6852519322237,0.3687693573364305,0.2625205254515599,0.25876447223335997,136514.89327164993,2075.7502434867165,138590.64351513665,2265,144,784.952380952381,36,6,18,28.714529454022983,0.6851851851851853,38.73873873873873,1045.0450450450442,29.029029029029005,0
2290,4,1,0,43,0.023255813953488372,0.0,1.0,43,650,500,150,0.7692307692307693,8,5,3,376.03980506412717,0.37209302325581395,0.26261653052689526,0.2553234719701254,136752.0479024944,1685.3087358939285,138437.35663838833,2266,0,767.6744186046511,34,9,19,28.67891152591244,0.6917892156862745,38.511904761904766,1045.9523809523814,30.763305322128865,0
2291,4,0,0,43,0.0,0.0,1.0,43,950,700,250,0.7368421052631579,12,7,5,372.75852975779975,0.37140088593576964,0.25377721818989785,0.25444821379119353,136938.8888888888,1609.0277777777671,138547.91666666657,2267,1,768.6744186046511,34,9,21,28.579485138004245,0.6936274509803921,38.33333333333333,1046.6666666666658,30.784313725490172,0
2292,4,0,0,43,0.0,0.0,1.0,43,1000,900,100,0.9,11,9,2,375.72125611567975,0.3704549649317091,0.2613111560573318,0.2577635820008175,137114.60108292595,1703.3740301354455,138817.9751130614,2268,2,769.6744186046511,35,8,16,28.327830883707232,0.693154761904762,38.16550925925925,1047.3379629629617,29.92394179894176,0
2293,4,0,0,43,0.0,0.0,1.0,43,850,600,250,0.7058823529411765,11,6,5,374.68707047205385,0.370547249907715,0.2593520438445709,0.2575013420533453,137175.2176167052,1679.5560860339438,138854.77370273913,2269,3,770.6744186046511,35,8,16,28.294870732515736,0.69375,38.107638888888886,1047.5694444444441,29.930555555555546,0
2294,4,0,0,43,0.0,0.0,1.0,43,1350,900,450,0.6666666666666666,18,9,9,374.68707047205385,0.3708702473237357,0.2593520438445709,0.2575013420533453,137175.2176167052,1679.5560860339438,138854.77370273913,2270,4,771.6744186046511,35,8,16,28.294870732515736,0.69375,38.107638888888886,1047.5694444444441,29.930555555555546,0
2295,4,0,0,43,0.0,0.0,1.0,43,850,600,250,0.7058823529411765,11,6,5,376.147758510217,0.37091638981173863,0.2625726021696515,0.25895556333026587,137235.8475464035,1724.191288365914,138960.03883476942,2271,5,772.6744186046511,35,8,16,28.196569277219325,0.6943452380952381,38.04976851851852,1047.8009259259263,29.937169312169324,0
2296,4,0,0,43,0.0,0.0,1.0,43,1000,800,200,0.8,12,8,4,377.5710189982625,0.3705241786637135,0.26542190489643414,0.2603888482124345,137296.4908720207,1767.8351926868932,139064.3260647076,2272,6,773.6744186046511,35,8,16,28.09923154794772,0.6949404761904763,37.991898148148145,1048.032407407407,29.943783068783056,0
2297,4,0,0,43,0.0,0.0,1.0,43,900,600,300,0.6666666666666666,12,6,6,379.9896085419887,0.3702473237356958,0.27462859754015656,0.2629737099909758,137417.81771101235,1843.4685517403764,139261.28626275272,2273,7,774.6744186046511,35,8,17,27.91572377377929,0.6961309523809525,37.8761574074074,1048.495370370369,29.957010582010543,0
2298,4,0,0,43,0.0,0.0,1.0,43,1250,1000,250,0.8,15,10,5,381.4693072237206,0.3702473237356958,0.2687327095512564,0.2646917964824927,137508.8480045438,1891.0809970850378,139399.92900162883,2274,8,775.6744186046511,35,8,18,27.786820422276175,0.6970238095238095,37.78935185185185,1048.842592592592,29.966931216931197,0
2299,4,0,0,43,0.0,0.0,1.0,43,1300,1000,300,0.7692307692307693,16,10,6,380.9133163044439,0.36969361387966043,0.2640241509588821,0.2654681813168633,137660.63214002483,1887.3535826045895,139547.9857226294,2275,9,776.6744186046511,35,8,20,27.65121227160766,0.6985119047619048,37.644675925925924,1049.421296296296,29.983465608465604,0
2300,4,0,0,43,0.0,0.0,1.0,43,1300,1000,300,0.7692307692307693,16,10,6,379.5567098380933,0.3698781838316722,0.25856033972105297,0.26498843737657163,137721.36923707553,1854.6139564043083,139575.98319347983,2276,10,777.6744186046511,35,8,21,27.62673668541183,0.6991071428571429,37.58680555555555,1049.6527777777771,29.990079365079346,0
2301,4,0,0,43,0.0,0.0,1.0,43,750,600,150,0.8,9,6,3,379.11031995037763,0.3701781100036914,0.2608517304058684,0.2651433856800208,137782.11973004526,1846.9246988597204,139629.04442890498,2277,11,778.6744186046511,35,8,21,27.57838624921913,0.699702380952381,37.528935185185176,1049.8842592592578,29.996693121693077,0
2302,4,0,0,43,0.0,0.0,1.0,43,1000,800,200,0.8,12,8,4,381.06088548999537,0.3694629014396456,0.25772492085959287,0.267470182392858,137906.2659438774,1910.1401120182982,139816.4060558957,2278,12,779.6744186046511,34,9,21,27.40446371226717,0.703125,37.41071428571428,1050.3571428571418,30.89285714285711,0
2303,4,0,0,43,0.0,0.0,1.0,43,1100,800,300,0.7272727272727273,14,8,6,381.6321453506569,0.36920911775562937,0.26022794650504033,0.2683588591808402,137968.79428854864,1930.665391156445,139899.4596797051,2279,13,780.6744186046511,34,9,21,27.32766761095371,0.7037377450980393,37.35119047619047,1050.5952380952372,30.899859943977564,0
2304,4,0,0,43,0.0,0.0,1.0,43,900,700,200,0.7777777777777778,11,7,4,382.10433129830136,0.3688169066076043,0.25457582111885,0.2694262808866936,138062.6133786848,1950.8645124716495,140013.47789115645,2280,14,781.6744186046511,34,9,18,27.222568343150584,0.7046568627450981,37.26190476190476,1050.9523809523807,30.910364145658257,0
2305,4,0,0,43,0.0,0.0,1.0,43,900,500,400,0.5555555555555556,13,5,8,377.46618933485234,0.3681016980435585,0.2550107575586009,0.2668858220989656,138156.4643565759,1829.878826530605,139986.34318310648,2281,15,782.6744186046511,34,9,18,27.25177405352358,0.7055759803921569,37.172619047619044,1051.3095238095232,30.920868347338917,0
2306,4,0,0,43,0.0,0.0,1.0,43,1500,1000,500,0.6666666666666666,20,10,10,376.39372908785805,0.3672019195275009,0.25190508153354085,0.26710350172620306,138281.64859693885,1809.6690759637233,140091.31767290257,2282,16,783.6744186046511,34,9,18,27.156432748538002,0.7068014705882353,37.05357142857143,1051.785714285715,30.93487394957985,0
2307,4,0,0,43,0.0,0.0,1.0,43,1200,1000,200,0.8333333333333334,14,10,4,377.99789911214947,0.3661637135474345,0.2545115858102436,0.26922831831202987,138406.88952664402,1863.5026927437673,140270.39221938778,2283,17,784.6744186046511,34,9,18,26.99070407663007,0.7080269607843137,36.93452380952381,1052.261904761905,30.94887955182074,0
2308,4,0,1,42,0.0,0.023255813953488372,0.9767441860465116,43,1200,800,400,0.6666666666666666,16,8,8,378.39722723296177,0.36618678479143596,0.2589964387726653,0.2702575349914255,138500.85742630385,1881.6680839002258,140382.52551020408,2284,18,785.6744186046511,34,9,18,26.88753487144689,0.7089460784313726,36.845238095238095,1052.6190476190475,30.959383753501395,0
2309,4,0,0,42,0.0,0.0,1.0,42,1500,1100,400,0.7333333333333333,19,11,8,380.51043502643813,0.36451074332171896,0.2658981314044604,0.2732756760644419,138688.88888888896,2154.5138888888987,140843.40277777787,2285,19,798.952380952381,34,8,19,26.64655854430381,0.7107843137254901,36.66666666666667,1053.333333333334,30.980392156862763,0
2310,4,0,0,42,0.0,0.0,1.0,42,1150,900,250,0.782608695652174,14,9,5,378.8138590332891,0.36465592334494773,0.26608998773481374,0.2730667980588498,138814.31405895698,2116.957199546493,140931.27125850346,2286,20,799.952380952381,34,8,19,26.5676777376111,0.7120098039215685,36.54761904761905,1053.8095238095243,30.994397759103656,0
2311,4,0,0,42,0.0,0.0,1.0,42,1150,700,450,0.6086956521739131,16,7,9,377.58382154429944,0.36360336817653893,0.26106066226874614,0.2734472532639297,138971.17524092976,2094.6534863945626,141065.82872732432,2287,21,800.952380952381,34,8,19,26.44565503744684,0.7135416666666666,36.398809523809526,1054.4047619047624,31.011904761904777,0
2312,4,0,0,42,0.0,0.0,1.0,42,1550,1100,450,0.7096774193548387,20,11,9,377.8726298543114,0.3634702864885792,0.264119601328904,0.2739112729336736,139002.55810657603,2105.052437641727,141107.61054421775,2288,22,801.952380952381,34,8,19,26.407155490328893,0.7138480392156863,36.36904761904762,1054.5238095238099,31.015406162464995,0
2313,4,0,0,42,0.0,0.0,1.0,42,1200,700,500,0.5833333333333334,17,7,10,378.11020693099067,0.362538714672861,0.2632752875416533,0.27459478962365386,139065.33446712024,2116.4044784580524,141181.73894557828,2289,23,802.952380952381,34,8,19,26.33911775771256,0.7144607843137255,36.30952380952381,1054.761904761905,31.02240896358544,0
2314,4,0,0,42,0.0,0.0,1.0,42,950,800,150,0.8421052631578947,11,8,3,377.74709608342323,0.3620547812620984,0.26369967917197346,0.2745871220996896,139096.72796201828,2108.6770124716727,141205.40497448997,2290,24,803.952380952381,34,8,20,26.317806492871384,0.714767156862745,36.27976190476191,1054.8809523809534,31.025910364145687,0
2315,4,0,0,42,0.0,0.0,1.0,42,950,700,250,0.7368421052631579,12,7,5,380.1127621611914,0.36161924119241196,0.26135136442030293,0.27682328767745595,139159.52558106574,2179.2623299319735,141338.78791099772,2291,25,804.952380952381,34,8,19,26.193632705254053,0.7153799019607843,36.220238095238095,1055.1190476190475,31.032913165266102,0
2316,4,0,0,42,0.0,0.0,1.0,42,950,500,450,0.5263157894736842,14,5,9,377.56063570102936,0.3610627177700348,0.2600412444215312,0.2759958909118735,139285.16333616772,2117.718962585032,141402.88229875275,2292,26,805.952380952381,34,8,19,26.13741024773505,0.7166053921568627,36.101190476190474,1055.5952380952376,31.046918767506988,0
2317,4,0,0,42,0.0,0.0,1.0,42,1250,1000,250,0.8,15,10,5,379.6957795103755,0.3616918312040263,0.26535596204216594,0.27886266190530223,139442.29024943305,2189.1298185940977,141631.42006802716,2293,27,806.952380952381,34,8,20,25.92660429816652,0.7181372549019608,35.95238095238095,1056.1904761904757,31.06442577030811,0
2318,4,0,0,42,0.0,0.0,1.0,42,550,300,250,0.5454545454545454,8,3,5,379.84581480871174,0.3613167828106853,0.2680335742997748,0.27923545275871575,139473.72626133784,2195.702239229018,141669.42850056686,2294,28,807.952380952381,34,8,20,25.89175025357825,0.7184436274509804,35.922619047619044,1056.3095238095236,31.06792717086834,0
2319,4,0,0,42,0.0,0.0,1.0,42,1150,800,350,0.6956521739130435,15,8,7,381.70116694369847,0.3598891792489354,0.2707119793175212,0.28192537105874826,139630.9594671201,2259.4600340135944,141890.41950113367,2295,29,808.952380952381,34,8,20,25.688264999624536,0.7199754901960784,35.77380952380952,1056.9047619047612,31.085434173669448,0
2320,4,0,0,42,0.0,0.0,1.0,42,600,300,300,0.5,9,3,6,383.12383329275247,0.35996176926054974,0.2678035178035183,0.2835116366366366,139693.87755102027,2304.0107709750437,141997.8883219953,2296,30,809.952380952381,34,8,20,25.588870120120127,0.7205882352941178,35.71428571428571,1057.1428571428562,31.092436974789887,0
2321,4,0,0,42,0.0,0.0,1.0,42,1000,600,400,0.6,14,6,8,384.1981138174251,0.35973190089043744,0.2695875017424221,0.28484537954310246,139756.8098072561,2338.8605442176727,142095.67035147376,2297,31,810.952380952381,34,8,20,25.49866771748105,0.721200980392157,35.6547619047619,1057.3809523809514,31.099439775910334,0
2322,4,0,0,42,0.0,0.0,1.0,42,1300,1100,200,0.8461538461538461,15,11,4,384.2554557642668,0.35892131242741,0.26982250741116043,0.2851579961197976,139788.28124999977,2342.8819444444143,142131.16319444418,2298,32,811.952380952381,34,8,20,25.4662463882322,0.7215073529411766,35.624999999999986,1057.4999999999982,31.102941176470534,0
2323,4,0,0,42,0.0,0.0,1.0,42,1250,1000,250,0.8,15,10,5,384.2554557642668,0.35892131242741,0.26982250741116043,0.2851579961197976,139788.28124999977,2342.8819444444143,142131.16319444418,2299,33,812.952380952381,34,8,20,25.4662463882322,0.7215073529411766,35.624999999999986,1057.4999999999982,31.102941176470534,0
2324,4,0,0,42,0.0,0.0,1.0,42,1350,1000,350,0.7407407407407407,17,10,7,385.92395668362656,0.3594294425087108,0.268839158440779,0.2872127536926888,139882.71683673456,2396.81831065758,142279.53514739213,2300,34,813.952380952381,34,8,20,25.32940393127766,0.7224264705882353,35.53571428571428,1057.8571428571418,31.113445378151226,0
2325,4,0,0,42,0.0,0.0,1.0,42,950,800,150,0.8421052631578947,11,8,3,384.7035144343668,0.3589576074332172,0.2653233454966326,0.28657670853128375,139914.2024518139,2365.097080498848,142279.29953231275,2301,35,814.952380952381,34,8,20,25.330773414350546,0.722732843137255,35.50595238095237,1057.9761904761892,31.116946778711448,0
2326,4,0,0,42,0.0,0.0,1.0,42,1300,1100,200,0.8461538461538461,15,11,4,388.34526003049814,0.3586672473867596,0.26585234070472064,0.29040155938384477,140041.1068609426,2476.8918995293834,142517.99876047196,2302,36,815.952380952381,33,9,20,25.109871290185644,0.7263257575757577,35.38602941176469,1058.4558823529387,32.07442067736178,0
2327,4,0,1,41,0.0,0.023809523809523808,0.9761904761904762,42,1450,1000,450,0.6896551724137931,19,10,9,387.8363906168749,0.3584736740224545,0.2628748918250019,0.2905913771499724,140105.97073541422,2467.638798779306,142573.60953419353,2303,37,816.952380952381,33,9,20,25.05968572751476,0.7269570707070707,35.32475490196078,1058.7009803921565,32.081847890671405,0
2328,4,0,1,40,0.0,0.024390243902439025,0.975609756097561,41,950,600,350,0.631578947368421,13,6,7,387.9263059194001,0.3577997967479675,0.2642349142632754,0.2906847252130622,140108.91945018352,2670.387109733682,142779.3065599172,2304,38,832.0243902439024,32,9,20,25.054412641621944,0.7294921875,35.32196969696969,1058.71212121212,33.08475378787875,0
2329,4,0,0,40,0.0,0.0,1.0,40,1050,800,250,0.7619047619047619,13,8,5,386.09724499131215,0.35670405982905984,0.25143061516452114,0.29019567123540535,140209.1942148759,2826.8767217630684,143036.07093663898,2305,39,826.5,32,8,20,25.00447067238912,0.73046875,35.22727272727272,1059.090909090908,33.09659090909088,0
2330,4,0,0,40,0.0,0.0,1.0,40,950,600,350,0.631578947368421,13,6,7,387.51251916053087,0.35551549145299144,0.25472586412395715,0.2918518883085147,140276.06398581775,2871.7461866136055,143147.81017243135,2306,40,827.5,32,8,20,24.901420341676605,0.7311197916666667,35.16414141414141,1059.343434343434,33.10448232323231,0
2331,4,0,0,40,0.0,0.0,1.0,40,950,700,250,0.7368421052631579,12,7,5,385.7951555841918,0.35460737179487184,0.2536939942802672,0.2911504447538252,140342.9496990102,2828.726022854801,143171.675721865,2307,41,828.5,32,8,20,24.8813353987925,0.7317708333333334,35.1010101010101,1059.595959595959,33.112373737373716,0
2332,4,0,0,40,0.0,0.0,1.0,40,800,400,400,0.5,12,4,8,383.9950254994684,0.3547676282051282,0.25376802096985607,0.29008733114464785,140376.39853395056,2780.767746913577,143157.16628086413,2308,42,829.5,32,8,20,24.896242900830064,0.7320963541666667,35.06944444444444,1059.722222222222,33.116319444444436,0
2333,4,0,0,40,0.0,0.0,1.0,40,700,400,300,0.5714285714285714,10,4,6,383.11343597310633,0.3545673076923077,0.25226947819871315,0.2897165929331762,140409.85135445365,2758.5801193755756,143168.43147382923,2309,43,830.5,32,8,20,24.886823921848944,0.732421875,35.03787878787879,1059.8484848484852,33.12026515151516,0
2334,4,0,0,40,0.0,0.0,1.0,40,700,400,300,0.5714285714285714,10,4,6,381.64632429769154,0.3540331196581197,0.24988727020464774,0.2887890690158121,140430.51538170403,2718.958002931545,143149.47338463558,2310,44,831.5,33,7,20,24.90545631479554,0.7301136363636365,35.01838235294117,1059.9264705882342,32.11898395721922,0
2335,4,0,0,40,0.0,0.0,1.0,40,700,300,400,0.42857142857142855,11,3,8,381.844013722057,0.3540064102564102,0.2475118483412324,0.28951205632861643,140495.4693657487,2729.4707864763477,143224.94015222503,2311,45,832.5,33,7,20,24.836603668169385,0.7307449494949496,34.95710784313725,1060.1715686274504,32.1264111705288,0
2336,4,0,0,40,0.0,0.0,1.0,40,750,500,250,0.6666666666666666,10,5,5,381.3110376271036,0.35380608974358974,0.24927184466019447,0.28939500855699124,140527.9519896194,2716.9718377547156,143244.92382737412,2312,46,833.5,33,7,20,24.818924333487452,0.7310606060606061,34.9264705882353,1060.294117647059,32.1301247771836,0
2337,4,0,0,40,0.0,0.0,1.0,40,900,800,100,0.8888888888888888,10,8,2,379.65745782968077,0.35312499999999997,0.24610340843443113,0.2890004659204826,140625.42238862457,2677.8980740580573,143303.32046268263,2313,47,834.5,33,7,20,24.767355093394958,0.7320075757575758,34.83455882352941,1060.6617647058824,32.14126559714795,0
2338,4,0,0,40,0.0,0.0,1.0,40,600,200,400,0.3333333333333333,10,2,8,381.3147333590854,0.3527510683760684,0.24745322245322243,0.29113077261225384,140722.9265787196,2731.9450451749162,143454.87162389452,2314,48,835.5,33,7,21,24.62799337799338,0.7329545454545455,34.74264705882352,1061.029411764705,32.152406417112275,0
2339,4,0,0,40,0.0,0.0,1.0,40,700,500,200,0.7142857142857143,9,5,4,388.7100279751741,0.3527510683760684,0.26045659526493736,0.2849469378627931,139379.4288548754,2836.1769953079365,142215.60585018335,2315,49,836.5,34,6,20,25.75042277339345,0.7175245098039216,36.011904761904766,1055.9523809523819,31.0574229691877,3
2340,4,0,0,40,0.0,0.0,1.0,40,1400,1100,300,0.7857142857142857,17,11,6,388.55912455065317,0.3516426282051282,0.26327341372703694,0.285640854361056,139473.72626133793,2838.7577947845884,142312.4840561225,2316,50,837.5,34,6,20,25.661651451970386,0.7184436274509804,35.92261904761905,1056.3095238095243,31.067927170868362,0
2341,4,0,0,40,0.0,0.0,1.0,40,1650,1200,450,0.7272727272727273,21,12,9,389.9920012567331,0.3510416666666667,0.26551481356314066,0.28777714007946975,139599.50573979598,2888.5381235827713,142488.04386337876,2317,51,838.5,34,6,21,25.50012203822613,0.7196691176470589,35.80357142857143,1056.7857142857147,31.081932773109255,0
2342,4,0,0,40,0.0,0.0,1.0,40,1300,900,400,0.6923076923076923,17,9,8,389.2232859588628,0.350801282051282,0.26128841607565056,0.2888446490536823,139788.28124999997,2881.770833333333,142670.0520833333,2318,52,839.5,34,6,22,25.33490937746258,0.7215073529411765,35.625,1057.4999999999998,31.10294117647058,0
2343,4,0,0,40,0.0,0.0,1.0,40,850,700,150,0.8235294117647058,10,7,3,388.02867353721774,0.3504807692307692,0.2609128770823961,0.2882313324167757,139819.75623582752,2850.8149092970366,142670.57114512456,2319,53,840.5,34,6,22,25.335575191355254,0.7218137254901962,35.59523809523809,1057.6190476190463,31.106442577030776,0
2344,4,0,0,40,0.0,0.0,1.0,40,1050,700,350,0.6666666666666666,14,7,7,390.2872935383432,0.3496661324786325,0.26549735568808397,0.29073622612533573,139914.20245181394,2921.347080498848,142835.54953231278,2320,54,841.5,34,6,22,25.183085780728398,0.722732843137255,35.50595238095237,1057.9761904761895,31.116946778711455,0
2345,4,0,0,40,0.0,0.0,1.0,40,850,600,250,0.7058823529411765,11,6,5,389.3671601633613,0.34929220085470086,0.2663028802880292,0.2903267885513382,139945.69160997716,2898.051303854856,142843.74291383201,2321,55,842.5,34,6,22,25.176502025202502,0.7230392156862746,35.47619047619047,1058.095238095237,31.120448179271676,0
2346,4,0,0,40,0.0,0.0,1.0,40,1100,1000,100,0.9090909090909091,12,10,2,392.88276727225,0.3488514957264957,0.2703667262969587,0.29439874920266457,140108.91945018366,3009.3043432937884,143118.22379347746,2322,56,843.5,32,8,22,24.92322599880739,0.7294921875,35.321969696969695,1058.7121212121212,33.08475378787879,0
2347,4,0,0,40,0.0,0.0,1.0,40,950,800,150,0.8421052631578947,11,8,3,393.31363772846805,0.3487980769230769,0.27380753637014044,0.2950204084070607,140142.34038618527,3023.9787394143646,143166.31912559964,2323,57,844.5,32,8,22,24.87901462755385,0.7298177083333333,35.29040404040405,1058.8383838383852,33.08869949494954,0
2348,4,0,0,40,0.0,0.0,1.0,40,1100,1000,100,0.9090909090909091,12,10,2,393.52661988002467,0.34770299145299144,0.2741952789699569,0.29577968526466375,140209.19421487604,3035.2100550964174,143244.40426997247,2324,58,845.5,32,8,22,24.807761087267522,0.73046875,35.22727272727273,1059.0909090909092,33.096590909090914,0
2349,4,0,0,40,0.0,0.0,1.0,40,750,500,250,0.6666666666666666,10,5,5,393.727512978832,0.3479700854700855,0.24509531374106475,0.2738690269836184,137593.83680555547,2849.243859044986,140443.08066460045,2325,59,846.5,34,6,19,27.381188774159387,0.7000612745098039,37.70833333333333,1049.166666666666,30.857843137254886,6
2350,4,0,0,40,0.0,0.0,1.0,40,850,700,150,0.8235294117647058,10,7,3,393.727512978832,0.34763621794871796,0.24509531374106475,0.2738690269836184,137593.83680555547,2834.895833333324,140428.7326388888,2326,60,847.5,34,6,19,27.381188774159387,0.7000612745098039,37.70833333333333,1049.166666666666,30.857843137254886,0
2351,4,0,0,40,0.0,0.0,1.0,40,950,600,350,0.631578947368421,13,6,7,396.73319175496806,0.3476629273504273,0.242632713248639,0.27670884640124976,137687.5283446711,2925.0425170067906,140612.5708616779,2327,61,848.5,34,6,19,27.20952434966727,0.7009803921568627,37.61904761904761,1049.5238095238087,30.86834733893555,0
2352,4,0,0,40,0.0,0.0,1.0,40,950,700,250,0.7368421052631579,12,7,5,360.11939623876805,0.3476629273504273,0.18613869400971428,0.23986385378520395,136073.9302435882,1800.572320631445,137874.50256421964,2328,62,849.5,36,4,16,29.767719014211192,0.6808449074074074,39.16103603603604,1043.355855855856,28.982107107107108,3
2353,4,0,0,40,0.0,0.0,1.0,40,900,600,300,0.6666666666666666,12,6,6,361.4341018487697,0.3467280982905983,0.1880826499784205,0.2413379867387895,136162.06578199822,1842.7227903579283,138004.78857235613,2329,63,850.5,36,4,16,29.64591425694145,0.681712962962963,39.07657657657658,1043.6936936936938,28.991491491491495,0
2354,4,0,0,40,0.0,0.0,1.0,40,750,500,250,0.6666666666666666,10,5,5,366.9005313268241,0.3466346153846154,0.19861231101511856,0.2433738481437245,135927.1010875742,1974.3451221491891,137901.4462097234,2330,64,851.5,36,4,17,29.736771058315338,0.6793981481481481,39.30180180180181,1042.7927927927938,28.966466466466493,2
2355,4,0,0,40,0.0,0.0,1.0,40,1100,700,400,0.6363636363636364,15,7,8,363.30904305062086,0.3460870726495726,0.19492444684295762,0.24198837410956187,136073.93024358834,1887.3778761870162,137961.30811977535,2331,65,852.5,36,4,17,29.684520597229714,0.6808449074074074,39.161036036036045,1043.355855855857,28.98210710710714,0
2356,4,0,0,40,0.0,0.0,1.0,40,900,600,300,0.6666666666666666,12,6,6,364.93491466461575,0.345446047008547,0.19644783687560685,0.2438775576082427,136191.45063560194,1940.2030831507313,138131.65371875267,2332,66,853.5,36,4,17,29.525389290466432,0.6820023148148149,39.04842342342343,1043.806306306307,28.99461961961964,0
2357,4,0,1,39,0.0,0.025,0.975,40,750,600,150,0.8,9,6,3,363.9416586395565,0.34477831196581193,0.20000269658073555,0.24361755359186507,136250.22985400958,1917.426928617825,138167.6567826274,2333,67,854.5,36,4,17,29.49295293567756,0.6825810185185185,38.992117117117125,1044.031531531533,29.000875875875913,0
2358,4,0,0,39,0.0,0.0,1.0,39,900,700,200,0.7777777777777778,11,7,4,382.118710659186,0.34379217273954116,0.1813139076388426,0.24299372152968096,134404.7763980195,2471.7159727294684,136876.49237074895,2334,68,856.5641025641025,36,3,18,30.85994063133505,0.6643518518518519,40.76576576576576,1036.9369369369358,28.803803803803774,8
2359,4,0,1,38,0.0,0.02564102564102564,0.9743589743589743,39,1250,1000,250,0.8,15,10,5,379.4824767170701,0.3428924876293297,0.1818450069454307,0.2418970998644242,134492.36979800728,2407.499518099162,136899.86931610643,2335,69,857.5641025641025,36,3,19,30.8406162921145,0.6652199074074074,40.6813063063063,1037.2747747747733,28.813188188188146,0
2360,4,0,0,38,0.0,0.0,1.0,38,1000,900,100,0.9,11,9,2,378.05904878849856,0.34016417733522997,0.17810425782276407,0.24156976945473138,134579.9917315964,2575.8367320022676,137155.82846359868,2336,70,864.3421052631579,36,2,19,30.789875913465018,0.666087962962963,40.596846846846844,1037.6126126126123,28.822572572572565,0
2361,4,0,0,38,0.0,0.0,1.0,38,1000,600,400,0.6,14,6,8,377.7668517814712,0.3404753437648174,0.17843298451139256,0.2423543915499916,134726.09169558057,2579.0103025322474,137305.10199811283,2337,71,865.3421052631579,36,2,19,30.651372166178533,0.6675347222222223,40.456081081081074,1038.1756756756747,28.838213213213187,0
2362,4,0,0,38,0.0,0.0,1.0,38,600,400,200,0.6666666666666666,8,4,4,376.6858749932861,0.34077169274537694,0.17805752315937884,0.24205020580579006,134784.55387397515,2554.2875223195924,137338.84139629474,2338,72,866.3421052631579,36,2,17,30.621000976032963,0.668113425925926,40.39977477477476,1038.4009009008994,28.844469469469427,0
2363,4,0,0,38,0.0,0.0,1.0,38,900,700,200,0.7777777777777778,11,7,4,375.11779380687847,0.3387565196775723,0.1815521352698899,0.2420165570393188,134930.76480196405,2522.986161837507,137453.75096380155,2339,73,867.3421052631579,36,2,17,30.515662258833732,0.6695601851851853,40.259009009009006,1038.9639639639634,28.860110110110092,0
2364,4,0,0,38,0.0,0.0,1.0,38,1250,900,350,0.72,16,9,7,373.39378897662914,0.33770448079658605,0.17821944353446173,0.2415972509016698,135034.699679228,2484.223631309611,137518.92331053762,2340,74,868.3421052631579,37,1,17,30.456689348384135,0.6686373873873874,40.158991228070164,1039.3640350877174,28.090919867235606,0
2365,4,0,0,38,0.0,0.0,1.0,38,1100,800,300,0.7272727272727273,14,8,6,358.66574953898345,0.33813418681839735,0.09607938187600862,0.21796595004406605,132725.77649444863,2119.898670373753,134845.67516482237,2341,75,869.3421052631579,35,3,17,33.15045958291211,0.649702380952381,42.39004629629629,1030.439814814814,29.441137566137545,8
2366,4,0,0,38,0.0,0.0,1.0,38,500,300,200,0.6,7,3,4,362.2938617467241,0.33792674253200566,0.101394840273058,0.2205213150276538,132785.4151261358,2021.4681659379096,134806.8832920737,2342,76,870.3421052631579,35,3,17,32.99702882275875,0.6502976190476191,42.33217592592592,1030.671296296295,29.447751322751284,0
2367,4,0,0,38,0.0,0.0,1.0,38,1150,800,350,0.6956521739130435,15,8,7,361.88144066931943,0.33868243243243246,0.10467836257309937,0.22114976929791746,132934.5703125,2021.3107638888885,134955.88107638888,2343,77,871.3421052631579,35,3,17,32.857744107744104,0.6517857142857143,42.1875,1031.25,29.464285714285715,0
2368,4,1,0,39,0.02564102564102564,0.0,1.0,39,1000,700,300,0.7,13,7,6,354.1688014517022,0.34635065227170486,0.10560824259454438,0.21841569111137404,133274.01369892666,1640.2995392813268,134914.31323820798,2344,0,849.974358974359,37,2,18,32.715987929630806,0.6511824324324323,41.85855263157895,1032.5657894736848,27.90718349928878,0
2369,4,0,0,39,0.0,0.0,1.0,39,1350,1000,350,0.7407407407407407,17,10,7,352.5370817555758,0.3462944219523167,0.1065900724568496,0.21792381754558243,133361.84619037196,1602.999214697945,134964.8454050699,2345,1,850.974358974359,38,1,18,32.67006274996553,0.650219298245614,41.77350427350428,1032.9059829059838,27.18173639226273,0
2370,4,0,0,39,0.0,0.0,1.0,39,550,500,50,0.9090909090909091,6,5,1,352.5370817555758,0.3462944219523167,0.1065900724568496,0.21792381754558243,133361.84619037196,1602.999214697945,134964.8454050699,2346,2,851.974358974359,38,1,18,32.67006274996553,0.650219298245614,41.77350427350428,1032.9059829059838,27.18173639226273,0
2371,4,0,0,39,0.0,0.0,1.0,39,1350,1000,350,0.7407407407407407,17,10,7,355.21961887831685,0.3467723796671165,0.11040135316304611,0.22108024992763367,133613.88991083796,1692.50066729239,135306.39057813035,2347,3,852.974358974359,37,2,19,32.34822975218299,0.6545608108108107,41.5296052631579,1033.8815789473686,27.942745376955905,0
2372,4,0,0,39,0.0,0.0,1.0,39,1300,900,400,0.6923076923076923,17,9,8,350.3862911807124,0.34781264057579847,0.10157902959720588,0.21903101726938934,133775.99172921694,1574.654718204404,135350.64644742134,2348,4,853.974358974359,38,1,16,32.31092292333642,0.6543311403508771,41.37286324786325,1034.5085470085476,27.223909131803882,0
2373,4,0,0,39,0.0,0.0,1.0,39,600,400,200,0.6666666666666666,8,4,4,350.77699202738626,0.3475596041385515,0.10256410256410287,0.21960408324403602,133831.2596450618,1588.985339506185,135420.24498456798,2349,5,854.974358974359,38,1,16,32.24552572706936,0.6548793859649122,41.31944444444445,1034.7222222222229,27.229532163742707,0
2374,4,0,0,39,0.0,0.0,1.0,39,1300,900,400,0.6923076923076923,17,9,8,333.2510008160384,0.3475596041385515,0.03602422476699174,0.18341347786661524,128902.86138733661,791.4015130762009,129694.26290041281,2350,6,855.974358974359,38,1,15,37.666798176398395,0.6055372807017543,46.12713675213676,1015.4914529914535,26.723459289248776,7
2375,4,1,0,40,0.025,0.0,1.0,40,1150,900,250,0.782608695652174,14,9,5,327.5329212577264,0.3530715811965812,0.046311475409836156,0.18163189269746632,129201.38888888882,463.88694846225917,129665.27583735107,2351,0,835.55,38,2,17,37.50853825136611,0.6085526315789473,45.83333333333333,1016.6666666666661,26.754385964912263,0
2376,4,1,2,39,0.024390243902439025,0.04878048780487805,0.9512195121951219,41,1400,1100,300,0.7857142857142857,17,11,6,322.7682104234724,0.3567581300813008,0.057155127677468665,0.18211303936430218,129881.14458917745,192.98147691577014,130074.12606609322,2352,0,816.1463414634146,38,3,12,36.94035391119031,0.6154057017543859,45.16559829059829,1019.3376068376069,26.824673864147552,1
2377,4,1,0,40,0.025,0.0,1.0,40,550,300,250,0.5454545454545454,8,3,5,329.3947114300613,0.3539663461538462,0.06551000645577809,0.18553905745642352,129815.23762119105,552.0905470914048,130367.32816828245,2353,0,837.5,37,3,13,36.83828276307296,0.6165540540540541,45.23026315789473,1019.0789473684204,27.542674253200552,0
2378,4,0,0,40,0.0,0.0,1.0,40,700,400,300,0.5714285714285714,10,4,6,330.89574921273487,0.35426014957264956,0.06838425129087766,0.18665090319669797,129871.11418898118,594.7599261311133,130465.8741151123,2354,1,838.5,37,3,14,36.74340218014917,0.617117117117117,45.175438596491226,1019.2982456140348,27.54860123281175,0
2379,4,1,1,40,0.024390243902439025,0.024390243902439025,0.975609756097561,41,1100,800,300,0.7272727272727273,14,8,6,321.67117509527134,0.35848577235772355,0.07705917946858776,0.18302112779542123,130208.06081753573,176.83598601064017,130384.89680354638,2355,0,819.0243902439024,38,3,15,36.637487351268355,0.6186951754385965,44.84508547008546,1020.6196581196562,26.858412055780423,0
2380,4,0,0,40,0.0,0.0,1.0,40,950,700,250,0.7368421052631579,12,7,5,308.02422355175236,0.35144230769230766,0.01127248294397365,0.16142071173562594,126934.51063368062,-180.21918402776816,126754.29144965285,2356,1,840.225,39,1,15,40.31295224312591,0.5838675213675213,48.07291666666667,1007.7083333333339,25.83867521367523,5
2381,4,1,1,40,0.024390243902439025,0.024390243902439025,0.975609756097561,41,800,500,300,0.625,11,5,6,306.67853289729567,0.35823170731707316,0.03793980224968885,0.1564377024681427,125829.362592684,-401.676685545866,125427.68590713813,2357,0,820.7073170731708,38,3,17,41.479652504170666,0.5742872807017543,49.17200854700855,1003.3119658119666,26.402946468735962,8
2382,4,3,2,41,0.06976744186046512,0.046511627906976744,0.9534883720930233,43,700,300,400,0.42857142857142855,11,3,8,293.3599575782379,0.37396179401993357,0.05685120228702556,0.15145703029039315,126324.62902372942,-1188.282437702411,125136.34658602701,2358,0,783.3720930232558,40,3,13,41.306105944197334,0.5760416666666666,48.678861788617894,1005.2845528455297,25.13211382113824,0
2383,4,6,5,42,0.1276595744680851,0.10638297872340426,0.8936170212765957,47,1800,1500,300,0.8333333333333334,21,15,6,266.62574740538435,0.3970282146160962,0.07097406731794642,0.14059152430949975,127185.39523319644,-2617.8197873799395,124567.5754458165,2359,0,717.5106382978723,44,3,16,41.100414601309595,0.5790719696969696,47.82407407407409,1008.703703703706,22.925084175084226,0
2384,4,0,0,42,0.0,0.0,1.0,42,650,500,150,0.7692307692307693,8,5,3,295.3957160125278,0.3709712543554007,0.06401721918963332,0.1531205812953828,126488.78173828125,-927.1511501736118,125561.63058810764,2360,1,803.9285714285714,39,3,16,41.08688429809118,0.5793269230769231,48.515625,1005.9375,25.79326923076923,0
2385,4,3,2,43,0.06666666666666667,0.044444444444444446,0.9555555555555556,45,1050,800,250,0.7619047619047619,13,8,5,279.3525032443142,0.38396464646464645,0.07511478420569406,0.14696370822853036,127092.01388888879,-1899.3055555555602,125192.70833333323,2361,0,751.2666666666667,42,3,17,40.87465564738293,0.5808531746031746,47.916666666666664,1008.3333333333325,24.00793650793649,0
2386,4,1,0,44,0.022727272727272728,0.0,1.0,44,1050,600,450,0.5714285714285714,15,6,9,287.89017143637767,0.3792503523608175,0.07644628099173634,0.1514552641034855,127092.01388888879,-1482.291666666671,125609.72222222212,2362,0,769.3181818181819,41,3,19,40.65943526170801,0.5823170731707317,47.916666666666664,1008.3333333333325,24.59349593495933,0
2387,4,5,5,44,0.10204081632653061,0.10204081632653061,0.8979591836734694,49,800,400,400,0.5,12,4,8,259.73683133919553,0.4001204648526077,0.08360694435502869,0.13955351785512712,127942.64938886376,-3153.716330918969,124788.9330579448,2363,0,691.7142857142857,46,3,10,40.50506046267088,0.5842391304347827,47.07446808510638,1011.7021276595747,21.99352451433858,0
2388,4,4,2,46,0.08333333333333333,0.041666666666666664,0.9583333333333334,48,900,600,300,0.6666666666666666,12,6,6,266.6607399330504,0.39891770094562645,0.11158583870198058,0.14383206706041332,128098.6793740807,-2768.222274732232,125330.45709934847,2364,0,707.0208333333334,45,3,15,40.171647578143634,0.5870370370370372,46.92028985507245,1012.3188405797072,22.495974235104605,0
2389,4,2,2,46,0.041666666666666664,0.041666666666666664,0.9583333333333334,48,550,300,250,0.5454545454545454,8,3,5,268.0824400074522,0.39315528959810875,0.11702674897119492,0.1447645176040235,128144.53124999943,-2729.332073093934,125415.1991769055,2365,0,707.8541666666666,44,4,16,40.08916323731141,0.5887784090909093,46.87499999999998,1012.4999999999955,23.011363636363534,0
2390,4,0,1,45,0.0,0.021739130434782608,0.9782608695652174,46,1250,900,350,0.72,16,9,7,281.18338026427836,0.3851247987117552,0.11186984194162863,0.15111485084223023,127952.84162649162,-2004.3574954086803,125948.48413108294,2366,1,739.5,43,3,18,39.95226506926249,0.5881782945736436,47.064393939393916,1011.7424242424196,23.528893587033014,0
2391,4,1,1,45,0.021739130434782608,0.021739130434782608,0.9782608695652174,46,850,500,350,0.5882352941176471,12,5,7,280.1390281608752,0.38261876006441226,0.11092509794508532,0.1508234656904417,128024.7084212147,-2027.0565204603167,125997.65190075438,2367,0,740.304347826087,43,3,18,39.90566810143162,0.5889050387596901,46.9933712121212,1012.0265151515127,23.53550035236076,0
2392,4,4,3,46,0.08163265306122448,0.061224489795918366,0.9387755102040817,49,1300,1000,300,0.7692307692307693,16,10,6,275.49643267893816,0.3969316893424036,0.1465015850827487,0.1508771372460823,128706.14924425297,-2708.383003873077,125997.76624037989,2368,0,695.8979591836735,46,3,8,39.33215388199662,0.5919384057971016,46.32092198581559,1014.7163120567349,22.059050262102932,0
2393,4,2,2,46,0.041666666666666664,0.041666666666666664,0.9583333333333334,48,1450,900,550,0.6206896551724138,20,9,11,279.6505102040819,0.39205636820330975,0.1421800595238094,0.15293387276785697,128649.4433942446,-2404.6235034656884,126244.81989077892,2369,0,711.3541666666666,45,3,9,39.28422619047618,0.5925925925925928,46.376811594202884,1014.492753623186,22.54428341384858,0
2394,4,0,0,46,0.0,0.0,1.0,46,650,400,250,0.6153846153846154,9,4,5,289.6182540093313,0.3850442834138486,0.13336163367442722,0.15742936377155245,128408.3387586803,-1762.1202256944694,126646.21853298583,2370,2,743.2826086956521,43,3,9,39.27607913669065,0.5927810077519382,46.61458333333332,1013.5416666666646,23.57073643410848,0
2395,4,1,1,46,0.02127659574468085,0.02127659574468085,0.9787234042553191,47,1100,1000,100,0.9090909090909091,12,10,2,286.9981037073874,0.3889531298180697,0.14022681580724572,0.1576476557639174,128825.12002743462,-2005.48696844995,126819.63305898468,2371,0,728.4468085106383,44,3,10,38.9197981272042,0.5956439393939397,46.203703703703695,1015.1851851851834,23.072390572390532,0
2396,4,0,2,44,0.0,0.043478260869565216,0.9565217391304348,46,950,400,550,0.42105263157894735,15,4,11,291.4998524780429,0.38680555555555557,0.13345923380569658,0.1597955968801628,128744.48609855642,-1694.2002589818824,127050.28583957453,2372,1,745.1521739130435,43,3,11,38.88730132810798,0.5961724806201552,46.28314393939393,1014.8674242424229,23.60156800563774,0
2397,4,0,0,44,0.0,0.0,1.0,44,700,600,100,0.8571428571428571,8,6,2,304.77231005176026,0.37604607117688515,0.13404888331510056,0.16613748165541517,128521.48216057222,-966.0421981292818,127555.43996244295,2373,2,779.6590909090909,41,3,11,38.77708883670874,0.596798780487805,46.502976190476176,1013.9880952380926,24.73141695702665,0
2398,4,1,2,43,0.022222222222222223,0.044444444444444446,0.9555555555555556,45,1600,1300,300,0.8125,19,13,6,300.15187824807504,0.3822180134680135,0.12817494405735386,0.1649025290196683,128832.22467287084,-1266.153157111987,127566.07151575886,2374,0,763.3111111111111,42,3,12,38.57875186917375,0.5984623015873017,46.19670542635657,1015.2131782945706,24.17174234034692,0
2399,4,0,0,43,0.0,0.0,1.0,43,800,600,200,0.75,10,6,4,313.1047678094642,0.372485234403839,0.12985602878026414,0.17105083128113088,128607.98306439612,-546.4454648357531,128061.53759956037,2375,4,799.5581395348837,40,3,12,38.47789967605116,0.5992187500000001,46.417682926829265,1014.3292682926823,25.358231707317056,0
2400,4,3,1,45,0.06521739130434782,0.021739130434782608,0.9782608695652174,46,900,500,400,0.5555555555555556,13,5,8,303.000056930486,0.38881843800322063,0.15176385799669423,0.16855281386323867,129324.56099580861,-1361.5642733622963,127962.99672244632,2376,0,748.3478260869565,42,4,15,38.00728779651328,0.6034226190476191,45.71220930232558,1017.1511627906982,24.21788482834996,0
2401,4,0,0,45,0.0,0.0,1.0,45,750,600,150,0.8,9,6,3,307.5200526486674,0.3825547138047138,0.1444541995902835,0.17086114144723538,129277.04480229605,-1048.943275226747,128228.1015270693,2377,1,765.9777777777778,41,4,15,37.940505804311776,0.604420731707317,45.75892857142858,1016.9642857142868,24.80400696864114,0
2402,4,1,1,45,0.021739130434782608,0.021739130434782608,0.9782608695652174,46,950,800,150,0.8421052631578947,11,8,3,302.2554665334165,0.3858192431561997,0.1465730288240623,0.1687713538011948,129472.44498715524,-1373.249147437056,128099.19583971817,2378,0,750.304347826087,42,4,11,37.87647973594845,0.6049107142857143,45.56686046511628,1017.7325581395351,24.231727574750835,0
2403,4,1,1,45,0.021739130434782608,0.021739130434782608,0.9782608695652174,46,1150,700,450,0.6086956521739131,16,7,9,303.6188036323392,0.3879730273752013,0.14914044976369611,0.16985192497131818,129546.41867225527,-1333.4542695751447,128212.96440268013,2379,0,751.2826086956521,42,4,12,37.76691097150835,0.6056547619047619,45.49418604651163,1018.0232558139535,24.238648947951273,0
2404,4,1,2,44,0.021739130434782608,0.043478260869565216,0.9565217391304348,46,1050,800,250,0.7619047619047619,13,8,5,300.7073941619403,0.38739935587761676,0.14321849160093136,0.16875255846429008,129669.75509472085,-1401.469168769906,128268.28592595094,2380,0,752.2608695652174,42,4,12,37.7162417150287,0.6068948412698413,45.373062015503876,1018.5077519379844,24.250184569952008,0
2405,4,2,2,44,0.043478260869565216,0.043478260869565216,0.9565217391304348,46,1000,700,300,0.7,13,7,6,301.24905909611294,0.38931159420289857,0.1413653373028183,0.1694828173566413,129768.46648526228,-1381.4743141938573,128386.99217106843,2381,0,753.1304347826087,42,4,13,37.60263116183233,0.6078869047619047,45.276162790697676,1018.8953488372091,24.259413067552597,0
2406,4,2,1,45,0.043478260869565216,0.021739130434782608,0.9782608695652174,46,1700,900,800,0.5294117647058824,25,9,16,306.0305047649915,0.38699677938808374,0.15625925121869333,0.17331239125893985,130026.38996056237,-1241.5916495198967,128784.79831104248,2382,0,754.0869565217391,44,2,14,37.22007868058708,0.607717803030303,45.023148148148145,1019.907407407407,23.179713804713796,0
2407,4,0,0,45,0.0,0.0,1.0,45,1750,1200,550,0.6857142857142857,23,12,11,310.097058529422,0.382260101010101,0.15022036650429116,0.17582806453003824,130073.61218278471,-932.9110939643305,129140.70108882038,2383,1,771.8444444444444,44,1,14,37.068659042086466,0.6081912878787878,44.976851851851855,1020.0925925925932,23.18392255892257,0
2408,4,2,1,46,0.0425531914893617,0.02127659574468085,0.9787234042553191,47,1700,1300,400,0.7647058823529411,21,13,8,277.3497942386831,0.389300030835646,0.11095350669818771,0.16000949667616338,130746.38429752071,-2135.1877713725294,128611.19652614818,2384,0,739.9574468085107,43,4,11,37.226851851851855,0.6162790697674418,44.31818181818182,1022.7272727272731,23.784355179704026,7
2409,4,0,1,45,0.0,0.021739130434782608,0.9782608695652174,46,1050,700,350,0.6666666666666666,14,7,7,283.11830329939653,0.3861714975845411,0.00424130040243087,0.1608228712556365,130144.46159122074,-1774.4999093063118,128369.96168191443,2385,1,757.0434782608696,44,2,16,37.68526920750153,0.6089015151515151,44.907407407407405,1020.3703703703694,23.190235690235667,8
2410,4,0,0,45,0.0,0.0,1.0,45,800,400,400,0.5,12,4,8,294.12370183233935,0.38257575757575757,-0.0007057874571481104,0.1670743914532154,130144.46159122078,-1344.2858367626943,128800.17575445809,2386,4,774.8444444444444,44,1,16,37.4045296430732,0.6089015151515151,44.907407407407405,1020.3703703703698,23.190235690235678,0
2411,4,0,0,45,0.0,0.0,1.0,45,1050,700,350,0.6666666666666666,14,7,7,292.7113702623905,0.3818813131313132,-0.001088435374149821,0.1667774086378738,130262.58680555566,-1374.1319444444343,128888.45486111123,2387,5,775.8444444444444,45,0,17,37.32142857142858,0.6087962962962963,44.79166666666667,1020.8333333333343,22.685185185185205,0
2412,4,0,0,45,0.0,0.0,1.0,45,1100,800,300,0.7272727272727273,14,8,6,287.34255774869644,0.3817550505050505,0.001964628259448542,0.16444979607962842,130435.75074364511,-1504.0515518899242,128931.6991917552,2388,6,776.8444444444444,42,3,17,37.283998924935176,0.6145833333333334,44.62209302325581,1021.511627906976,24.32170542635657,0
2413,4,1,1,45,0.021739130434782608,0.021739130434782608,0.9782608695652174,46,900,500,400,0.5555555555555556,13,5,8,279.7364753884924,0.3838768115942029,0.007633497630032959,0.16124267401829379,130711.95130315493,-1887.0198902606403,128824.9314128943,2389,0,760.9347826086956,44,2,12,37.20044066159603,0.6145833333333335,44.35185185185185,1022.5925925925919,23.240740740740726,0
2414,4,0,0,45,0.0,0.0,1.0,45,900,600,300,0.6666666666666666,12,6,6,287.7056523174693,0.38198653198653204,0.0074208217634512685,0.16583618080345158,130711.9513031551,-1478.6865569272913,129233.26474622781,2390,8,778.8444444444444,44,1,14,36.99671012918026,0.6145833333333334,44.351851851851855,1022.5925925925933,23.24074074074076,0
2415,4,2,1,46,0.0425531914893617,0.02127659574468085,0.9787234042553191,47,1700,1200,500,0.7058823529411765,22,12,10,303.23278268107833,0.3882593277829171,0.04918593812335614,0.17104152899800376,129869.89935314274,-1520.9400013143686,128348.95935182837,2391,0,746.6595744680851,45,2,18,37.44955049023962,0.6048611111111111,45.17663043478261,1019.2934782608697,22.650966183574884,4
2416,4,0,0,46,0.0,0.0,1.0,46,1100,600,500,0.5454545454545454,16,6,10,311.5575532368418,0.3854669887278583,0.06333801860421073,0.1761227811213603,129955.57270233182,-1102.2719478738095,128853.300754458,2392,1,763.304347826087,44,2,18,37.150759777212734,0.6070075757575759,45.09259259259259,1019.6296296296284,23.173400673400646,0
2417,4,2,2,46,0.041666666666666664,0.041666666666666664,0.9583333333333334,48,1100,600,500,0.5454545454545454,16,6,10,304.9563958814375,0.3908281619385343,0.07169828092632136,0.1738622371230973,130286.75538230278,-1652.5574525505813,128634.1979297522,2393,0,732.4583333333334,43,5,18,36.984529109853746,0.6116763565891474,44.76799242424241,1020.9280303030274,23.742512332628543,0
2418,4,0,0,46,0.0,0.0,1.0,46,750,600,150,0.8,9,6,3,314.7427271562223,0.3857085346215781,0.06656720659278181,0.17835421205519225,130049.9999999997,-1013.5416666666968,129036.458333333,2394,3,765.304347826087,44,2,18,36.974060457516345,0.6079545454545456,44.999999999999986,1019.9999999999976,23.181818181818127,0
2419,4,0,1,45,0.0,0.021739130434782608,0.9782608695652174,46,800,500,300,0.625,11,5,6,319.4511654673529,0.3851650563607085,0.0740692527987501,0.18168166902895583,130191.70524691354,-882.0216049382793,129309.68364197527,2395,4,766.304347826087,44,2,18,36.71066956995099,0.609375,44.86111111111111,1020.5555555555552,23.194444444444436,0
2420,4,0,0,45,0.0,0.0,1.0,45,1500,1200,300,0.8,18,12,6,325.03123698459007,0.3814183501683502,0.0812698412698416,0.18519221642145242,130262.58680555546,-532.0601851851894,129730.52662037028,2396,5,783.4888888888889,40,5,20,36.4965986394558,0.6158854166666667,44.791666666666664,1020.8333333333326,25.520833333333314,0
2421,4,0,0,45,0.0,0.0,1.0,45,1200,900,300,0.75,15,9,6,301.08313311245837,0.3814814814814815,-0.04100665158060701,0.16279923359951712,128197.27105034712,-1215.2886284722276,126981.98242187488,2397,6,784.4888888888889,39,6,18,39.20018171843928,0.5966880341880343,46.822916666666664,1012.7083333333325,25.96688034188032,7
2422,4,2,1,46,0.0425531914893617,0.02127659574468085,0.9787234042553191,47,1200,800,400,0.6666666666666666,16,8,8,294.1555492805854,0.38972402096823927,-0.020900184462324445,0.1613675830932798,128773.09032698724,-1824.1361764613282,126948.95415052591,2398,0,752.063829787234,41,6,16,38.79090916495619,0.599339430894309,46.254960317460316,1014.9801587301583,24.755613627564838,0
2423,4,3,2,47,0.061224489795918366,0.04081632653061224,0.9591836734693877,49,1200,800,400,0.6666666666666666,16,8,8,282.14501744404697,0.3980477607709751,0.007688792525109678,0.1567555298081142,129275.28511094593,-2504.4134082026203,126770.87170274332,2399,0,722.3061224489796,42,7,19,38.58742258218197,0.6029265873015872,45.76065891472869,1016.9573643410858,24.213270579549665,0
2424,4,1,0,48,0.020833333333333332,0.0,1.0,48,800,500,300,0.625,11,5,6,291.9405001805494,0.39852061170212766,0.02106086461888479,0.16262084895988776,129377.95380015433,-2045.8670910493847,127332.08670910494,2400,0,738.0,41,7,20,38.23449943117176,0.6054369918699187,45.65972222222222,1017.3611111111112,24.81368563685637,0
2425,4,0,0,48,0.0,0.0,1.0,48,850,400,450,0.47058823529411764,13,4,9,291.9205838556126,0.3986037234042554,0.02237684408916607,0.16292281551636953,129453.66138353483,-2041.9623173343525,127411.69906620047,2401,1,739.0,41,7,14,38.158429193475015,0.6061991869918699,45.585317460317455,1017.6587301587297,24.820944638017796,0
2426,4,1,2,47,0.02040816326530612,0.04081632653061224,0.9591836734693877,49,1350,800,550,0.5925925925925926,19,8,11,283.85697220803394,0.40072278911564624,0.03229594262812108,0.1596980236900734,129768.46648526218,-2432.8632030827603,127335.60328217942,2402,0,724.8979591836735,42,7,16,38.04564907275322,0.6078869047619049,45.27616279069767,1018.8953488372083,24.25941306755258,0
2427,4,1,1,47,0.020833333333333332,0.020833333333333332,0.9791666666666666,48,1350,1200,150,0.8888888888888888,15,12,3,292.0894933748512,0.3958887411347518,0.021547595857277946,0.16396297586001066,129680.91699932276,-2024.3133306563448,127656.60366866642,2403,0,740.8541666666666,41,7,16,37.9243977468264,0.6084857723577236,45.36210317460317,1018.5515873015863,24.842721641502106,0
2428,4,0,0,47,0.0,0.0,1.0,47,1150,600,550,0.5217391304347826,17,6,11,298.8950199133076,0.391709065679926,0.020667115459350738,0.16739123557917435,129589.12854658272,-1653.290968504196,127935.83757807853,2404,2,757.6170212765958,40,7,17,37.84392986658684,0.6091145833333333,45.452235772357724,1018.191056910569,25.454776422764226,0
2429,4,1,1,47,0.020833333333333332,0.020833333333333332,0.9791666666666666,48,1900,1600,300,0.8421052631578947,22,16,6,295.40571437570827,0.39370936761229314,0.030375441839348705,0.16711476819306015,129984.23450688133,-1920.3828695830343,128063.8516372983,2405,0,742.8125,41,7,19,37.533543308363335,0.6115345528455285,45.06448412698412,1019.7420634920625,24.871757646147866,0
2430,4,0,1,46,0.0,0.02127659574468085,0.9787234042553191,47,1450,1200,250,0.8275862068965517,17,12,5,303.94565592790775,0.3905334566759174,0.031535333059088844,0.17191604913081318,129977.44914568045,-1498.7837927159771,128478.66535296448,2406,1,759.468085106383,40,7,19,37.32268620025248,0.6130208333333333,45.07113821138211,1019.7154471544713,25.492886178861784,0
2431,4,1,1,46,0.02127659574468085,0.02127659574468085,0.9787234042553191,47,850,500,350,0.5882352941176471,12,5,7,298.03101470798106,0.3945613629355535,0.041759041725952795,0.16958755969666514,130211.95515243118,-1638.5597757621704,128573.39537666901,2407,0,753.531914893617,41,6,19,37.236748315189224,0.6138211382113821,44.841269841269835,1020.6349206349194,24.89353464963218,0
2432,4,4,1,49,0.08,0.02,0.98,50,1000,500,500,0.5,15,5,10,285.4788410026981,0.4020748299319728,0.0749099791911696,0.16546395540654543,130925.07823216736,-2524.7320816186557,128400.3461505487,2408,0,709.24,44,6,15,36.839357338882344,0.6167140151515151,44.14351851851852,1023.4259259259261,23.25968013468014,0
2433,4,0,0,49,0.0,0.0,1.0,49,800,400,400,0.5,12,4,8,295.28328874588266,0.39985473356009066,0.07859522928016083,0.17078376079285398,130843.25140610641,-2072.8348829201213,128770.41652318629,2409,1,724.7142857142857,43,6,15,36.67083179069481,0.6172480620155039,44.223484848484844,1023.1060606060597,23.793164200140925,0
2434,4,0,0,49,0.0,0.0,1.0,49,1000,700,300,0.7,13,7,6,294.0802179087037,0.3999255952380953,0.0766392064877035,0.17030175963137467,130891.69841167347,-2101.4681617309534,128790.23024994251,2410,2,725.7142857142857,43,6,15,36.65286260719353,0.617732558139535,44.17613636363636,1023.2954545454539,23.797568710359393,0
2435,4,1,2,48,0.02,0.04,0.96,50,900,600,300,0.6666666666666666,12,6,6,294.25391470399745,0.4021938775510204,0.10639855399909637,0.17181633594721524,131209.5175325787,-2278.2171639231965,128931.3003686555,2411,0,712.18,44,6,16,36.32888989305618,0.6195549242424243,43.86574074074073,1024.5370370370358,23.284932659932633,0
2436,4,1,0,49,0.02040816326530612,0.0,1.0,49,750,500,250,0.6666666666666666,10,5,5,301.4535082737184,0.39985473356009066,0.10592323451843311,0.17589665871116963,131182.56876291317,-1890.9108844123057,129291.65787850086,2412,0,727.3877551020408,43,6,17,36.17158131509212,0.6206395348837209,43.89204545454545,1024.4318181818178,23.82399577167018,0
2437,4,0,0,49,0.0,0.0,1.0,49,1500,1200,300,0.8,18,12,6,305.0432943353825,0.3984375,0.10187489629998359,0.1786682152535811,131328.125,-1787.6858069329667,129540.43919306704,2413,1,728.3877551020408,41,8,18,35.93326558265583,0.625,43.75,1025.0,25.0,0
2438,4,0,0,49,0.0,0.0,1.0,49,1400,1100,300,0.7857142857142857,17,11,6,306.5827214868349,0.3991638321995465,0.10538952423074499,0.18004767098226862,131429.83119173607,-1741.1769337364394,129688.65425799963,2414,2,729.3877551020408,41,8,19,35.791569917440675,0.6260162601626016,43.65079365079366,1025.3968253968264,25.00967866821528,0
2439,4,0,0,49,0.0,0.0,1.0,49,1550,1200,350,0.7741935483870968,19,12,7,308.15122987223174,0.3981186224489796,0.11894434818986599,0.18169327362249843,131582.4642935879,-1690.5403596623682,129891.92393392553,2415,3,730.3877551020408,41,8,15,35.59796622187842,0.627540650406504,43.501984126984134,1025.9920634920643,25.024196670538153,0
2440,4,0,0,49,0.0,0.0,1.0,49,950,600,350,0.631578947368421,13,6,7,309.9278104661366,0.39792375283446707,0.11986836497940234,0.18298477576836286,131633.3616780046,-1640.632086167793,129992.72959183682,2416,4,731.3877551020408,41,8,15,35.50125676720807,0.6280487804878048,43.452380952380956,1026.1904761904768,25.029036004645775,0
2441,4,0,0,49,0.0,0.0,1.0,49,1400,800,600,0.5714285714285714,20,8,12,306.4815875505212,0.3975517290249433,0.1141429419385882,0.18155569259074655,131760.6481973576,-1723.5574727576275,130037.09072459997,2417,5,732.3877551020408,41,8,15,35.461860244145946,0.6293191056910569,43.32837301587301,1026.6865079365075,25.041134339914816,0
2442,4,0,0,49,0.0,0.0,1.0,49,1750,1500,250,0.8571428571428571,20,15,5,304.23282306870766,0.39751629818594103,0.11558336542164005,0.18076613926728152,131874.96244216096,-1775.8615768283146,130099.10086533264,2418,6,733.3877551020408,42,7,15,35.40487421383647,0.628968253968254,43.21705426356589,1027.1317829457366,24.455518641565156,0
2443,4,1,0,50,0.02,0.0,1.0,50,1700,1200,500,0.7058823529411765,22,12,10,294.34419439911153,0.40085884353741497,0.11839241322161853,0.1765252509866788,132227.50521012698,-2215.9203003041594,130011.58490982282,2419,0,719.7,43,7,17,35.305700058312645,0.6310562015503876,42.87405303030304,1028.5037878787891,23.918692741367188,0
2444,4,0,1,49,0.0,0.02,0.98,50,1200,700,500,0.5833333333333334,17,7,10,294.30648586963656,0.40041666666666664,0.12129750621146629,0.17718717905514356,132373.63985200014,-2208.315846676992,130165.32400532314,2420,1,720.7,43,7,18,35.16044369804609,0.6325096899224807,42.73200757575758,1029.0719696969697,23.93190627202255,0
2445,4,1,0,50,0.02,0.0,1.0,50,1400,1000,400,0.7142857142857143,18,10,8,284.26576578553676,0.40303571428571433,0.10904125508425322,0.16583775692098607,131175.63952664402,-2542.2512755102007,128633.38825113382,2421,0,721.44,48,2,14,36.61872942087932,0.6143663194444444,43.898809523809526,1024.4047619047622,21.341765873015877,4
2446,4,2,1,51,0.038461538461538464,0.019230769230769232,0.9807692307692307,52,1450,1000,450,0.6896551724137931,19,10,9,274.52171697572186,0.40848102061337355,0.11294826056711171,0.1606998666686923,131306.3359378615,-3184.954330371599,128121.3816074899,2422,0,694.6538461538462,48,4,14,36.73722309798392,0.6156684027777777,43.77125850340136,1024.9149659863942,21.352395124716548,5
2447,4,0,1,50,0.0,0.0196078431372549,0.9803921568627451,51,1300,1000,300,0.7692307692307693,16,10,6,282.820842707293,0.40596405228758164,0.10391642046841598,0.16555605799925663,131305.88201828935,-2772.7919590326082,128533.09005925675,2423,1,709.2745098039215,47,4,15,36.52503105502387,0.6167996453900709,43.771701388888886,1024.913194444444,21.806663711583912,0
2448,4,0,0,50,0.0,0.0,1.0,50,1100,1000,100,0.9090909090909091,12,10,2,284.2077859609092,0.40501700680272107,0.11357837073687982,0.1666665140676461,131374.5512037912,-2532.462166550247,128842.08903724095,2424,2,721.32,45,5,15,36.420598456735604,0.6199074074074074,43.70471014492754,1025.1811594202898,22.781803542673106,0
2449,4,0,0,50,0.0,0.0,1.0,50,1100,700,400,0.6363636363636364,15,7,8,284.64740537895295,0.40516156462585035,0.1190647419828843,0.16741666664103266,131487.1935280546,-2514.502304335791,128972.69122371881,2425,3,722.32,46,4,15,36.296352320857444,0.6197916666666666,43.59485815602837,1025.620567375888,22.296099290780173,0
2450,4,1,2,49,0.0196078431372549,0.0392156862745098,0.9607843137254902,51,1000,700,300,0.7,13,7,6,282.22683251513877,0.4069281045751634,0.12719891745602196,0.16685250338294985,131684.26890432084,-2767.033179012358,128917.23572530848,2426,0,709.1372549019608,47,4,12,36.16091565178168,0.6205673758865249,43.40277777777777,1026.3888888888878,21.838061465721015,0
2451,4,1,0,50,0.02,0.0,1.0,50,1050,700,350,0.6666666666666666,14,7,7,285.63954216939345,0.40380102040816324,0.1475192125032383,0.1692067282794754,131760.106422275,-2472.820705070165,129287.28571720485,2427,0,723.94,46,4,13,35.99735918026654,0.6225090579710145,43.32890070921986,1026.6843971631204,22.319226025285225,0
2452,4,0,0,50,0.0,0.0,1.0,50,1250,700,550,0.56,18,7,11,284.5789286406306,0.40370748299319725,0.15175019014620128,0.16913221811173174,131884.81177812727,-2493.672312041871,129391.1394660854,2428,1,724.94,47,3,14,35.89969083636159,0.6225620567375887,43.20746527777777,1027.1701388888878,21.85468380614655,0
2453,4,0,0,50,0.0,0.0,1.0,50,1000,600,400,0.6,14,6,8,287.6105683185245,0.40368197278911566,0.1598682209832747,0.1714367526563288,131996.29041883664,-2407.294379340286,129588.99603949636,2429,2,725.94,47,3,15,35.71021287379627,0.6236702127659575,43.09895833333333,1027.6041666666654,21.863918439716283,0
2454,4,0,0,50,0.0,0.0,1.0,50,1650,1300,350,0.7878787878787878,20,13,7,286.16648738338097,0.4034013605442177,0.14946897425073935,0.1712805479058181,132152.43963547665,-2436.4801100742875,129715.95952540236,2430,3,726.94,47,3,15,35.59105459406221,0.6252216312056739,42.9470486111111,1028.2118055555532,21.876846926713895,0
2455,4,0,0,50,0.0,0.0,1.0,50,1500,1200,300,0.8,18,12,6,286.1137646291819,0.4033503401360545,0.1525196252215757,0.17145117701375384,132197.0706515839,-2435.3196885850925,129761.7509629988,2431,4,727.94,47,3,15,35.54776525702709,0.6256648936170214,42.90364583333332,1028.3854166666642,21.880540780141793,0
2456,4,1,1,50,0.0196078431372549,0.0196078431372549,0.9803921568627451,51,1350,1200,150,0.8888888888888888,15,12,3,280.68552765590266,0.40679738562091505,0.15587775270196436,0.16920526900122063,132422.36933432348,-2765.4285385369867,129656.94079578649,2432,0,714.6470588235294,43,8,16,35.46218986720645,0.6329941860465116,42.6846590909091,1029.2613636363649,23.936310782241044,0
2457,4,1,0,51,0.0196078431372549,0.0,1.0,51,650,300,350,0.46153846153846156,10,3,7,284.59162590656064,0.4058006535947712,0.1896804176215936,0.16856580919080927,131755.5555555558,-2700.694444444422,129054.86111111137,2433,0,715.6274509803922,44,7,15,36.02881493506492,0.625,43.33333333333334,1026.6666666666688,23.333333333333382,1
2458,4,0,0,51,0.0,0.0,1.0,51,1000,600,400,0.6,14,6,8,288.2134878152144,0.4055392156862745,0.1956011613570381,0.17119186685891644,131862.52170138882,-2599.08854166667,129263.43315972215,2434,1,716.6274509803922,45,6,15,35.82868492224475,0.6247685185185186,43.229166666666664,1027.0833333333328,22.824074074074062,0
2459,4,0,0,51,0.0,0.0,1.0,51,1300,800,500,0.6153846153846154,18,8,10,290.4401537686842,0.40508169934640526,0.19486147628406947,0.17293767266132198,131955.5710213846,-2534.9607323829114,129420.61028900168,2435,2,717.6274509803922,45,6,15,35.67830012636281,0.6256944444444446,43.138586956521735,1027.4456521739123,22.832125603864718,0
2460,4,0,0,51,0.0,0.0,1.0,51,1700,1500,200,0.8823529411764706,19,15,4,290.529263648057,0.40508169934640526,0.2003744653213655,0.17334563836705716,132033.30224994948,-2528.0923840601768,129505.20986588931,2436,3,718.6274509803922,46,5,15,35.5981698726243,0.6252264492753624,43.06294326241134,1027.748226950353,22.342352759790284,0
2461,4,1,0,52,0.019230769230769232,0.0,1.0,52,1400,900,500,0.6428571428571429,19,9,10,296.07976092724897,0.4061635872297637,0.2142731198392478,0.17331534764961623,131305.408783826,-2616.826838438738,128688.58194538725,2437,0,705.7884615384615,46,6,17,36.1857754519505,0.6179800724637683,43.77216312056736,1024.9113475177282,22.280681467776702,5
2462,4,0,0,52,0.0,0.0,1.0,52,1100,800,300,0.7272727272727273,14,8,6,299.13440284022573,0.4058179361488185,0.22063253547044104,0.17554082273989813,131400.93338390996,-2538.6861574642103,128862.24722644575,2438,1,706.7884615384615,43,9,17,36.01153366583542,0.6228197674418606,43.678977272727266,1025.2840909090896,23.843816067653247,0
2463,4,0,0,52,0.0,0.0,1.0,52,1350,800,550,0.5925925925925926,19,8,11,296.7543707407018,0.4056843891402715,0.21247578579016535,0.17478690448890125,131541.75347222207,-2592.88194444445,128948.87152777762,2439,2,707.7884615384615,44,8,17,35.93115353371244,0.6228693181818181,43.541666666666664,1025.8333333333323,23.314393939393916,0
2464,4,0,0,52,0.0,0.0,1.0,52,1350,1000,350,0.7407407407407407,17,10,7,305.2037317771584,0.4057393790849673,0.24215528061681946,0.17457653457653466,130414.54081632657,-2405.718537414959,128008.82227891161,2440,3,708.7884615384615,41,11,15,36.84926184926187,0.6158536585365852,44.642857142857146,1021.4285714285717,24.912891986062725,8
2465,4,1,1,52,0.018867924528301886,0.018867924528301886,0.9811320754716981,53,1300,900,400,0.6923076923076923,17,9,8,296.22529837681145,0.4096819061441703,0.24114755886281114,0.1707299603370013,130708.09789262975,-2856.1909402980505,127851.9069523317,2441,0,696.3962264150944,42,11,12,36.78278688524589,0.6173115079365079,44.355620155038764,1022.5775193798457,24.34708379475823,0
2466,4,0,1,51,0.0,0.019230769230769232,0.9807692307692307,52,1300,1000,300,0.7692307692307693,16,10,6,304.3034643187434,0.40600647310206134,0.24023068713570384,0.17531893833053602,130693.35322381268,-2445.9119701121163,128247.44125370056,2442,5,710.7884615384615,41,11,12,36.59113143171307,0.6186483739837398,44.370039682539684,1022.5198412698413,24.939508323654668,0
2467,4,2,1,52,0.03773584905660377,0.018867924528301886,0.9811320754716981,53,1750,1400,350,0.8,21,14,7,301.63063549920497,0.4092737058538945,0.2613297344611192,0.17633414947255024,131255.3367930013,-2681.873870092946,128573.46292290837,2443,0,686.6981132075472,43,10,14,36.09387995564182,0.6213662790697674,43.82102272727274,1024.7159090909113,23.830602536997937,0
2468,4,0,1,51,0.0,0.019230769230769232,0.9807692307692307,52,1350,900,450,0.6666666666666666,18,9,9,306.8264088814796,0.40767973856209155,0.2641566396531405,0.1792476490338548,131228.82207349344,-2347.1063562886557,128881.71571720479,2444,1,700.9038461538462,42,10,14,35.98744562133536,0.6225198412698412,43.846899224806215,1024.6124031007773,24.395533407161366,0
2469,4,1,1,51,0.019230769230769232,0.019230769230769232,0.9807692307692307,52,1800,1300,500,0.7222222222222222,23,13,10,312.9122447106723,0.40709841628959276,0.2813526198018077,0.18447187344079086,131576.54663181322,-2165.617488432159,129410.92914338107,2445,0,701.25,42,10,14,35.48179542878733,0.6259920634920633,43.50775193798451,1025.9689922480638,24.427833148763426,0
2470,4,1,1,51,0.019230769230769232,0.019230769230769232,0.9807692307692307,52,1150,600,550,0.5217391304347826,17,6,11,313.4105087431698,0.40884238310708904,0.28927847853081534,0.18536892904055832,131700.84547390486,-2144.7142036235714,129556.13127028129,2446,0,702.2307692307693,42,10,14,35.34409515717928,0.6272321428571428,43.38662790697675,1026.4534883720935,24.43936877076413,0
2471,4,0,0,51,0.0,0.0,1.0,51,1200,800,400,0.6666666666666666,16,8,8,319.46934114899597,0.4055718954248366,0.2978503786742197,0.18227232141690689,130315.76063368065,-1746.068498221631,128569.69213545902,2447,4,717.0,39,12,17,36.58479561994149,0.6180555555555556,44.739583333333336,1021.0416666666674,26.180555555555575,5
2472,4,1,1,51,0.019230769230769232,0.019230769230769232,0.9807692307692307,52,2050,1700,350,0.8292682926829268,24,17,7,314.29573111035836,0.40760903720462544,0.2989900535006751,0.18131363693434158,130744.07837498422,-2181.538859756868,128562.53951522736,2448,0,704.1923076923077,41,11,14,36.28453697416497,0.6191565040650406,44.320436507936506,1022.7182539682537,24.944347657762286,0
2473,4,1,1,51,0.019230769230769232,0.019230769230769232,0.9807692307692307,52,1150,800,350,0.6956521739130435,15,8,7,311.95663491463546,0.4077268728004022,0.2987855821447758,0.18031932843271997,130820.18455530373,-2237.9550894431654,128582.22946586057,2449,0,705.1730769230769,41,11,14,36.267617015774505,0.6199186991869918,44.246031746031754,1023.015873015874,24.951606658923758,0
2474,4,0,0,51,0.0,0.0,1.0,51,1350,1000,350,0.7407407407407407,17,10,7,317.3169457917657,0.40545751633986926,0.2985169425480845,0.18311225587433105,130755.83316808796,-1901.7916749289216,128854.04149315905,2450,7,720.0,40,11,14,36.19543256491786,0.6208333333333333,44.308943089430905,1022.7642276422779,25.569105691056947,0
2475,4,1,1,51,0.019230769230769232,0.019230769230769232,0.9807692307692307,52,1250,900,350,0.72,16,9,7,309.98144367653725,0.407514768728004,0.29961348371562546,0.18000554402353353,130997.85175933808,-2278.619358623069,128719.23240071502,2451,0,707.1346153846154,41,11,16,36.13914058209774,0.6216971544715446,44.07242063492064,1023.7103174603182,24.968544328300442,0
2476,4,1,0,52,0.019230769230769232,0.0,1.0,52,1150,600,550,0.5217391304347826,17,6,11,345.6215015092117,0.4107513197586727,0.3071441444147418,0.19117422578079749,129100.5487843287,-1413.5901872322834,127686.95859709641,2452,0,701.4615384615385,41,11,16,37.151421970584416,0.6026422764227641,45.93253968253969,1016.2698412698426,24.787069299264452,6
2477,4,0,0,52,0.0,0.0,1.0,52,1550,1000,550,0.6451612903225806,21,10,11,347.6887933351245,0.41077488687782804,0.29949558638083196,0.19280923994038765,129201.38888888923,-1415.6249999999645,127785.76388888925,2453,1,702.4615384615385,42,10,17,36.99624316939892,0.6021825396825395,45.83333333333335,1016.6666666666694,24.20634920634927,0
2478,4,0,0,52,0.0,0.0,1.0,52,1650,1200,450,0.7272727272727273,21,12,9,365.2199124724277,0.4110576923076923,0.31587136519284154,0.19813129328607412,128329.16802300363,-1013.3056640624791,127315.86235894114,2454,2,703.4615384615385,39,13,17,37.44142164422057,0.5980235042735043,46.69270833333334,1013.229166666668,25.980235042735078,4
2479,4,2,0,54,0.037037037037037035,0.0,1.0,54,1650,1000,650,0.6060606060606061,23,10,13,368.5505714842532,0.4147958886559515,0.34971476006287605,0.20348882264414966,129029.04652852917,-1289.254232768435,127739.79229576074,2455,0,678.3703703703703,42,12,17,36.6418295978382,0.6004464285714284,46.0029069767442,1015.9883720930252,24.19019933554822,0
2480,4,0,0,54,0.0,0.0,1.0,54,1350,1000,350,0.7407407407407407,17,10,7,372.6662878966386,0.4143154553924994,0.3495246772325331,0.2061457820390273,129102.89345592257,-1177.5407878131846,127925.3526681094,2456,1,679.3703703703703,42,12,18,36.461908848207486,0.601190476190476,45.93023255813956,1016.2790697674455,24.197120708748702,0
2481,4,0,0,54,0.0,0.0,1.0,54,1700,1300,400,0.7647058823529411,21,13,8,365.778149495092,0.4146866992778942,0.3375661375661374,0.20339999901829894,129310.02995105565,-1340.0930753132952,127969.93687574235,2457,2,680.3703703703703,38,16,18,36.425726540616246,0.6096491228070176,45.72649572649573,1017.0940170940175,26.765632028789934,0
2482,4,1,0,55,0.01818181818181818,0.0,1.0,55,1400,800,600,0.5714285714285714,20,8,12,361.6592691008545,0.41630190796857464,0.34349055200119105,0.20272826919323117,129625.34722222216,-1623.9583333333367,128001.38888888882,2458,0,668.9818181818182,39,16,14,36.209424440807425,0.6111111111111112,45.416666666666664,1018.3333333333328,26.111111111111097,0
2483,4,0,0,55,0.0,0.0,1.0,55,1000,800,200,0.8,12,8,4,361.0354295164727,0.41663860830527494,0.3427928845285433,0.20266543219494929,129680.91699932277,-1636.1188862118993,128044.79811311087,2459,1,669.9818181818182,41,14,14,36.16877292945034,0.6084857723577236,45.36210317460317,1018.5515873015864,24.84272164150211,0
2484,4,0,0,55,0.0,0.0,1.0,55,1850,1500,350,0.8108108108108109,22,15,7,359.98502959275436,0.41665263748597087,0.3381706668018347,0.20271056532954668,129803.80980436498,-1654.5143372646617,128149.29546710032,2460,2,670.9818181818182,43,12,14,36.07055183842891,0.6068313953488371,45.24147727272729,1019.0340909090934,23.69846723044403,0
2485,4,0,2,53,0.0,0.03636363636363636,0.9636363636363636,55,1450,800,650,0.5517241379310345,21,8,13,370.21257167006036,0.4158389450056117,0.3510321943311636,0.20924297948407056,129948.59931882766,-1378.2789722508987,128570.32034657676,2461,3,671.9818181818182,43,12,14,35.66269233150678,0.6082848837209301,45.09943181818183,1019.6022727272741,23.711680761099398,0
2486,4,0,1,52,0.0,0.018867924528301886,0.9811320754716981,53,1850,1600,250,0.8648648648648649,21,16,5,382.73188710474074,0.4144442428640542,0.34618428034023596,0.21623615193927556,129933.65698420577,-654.0492528029669,129279.6077314028,2462,4,666.8301886792453,41,12,15,35.35879066523953,0.6110264227642277,45.114087301587304,1019.5436507936511,24.86691831204027,0
2487,4,0,0,52,0.0,0.0,1.0,52,1600,1100,500,0.6875,21,11,10,387.6029019248477,0.41368935394670686,0.3456500417602122,0.21996300352874787,130107.01844346964,-314.0284181042851,129792.99002536536,2463,5,679.6153846153846,40,12,15,35.05806521233857,0.6143229166666666,44.94410569105692,1020.2235772357735,25.50558943089434,0
2488,4,0,0,52,0.0,0.0,1.0,52,1400,1200,200,0.8571428571428571,16,12,4,386.0079242564615,0.41396430367018605,0.34476353162869744,0.21949555919498243,130184.7910056846,-349.5278108268752,129835.26319485773,2464,6,680.6153846153846,40,12,15,35.01958441213569,0.6151041666666666,44.867886178861795,1020.5284552845541,25.51321138211385,0
2489,4,1,1,52,0.018867924528301886,0.018867924528301886,0.9811320754716981,53,1350,1100,250,0.8148148148148148,16,11,5,378.45059065542887,0.4155630140299951,0.34134630182523273,0.2168132823100731,130475.34722222242,-724.2590802432226,129751.0881419792,2465,0,668.7547169811321,39,14,17,34.91707449700925,0.6196581196581196,44.58333333333334,1021.6666666666682,26.196581196581235,0
2490,4,0,2,50,0.0,0.038461538461538464,0.9615384615384616,52,1150,800,350,0.6956521739130435,15,8,7,377.2558734024027,0.41394859225741576,0.34078529625521137,0.2163894927017207,130522.07396597612,-551.9561975345184,129970.1177684416,2466,1,680.6153846153846,40,12,12,34.900132604011276,0.6184895833333333,44.53760162601627,1021.8495934959365,25.54623983739841,0
2491,4,1,1,50,0.0196078431372549,0.0196078431372549,0.9803921568627451,51,1050,400,650,0.38095238095238093,17,4,13,383.74704225568195,0.4138562091503268,0.33662962585380796,0.21999852352343557,130501.95448133674,-184.0521918402825,130317.90228949646,2467,0,693.2745098039215,39,12,13,34.75475328779692,0.6199252136752137,44.557291666666664,1021.7708333333328,26.199252136752122,0
2492,4,0,0,50,0.0,0.0,1.0,50,1150,600,550,0.5217391304347826,17,6,11,389.72658147417417,0.41022108843537414,0.33577912570591884,0.2231476390452728,130453.51765103376,168.24069508365403,130621.75834611742,2468,10,708.14,38,12,18,34.651267168653696,0.6211622807017543,44.60470085470086,1021.5811965811973,26.883715699505192,0
2493,4,0,0,50,0.0,0.0,1.0,50,400,100,300,0.25,7,1,6,389.809073144952,0.4098639455782313,0.3321547307893358,0.22366669373914028,130535.38795976707,176.77571864271405,130712.1636784098,2469,11,709.14,38,12,13,34.565908694894595,0.6219846491228069,44.524572649572654,1021.9017094017103,26.89215024741343,0
2494,4,0,1,49,0.0,0.02,0.98,50,1100,700,400,0.6363636363636364,15,7,8,389.809073144952,0.40968537414965983,0.3321547307893358,0.22366669373914028,130535.38795976707,176.77571864271405,130712.1636784098,2470,12,710.14,38,12,13,34.565908694894595,0.6219846491228069,44.524572649572654,1021.9017094017103,26.89215024741343,0
2495,4,0,0,49,0.0,0.0,1.0,49,1550,1000,550,0.6451612903225806,21,10,11,393.3872063066093,0.4105194160997732,0.33211817073144023,0.22592496303043177,130570.5857210874,472.9595885272573,131043.54530961465,2471,13,712.2244897959183,37,12,13,34.43870024675465,0.6241554054054053,44.49013157894738,1022.0394736842117,27.622688477951666,0
2496,4,1,1,49,0.02,0.02,0.98,50,1400,1200,200,0.8571428571428571,16,12,4,388.27006579240975,0.4121938775510204,0.33219542749765085,0.22499933213705353,130917.78897518085,166.29170775806227,131084.08068293892,2472,0,698.96,38,12,14,34.21677628144901,0.6258223684210527,44.15064102564103,1023.3974358974363,26.931511470985164,0
2497,4,0,1,48,0.0,0.02040816326530612,0.9795918367346939,49,1350,900,450,0.6666666666666666,18,9,9,400.0424132335445,0.4096690759637189,0.3375339206720944,0.23175641481742207,130906.99932912046,673.6703841566618,131580.6697132771,2473,15,714.2244897959183,37,12,14,33.926546483803,0.6275337837837838,44.161184210526315,1023.3552631578943,27.658250355618765,0
2498,4,0,0,48,0.0,0.0,1.0,48,1350,1100,250,0.8148148148148148,16,11,5,391.55412563036924,0.4075520833333333,0.25481256934538,0.22028847677920435,129768.46648526216,562.2756858061298,130330.7421710683,2474,19,729.7916666666666,42,6,17,35.30234585512759,0.6078869047619049,45.27616279069767,1018.8953488372082,24.259413067552575,5
2499,4,3,2,49,0.058823529411764705,0.0392156862745098,0.9607843137254902,51,1250,1000,250,0.8,15,10,5,367.08677928552817,0.4138398692810457,0.26175771021966443,0.21059188916906613,130528.56445312497,-611.3042581669517,129917.26019495801,2475,0,687.8039215686274,39,12,17,35.15332993544004,0.6201923076923077,44.53125,1021.8749999999998,26.20192307692307,0
2500,4,0,0,49,0.0,0.0,1.0,49,1000,800,200,0.8,12,8,4,380.12783724026974,0.41016510770975056,0.27713567178696263,0.21752278450432172,130430.5411280396,116.05590181596506,130546.59702985556,2476,1,715.8979591836735,37,12,19,34.91976170030057,0.6227477477477477,44.62719298245615,1021.491228070177,27.607871028923704,0
2501,4,1,1,49,0.02,0.02,0.98,50,1500,1200,300,0.8,18,12,6,370.9919096459251,0.4123044217687075,0.2681027998328458,0.21392376862233733,130726.51855504441,-300.30384798010584,130426.21470706431,2477,0,702.56,38,12,18,34.852738891210485,0.6239035087719296,44.33760683760685,1022.6495726495743,26.911830859199323,0
2502,4,2,1,50,0.0392156862745098,0.0196078431372549,0.9803921568627451,51,1100,800,300,0.7272727272727273,14,8,6,359.9312602246353,0.4148366013071896,0.26292054549569555,0.19848287222171743,128979.82698042472,-913.8445390936657,128065.98244133106,2478,0,689.7450980392157,42,9,12,36.91095106362683,0.599950396825397,46.05135658914728,1015.7945736434098,24.185585086747853,8
2503,4,2,2,50,0.038461538461538464,0.038461538461538464,0.9615384615384616,52,1600,1000,600,0.625,22,10,12,354.82122448979646,0.41842634489693314,0.27024908424908456,0.19775068243858038,129398.49242833932,-1217.143557328321,128181.348871011,2479,0,677.3846153846154,42,10,13,36.61428571428569,0.6041666666666669,45.63953488372091,1017.4418604651136,24.224806201550322,0
2504,4,1,1,50,0.0196078431372549,0.0196078431372549,0.9803921568627451,51,950,700,250,0.7368421052631579,12,7,5,361.9860469269891,0.4167483660130719,0.3101187474210265,0.20280702978485868,129605.14298311903,-816.9493260267204,128788.19365709231,2480,0,690.9411764705883,41,10,13,36.2216647181086,0.6077235772357723,45.43650793650793,1018.2539682539671,24.83546264034066,0
2505,4,0,0,50,0.0,0.0,1.0,50,1250,800,450,0.64,17,8,9,371.23905143158396,0.4131972789115646,0.3113863659047802,0.20790631952448535,129589.1285465829,-378.2909685041816,129210.83757807872,2481,1,705.74,40,10,13,36.00242871876768,0.6091145833333333,45.45223577235773,1018.1910569105705,25.45477642276426,0
2506,4,1,0,51,0.0196078431372549,0.0,1.0,51,1100,900,200,0.8181818181818182,13,9,4,382.12921983364316,0.41539215686274505,0.37408962100374055,0.20010331328434675,126903.55994091956,-454.3456817338622,126449.2142591857,2482,0,692.8823529411765,38,13,13,38.47793623864558,0.5852521929824561,48.10363247863247,1007.5854700854688,26.51540710751234,6
2507,4,3,3,51,0.05555555555555555,0.05555555555555555,0.9444444444444444,54,1200,800,400,0.6666666666666666,16,8,8,356.871083308584,0.42445550896808754,0.35401712841841637,0.18965694256260485,127502.23597891476,-1699.4879595282152,125802.74801938655,2483,0,655.3333333333334,40,14,12,38.49953042194942,0.5880208333333332,47.51016260162602,1009.9593495934967,25.248983739837417,0
2508,4,4,6,49,0.07272727272727272,0.10909090909090909,0.8909090909090909,55,1200,900,300,0.75,15,9,6,350.1452670801708,0.4244248035914702,0.3506755973350697,0.18754759365991486,127818.28826727445,-2049.00626338499,125769.28200388946,2484,0,644.3454545454546,41,14,12,38.34565796788647,0.5896849593495934,47.19742063492063,1011.210317460317,24.663666279519926,0
2509,4,3,3,49,0.057692307692307696,0.057692307692307696,0.9423076923076923,52,1400,1100,300,0.7857142857142857,17,11,6,367.0189244087446,0.4238153594771242,0.34765911051081355,0.19515168230372723,127523.29082657606,-1039.3077927533095,126483.98303382275,2485,0,681.0769230769231,38,14,13,38.22169628375996,0.5915570175438596,47.48931623931624,1010.0427350427349,26.580071974808813,0
2510,4,2,0,51,0.0392156862745098,0.0,1.0,51,1400,900,500,0.6428571428571429,19,9,10,363.5353748447835,0.42027777777777775,0.3253589968186077,0.18411767123627565,125533.51379874995,-1050.8871660384743,124482.62663271147,2486,0,695.3921568627451,42,9,15,40.359295429639644,0.5649801587301587,49.467054263565885,1002.1317829457355,23.860280546327036,8
2511,4,3,2,52,0.05555555555555555,0.037037037037037035,0.962962962962963,54,1450,900,550,0.6206896551724138,20,9,11,349.04942871990295,0.42948549965059396,0.3204800907704852,0.17921429161091257,126097.48389445915,-1989.9027411483808,124107.58115331076,2487,0,657.7037037037037,38,16,17,40.14045491614367,0.5770285087719298,48.904914529914535,1004.3803418803427,26.431061628430072,0
2512,4,1,0,53,0.018867924528301886,0.0,1.0,53,1400,1100,300,0.7857142857142857,17,11,6,360.29156575961565,0.4273403483309144,0.33007332948834156,0.18499275461648415,126098.8958140966,-1513.5262773161007,124585.3695367805,2488,0,671.0943396226415,37,16,18,39.856713973799124,0.5788288288288288,48.90350877192982,1004.3859649122803,27.14556661925082,0
2513,4,4,5,52,0.07017543859649122,0.08771929824561403,0.9122807017543859,57,1050,600,450,0.5714285714285714,15,6,9,337.6278875964688,0.43273548454469507,0.33097649402860885,0.17687619159272983,126921.08464222436,-2829.580460158613,124091.50418206575,2489,0,624.9298245614035,42,15,14,39.5809292560182,0.5791170634920635,48.086240310077535,1007.6550387596926,23.99178663713554,0
2514,4,6,4,54,0.10344827586206896,0.06896551724137931,0.9310344827586207,58,2050,1700,350,0.8292682926829268,24,17,7,339.46901748988176,0.43420422464206493,0.37075816281578566,0.18075316030353042,127579.22620670559,-2937.8160228515817,124641.41018385401,2490,0,615.0,40,18,15,38.86010797035845,0.5888020833333334,47.43394308943089,1010.2642276422758,25.256605691056897,0
2515,4,1,0,55,0.01818181818181818,0.0,1.0,55,1700,1500,200,0.8823529411764706,19,15,4,363.65461680659956,0.42695005611672276,0.3879472395545376,0.19288777140294758,127423.91889812255,-1732.3407202216044,125691.57817790094,2491,0,649.4545454545455,37,18,16,38.40863017665797,0.5923423423423423,47.58771929824562,1009.6491228070179,27.2878141299194,0
2516,4,2,0,57,0.03508771929824561,0.0,1.0,57,1450,900,550,0.6206896551724138,20,9,11,350.5976797354943,0.4308035714285714,0.38887069108225303,0.18920119639897046,128118.80845561503,-2416.3686049970274,125702.439850618,2492,0,627.6315789473684,40,17,18,38.02679348189787,0.5942708333333333,46.90040650406504,1012.3983739837397,25.30995934959349,0
2517,4,3,4,56,0.05,0.06666666666666667,0.9333333333333333,60,1100,700,400,0.6363636363636364,15,7,8,326.2022449082,0.4363877118644068,0.37152325620221016,0.1784370964886883,128659.52934967614,-3606.186793575253,125053.34255610089,2493,0,597.2,40,20,15,38.09330027713779,0.5997395833333332,46.36686991869919,1014.5325203252034,25.363313008130085,0
2518,4,2,1,57,0.034482758620689655,0.017241379310344827,0.9827586206896551,58,1500,1200,300,0.8,18,12,6,340.6950864577983,0.4334165154264973,0.39068947806528187,0.18580765639589178,128540.34423828125,-2841.3872612847213,125698.95697699653,2494,0,618.7413793103449,39,19,16,37.84722222222223,0.6001602564102565,46.484375,1014.0625,26.001602564102566,0
2519,4,2,0,59,0.03389830508474576,0.0,1.0,59,1850,1200,650,0.6486486486486487,25,12,13,336.2933047676585,0.43283654782778097,0.4020543624572217,0.18518744275989857,128924.17332963255,-3128.732737307907,125795.44059232465,2495,0,609.2203389830509,41,18,18,37.56787063267234,0.6008638211382115,46.106150793650784,1015.575396825395,24.770131629887683,0
2520,4,1,0,60,0.016666666666666666,0.0,1.0,60,1900,1300,600,0.6842105263157895,25,13,12,327.8770064448288,0.435463747645951,0.3974084191356726,0.1820731241156286,129255.70371283485,-3522.814490276745,125732.88922255811,2496,0,600.05,38,22,19,37.444622469706516,0.6091008771929827,45.779914529914514,1016.8803418803396,26.76000899685104,0
2521,4,1,0,61,0.01639344262295082,0.0,1.0,61,1800,1200,600,0.6666666666666666,24,12,12,317.64156318102334,0.4360200364298725,0.3940283367690849,0.178007184735674,129614.99851278991,-3965.777852138291,125649.22066065163,2497,0,591.1967213114754,40,21,16,37.34052727877579,0.609375,45.42682926829268,1018.2926829268285,25.457317073170714,0
2522,4,0,1,60,0.0,0.01639344262295082,0.9836065573770492,61,1750,1000,750,0.5714285714285714,25,10,15,319.75133155690264,0.4357581967213115,0.3896720984456803,0.1799004966436311,129770.27253123141,-3901.1565123273194,125869.1160189041,2498,1,592.1967213114754,40,21,17,37.12950495378681,0.6109375000000001,45.27439024390244,1018.9024390243903,25.47256097560976,0
2523,4,1,3,58,0.01639344262295082,0.04918032786885246,0.9508196721311475,61,1400,900,500,0.6428571428571429,19,9,10,320.9348587192093,0.4384448998178507,0.3907659471970675,0.18132201995917052,129933.65698420563,-3859.952030580758,126073.70495362488,2499,0,586.6229508196722,41,20,17,36.93390986344913,0.6110264227642277,45.1140873015873,1019.54365079365,24.866918312040244,0
2524,4,1,1,58,0.01694915254237288,0.01694915254237288,0.9830508474576272,59,1750,1400,350,0.8,21,14,7,340.8985576193737,0.43700077927138126,0.40215480283727323,0.19225892716458615,129864.1289605034,-2945.901150173614,126918.22781032979,2500,0,607.1016949152543,39,20,18,36.495592743995914,0.6135149572649572,45.182291666666664,1019.2708333333327,26.135149572649556,0
2525,4,0,1,57,0.0,0.017241379310344827,0.9827586206896551,58,1700,1400,300,0.8235294117647058,20,14,6,351.1615152861272,0.4359119782214156,0.37369872798285764,0.20171784257828398,130578.91506371224,-2427.311009674175,128151.60405403806,2501,1,617.7241379310345,36,22,16,35.50917254297046,0.6261574074074074,44.481981981981974,1022.072072072071,28.390890890890862,4
2526,4,1,2,56,0.017241379310344827,0.034482758620689655,0.9655172413793104,58,1800,1300,500,0.7222222222222222,23,13,10,346.5889162905951,0.43637200040330715,0.37233397874573226,0.20064316171363725,130878.94833025543,-2527.761426592801,128351.18690366263,2502,0,618.5172413793103,37,21,17,35.322456779539934,0.6272522522522522,44.18859649122807,1023.2456140350874,27.655286865813174,0
2527,4,0,1,55,0.0,0.017857142857142856,0.9821428571428571,56,1700,1300,400,0.7647058823529411,21,13,8,360.8556414861018,0.4310267857142857,0.3958707252000968,0.2079686622654737,130706.03358892756,-1766.798080632709,128939.23550829485,2503,3,641.5,35,21,17,35.132640067911716,0.6294642857142856,44.35763888888889,1022.5694444444451,29.21626984126986,0
2528,4,0,0,55,0.0,0.0,1.0,55,1350,1100,250,0.8148148148148148,16,11,5,366.4708758845866,0.4293771043771044,0.3992548603892434,0.21088190532172996,130646.86381440758,-1424.3458772719473,129222.51793713564,2504,7,654.1090909090909,35,20,18,35.04908204083173,0.6288690476190476,44.41550925925926,1022.337962962963,29.209656084656086,0
2529,4,0,0,55,0.0,0.0,1.0,55,1150,900,250,0.782608695652174,14,9,5,385.49795075702224,0.42930695847362516,0.39916532146934913,0.20845779117048358,128200.04712988615,-1044.9276582520354,127155.11947163411,2505,8,655.1090909090909,37,18,16,37.06014508445215,0.6002252252252251,46.82017543859649,1012.7192982456143,27.37079184447606,8
2530,4,1,1,55,0.017857142857142856,0.017857142857142856,0.9821428571428571,56,2050,1400,650,0.6829268292682927,27,14,13,380.30660862344496,0.430762987012987,0.4010467095032715,0.2078241164295796,128619.58007812512,-1417.0247395833194,127202.5553385418,2506,0,644.3928571428571,39,17,15,36.76191209693983,0.6009615384615383,46.40625000000001,1014.3750000000009,26.009615384615408,0
2531,4,4,1,58,0.06779661016949153,0.01694915254237288,0.9830508474576272,59,2000,1600,400,0.8,24,16,8,364.67926521617477,0.43484560685758816,0.4168491690876781,0.20377122344366538,129500.26167223672,-2349.536209502168,127150.72546273455,2507,0,612.5593220338983,38,21,15,36.259884188796754,0.6115679824561404,45.53952991452991,1017.8418803418795,26.785312640575775,0
2532,4,0,1,57,0.0,0.017241379310344827,0.9827586206896551,58,1350,1000,350,0.7407407407407407,17,10,7,369.0147601097747,0.43408449284129863,0.4247777253491565,0.20594263310756558,129452.33298947736,-2046.0356792474824,127406.29731022989,2508,1,624.1206896551724,37,21,16,36.19839367165895,0.6128941441441442,45.586622807017534,1017.6535087719285,27.504148885727798,0
2533,4,1,1,57,0.017241379310344827,0.017241379310344827,0.9827586206896551,58,1900,1600,300,0.8421052631578947,22,16,6,364.11022861086445,0.43513687235329707,0.4085331442545619,0.20415874700698572,129636.22708013715,-2159.624744320278,127476.60233581687,2509,0,624.5862068965517,38,20,16,36.13595432927682,0.6129385964912282,45.405982905982896,1018.3760683760669,26.799370220422812,0
2534,4,1,1,57,0.017241379310344827,0.017241379310344827,0.9827586206896551,58,1500,1000,500,0.6666666666666666,20,10,10,362.37911224455996,0.433145543456342,0.41118803714070173,0.20395814015974,129784.51063368039,-2193.7608506944594,127590.74978298593,2510,0,625.5689655172414,39,19,16,36.029186260478426,0.6127136752136753,45.26041666666666,1018.958333333332,26.127136752136717,0
2535,4,0,0,57,0.0,0.0,1.0,57,1700,1300,400,0.7647058823529411,21,13,8,372.6977225462237,0.43273548454469507,0.4120479489231741,0.20940912106530568,129717.84056770016,-1730.8912493608195,127986.94931833934,2511,4,637.5438596491229,38,19,16,35.83420730641497,0.6137609649122808,45.32585470085469,1018.6965811965796,26.807804768331042,0
2536,4,3,1,59,0.05,0.016666666666666666,0.9833333333333333,60,950,700,250,0.7368421052631579,12,7,5,357.3821537696337,0.43782368173258,0.41552896139673035,0.20465454988762607,130458.54403518385,-2670.723201317172,127787.82083386667,2512,0,606.6166666666667,37,23,19,35.47223265715001,0.6230292792792793,44.59978070175438,1021.600877192982,27.610834518729245,0
2537,4,0,0,59,0.0,0.0,1.0,59,1550,1200,350,0.7741935483870968,19,12,7,367.48275012116915,0.43556399766218584,0.4278405658935609,0.21028681204722416,130430.54112803932,-2213.805209295177,128216.73591874413,2513,1,617.8983050847457,37,22,19,35.24268283955919,0.6227477477477478,44.62719298245614,1021.4912280701748,27.607871028923643,0
2538,4,0,0,59,0.0,0.0,1.0,59,1800,1200,600,0.6666666666666666,24,12,12,367.2959188687222,0.43571011104617186,0.4255353063067855,0.211493498409968,130671.89554569348,-2200.949211045377,128470.9463346481,2514,2,618.8983050847457,38,21,16,35.00261233019854,0.6233552631578948,44.391025641025635,1022.4358974358963,26.90620782726043,0
2539,4,0,1,58,0.0,0.01694915254237288,0.9830508474576272,59,1850,1400,450,0.7567567567567568,23,14,9,370.63994572898446,0.4349673680109098,0.43081219999150444,0.2143265773128472,130835.79881656784,-2101.405325443809,128734.39349112404,2515,3,619.8983050847457,38,21,17,34.75093984962405,0.6250000000000002,44.23076923076922,1023.0769230769214,26.923076923076877,0
2540,4,0,1,57,0.0,0.017241379310344827,0.9827586206896551,58,1400,1000,400,0.7142857142857143,18,10,8,378.73302019188696,0.4338387275660415,0.42799580055598363,0.21861519878402919,130766.77439212025,-1694.860918744271,129071.91347337597,2516,4,631.448275862069,37,21,18,34.61397584333906,0.6261261261261263,44.29824561403507,1022.8070175438564,27.643432906590714,0
2541,4,1,2,56,0.017241379310344827,0.034482758620689655,0.9655172413793104,58,1350,800,550,0.5925925925925926,19,8,11,349.662048204034,0.4359119782214156,0.32495932048368736,0.1896911736129751,128329.16802300364,-2605.4094844687597,125723.75853853488,2517,0,630.6379310344828,39,19,18,37.835513690415,0.5980235042735043,46.69270833333334,1013.2291666666681,25.980235042735078,8
2542,4,0,1,55,0.0,0.017857142857142856,0.9821428571428571,56,1000,700,300,0.7,13,7,6,359.42920925724025,0.43390151515151515,0.34020602610901496,0.19436113446720538,128200.04712988604,-1984.231686672833,126215.8154432132,2518,1,653.3214285714286,37,19,18,37.720153024397284,0.6002252252252254,46.820175438596486,1012.7192982456133,27.370791844476038,0
2543,4,3,1,57,0.05172413793103448,0.017241379310344827,0.9827586206896551,58,1750,1200,550,0.6857142857142857,23,12,11,351.4951952047606,0.4372857430933656,0.35619504255055623,0.19297581280396606,128804.55864800366,-2545.1633029513678,126259.3953450523,2519,0,631.6379310344828,39,19,17,37.303852402941686,0.6028311965811965,46.22395833333334,1015.1041666666682,26.028311965812005,0
2544,4,3,3,57,0.05,0.05,0.95,60,1500,800,700,0.5333333333333333,22,8,14,345.2098803439329,0.4385298964218456,0.3655909923499625,0.1926574202929668,129452.33298947733,-3059.913717441928,126392.4192720354,2520,0,611.5333333333333,37,23,14,36.804021657149015,0.6128941441441442,45.586622807017534,1017.6535087719283,27.50414888572779,0
2545,4,0,0,57,0.0,0.0,1.0,57,1400,900,500,0.6428571428571429,19,9,10,367.94205785938095,0.4356072472848789,0.3889118494426578,0.2044975877552421,129289.65627411254,-1885.7795621142122,127403.87671199832,2521,1,644.2631578947369,35,22,19,36.391473199044036,0.6151785714285715,45.74652777777777,1017.013888888888,29.05753968253966,0
2546,4,1,0,58,0.017241379310344827,0.0,1.0,58,1550,900,650,0.5806451612903226,22,9,13,359.95818458817797,0.43701477112321035,0.38367882165483724,0.20224731290587925,129717.10519641252,-2261.4532606931375,127455.65193571939,2522,0,634.1379310344828,36,22,16,36.1593982607414,0.6174768518518519,45.32657657657657,1018.6936936936928,28.297047047047023,0
2547,4,1,0,59,0.01694915254237288,0.0,1.0,59,1250,800,450,0.64,17,8,9,353.5945773665643,0.4389246054938632,0.385954133409097,0.20006284771569965,129990.07100819987,-2607.2431560011855,127382.82785219868,2523,0,624.3728813559322,38,21,17,36.044176706827294,0.6165021929824562,45.058760683760674,1019.7649572649561,26.835919928025163,0
2548,4,0,1,58,0.0,0.01694915254237288,0.9830508474576272,59,1600,1200,400,0.75,20,12,8,353.5945773665643,0.43898548607052407,0.385954133409097,0.20006284771569965,129990.07100819987,-2607.2431560011855,127382.82785219868,2524,1,625.3728813559322,38,21,17,36.044176706827294,0.6165021929824562,45.058760683760674,1019.7649572649561,26.835919928025163,0
2549,4,1,1,58,0.01694915254237288,0.01694915254237288,0.9830508474576272,59,1300,1000,300,0.7692307692307693,16,10,6,347.8362130666405,0.4401056886810832,0.38378369030760595,0.19833634359798505,130292.12648158838,-2734.794599025455,127557.33188256292,2525,0,603.8983050847457,35,24,18,35.884654989986004,0.6252976190476192,44.76273148148147,1020.9490740740719,29.16997354497348,0
2550,4,1,2,57,0.01694915254237288,0.03389830508474576,0.9661016949152542,59,1500,1100,400,0.7333333333333333,19,11,8,342.06639080722215,0.44051967660237673,0.38830698914492445,0.19678572216400242,130636.47050766963,-2862.730805129484,127773.73970254014,2526,0,604.6610169491526,36,23,13,35.68333700521407,0.6267361111111112,44.42567567567566,1022.2972972972957,28.397147147147102,0
2551,4,0,1,56,0.0,0.017543859649122806,0.9824561403508771,57,1450,1200,250,0.8275862068965517,17,12,5,356.31326715242807,0.43782633667502086,0.39410297305034114,0.20381118881118857,130414.54081632636,-2106.3137755102266,128308.22704081614,2527,2,626.5438596491229,34,23,20,35.544143356643346,0.6286764705882355,44.64285714285713,1021.4285714285701,30.04201680672265,0
2552,4,0,0,56,0.0,0.0,1.0,56,900,600,300,0.6666666666666666,12,6,6,363.3354502546837,0.43773674242424243,0.39702516672095456,0.20751708752380243,130356.43029423773,-1727.3775410899736,128629.05275314776,2528,3,624.0714285714286,33,23,20,35.42379195167806,0.6303661616161617,44.69975490196078,1021.2009803921563,30.945484254307768,0
2553,4,1,1,56,0.017543859649122806,0.017543859649122806,0.9824561403508771,57,1550,1200,350,0.7741935483870968,19,12,7,355.1755841235785,0.4383876357560568,0.3894486584399415,0.20438214557417383,130646.86381440745,-2119.484766160852,128527.3790482466,2529,0,614.1052631578947,35,22,15,35.337772180082275,0.6288690476190477,44.41550925925925,1022.3379629629619,29.209656084656054,0
2554,4,0,0,56,0.0,0.0,1.0,56,1350,1000,350,0.7407407407407407,17,10,7,363.6762662185572,0.43722267316017316,0.40052209002412864,0.20884018364456952,130566.58340419503,-1703.2064909297044,128863.37691326533,2530,5,626.0714285714286,34,22,16,35.2019025431955,0.6302083333333333,44.49404761904762,1022.0238095238096,30.059523809523814,0
2555,4,1,1,56,0.017543859649122806,0.017543859649122806,0.9824561403508771,57,2200,1700,500,0.7727272727272727,27,17,10,355.82663249369256,0.4378654970760234,0.38952425623415987,0.20638852984908596,130953.25213304539,-2080.6690558801824,128872.58307716521,2531,0,616.0701754385965,36,21,16,35.01095646752485,0.6299189814814814,44.115990990991,1023.5360360360376,28.4315565565566,0
2556,4,1,1,56,0.017543859649122806,0.017543859649122806,0.9824561403508771,57,2050,1700,350,0.8292682926829268,24,17,7,364.732775352485,0.43853122389306604,0.4013623153189123,0.21282707231440362,131183.87972009153,-1830.5878936368983,129353.29182645463,2532,0,617.0526315789474,36,21,18,34.549622586200584,0.6322337962962964,43.89076576576576,1024.4369369369356,28.456581581581545,0
2557,4,0,0,56,0.0,0.0,1.0,56,1400,1000,400,0.7142857142857143,18,10,8,367.77714092905126,0.43627570346320343,0.4060153394405619,0.21431105885329138,131131.5155264117,-1554.5652268005815,129576.95029961113,2533,1,628.9107142857143,37,19,18,34.52465385576134,0.6297860360360361,43.94188596491227,1024.2324561403489,27.681958274063483,0
2558,4,0,0,56,0.0,0.0,1.0,56,1450,1000,450,0.6896551724137931,19,10,9,368.0895706617003,0.4363839285714286,0.4058644734489547,0.2146741364662031,131163.91354372105,-1543.986275476676,129619.92726824437,2534,2,629.9107142857143,38,18,18,34.483860033375045,0.6282894736842106,43.9102564102564,1024.358974358973,26.956815114709816,0
2559,4,1,1,56,0.017543859649122806,0.017543859649122806,0.9824561403508771,57,1450,1100,350,0.7586206896551724,18,11,7,359.06404358195715,0.4384659565580618,0.4028120843625309,0.21161859589830245,131565.50068587108,-1951.5009516968184,129613.99973417427,2535,0,619.8421052631579,35,22,16,34.30919073405537,0.638095238095238,43.51851851851852,1025.925925925926,29.312169312169317,0
2560,4,0,0,56,0.0,0.0,1.0,56,1550,1100,450,0.7096774193548387,20,11,9,366.71933622023084,0.43643127705627704,0.41062721814985603,0.21547887873131452,131450.17715419506,-1558.935657596357,129891.2414965987,2536,4,631.9107142857143,34,22,19,34.2294036839254,0.6390931372549019,43.63095238095239,1025.476190476191,30.161064425770324,0
2561,4,1,1,56,0.017543859649122806,0.017543859649122806,0.9824561403508771,57,1700,1200,500,0.7058823529411765,22,12,10,357.63083282888334,0.43725198412698413,0.40553192246765013,0.2119267279909838,131773.38023244613,-1974.7552565586284,129798.6249758875,2537,0,621.8070175438596,35,22,17,34.136159959418315,0.6401785714285714,43.31597222222223,1026.7361111111122,29.33531746031749,0
2562,4,0,0,56,0.0,0.0,1.0,56,950,600,350,0.631578947368421,13,6,7,367.0643999547805,0.4355181277056277,0.40650894928737125,0.21671884435686367,131633.3616780046,-1536.415816326523,130096.94586167809,2538,1,633.5892857142857,34,22,17,34.035431167826765,0.6409313725490196,43.452380952380956,1026.1904761904768,30.18207282913167,0
2563,4,0,0,56,0.0,0.0,1.0,56,1500,700,800,0.4666666666666667,23,7,16,363.80782546096424,0.43563988095238093,0.39883172444054416,0.21535533356507472,131732.4334469605,-1614.9419689960177,130117.49147796448,2539,2,634.5892857142857,36,20,18,34.01894105601871,0.6377314814814814,43.35585585585586,1026.5765765765768,28.516016016016025,0
2564,4,0,0,56,0.0,0.0,1.0,56,1350,900,450,0.6666666666666666,18,9,9,363.6551956745574,0.43509199134199134,0.39487216643428913,0.21575613073235453,131819.1518165125,-1612.6561105023877,130206.4957060101,2540,3,635.5892857142857,36,20,19,33.93532733852395,0.638599537037037,43.2713963963964,1026.9144144144148,28.52540040040041,0
2565,4,0,0,56,0.0,0.0,1.0,56,1600,1100,500,0.6875,21,11,10,363.2251571220668,0.4347334956709957,0.38961957101696787,0.21638798139802212,131975.16453379884,-1612.660025200057,130362.5045085988,2541,4,636.5892857142857,37,19,19,33.78897218368728,0.6382319819819819,43.11951754385965,1027.5219298245613,27.770862968231388,0
2566,4,1,0,57,0.017543859649122806,0.0,1.0,57,1500,1200,300,0.8,18,12,6,357.51016043020576,0.4357638888888889,0.395725061797886,0.2150643569708502,132343.03232750748,-1937.2042561545786,130405.8280713529,2542,0,626.4035087719299,38,19,20,33.56522341051466,0.6400767543859649,42.761752136752136,1028.9529914529915,27.07771030139451,0
2567,4,0,0,57,0.0,0.0,1.0,57,1650,900,750,0.5454545454545454,24,9,15,356.0368974713786,0.4356464076858814,0.3919881761296018,0.21465549095569944,132426.97934420922,-1970.198998007803,130456.78034620141,2543,1,627.4035087719299,36,21,21,33.5186451495259,0.6446759259259258,42.68018018018019,1029.2792792792804,28.591091091091123,0
2568,4,0,0,57,0.0,0.0,1.0,57,1950,1400,550,0.717948717948718,25,14,11,354.73136532692797,0.4356203007518797,0.38852435112277584,0.21452801617390418,132542.9145361579,-1996.5741924356676,130546.34034372224,2544,2,628.4035087719299,36,21,22,33.43563174394867,0.6458333333333334,42.56756756756757,1029.7297297297307,28.60360360360363,0
2569,4,0,0,57,0.0,0.0,1.0,57,2250,1900,350,0.8444444444444444,26,19,7,354.37584373133313,0.43468045112781956,0.38889751418861795,0.21580852279926124,132803.95418645017,-1987.497336863866,130816.4568495863,2545,3,629.4035087719299,36,21,17,33.1824265268218,0.6484375,42.3141891891892,1030.743243243245,28.631756756756804,0
2570,4,0,1,56,0.0,0.017543859649122806,0.9824561403508771,57,1400,1100,300,0.7857142857142857,17,11,6,352.5701586080104,0.434484649122807,0.38765108489879174,0.21520882481432954,132891.0244704164,-2029.3180849768592,130861.70638543954,2546,4,630.4035087719299,36,21,17,33.14151922236787,0.6493055555555556,42.22972972972973,1031.0810810810813,28.641141141141148,0
2571,4,0,1,55,0.0,0.017857142857142856,0.9821428571428571,56,1300,900,400,0.6923076923076923,17,9,8,364.32791279966233,0.43302218614718613,0.39112525744242643,0.22238575797291388,132891.02447041633,-1516.818084976875,131374.20638543947,2547,5,640.4464285714286,36,20,17,32.83843927479247,0.6493055555555556,42.229729729729726,1031.0810810810808,28.641141141141134,0
2572,4,0,0,55,0.0,0.0,1.0,55,1250,900,350,0.72,16,9,7,348.5997397126707,0.4318322109988777,0.31100948975381604,0.2039154229646688,131278.46884201694,-1836.9713563370576,129441.49748567988,2548,6,652.9090909090909,42,13,20,34.8672702344932,0.6230158730158729,43.79844961240311,1024.8062015503895,24.400147655961653,6
2573,4,0,0,55,0.0,0.0,1.0,55,1400,1000,400,0.7142857142857143,18,10,8,348.6559517366494,0.4318181818181818,0.3110009910802771,0.20476941519341071,131432.3123223612,-1835.049632740178,129597.26268962101,2549,7,653.9090909090909,40,15,20,34.71052196894614,0.6276041666666666,43.648373983739845,1025.4065040650419,25.635162601626046,0
2574,4,0,0,55,0.0,0.0,1.0,55,1250,700,550,0.56,18,7,11,350.20440066957826,0.43162177328844,0.3101714450367383,0.20652240824533075,131588.6707647564,-1783.4136839844075,129805.25708077197,2550,8,654.9090909090909,40,15,19,34.51304972266243,0.6291666666666667,43.49593495934959,1026.0162601626014,25.650406504065035,0
2575,4,0,1,54,0.0,0.01818181818181818,0.9818181818181818,55,1900,1600,300,0.8421052631578947,22,16,6,352.23861324871257,0.43162177328844,0.31242784469806795,0.20838267188590223,131709.72620819163,-1721.349737811793,129988.37647037984,2551,9,655.9090909090909,41,14,19,34.3387576109017,0.6288109756097562,43.37797619047619,1026.4880952380954,25.036295005807204,0
2576,4,0,0,54,0.0,0.0,1.0,54,1450,800,650,0.5517241379310345,21,8,13,356.534230033277,0.4300751222921034,0.3173335623103781,0.21163086865277983,131837.04963466854,-1399.1158037289167,130437.93383093963,2552,10,668.2407407407408,41,13,19,34.10009337970118,0.6300813008130082,43.253968253968246,1026.9841269841259,25.048393341076242,0
2577,4,0,0,54,0.0,0.0,1.0,54,1250,800,450,0.64,17,8,9,334.04240056158176,0.43009696016771487,0.2636431003110875,0.19699135958351247,131588.67076475662,-1997.4919310239345,129591.17883373269,2553,11,669.2407407407408,40,14,15,34.9276115953513,0.6291666666666667,43.495934959349604,1026.0162601626032,25.65040650406508,2
2578,4,0,0,54,0.0,0.0,1.0,54,1250,700,550,0.56,18,7,11,334.0417606117045,0.4298203470766364,0.2628382838283827,0.19753054930785827,131692.9613655895,-2001.8102650538476,129691.15110053564,2554,12,670.2407407407408,40,14,15,34.82260726072608,0.6302083333333333,43.39430894308944,1026.422764227644,25.6605691056911,0
2579,4,1,2,53,0.01818181818181818,0.03636363636363636,0.9636363636363636,55,1300,1000,300,0.7692307692307693,16,10,6,323.02262827305424,0.43013468013468015,0.25259764754295144,0.19243437922513876,131974.50949462186,-2473.8494156000056,129500.66007902185,2555,0,659.0363636363636,42,13,16,34.822354771784255,0.6299603174603173,43.1201550387597,1027.5193798449625,24.464747139165773,0
2580,4,0,0,53,0.0,0.0,1.0,53,1850,1500,350,0.8108108108108109,22,15,7,332.53872439337505,0.4289580309627479,0.25249222783415726,0.1973167240161511,131823.38271077065,-1832.7240936281312,129990.65861714252,2556,14,681.433962264151,40,13,17,34.72991918192315,0.6315104166666667,43.267276422764226,1026.9308943089425,25.67327235772356,0
2581,4,0,0,53,0.0,0.0,1.0,53,1400,900,500,0.6428571428571429,19,9,10,333.36159901915937,0.42885220125786166,0.25121155177529375,0.19862222319874617,131979.97352972775,-1800.5889971247223,130179.38453260303,2557,15,682.433962264151,40,13,17,34.55127254145649,0.6330729166666667,43.114837398373986,1027.5406504065047,25.68851626016262,0
2582,4,1,0,54,0.018518518518518517,0.0,1.0,54,1500,1000,500,0.6666666666666666,20,10,10,327.36093154178633,0.4284227230375029,0.2480824441873417,0.19694823561203056,132346.95845930962,-2134.9552784076595,130212.00318090196,2558,0,670.7777777777778,41,13,18,34.33683635428719,0.6351626016260162,42.757936507936506,1028.9682539682537,25.09678668215253,0
2583,4,0,0,54,0.0,0.0,1.0,54,1300,1000,300,0.7692307692307693,16,10,6,355.64430030324485,0.42810971348707194,0.2785007229451675,0.20469305284120112,130654.64854570657,-1460.7614832123254,129193.88706249425,2559,1,671.7777777777778,37,17,16,35.317907192907214,0.6249999999999998,44.40789473684212,1022.3684210526332,27.631578947368464,7
2584,4,0,0,54,0.0,0.0,1.0,54,1000,600,400,0.6,14,6,8,356.60213787067386,0.4279932448171442,0.2817756656860524,0.2059901761111778,130794.81336805575,-1471.6579861110924,129323.15538194466,2560,2,672.7777777777778,37,17,17,35.151476578411405,0.6264076576576575,44.27083333333334,1022.9166666666682,27.646396396396437,0
2585,4,0,0,54,0.0,0.0,1.0,54,1100,700,400,0.6363636363636364,15,7,8,356.20605160237477,0.42745457721872815,0.28358813163785257,0.2062106000963628,130878.94833025581,-1476.0253154816482,129402.92301477416,2561,3,673.7777777777778,37,17,17,35.07643949135593,0.627252252252252,44.18859649122809,1023.2456140350905,27.655286865813256,0
2586,4,0,0,54,0.0,0.0,1.0,54,1200,800,400,0.6666666666666666,16,8,8,356.20605160237477,0.427243477754484,0.28358813163785257,0.2062106000963628,130878.94833025581,-1476.0253154816482,129402.92301477416,2562,4,674.7777777777778,37,17,17,35.07643949135593,0.627252252252252,44.18859649122809,1023.2456140350905,27.655286865813256,0
2587,4,0,0,54,0.0,0.0,1.0,54,1050,600,450,0.5714285714285714,15,6,9,354.45431494610784,0.4273381085488004,0.28507383048566814,0.20540338069381603,130917.7889751813,-1519.1249589085623,129398.66401627274,2563,5,675.7777777777778,38,16,17,35.08195009917528,0.6258223684210524,44.15064102564105,1023.3974358974399,26.93151147098526,0
2588,4,1,3,52,0.01818181818181818,0.05454545454545454,0.9454545454545454,55,1750,1200,550,0.6857142857142857,23,12,11,349.5595322751156,0.42944725028058356,0.28348492360391186,0.20460289512446603,131302.0846243146,-1820.4209423953575,129481.66368191924,2564,0,664.4727272727273,40,15,17,34.818831598082966,0.6263020833333331,43.77540650406506,1024.8983739837429,25.622459349593573,0
2589,4,1,1,52,0.018867924528301886,0.018867924528301886,0.9811320754716981,53,850,400,450,0.47058823529411764,13,4,9,349.32910304712806,0.43080249153362365,0.26905967172879275,0.20460704607046076,131328.12500000012,-1424.6527777777628,129903.47222222235,2565,0,636.4905660377359,38,15,17,34.79844173441735,0.6299342105263157,43.75000000000001,1025.000000000001,26.97368421052634,0
2590,4,0,0,52,0.0,0.0,1.0,52,1350,1100,250,0.8148148148148148,16,11,5,351.8020497766922,0.4272640145801911,0.26847141622422543,0.20560288650176314,131243.8457626387,-1165.6292080255237,130078.21655461317,2566,8,649.7307692307693,37,15,17,34.82020242553952,0.6309121621621621,43.832236842105274,1024.6710526315803,27.693812233285954,0
2591,4,0,0,52,0.0,0.0,1.0,52,1000,600,400,0.6,14,6,8,350.5203288897435,0.4272247360482655,0.26738226620133676,0.20545953341167655,131356.98356718212,-1191.3143320205372,130165.66923516158,2567,9,650.7307692307693,36,16,17,34.73877659379691,0.6339699074074073,43.72184684684685,1025.1126126126132,28.475350350350368,0
2592,4,0,1,51,0.0,0.019230769230769232,0.9807692307692307,52,1050,600,450,0.5714285714285714,15,6,9,349.5652145195396,0.4265570010055304,0.21488391500014892,0.20366316448644073,131124.83071932488,-1232.6640841521696,129892.1666351727,2568,10,651.7307692307693,41,11,19,34.9977398940979,0.6229674796747966,43.9484126984127,1024.20634920635,24.980642663569515,4
2593,4,1,0,52,0.019230769230769232,0.0,1.0,52,1150,700,450,0.6086956521739131,16,7,9,340.50709106661463,0.42922794117647056,0.20950656069522244,0.1998575609641436,131408.21533203125,-1450.599230215813,129957.61610181544,2569,0,643.3076923076923,39,13,21,34.94372057976904,0.6290064102564104,43.671875,1025.3125,26.290064102564102,0
2594,4,0,0,52,0.0,0.0,1.0,52,1150,500,650,0.43478260869565216,18,5,13,340.5320258200129,0.4291415284062343,0.20606962608790758,0.20029141733714742,131488.330078125,-1444.802517361111,130043.52756076389,2570,1,644.3076923076923,39,13,21,34.86229602545875,0.6298076923076923,43.59375,1025.625,26.298076923076923,0
2595,4,0,0,52,0.0,0.0,1.0,52,1400,1000,400,0.7142857142857143,18,10,8,343.44977316685936,0.4293614881850176,0.20685231612736965,0.20243188605148987,131568.46923828113,-1362.5678168402935,130205.90142144084,2571,2,645.3076923076923,39,13,15,34.706674958540624,0.6306089743589745,43.51562499999999,1025.937499999999,26.30608974358972,0
2596,4,1,1,52,0.018867924528301886,0.018867924528301886,0.9811320754716981,53,1500,800,700,0.5333333333333333,22,8,14,339.6479476272529,0.43021286889211413,0.2017245660116005,0.2018119815795794,131875.56932257587,-1641.7467074823153,130233.82261509355,2572,0,634.1132075471698,40,13,16,34.494863296065425,0.63203125,43.21646341463415,1027.1341463414637,25.678353658536594,0
2597,4,0,0,52,0.0,0.0,1.0,52,1400,900,500,0.6428571428571429,19,9,10,347.4449785863709,0.4280260180995475,0.20217472728123953,0.20608379054780032,131809.03320312488,-1240.7226562500146,130568.31054687487,2573,1,647.25,39,13,18,34.361685940353006,0.6330128205128207,43.28124999999999,1026.874999999999,26.330128205128183,0
2598,4,1,1,52,0.018867924528301886,0.018867924528301886,0.9811320754716981,53,950,600,350,0.631578947368421,13,6,7,342.90936094252504,0.4296232462506047,0.20812909868170726,0.20501602218053086,132110.5368828078,-1539.6120447485027,130570.92483805929,2574,0,636.0188679245283,40,13,18,34.17461611967839,0.6343750000000001,42.98780487804878,1028.0487804878044,25.70121951219511,0
2599,4,0,0,52,0.0,0.0,1.0,52,1750,1200,550,0.6857142857142857,23,12,11,346.7985974893055,0.4275860985419809,0.20764046432942718,0.2070091809695692,132049.81689453128,-1241.0617404513891,130808.75515407989,2575,3,649.25,39,13,18,34.13577666295058,0.6354166666666667,43.046875,1027.8125000000002,26.35416666666667,0
2600,4,0,0,52,0.0,0.0,1.0,52,1200,1000,200,0.8333333333333334,14,10,4,346.1092913112806,0.42753110859728505,0.20655155217553944,0.2073295463486018,132183.6805555554,-1250.0000000000189,130933.68055555537,2576,4,650.25,39,13,19,34.01877363587249,0.6367521367521369,42.91666666666666,1028.333333333332,26.36752136752133,0
2601,4,0,2,50,0.0,0.038461538461538464,0.9615384615384616,52,1100,600,500,0.5454545454545454,16,6,10,347.61306211557115,0.4276096656611363,0.21091522413175245,0.20852559995924339,132237.24500868045,-1206.5212673611202,131030.72374131932,2577,5,651.25,39,13,19,33.92622037674701,0.6372863247863249,42.86458333333333,1028.5416666666658,26.372863247863226,0
2602,4,1,1,50,0.0196078431372549,0.0196078431372549,0.9803921568627451,51,1300,1000,300,0.7692307692307693,16,10,6,343.52848914046,0.4257679738562092,0.22240803355996874,0.2077118932456558,132535.48127145885,-1093.9596160124022,131441.52165544644,2578,0,659.8235294117648,38,13,21,33.73149685273571,0.6419956140350876,42.574786324786324,1029.7008547008547,27.097390913180387,0
2603,4,1,1,50,0.0196078431372549,0.0196078431372549,0.9803921568627451,51,1300,1100,200,0.8461538461538461,15,11,4,339.41608451306126,0.4252124183006536,0.21523027815777507,0.20594018870148328,132666.15125868062,-1194.1948784722124,131471.9563802084,2579,0,660.8039215686274,39,12,14,33.706184698348515,0.641559829059829,42.44791666666667,1030.208333333334,26.415598290598307,0
2604,4,1,1,50,0.0196078431372549,0.0196078431372549,0.9803921568627451,51,1200,700,500,0.5833333333333334,17,7,10,336.87632670201424,0.4254248366013072,0.2152066810148352,0.20498489399690845,132773.48632812503,-1254.3511284722215,131519.1351996528,2580,0,661.7843137254902,39,12,14,33.663920894818396,0.6426282051282051,42.34375,1030.6250000000002,26.426282051282058,0
2605,4,0,0,50,0.0,0.0,1.0,50,1550,1100,450,0.7096774193548387,20,11,9,342.54963610119563,0.4236819727891157,0.21412959857974134,0.20809531218873709,132711.95969867468,-907.9132997884936,131804.0463988862,2581,9,676.02,40,10,14,33.57949501923266,0.6403645833333333,42.40345528455284,1030.386178861788,25.7596544715447,0
2606,4,0,0,50,0.0,0.0,1.0,50,950,600,350,0.631578947368421,13,6,7,345.0582724420269,0.4236139455782313,0.21055900621118062,0.21020576921198036,132816.69439693607,-834.1001759865379,131982.59422094954,2582,10,677.02,40,10,15,33.40974070787737,0.6414062500000002,42.30182926829267,1030.7926829268272,25.769817073170678,0
2607,4,0,0,50,0.0,0.0,1.0,50,1450,1000,450,0.6896551724137931,19,10,9,346.28415367551196,0.42403061224489796,0.21328800867080444,0.21184073994290376,132973.87390318268,-790.6509228964239,132183.22298028626,2583,11,678.02,40,10,16,33.22043222649193,0.64296875,42.14939024390244,1031.4024390243906,25.785060975609763,0
2608,4,0,0,50,0.0,0.0,1.0,50,1300,900,400,0.6923076923076923,17,9,8,328.80991575127143,0.42403061224489796,0.18703653585926916,0.1943924221921516,131684.26890432095,-1339.2492389524161,130345.01966536854,2584,12,679.02,41,9,11,34.96560667568787,0.6285569105691057,43.40277777777778,1026.3888888888887,25.033875338753383,7
2609,4,0,0,50,0.0,0.0,1.0,50,1500,1000,500,0.6666666666666666,20,10,10,330.18033400672306,0.42329931972789114,0.19168356997971614,0.1961191622473668,131862.52170138882,-1292.3177083333385,130570.20399305547,2585,13,680.02,41,9,13,34.751098715348206,0.6303353658536586,43.229166666666664,1027.0833333333328,25.050813008130067,0
2610,4,1,2,49,0.0196078431372549,0.0392156862745098,0.9607843137254902,51,1050,700,350,0.6666666666666666,14,7,7,333.5183800709738,0.42493464052287583,0.20216617166836603,0.2002619413367342,132273.3759990386,-1376.8795820563587,130896.49641698225,2586,0,667.6666666666666,42,9,15,34.25234708615926,0.6329365079365079,42.82945736434109,1028.6821705426362,24.492432631967528,0
2611,4,0,0,49,0.0,0.0,1.0,49,1250,900,350,0.72,16,9,7,333.41468777131104,0.4239477040816326,0.22468063673941563,0.20072609148298354,132372.47973552838,-973.0141998929276,131399.46553563545,2587,1,692.1020408163265,41,8,16,34.15547977120087,0.6354166666666666,42.73313492063492,1029.0674603174598,25.099206349206337,0
2612,4,0,0,49,0.0,0.0,1.0,49,1400,900,500,0.6428571428571429,19,9,10,332.99098355165154,0.42357568027210885,0.22598468768324764,0.20117866023377293,132505.2300347223,-975.3857040501283,131529.84433067217,2588,2,693.1020408163265,39,10,17,34.033117496290295,0.6399572649572649,42.60416666666667,1029.5833333333342,26.399572649572672,0
2613,4,0,0,49,0.0,0.0,1.0,49,1650,1200,450,0.7272727272727273,21,12,9,334.83587408919766,0.4229202097505669,0.22545964796434226,0.2031611530516665,132666.15125868047,-915.7226562500064,131750.42860243047,2589,3,694.1020408163265,39,10,12,33.82414897202562,0.6415598290598291,42.447916666666664,1030.2083333333328,26.415598290598275,0
2614,4,0,1,48,0.0,0.02040816326530612,0.9795918367346939,49,900,600,300,0.6666666666666666,12,6,6,334.66256333856876,0.42279620181405897,0.2217317130025971,0.20349211672455203,132746.64849175353,-914.9332682291582,131831.71522352437,2590,4,695.1020408163265,39,10,12,33.747873075238395,0.642361111111111,42.36979166666667,1030.520833333334,26.423611111111125,0
2615,4,0,0,48,0.0,0.0,1.0,48,2000,1700,300,0.85,23,17,6,338.4363472340325,0.4223274970449173,0.22269891469652947,0.20553401339578153,132700.54879830524,-617.8621977500165,132082.68660055523,2591,5,709.9166666666666,38,10,13,33.69690135490115,0.643640350877193,42.414529914529915,1030.3418803418806,27.114260008996858,0
2616,4,0,0,48,0.0,0.0,1.0,48,1250,1000,250,0.8,15,10,5,338.90714338753963,0.4218934692671395,0.22401015754560505,0.20642526006331993,132810.65088757421,-597.904339250467,132212.74654832375,2592,6,710.9166666666666,38,10,14,33.574315920398014,0.644736842105263,42.30769230769232,1030.7692307692328,27.125506072874547,0
2617,4,0,0,48,0.0,0.0,1.0,48,1550,1200,350,0.7741935483870968,19,12,7,337.4238207420208,0.42191193853427894,0.22394413022253623,0.2063516522030113,132961.427137587,-627.1294487847006,132334.2976888023,2593,7,711.9166666666666,39,9,16,33.46137174696158,0.6444978632478632,42.16145833333334,1031.3541666666683,26.444978632478676,0
2618,4,0,0,48,0.0,0.0,1.0,48,1450,900,550,0.6206896551724138,20,9,11,337.4587608020766,0.4217087765957446,0.22443420831229988,0.20696774153217196,133068.8815646705,-618.9480251735727,132449.93353949694,2594,8,712.9166666666666,39,9,17,33.35278899545684,0.6455662393162391,42.057291666666686,1031.7708333333362,26.455662393162466,0
2619,4,0,0,48,0.0,0.0,1.0,48,1750,1400,350,0.8,21,14,7,339.4322871535033,0.42149638002364065,0.22332240161453032,0.2089300599808214,133203.26063368088,-557.3025173610775,132645.95811631982,2595,9,713.9166666666666,39,9,17,33.167255297679105,0.6469017094017092,41.92708333333335,1032.2916666666692,26.46901709401716,0
2620,4,0,2,46,0.0,0.041666666666666664,0.9583333333333334,48,1450,1100,350,0.7586206896551724,18,11,7,339.08145219304214,0.4213209219858156,0.21818361410941822,0.20916704639636785,133283.92062717033,-561.1789279513692,132722.74169921895,2596,10,714.9166666666666,39,9,17,33.09553532398534,0.6477029914529913,41.84895833333334,1032.6041666666683,26.477029914529957,0
2621,4,0,1,45,0.0,0.021739130434782608,0.9782608695652174,46,1050,700,350,0.6666666666666666,14,7,7,342.7735446531082,0.42143719806763286,0.21933856199744572,0.2118884034339033,133361.84619037167,-57.41745196874956,133304.42873840293,2597,11,731.1521739130435,38,8,18,32.92218314715212,0.6502192982456141,41.773504273504265,1032.9059829059815,27.18173639226267,0
2622,4,0,0,45,0.0,0.0,1.0,45,1100,600,500,0.5454545454545454,16,6,10,350.95013027445026,0.4207281144781145,0.22813682832785043,0.21742295053097568,133443.8977016964,366.4306565481328,133810.32835824453,2598,12,744.4444444444445,37,8,19,32.62882928296012,0.6528716216216217,41.6940789473684,1033.223684210524,27.92496443812227,0
2623,4,0,0,45,0.0,0.0,1.0,45,1050,700,350,0.6666666666666666,14,7,7,348.45414714292485,0.4203914141414142,0.22446889639394296,0.2165511588777863,133559.51126379738,307.8761237829971,133867.38738758038,2599,13,745.4444444444445,36,9,20,32.57753204779025,0.6559606481481483,41.5822072072072,1033.6711711711696,28.713088088088043,0
2624,4,1,1,45,0.021739130434782608,0.021739130434782608,0.9782608695652174,46,1150,1000,150,0.8695652173913043,13,10,3,342.56869891900345,0.4206521739130435,0.22261357929703185,0.21452029274708906,133840.71451071464,-30.072113534954525,133810.64239717968,2600,0,730.2173913043479,37,9,18,32.44840786266823,0.6568130630630632,41.31030701754385,1034.7587719298228,27.96645329540062,0
2625,4,0,0,45,0.0,0.0,1.0,45,1100,800,300,0.7272727272727273,14,8,6,352.5400770341042,0.4198232323232323,0.23084512150888625,0.22099886138768188,133879.8152037171,439.60007304600373,134319.4152767631,2601,15,747.4444444444445,36,9,18,32.15134203844757,0.6591435185185186,41.272522522522515,1034.909909909909,28.74749749749747,0
2626,4,0,0,45,0.0,0.0,1.0,45,1150,600,550,0.5217391304347826,17,6,11,351.2036002051524,0.4199494949494949,0.23170232295417637,0.22077659075479658,133982.577571945,411.03272160662306,134393.61029355164,2602,16,748.4444444444445,37,8,18,32.08315681705852,0.6582207207207208,41.173245614035075,1035.307017543858,27.981270744428592,0
2627,4,0,0,45,0.0,0.0,1.0,45,1500,900,600,0.6,21,9,12,348.00720585383885,0.419212962962963,0.228727293564839,0.21951397922921043,134107.77043839928,334.0940947110644,134441.86453311035,2603,17,749.4444444444445,38,7,18,32.04078562833076,0.6576206140350878,41.05235042735042,1035.790598290597,27.257647323436764,0
2628,4,0,0,45,0.0,0.0,1.0,45,900,500,400,0.5555555555555556,13,5,8,347.2942602459534,0.4183291245791246,0.2270463428252374,0.22010050251256294,134280.73459201396,326.98567708334326,134607.7202690973,2604,18,750.4444444444445,39,6,18,31.886515912897828,0.65758547008547,40.88541666666667,1036.458333333334,26.575854700854716,0
2629,4,0,0,45,0.0,0.0,1.0,45,1250,900,350,0.72,16,9,7,344.8966615316219,0.4183291245791246,0.220221507681315,0.218903799461907,134334.72222222228,266.31944444444974,134601.04166666672,2605,19,751.4444444444445,39,6,18,31.894761521972132,0.6581196581196581,40.833333333333336,1036.666666666667,26.58119658119659,0
2630,4,0,0,45,0.0,0.0,1.0,45,1200,800,400,0.6666666666666666,16,8,8,342.9622338393142,0.4174452861952862,0.2226328769263386,0.21848208332297203,134469.7387695313,223.60839843750108,134693.3471679688,2606,20,752.4444444444445,39,6,18,31.810221452244644,0.6594551282051282,40.703125,1037.1875000000005,26.594551282051295,0
2631,4,0,0,45,0.0,0.0,1.0,45,1350,1000,350,0.7407407407407407,17,10,7,348.0534494659048,0.417192760942761,0.23253761574074105,0.22275420765817908,134638.42220598977,372.3466980758211,135010.7689040656,2607,21,753.4444444444445,36,9,18,31.50996455439815,0.6666666666666666,40.54054054054054,1037.8378378378377,28.828828828828826,0
2632,4,0,0,45,0.0,0.0,1.0,45,1150,800,350,0.6956521739130435,15,8,7,348.77283918273594,0.4163720538720539,0.23464101915127,0.22375343106650264,134726.0916955807,397.7603025322621,135123.85199811295,2608,22,754.4444444444445,36,9,18,31.40389413168457,0.6675347222222222,40.45608108108108,1038.1756756756756,28.838213213213212,0
2633,4,0,1,44,0.0,0.022222222222222223,0.9777777777777777,45,1350,900,450,0.6666666666666666,18,9,9,352.07309098805194,0.41550925925925924,0.23785945763610283,0.2265994499778648,134843.02873397042,494.92038491193426,135337.94911888236,2609,23,755.4444444444445,36,9,18,31.20166070331418,0.6686921296296295,40.343468468468465,1038.6261261261259,28.85072572572572,0
2634,4,0,0,44,0.0,0.0,1.0,44,600,300,300,0.5,9,3,6,356.46110632122014,0.41373766737138834,0.2265583430226834,0.2299797319524178,134930.76480196405,819.5139396152864,135750.27874157933,2610,24,744.4318181818181,36,8,18,31.00025290844714,0.6695601851851853,40.259009009009006,1038.9639639639634,28.860110110110092,0
2635,4,0,0,44,0.0,0.0,1.0,44,1100,800,300,0.7272727272727273,14,8,6,354.69579923181794,0.4126915961945032,0.21815277217096773,0.23014099186980852,135135.5932579539,786.4054510591701,135921.99870901307,2611,25,745.4318181818181,36,8,18,30.842043034044558,0.6715856481481481,40.06193693693694,1039.7522522522524,28.88200700700701,0
2636,4,0,0,44,0.0,0.0,1.0,44,1450,1000,450,0.6896551724137931,19,10,9,354.9835273343065,0.41228417899929526,0.22020229364571486,0.2307018208960115,135194.14420755222,798.3388371479666,135992.48304470017,2612,26,746.4318181818181,36,8,18,30.776258798050897,0.6721643518518519,40.005630630630634,1039.9774774774783,28.888263263263283,0
2637,4,0,0,44,0.0,0.0,1.0,44,1000,600,400,0.6,14,6,8,356.0920171599736,0.4120309196617336,0.2172326724608793,0.23186307253237254,135262.72657211832,833.1954303247092,136095.92200244303,2613,27,747.4318181818181,37,7,18,30.67915305154421,0.6708896396396395,39.93969298245614,1040.241228070175,28.11462778568041,0
2638,4,1,1,44,0.022222222222222223,0.022222222222222223,0.9777777777777777,45,1200,1000,200,0.8333333333333334,14,10,4,350.789632005151,0.4131313131313132,0.22545479414580805,0.23042434857049954,135578.0416757981,511.8742694864491,136089.91594528456,2614,0,731.8,38,7,19,30.503479346190673,0.6721491228070176,39.636752136752136,1041.4529914529915,27.406657669815566,0
2639,4,0,1,43,0.0,0.022727272727272728,0.9772727272727273,44,1500,1000,500,0.6666666666666666,20,10,10,354.5599999999998,0.41216305496828753,0.22199999999999975,0.23326315789473695,135633.68055555574,818.0669698298115,136451.74752538555,2615,1,731.2954545454545,36,8,19,30.350000000000005,0.6765046296296295,39.58333333333334,1041.666666666668,28.935185185185226,0
2640,4,0,0,43,0.0,0.0,1.0,43,1200,800,400,0.6666666666666666,16,8,8,356.4810822022729,0.4112218530823182,0.2337565733059206,0.23531933021622198,135754.2706189987,1078.7658607681824,136833.0364797669,2616,2,746.2093023255813,35,8,20,30.18010513845698,0.6797619047619048,39.467592592592595,1042.1296296296302,29.775132275132293,0
2641,4,0,0,43,0.0,0.0,1.0,43,700,600,100,0.8571428571428571,8,6,2,355.2598485448736,0.41099114064230347,0.23261495551566957,0.23471129392124615,135784.42650730876,1047.750959147802,136832.17746645657,2617,3,747.2093023255813,35,8,20,30.181959096798067,0.6800595238095237,39.438657407407405,1042.24537037037,29.77843915343914,0
2642,4,0,0,43,0.0,0.0,1.0,43,950,700,250,0.7368421052631579,12,7,5,353.4612217598564,0.41064507198228134,0.23142219835598343,0.23411607982446972,135874.91426611805,1005.302640603574,136880.21690672162,2618,4,748.2093023255813,35,8,16,30.13895056246299,0.680952380952381,39.351851851851855,1042.5925925925933,29.78835978835981,0
2643,4,0,0,43,0.0,0.0,1.0,43,800,500,300,0.625,11,5,6,350.3650351634766,0.4100452196382429,0.2291128337639965,0.2325971749569146,135956.46057797672,926.8780182209332,136883.33859619766,2619,5,749.2093023255813,36,7,16,30.138708922722536,0.6796875,39.27364864864865,1042.905405405406,28.969594594594614,0
2644,4,0,0,43,0.0,0.0,1.0,43,1000,400,600,0.4,16,4,12,349.9125264408381,0.4089608711701735,0.2284868032982339,0.23306538874725852,136073.93024358823,922.7945428536685,136996.7247864419,2620,6,750.2093023255813,36,7,16,30.033953948551893,0.6808449074074074,39.16103603603604,1043.3558558558561,28.982107107107115,0
2645,4,0,0,43,0.0,0.0,1.0,43,1050,700,350,0.6666666666666666,14,7,7,350.2639850394903,0.40905315614617943,0.230350467875869,0.23426747051342522,136220.83865960548,942.6507588669679,137163.48941847245,2621,7,751.2093023255813,36,7,17,29.879090255303854,0.6822916666666667,39.02027027027027,1043.9189189189183,28.99774774774773,0
2646,4,1,0,44,0.022727272727272728,0.0,1.0,44,1400,900,500,0.6428571428571429,19,9,10,341.523576711654,0.4089257399577167,0.22149137446000977,0.23074020246578264,136577.61432604239,528.8950686749473,137106.50939471734,2622,0,735.1136363636364,37,7,18,29.753990524144193,0.6838400900900903,38.678728070175424,1045.2850877192964,28.25094831673774,0
2647,4,0,0,44,0.0,0.0,1.0,44,1400,900,500,0.6428571428571429,19,9,10,341.1393861431704,0.40828708597603947,0.2182094704121138,0.2306682913112756,136606.2694771467,520.3557825484638,137126.62525969517,2623,1,736.1136363636364,37,7,18,29.73568281938325,0.6841216216216217,38.65131578947368,1045.3947368421045,28.253911806543364,0
2648,4,0,0,44,0.0,0.0,1.0,44,1150,900,250,0.782608695652174,14,9,5,338.8571994599188,0.40729607117688515,0.21500259348789852,0.23025929230308592,136779.81349170115,469.81300021010077,137249.62649191124,2624,2,737.1136363636364,36,8,18,29.62374851975455,0.6877893518518519,38.48536036036036,1046.0585585585584,29.057182182182178,0
2649,4,0,1,43,0.0,0.022727272727272728,0.9772727272727273,44,1400,1200,200,0.8571428571428571,16,12,4,340.81293968547885,0.40615089852008457,0.2177386216882562,0.23217256858925728,136868.17729892052,529.2891709276842,137397.4664698482,2625,3,738.1136363636364,36,8,18,29.485265102597214,0.6886574074074074,38.4009009009009,1046.3963963963963,29.066566566566564,0
2650,4,0,0,43,0.0,0.0,1.0,43,950,700,250,0.7368421052631579,12,7,5,342.66974704362116,0.4048772609819122,0.21525005145091547,0.23326314105981436,136841.9924554184,778.3221879286656,137620.31464334705,2626,4,744.1395348837209,35,8,18,29.46257374631267,0.6904761904761905,38.425925925925924,1046.2962962962963,29.894179894179896,0
2651,4,0,0,43,0.0,0.0,1.0,43,1050,700,350,0.6666666666666666,14,7,7,341.49417295707855,0.40455426356589147,0.21224981095970752,0.23286503106168194,136902.54870756163,750.2845293209763,137652.8332368826,2627,5,745.1395348837209,35,8,19,29.43347710683477,0.6910714285714287,38.36805555555555,1046.527777777777,29.900793650793627,0
2652,4,0,0,43,0.0,0.0,1.0,43,1450,1000,450,0.6896551724137931,19,10,9,342.8385705820091,0.40358527131782945,0.2094000174817081,0.23459286758584377,137023.70139960558,795.4019847393578,137819.10338434493,2628,6,746.1395348837209,35,8,16,29.278594590610947,0.6922619047619047,38.25231481481481,1046.9907407407402,29.914021164021147,0
2653,4,0,0,43,0.0,0.0,1.0,43,1050,700,350,0.6666666666666666,14,7,7,341.50410549128515,0.4029623477297896,0.21154824617756618,0.2344925762288416,137144.90767532584,767.109803669415,137912.01747899526,2629,7,747.1395348837209,35,8,17,29.193830570902392,0.6934523809523809,38.136574074074076,1047.4537037037042,29.92724867724869,0
2654,4,0,0,43,0.0,0.0,1.0,43,950,700,250,0.7368421052631579,12,7,5,341.29220699658947,0.4027316352897748,0.20999583891996876,0.2351643563277868,137266.1675347221,769.5746527777682,138035.74218749988,2630,8,748.1395348837209,35,8,17,29.079688535453947,0.6946428571428571,38.02083333333333,1047.9166666666656,29.94047619047616,0
2655,4,0,0,43,0.0,0.0,1.0,43,1100,700,400,0.6363636363636364,15,7,8,343.0357034037247,0.402062569213732,0.20084869986676468,0.23739957502936154,137417.81771101258,827.8435517404073,138245.66126275298,2631,9,749.1395348837209,35,8,17,28.884373735143686,0.6961309523809522,37.87615740740741,1048.495370370371,29.957010582010597,0
2656,4,0,1,42,0.0,0.023255813953488372,0.9767441860465116,43,600,300,300,0.5,9,3,6,343.5463356870311,0.40187799926172024,0.20397350993377472,0.23796099398505396,137448.15779320998,843.9621913580384,138292.119984568,2632,10,750.1395348837209,35,8,17,28.841059602649004,0.6964285714285714,37.84722222222223,1048.611111111112,29.960317460317487,0
2657,4,0,0,42,0.0,0.0,1.0,42,1550,1200,350,0.7741935483870968,19,12,7,351.5745841654972,0.40028552071234996,0.2121772414687948,0.2434488158278067,137437.75510204086,1263.9243197278997,138701.67942176876,2633,19,768.7619047619048,34,8,18,28.64086625794732,0.6985294117647058,37.85714285714286,1048.5714285714291,30.840336134453796,0
2658,4,0,0,42,0.0,0.0,1.0,42,750,500,250,0.6666666666666666,10,5,5,351.80845211238375,0.4000193573364305,0.21498837900654033,0.24404980024489015,137500.1771541952,1274.7448979592064,138774.9220521544,2634,20,769.7619047619048,34,8,18,28.57311766931517,0.699142156862745,37.79761904761906,1048.8095238095252,30.84733893557427,0
2659,4,0,0,42,0.0,0.0,1.0,42,1400,700,700,0.5,21,7,14,353.71447636703886,0.3990998838559814,0.21639651560260265,0.2469466194128311,137721.36923707565,1342.808400848769,139064.1776379244,2635,21,770.7619047619048,35,7,18,28.304870989083696,0.6991071428571427,37.58680555555556,1049.652777777778,29.990079365079374,0
2660,4,0,0,42,0.0,0.0,1.0,42,1700,1300,400,0.7647058823529411,21,13,8,350.5291005291004,0.39877322880371663,0.21239606953892642,0.24537037037037046,137812.50000000015,1261.4583333333485,139073.9583333335,2636,22,771.7619047619048,35,7,19,28.29861111111111,0.7,37.50000000000001,1050.0000000000011,30.000000000000032,0
2661,4,0,0,42,0.0,0.0,1.0,42,900,600,300,0.6666666666666666,12,6,6,349.83366551024653,0.3980715253581107,0.20952171084387916,0.24575002694821982,137934.05456961607,1250.7951817558464,139184.84975137192,2637,23,772.7619047619048,35,7,19,28.19707653885706,0.7011904761904761,37.38425925925927,1050.4629629629642,30.013227513227548,0
2662,4,0,0,42,0.0,0.0,1.0,42,1050,800,250,0.7619047619047619,13,8,5,349.83366551024653,0.3980715253581107,0.20952171084387916,0.24575002694821982,137934.05456961607,1250.7951817558464,139184.84975137192,2638,24,773.7619047619048,35,7,19,28.19707653885706,0.7011904761904761,37.38425925925927,1050.4629629629642,30.013227513227548,0
2663,4,0,0,42,0.0,0.0,1.0,42,1450,1100,350,0.7586206896551724,18,11,7,348.9997357774087,0.39743031358885017,0.20777290103355517,0.24625226111846535,138086.0731336806,1238.4006076388944,139324.4737413195,2639,25,774.7619047619048,35,7,16,28.069251734390484,0.7026785714285714,37.239583333333336,1051.041666666667,30.029761904761912,0
2664,4,0,0,42,0.0,0.0,1.0,42,650,400,250,0.6153846153846154,9,4,5,352.09903516104197,0.39729723190089045,0.20755488456941573,0.24910184076346634,138177.3244598767,1330.420524691376,139507.74498456807,2640,26,775.7619047619048,35,7,16,27.897952443857342,0.7035714285714285,37.152777777777786,1051.38888888889,30.039682539682573,0
2665,4,0,1,41,0.0,0.023809523809523808,0.9761904761904762,42,600,400,200,0.6666666666666666,8,4,4,352.6022957782047,0.3968253968253968,0.2043185712713611,0.2501246730473496,138268.60592689054,1350.7655767747053,139619.37150366523,2641,27,776.7619047619048,35,7,16,27.794858038956757,0.7044642857142857,37.06597222222223,1051.736111111112,30.0496031746032,0
2666,4,0,0,41,0.0,0.0,1.0,41,1150,1000,150,0.8695652173913043,13,10,3,362.07714969572623,0.3957825203252032,0.2132503575431952,0.2567086308516891,138250.34722222225,1811.458333333339,140061.8055555556,2642,28,793.0487804878048,34,7,16,27.563721605916548,0.7064950980392157,37.083333333333336,1051.6666666666667,30.93137254901961,0
2667,4,0,0,41,0.0,0.0,1.0,41,1500,1100,400,0.7333333333333333,19,11,8,361.53593375025184,0.3948932926829268,0.20994706892079118,0.2572668745961938,138375.57397959183,1805.5484693877575,140181.1224489796,2643,29,794.0487804878048,34,7,17,27.4545994568907,0.7077205882352942,36.964285714285715,1052.142857142857,30.945378151260503,0
2668,4,0,0,41,0.0,0.0,1.0,41,700,500,200,0.7142857142857143,9,5,4,380.82205787642624,0.3948932926829268,0.21910790695402782,0.24823854084490193,135302.3341719179,2105.2226669667425,137407.55683888463,2644,30,795.0487804878048,35,6,18,29.996500352282425,0.675297619047619,39.901620370370374,1040.393518518519,29.725529100529112,5
2669,4,0,0,41,0.0,0.0,1.0,41,1100,500,600,0.45454545454545453,17,5,12,377.51207053312385,0.394385162601626,0.22252233196114468,0.24711379638827624,135452.89592978393,2027.0206404320966,137479.91657021604,2645,31,796.0487804878048,35,6,19,29.932454969979986,0.6767857142857143,39.75694444444444,1040.9722222222222,29.74206349206349,0
2670,4,0,0,41,0.0,0.0,1.0,41,650,400,250,0.6153846153846154,9,4,5,377.4112833253239,0.39423272357723577,0.21921941724013339,0.2476878734499125,135545.71621875244,2031.2965414738974,137577.01276022632,2646,32,797.0487804878048,36,5,19,29.84256155149417,0.6756365740740742,39.66779279279279,1041.3288288288281,28.925800800800783,0
2671,4,0,1,40,0.0,0.024390243902439025,0.975609756097561,41,1050,800,250,0.7619047619047619,13,8,5,375.3355860566667,0.39385162601626017,0.21853679626290412,0.24733652722195743,135692.3392987583,1986.0327388199112,137678.37203757823,2647,33,798.0487804878048,36,5,19,29.750549430753704,0.6770833333333334,39.52702702702703,1041.8918918918926,28.94144144144146,0
2672,4,0,0,40,0.0,0.0,1.0,40,600,400,200,0.6666666666666666,8,4,4,378.64906096609326,0.3920940170940171,0.2394039551160987,0.24932115565148547,135663.82304794673,2273.795840835058,137937.61888878178,2648,34,817.475,35,5,19,29.69264989075289,0.6788690476190475,39.55439814814815,1041.7824074074078,29.765211640211653,0
2673,4,0,0,40,0.0,0.0,1.0,40,850,600,250,0.7058823529411765,11,6,5,379.01577125838804,0.3919471153846154,0.22904085257548834,0.25104221084526174,135874.91426611802,2299.7470850480177,138174.66135116605,2649,35,818.475,35,5,16,29.472875962107754,0.680952380952381,39.351851851851855,1042.592592592593,29.788359788359802,0
2674,4,0,0,40,0.0,0.0,1.0,40,1300,1000,300,0.7692307692307693,16,10,6,377.428408814878,0.39161324786324786,0.22247003994673786,0.2508395885132507,135995.6114969135,2265.721450617276,138261.33294753078,2650,36,819.475,35,5,16,29.39414114513982,0.6821428571428572,39.23611111111111,1043.055555555555,29.801587301587286,0
2675,4,1,1,40,0.024390243902439025,0.024390243902439025,0.975609756097561,41,1100,800,300,0.7272727272727273,14,8,6,367.76428216020236,0.39217479674796746,0.21396381583274326,0.2461763653362627,136250.22985400958,1821.5935952844911,138071.82344929408,2651,0,800.4634146341464,36,5,17,29.39317944845936,0.6825810185185185,38.992117117117125,1044.031531531533,29.000875875875913,0
2676,4,0,0,40,0.0,0.0,1.0,40,900,500,400,0.5555555555555556,13,5,8,373.14713702308967,0.3908253205128205,0.21730257320319457,0.24883835705622614,136116.3623113854,2158.2861796982097,138274.64849108362,2652,38,821.475,35,5,17,29.38572167997633,0.6833333333333333,39.12037037037037,1043.518518518518,29.8148148148148,0
2677,4,0,0,40,0.0,0.0,1.0,40,1200,1000,200,0.8333333333333334,14,10,4,401.321601742275,0.39085202991452994,0.1996394230769234,0.26085904113247865,135199.99999999997,2853.075703017833,138053.0757030178,2653,39,822.475,34,6,18,29.565638354700873,0.6764705882352942,40.0,1039.9999999999998,30.58823529411764,4
2678,4,0,0,40,0.0,0.0,1.0,40,550,300,250,0.5454545454545454,8,3,5,401.321601742275,0.3904380341880342,0.1996394230769234,0.26085904113247865,135199.99999999997,2851.7361111111118,138051.7361111111,2654,40,823.475,34,6,18,29.565638354700873,0.6764705882352942,40.0,1039.9999999999998,30.58823529411764,0
2679,4,0,0,40,0.0,0.0,1.0,40,1000,700,300,0.7,13,7,6,403.7056982121892,0.3904380341880342,0.22367489008304808,0.2511810225654564,133602.72548719525,2788.625204060812,136391.35069125606,2655,41,824.475,32,8,19,31.10624287575313,0.6653645833333334,41.54040404040404,1033.8383838383843,32.30744949494951,2
2680,4,0,0,40,0.0,0.0,1.0,40,800,600,200,0.75,10,6,4,404.67143058776867,0.39001068376068376,0.22396240234375053,0.2526728932450458,133733.29252117136,2823.6085603509937,136556.90108152234,2656,42,825.475,32,8,18,30.949910481770836,0.6666666666666666,41.41414141414142,1034.3434343434346,32.32323232323233,0
2681,4,0,0,40,0.0,0.0,1.0,40,1150,900,250,0.782608695652174,14,9,5,400.55350590767597,0.3890090811965812,0.22680009474182872,0.2509105195759953,133852.3945117263,2723.009179161871,136575.40369088817,2657,43,826.475,33,7,18,30.93666114006001,0.6654040404040404,41.29901960784314,1034.8039215686279,31.35769459298872,0
2682,4,0,0,40,0.0,0.0,1.0,40,800,600,200,0.75,10,6,4,397.15559278952554,0.387900641025641,0.22594116254291507,0.2494255235905668,133947.52206182724,2639.601505430611,136587.12356725786,2658,44,827.475,33,7,18,30.929003393709806,0.6663510101010102,41.20710784313726,1035.1715686274513,31.368835412953068,0
2683,4,0,0,40,0.0,0.0,1.0,40,650,500,150,0.7692307692307693,8,5,3,397.62414629247036,0.38826121794871793,0.2269294507575763,0.24993517766955267,133979.23875432528,2654.6760861207285,136633.914840446,2659,45,828.475,33,7,18,30.88502209595961,0.6666666666666665,41.1764705882353,1035.294117647059,31.37254901960785,0
2684,4,0,0,40,0.0,0.0,1.0,40,750,600,150,0.8,9,6,3,397.4349112785366,0.3881009615384616,0.22650905432595603,0.2500318365891553,134010.9592013889,2652.126736111116,136663.08593750003,2660,46,829.475,33,7,19,30.85806505700873,0.6669823232323232,41.145833333333336,1035.4166666666667,31.37626262626263,0
2685,4,1,0,41,0.024390243902439025,0.0,1.0,41,1350,700,650,0.5185185185185185,20,7,13,387.48441722759446,0.38732215447154467,0.2161278493308294,0.24697525437483753,134489.03238378672,2222.4808673469242,136711.51325113364,2661,0,810.219512195122,34,7,20,30.63645319254755,0.6694240196078431,40.6845238095238,1037.2619047619037,30.50770308123246,0
2686,4,0,0,41,0.0,0.0,1.0,41,700,500,200,0.7142857142857143,9,5,4,388.2195448460509,0.3870934959349594,0.21902243118816678,0.24786324786324784,134550.78125,2247.091128117913,136797.8723781179,2662,1,811.219512195122,31,10,20,30.555555555555557,0.6774193548387097,40.625,1037.5,33.46774193548387,0
2687,4,0,1,40,0.0,0.024390243902439025,0.975609756097561,41,800,500,300,0.625,11,5,6,396.47830364897845,0.3870934959349594,0.20651380166496236,0.2313269258798357,131179.87403817297,2201.9947863082953,133381.86882448127,2663,2,812.219512195122,35,6,19,33.740655481489846,0.6342261904761906,43.894675925925924,1024.421296296296,29.26917989417989,5
2688,4,0,0,40,0.0,0.0,1.0,40,900,600,300,0.6666666666666666,12,6,6,401.3960298943687,0.38721955128205127,0.21372355266217147,0.23361357572066035,131084.19075963713,2523.3347505668853,133607.52551020402,2664,50,833.475,34,6,19,33.711879020382845,0.6354166666666667,43.988095238095234,1024.0476190476186,30.119047619047606,0
2689,4,0,0,40,0.0,0.0,1.0,40,850,600,250,0.7058823529411765,11,6,5,405.08251455766896,0.38736645299145295,0.2186664729808252,0.23632101950974485,131175.6395266438,2627.391581632628,133803.03110827642,2665,51,834.475,34,6,19,33.524598101878745,0.6363357843137256,43.89880952380951,1024.4047619047603,30.129551820728246,0
2690,4,0,1,39,0.0,0.025,0.975,40,1350,1100,250,0.8148148148148148,16,11,5,406.10724315944094,0.3879407051282051,0.22470960622604252,0.23767350485109606,131297.62081916086,2664.1829648525945,133961.80378401346,2666,52,835.475,34,6,19,33.374472451310645,0.6375612745098039,43.7797619047619,1024.8809523809514,30.14355742296916,0
2691,4,2,1,40,0.04878048780487805,0.024390243902439025,0.975609756097561,41,950,700,250,0.7368421052631579,12,7,5,394.09748979516286,0.3938770325203252,0.23002771345962336,0.23358606319345948,131781.48275686154,2186.9609404444395,133968.44369730598,2667,0,812.4146341463414,32,9,18,33.19191670765699,0.6471354166666666,43.30808080808081,1026.767676767677,32.0864898989899,0
2692,4,0,0,40,0.0,0.0,1.0,40,800,300,500,0.375,13,3,10,407.34377206902116,0.38835470085470086,0.23922047443866568,0.24089204465267022,131695.40617201067,2729.060702853738,134424.46687486442,2668,1,833.725,31,9,19,32.93915704680959,0.6488575268817204,43.391927083333336,1026.432291666667,33.11071908602152,0
2693,4,1,0,41,0.024390243902439025,0.0,1.0,41,550,400,150,0.7272727272727273,7,4,3,396.87004822720144,0.3906758130081301,0.23744752007048264,0.2366392177671206,132008.45457415067,2278.040346648314,134286.49492079898,2669,0,814.3658536585366,32,9,20,32.89101855264776,0.6494140625,43.08712121212122,1027.651515151516,32.11410984848487,0
2694,4,0,0,41,0.0,0.0,1.0,41,1000,700,300,0.7,13,7,6,397.9611348432567,0.39049796747967475,0.2384836768510714,0.23815220551604302,132145.87688629373,2317.7846261053446,134463.66151239906,2670,1,815.3658536585366,33,8,20,32.72397695669448,0.6483585858585859,42.95343137254902,1028.1862745098038,31.157159833630416,0
2695,4,0,0,41,0.0,0.0,1.0,41,1400,1000,400,0.7142857142857143,18,10,8,402.3949393944606,0.39049796747967475,0.23506918414430755,0.2416096653274037,132271.91014273363,2445.109453094973,134717.0195958286,2671,2,816.3658536585366,33,8,20,32.48252720196966,0.649621212121212,42.83088235294118,1028.6764705882358,31.17201426024957,0
2696,4,0,1,40,0.0,0.024390243902439025,0.975609756097561,41,1500,1200,300,0.8,18,12,6,399.7901902987436,0.3909552845528455,0.23300423786660196,0.24064790164434058,132366.47450800176,2383.763606545566,134750.23811454733,2672,3,817.3658536585366,33,8,20,32.453926997737305,0.6505681818181817,42.7389705882353,1029.044117647059,31.183155080213908,0
2697,4,0,0,40,0.0,0.0,1.0,40,600,400,200,0.6666666666666666,8,4,4,400.7209938123827,0.39035790598290593,0.22449405514798926,0.2418397081740992,132465.01498752178,2616.3099993654873,135081.32498688725,2673,4,823.1,31,9,20,32.33040306939876,0.6565860215053763,42.64322916666667,1029.427083333334,33.20732526881722,0
2698,4,0,0,40,0.0,0.0,1.0,40,1450,1200,250,0.8275862068965517,17,12,5,403.87354445241607,0.38967681623931627,0.2204999367968652,0.244830927981844,132632.61795043945,2713.3611043294263,135345.9790547689,2674,5,824.1,31,9,19,32.07993616483377,0.658266129032258,42.48046875,1030.078125,33.228326612903224,0
2699,4,0,0,40,0.0,0.0,1.0,40,650,200,450,0.3076923076923077,11,2,9,405.98368218772026,0.389730235042735,0.2182614555256066,0.24691794441253154,132755.59413580253,2779.3209876543265,135534.91512345686,2675,6,825.1,32,8,19,31.901392632524722,0.6569010416666666,42.361111111111114,1030.5555555555559,32.20486111111112,0
2700,4,0,0,40,0.0,0.0,1.0,40,1050,900,150,0.8571428571428571,12,9,3,405.98368218772026,0.38958333333333334,0.2182614555256066,0.24691794441253154,132755.59413580253,2779.3209876543265,135534.91512345686,2676,7,826.1,32,8,19,31.901392632524722,0.6569010416666666,42.361111111111114,1030.5555555555559,32.20486111111112,0
2701,4,0,0,40,0.0,0.0,1.0,40,700,400,300,0.5714285714285714,10,4,6,405.8766141718486,0.3895165598290598,0.21595418912297903,0.24728184164917694,132820.66243240488,2781.760152025306,135602.42258443017,2677,8,827.1,32,8,19,31.838457455495682,0.6575520833333334,42.2979797979798,1030.8080808080808,32.212752525252526,0
2702,4,0,0,40,0.0,0.0,1.0,40,950,600,350,0.631578947368421,13,6,7,404.09572638867667,0.3890090811965812,0.21506245407788382,0.24662523928923272,132885.746671258,2739.7124655647376,135625.45913682276,2678,9,828.1,32,8,19,31.818668870928235,0.658203125,42.234848484848484,1031.060606060606,32.22064393939394,0
2703,4,0,0,40,0.0,0.0,1.0,40,1350,700,650,0.5185185185185185,20,7,13,405.2138802100068,0.38847489316239314,0.21538320274240919,0.24773854592480074,132950.8468523621,2774.7057060504135,135725.5525584125,2679,10,829.1,32,8,19,31.724157280444004,0.6588541666666666,42.17171717171718,1031.313131313132,32.22853535353538,0
2704,4,0,0,40,0.0,0.0,1.0,40,1450,1200,250,0.8275862068965517,17,12,5,408.3152039040015,0.38840811965811967,0.2210296096904445,0.25072578223196107,133113.66705246898,2870.466820987634,135984.13387345662,2680,11,830.1,32,8,19,31.47992373261552,0.6604817708333335,42.01388888888888,1031.9444444444432,32.24826388888885,0
2705,4,1,2,39,0.024390243902439025,0.04878048780487805,0.9512195121951219,41,950,800,150,0.8421052631578947,11,8,3,400.6475022474472,0.39209857723577235,0.22005317194673535,0.24818949973903204,133440.56560277284,2492.5258614475024,135933.09146422034,2681,0,810.829268292683,33,8,19,31.348470920808126,0.6613005050505052,41.69730392156862,1033.2107843137244,31.309417706476495,0
2706,4,0,0,39,0.0,0.0,1.0,39,1150,900,250,0.782608695652174,14,9,5,415.98564081988604,0.38602114260008996,0.2377633449952654,0.2555080292738335,133124.20590938564,3275.551620770836,136399.75753015646,2682,15,853.1025641025641,33,6,19,31.27139987333255,0.6581439393939394,42.003676470588225,1031.9852941176457,31.272281639928657,0
2707,4,0,0,39,0.0,0.0,1.0,39,900,500,400,0.5555555555555556,13,5,8,414.8161226259704,0.38627417903733696,0.23810871940991873,0.2552225128472276,133187.44781153864,3249.6601367262356,136437.1079482649,2683,16,854.1025641025641,33,6,19,31.237756737504462,0.6587752525252526,41.9424019607843,1032.2303921568612,31.27970885323822,0
2708,4,0,0,39,0.0,0.0,1.0,39,1300,900,400,0.6923076923076923,17,9,8,409.7702241190803,0.3854026090868196,0.22897466313836468,0.25362430171247013,133408.9127378891,3133.400014417515,136542.3127523066,2684,17,855.1025641025641,33,6,19,31.144721233689207,0.6609848484848486,41.72794117647058,1033.0882352941164,31.30570409982171,0
2709,4,0,0,39,0.0,0.0,1.0,39,950,600,350,0.631578947368421,13,6,7,407.803205663405,0.3847559604138551,0.22832100094583807,0.25262225032683083,133440.56560277296,3083.498083669739,136524.0636864427,2685,18,856.1025641025641,33,6,19,31.163637172340163,0.661300505050505,41.697303921568626,1033.2107843137253,31.309417706476523,0
2710,4,0,0,39,0.0,0.0,1.0,39,1000,800,200,0.8,12,8,4,411.44925796511325,0.3850089968511021,0.22904646457053013,0.2555480747877406,133537.46588358347,3188.7820042339727,136726.24788781744,2686,19,857.1025641025641,32,7,19,30.971831989575698,0.6647135416666665,41.603535353535364,1033.5858585858598,32.29955808080812,0
2711,4,0,0,39,0.0,0.0,1.0,39,1000,800,200,0.8,12,8,4,411.67618338286866,0.3849527665317139,0.23018370484483608,0.2563662559484648,133635.3612673452,3202.899098306302,136838.2603656515,2687,20,858.1025641025641,32,7,19,30.86737289860383,0.6656901041666666,41.50883838383839,1033.9646464646466,32.31139520202021,0
2712,4,0,0,39,0.0,0.0,1.0,39,750,500,250,0.6666666666666666,10,5,5,415.23922777576206,0.3843623481781377,0.23486691146317562,0.2590422326512771,133700.6447843333,3303.550498673608,137004.1952830069,2688,21,859.1025641025641,32,7,19,30.709518577300297,0.6663411458333334,41.44570707070707,1034.217171717172,32.31928661616163,0
2713,4,0,0,39,0.0,0.0,1.0,39,1000,800,200,0.8,12,8,4,415.63538904533124,0.38433423301844355,0.2376535676511271,0.25997834945323983,133798.59995153546,3322.286628915407,137120.88658045087,2689,22,860.1025641025641,32,7,19,30.60064274672525,0.6673177083333334,41.3510101010101,1034.595959595959,32.331123737373716,0
2714,4,0,0,39,0.0,0.0,1.0,39,1300,900,400,0.6923076923076923,17,9,8,418.5329871530496,0.38444669365721995,0.23383163946784813,0.26248775024434173,133896.5909888021,3408.028039230684,137304.6190280328,2690,23,861.1025641025641,32,7,19,30.42703631409866,0.6682942708333334,41.25631313131313,1034.974747474747,32.34296085858584,0
2715,4,0,0,39,0.0,0.0,1.0,39,700,400,300,0.5714285714285714,10,4,6,419.26160177709505,0.38441857849752586,0.232764714345588,0.2631781478842747,133929.26263901652,3430.279435771873,137359.5420747884,2691,24,862.1025641025641,32,7,19,30.375294787346512,0.6686197916666666,41.22474747474748,1035.1010101010108,32.34690656565659,0
2716,4,0,0,39,0.0,0.0,1.0,39,900,700,200,0.7777777777777778,11,7,4,418.683759592111,0.3841374269005848,0.22984041205775552,0.26304889999200914,133961.9382747934,3417.5375918273694,137379.47586662078,2692,25,863.1025641025641,32,7,19,30.35736065373826,0.6689453125,41.19318181818182,1035.227272727273,32.35085227272728,0
2717,4,0,0,39,0.0,0.0,1.0,39,1100,900,200,0.8181818181818182,13,9,4,416.8004164187985,0.3837156995051732,0.22753595997498444,0.2620984213676493,133994.617896133,3369.8025073972,137364.42040353018,2693,26,864.1025641025641,32,7,19,30.373221544715452,0.6692708333333334,41.16161616161616,1035.3535353535349,32.354797979797965,0
2718,4,0,0,39,0.0,0.0,1.0,39,1050,600,450,0.5714285714285714,15,6,9,415.2724182568634,0.38396873594242015,0.22953125879241498,0.2616024865240242,134059.9890955005,3334.2831726354516,137394.27226813594,2694,27,865.1025641025641,32,7,19,30.347019019751293,0.669921875,41.09848484848485,1035.606060606061,32.362689393939405,0
2719,4,0,0,39,0.0,0.0,1.0,39,1000,800,200,0.8,12,8,4,413.3609298334896,0.3834907782276203,0.22887811526114632,0.2606302619080794,134092.68067352817,3285.7350334149546,137378.41570694314,2695,28,866.1025641025641,32,7,19,30.36363728717136,0.6702473958333334,41.06691919191919,1035.7323232323229,32.36663510101009,0
2720,4,0,0,39,0.0,0.0,1.0,39,950,800,150,0.8421052631578947,11,8,3,414.35398363078514,0.38270355375618537,0.22853536536977503,0.2621899108448613,134223.48684126613,3323.2072938985716,137546.6941351647,2696,29,867.1025641025641,32,7,19,30.206429470776975,0.6715494791666667,40.94065656565656,1036.2373737373732,32.38241792929291,0
2721,4,0,0,39,0.0,0.0,1.0,39,1200,1000,200,0.8333333333333334,14,10,4,411.3955190118504,0.3827878992352676,0.22681797027027906,0.2607834606616432,134288.91383851136,3249.171481226406,137538.08531973776,2697,30,868.1025641025641,32,7,19,30.217342753888012,0.6722005208333334,40.87752525252525,1036.4898989898988,32.39030934343434,0
2722,4,0,0,39,0.0,0.0,1.0,39,1150,1000,150,0.8695652173913043,13,10,3,428.59001040582683,0.3827878992352676,0.18403639371381275,0.26572580645161287,133472.2222222223,3641.2272982348836,137113.4495204572,2698,31,869.1025641025641,33,6,20,30.594758064516125,0.6616161616161615,41.66666666666667,1033.3333333333342,31.31313131313134,2
2723,4,0,0,39,0.0,0.0,1.0,39,750,400,350,0.5333333333333333,11,4,7,426.8905382296065,0.38264732343679714,0.1865483135324406,0.2651531371257133,133539.5050048828,3601.3502332899307,137140.85523817275,2699,32,870.1025641025641,31,8,20,30.570777693793573,0.6673387096774194,41.6015625,1033.59375,33.341733870967744,0
2724,4,0,0,39,0.0,0.0,1.0,39,1050,700,350,0.6666666666666666,14,7,7,434.735184405753,0.3823942869995502,0.18392318669327,0.2710099556162081,133674.12143283428,3822.568766276051,137496.69019911034,2700,33,871.1025641025641,31,8,20,30.232204314614286,0.6686827956989246,41.47135416666667,1034.114583333334,33.35853494623658,0
2725,4,0,0,39,0.0,0.0,1.0,39,1000,600,400,0.6,14,6,8,429.4623659726825,0.3817757534862798,0.18030015614313544,0.26919297198350794,133876.17323133687,3698.955620659732,137575.1288519966,2701,34,872.1025641025641,31,8,20,30.16482133870156,0.6706989247311828,41.27604166666667,1034.895833333334,33.383736559139805,0
2726,4,0,0,39,0.0,0.0,1.0,39,850,700,150,0.8235294117647058,10,7,3,423.9752585036478,0.38171952316689156,0.18113488348825513,0.2668473595539845,134027.3015030355,3564.851960259173,137592.15346329467,2702,35,873.1025641025641,32,7,20,30.15460512945576,0.6695963541666665,41.13005050505051,1035.4797979797988,32.35874368686871,0
2727,4,0,0,39,0.0,0.0,1.0,39,800,500,300,0.625,11,5,6,423.73700286763574,0.38143837156995053,0.1814249459300652,0.2674106439635451,134125.3762371188,3566.7769870421553,137692.15322416095,2703,36,874.1025641025641,32,7,20,30.06206322119293,0.6705729166666665,41.03535353535354,1035.8585858585868,32.37058080808084,0
2728,4,0,0,39,0.0,0.0,1.0,39,550,400,150,0.7272727272727273,7,4,3,421.446449334838,0.38124156545209176,0.1797495876443247,0.2669160845787308,134256.1983471075,3516.359618916447,137772.55796602395,2704,37,875.1025641025641,32,7,20,29.989796539961013,0.671875,40.909090909090914,1036.363636363637,32.386363636363654,0
2729,4,0,0,39,0.0,0.0,1.0,39,600,500,100,0.8333333333333334,7,5,2,417.49567162828384,0.381044759334233,0.1799431587494924,0.2648871301443747,134321.63331547793,3415.7401030507,137737.37341852862,2705,38,876.1025641025641,32,7,20,30.026390580592775,0.6725260416666667,40.84595959595959,1036.616161616161,32.39425505050503,0
2730,4,0,0,39,0.0,0.0,1.0,39,800,400,400,0.5,12,4,8,417.49567162828384,0.381044759334233,0.1799431587494924,0.2648871301443747,134321.63331547793,3415.7401030507,137737.37341852862,2706,39,877.1025641025641,32,7,20,30.026390580592775,0.6725260416666667,40.84595959595959,1036.616161616161,32.39425505050503,0
2731,4,0,0,39,0.0,0.0,1.0,39,1100,900,200,0.8181818181818182,13,9,4,418.73704891719836,0.38118533513270353,0.18148262649541436,0.26591259927758054,134354.35677800732,3451.829373278233,137806.18615128554,2707,40,878.1025641025641,32,7,20,29.961332359030564,0.6728515625,40.81439393939394,1036.742424242424,32.39820075757575,0
2732,4,0,0,39,0.0,0.0,1.0,39,800,300,500,0.375,13,3,10,416.8182469829954,0.3811572199730095,0.17939666338935978,0.26564483312376325,134485.29048375168,3411.1846048872603,137896.47508863895,2708,41,879.1025641025641,32,7,20,29.87953946033678,0.6741536458333334,40.688131313131315,1037.2474747474748,32.41398358585859,0
2733,4,0,0,39,0.0,0.0,1.0,39,450,300,150,0.6666666666666666,6,3,3,417.68519449071766,0.3811572199730095,0.18217112326167872,0.26643645636147006,134518.03387409443,3437.238228242011,137955.27210233643,2709,42,880.1025641025641,32,7,20,29.82417437520285,0.6744791666666667,40.656565656565654,1037.373737373737,32.41792929292928,0
2734,4,0,0,39,0.0,0.0,1.0,39,1100,700,400,0.6363636363636364,15,7,8,417.3212676979133,0.38121345029239767,0.18163667050392895,0.26692322951043956,134616.2879584991,3435.647988725636,138051.93594722473,2710,43,881.1025641025641,32,7,20,29.734963701991312,0.6754557291666667,40.561868686868685,1037.7525252525252,32.42976641414141,0
2735,4,0,0,39,0.0,0.0,1.0,39,850,400,450,0.47058823529411764,13,4,9,414.2897640819958,0.38084795321637427,0.17760355269477146,0.2657012823933048,134714.57791296806,3362.1741403938354,138076.75205336188,2711,44,882.1025641025641,32,7,20,29.714992297089115,0.6764322916666667,40.467171717171716,1038.1313131313132,32.441603535353536,0
2736,4,0,0,39,0.0,0.0,1.0,39,1050,900,150,0.8571428571428571,12,9,3,415.47827484078056,0.38048245614035087,0.1796367988928167,0.26742756563695336,134845.6869834711,3405.090679522504,138250.7776629936,2712,45,883.1025641025641,32,7,19,29.552637977145633,0.677734375,40.34090909090909,1038.636363636364,32.457386363636374,0
2737,4,0,0,39,0.0,0.0,1.0,39,900,600,300,0.6666666666666666,12,6,6,412.8854025272828,0.37983580746738643,0.1793095712162429,0.2664810962664323,134944.06063475672,3343.286558769521,138287.34719352625,2713,46,884.1025641025641,32,7,20,29.521357394580143,0.6787109375,40.246212121212125,1039.015151515152,32.4692234848485,0
2738,4,0,0,39,0.0,0.0,1.0,39,1500,1200,300,0.8,18,12,6,415.07730728892915,0.3795546558704453,0.1766125691790703,0.2688695099063536,135075.28130101532,3413.3368087440217,138488.61810975935,2714,47,885.1025641025641,32,7,20,29.332918336774775,0.6800130208333333,40.1199494949495,1039.5202020202028,32.485006313131336,0
2739,4,0,0,39,0.0,0.0,1.0,39,1250,1000,250,0.8,15,10,5,414.2356550024891,0.37907669815564554,0.17279519506454788,0.2693960156326534,135219.1183228807,3402.516009467518,138621.6343323482,2715,48,886.1025641025641,33,6,20,29.210729154392986,0.6789772727272727,39.981617647058826,1040.0735294117653,31.517379679144405,0
2740,4,0,0,39,0.0,0.0,1.0,39,1150,900,250,0.782608695652174,14,9,5,415.3817766623523,0.3786268556005398,0.1761106580894567,0.2708595456116258,135314.73021193763,3441.4546088042935,138756.1848207419,2716,49,887.1025641025641,33,6,20,29.085198272477427,0.6799242424242424,39.889705882352935,1040.4411764705874,31.52852049910871,0
2741,4,0,0,39,0.0,0.0,1.0,39,850,500,350,0.5882352941176471,12,5,7,415.3817766623523,0.37834570400359874,0.1761106580894567,0.2708595456116258,135314.73021193763,3441.4546088042935,138756.1848207419,2717,50,888.1025641025641,33,6,20,29.085198272477427,0.6799242424242424,39.889705882352935,1040.4411764705874,31.52852049910871,0
2742,4,0,0,39,0.0,0.0,1.0,39,700,500,200,0.7142857142857143,9,5,4,416.385373493831,0.37828947368421056,0.17961099082286247,0.2717546661288332,135346.60835075454,3471.269613850443,138817.877964605,2718,51,889.1025641025641,33,6,20,29.027180740391795,0.680239898989899,39.85906862745098,1040.5637254901962,31.53223410576352,0
2743,4,0,0,39,0.0,0.0,1.0,39,950,700,250,0.7368421052631579,12,7,5,413.570008463241,0.37775528565002253,0.17307918685199453,0.2708771952116601,135474.1584516772,3405.6097714821194,138879.76822315934,2719,52,890.1025641025641,33,6,20,28.972802628997453,0.6815025252525253,39.736519607843135,1041.0539215686274,31.54708853238265,0
2744,4,0,0,39,0.0,0.0,1.0,39,850,500,350,0.5882352941176471,12,5,7,396.3587749498667,0.377895861448493,0.11459407437959723,0.2505793611123735,134190.77932098773,2837.5385802469277,137028.31790123467,2720,53,891.1025641025641,35,4,18,30.705428954423603,0.6642857142857143,40.97222222222223,1036.1111111111118,29.603174603174622,3
2745,4,0,0,39,0.0,0.0,1.0,39,1300,1100,200,0.8461538461538461,15,11,4,400.5276272582105,0.3778396311291048,0.11768477884364925,0.2542541429731958,134340.721517597,2961.4340867198403,137302.15560431685,2721,54,892.1025641025641,35,4,19,30.44697350303301,0.6657738095238095,40.827546296296305,1036.689814814816,29.619708994709026,0
2746,4,1,1,39,0.025,0.025,0.975,40,1200,900,300,0.75,15,9,6,388.9274923620647,0.37804487179487184,0.11050126175728381,0.24894786185113665,134643.43112244908,2473.6346059128523,137117.06572836192,2722,0,870.775,34,6,20,30.444434885677143,0.6709558823529411,40.53571428571429,1037.8571428571436,30.525210084033635,0
2747,4,1,1,39,0.025,0.025,0.975,40,750,500,250,0.6666666666666666,10,5,5,389.8885300058919,0.3803952991452992,0.11542431192660563,0.24998735159201294,134705.2154195011,2504.003684807254,137209.21910430834,2723,0,871.75,34,6,20,30.357654816513758,0.6715686274509804,40.476190476190474,1038.0952380952378,30.532212885154053,0
2748,4,0,0,39,0.0,0.0,1.0,39,750,300,450,0.4,12,3,9,394.95236224354505,0.3764057579847053,0.12208483615121168,0.2523820114049885,134582.56927924367,2830.7407307285803,137413.31000997225,2724,57,895.1025641025641,33,6,20,30.349075823786468,0.6726641414141414,40.594362745098046,1037.6225490196089,31.443107546048754,0
2749,4,0,0,39,0.0,0.0,1.0,39,550,200,350,0.36363636363636365,9,2,7,396.83588040133986,0.3767150247413405,0.1210106221915388,0.25380711746514695,134614.36106305264,2883.9616974240657,137498.3227604767,2725,58,896.1025641025641,33,6,20,30.268363249881915,0.6729797979797979,40.56372549019608,1037.7450980392155,31.4468211527035,0
2750,4,0,0,39,0.0,0.0,1.0,39,700,500,200,0.7142857142857143,9,5,4,397.4989322155256,0.3761246063877643,0.1167163022687101,0.25512204194923727,134741.5657439446,2911.9257016532033,137653.4914455978,2726,59,897.1025641025641,33,6,20,30.123740950582306,0.6742424242424242,40.44117647058823,1038.2352941176468,31.46167557932263,0
2751,4,0,0,39,0.0,0.0,1.0,39,900,600,300,0.6666666666666666,12,6,6,397.6828447799533,0.3757309941520468,0.1245628683099187,0.2561367623369973,134868.83049788547,2927.0040369088847,137795.83453479435,2727,60,898.1025641025641,33,6,18,29.991544753814686,0.6755050505050504,40.318627450980394,1038.7254901960787,31.47653000594178,0
2752,4,0,0,39,0.0,0.0,1.0,39,750,400,350,0.5333333333333333,11,4,7,399.78235820441125,0.3743814664867296,0.13050589704286208,0.2586235072411602,135027.9959180362,2996.36212634562,138024.35804438184,2728,61,899.1025641025641,33,6,19,29.777713909523243,0.6770833333333335,40.16544117647058,1039.3382352941167,31.495098039215655,0
2753,4,0,0,39,0.0,0.0,1.0,39,1250,800,450,0.64,17,8,9,413.8318471502432,0.37471884840305897,0.1535635756735516,0.2633228064664553,134427.29768990944,3336.6059567209404,137763.90364663038,2729,62,900.1025641025641,34,5,22,30.015210653197105,0.6688112745098038,40.74404761904763,1037.0238095238108,30.50070028011208,5
2754,4,0,0,39,0.0,0.0,1.0,39,1550,1400,150,0.9032258064516129,17,14,3,404.25161139025977,0.37480319388214123,0.14451994234705667,0.25855004873509946,134614.3610630525,3083.671164544232,137698.03222759673,2730,63,901.1025641025641,33,6,22,30.075972287828698,0.672979797979798,40.56372549019607,1037.7450980392143,31.446821152703464,0
2755,4,0,0,39,0.0,0.0,1.0,39,700,500,200,0.7142857142857143,9,5,4,405.3222560026576,0.3741565452091768,0.14885779234734486,0.25991558142305166,134709.75894187333,3120.1726799788485,137829.93162185219,2731,64,902.1025641025641,33,6,22,29.952558729783963,0.6739267676767677,40.47181372549019,1038.112745098039,31.457961972667853,0
2756,4,0,0,39,0.0,0.0,1.0,39,1250,1000,250,0.8,15,10,5,403.8394172119746,0.37404408457040034,0.15106204625855324,0.25941860364193003,134773.37630058132,3085.360348183368,137858.7366487647,2732,65,903.1025641025641,33,6,22,29.927293559935478,0.6745580808080809,40.41053921568626,1038.3578431372534,31.465389185977376,0
2757,4,0,0,39,0.0,0.0,1.0,39,1300,1100,200,0.8461538461538461,15,11,4,406.23046666504064,0.3729757085020243,0.1435377174435808,0.26187191375814034,134900.6560727843,3160.151293973444,138060.80736675774,2733,66,904.1025641025641,33,6,19,29.737697101962173,0.6758207070707072,40.28799019607842,1038.8480392156846,31.480243612596503,0
2758,4,0,0,39,0.0,0.0,1.0,39,1350,900,450,0.6666666666666666,18,9,9,399.4488045801204,0.37261021142600087,0.15425705774133602,0.25968901368006747,135206.5657362771,3003.60637612474,138210.17211240184,2734,67,905.1025641025641,32,7,20,29.607765772328122,0.6813151041666666,39.99368686868688,1040.025252525254,32.50078914141419,1
2759,4,1,0,40,0.025,0.0,1.0,40,850,600,250,0.7058823529411765,11,6,5,386.9485772156542,0.3753739316239317,0.1510178865615439,0.254118161451208,135569.86045030766,2491.712922914272,138061.57337322194,2735,0,883.45,33,7,21,29.570192986585067,0.6824494949494949,39.64460784313726,1041.4215686274515,31.558229352347016,0
2760,4,0,0,40,0.0,0.0,1.0,40,1150,900,250,0.782608695652174,14,9,5,386.7727083851083,0.3747596153846154,0.1517819336626678,0.2549101989682318,135697.51567906578,2496.8191320645933,138194.33481113036,2736,1,884.45,33,7,21,29.447482945189375,0.6837121212121212,39.52205882352941,1041.9117647058824,31.573083778966133,0
2761,4,0,0,40,0.0,0.0,1.0,40,800,400,400,0.5,12,4,8,386.3847875207386,0.3746928418803419,0.15227272727272756,0.2548820673614305,135729.43887266915,2488.7580798250697,138218.1969524942,2737,2,885.45,33,7,22,29.4257663961739,0.6840277777777777,39.49142156862745,1042.0343137254902,31.576797385620914,0
2762,4,0,0,40,0.0,0.0,1.0,40,800,600,200,0.75,10,6,4,386.3070579812369,0.37463942307692305,0.15276340545625655,0.25505863517643146,135761.36582083814,2489.1147635524803,138250.4805843906,2738,3,886.45,33,7,22,29.395970523675135,0.6843434343434343,39.46078431372549,1042.156862745098,31.580510992275695,0
2763,4,0,1,39,0.0,0.025,0.975,40,1100,600,500,0.5454545454545454,16,6,10,382.67707177183905,0.3748263888888889,0.1443445243804955,0.25329577607755055,135850.78125000003,2397.395833333334,138248.17708333337,2739,4,887.45,34,6,22,29.401478816946437,0.6829044117647058,39.375,1042.5000000000002,30.66176470588236,0
2764,4,0,0,39,0.0,0.0,1.0,39,1400,1100,300,0.7857142857142857,17,11,6,380.67906843648177,0.37244152046783624,0.12179414028095992,0.2532946603423606,136037.00573979592,2557.2881235827626,138594.29386337867,2740,5,843.3076923076923,34,5,21,29.268182509794965,0.6847426470588236,39.19642857142857,1043.2142857142856,30.682773109243694,0
2765,4,0,0,39,0.0,0.0,1.0,39,1100,900,200,0.8181818181818182,13,9,4,399.051545580215,0.3717948717948718,0.14890433563324512,0.2618721192987013,135543.27317226087,3030.9768626779496,138574.25003493883,2741,6,844.3076923076923,35,4,18,29.28163554518173,0.6776785714285714,39.67013888888889,1041.319444444445,29.751984126984144,6
2766,4,0,0,39,0.0,0.0,1.0,39,1250,800,450,0.64,17,8,9,395.84000000000015,0.3710076473234368,0.15117948717948737,0.2604210526315788,135633.68055555536,2937.9075038579995,138571.58805941336,2742,7,845.3076923076923,33,6,18,29.275000000000002,0.6830808080808082,39.58333333333332,1041.6666666666652,31.56565656565652,0
2767,4,0,0,39,0.0,0.0,1.0,39,950,900,50,0.9473684210526315,10,9,1,395.65824039883057,0.37016419253261357,0.15186193711420115,0.26099938076891044,135729.43887266915,2940.49419093618,138669.93306360533,2743,8,846.3076923076923,33,6,18,29.184184993531694,0.6840277777777778,39.49142156862745,1042.0343137254902,31.576797385620914,0
2768,4,0,0,39,0.0,0.0,1.0,39,1050,600,450,0.5714285714285714,15,6,9,394.7504670082817,0.3702204228520018,0.1513140045940422,0.2611001144924138,135825.2309808726,2923.414672241429,138748.64565311404,2744,9,847.3076923076923,33,6,19,29.112293283172665,0.6849747474747476,39.39950980392156,1042.4019607843127,31.587938205585232,0
2769,4,0,0,39,0.0,0.0,1.0,39,900,600,300,0.6666666666666666,12,6,6,392.6070631496141,0.3697143499775079,0.155799066941521,0.26014804464773494,135889.11115916952,2870.204969242595,138759.31612841212,2745,10,848.3076923076923,33,6,16,29.104470302460435,0.6856060606060606,39.338235294117645,1042.647058823529,31.59536541889482,0
2770,4,0,1,38,0.0,0.02564102564102564,0.9743589743589743,39,1050,700,350,0.6666666666666666,14,7,7,393.30020256807177,0.36988304093567254,0.15577450360059086,0.2610752514706934,135953.0063557285,2894.0689878892663,138847.07534361776,2746,11,849.3076923076923,33,6,16,29.02271837054446,0.6862373737373737,39.27696078431372,1042.8921568627445,31.60279263220438,0
2771,4,0,1,37,0.0,0.02631578947368421,0.9736842105263158,38,1050,900,150,0.8571428571428571,12,9,3,390.7630183306013,0.3690730203888099,0.15449396517609837,0.25985740718984957,136016.91657054957,3030.076172625889,139046.99274317545,2747,12,862.921052631579,33,5,16,29.025199718045116,0.686868686868687,39.21568627450979,1043.137254901959,31.61021984551391,0
2772,4,0,0,37,0.0,0.0,1.0,37,850,600,250,0.7058823529411765,11,6,5,394.99491292331214,0.36570945945945943,0.16078774015570207,0.26202915548864536,135929.77000114782,3338.3135330578466,139268.08353420565,2748,81,886.918918918919,32,5,16,29.00169512047463,0.6884765625,39.29924242424242,1042.8030303030303,32.587594696969695,0
2773,4,0,0,37,0.0,0.0,1.0,37,1400,1100,300,0.7857142857142857,17,11,6,395.91715542560667,0.36542792792792794,0.15701976486290237,0.26337097730486003,136028.5382231405,3371.2063820018334,139399.74460514233,2749,82,887.918918918919,32,5,16,28.879206003389005,0.689453125,39.20454545454545,1043.181818181818,32.59943181818181,0
2774,4,0,0,37,0.0,0.0,1.0,37,950,600,350,0.631578947368421,13,6,7,395.791845217901,0.3646146146146146,0.1588659439839113,0.2640209524395441,136127.34231519746,3375.6183999081723,139502.96071510564,2750,83,888.918918918919,32,5,16,28.784029038112514,0.6904296875,39.109848484848484,1043.5606060606062,32.611268939393945,0
2775,4,0,0,37,0.0,0.0,1.0,37,900,800,100,0.8888888888888888,10,8,2,395.19891739042873,0.36492742742742745,0.16156708365757444,0.26387029492320563,136160.2849836752,3362.0794434241457,139522.36442709935,2751,84,889.918918918919,32,5,16,28.766684813291384,0.6907552083333334,39.07828282828283,1043.6868686868693,32.615214646464665,0
2776,4,0,0,37,0.0,0.0,1.0,37,1200,800,400,0.6666666666666666,16,8,8,392.35491194427914,0.36464589589589586,0.16103286384976534,0.2628037617739983,136272.70761245672,3293.4532391387897,139566.16085159552,2752,85,890.918918918919,33,4,16,28.72897104851331,0.6893939393939394,38.970588235294116,1044.1176470588234,31.639928698752225,0
2777,4,0,1,36,0.0,0.02702702702702703,0.972972972972973,37,600,200,400,0.3333333333333333,10,2,8,394.4063822883754,0.3641453953953954,0.15805197358823242,0.2646559992016957,136336.692918589,3354.4123654363657,139691.10528402537,2753,86,891.918918918919,33,4,16,28.611730423218344,0.6900252525252526,38.90931372549019,1044.3627450980389,31.647355912061784,0
2778,4,0,0,36,0.0,0.0,1.0,36,1050,900,150,0.8571428571428571,12,9,3,395.361432103256,0.36278108465608466,0.16543456152702807,0.2652968601877124,136336.692918589,3580.4540321030318,139917.14695069203,2754,87,911.2222222222222,33,3,17,28.586794962058992,0.6900252525252526,38.90931372549019,1044.3627450980389,31.647355912061784,0
2779,4,0,0,36,0.0,0.0,1.0,36,950,800,150,0.8421052631578947,11,8,3,396.4173478984781,0.36256613756613754,0.16159601647635502,0.2664874979090399,136400.69324298337,3614.320213379462,140015.01345636282,2755,88,912.2222222222222,33,3,17,28.495522446425777,0.6906565656565657,38.84803921568627,1044.6078431372543,31.654783125371345,0
2780,4,1,1,36,0.02702702702702703,0.02702702702702703,0.972972972972973,37,550,300,250,0.5454545454545454,8,3,5,387.1158668186236,0.3654592092092092,0.1507839807020135,0.26237853195484495,136689.79591836734,3182.9577664399058,139872.75368480725,2756,0,888.5405405405405,34,3,18,28.451113767455976,0.6911764705882353,38.57142857142857,1045.7142857142856,30.756302521008397,0
2781,4,0,0,36,0.0,0.0,1.0,36,600,500,100,0.8333333333333334,7,5,2,396.82106663756764,0.36140873015873015,0.1632270168855534,0.2677286436934476,136528.73894655905,3635.495963091122,140164.23490965017,2757,90,914.2222222222222,33,3,18,28.35756722951845,0.6919191919191918,38.72549019607843,1045.0980392156866,31.669637551990505,0
2782,4,0,0,36,0.0,0.0,1.0,36,750,400,350,0.5333333333333333,11,4,7,395.53496452077945,0.36061507936507936,0.16337762146671864,0.2673465330714938,136592.7843257402,3605.4444204152396,140198.22874615545,2758,91,915.2222222222222,33,3,19,28.32747166862056,0.692550505050505,38.66421568627452,1045.343137254903,31.67706476530009,0
2783,4,0,0,36,0.0,0.0,1.0,36,900,500,400,0.5555555555555556,13,5,8,394.30434449099425,0.3589781746031746,0.15750576747679546,0.26773911391503274,136753.9345474953,3584.5941767117342,140338.52872420705,2759,92,916.2222222222222,32,4,19,28.199440688878155,0.6966145833333333,38.51010101010102,1045.9595959595972,32.68623737373741,0
2784,4,0,0,36,0.0,0.0,1.0,36,1050,900,150,0.8571428571428571,12,9,3,386.4176902147983,0.3594246031746032,0.16093828399397836,0.24763037189649278,134685.90630425338,3217.165796120115,137903.0721003735,2760,93,917.2222222222222,31,5,22,30.46705134637898,0.6787634408602151,40.49479166666666,1038.0208333333326,33.48454301075267,6
2785,4,0,0,36,0.0,0.0,1.0,36,550,300,250,0.5454545454545454,8,3,5,385.21692009918934,0.3590277777777778,0.15875454659475774,0.24709046693087972,134719.69816419802,3179.261440700945,137898.95960489896,2761,94,918.2222222222222,31,5,22,30.464405911618385,0.6790994623655915,40.46223958333333,1038.1510416666658,33.48874327956987,0
2786,4,0,1,35,0.0,0.027777777777777776,0.9722222222222222,36,850,600,250,0.7058823529411765,11,6,5,384.0063602746048,0.3581845238095238,0.1559025165119976,0.2465432139154345,134753.49426269517,3149.2397732204713,137902.73403591564,2762,95,919.2222222222222,31,5,22,30.462022406153338,0.6794354838709677,40.42968749999999,1038.2812499999989,33.49294354838706,0
2787,4,0,0,35,0.0,0.0,1.0,35,1150,700,450,0.6086956521739131,16,7,9,394.4257932291254,0.35595238095238096,0.16298953441071018,0.2535219366462746,134794.9275205225,3633.3192421089016,138428.2467626314,2763,96,937.6285714285714,30,5,18,30.15008844594011,0.6826388888888889,40.38978494623655,1038.440860215053,34.61469534050176,0
2788,4,0,0,35,0.0,0.0,1.0,35,650,400,250,0.6153846153846154,9,4,5,392.7843469179058,0.3562324929971989,0.16338996838543896,0.25270979588964676,134829.82362484094,3591.8088435079108,138421.63246834883,2764,97,938.6285714285714,30,5,18,30.157780078512577,0.6829861111111111,40.35618279569892,1038.5752688172038,34.619175627240125,0
2789,4,0,0,35,0.0,0.0,1.0,35,850,700,150,0.8235294117647058,10,7,3,373.9060692977256,0.3562324929971989,0.13951574407848244,0.23162960566987567,133441.47002551012,2978.9151077097467,136420.38513321985,2765,98,939.6285714285714,34,1,22,32.03830126358644,0.6590073529411764,41.69642857142857,1033.214285714285,30.388655462184857,5
2790,4,0,0,35,0.0,0.0,1.0,35,950,800,150,0.8421052631578947,11,8,3,376.53358468785893,0.3560574229691877,0.13870678118276847,0.2336503104983601,133503.88259623697,3053.742639825531,136557.6252360625,2766,99,940.6285714285714,33,2,22,31.907758211787023,0.6619318181818181,41.6360294117647,1033.4558823529408,31.316844919786085,0
2791,4,0,0,35,0.0,0.0,1.0,35,850,600,250,0.7058823529411765,11,6,5,369.86785501938505,0.3560574229691877,0.1174077915894367,0.2233831667877681,132492.61289227704,2805.0404291618615,135297.6533214389,2767,100,941.6285714285714,33,2,20,33.096630361464904,0.6518308080808082,42.61642156862745,1029.5343137254904,31.198009506833042,2
2792,4,1,1,35,0.027777777777777776,0.027777777777777776,0.9722222222222222,36,900,700,200,0.7777777777777778,11,7,4,361.79329885578426,0.3602513227513227,0.11320639687856948,0.22010151709026857,132765.81809807243,2406.756660997714,135172.57475907015,2768,0,916.4444444444445,34,2,17,33.029629201801995,0.6522671568627452,42.35119047619047,1030.5952380952372,30.311624649859915,0
2793,4,0,0,35,0.0,0.0,1.0,35,750,500,250,0.6666666666666666,10,5,5,369.29846508604254,0.3571778711484594,0.11948670009348206,0.22378901218804506,132618.81134960108,2795.1846945886173,135413.9960441897,2769,102,943.6285714285714,33,2,21,32.98421078722981,0.6530934343434345,42.493872549019606,1030.0245098039213,31.212863933452162,0
2794,4,0,0,35,0.0,0.0,1.0,35,1000,700,300,0.7,13,7,6,372.82212437927694,0.35721288515406163,0.11879109117782005,0.2266855563199813,132745.06987997406,2898.0597907055044,135643.12967067957,2770,103,944.6285714285714,33,2,17,32.76635648313316,0.6543560606060606,42.37132352941177,1030.5147058823532,31.227718360071307,0
2795,4,0,0,35,0.0,0.0,1.0,35,700,600,100,0.8571428571428571,8,6,2,374.1952019424827,0.35721288515406163,0.12525774071369078,0.22790411611428132,132808.221672554,2939.239865676682,135747.46153823068,2771,104,945.6285714285714,33,2,18,32.66741469504221,0.6549873737373737,42.31004901960785,1030.75980392157,31.23514557338091,0
2796,4,0,0,35,0.0,0.0,1.0,35,750,400,350,0.5333333333333333,11,4,7,358.7750303125967,0.3568627450980392,0.047600592727687685,0.1973375135380819,128877.9996811769,2247.6416484481956,131125.6413296251,2772,105,946.6285714285714,35,0,22,37.044174360728,0.6110119047619048,46.15162037037036,1015.3935185185167,29.011243386243333,8
2797,4,2,4,33,0.05405405405405406,0.10810810810810811,0.8918918918918919,37,1000,700,300,0.7,13,7,6,340.49485845149775,0.3699011511511512,0.04008281028427141,0.18964430032372565,129373.18019032538,1410.585761816767,130783.76595214214,2773,0,896.4054054054054,36,1,22,37.00441849310013,0.6140046296296298,45.66441441441441,1017.3423423423417,28.259509509509492,0
2798,4,1,0,34,0.029411764705882353,0.0,1.0,34,1200,900,300,0.75,15,9,6,359.12746865716235,0.36012700534759357,0.03499847570702386,0.19930973962866047,129232.53864198858,2482.190894127247,131714.72953611583,2774,0,924.6176470588235,33,1,23,36.673772648748546,0.6190025252525253,45.80269607843137,1016.7892156862739,30.811794414735573,0
2799,4,1,1,34,0.02857142857142857,0.02857142857142857,0.9714285714285714,35,650,200,450,0.3076923076923077,11,2,9,350.49941095623177,0.3677170868347339,0.03489798305566194,0.19571649015446282,129473.85381235828,2076.1018990929692,131549.95571145124,2775,0,899.1714285714286,34,1,19,36.64756111825944,0.6191789215686274,45.56547619047619,1017.7380952380953,29.933473389355743,0
2800,4,0,0,34,0.0,0.0,1.0,34,600,400,200,0.6666666666666666,8,4,4,356.4339960440733,0.3597556446821153,0.033370047843596096,0.19841879454049546,129352.7228599772,2421.14158163264,131773.86444160985,2776,2,926.6176470588235,34,0,23,36.61985566608153,0.617953431372549,45.6845238095238,1017.2619047619038,29.91946778711482,0
2801,4,1,1,34,0.02857142857142857,0.02857142857142857,0.9714285714285714,35,750,500,250,0.6666666666666666,10,5,5,348.7403386015014,0.3662464985994398,0.030853636762056214,0.19586877600713548,129701.96926708249,2046.4617358967728,131748.43100297925,2777,0,901.1142857142858,35,0,20,36.4604637730561,0.6193452380952381,45.34143518518518,1018.6342592592594,29.10383597883598,0
2802,4,0,0,34,0.0,0.0,1.0,34,1250,700,550,0.56,18,7,11,355.3239761756605,0.35962566844919786,0.0339287187525783,0.19948503544350077,129685.96938775509,2416.1068594104245,132102.0762471655,2778,4,928.6176470588235,34,0,20,36.30907160666978,0.6213235294117647,45.357142857142854,1018.5714285714284,29.957983193277308,0
2803,4,0,0,34,0.0,0.0,1.0,34,900,700,200,0.7777777777777778,11,7,4,355.590143099811,0.3599041889483066,0.03380445318246483,0.19978889392679477,129716.28578514747,2425.166524943318,132141.4523100908,2779,5,929.6176470588235,34,0,20,36.271473647306294,0.6216299019607843,45.327380952380956,1018.6904761904768,29.961484593837554,0
2804,4,0,0,34,0.0,0.0,1.0,34,850,600,250,0.7058823529411765,11,6,5,355.4237064704215,0.3597927807486631,0.028023477179164757,0.20000470109666904,129776.9292091836,2425.159438775501,132202.08864795908,2780,6,930.6176470588235,34,0,20,36.21407290571329,0.6222426470588236,45.26785714285714,1018.9285714285708,29.968487394957965,0
2805,4,1,0,35,0.02857142857142857,0.0,1.0,35,700,400,300,0.5714285714285714,10,4,6,348.26857389915745,0.365546218487395,0.02964115530487188,0.19753148071732132,130085.41907793214,2060.932677469137,132146.35175540127,2781,0,905.0,35,0,22,36.08321987746765,0.6232142857142857,44.96527777777778,1020.1388888888891,29.146825396825403,0
2806,4,1,0,36,0.027777777777777776,0.0,1.0,36,800,500,300,0.625,11,5,6,335.75293571938766,0.36985780423280423,0.028386215645915147,0.19250283548961306,130505.75573979608,1563.7792501259942,132069.53498992207,2782,0,880.8333333333334,34,2,18,35.976882597382414,0.6295955882352939,44.55357142857144,1021.7857142857156,30.0525210084034,0
2807,4,0,0,36,0.0,0.0,1.0,36,600,400,200,0.6666666666666666,8,4,4,334.82833022987126,0.36964285714285716,0.02570175769700178,0.19237924425894556,130587.7074358067,1544.892805855616,132132.60024166232,2783,1,881.8333333333334,35,1,18,35.917624466840294,0.6282738095238095,44.473379629629626,1022.1064814814811,29.203042328042315,0
2808,4,0,0,36,0.0,0.0,1.0,36,1050,700,350,0.6666666666666666,14,7,7,335.9337410889422,0.36985780423280423,0.025815661711066307,0.19345754033766072,130676.44702717765,1579.725544410154,132256.1725715878,2784,2,882.8333333333334,35,1,18,35.79965662968833,0.6291666666666667,44.386574074074076,1022.4537037037038,29.212962962962965,0
2809,4,0,0,36,0.0,0.0,1.0,36,1200,1000,200,0.8333333333333334,14,10,4,335.59257259642175,0.369973544973545,0.030530728714912803,0.19400279589141725,130824.41332572428,1580.7402852794712,132405.15361100374,2785,3,883.8333333333334,35,1,19,35.6588462118641,0.630654761904762,44.24189814814814,1023.032407407406,29.229497354497315,0
2810,4,0,0,36,0.0,0.0,1.0,36,750,500,250,0.6666666666666666,10,5,5,335.59257259642175,0.369973544973545,0.030530728714912803,0.19400279589141725,130824.41332572428,1580.7402852794712,132405.15361100374,2786,4,884.8333333333334,35,1,19,35.6588462118641,0.630654761904762,44.24189814814814,1023.032407407406,29.229497354497315,0
2811,4,0,0,36,0.0,0.0,1.0,36,850,500,350,0.5882352941176471,12,5,7,335.52263498253086,0.37043650793650795,0.03512988726765465,0.19426035467456165,130883.62328800157,1582.8836323302487,132466.50692033183,2787,5,885.8333333333334,35,1,19,35.60082287071597,0.63125,44.18402777777778,1023.2638888888891,29.236111111111118,0
2812,4,0,0,36,0.0,0.0,1.0,36,1200,1000,200,0.8333333333333334,14,10,4,334.09259548644377,0.3703042328042328,0.033316378433367655,0.19432723157584258,131061.33355034713,1557.3242187499945,132618.65776909713,2788,6,886.8333333333334,35,1,21,35.45799423533402,0.6330357142857144,44.010416666666664,1023.9583333333326,29.25595238095236,0
2813,4,0,0,36,0.0,0.0,1.0,36,850,500,350,0.5882352941176471,12,5,7,334.79404962133714,0.3704530423280423,0.025367776271526532,0.1954879239609551,131209.51753257902,1585.633144718806,132795.15067729782,2789,7,887.8333333333334,35,1,22,35.29051815032382,0.6345238095238095,43.86574074074075,1024.5370370370383,29.272486772486808,0
2814,4,0,0,36,0.0,0.0,1.0,36,900,700,200,0.7777777777777778,11,7,4,342.0671877267781,0.3710978835978836,0.03731242525942213,0.2054067108510833,132275.51197562352,1868.7661844573154,134144.27816008084,2790,8,888.8333333333334,34,2,19,34.03034949658604,0.6473651960784315,42.82738095238095,1028.6904761904757,30.255602240896344,3
2815,4,0,0,36,0.0,0.0,1.0,36,900,500,400,0.5555555555555556,13,5,8,339.3998065917241,0.3706845238095238,0.036191255304148795,0.19701227133152685,130982.91710219628,1691.1720356034546,132674.08913779975,2791,9,889.8333333333334,33,3,17,35.40132786623568,0.6366792929292929,44.08700980392157,1023.6519607843138,31.019756387403447,2
2816,4,0,0,36,0.0,0.0,1.0,36,900,600,300,0.6666666666666666,12,6,6,338.462149092843,0.3696924603174603,0.027930676877667704,0.1971099776981805,131108.3946829345,1675.0458056997386,132783.44048863425,2792,10,890.8333333333334,33,3,18,35.29862689960514,0.6379419191919191,43.96446078431373,1024.1421568627454,31.03461081402259,0
2817,4,0,0,36,0.0,0.0,1.0,36,700,500,200,0.7142857142857143,9,5,4,336.6623932602276,0.36980820105820106,0.027671451355661736,0.1965431290262222,131202.5422914263,1634.192377931554,132836.73466935786,2793,11,891.8333333333334,33,3,18,35.249700956937794,0.638888888888889,43.87254901960784,1024.5098039215682,31.045751633986914,0
2818,4,0,2,34,0.0,0.05555555555555555,0.9444444444444444,36,1000,800,200,0.8,12,8,4,337.72843184573003,0.3698743386243386,0.030887081772037472,0.19748847182475485,131265.326136582,1666.4065503652319,132931.73268694725,2794,12,892.8333333333334,33,3,18,35.159052858167904,0.6395202020202021,43.811274509803916,1024.7549019607836,31.053178847296472,0
2819,4,3,2,35,0.08108108108108109,0.05405405405405406,0.9459459459459459,37,800,500,300,0.625,11,5,6,331.3554690293252,0.3743743743743744,0.045961303992151814,0.1961069464268957,131725.00177154198,1329.5599489795968,133054.56172052157,2795,0,868.7567567567568,34,3,17,34.85929104333371,0.6418504901960784,43.36309523809524,1026.5476190476193,30.19257703081233,0
2820,4,0,0,35,0.0,0.0,1.0,35,1050,700,350,0.6666666666666666,14,7,7,347.06782682308983,0.3685574229691877,0.05313357248364636,0.20431732066020167,131522.3255280075,2129.433539944921,133651.75906795243,2796,1,910.5714285714286,32,3,21,34.660419743968475,0.64453125,43.56060606060607,1025.757575757577,32.05492424242428,0
2821,4,0,0,35,0.0,0.0,1.0,35,950,600,350,0.631578947368421,13,6,7,346.600520710059,0.36792717086834736,0.05060923076923074,0.20421531767724665,131554.70623214476,2119.38593638405,133674.09216852882,2797,2,911.5714285714286,32,3,17,34.63974358974358,0.6448567708333333,43.52904040404041,1025.883838383839,32.05886994949497,0
2822,4,0,0,35,0.0,0.0,1.0,35,1100,900,200,0.8181818181818182,13,9,4,345.9654398385761,0.3681372549019608,0.05020302694721335,0.20418744586551268,131619.47959710754,2107.158230027567,133726.6378271351,2798,3,912.5714285714286,32,3,17,34.59071613141382,0.6455078125,43.4659090909091,1026.1363636363644,32.06676136363639,0
2823,4,0,0,35,0.0,0.0,1.0,35,700,200,500,0.2857142857142857,12,2,10,346.7865529481056,0.36841736694677873,0.053480033745781475,0.2048460103460905,131651.872257933,2131.0197938985925,133782.8920518316,2799,4,913.5714285714286,32,3,17,34.536991469816265,0.6458333333333333,43.43434343434344,1026.2626262626272,32.0707070707071,0
2824,4,0,0,35,0.0,0.0,1.0,35,1100,700,400,0.6363636363636364,15,7,8,338.09240531429714,0.36757703081232496,0.043902439024390505,0.19802555168408822,131328.12499999997,1882.3166960004075,133210.44169600037,2800,5,914.5714285714286,33,2,21,35.086382113821145,0.6401515151515151,43.75,1024.9999999999998,31.060606060606055,1
2825,4,0,0,35,0.0,0.0,1.0,35,850,500,350,0.5882352941176471,12,5,7,337.6198100692348,0.3677871148459384,0.04361513327030542,0.1982221829670293,131419.6588010204,1873.9760487528315,133293.63484977325,2801,6,915.5714285714286,34,1,21,35.00619219010022,0.6387867647058822,43.660714285714285,1025.357142857143,30.157563025210084,0
2826,4,1,1,35,0.027777777777777776,0.027777777777777776,0.9722222222222222,36,950,600,350,0.631578947368421,13,6,7,331.5565598100056,0.3749007936507936,0.04153510750263134,0.19601623815967525,131684.26890432098,1532.1566358024706,133216.42554012345,2802,0,891.1111111111111,35,1,17,34.89512855209744,0.6392857142857142,43.40277777777778,1026.388888888889,29.325396825396826,0
2827,4,0,1,34,0.0,0.02857142857142857,0.9714285714285714,35,950,800,150,0.8421052631578947,11,8,3,342.3350434160022,0.3677871148459384,0.04673516738481931,0.2021183612497221,131633.3616780047,2012.5425170068243,133645.90419501154,2803,8,917.5714285714286,34,1,17,34.669856921887096,0.6409313725490196,43.45238095238096,1026.1904761904775,30.18207282913169,0
2828,4,0,0,34,0.0,0.0,1.0,34,800,400,400,0.5,12,4,8,352.2576142006903,0.3671457219251337,0.054183264133314424,0.2078543342989696,131610.9057363754,2472.1887314975047,134083.0944678729,2804,9,924.4411764705883,33,1,18,34.437950356304015,0.6429924242424242,43.474264705882355,1026.1029411764705,31.094028520499105,0
2829,4,1,1,34,0.02857142857142857,0.02857142857142857,0.9714285714285714,35,1100,700,400,0.6363636363636364,15,7,8,344.58536175328635,0.3729341736694678,0.04857838348043497,0.20459311189577434,131847.23816609982,2086.5256519274412,133933.76381802728,2805,0,899.0,34,1,19,34.396613345697624,0.6430759803921569,43.24404761904762,1027.0238095238099,30.20658263305323,0
2830,4,0,0,34,0.0,0.0,1.0,34,800,700,100,0.875,9,7,2,356.3456576346684,0.3671642899584076,0.06487435069493186,0.21148559567836528,131831.05656478263,2595.4849096501166,134426.54147443274,2806,11,926.4411764705883,33,1,19,34.11097852028639,0.6452020202020203,43.25980392156862,1026.9607843137244,31.120023767082557,0
2831,4,1,0,35,0.02857142857142857,0.0,1.0,35,900,500,400,0.5555555555555556,13,5,8,349.1245160428323,0.3696078431372549,0.058512380290775656,0.20896662820942075,132153.07716836734,2227.575821995461,134380.6529903628,2807,0,900.9428571428572,34,1,21,33.972058199220406,0.646139705882353,42.94642857142857,1028.2142857142856,30.24159663865546,0
2832,4,0,0,35,0.0,0.0,1.0,35,1300,1100,200,0.8461538461538461,15,11,4,348.3375513652337,0.3699229691876751,0.058338960162052755,0.2088615034704093,132219.38898533946,2211.3956404320966,134430.78462577157,2808,1,901.9428571428572,35,0,21,33.92555705604321,0.6446428571428571,42.88194444444444,1028.472222222222,29.384920634920626,0
2833,4,0,0,35,0.0,0.0,1.0,35,800,700,100,0.875,9,7,2,349.50494100509474,0.3700980392156863,0.06203603980131511,0.2097265638563319,132249.1496940371,2244.3462523576686,134493.49594639477,2809,2,902.9428571428572,35,0,21,33.86559487641122,0.6449404761904762,42.85300925925925,1028.5879629629621,29.38822751322749,0
2834,4,0,0,35,0.0,0.0,1.0,35,1150,800,350,0.6956521739130435,15,8,7,348.6262269272412,0.3699229691876751,0.06249723606551805,0.2102018435004953,132429.53619100832,2233.849356187499,134663.38554719582,2810,3,903.9428571428572,33,2,22,33.70676568639123,0.651199494949495,42.677696078431374,1029.289215686275,31.190582293523484,0
2835,4,1,1,35,0.027777777777777776,0.027777777777777776,0.9722222222222222,36,550,400,150,0.7272727272727273,7,4,3,338.33373215043173,0.3732308201058201,0.061156043391745296,0.2054932246850516,132704.48022959172,1779.680413832184,134484.1606434239,2811,0,879.8055555555555,34,2,17,33.69559984594646,0.651654411764706,42.41071428571428,1030.357142857142,30.30462184873947,0
2836,4,0,0,35,0.0,0.0,1.0,35,1300,800,500,0.6153846153846154,18,8,10,348.6801608487061,0.36988795518207285,0.06755162743265086,0.21129464685893098,132618.81134960108,2248.3096945886186,134867.1210441897,2812,5,905.9428571428572,33,2,23,33.51514475510608,0.6530934343434345,42.493872549019606,1030.0245098039213,31.212863933452162,0
2837,4,0,0,35,0.0,0.0,1.0,35,700,500,200,0.7142857142857143,9,5,4,346.42842117282015,0.370343137254902,0.0684235713460617,0.21075409993626867,132765.81809807254,2198.770549886619,134964.58864795917,2813,6,906.9428571428572,34,1,19,33.42550344615147,0.6522671568627452,42.351190476190474,1030.595238095238,30.311624649859944,0
2838,4,0,0,35,0.0,0.0,1.0,35,1000,700,300,0.7,13,7,6,348.4358381404716,0.37048319327731094,0.07579461296122214,0.21267109190518865,132888.5363520409,2260.625708616789,135149.16206065766,2814,7,907.9428571428572,34,1,20,33.25058692221836,0.6534926470588235,42.23214285714286,1031.0714285714294,30.325630252100865,0
2839,4,0,0,35,0.0,0.0,1.0,35,800,600,200,0.75,10,6,4,347.7982571240759,0.3702731092436975,0.07704788286505782,0.21280537427422275,132980.61224489796,2250.085034013613,135230.69727891157,2815,8,908.9428571428572,34,1,20,33.17463065558635,0.6544117647058822,42.142857142857146,1031.4285714285716,30.336134453781515,0
2840,4,0,0,35,0.0,0.0,1.0,35,750,500,250,0.6666666666666666,10,5,5,353.2832804364501,0.37006302521008405,0.08290295469900943,0.21705264054596646,133134.14292800458,2406.8133503401396,135540.95627834473,2816,9,909.9428571428572,34,1,20,32.87912869612027,0.6559436274509804,41.99404761904762,1032.0238095238099,30.353641456582643,0
2841,4,0,1,34,0.0,0.02857142857142857,0.9714285714285714,35,800,500,300,0.625,11,5,6,355.06705565732625,0.37006302521008405,0.08324270884824525,0.2183284661382283,133164.8596938776,2456.490929705219,135621.3506235828,2817,10,910.9428571428572,34,1,20,32.80228758169935,0.65625,41.964285714285715,1032.1428571428576,30.35714285714287,0
2842,4,0,0,34,0.0,0.0,1.0,34,1050,700,350,0.6666666666666666,14,7,7,366.428746360641,0.3667929292929293,0.0942496699427906,0.225069035237269,133124.20590938584,2956.107176326421,136080.31308571226,2818,23,938.4411764705883,33,1,20,32.54994953093459,0.6581439393939392,42.00367647058824,1031.9852941176473,31.272281639928707,0
2843,4,0,0,34,0.0,0.0,1.0,34,1100,800,300,0.7272727272727273,14,8,6,373.2186071903426,0.36601307189542487,0.09801710595217328,0.23001951467290668,133250.70473195397,3146.328485438282,136397.03321739225,2819,24,939.4411764705883,33,1,20,32.247650840751724,0.6594065656565657,41.88112745098039,1032.4754901960778,31.287136066547813,0
2844,4,0,0,34,0.0,0.0,1.0,34,900,600,300,0.6666666666666666,12,6,6,372.66561683668385,0.3656231431966726,0.09799268544627182,0.230265822485306,133345.61827181865,3138.6654171472665,136484.28368896592,2820,25,940.4411764705883,33,1,21,32.166587565258666,0.6603535353535352,41.78921568627452,1032.843137254903,31.298276886512213,0
2845,4,0,0,34,0.0,0.0,1.0,34,650,400,250,0.6153846153846154,9,4,5,372.35326446228135,0.36616161616161613,0.09917092949411388,0.23026894102366616,133377.2636275711,3132.6919033544777,136509.9555309256,2821,26,941.4411764705883,33,1,22,32.142874797326684,0.6606691919191918,41.75857843137255,1032.9656862745096,31.301990493166958,0
2846,4,0,0,34,0.0,0.0,1.0,34,650,500,150,0.7692307692307693,8,5,3,371.3741700912559,0.36616161616161613,0.0984427218877113,0.2300555200616736,133440.56560277296,3111.275861447516,136551.84146422046,2822,27,942.4411764705883,33,1,22,32.10460898272248,0.661300505050505,41.697303921568626,1033.2107843137253,31.309417706476523,0
2847,4,0,0,34,0.0,0.0,1.0,34,700,400,300,0.5714285714285714,10,4,6,372.5576346319401,0.3655117349970291,0.09621258399511312,0.23118910079320948,133504.84206012153,3147.653388531489,136652.49544865303,2823,28,943.4411764705883,32,2,22,32.009519446141326,0.6643880208333333,41.63510101010102,1033.459595959597,32.295612373737406,0
2848,4,0,0,34,0.0,0.0,1.0,34,500,200,300,0.4,8,2,6,371.4714013288287,0.36564171122994654,0.09825958235725274,0.2307181252866307,133537.46588358335,3121.0699163350746,136658.53579991843,2824,29,944.4411764705883,32,2,22,32.004845671471614,0.6647135416666666,41.60353535353536,1033.585858585859,32.29955808080809,0
2849,4,0,0,34,0.0,0.0,1.0,34,950,800,150,0.8421052631578947,11,8,3,374.17381153644885,0.3653817587641117,0.09909502262443448,0.23321792362888252,133668.00103305784,3203.013085399448,136871.01411845727,2825,30,945.4411764705883,32,2,23,31.804029304029314,0.666015625,41.47727272727273,1034.090909090909,32.31534090909091,0
2850,4,0,0,34,0.0,0.0,1.0,34,600,300,300,0.5,9,3,6,374.9550336863553,0.3645833333333333,0.09267236737243367,0.23432544553717086,133765.94424357213,3231.2428259871444,136997.18706955927,2826,31,946.4411764705883,32,2,18,31.685585255706084,0.6669921875,41.38257575757576,1034.4696969696972,32.32717803030304,0
2851,4,0,0,34,0.0,0.0,1.0,34,850,500,350,0.5882352941176471,12,5,7,375.96813644051605,0.36404486036838973,0.09620187752992848,0.23558370384300248,133863.92332415076,3265.713957759429,137129.6372819102,2827,32,947.4411764705883,32,2,18,31.561127379209356,0.66796875,41.287878787878796,1034.8484848484861,32.33901515151519,0
2852,4,0,0,34,0.0,0.0,1.0,34,1100,700,400,0.6363636363636364,15,7,8,375.44570173406555,0.3636549316696376,0.09349299089826557,0.23579106636042008,133947.5220618271,3258.0042832083736,137205.52634503547,2828,33,948.4411764705883,33,1,19,31.490839943175096,0.6663510101010102,41.20710784313725,1035.1715686274504,31.368835412953043,0
2853,4,0,1,33,0.0,0.029411764705882353,0.9705882352941176,34,1000,800,200,0.8,12,8,4,375.6616496965582,0.362689393939394,0.09765290567771312,0.23674247588259584,134074.4113592127,3273.32291065935,137347.73426987207,2829,34,949.4411764705883,33,1,19,31.358098647102906,0.6676136363636365,41.084558823529406,1035.6617647058815,31.383689839572167,0
2854,4,0,0,33,0.0,0.0,1.0,33,1400,1300,100,0.9285714285714286,15,13,2,382.6399865354475,0.35913825757575757,0.07857955468876998,0.24147526534898534,134125.3762371186,3664.3464314865705,137789.72266860516,2830,35,896.1515151515151,32,1,20,31.126330651714607,0.6705729166666667,41.03535353535353,1035.8585858585852,32.37058080808079,0
2855,4,0,0,33,0.0,0.0,1.0,33,800,600,200,0.75,10,6,4,381.3593285113368,0.3586647727272727,0.07724171539961011,0.24152757472384662,134256.19834710742,3639.970730027544,137896.16907713495,2831,36,897.1515151515151,32,1,20,31.02841739766081,0.671875,40.90909090909091,1036.363636363636,32.386363636363626,0
2856,4,0,0,33,0.0,0.0,1.0,33,1050,800,250,0.7619047619047619,13,8,5,379.3253095745137,0.35909880050505055,0.07307270734380733,0.24088477315671553,134354.35677800732,3592.8015955004566,137947.1583735078,2832,37,898.1515151515151,32,1,20,30.982827913774194,0.6728515625,40.81439393939394,1036.742424242424,32.39820075757575,0
2857,4,0,0,33,0.0,0.0,1.0,33,650,400,250,0.6153846153846154,9,4,5,377.6254777499879,0.35858585858585856,0.07670655980748187,0.2402606611067967,134423.66667868118,3552.3602700884176,137976.0269487696,2833,38,899.1515151515151,33,0,20,30.957515953675255,0.6710858585858586,40.74754901960784,1037.009803921568,31.424539512774786,0
2858,4,0,0,33,0.0,0.0,1.0,33,600,300,300,0.5,9,3,6,397.6413159499564,0.3590198863636364,0.07792535788494925,0.2427850101008252,132901.00309583865,4043.0355102820563,136944.0386061207,2834,39,900.1515151515151,31,2,18,31.969656311823897,0.6609543010752689,42.22005208333333,1031.1197916666658,33.261928763440835,6
2859,4,0,0,33,0.0,0.0,1.0,33,750,500,250,0.6666666666666666,10,5,5,395.26074590615497,0.358822601010101,0.07574418933752547,0.2422003781759059,133035.2973937987,3916.7261759439975,136952.0235697427,2835,40,901.1515151515151,31,2,18,31.89566767638521,0.6622983870967742,42.08984374999999,1031.640624999999,33.27872983870965,0
2860,4,0,0,33,0.0,0.0,1.0,33,850,700,150,0.8235294117647058,10,7,3,398.0135710278441,0.35771780303030304,0.07264163206631058,0.2445469429431544,133136.0626220703,3997.991943359376,137134.0545654297,2836,41,902.1515151515151,31,2,18,31.72312641937926,0.6633064516129032,41.9921875,1032.03125,33.29133064516129,0
2861,4,0,0,33,0.0,0.0,1.0,33,650,400,250,0.6153846153846154,9,4,5,397.2285161181722,0.3569681186868687,0.06956908534890238,0.24434485472280326,133178.82303145077,3980.485250229559,137159.30828168034,2837,42,903.1515151515151,32,1,18,31.70030581039756,0.6611328125,41.95075757575757,1032.1969696969688,32.256155303030276,0
2862,4,0,0,33,0.0,0.0,1.0,33,950,600,350,0.631578947368421,13,6,7,392.95246576789486,0.35665246212121215,0.07396207396207344,0.2421380793205784,133243.99495268334,3871.711273084366,137115.7062257677,2838,43,904.1515151515151,32,1,18,31.745036892095687,0.6617838541666667,41.887626262626256,1032.4494949494945,32.2640467171717,0
2863,4,0,0,33,0.0,0.0,1.0,33,700,400,300,0.5714285714285714,10,4,6,393.14267609591064,0.356060606060606,0.06917833592650235,0.2428932847782891,133341.78272625234,3884.4690592796537,137226.251785532,2839,44,905.1515151515151,32,1,18,31.64170741646292,0.6627604166666667,41.79292929292929,1032.828282828282,32.27588383838381,0
2864,4,0,0,33,0.0,0.0,1.0,33,700,600,100,0.8571428571428571,8,6,2,393.56636767739735,0.35610006313131315,0.06977510655868202,0.24379663790341724,133439.60636988565,3903.468236659515,137343.07460654515,2840,45,906.1515151515151,32,1,19,31.532343476312672,0.6637369791666667,41.69823232323232,1033.2070707070702,32.287720959595944,0
2865,4,0,0,33,0.0,0.0,1.0,33,500,400,100,0.8,6,4,2,394.66461474850996,0.3556265782828283,0.0685437144814054,0.24490749596031497,133504.84206012142,3937.9274117437017,137442.76947186512,2841,46,907.1515151515151,32,1,19,31.43835267766239,0.6643880208333334,41.63510101010101,1033.459595959596,32.29561237373738,0
2866,4,0,0,33,0.0,0.0,1.0,33,1000,700,300,0.7,13,7,6,395.58408661715913,0.3546006944444444,0.07451407085017214,0.2461278496368768,133602.72548719522,3970.222426283036,137572.94791347825,2842,47,908.1515151515151,32,1,19,31.316153720892366,0.6653645833333334,41.54040404040404,1033.838383838384,32.3074494949495,0
2867,4,0,0,33,0.0,0.0,1.0,33,1300,800,500,0.6153846153846154,18,8,10,392.51536994137984,0.3538904671717172,0.07022489576512259,0.2448662144089751,133700.6447843333,3895.9116097847204,137596.55639411803,2843,48,909.1515151515151,32,1,17,31.297053676799745,0.6663411458333334,41.44570707070707,1034.217171717172,32.31928661616163,0
2868,4,0,0,33,0.0,0.0,1.0,33,850,700,150,0.8235294117647058,10,7,3,391.8273733330957,0.35428503787878785,0.07143570453713255,0.24486969257956143,133765.94424357198,3882.631714876019,137648.575958448,2844,49,910.1515151515151,32,1,17,31.249237153667767,0.6669921875,41.38257575757575,1034.469696969696,32.327178030303,0
2869,4,0,0,33,0.0,0.0,1.0,33,950,700,250,0.7368421052631579,12,7,5,391.62841453508935,0.3541272095959596,0.06555983157178713,0.24561423978149394,133896.59098880214,3887.5419281195736,137784.13291692172,2845,50,911.1515151515151,32,1,17,31.123175145378394,0.6682942708333334,41.25631313131313,1034.9747474747471,32.34296085858585,0
2870,4,0,0,33,0.0,0.0,1.0,33,800,600,200,0.75,10,6,4,391.6382019694019,0.3544034090909091,0.057857285362772126,0.24671401939731474,134059.9890955006,3900.6026170799105,137960.59171258053,2846,51,912.1515151515151,32,1,18,30.958912460375526,0.669921875,41.09848484848486,1035.6060606060619,32.362689393939434,0
2871,4,0,0,33,0.0,0.0,1.0,33,800,600,200,0.75,10,6,4,392.32189517935933,0.3545612373737374,0.05480626082844786,0.24736483521570224,134092.6806735283,3921.4989223038583,138014.17959583216,2847,52,913.1515151515151,32,1,18,30.908407493193547,0.6702473958333333,41.0669191919192,1035.7323232323238,32.36663510101012,0
2872,4,0,0,33,0.0,0.0,1.0,33,1100,1000,100,0.9090909090909091,12,10,2,391.0719182222499,0.3545217803030303,0.05455062382075915,0.24745776660370142,134223.48684126633,3898.207293898602,138121.69413516493,2848,53,914.1515151515151,32,1,19,30.80957312863003,0.6715494791666665,40.940656565656575,1036.2373737373748,32.38241792929296,0
2873,4,0,0,33,0.0,0.0,1.0,33,900,700,200,0.7777777777777778,11,7,4,391.54650898771445,0.35365372474747475,0.05368344920220203,0.24886841577454438,134387.08422609948,3923.7587363534503,138310.84296245294,2849,54,915.1515151515151,32,1,19,30.63327041727554,0.6731770833333333,40.78282828282829,1036.8686868686877,32.40214646464649,0
2874,4,0,0,33,0.0,0.0,1.0,33,850,600,250,0.7058823529411765,11,6,5,392.17262693528613,0.35404829545454547,0.03164139263421406,0.2508378848856901,134616.2879584992,3958.5646553923198,138574.8526138915,2850,55,916.1515151515151,32,1,19,30.38741533844345,0.6754557291666666,40.56186868686869,1037.7525252525259,32.42976641414143,1
2875,4,0,0,33,0.0,0.0,1.0,33,650,400,250,0.6153846153846154,9,4,5,390.74804198412284,0.35353535353535354,0.034682592346826135,0.25015178388703185,134649.04729109278,3922.77031680441,138571.8176078972,2851,56,917.1515151515151,32,1,19,30.39157542579075,0.67578125,40.53030303030303,1037.878787878788,32.433712121212125,0
2876,4,0,0,33,0.0,0.0,1.0,33,550,400,150,0.7272727272727273,7,4,3,389.80383863714763,0.35321969696969696,0.03784377464747224,0.24999743847696035,134714.5779129683,3902.451918171644,138617.02983113992,2852,57,918.1515151515151,32,1,19,30.350482445471503,0.6764322916666665,40.46717171717173,1038.1313131313148,32.441603535353586,0
2877,4,0,0,33,0.0,0.0,1.0,33,1050,800,250,0.7619047619047619,13,8,5,387.06295832153904,0.3534169823232323,0.04375992106053461,0.24929678075481496,134868.83049788547,3840.545703575552,138709.376201461,2853,58,919.1515151515151,33,0,18,30.267323422998267,0.6755050505050504,40.318627450980394,1038.7254901960787,31.47653000594178,0
2878,4,0,0,33,0.0,0.0,1.0,33,550,300,250,0.5454545454545454,8,3,5,389.67459788378085,0.3533380681818182,0.04131906467362967,0.25142018575789143,134932.48540224915,3915.9523981161087,138848.43780036527,2854,59,920.1515151515151,33,0,18,30.135841786584884,0.6761363636363636,40.25735294117647,1038.9705882352941,31.483957219251337,0
2879,4,0,0,33,0.0,0.0,1.0,33,1300,1200,100,0.9230769230769231,14,12,2,388.2313826097155,0.3534169823232323,0.041071166911478274,0.2507093597218414,134964.31848627928,3879.476793781238,138843.79528006053,2855,60,921.1515151515151,33,0,18,30.141501552856074,0.6764520202020202,40.22671568627451,1039.0931372549019,31.487670825906118,0
2880,4,0,0,33,0.0,0.0,1.0,33,550,500,50,0.9090909090909091,6,5,1,386.6035068351806,0.3538510101010101,0.04422005695440445,0.2500979665498982,135027.99591803632,3840.459348567856,138868.45526660417,2856,61,922.1515151515151,33,0,18,30.12014601265573,0.6770833333333334,40.16544117647059,1039.3382352941176,31.495098039215684,0
2881,4,0,0,33,0.0,0.0,1.0,33,1050,600,450,0.5714285714285714,15,6,9,384.1989520832807,0.3533380681818182,0.053184764557775654,0.24942066629124984,135155.39583633692,3785.312289744322,138940.70812608124,2857,62,923.1515151515151,33,0,18,30.055367314869383,0.6783459595959596,40.04289215686274,1039.8284313725485,31.509952465834804,0
2882,4,0,0,33,0.0,0.0,1.0,33,650,500,150,0.7692307692307693,8,5,3,384.61762782515336,0.3536931818181818,0.05196437626322159,0.24991310794213273,135187.25520232608,3799.080281622459,138986.33548394853,2858,63,924.1515151515151,33,0,18,30.012667923638944,0.6786616161616161,40.01225490196079,1039.9509803921571,31.51366607248961,0
2883,4,0,0,33,0.0,0.0,1.0,33,750,500,250,0.6666666666666666,10,5,5,381.64333737363404,0.3536142676767677,0.05073232025758845,0.24863931626744273,135282.85582768646,3725.9601175028847,139008.81594518936,2859,64,925.1515151515151,33,0,18,29.994576314446146,0.6796085858585859,39.9203431372549,1040.3186274509803,31.52480689245395,0
2884,4,0,0,33,0.0,0.0,1.0,33,900,700,200,0.7777777777777778,11,7,4,378.31715890367406,0.35298295454545453,0.05312841149902581,0.2475674844166262,135442.2652945982,3648.0266003460174,139090.29189494424,2860,65,926.1515151515151,33,0,18,29.922101875833917,0.6811868686868687,39.7671568627451,1040.9313725490194,31.54337492572786,0
2885,4,0,0,33,0.0,0.0,1.0,33,850,600,250,0.7058823529411765,11,6,5,380.545564387639,0.35254892676767674,0.06013536161806354,0.24991315349042953,135569.86045030763,3718.10181180316,139287.96226211078,2861,66,927.1515151515151,33,0,18,29.736898878167423,0.6824494949494949,39.64460784313726,1041.4215686274513,31.55822935234701,0
2886,4,0,0,33,0.0,0.0,1.0,33,400,300,100,0.75,5,3,2,379.8399999999999,0.3523121843434343,0.05648484848484858,0.24989473684210528,135633.6805555556,3703.8344627066563,139337.51501826226,2862,67,928.1515151515151,32,1,18,29.691666666666677,0.685546875,39.583333333333336,1041.666666666667,32.55208333333334,0
2887,4,0,0,33,0.0,0.0,1.0,33,900,800,100,0.8888888888888888,10,8,2,381.045139925325,0.352114898989899,0.054657810383001326,0.2513801390730382,135732.34116735542,3744.0297865013827,139476.3709538568,2863,68,929.1515151515151,32,1,18,29.56197746274082,0.6865234375,39.48863636363637,1042.045454545455,32.56392045454547,0
2888,4,0,0,33,0.0,0.0,1.0,33,550,300,250,0.5454545454545454,8,3,5,381.51957138994084,0.3517203282828283,0.05646582100070496,0.25238987030411447,135831.0376492194,3764.4398530762105,139595.4775022956,2864,69,930.1515151515151,32,1,18,29.45130813953488,0.6875,39.39393939393939,1042.4242424242418,32.57575757575756,0
2889,4,0,0,33,0.0,0.0,1.0,33,900,700,200,0.7777777777777778,11,7,4,382.6159648540251,0.3518781565656566,0.05513044946253132,0.25334883895747257,135863.9444476328,3796.742838740929,139660.68728637372,2865,70,931.1515151515151,32,1,17,29.38996205239998,0.6878255208333334,39.36237373737373,1042.5505050505042,32.579703282828255,0
2890,4,0,0,33,0.0,0.0,1.0,33,950,800,150,0.8421052631578947,11,8,3,384.2169290797559,0.3513652146464647,0.052525727141021106,0.2557340670254855,136048.87730980865,3854.4563689446277,139903.3336787533,2866,71,932.1515151515151,33,0,17,29.164097067230504,0.6871843434343434,39.18504901960784,1043.2598039215682,31.613933452168734,0
2891,4,0,0,33,0.0,0.0,1.0,33,950,600,350,0.631578947368421,13,6,7,379.1101655039746,0.35093118686868685,0.04959195144684703,0.2534741279248709,136208.7373245867,3727.6233900422903,139936.36071462897,2867,72,933.1515151515151,33,0,18,29.138295374501052,0.6887626262626263,39.03186274509804,1043.8725490196077,31.63250148544266,0
2892,4,0,0,33,0.0,0.0,1.0,33,550,400,150,0.7272727272727273,7,4,3,378.1705354354049,0.3506549873737374,0.05343744888452684,0.253761362439411,136336.692918589,3711.704032103031,140048.39695069203,2868,73,934.1515151515151,33,0,19,29.035633262927327,0.6900252525252526,38.90931372549019,1044.3627450980389,31.647355912061784,0
2893,4,0,0,33,0.0,0.0,1.0,33,950,700,250,0.7368421052631579,12,7,5,379.00746404927486,0.3511679292929293,0.05678930740499899,0.2554779957271275,136496.72188881657,3746.6552828238882,140243.37717164046,2869,74,935.1515151515151,33,0,19,28.8547896876588,0.6916035353535355,38.75612745098038,1044.9754901960766,31.665923945335656,0
2894,4,0,0,33,0.0,0.0,1.0,33,550,200,350,0.36363636363636365,9,2,7,379.3295574958529,0.35223327020202017,0.051937901879285375,0.25639311612041404,136592.78432574007,3762.736087081892,140355.52041282196,2870,75,936.1515151515151,33,0,19,28.7509769441188,0.6925505050505051,38.66421568627451,1045.3431372549019,31.677064765300056,0
2895,4,0,0,33,0.0,0.0,1.0,33,1050,800,250,0.7619047619047619,13,8,5,380.19963965049845,0.3513652146464647,0.04998774810095563,0.25768415608718814,136688.8805537532,3793.812626153384,140482.69317990658,2871,76,937.1515151515151,33,0,19,28.632832337200682,0.6934974747474748,38.57230392156862,1045.7107843137242,31.68820558526437,0
2896,4,0,0,33,0.0,0.0,1.0,33,500,300,200,0.6,7,3,4,379.0781026430649,0.3506944444444444,0.051418590781290296,0.25762823918480876,136785.0105728564,3770.440455593979,140555.4510284504,2872,77,938.1515151515151,33,0,19,28.566756482349273,0.6944444444444444,38.480392156862735,1046.0784313725476,31.699346405228713,0
2897,4,0,0,33,0.0,0.0,1.0,33,650,600,50,0.9230769230769231,7,6,1,379.0781026430649,0.3506944444444444,0.051418590781290296,0.25762823918480876,136785.0105728564,3770.440455593979,140555.4510284504,2873,78,939.1515151515151,33,0,19,28.566756482349273,0.6944444444444444,38.480392156862735,1046.0784313725476,31.699346405228713,0
2898,4,0,0,33,0.0,0.0,1.0,33,500,100,400,0.2,9,1,8,379.6370734621282,0.35057607323232326,0.05213668842578301,0.2582439598522858,136817.0614216887,3788.16575956362,140605.22718125232,2874,79,940.1515151515151,33,0,19,28.520337940728602,0.694760101010101,38.44975490196078,1046.2009803921562,31.703060011883522,0
2899,4,0,0,33,0.0,0.0,1.0,33,850,700,150,0.8235294117647058,10,7,3,386.010628715182,0.35057607323232326,0.06721750061780796,0.2453821134154135,134391.8974222654,3775.3401636389763,138167.2375859044,2875,80,941.1515151515151,33,0,19,30.771948745223185,0.6707702020202021,40.7781862745098,1036.8872549019602,31.420825906120005,4
2900,4,0,0,33,0.0,0.0,1.0,33,650,400,250,0.6153846153846154,9,4,5,382.4131868840825,0.34974747474747475,0.06279664110989414,0.24415611162599116,134550.78125,3690.8924752499042,138241.67372524992,2876,81,942.1515151515151,32,1,20,30.706157965194112,0.6748046875,40.625,1037.5,32.421875,0
2901,4,0,0,33,0.0,0.0,1.0,33,500,300,200,0.6,7,3,4,384.30124140870606,0.34974747474747475,0.06801592568015957,0.24602462650931178,134649.04729109275,3749.1592056932986,138398.20649678604,2877,82,943.1515151515151,32,1,20,30.5588503649635,0.67578125,40.53030303030303,1037.8787878787878,32.43371212121212,0
2902,4,0,0,33,0.0,0.0,1.0,33,750,400,350,0.5333333333333333,11,4,7,387.66988479411657,0.34947127525252525,0.06446716404163189,0.249302955624051,134812.9037375014,3852.5805721355114,138665.4843096369,2878,83,944.1515151515151,32,1,18,30.307497467071926,0.6774088541666665,40.372474747474755,1038.510101010102,32.45344065656569,0
2903,4,0,0,33,0.0,0.0,1.0,33,750,600,150,0.8,9,6,3,388.66567531241975,0.3499842171717172,0.06579160589855793,0.2506223492531808,134911.26543209865,3887.0756172839374,138798.34104938258,2879,84,945.1515151515151,32,1,18,30.18326648841354,0.6783854166666667,40.27777777777777,1038.888888888888,32.46527777777775,0
2904,4,0,0,33,0.0,0.0,1.0,33,900,800,100,0.8888888888888888,10,8,2,387.82976775193634,0.3492739898989899,0.06437116657557485,0.25133383650417723,135091.68836805565,3878.5156250000105,138970.20399305565,2880,85,946.1515151515151,33,0,18,30.02463259853039,0.6777146464646464,40.10416666666667,1039.5833333333342,31.502525252525277,0
2905,4,0,0,33,0.0,0.0,1.0,33,800,500,300,0.625,11,5,6,386.3400080157542,0.34935290404040403,0.06679239352506694,0.2505893446487506,135123.54022491345,3840.725922722023,138964.26614763547,2881,86,947.1515151515151,33,0,18,30.031529938708164,0.678030303030303,40.0735294117647,1039.7058823529408,31.506238859180023,0
2906,4,0,0,33,0.0,0.0,1.0,33,600,500,100,0.8333333333333334,7,5,2,383.287183643041,0.34935290404040403,0.07394028042492184,0.2418836965082698,134125.3762371186,3682.66871137892,137808.0449484975,2882,87,948.1515151515151,32,1,19,31.10957053469852,0.6705729166666667,41.03535353535353,1035.8585858585852,32.37058080808079,3
2907,4,0,0,33,0.0,0.0,1.0,33,750,600,150,0.8,9,6,3,382.9817953336966,0.3495107323232323,0.07649437704282325,0.24190651506643418,134158.07578627174,3676.0201446280926,137834.09593089984,2883,88,949.1515151515151,32,1,20,31.084704448507004,0.6708984375,41.003787878787875,1035.984848484848,32.3745265151515,0
2908,4,0,0,33,0.0,0.0,1.0,33,700,500,200,0.7142857142857143,9,5,4,382.9757446735748,0.3498263888888889,0.07489367357788401,0.24255130495993066,134256.19834710742,3683.373507805321,137939.57185491273,2884,89,950.1515151515151,32,1,20,30.98653752436646,0.671875,40.90909090909091,1036.363636363636,32.386363636363626,0
2909,4,0,0,33,0.0,0.0,1.0,33,800,500,300,0.625,11,5,6,381.85745783498123,0.3492739898989899,0.07341067764837894,0.24271001886539223,134387.0842260994,3663.3420696867697,138050.42629578616,2885,90,951.1515151515151,32,1,20,30.884427260918986,0.6731770833333334,40.782828282828284,1036.868686868687,32.40214646464647,0
2910,4,0,0,33,0.0,0.0,1.0,33,900,600,300,0.6666666666666666,12,6,6,381.07718600483093,0.34935290404040403,0.07705248245788798,0.2426486826235411,134452.5510789715,3647.3599632690534,138099.91104224056,2886,91,952.1515151515151,32,1,20,30.839116143170195,0.673828125,40.71969696969697,1037.121212121212,32.410037878787875,0
2911,4,0,0,33,0.0,0.0,1.0,33,1100,800,300,0.7272727272727273,14,8,6,384.0260640957405,0.3485637626262626,0.07399294146282154,0.2451858716918958,134550.78125,3734.201388888889,138284.98263888888,2887,92,953.1515151515151,32,1,20,30.66432396251673,0.6748046875,40.625,1037.5,32.421875,0
2912,4,0,0,33,0.0,0.0,1.0,33,800,500,300,0.625,11,5,6,384.23541364689777,0.34903724747474746,0.07508278206745023,0.2455401733553816,134583.53261146825,3742.35186460566,138325.8844760739,2888,93,954.1515151515151,32,1,20,30.626115437657173,0.6751302083333333,40.593434343434346,1037.626262626263,32.42582070707072,0
2913,4,0,0,33,0.0,0.0,1.0,33,1200,1000,200,0.8333333333333334,14,10,4,383.8411964412467,0.3481691919191919,0.06958309840469656,0.2463954846476484,134747.34920224993,3744.3167470156295,138491.66594926556,2889,94,955.1515151515151,32,1,20,30.47245530828165,0.6767578125,40.43560606060607,1038.257575757577,32.44554924242428,0
2914,4,0,0,33,0.0,0.0,1.0,33,1000,800,200,0.8,12,8,4,385.60002564384,0.348208648989899,0.07286139606178521,0.2477480164761674,134780.12447709424,3794.2438909295074,138574.36836802374,2890,95,956.1515151515151,32,1,18,30.394019536316474,0.6770833333333333,40.40404040404041,1038.383838383839,32.44949494949497,0
2915,4,0,0,33,0.0,0.0,1.0,33,700,600,100,0.8571428571428571,8,6,2,386.38209181363834,0.348208648989899,0.07540941328175377,0.2484748010294897,134812.90373750124,3817.8583499132747,138630.7620874145,2891,96,957.1515151515151,32,1,18,30.340932117527867,0.6774088541666666,40.37247474747475,1038.510101010101,32.453440656565654,0
2916,4,0,0,33,0.0,0.0,1.0,33,800,700,100,0.875,9,7,2,385.12682661786164,0.34777462121212116,0.06919461999675902,0.24834040199151747,134911.26543209868,3791.589506172827,138702.8549382715,2892,97,958.1515151515151,32,1,18,30.275178253119414,0.6783854166666667,40.27777777777777,1038.8888888888882,32.46527777777776,0
2917,4,0,0,33,0.0,0.0,1.0,33,850,600,250,0.7058823529411765,11,6,5,386.9977460008811,0.34757733585858586,0.06419927620267818,0.25022611526576993,135009.66299676045,3849.687053616966,138859.35005037743,2893,98,959.1515151515151,32,1,18,30.128224598064225,0.6793619791666667,40.1830808080808,1039.2676767676762,32.47711489898988,0
2918,4,0,0,33,0.0,0.0,1.0,33,1000,600,400,0.6,14,6,8,388.7288315093639,0.3474589646464647,0.06054716974187424,0.2518020825976861,135075.2813010152,3901.5312531884497,138976.81255420364,2894,99,960.1515151515151,32,1,18,30.01766265840722,0.6800130208333334,40.119949494949495,1039.5202020202019,32.48500631313131,0
2919,4,0,0,33,0.0,0.0,1.0,33,800,700,100,0.875,9,7,2,385.6005786311262,0.347103851010101,0.0624827510073418,0.2502301627287094,135140.9155475206,3822.083046372814,138962.9985938934,2895,100,961.1515151515151,32,1,18,30.03339404978749,0.6806640625,40.05681818181818,1039.7727272727268,32.49289772727271,0
2920,4,0,0,33,0.0,0.0,1.0,33,550,500,50,0.9090909090909091,6,5,1,382.44332350730406,0.34809027777777773,0.058465205588293934,0.2488600394196816,135239.39680899904,3744.280876951329,138983.67768595036,2896,101,962.1515151515151,32,1,19,30.017146151978643,0.681640625,39.96212121212121,1040.1515151515148,32.50473484848484,0
2921,4,1,1,33,0.029411764705882353,0.029411764705882353,0.9705882352941176,34,950,700,250,0.7368421052631579,12,7,5,374.11611902985993,0.35288547237076645,0.049178796121343016,0.24590973670802635,135601.76862564884,3346.161482362559,138947.9301080114,2897,0,934.8235294117648,33,1,19,29.872509510922853,0.6827651515151516,39.6139705882353,1041.5441176470592,31.561942959001794,0
2922,4,0,0,33,0.0,0.0,1.0,33,700,500,200,0.7142857142857143,9,5,4,381.9609974383911,0.34663036616161613,0.05456309823122063,0.2499116240382616,135436.46694214878,3746.2896005509665,139182.75654269973,2898,103,964.1515151515151,32,1,19,29.833060407569146,0.68359375,39.77272727272727,1040.909090909091,32.52840909090909,0
2923,4,0,0,33,0.0,0.0,1.0,33,900,700,200,0.7777777777777778,11,7,4,383.25430095741984,0.3472616792929293,0.054308849895658984,0.2516784613293631,135567.92674216925,3791.398199163361,139359.3249413326,2899,104,965.1515151515151,32,1,20,29.668303427093438,0.6848958333333333,39.64646464646465,1041.414141414142,32.54419191919194,0
2924,4,0,0,33,0.0,0.0,1.0,33,800,600,200,0.75,10,6,4,382.51197157052593,0.34809027777777773,0.05369980566974153,0.25142161382352773,135600.80165608114,3773.785997602302,139374.58765368344,2900,105,966.1515151515151,32,1,20,29.654857154402546,0.6852213541666666,39.614898989899,1041.540404040405,32.54813762626266,0
2925,4,0,0,33,0.0,0.0,1.0,33,1050,800,250,0.7619047619047619,13,8,5,381.82638313389975,0.3480508207070707,0.053085386095565346,0.2516638429409697,135699.45031119275,3762.7260611162146,139462.17637230895,2901,106,967.1515151515151,32,1,20,29.574396105994516,0.6861979166666666,39.52020202020202,1041.919191919192,32.55997474747475,0
2926,4,0,0,33,0.0,0.0,1.0,33,900,700,200,0.7777777777777778,11,7,4,408.0671626790544,0.3480508207070707,0.05059001694330734,0.23231091148573782,130230.36552392616,4028.547150800943,134258.9126747271,2902,107,968.1515151515151,32,1,18,34.41030636648523,0.6315104166666666,44.823232323232325,1020.707070707071,31.89709595959597,8
2927,4,0,0,33,0.0,0.0,1.0,33,950,700,250,0.7368421052631579,12,7,5,406.5833472461418,0.3474984217171717,0.04514349530426709,0.2318499961799933,130294.81207274778,3995.140164268969,134289.95223701675,2903,108,969.1515151515151,32,1,18,34.382471761892994,0.6321614583333333,44.76010101010102,1020.9595959595968,31.9049873737374,0
2928,4,1,0,34,0.029411764705882353,0.0,1.0,34,700,600,100,0.8571428571428571,8,6,2,397.74252227435727,0.3525698158051099,0.05983821415485213,0.22994145262786253,130826.15460399848,3607.0249423298765,134433.17954632835,2904,0,941.6176470588235,33,1,16,34.06754112761539,0.6351010101010102,44.240196078431374,1023.0392156862747,31.001188354129535,0
2929,4,0,0,34,0.0,0.0,1.0,34,500,200,300,0.4,8,2,6,396.16757295513025,0.35236556743909686,0.06246169884550645,0.22959024300820913,130920.20083922052,3573.2676434544424,134493.46848267497,2905,1,942.6176470588235,33,1,16,34.012268989741756,0.6360479797979798,44.14828431372549,1023.4068627450982,31.012329174093885,0
2930,4,1,1,34,0.02857142857142857,0.02857142857142857,0.9714285714285714,35,1100,600,500,0.5454545454545454,16,6,10,387.42489263260256,0.35990896358543417,0.0626134873607862,0.22637922952401987,131236.62308673482,3168.866921768725,134405.49000850355,2906,0,916.6571428571428,34,1,17,33.91498199140234,0.6369485294117647,43.83928571428572,1024.6428571428582,30.136554621848774,0
2931,4,0,0,34,0.0,0.0,1.0,34,500,300,200,0.6,7,3,4,387.5954411908182,0.35838161021984555,0.0343177112870936,0.22683950735633962,131297.62081916112,3378.0718537415128,134675.69267290263,2900,1,859.1470588235294,34,0,17,33.84878228210788,0.6375612745098038,43.77976190476191,1024.8809523809534,30.14355742296922,0
2932,4,1,1,34,0.02857142857142857,0.02857142857142857,0.9714285714285714,35,800,600,200,0.75,10,6,4,378.9590236191687,0.3633053221288515,0.0279780551273765,0.2235624794369349,131602.82206632668,2974.4189342403856,134577.24100056707,2901,0,835.5714285714286,34,1,14,33.76116718876901,0.6406249999999998,43.48214285714287,1026.0714285714298,30.178571428571466,0
2933,4,0,0,34,0.0,0.0,1.0,34,800,700,100,0.875,9,7,2,391.476113254508,0.358493018419489,0.033945302341273464,0.23023637328369523,131485.18786344223,3494.6620590638595,134979.84992250608,2902,3,861.1470588235294,33,1,18,33.559241446608524,0.6417297979797978,43.596813725490215,1025.6127450980416,31.07917409388005,0
2934,4,0,0,34,0.0,0.0,1.0,34,700,500,200,0.7142857142857143,9,5,4,391.476113254508,0.358493018419489,0.033945302341273464,0.23023637328369523,131485.18786344223,3494.6620590638595,134979.84992250608,2903,4,862.1470588235294,33,1,18,33.559241446608524,0.6417297979797978,43.596813725490215,1025.6127450980416,31.07917409388005,0
2935,4,0,0,34,0.0,0.0,1.0,34,700,600,100,0.8571428571428571,8,6,2,390.35405624206084,0.3590129233511587,0.03647396122467583,0.22995452532035857,131548.03929077776,3470.062145569032,135018.1014363468,2904,5,863.1470588235294,33,1,19,33.524344960777285,0.6423611111111109,43.535539215686285,1025.8578431372564,31.08660130718959,0
2936,4,0,0,34,0.0,0.0,1.0,34,550,300,250,0.5454545454545454,8,3,5,387.5435706147273,0.35969994058229354,0.03789538738131326,0.22924187482125427,131705.2335640141,3408.3032968089483,135113.53686082305,2905,6,864.1470588235294,33,1,14,33.43730101878382,0.6439393939393938,43.382352941176485,1026.4705882352962,31.105169340463522,0
2937,4,1,0,35,0.02857142857142857,0.0,1.0,35,800,700,100,0.875,9,7,2,378.72221862721165,0.3649509803921569,0.04496649846968337,0.2263160109235971,132091.88102324284,3005.2260487528606,135097.1070719957,2906,0,840.4285714285714,34,1,16,33.27301679212508,0.6455269607843136,43.005952380952394,1027.9761904761922,30.234593837535066,0
2938,4,0,1,34,0.0,0.02857142857142857,0.9714285714285714,35,900,800,100,0.8888888888888888,10,8,2,379.26182142988677,0.36558123249299723,0.034329370132125225,0.2273728574137955,132214.28748582772,3028.7662981859503,135243.05378401367,2907,1,841.4285714285714,34,1,17,33.135586680557175,0.6467524509803921,42.886904761904766,1028.4523809523814,30.248599439775923,0
2939,4,1,0,35,0.02857142857142857,0.0,1.0,35,600,500,100,0.8333333333333334,7,5,2,377.3972821964765,0.36722689075630255,0.035870980184176116,0.2268211251821828,132308.68115837208,2986.587336033973,135295.26849440605,2908,0,842.1714285714286,35,0,18,33.08829733378332,0.6455357142857141,42.7951388888889,1028.819444444446,29.39484126984131,0
2940,4,0,0,35,0.0,0.0,1.0,35,1000,700,300,0.7,13,7,6,377.8131095412148,0.36698179271708686,0.043030653556969334,0.22760936111385419,132398.0034722224,3004.340277777796,135402.3437500002,2909,1,843.1714285714286,35,0,19,32.98751686909581,0.6464285714285714,42.70833333333334,1029.166666666668,29.404761904761944,0
2941,4,1,1,35,0.027777777777777776,0.027777777777777776,0.9722222222222222,36,450,200,250,0.4444444444444444,7,2,5,370.654210326979,0.3736276455026455,0.038789013732834166,0.2247154272418333,132636.34366426614,2632.4438443072763,135268.7875085734,2910,0,820.7222222222222,35,1,16,32.93164794007491,0.6488095238095237,42.476851851851855,1030.0925925925928,29.431216931216937,0
2942,4,0,0,35,0.0,0.0,1.0,35,750,600,150,0.8,9,6,3,378.2369888146826,0.3669117647058824,0.03737051661187252,0.22823553679557296,132459.27047902494,3020.1991213151955,135479.46960034015,2911,3,845.1714285714286,34,1,19,32.91483558845072,0.649203431372549,42.648809523809526,1029.404761904762,30.276610644257705,0
2943,4,0,0,35,0.0,0.0,1.0,35,700,500,200,0.7142857142857143,9,5,4,375.36168933141767,0.36715686274509807,0.037324525185796986,0.22705444844173173,132551.19756235828,2950.928287981861,135502.12585034015,2912,4,846.1714285714286,34,1,20,32.89619460500962,0.6501225490196079,42.55952380952381,1029.7619047619048,30.287114845938376,0
2944,4,0,0,35,0.0,0.0,1.0,35,1050,800,250,0.7619047619047619,13,8,5,376.3065063163998,0.3673669467787115,0.03965135857902213,0.22837002143493132,132673.81660997716,2985.204081632637,135659.0206916098,2913,5,847.1714285714286,34,1,16,32.74834373314844,0.6513480392156863,42.44047619047618,1030.238095238094,30.301120448179237,0
2945,4,0,0,35,0.0,0.0,1.0,35,650,400,250,0.6153846153846154,9,4,5,376.3065063163998,0.3673669467787115,0.03965135857902213,0.22837002143493132,132673.81660997716,2985.204081632637,135659.0206916098,2914,6,848.1714285714286,34,1,16,32.74834373314844,0.6513480392156863,42.44047619047618,1030.238095238094,30.301120448179237,0
2946,4,0,0,35,0.0,0.0,1.0,35,600,400,200,0.6666666666666666,8,4,4,379.1729519511003,0.36733193277310927,0.04162265645629781,0.2304860303433093,132735.1473922902,3065.9155328798165,135801.06292517003,2915,7,849.1714285714286,34,1,17,32.612734904497835,0.6519607843137255,42.38095238095238,1030.4761904761904,30.308123249299715,0
2947,4,1,0,36,0.027777777777777776,0.0,1.0,36,700,300,400,0.42857142857142855,11,3,8,369.7163558491131,0.3710648148148148,0.04690284788433985,0.2268424853678486,133083.80922335808,2640.652193715697,135724.4614170738,2916,0,826.5555555555555,35,1,18,32.505725369227896,0.6532738095238095,42.04282407407407,1031.8287037037028,29.48082010582008,0
2948,4,0,1,35,0.0,0.027777777777777776,0.9722222222222222,36,500,500,0,1.0,5,5,0,370.4982974521276,0.3711640211640212,0.04611354092681874,0.22768665185255818,133143.52823055972,2665.8901052383235,135809.41833579805,2917,1,827.5555555555555,35,1,18,32.42554016672272,0.6538690476190477,41.984953703703695,1032.0601851851843,29.487433862433836,0
2949,4,0,0,35,0.0,0.0,1.0,35,1150,900,250,0.782608695652174,14,9,5,379.0387272295049,0.3629551820728291,0.04783332509189209,0.23249318109682365,133072.72002551012,3087.942885487518,136160.66291099763,2918,2,851.9428571428572,34,1,18,32.27640283066036,0.6553308823529412,42.05357142857142,1031.7857142857138,30.34663865546217,0
2950,4,1,0,36,0.027777777777777776,0.0,1.0,36,600,400,200,0.6666666666666666,8,4,4,368.69147659063634,0.36669973544973544,0.04183940242763762,0.22803682803682793,133382.53821855696,2635.400993441344,136017.9392119983,2919,0,829.25,35,1,19,32.232142857142854,0.65625,41.753472222222214,1032.9861111111102,29.51388888888886,0
2951,4,0,0,36,0.0,0.0,1.0,36,750,500,250,0.6666666666666666,10,5,5,368.69147659063634,0.36669973544973544,0.04183940242763762,0.22803682803682793,133382.53821855696,2635.400993441344,136017.9392119983,2920,1,830.25,35,1,19,32.232142857142854,0.65625,41.753472222222214,1032.9861111111102,29.51388888888886,0
2952,4,1,1,36,0.02702702702702703,0.02702702702702703,0.972972972972973,37,950,700,250,0.7368421052631579,12,7,5,361.4149555427621,0.36955705705705705,0.04141965799996861,0.22500995619275177,133626.0363520408,2258.9498791414644,135884.98623118227,2921,0,808.7837837837837,34,3,19,32.175925925925924,0.6608455882352942,41.51785714285714,1033.928571428571,30.409663865546207,0
2953,4,0,0,36,0.0,0.0,1.0,36,950,700,250,0.7368421052631579,12,7,5,368.18677242182906,0.3663690476190476,0.04966853515574998,0.22865504707913595,133533.73724489796,2633.0711451247107,136166.80839002266,2922,3,832.25,34,2,20,32.09345964831452,0.6599264705882353,41.607142857142854,1033.5714285714284,30.399159663865543,0
2954,4,1,0,37,0.02702702702702703,0.0,1.0,37,600,500,100,0.8333333333333334,7,5,2,362.33338035958667,0.3719344344344344,0.05452571936518713,0.2266548696315147,133801.3214404363,2296.137018818581,136097.45845925488,2923,0,810.7297297297297,35,2,17,31.97656803520156,0.6604166666666667,41.348379629629626,1034.6064814814808,29.560185185185166,0
2955,4,0,0,37,0.0,0.0,1.0,37,950,800,150,0.8421052631578947,11,8,3,357.4750794666151,0.3716529029029029,0.05049961614488563,0.22416144183663897,133891.14610125174,2172.5496184842295,136063.69571973596,2924,1,811.7297297297297,35,2,17,32.01232013718035,0.6613095238095238,41.261574074074076,1034.953703703704,29.570105820105827,0
2956,4,0,0,37,0.0,0.0,1.0,37,750,500,250,0.6666666666666666,10,5,5,354.764401297119,0.3714652152152152,0.04948610582413426,0.2231872246135037,134010.95920138867,2108.463541666643,136119.42274305533,2925,2,812.7297297297297,35,2,17,31.96260898725687,0.6625000000000001,41.14583333333332,1035.416666666665,29.583333333333282,0
2957,4,0,1,36,0.0,0.02702702702702703,0.972972972972973,37,1050,800,250,0.7619047619047619,13,8,5,353.93208739343027,0.371214964964965,0.05003125821094301,0.22320917900520146,134100.85419077936,2092.5190489969164,136193.37323977627,2926,3,813.7297297297297,35,2,18,31.894275896748233,0.6633928571428571,41.05902777777778,1035.7638888888891,29.593253968253975,0
2958,4,0,0,36,0.0,0.0,1.0,36,400,300,100,0.75,5,3,2,362.3577368588921,0.3677579365079365,0.05264805868670597,0.22729712584785053,133903.125,2504.1666666666683,136407.29166666666,2927,4,837.1388888888889,34,2,18,31.873993558776174,0.6636029411764706,41.25,1035.0,30.441176470588236,0
2959,4,0,0,36,0.0,0.0,1.0,36,450,300,150,0.6666666666666666,6,3,3,363.2427406178522,0.3673115079365079,0.0522810044086639,0.22804300575250727,133933.93034297053,2530.1055839002274,136464.03592687077,2928,5,838.1388888888889,34,2,18,31.820251102165987,0.6639093137254901,41.220238095238095,1035.1190476190477,30.44467787114846,0
2960,4,0,0,36,0.0,0.0,1.0,36,1200,1100,100,0.9166666666666666,13,11,2,364.6127924143618,0.365922619047619,0.05891719745222934,0.22994502320761986,134100.85419077936,2578.97738233025,136679.8315731096,2929,6,839.1388888888889,35,1,18,31.617708682534357,0.6633928571428571,41.05902777777778,1035.7638888888891,29.593253968253975,0
2961,4,0,1,35,0.0,0.027777777777777776,0.9722222222222222,36,600,500,100,0.8333333333333334,7,5,2,362.9125183358823,0.36613756613756615,0.05648044692737453,0.2290597347747633,134130.82588520227,2535.551161694094,136666.37704689638,2930,7,840.1388888888889,35,1,18,31.631750465549338,0.6636904761904763,41.03009259259259,1035.879629629629,29.59656084656083,0
2962,4,0,0,35,0.0,0.0,1.0,35,950,600,350,0.631578947368421,13,6,7,372.3741577487119,0.3611344537815126,0.06564860426929386,0.23475762118940527,134088.01020408163,2986.181972789114,137074.19217687074,2931,8,864.7428571428571,34,1,19,31.429597701149422,0.6654411764705883,41.07142857142857,1035.7142857142856,30.462184873949575,0
2963,4,0,0,35,0.0,0.0,1.0,35,800,600,200,0.75,10,6,4,372.20320452465046,0.3615546218487395,0.06297141580350174,0.2351157998376955,134160.80092860508,2987.016005444098,137147.8169340492,2932,9,865.7428571428571,35,0,19,31.36113748929355,0.6639880952380952,41.001157407407405,1035.99537037037,29.599867724867714,0
2964,4,0,1,34,0.0,0.02857142857142857,0.9714285714285714,35,850,600,250,0.7058823529411765,11,6,5,374.7778148249241,0.3607843137254902,0.0647882829701012,0.23732394299451,134250.74615269213,3062.8402563443146,137313.58640903645,2933,10,866.7428571428571,35,0,19,31.204396545305627,0.6648809523809524,40.914351851851855,1036.3425925925933,29.60978835978838,0
2965,4,0,0,34,0.0,0.0,1.0,34,1000,800,200,0.8,12,8,4,380.9235055084308,0.35942142008318484,0.06610467277088916,0.24115920839642843,134242.17864229032,3427.2002551020487,137669.37889739237,2934,11,885.2058823529412,34,0,19,31.05375263258665,0.6669730392156863,40.92261904761905,1036.3095238095243,30.479691876750714,0
2966,4,1,0,35,0.02857142857142857,0.0,1.0,35,850,500,350,0.5882352941176471,12,5,7,371.4073176451498,0.36288515406162464,0.06913530284635105,0.23837596932497765,134741.56574394446,3009.5093184332345,137751.0750623777,2935,0,860.8857142857142,33,2,21,30.80097182876928,0.6742424242424243,40.441176470588225,1038.2352941176457,31.4616755793226,0
2967,4,0,0,35,0.0,0.0,1.0,35,1050,900,150,0.8571428571428571,12,9,3,371.9571930075678,0.36239495798319327,0.07231710812496872,0.23893808160372404,134773.3763005814,3025.9853481833834,137799.36164876478,2936,1,861.8857142857142,33,2,21,30.75492249891812,0.6745580808080809,40.41053921568627,1038.3578431372543,31.465389185977404,0
2968,4,0,0,35,0.0,0.0,1.0,35,700,200,500,0.2857142857142857,12,2,10,375.28013156864245,0.36239495798319327,0.07523978086809913,0.24149575664724732,134837.00867755196,3120.3300713667873,137957.33874891876,2937,2,862.8857142857142,33,2,19,30.605088495575206,0.6751893939393939,40.349264705882355,1038.6029411764712,31.472816399287005,0
2969,4,0,0,35,0.0,0.0,1.0,35,850,500,350,0.5882352941176471,12,5,7,375.6565676508321,0.36057422969187675,0.06822050543407121,0.2425096540278449,134952.4943310658,3139.158163265313,138091.65249433112,2938,3,863.8857142857142,34,1,19,30.479968683165293,0.6740196078431373,40.23809523809524,1039.0476190476193,30.56022408963586,0
2970,4,0,0,35,0.0,0.0,1.0,35,1200,600,600,0.5,18,6,12,377.2260142252857,0.3590686274509804,0.06787922405050861,0.24477652364365857,135138.10232426293,3195.5215419500996,138333.62386621302,2939,4,864.8857142857142,34,1,19,30.25389283260819,0.6758578431372548,40.0595238095238,1039.761904761904,30.581232492997174,0
2971,4,0,0,35,0.0,0.0,1.0,35,950,800,150,0.8421052631578947,11,8,3,378.0427908305645,0.35927871148459384,0.06839479924768965,0.24551700950966382,135169.04939058947,3219.936933106562,138388.98632369604,2940,5,865.8857142857142,34,1,19,30.201774470520895,0.6761642156862746,40.0297619047619,1039.8809523809516,30.5847338935574,0
2972,4,0,0,35,0.0,0.0,1.0,35,900,600,300,0.6666666666666666,12,6,6,378.2076964168311,0.3593487394957983,0.06913919413919434,0.2458350026709401,135200.0,3226.73611111111,138426.73611111112,2941,6,866.8857142857142,34,1,19,30.1665998931624,0.6764705882352942,40.0,1040.0,30.58823529411765,0
2973,4,0,0,35,0.0,0.0,1.0,35,900,700,200,0.7777777777777778,11,7,4,377.041303888991,0.3582983193277311,0.06816732872345654,0.24570946716524159,135292.87308673456,3202.200255102024,138495.07334183657,2942,7,867.8857142857142,34,1,19,30.104273944387224,0.677389705882353,39.91071428571428,1040.3571428571418,30.598739495798288,0
2974,4,0,1,34,0.0,0.02857142857142857,0.9714285714285714,35,1150,800,350,0.6956521739130435,15,8,7,377.17283514561854,0.3581232492997199,0.060162415646803025,0.24664338800883626,135416.75347222216,3215.104166666661,138631.85763888882,2943,8,868.8857142857142,34,1,20,29.977315185481714,0.6786151960784315,39.791666666666664,1040.833333333333,30.612745098039206,0
2975,4,0,0,34,0.0,0.0,1.0,34,750,500,250,0.6666666666666666,10,5,5,384.14158570373996,0.3522912953060012,0.062274768531352276,0.25004553523415235,135250.98519800082,3591.1055843906233,138842.09078239146,2944,9,894.8529411764706,33,1,20,29.96141611687088,0.6792929292929293,39.950980392156865,1040.1960784313728,31.521093285799175,0
2976,4,0,0,34,0.0,0.0,1.0,34,1150,1000,150,0.8695652173913043,13,10,3,401.38367030476525,0.35266265597147956,0.07483186511319517,0.25177702955480735,133903.125,3998.4453094963487,137901.57030949634,2945,10,895.8529411764706,29,5,20,30.8641975308642,0.6767241379310345,41.25,1035.0,35.689655172413794,4
2977,4,0,0,34,0.0,0.0,1.0,34,1300,1100,200,0.8461538461538461,15,11,4,399.921956721344,0.3522912953060012,0.0860597548129034,0.2521930113334436,134097.9538819518,3925.743221759758,138023.69710371157,2946,11,896.8529411764706,30,4,20,30.706321913660336,0.6756944444444444,41.061827956989255,1035.7526881720441,34.525089605734806,0
2978,4,0,0,34,0.0,0.0,1.0,34,850,600,250,0.7058823529411765,11,6,5,379.06591942216147,0.3522912953060012,0.03331141956401584,0.22241170264754825,131394.8652479383,3161.463080512143,134556.32832845044,2947,12,897.8529411764706,31,3,23,33.96886377106087,0.6458333333333334,43.68489583333333,1025.260416666666,33.07291666666665,4
2979,4,0,0,34,0.0,0.0,1.0,34,850,600,250,0.7058823529411765,11,6,5,379.9133794684759,0.35210561497326204,0.03154727237429644,0.22368890907717887,131528.3966064453,3193.87953016493,134722.27613661025,2948,13,898.8529411764706,31,3,23,33.81198696792756,0.6471774193548387,43.5546875,1025.78125,33.08971774193548,0
2980,4,0,0,34,0.0,0.0,1.0,34,850,600,250,0.7058823529411765,11,6,5,379.7778865727022,0.3528483363042187,0.030904747685876366,0.22400072950545613,131595.18771701393,3195.3884548611163,134790.57617187506,2949,14,899.8529411764706,31,3,20,33.74788494077834,0.6478494623655914,43.489583333333336,1026.041666666667,33.0981182795699,0
2981,4,2,2,34,0.05555555555555555,0.05555555555555555,0.9444444444444444,36,750,500,250,0.6666666666666666,10,5,5,360.1547307588899,0.36522817460317464,0.015230410472480749,0.21481206060768473,132019.90370290255,2309.5185745866734,134329.4222774892,2950,0,850.8055555555555,33,3,21,33.82274028142142,0.6470959595959597,43.07598039215685,1027.696078431371,31.142305407011243,0
2982,4,0,0,34,0.0,0.0,1.0,34,700,400,300,0.5714285714285714,10,4,6,376.0848899607475,0.3526997920380273,0.029859432357417726,0.22260159703082083,131728.82080078125,3108.2438151041674,134837.0646158854,2951,16,901.8529411764706,31,3,21,33.707508878741756,0.6491935483870968,43.359375,1026.5625,33.11491935483871,0
2983,4,0,0,34,0.0,0.0,1.0,34,450,300,150,0.6666666666666666,6,3,3,376.50844068480035,0.3515485739750446,0.03311060732609494,0.22363694127422476,131862.52170138882,3129.4704861111068,134991.9921874999,2952,17,902.8529411764706,31,3,21,33.561528059499665,0.6505376344086022,43.229166666666664,1027.0833333333328,33.13172043010751,0
2984,4,0,0,34,0.0,0.0,1.0,34,600,300,300,0.5,9,3,6,376.8344533090251,0.35136289364230544,0.03159648952748784,0.22402765653013557,131895.95752292217,3140.588209364155,135036.54573228632,2953,18,903.8529411764706,31,3,21,33.51937824819368,0.6508736559139785,43.196614583333336,1027.2135416666672,33.13592069892475,0
2985,4,0,0,34,0.0,0.0,1.0,34,850,600,250,0.7058823529411765,11,6,5,376.1385424373121,0.35128862150920975,0.03667991084407429,0.22400824440549663,131962.8418816461,3127.262200249577,135090.10408189567,2954,19,904.8529411764706,31,3,23,33.469696489671776,0.6515456989247311,43.13151041666667,1027.473958333334,33.14432123655916,0
2986,4,1,0,35,0.02857142857142857,0.0,1.0,35,1000,600,400,0.6,14,6,8,367.86045058899316,0.3584733893557423,0.03972228066484362,0.2210418105751562,132300.56244260803,2733.628902663012,135034.19134527104,2955,0,879.9714285714285,32,3,24,33.34177098674521,0.65234375,42.80303030303031,1028.78787878788,32.14962121212125,0
2987,4,0,0,35,0.0,0.0,1.0,35,750,600,150,0.8,9,6,3,375.74986524820116,0.3584733893557423,0.017229286954057788,0.2107648409660634,129651.06398581786,2743.273964391397,132394.33795020927,2956,1,880.9714285714285,32,3,18,35.82449995867426,0.6256510416666666,45.391414141414145,1018.4343434343441,31.826073232323253,4
2988,4,1,0,36,0.027777777777777776,0.0,1.0,36,800,400,400,0.5,12,4,8,374.6409229284266,0.36365740740740743,0.049525029352119,0.2131154102560065,130200.04325259512,2555.6528738946536,132755.69612648978,2957,0,857.4722222222222,33,3,20,35.29408821645853,0.6287878787878787,44.85294117647059,1020.5882352941173,30.92691622103386,0
2989,4,1,1,36,0.02702702702702703,0.02702702702702703,0.972972972972973,37,1250,1100,150,0.88,14,11,3,367.6800077710925,0.3681181181181181,0.047220936420516724,0.21080811667997923,130505.75573979598,2196.8714569161048,132702.62719671207,2958,0,835.2702702702703,34,3,14,35.161316944347355,0.6295955882352942,44.55357142857143,1021.7857142857148,30.052521008403374,0
2990,4,1,1,36,0.02702702702702703,0.02702702702702703,0.972972972972973,37,600,300,300,0.5,9,3,6,370.00802344152976,0.3695257757757758,0.04700051327104826,0.21214287676677673,130505.75573979582,2257.6353458049784,132763.3910856008,2959,0,836.2432432432432,34,3,14,35.10184861548023,0.6295955882352942,44.55357142857142,1021.7857142857134,30.052521008403335,0
2991,4,2,0,38,0.05263157894736842,0.0,1.0,38,700,500,200,0.7142857142857143,9,5,4,375.0949962215911,0.37357752489331436,0.1034758746855704,0.2022552920440219,128085.9441979596,2011.4622591577854,130097.40645711738,2960,0,815.1842105263158,35,3,19,37.440448967146885,0.6029761904761904,46.932870370370374,1012.268518518519,28.92195767195769,6
2992,4,0,0,38,0.0,0.0,1.0,38,750,100,650,0.13333333333333333,14,1,13,374.19181956399933,0.37265884305357994,0.09954583142549489,0.20221573171609775,128174.6669501134,1992.3957655335787,130167.06271564699,2961,1,816.1842105263158,34,4,20,37.37239399639469,0.6060049019607843,46.845238095238095,1012.6190476190478,29.782913165266113,0
2993,4,3,3,38,0.07317073170731707,0.07317073170731707,0.926829268292683,41,850,600,250,0.7058823529411765,11,6,5,351.7746436428422,0.38940548780487805,0.08973038201809014,0.19302773421468847,128783.68975309728,860.5673139812423,129644.25706707852,2962,0,757.390243902439,37,4,15,37.31804310251701,0.6061373873873873,46.24451754385966,1015.0219298245629,27.43302513039359,0
2994,4,1,1,38,0.02564102564102564,0.02564102564102564,0.9743589743589743,39,900,600,300,0.6666666666666666,12,6,6,364.390785492346,0.37935784975258663,0.0996848638067398,0.19895055783610138,128584.36113522365,1570.9912712191194,130155.35240644276,2963,0,797.2051282051282,35,4,16,37.201514892160205,0.6080357142857145,46.440972222222214,1014.2361111111102,28.978174603174576,0
2995,4,2,2,38,0.05,0.05,0.95,40,1200,800,400,0.6666666666666666,16,8,8,360.445549298161,0.3837873931623932,0.09381446157258555,0.19830003160594972,128886.73460200061,1291.3299701728765,130178.06457217349,2964,0,778.225,36,4,16,36.992856086651145,0.6090856481481481,46.14301801801802,1015.4279279279276,28.206331331331324,0
2996,4,1,0,39,0.02564102564102564,0.0,1.0,39,750,400,350,0.5333333333333333,11,4,7,372.900731465961,0.37913292847503377,0.13638390945152845,0.19188804089247224,126189.15741008657,1634.4955796128602,127823.65298969943,2965,0,799.1538461538462,35,4,15,39.446900318703676,0.5836309523809524,48.813657407407405,1004.7453703703701,28.707010582010575,7
2997,4,6,1,44,0.13333333333333333,0.022222222222222223,0.9777777777777777,45,700,500,200,0.7142857142857143,9,5,4,345.8286023775867,0.41119528619528617,0.12913557018919186,0.18002732827001733,126662.68957329004,-239.28381829657232,126423.40575499347,2966,0,693.4666666666667,43,2,15,39.63977735967388,0.5750968992248061,48.342803030303045,1006.6287878787906,23.409971811134664,7
2998,4,0,0,44,0.0,0.0,1.0,44,950,500,450,0.5263157894736842,14,5,9,351.4876576462856,0.4087495595489781,0.1315085030442995,0.18336645272390564,126750.27041644132,110.23113094164805,126860.50154738297,2967,1,710.2272727272727,42,2,18,39.407316525532444,0.5773809523809523,48.25581395348837,1006.9767441860465,23.97563676633444,0
2999,4,2,2,44,0.043478260869565216,0.043478260869565216,0.9565217391304348,46,800,700,100,0.875,9,7,2,338.90616113518763,0.41650563607085345,0.1355108246541843,0.178406675699972,127117.63340480221,-581.9698359231263,126535.66356887908,2968,0,680.304347826087,40,6,18,39.347139641909365,0.5841145833333332,47.89126016260163,1008.4349593495949,25.210873983739873,0
3000,4,3,4,43,0.06382978723404255,0.0851063829787234,0.9148936170212766,47,1250,1000,250,0.8,15,10,5,322.77946964700385,0.41878661732963307,0.16758809955254694,0.16661866357275038,126317.93986402433,-1241.3013338852559,125076.63853013907,2969,0,666.7659574468086,41,6,12,40.57360028290403,0.5744410569105691,48.68551587301587,1005.2579365079366,24.518486256291137,6
3001,4,2,3,42,0.044444444444444446,0.06666666666666667,0.9333333333333333,45,900,600,300,0.6666666666666666,12,6,6,315.76280105506123,0.40993265993266,0.11981758678040677,0.1611495221747242,125849.30597808097,-1052.2941267051542,124797.01185137582,2970,0,697.1333333333333,42,3,15,41.231289232254944,0.5682043650793652,49.15213178294572,1003.3914728682148,23.890273163528924,7
3002,4,4,0,46,0.08695652173913043,0.0,1.0,46,800,400,400,0.5,12,4,8,314.50895029926374,0.4102355072463768,0.17524033630334368,0.16329304699537744,126555.19500030021,-1239.3014617511192,125315.89353854909,2971,0,682.7608695652174,42,4,15,40.53812756805342,0.5753968253968255,48.449612403100765,1006.2015503875948,23.95717977113321,0
3003,4,2,0,48,0.041666666666666664,0.0,1.0,48,550,200,350,0.36363636363636365,9,2,7,310.0988098308833,0.4165004432624113,0.19713304859006175,0.16285797118325235,127022.00038580224,-1722.1257716049627,125299.87461419728,2972,0,655.2708333333334,44,4,17,40.17119041058143,0.5774147727272728,47.9861111111111,1008.0555555555536,22.91035353535349,0
3004,4,7,5,50,0.12727272727272726,0.09090909090909091,0.9090909090909091,55,1050,700,350,0.6666666666666666,14,7,7,283.6829918599782,0.4340207631874298,0.23720094624145438,0.15362842120920728,128259.19683528908,-3703.2177949748216,124555.97904031427,2973,0,572.7454545454545,45,10,16,39.577837640466186,0.5886574074074075,46.76177536231883,1012.9528985507226,22.51006441223828,0
3005,4,1,1,50,0.0196078431372549,0.0196078431372549,0.9803921568627451,51,1300,900,400,0.6923076923076923,17,9,8,310.4031551759978,0.42344771241830065,0.24904520644672568,0.16686911022249912,127965.0728475049,-2255.847527161629,125709.22532034326,2974,0,618.6274509803922,46,5,18,39.20072870118871,0.5844655797101449,47.052304964539,1011.7907801418419,21.995451742213955,0
3006,4,2,3,49,0.038461538461538464,0.057692307692307696,0.9423076923076923,52,1850,1300,550,0.7027027027027027,24,13,11,309.95525156373554,0.4249937154348919,0.2505406757343249,0.1681993806747271,128340.82729591096,-2443.388576910573,125897.43871900039,2975,0,607.6346153846154,42,10,18,38.82945236046027,0.593501984126984,46.681201550387605,1013.2751937984517,24.125599852344088,0
3007,4,0,0,49,0.0,0.0,1.0,49,1300,700,600,0.5384615384615384,19,7,12,328.37135260546313,0.4184559240362811,0.25699168556311425,0.1773205304069503,128144.53125000013,-1384.2013888888732,126760.32986111126,2976,2,645.530612244898,42,7,18,38.56310013717423,0.591517857142857,46.87500000000001,1012.500000000001,24.107142857142883,0
3008,4,0,0,49,0.0,0.0,1.0,49,1450,800,650,0.5517241379310345,21,8,13,327.1249862645029,0.4179244614512472,0.2517413193854563,0.17720282412450095,128270.12004165107,-1407.9277486457406,126862.19229300533,2977,3,646.530612244898,41,8,19,38.46658423921913,0.5942581300813007,46.75099206349207,1012.9960317460329,24.707220286488607,0
3009,4,1,0,50,0.02,0.0,1.0,50,1050,400,650,0.38095238095238093,17,4,13,323.67313380210544,0.4200680272108843,0.2640584694754946,0.17672857024030472,128586.408616144,-1676.006831770913,126910.4017843731,2978,0,634.58,42,8,17,38.23186363491609,0.5959821428571428,46.4389534883721,1014.2441860465128,24.148671096345545,0
3010,4,2,4,48,0.038461538461538464,0.07692307692307693,0.9230769230769231,52,900,400,500,0.4444444444444444,14,4,10,318.1370496125154,0.4265177224736048,0.2670433831571264,0.175583486335439,129013.18587105656,-2191.2251371741795,126821.96073388238,2979,0,611.1346153846154,44,8,18,37.9384266010451,0.5975378787878787,46.01851851851853,1015.9259259259285,23.08922558922565,0
3011,4,1,0,49,0.02040816326530612,0.0,1.0,49,1750,1100,650,0.6285714285714286,24,11,13,338.7258816204857,0.4177827380952381,0.2811685049166208,0.18640850130469303,128898.98667800453,-1067.7154195011349,127831.27125850339,2980,0,648.9387755102041,41,8,19,37.53175068386087,0.600609756097561,46.13095238095238,1015.4761904761904,24.76771196283391,0
3012,4,0,0,49,0.0,0.0,1.0,49,1850,1400,450,0.7567567567567568,23,14,9,342.0732262537088,0.4181370464852608,0.28513441990068356,0.18922278464920325,129102.89345592196,-967.4713433687996,128135.42211255316,2981,1,649.9387755102041,42,7,19,37.23918605390288,0.6011904761904763,45.93023255813953,1016.2790697674405,24.197120708748585,0
3013,4,0,0,49,0.0,0.0,1.0,49,1800,1200,600,0.6666666666666666,24,12,12,344.4943027095473,0.4172512755102041,0.2903147087001323,0.19159313682713258,129315.9037415795,-890.0562352234874,128425.84750635602,2982,2,650.9387755102041,36,13,20,36.96094441984057,0.6134259259259258,45.72072072072073,1017.1171171171178,28.253253253253273,0
3014,4,1,1,49,0.02,0.02,0.98,50,1600,1300,300,0.8125,19,13,6,337.7228709991164,0.41843537414965987,0.2920155038759691,0.18941847982124357,129647.68005540161,-1243.0026546629788,128404.67740073863,2983,0,638.9,37,13,19,36.79613479758827,0.6148648648648649,45.39473684210526,1018.4210526315785,27.524893314366988,0
3015,4,1,1,49,0.02,0.02,0.98,50,1300,900,400,0.6923076923076923,17,9,8,341.8504349244182,0.41912414965986394,0.3005397117448634,0.19253441593929677,129811.04736328137,-1124.8074001735965,128686.23996310777,2984,0,639.88,39,11,19,36.52520102899589,0.6129807692307692,45.23437500000001,1019.0625000000009,26.129807692307715,0
3016,4,1,0,50,0.02,0.0,1.0,50,1500,1100,400,0.7333333333333333,19,11,8,360.7440286634558,0.41908163265306125,0.3029813142977116,0.2014330373416224,129473.07715136233,-648.2907070829065,128824.78644427942,2985,0,640.86,38,12,20,36.38769333053398,0.6112938596491229,45.56623931623931,1017.7350427350422,26.782501124606373,2
3017,4,0,0,50,0.0,0.0,1.0,50,1050,800,250,0.7619047619047619,13,8,5,339.2089938787684,0.4186479591836734,0.23571905716194275,0.18659165600291946,128881.41605259608,-1251.6532039098543,127629.76284868622,2986,1,641.86,42,8,19,37.537376339981556,0.5989583333333333,46.14825581395349,1015.4069767441866,24.1763565891473,5
3018,4,3,4,49,0.05660377358490566,0.07547169811320754,0.9245283018867925,53,1400,1000,400,0.7142857142857143,18,10,8,324.599021921275,0.4238328495403967,0.2368090036411783,0.18139357107365367,129504.14540816325,-2191.0293944511286,127313.11601371213,2987,0,606.4716981132076,41,12,14,37.27582846003898,0.6067073170731707,45.535714285714285,1017.8571428571428,24.825783972125432,0
3019,4,2,0,51,0.0392156862745098,0.0,1.0,51,1600,1100,500,0.6875,21,11,10,339.2820345509481,0.42200980392156867,0.2531667880895867,0.18913651057483802,129408.11107806192,-1418.830557208019,127989.2805208539,2988,0,630.8039215686274,40,11,21,36.999766946331064,0.6072916666666668,45.630081300813,1017.4796747967473,25.436991869918682,0
3020,4,1,1,51,0.019230769230769232,0.019230769230769232,0.9807692307692307,52,1700,1300,400,0.7647058823529411,21,13,8,337.0615965152129,0.4242081447963801,0.2595385785762361,0.18975052189261096,129793.15020130973,-1650.3427152815632,128142.80748602818,2989,0,619.6538461538462,42,10,17,36.665359135285904,0.6081349206349207,45.25193798449611,1018.9922480620132,24.261720191952698,0
3021,4,0,1,50,0.0,0.0196078431372549,0.9803921568627451,51,1200,800,400,0.6666666666666666,16,8,8,341.01799428709984,0.4214705882352941,0.2645585531149883,0.19173599956869317,129743.78511657927,-1351.0069256655493,128392.77819091371,2990,2,632.8039215686274,42,9,18,36.61467250015852,0.6076388888888891,45.30038759689921,1018.798449612401,24.257105943152403,0
3022,4,0,0,50,0.0,0.0,1.0,50,1650,1300,350,0.7878787878787878,20,13,7,346.3100271410713,0.4193027210884354,0.2644171779141109,0.19465011870342933,129731.44531249971,-1014.5399305555841,128716.90538194412,2991,3,646.08,41,9,19,36.49241649625085,0.6089939024390245,45.312499999999986,1018.7499999999977,24.8475609756097,0
3023,4,2,0,52,0.038461538461538464,0.0,1.0,52,1600,1000,600,0.625,22,10,12,341.4087676670653,0.42226778531925596,0.288398750519963,0.19465662198399708,130289.17236328137,-1499.2865668402646,128789.8857964411,2992,0,622.1923076923077,39,13,21,36.05169965649766,0.6177884615384615,44.76562500000001,1020.9375000000009,26.177884615384638,0
3024,4,0,0,52,0.0,0.0,1.0,52,1350,900,450,0.6666666666666666,18,9,9,344.5228877959578,0.4220556812468577,0.2958361118738475,0.1969706655883014,130395.54172092032,-1415.1502821180356,128980.39143880228,2993,1,623.1923076923077,39,13,22,35.864461159272494,0.6188568376068375,44.66145833333334,1021.3541666666681,26.188568376068414,0
3025,4,1,1,52,0.018867924528301886,0.018867924528301886,0.9811320754716981,53,1100,500,600,0.45454545454545453,17,5,12,337.6796432923064,0.4235153604257378,0.2920449409545163,0.19447022845815123,130677.89019639461,-1774.5473304580357,128903.34286593657,2994,0,612.4150943396227,40,13,17,35.75356989033559,0.6200520833333332,44.38516260162603,1022.4593495934981,25.561483739837453,0
3026,4,0,0,52,0.0,0.0,1.0,52,1250,900,350,0.72,16,9,7,344.8082372415333,0.4220949597787833,0.29050027444522764,0.19781104136488023,130528.56445312547,-1398.535156249956,129130.02929687551,2995,3,625.1923076923077,39,13,17,35.72247706422018,0.6201923076923075,44.53125000000002,1021.8750000000038,26.201923076923173,0
3027,4,1,3,50,0.018867924528301886,0.05660377358490566,0.9433962264150944,53,1250,1000,250,0.8,15,10,5,346.00134991059986,0.4216708998548621,0.2991204214779837,0.2000686725761067,130833.7993774377,-1546.2657602947652,129287.53361714294,2996,0,614.377358490566,40,13,18,35.38314128671236,0.6216145833333332,44.23272357723579,1023.0691056910595,25.576727642276488,0
3028,4,0,1,49,0.0,0.02,0.98,50,1700,1100,600,0.6470588235294118,23,11,12,361.4340148863047,0.41692176870748304,0.29739041794087573,0.20734898748740715,130528.56445312557,-564.5073784721623,129964.0570746534,2997,5,651.56,39,11,18,35.29774040095141,0.6201923076923075,44.53125000000003,1021.8750000000045,26.201923076923194,0
3029,4,0,0,49,0.0,0.0,1.0,49,1350,700,650,0.5185185185185185,20,7,13,365.20420847372935,0.41622378117913833,0.29751325517138305,0.2095487854859768,130535.38795976745,-265.5853924683511,130269.8025672991,2998,6,664.0,38,11,18,35.19450252657259,0.6219846491228067,44.524572649572676,1021.9017094017133,26.892150247413507,0
3030,4,2,2,49,0.0392156862745098,0.0392156862745098,0.9607843137254902,51,950,500,450,0.5263157894736842,14,5,9,351.88039740622827,0.42112745098039217,0.299606171312629,0.20460606093688408,131048.63596190834,-977.3107796358801,130071.32518227246,2999,0,638.9215686274509,41,10,20,35.01548218841847,0.6222052845528453,44.02281746031748,1023.9087301587335,24.973383662408136,0
3031,4,0,0,49,0.0,0.0,1.0,49,1450,1000,450,0.6896551724137931,19,10,9,367.1727379434821,0.41609977324263037,0.3074416540521472,0.2128840900304443,130937.7904707023,-184.64259452042432,130753.14787618187,3000,1,665.0408163265306,40,9,20,34.73628901466256,0.6226562499999999,44.131097560975626,1023.4756097561003,25.58689024390251,0
3032,4,0,0,49,0.0,0.0,1.0,49,1350,1000,350,0.7407407407407407,17,10,7,367.1472619440265,0.4154443027210884,0.3102102606583361,0.21379500889732367,131104.74623107113,-173.05027867913378,130931.695952392,3001,2,666.0408163265306,42,7,21,34.567879332639485,0.6212797619047618,43.96802325581397,1024.1279069767465,24.38399778516063,0
3033,4,1,0,50,0.02,0.0,1.0,50,1250,900,350,0.72,16,9,7,362.3020914362787,0.4172789115646258,0.3110063094856168,0.21267337457756677,131412.4312889542,-476.6594412953161,130935.77184765888,3002,0,653.7,37,13,23,34.380792606851315,0.6326013513513513,43.66776315789473,1025.3289473684204,27.711593172119468,0
3034,4,1,1,50,0.0196078431372549,0.0196078431372549,0.9803921568627451,51,1050,700,350,0.6666666666666666,14,7,7,351.56041215651834,0.420359477124183,0.3014170065277828,0.20769307005999485,131656.85609796192,-942.9322813938115,130713.92381656812,3003,0,641.8627450980392,38,13,17,34.4094836560483,0.6332236842105262,43.42948717948718,1026.2820512820517,27.007422402159257,0
3035,4,0,0,50,0.0,0.0,1.0,50,1750,1400,350,0.8,21,14,7,354.16244151235287,0.4168452380952381,0.30164421553090315,0.20885654261149061,131588.67076475662,-679.2470173177105,130909.42374743891,3004,2,655.7,40,10,18,34.41152436608558,0.6291666666666667,43.495934959349604,1026.0162601626032,25.65040650406508,0
3036,4,0,1,49,0.0,0.02,0.98,50,1450,1200,250,0.8275862068965517,17,12,5,350.5276748690243,0.4165221088435374,0.2931677138714355,0.20709359203426955,131658.81406092548,-769.9884062421063,130888.82565468337,3005,3,656.7,41,9,18,34.43400596101178,0.6283028455284552,43.427579365079374,1026.289682539684,25.03145567169961,0
3037,4,1,0,50,0.02,0.0,1.0,50,1150,1000,150,0.8695652173913043,13,10,3,354.577609745852,0.4153146258503401,0.30751304347826136,0.21018775835449974,131786.11288265293,-654.3190192743878,131131.79386337855,3006,0,657.62,41,9,19,34.20169082125603,0.6295731707317074,43.30357142857142,1026.7857142857133,25.043554006968616,0
3038,4,2,2,50,0.038461538461538464,0.038461538461538464,0.9615384615384616,52,900,700,200,0.7777777777777778,11,7,4,340.70447721156023,0.4200210532931121,0.3042973924500765,0.20406563254497168,132178.81159786807,-1393.217419220599,130785.59417864747,3007,0,633.2884615384615,43,9,20,34.16261856524542,0.6305717054263565,42.92140151515152,1028.3143939393954,23.914288231148728,0
3039,4,0,0,50,0.0,0.0,1.0,50,1300,900,400,0.6923076923076923,17,9,8,355.6258078943359,0.4140901360544218,0.30386947287121036,0.21194315984864961,131989.91894211384,-612.195688460573,131377.72325365327,3008,2,659.62,41,9,20,33.96931518311128,0.6316056910569106,43.10515873015873,1027.5793650793648,25.062911343399144,0
3040,4,0,1,49,0.0,0.02,0.98,50,1250,900,350,0.72,16,9,7,358.9135260713309,0.41386904761904764,0.31234510712217767,0.21447877492221037,132091.8810232425,-518.0874433106735,131573.7935799318,3009,3,660.62,41,9,20,33.78208839992279,0.6326219512195121,43.00595238095237,1027.9761904761892,25.07259001161437,0
3041,4,1,0,50,0.02,0.0,1.0,50,1100,900,200,0.8181818181818182,13,9,4,354.7113311488627,0.41344387755102036,0.3062390276839977,0.2126831908629414,132219.38898533932,-620.0569058642127,131599.3320794751,3010,0,661.4,41,9,21,33.761675669592606,0.6338922764227644,42.881944444444436,1028.4722222222208,25.084688346883436,0
3042,4,0,0,50,0.0,0.0,1.0,50,1700,1100,600,0.6470588235294118,23,11,12,354.51457321784676,0.41357142857142853,0.30886028648536445,0.21372924895999584,132425.49332493235,-610.2848603349536,131815.2084645974,3011,1,662.4,38,12,21,33.55931250432494,0.6408991228070176,42.681623931623925,1029.2735042735035,27.086144849302723,0
3043,4,0,1,49,0.0,0.02,0.98,50,1500,1000,500,0.6666666666666666,20,10,10,344.50432362538425,0.4139200680272109,0.29357736446379157,0.2048382178356107,131901.66650142102,-903.6200133758782,130998.04648804513,3012,2,663.4,40,10,15,34.343877786571696,0.6322916666666667,43.1910569105691,1027.235772357723,25.680894308943074,2
3044,4,0,0,49,0.0,0.0,1.0,49,1050,800,250,0.7619047619047619,13,8,5,349.60028636200934,0.4104662698412698,0.2969739619985925,0.20765414599574772,131862.52170138885,-580.1649305555593,131282.35677083328,3013,3,677.4489795918367,41,8,15,34.25245098039216,0.6303353658536586,43.229166666666664,1027.083333333333,25.050813008130074,0
3045,4,0,0,49,0.0,0.0,1.0,49,1050,700,350,0.6666666666666666,14,7,7,350.3190400525001,0.4100765306122449,0.29623014803809133,0.20869567981554543,131974.50949462163,-553.3633044889249,131421.1461901327,3014,4,678.4489795918367,42,7,15,34.12116496919402,0.6299603174603176,43.120155038759684,1027.5193798449604,24.464747139165723,0
3046,4,0,0,49,0.0,0.0,1.0,49,1200,1000,200,0.8333333333333334,14,10,4,351.26296462649367,0.40970450680272114,0.30141583316336185,0.20953290229632102,132024.29710504157,-524.9507992308368,131499.34630581073,3015,5,679.4489795918367,42,7,16,34.04676598151988,0.6304563492063493,43.07170542635658,1027.7131782945721,24.469361387966003,0
3047,4,1,0,50,0.02,0.0,1.0,50,1050,800,250,0.7619047619047619,13,8,5,343.47111852742154,0.41241496598639454,0.30266224799779073,0.20625355226994918,132276.20778990188,-913.3885911673524,131362.81919873453,3016,0,666.84,43,7,17,33.993544600938975,0.6315406976744187,42.82670454545455,1028.693181818182,23.923097251585627,0
3048,4,0,0,50,0.0,0.0,1.0,50,1500,1100,400,0.7333333333333333,19,11,8,345.39130212836056,0.41231292517006807,0.3039874506628881,0.20822522613363834,132424.80604383687,-852.1005733829679,131572.7054704539,3017,1,667.84,39,11,18,33.79476183247311,0.639155982905983,42.68229166666667,1029.270833333334,26.391559829059844,0
3049,4,0,0,50,0.0,0.0,1.0,50,1150,700,450,0.6086956521739131,16,7,9,347.40341256839173,0.41175170068027206,0.3055847834884664,0.20988602260549996,132505.23003472204,-793.4461805555729,131711.78385416648,3018,2,668.84,39,11,18,33.66214757857817,0.6399572649572651,42.60416666666666,1029.583333333332,26.39957264957261,0
3050,4,0,1,49,0.0,0.02,0.98,50,1350,900,450,0.6666666666666666,18,9,9,349.0328133704901,0.4117687074829932,0.3068126718956907,0.20120112324475073,130714.91021050366,-856.0574001735912,129858.85281033006,3019,3,669.84,39,11,16,35.42589810193203,0.6220619658119657,44.34895833333334,1022.6041666666681,26.220619658119695,4
3051,4,0,0,49,0.0,0.0,1.0,49,1150,800,350,0.6956521739130435,15,8,7,352.3992355471949,0.40853528911564624,0.3104931901720154,0.20320273991914178,130726.5185550444,-586.4149590912187,130140.10359595319,3020,10,684.4489795918367,38,11,16,35.328083646747466,0.6239035087719296,44.33760683760685,1022.6495726495742,26.911830859199323,0
3052,4,1,0,50,0.02,0.0,1.0,50,1150,800,350,0.6956521739130435,15,8,7,346.0040639383551,0.4107993197278912,0.31328314172347094,0.20111614100828498,131034.66932508713,-932.294379340243,130102.3749457469,3021,0,671.74,39,11,17,35.18001576966121,0.6252670940170939,44.03645833333335,1023.8541666666692,26.252670940171008,0
3053,4,1,0,51,0.0196078431372549,0.0,1.0,51,1300,1000,300,0.7692307692307693,16,10,6,340.52436329752703,0.4148529411764706,0.31570105233684087,0.1991790997385306,131276.04683059044,-1259.4615473593549,130016.58528323108,3022,0,659.5490196078431,40,11,18,35.07660650535502,0.6260416666666666,43.80081300813009,1024.7967479674812,25.619918699187032,0
3054,4,0,0,51,0.0,0.0,1.0,51,1450,1100,350,0.7586206896551724,18,11,7,336.561204031159,0.4147385620915032,0.30838731266582187,0.1976795043247454,131434.9175347224,-1352.8108527083543,130082.10668201404,3023,1,660.5490196078431,39,12,18,35.017946634159564,0.6292735042735043,43.64583333333334,1025.416666666668,26.292735042735078,0
3055,4,0,0,51,0.0,0.0,1.0,51,1200,800,400,0.6666666666666666,16,8,8,338.2214067387307,0.414281045751634,0.3076316449797467,0.1989323757914901,131488.33007812512,-1305.5664062499854,130182.76367187513,3024,2,661.5490196078431,39,12,18,34.92154174283975,0.6298076923076923,43.59375000000001,1025.625000000001,26.298076923076945,0
3056,4,0,0,51,0.0,0.0,1.0,51,1850,1600,250,0.8648648648648649,21,16,5,335.37739344363786,0.41410130718954247,0.30777983603819736,0.19804917654934862,131640.81090124958,-1370.1295938263952,130270.68130742319,3025,3,662.5490196078431,40,11,13,34.840851323694444,0.6296874999999998,43.44512195121953,1026.2195121951245,25.655487804878113,0
3057,4,0,1,50,0.0,0.0196078431372549,0.9803921568627451,51,850,500,350,0.5882352941176471,12,5,7,335.0432069183073,0.41398692810457516,0.3036099477913752,0.19798720577343412,131666.88484243854,-1377.1809314891725,130289.70391094936,3026,4,663.5490196078431,40,11,13,34.82316731029476,0.6299479166666666,43.41971544715448,1026.3211382113834,25.658028455284587,0
3058,4,0,0,50,0.0,0.0,1.0,50,1350,900,450,0.6666666666666666,18,9,9,337.53183048316487,0.4133418367346939,0.30475059382422764,0.20014211356818667,131797.29327781094,-1102.8436694427835,130694.44960836816,3027,5,675.24,40,10,15,34.62799386381629,0.6312499999999999,43.29268292682927,1026.8292682926838,25.670731707317096,0
3059,4,0,1,49,0.0,0.02,0.98,50,1100,900,200,0.8181818181818182,13,9,4,345.96354052015397,0.4130867346938776,0.3118456973293775,0.2059888925005156,131953.86860499697,-869.7544864168151,131084.11411858015,3028,6,676.24,40,10,16,34.253832838773505,0.6328125,43.140243902439025,1027.4390243902435,25.68597560975609,0
3060,4,0,1,48,0.0,0.02040816326530612,0.9795918367346939,49,850,500,350,0.5882352941176471,12,5,7,350.50545363280673,0.40904903628117917,0.3159332698596684,0.20819179354334172,131862.52170138882,-556.2934027777828,131306.22829861104,3029,8,690.9183673469388,39,10,16,34.22920892494929,0.6335470085470085,43.229166666666664,1027.0833333333328,26.33547008547007,0
3061,4,0,0,48,0.0,0.0,1.0,48,1000,500,500,0.5,15,5,10,355.9903273218093,0.4054373522458629,0.31906731169371616,0.21122092754427324,131821.37573964478,-214.57306048654004,131606.80267915822,3030,20,706.1458333333334,38,10,16,34.12986371202663,0.6348684210526316,43.26923076923076,1026.9230769230755,27.02429149797567,0
3062,4,0,0,48,0.0,0.0,1.0,48,1350,900,450,0.6666666666666666,18,9,9,354.28492796678296,0.4052249556737589,0.30606308694597506,0.21127506026735798,132013.44515897796,-245.9252182409292,131767.51994073702,3031,21,707.1458333333334,38,10,16,33.98005683196452,0.6367872807017544,43.082264957264954,1027.6709401709397,27.043972109761572,0
3063,4,1,0,49,0.02040816326530612,0.0,1.0,49,1400,1200,200,0.8571428571428571,16,12,4,348.26902022212494,0.40789753401360546,0.31052469575744057,0.20966177030922417,132371.2036132811,-579.8421223958478,131791.36149088526,3032,0,693.6938775510204,39,10,18,33.77461028444174,0.6386217948717949,42.73437499999999,1029.0624999999989,26.38621794871792,0
3064,4,0,2,47,0.0,0.04081632653061224,0.9591836734693877,49,1450,900,550,0.6206896551724138,20,9,11,357.65951792587646,0.40766723356009066,0.27210749083884855,0.20556225321705537,130599.97046235722,-440.13494042379864,130159.83552193342,3033,1,694.6938775510204,40,9,10,35.321800225359574,0.6192708333333332,44.461382113821145,1022.1544715447167,25.553861788617915,6
3065,4,0,1,46,0.0,0.02127659574468085,0.9787234042553191,47,1150,700,450,0.6086956521739131,16,7,9,364.75917041526003,0.4055658341042245,0.26924328193116054,0.20925657671191228,130528.564453125,122.29817708333275,130650.86263020833,3034,2,713.1702127659574,39,8,12,35.212793068297664,0.6201923076923077,44.53125,1021.875,26.201923076923077,0
3066,4,0,0,46,0.0,0.0,1.0,46,1050,500,550,0.47619047619047616,16,5,11,369.7469037086915,0.40206320450885663,0.27919602889686645,0.21211796054867033,130528.56445312499,452.50651041666504,130981.07096354166,3035,25,729.6304347826087,39,7,13,35.08537206931703,0.6201923076923077,44.53125,1021.8749999999999,26.201923076923073,0
3067,4,0,0,46,0.0,0.0,1.0,46,1600,1100,500,0.6875,21,11,10,370.84761357044533,0.40241545893719805,0.2838397973553457,0.21392372914422034,130741.54188368049,497.0377604166606,131238.57964409716,3036,26,730.6304347826087,39,7,15,34.84119304678482,0.6223290598290598,44.322916666666664,1022.7083333333328,26.223290598290586,0
3068,4,0,0,46,0.0,0.0,1.0,46,1350,1000,350,0.7407407407407407,17,10,7,407.6593778255783,0.40270732689210953,0.270840780388689,0.22167078168350848,128422.23087873185,1283.5587332159807,129705.78961194782,3037,27,731.6304347826087,37,9,16,36.270824318476855,0.6024774774774775,46.60087719298245,1013.5964912280697,27.394499762920802,6
3069,4,2,1,47,0.041666666666666664,0.020833333333333332,0.9791666666666666,48,1050,800,250,0.7619047619047619,13,8,5,392.87761728952205,0.407348921394799,0.27440988958397416,0.2165601835042473,128963.21750217034,533.35232204863,129496.56982421897,3038,0,702.1041666666666,39,9,17,36.091276963046525,0.6044337606837606,46.06770833333334,1015.7291666666683,26.04433760683765,0
3070,4,0,0,47,0.0,0.0,1.0,47,1800,1200,600,0.6666666666666666,24,12,12,398.89685608401714,0.4046022201665125,0.2429014422576643,0.21057085328910166,127230.25504241692,756.8628763778322,127987.11791879474,3039,1,718.0425531914893,37,10,18,37.71861301307829,0.5903716216216215,47.7796052631579,1008.8815789473686,27.26706970128023,3
3071,4,4,2,49,0.0784313725490196,0.0392156862745098,0.9607843137254902,51,800,500,300,0.625,11,5,6,368.1303067287146,0.4163725490196078,0.243884439985933,0.19841698465679203,128069.20750070855,-770.768672052161,127298.43882865639,3040,0,662.6470588235294,41,10,18,37.63384543761638,0.5922256097560975,46.94940476190476,1012.2023809523804,24.687862950058058,0
3072,4,3,2,50,0.057692307692307696,0.038461538461538464,0.9615384615384616,52,1200,800,400,0.6666666666666666,16,8,8,370.8624869415872,0.4190312342885872,0.26773724822126455,0.2023420862323729,128556.44710696358,-864.6029741586167,127691.84413280497,3041,0,650.8461538461538,40,12,15,37.06596352339916,0.5986979166666666,46.46849593495936,1014.1260162601636,25.353150406504092,0
3073,4,4,3,51,0.07407407407407407,0.05555555555555555,0.9444444444444444,54,1400,800,600,0.5714285714285714,20,8,12,364.437853051955,0.42476851851851855,0.2850078764631496,0.2013432732930877,129053.65982362849,-1393.5922570758858,127660.0675665526,3042,0,627.6666666666666,42,12,18,36.721183800623045,0.6006944444444444,45.97868217054264,1016.0852713178303,24.19250645994834,0
3074,4,1,2,50,0.019230769230769232,0.038461538461538464,0.9615384615384616,52,1200,800,400,0.6666666666666666,16,8,8,374.0553317381661,0.41918834841628955,0.2825195117070236,0.20608098045155643,128943.21852898409,-753.6203235507992,128189.59820543329,3043,0,652.7115384615385,40,12,18,36.5896621306117,0.6026041666666667,46.08739837398374,1015.6504065040651,25.39126016260163,0
3075,4,2,0,52,0.038461538461538464,0.0,1.0,52,1700,1400,300,0.8235294117647058,20,14,6,373.9782882750966,0.41999748617395677,0.31212277601861405,0.2089431427631003,129495.73072059326,-712.9906763383267,128782.74004425493,3044,0,652.2692307692307,35,17,16,36.02787885679631,0.6172619047619048,45.54398148148148,1017.8240740740739,29.080687830687825,0
3076,4,0,0,52,0.0,0.0,1.0,52,1100,800,300,0.7272727272727273,14,8,6,346.061905231847,0.42012317747611866,0.3192291426061782,0.18450132467208608,127631.22420374006,-1566.3390769961484,126064.8851267439,3045,1,653.2692307692307,38,14,14,38.640348558539486,0.59265350877193,47.38247863247862,1010.4700854700841,26.591318038686424,8
3077,4,3,3,52,0.05454545454545454,0.05454545454545454,0.9454545454545454,55,1500,1000,500,0.6666666666666666,20,10,10,333.0210148412528,0.42605218855218857,0.3286662992817311,0.18138184317011238,128487.53390841994,-2440.129936174257,126047.40397224568,3046,0,618.5818181818182,39,16,14,38.095589746224164,0.5996260683760685,46.53645833333332,1013.854166666665,25.996260683760642,0
3078,4,0,0,52,0.0,0.0,1.0,52,1550,1200,350,0.7741935483870968,19,12,7,356.9376129541877,0.42158433886375063,0.33429205621466296,0.19302104349350616,128201.54772593529,-1248.009115534464,126953.53861040082,3047,1,653.0576923076923,36,16,16,37.781700581934096,0.6021412037037038,46.81869369369369,1012.7252252252244,28.131256256256236,0
3079,4,0,0,52,0.0,0.0,1.0,52,1850,1400,450,0.7567567567567568,23,14,9,359.9177777777782,0.42099516088486677,0.3278803418803422,0.1956074879227053,128401.2052593132,-1157.2247078159394,127243.98055149725,3048,2,654.0576923076923,36,16,14,37.502083333333324,0.6041666666666667,46.621621621621614,1013.5135135135122,28.153153153153117,0
3080,4,1,2,51,0.018867924528301886,0.03773584905660377,0.9622641509433962,53,1850,1600,250,0.8648648648648649,21,16,5,352.3255826453706,0.42470972423802617,0.32183725397112317,0.19311833292258349,128740.1737366679,-1528.308655672463,127211.86508099544,3049,0,642.6981132075472,38,15,14,37.34844895953959,0.6038925438596492,46.28739316239315,1014.8504273504255,26.706590193432252,0
3081,4,1,0,52,0.019230769230769232,0.0,1.0,52,2150,2000,150,0.9302325581395349,23,20,3,361.0885902345956,0.4218828557063851,0.34090380461870784,0.1985558399983583,128867.17547706982,-1093.506655894127,127773.66882117568,3050,0,655.2115384615385,37,15,15,36.99649028077753,0.6069819819819819,46.16228070175438,1015.350877192982,27.441915599810326,0
3082,4,3,1,54,0.05454545454545454,0.01818181818181818,0.9818181818181818,55,1200,800,400,0.6666666666666666,16,8,8,340.07528033605263,0.4282547699214366,0.3443848078658276,0.19024360130075788,129545.80213758672,-2188.502178855518,127357.29995873121,3051,0,620.4181818181818,39,16,15,36.83969865957229,0.6103098290598291,45.494791666666664,1018.0208333333327,26.103098290598275,0
3083,4,0,1,53,0.0,0.018518518518518517,0.9814814814814815,54,1400,900,500,0.6428571428571429,19,9,10,346.38713988188863,0.42633356627067315,0.34477792936183116,0.1938181477354384,129554.63927469139,-1824.7878086419691,127729.85146604943,3052,1,632.9074074074074,38,16,15,36.67007730786721,0.6121162280701754,45.486111111111114,1018.0555555555559,26.790935672514628,0
3084,4,0,0,53,0.0,0.0,1.0,53,1600,1100,500,0.6875,21,11,10,347.46162132421125,0.42519351717464926,0.35102794013640803,0.19432733086590215,129536.03512619267,-1598.2398430286241,127937.79528316404,3053,2,645.5849056603773,37,16,15,36.661640097659046,0.6137387387387387,45.50438596491228,1017.9824561403508,27.513039355144617,0
3085,4,0,1,52,0.0,0.018867924528301886,0.9811320754716981,53,2150,2000,150,0.9302325581395349,23,20,3,346.4461894169974,0.4249365021770682,0.34860388727156066,0.19514368996615614,129815.2376211912,-1605.2011195752473,128210.03650161596,3054,3,646.5849056603773,37,16,15,36.403862707122876,0.616554054054054,45.23026315789474,1019.0789473684216,27.542674253200584,0
3086,4,2,1,53,0.037037037037037035,0.018518518518518517,0.9814814814814815,54,1800,1000,800,0.5555555555555556,26,10,16,341.57572434966124,0.4281024341952015,0.3536358347876667,0.1939386544315855,130126.29323727096,-1910.403426108538,128215.88981116243,3055,0,635.5,38,16,16,36.21247818499128,0.6178728070175438,44.92521367521368,1020.2991452991466,26.84997750787228,0
3087,4,3,1,55,0.05357142857142857,0.017857142857142856,0.9821428571428571,56,1100,800,300,0.7272727272727273,14,8,6,331.38939721511855,0.43052624458874456,0.36538625390514046,0.19071952723021166,130651.91436975378,-2540.66817040118,128111.2461993526,3056,0,613.75,40,16,15,35.94060636182902,0.6197916666666665,44.410569105691074,1022.3577235772384,25.55894308943096,0
3088,4,1,1,55,0.017857142857142856,0.017857142857142856,0.9821428571428571,56,1000,600,400,0.6,14,6,8,338.4428123086215,0.42851731601731596,0.3732153501177933,0.1955663231170259,130807.80805902602,-2345.8075137153505,128462.00054531067,3057,0,614.7321428571429,40,16,16,35.60273031326576,0.6213541666666664,44.25813008130083,1022.9674796747993,25.574186991869983,0
3089,4,0,0,55,0.0,0.0,1.0,55,1000,400,600,0.4,16,4,12,343.3881074908472,0.42563131313131314,0.3751710854084287,0.19794721381313285,130714.91021050377,-2022.8108723957994,128692.09933810798,3058,1,626.8727272727273,39,16,17,35.5702055957353,0.6220619658119657,44.34895833333335,1022.604166666669,26.22061965811972,0
3090,4,1,1,55,0.017857142857142856,0.017857142857142856,0.9821428571428571,56,1150,800,350,0.6956521739130435,15,8,7,355.59985081748414,0.42735389610389607,0.4036315511628592,0.19483991826006333,128725.2658420137,-2034.2963324652994,126690.9695095484,3059,0,616.6607142857143,39,17,15,37.28058920139601,0.6020299145299146,46.30208333333332,1014.7916666666652,26.020299145299106,6
3091,4,0,2,53,0.0,0.03636363636363636,0.9636363636363636,55,1600,1100,500,0.6875,21,11,10,360.84749420310635,0.4271885521885522,0.40311896060159635,0.1981949647351392,128821.5047209435,-1703.0165643948044,127118.4881565487,3060,1,627.290909090909,38,17,15,37.04921770855258,0.6047149122807018,46.20726495726494,1015.1709401709376,26.71502474134046,0
3092,4,0,0,53,0.0,0.0,1.0,53,1250,800,450,0.64,17,8,9,374.8304717543902,0.4240142718916304,0.4161622168293271,0.20532506875251086,128715.26668137703,-950.7191735654848,127764.54750781156,3061,2,651.7358490566038,36,17,15,36.80293530129844,0.6073495370370372,46.311936936936924,1014.7522522522498,28.187562562562494,0
3093,4,0,0,53,0.0,0.0,1.0,53,1150,700,450,0.6086956521739131,16,7,9,375.23680460127554,0.42415033865505564,0.41464216257858144,0.20584353742369427,128772.40997331786,-935.97047216136,127836.43950115649,3062,3,652.7358490566038,36,17,15,36.73420799585783,0.6079282407407408,46.25563063063063,1014.9774774774771,28.19381881881881,0
3094,4,1,0,54,0.018518518518518517,0.0,1.0,54,1050,800,250,0.7619047619047619,13,8,5,370.6515375235118,0.427243477754484,0.4236483219652929,0.2051086030630104,129117.79495854466,-1228.4581553939997,127889.33680315067,3063,0,641.6296296296297,37,17,16,36.497891717912744,0.6095157657657658,45.91557017543858,1016.3377192982433,27.46858700806063,0
3095,4,1,0,55,0.01818181818181818,0.0,1.0,55,1200,900,300,0.75,15,9,6,361.7648933888943,0.4300224466891134,0.4171891802465053,0.2018170648905558,129436.83556241432,-1634.7782416550729,127802.05732075924,3064,0,630.9454545454546,35,20,17,36.39861995753715,0.6166666666666667,45.601851851851855,1017.592592592593,29.074074074074083,0
3096,4,1,1,55,0.017857142857142856,0.017857142857142856,0.9821428571428571,56,1300,900,400,0.6923076923076923,17,9,8,351.53059712187775,0.43193993506493505,0.40774500513306466,0.19736773749021652,129688.42734203815,-2082.1099393312047,127606.31740270695,3065,0,620.6607142857143,36,20,17,36.40316933849273,0.6171875,45.35472972972974,1018.5810810810824,28.293918918918955,0
3097,4,1,1,55,0.017857142857142856,0.017857142857142856,0.9821428571428571,56,1400,1200,200,0.8571428571428571,16,12,4,348.047364967596,0.432521645021645,0.4053900983534089,0.19598510302375727,129803.1577819375,-2164.4705939047017,127638.6871880328,3066,0,621.6428571428571,36,20,17,36.375336132906014,0.6183449074074073,45.242117117117125,1019.0315315315328,28.306431431431466,0
3098,4,1,0,56,0.017857142857142856,0.0,1.0,56,1150,900,250,0.782608695652174,14,9,5,362.1848437135758,0.430959145021645,0.43826179730435055,0.20576875186804272,130150.6773718838,-1772.2794513696365,128378.39792051415,3067,0,622.625,37,19,18,35.66202808224086,0.6199324324324322,44.90131578947369,1020.3947368421065,27.578236130867744,0
3099,4,1,1,56,0.017543859649122806,0.017543859649122806,0.9824561403508771,57,1150,700,450,0.6086956521739131,16,7,9,330.04052478963956,0.43427579365079366,0.32723893024480555,0.1900708483061566,130677.89019639399,-2774.1520165153456,127903.73817987864,3068,0,612.6842105263158,40,17,13,35.948837093728265,0.6200520833333335,44.385162601626,1022.4593495934931,25.56148373983733,6
3100,4,0,0,56,0.0,0.0,1.0,56,1550,1200,350,0.7741935483870968,19,12,7,339.0791312051819,0.43133793290043293,0.3345538990157826,0.19479182876962775,130581.79253472215,-2344.4878472222263,128237.30468749991,3069,2,624.625,39,17,13,35.814988449517585,0.6207264957264957,44.479166666666664,1022.0833333333327,26.20726495726494,0
3101,4,1,1,56,0.017543859649122806,0.017543859649122806,0.9824561403508771,57,1350,1000,350,0.7407407407407407,17,10,7,330.1464892430053,0.43280075187969924,0.330322606982844,0.19108478619822425,130870.93431122445,-2758.6840986394636,128112.25021258499,3070,0,614.6491228070175,41,16,13,35.751163467132045,0.6204268292682926,44.19642857142857,1023.2142857142853,24.95644599303135,0
3102,4,1,1,56,0.017543859649122806,0.017543859649122806,0.9824561403508771,57,1600,1200,400,0.75,20,12,8,331.517526273819,0.4326310568086884,0.33436532507739947,0.19251149992231487,130997.85175933782,-2714.3832475119857,128283.46851182583,3071,0,615.6315789473684,41,16,14,35.58797283328486,0.6216971544715447,44.072420634920626,1023.7103174603161,24.968544328300393,0
3103,4,1,1,56,0.017543859649122806,0.017543859649122806,0.9824561403508771,57,1650,1300,350,0.7878787878787878,20,13,7,330.33977943267473,0.4319000626566416,0.33345053018838167,0.19310014610979584,131251.8711911846,-2728.4571641156645,128523.41402706892,3072,0,616.4912280701755,41,16,16,35.36190579920613,0.6242378048780488,43.82440476190475,1024.7023809523791,24.992740998838517,0
3104,4,0,0,56,0.0,0.0,1.0,56,1550,1100,450,0.7096774193548387,20,11,9,339.3577722264059,0.43082386363636366,0.33753153970459016,0.19769061436402985,131119.87428944398,-2300.6903133055876,128819.18397613839,3073,2,628.5,40,16,16,35.26410663491433,0.6244791666666667,43.95325203252032,1024.1869918699176,25.60467479674794,0
3105,4,0,0,56,0.0,0.0,1.0,56,1300,900,400,0.6923076923076923,17,9,8,336.5050402522234,0.4308306277056277,0.32996478523955997,0.19642775395383094,131197.9489411889,-2370.245782107227,128827.70315908166,3074,3,629.5,40,16,16,35.25836557219852,0.6252604166666667,43.877032520325194,1024.4918699186976,25.61229674796744,0
3106,4,0,0,56,0.0,0.0,1.0,56,1500,1200,300,0.8,18,12,6,336.3101008547998,0.4307021103896104,0.3296220987899232,0.19644718637416525,131223.97898902767,-2373.61007832639,128850.36891070128,3075,4,630.5,40,16,16,35.23709746743372,0.6255208333333333,43.85162601626016,1024.5934959349593,25.614837398373982,0
3107,4,1,1,56,0.017543859649122806,0.017543859649122806,0.9824561403508771,57,1300,1000,300,0.7692307692307693,16,10,6,332.0795094448334,0.43025532581453635,0.3395296752519601,0.19554112344302818,131531.5767510707,-2664.211703199805,128867.3650478709,3076,0,620.421052631579,41,16,17,35.035460992907794,0.6270325203252034,43.5515873015873,1025.79365079365,25.019357336430485,0
3108,4,0,1,55,0.0,0.017857142857142856,0.9821428571428571,56,1600,1100,500,0.6875,21,11,10,337.29289045955926,0.42930194805194805,0.3491607461292421,0.19863678158102635,131536.54095611078,-2326.7319799722372,129209.80897613855,3077,1,631.9642857142857,40,16,18,34.89676210289941,0.6286458333333333,43.546747967479675,1025.8130081300815,25.645325203252035,0
3109,4,0,0,55,0.0,0.0,1.0,55,1050,700,350,0.6666666666666666,14,7,7,335.36174750917337,0.4300084175084175,0.33899294049848705,0.19776940437223214,131588.6707647564,-2174.038683984408,129414.63208077197,3078,2,611.8181818181819,40,15,13,34.89376980982567,0.6291666666666667,43.49593495934959,1026.0162601626014,25.650406504065035,0
3110,4,0,2,53,0.0,0.03636363636363636,0.9636363636363636,55,1100,700,400,0.6363636363636364,15,7,8,337.66709146162117,0.430331088664422,0.3393051305130512,0.19967433394393316,131692.9613655895,-2106.324153942736,129586.63721164675,3079,3,612.8181818181819,40,15,14,34.7295792079208,0.6302083333333333,43.39430894308944,1026.422764227644,25.6605691056911,0
3111,4,0,1,52,0.0,0.018867924528301886,0.9811320754716981,53,1700,1500,200,0.8823529411764706,19,15,4,348.56433981063196,0.42892779390420904,0.3453284056279582,0.20547964120328413,131574.6348002958,-1427.554857001983,130147.07994329382,3080,9,636.1698113207547,38,15,14,34.56927522649171,0.6324013157894737,43.50961538461538,1025.9615384615379,26.998987854251,0
3112,4,1,1,52,0.018867924528301886,0.018867924528301886,0.9811320754716981,53,1600,1200,400,0.75,20,12,8,349.0759833603751,0.42959300919206583,0.35224836878430255,0.20711841679382256,131821.37573964504,-1396.8647271531809,130424.51101249186,3081,0,636.7547169811321,38,15,14,34.30737619642114,0.6348684210526315,43.269230769230774,1026.9230769230774,27.02429149797572,0
3113,4,0,1,51,0.0,0.019230769230769232,0.9807692307692307,52,1700,1400,300,0.8235294117647058,20,14,6,358.07847666830656,0.4268869406737054,0.3606518988381848,0.21190459535832373,131721.78578985823,-966.6527200677301,130755.13306979049,3082,11,650.0,37,15,16,34.17672505874815,0.6356981981981983,43.36622807017543,1026.5350877192968,27.744191559980994,0
3114,4,0,0,51,0.0,0.0,1.0,51,1550,1300,250,0.8387096774193549,18,13,5,364.97883196958117,0.42673202614379085,0.35816218705680036,0.215231206347887,131587.9662390431,-594.6355561642733,130993.33068287883,3083,12,661.3529411764706,36,15,16,34.134791277942405,0.6362847222222223,43.49662162162162,1026.0135135135135,28.500375375375377,0
3115,4,0,0,51,0.0,0.0,1.0,51,700,500,200,0.7142857142857143,9,5,4,365.4222817637268,0.42648692810457517,0.360847148341338,0.21565594763154655,131616.85333982628,-580.8538267997794,131035.9995130265,3084,13,662.3529411764706,36,15,16,34.0942347088089,0.6365740740740742,43.468468468468465,1026.1261261261259,28.503503503503495,0
3116,4,1,1,51,0.019230769230769232,0.019230769230769232,0.9807692307692307,52,1550,1100,450,0.7096774193548387,20,11,9,360.2653199331542,0.42754682001005534,0.3599340846966501,0.21462468614708097,131975.16453379867,-890.7850252000869,131084.3795085986,3085,0,650.5961538461538,37,15,17,33.8650046241952,0.638231981981982,43.11951754385964,1027.5219298245597,27.770862968231345,0
3117,4,0,0,51,0.0,0.0,1.0,51,1450,900,550,0.6206896551724138,20,9,11,364.36252444444494,0.4249019607843137,0.3722415686274516,0.21771183343955797,132087.85545792908,-574.4271073792261,131513.42835054986,3086,1,663.5098039215686,37,14,18,33.64611111111111,0.6393581081081082,43.009868421052616,1027.960526315787,27.782716927453706,0
3118,4,0,1,50,0.0,0.0196078431372549,0.9803921568627451,51,1100,500,600,0.45454545454545453,17,5,12,361.2559156970422,0.42493464052287583,0.36545890176519547,0.21621436148434878,132150.7232084152,-651.95389546354,131498.76931295166,3087,2,664.5098039215686,38,13,18,33.662588320864494,0.6381578947368423,42.948717948717935,1028.205128205126,27.058029689608578,0
3119,4,0,1,49,0.0,0.02,0.98,50,1550,1100,450,0.7096774193548387,20,11,9,368.1739701060271,0.42426870748299317,0.36820846211233116,0.2213053402629626,132313.38158135168,-257.13140100803435,132056.25018034366,3088,3,676.9,37,13,18,33.320788482716964,0.6416103603603605,42.79057017543858,1028.8377192982434,27.80642484589847,0
3120,4,0,0,49,0.0,0.0,1.0,49,1400,900,500,0.6428571428571429,19,9,10,374.4065428656517,0.42309736394557823,0.37090091285368465,0.22505167147395305,132313.38158135183,107.79915454753643,132421.18073589937,3089,4,691.0612244897959,37,12,19,33.16048083413264,0.6416103603603605,42.79057017543859,1028.8377192982446,27.8064248458985,0
3121,4,0,0,49,0.0,0.0,1.0,49,1150,500,650,0.43478260869565216,18,5,13,373.60536621545987,0.4229910714285714,0.36787567212867067,0.2252574613876476,132428.6352040817,95.29090534529155,132523.92610942698,3090,5,692.0612244897959,34,15,19,33.06490477292004,0.6488970588235294,42.67857142857143,1029.2857142857147,30.27310924369749,0
3122,4,1,1,49,0.02,0.02,0.98,50,1100,700,400,0.6363636363636364,15,7,8,364.07947508101216,0.42345238095238097,0.3607433318758193,0.2208620051751396,132658.9004545088,-340.3234315396171,132318.5770229692,3091,0,679.2,36,14,17,33.078268473983385,0.6469907407407407,42.45495495495497,1030.1801801801823,28.616116116116174,0
3123,4,0,0,49,0.0,0.0,1.0,49,1450,1000,450,0.6896551724137931,19,10,9,370.2610364993134,0.423203656462585,0.3637584941029446,0.2240924671599089,132571.90626014542,17.242284514262906,132589.1485446597,3092,7,694.0612244897959,36,13,19,33.006652086750506,0.6461226851851851,42.53941441441442,1029.8423423423435,28.606731731731763,0
3124,4,0,0,49,0.0,0.0,1.0,49,1150,700,450,0.6086956521739131,16,7,9,368.30602082390203,0.4226190476190476,0.36239687364307427,0.22422775879175394,132793.2633117883,-18.288319482913437,132774.9749923054,3093,8,695.0612244897959,37,12,17,32.83421985815601,0.6463963963963963,42.324561403508774,1030.7017543859654,27.85680417259366,0
3125,4,0,0,49,0.0,0.0,1.0,49,1650,1300,350,0.7878787878787878,20,13,7,371.8334517953053,0.42284934807256236,0.36949059870599243,0.2274034751356729,132962.84072984025,88.00640581720484,133050.84713565744,3094,9,696.0612244897959,37,12,17,32.572737259905026,0.6480855855855854,42.16008771929826,1031.3596491228093,27.87458511142728,0
3126,4,0,0,49,0.0,0.0,1.0,49,1550,1000,550,0.6451612903225806,21,10,11,371.2770925949088,0.4219458616780045,0.36888948994383397,0.22781411437621554,133086.1058605451,82.36448973629854,133168.4703502814,3095,10,697.0612244897959,38,11,17,32.4631566231794,0.6474780701754386,42.0405982905983,1031.8376068376078,27.15362123256863,0
3127,4,0,0,49,0.0,0.0,1.0,49,1400,1000,400,0.7142857142857143,18,10,8,370.7838560393822,0.42222930839002265,0.3559008159962638,0.22446823922999967,132581.84700963713,81.82480188547146,132663.6718115226,3096,11,698.0612244897959,34,15,21,32.983181135128895,0.6504289215686274,42.529761904761905,1029.880952380952,30.29061624649859,3
3128,4,0,0,49,0.0,0.0,1.0,49,1200,700,500,0.5833333333333334,17,7,10,367.78142114993693,0.4218041383219955,0.3493367179640461,0.22328017399474298,132687.90486009675,-39.97075622918828,132647.93410386756,3097,12,699.0612244897959,36,13,18,32.953738113455,0.6472800925925926,42.42680180180181,1030.292792792794,28.61924424424428,0
3129,4,0,0,49,0.0,0.0,1.0,49,1850,1400,450,0.7567567567567568,23,14,9,369.05707740043044,0.4212018140589569,0.3386163691176638,0.21665149514706097,131414.7102127464,-84.79704366530177,131329.9131690811,3098,13,700.0612244897959,36,13,18,34.205335896027805,0.6345486111111112,43.66554054054053,1025.3378378378368,28.481606606606576,4
3130,4,0,0,49,0.0,0.0,1.0,49,850,500,350,0.5882352941176471,12,5,7,367.7887564020418,0.42116638321995464,0.33428811396284863,0.21653013317439257,131524.88175448202,-125.32546071870037,131399.5562937633,3099,14,701.0612244897959,37,12,19,34.12646980224476,0.6337274774774776,43.55811403508771,1025.7675438596482,27.723447131341842,0
3131,4,0,1,48,0.0,0.02040816326530612,0.9795918367346939,49,850,600,250,0.7058823529411765,11,6,5,365.5399926848555,0.4209360827664399,0.33622988676184296,0.21584156413486152,131637.3803117302,-176.2545927593479,131461.12571897084,3100,15,702.0612244897959,37,12,16,34.070480286355384,0.6348536036036038,43.448464912280684,1026.2061403508744,27.735301090564175,0
3132,4,0,0,48,0.0,0.0,1.0,48,1750,1500,250,0.8571428571428571,20,15,5,370.256248015232,0.4194093528368794,0.3410003475652146,0.21834334470335118,131587.96623904293,144.2533327246,131732.21957176752,3101,30,717.375,36,12,16,33.99942377346066,0.6362847222222223,43.496621621621614,1026.0135135135122,28.500375375375338,0
3133,4,0,0,48,0.0,0.0,1.0,48,1250,800,450,0.64,17,8,9,366.0374281330561,0.41914154846335694,0.33795712196013916,0.21651078244210265,131703.53366457656,41.68454772337577,131745.21821229995,3102,31,718.375,36,12,16,33.99090327299324,0.6374421296296298,43.384009009009,1026.4639639639624,28.512887887887846,0
3134,4,0,0,48,0.0,0.0,1.0,48,1750,1300,450,0.7428571428571429,22,13,9,364.9923682270298,0.4191230791962175,0.33225697409621446,0.21695739248418833,131890.67790089233,27.818174822990102,131918.49607571532,3103,32,719.375,37,11,18,33.8288144036436,0.6373873873873874,43.2017543859649,1027.1929824561382,27.761972498814547,0
3135,4,0,1,47,0.0,0.020833333333333332,0.9791666666666666,48,1200,800,400,0.6666666666666666,16,8,8,364.30495264431613,0.4191230791962175,0.3270897791528862,0.21735393514545986,132031.50398439902,19.94616131886096,132051.45014571788,3104,33,720.375,37,11,18,33.70441249688821,0.638795045045045,43.06469298245614,1027.741228070175,27.77678994784257,0
3136,4,0,0,47,0.0,0.0,1.0,47,950,600,350,0.631578947368421,13,6,7,368.5777645450204,0.4178615479494296,0.32489401323348766,0.22035012524764205,132108.41912436092,338.44515968672636,132446.86428404765,3105,34,726.1276595744681,36,11,18,33.5170427575127,0.6414930555555556,42.98986486486487,1028.0405405405413,28.556681681681702,0
3137,4,0,0,47,0.0,0.0,1.0,47,1050,400,650,0.38095238095238093,17,4,13,369.9009175363598,0.41701356768424297,0.3355628284422796,0.22201154877854073,132256.98201610107,384.3957996691223,132641.3778157702,3106,35,727.1276595744681,37,10,18,33.33322229328784,0.6410472972972973,42.8453947368421,1028.6184210526312,27.80049786628733,0
3138,4,0,0,47,0.0,0.0,1.0,47,1300,900,400,0.6923076923076923,17,9,8,371.91234080217663,0.41653176071538695,0.33801361013007125,0.2240545077515554,132398.00347222236,448.1654210911229,132846.1688933135,3107,36,728.1276595744681,36,11,18,33.13933873144401,0.6443865740740741,42.70833333333334,1029.1666666666679,28.587962962962997,0
3139,4,1,1,47,0.020833333333333332,0.020833333333333332,0.9791666666666666,48,1500,900,600,0.6,21,9,12,363.2939016374039,0.4171283983451537,0.33256860915249553,0.2206301251505746,132700.54879830522,41.86002447220423,132742.40882277742,3108,0,713.9375,38,10,15,33.05660687128441,0.643640350877193,42.414529914529915,1030.3418803418804,27.11426000899685,0
3140,4,0,0,47,0.0,0.0,1.0,47,950,600,350,0.631578947368421,13,6,7,370.18784974173246,0.4150477952513105,0.34018094731240067,0.224526458897584,132652.03145438977,421.2340575946399,133073.2655119844,3109,38,730.1276595744681,37,10,15,32.92786499911301,0.6449887387387387,42.46162280701754,1030.1535087719294,27.84198672356566,0
3141,4,0,0,47,0.0,0.0,1.0,47,1050,800,250,0.7619047619047619,13,8,5,370.5077331550515,0.41481652790625967,0.3404708157198204,0.22505889905998822,132708.51518015156,433.9062259541372,133142.42140610568,3110,39,731.1276595744681,37,10,17,32.862770919797114,0.6455518018018017,42.406798245614034,1030.3728070175437,27.847913703176857,0
3142,4,0,0,47,0.0,0.0,1.0,47,1200,600,600,0.5,18,6,12,375.484601384715,0.4140070921985815,0.3468534798211811,0.2293783147193211,132920.79863393985,581.9426181605895,133502.74125210044,3111,40,732.1276595744681,38,9,18,32.52089376985772,0.6458333333333331,42.20085470085471,1031.1965811965829,27.136752136752182,0
3143,4,0,0,47,0.0,0.0,1.0,47,1550,1100,450,0.7096774193548387,20,11,9,372.3401364733923,0.41464307739747147,0.3469545545660202,0.22863530694192635,133113.66705246933,512.7121913580468,133626.37924382737,3112,41,733.1276595744681,38,9,19,32.4080305069538,0.647752192982456,42.0138888888889,1031.9444444444462,27.156432748538055,0
3144,4,0,0,47,0.0,0.0,1.0,47,1450,900,550,0.6206896551724138,20,9,11,375.6221292086798,0.4132940178846747,0.3487724024987784,0.23184952113225418,133306.67529585803,614.587442472067,133921.2627383301,3113,42,734.1276595744681,38,9,19,32.12937099110284,0.649671052631579,41.82692307692308,1032.692307692308,27.176113360323896,0
3145,4,0,1,46,0.0,0.02127659574468085,0.9787234042553191,47,1050,600,450,0.5714285714285714,15,6,9,383.4921402829946,0.41317838421214925,0.3296216301949464,0.2280453261839295,131905.89871966562,734.3105121853869,132640.209231851,3114,43,735.1276595744681,36,11,19,33.33835781626837,0.6394675925925927,43.18693693693694,1027.2522522522524,28.53478478478479,3
3146,4,0,0,46,0.0,0.0,1.0,46,900,800,100,0.8888888888888888,10,8,2,392.64450132434,0.41325483091787435,0.3322876412418998,0.2337696336858596,131951.6933111497,1162.0213638117214,133113.7146749614,3115,44,737.2391304347826,35,11,19,33.05698715782357,0.6419642857142858,43.14236111111111,1027.4305555555554,29.355158730158728,0
3147,4,0,0,46,0.0,0.0,1.0,46,750,400,350,0.5333333333333333,11,4,7,392.64450132434,0.41311392914653783,0.3322876412418998,0.2337696336858596,131951.6933111497,1162.0213638117214,133113.7146749614,3116,45,738.2391304347826,35,11,19,33.05698715782357,0.6419642857142858,43.14236111111111,1027.4305555555554,29.355158730158728,0
3148,4,0,0,46,0.0,0.0,1.0,46,1650,1100,550,0.6666666666666666,22,11,11,391.62325512085977,0.4131038647342995,0.327044354685059,0.2339487613051839,132079.47812677553,1145.0790317344558,133224.55715851,3117,46,739.2391304347826,36,10,19,32.95400598889866,0.6412037037037036,43.018018018018026,1027.9279279279287,28.553553553553577,0
3149,4,0,0,46,0.0,0.0,1.0,46,1250,800,450,0.64,17,8,9,392.93473604161153,0.4120068438003221,0.3268010416121183,0.23563184138332516,132224.214818704,1191.097389619371,133415.31220832336,3118,47,740.2391304347826,36,10,19,32.774006350596764,0.6426504629629629,42.87725225225226,1028.4909909909923,28.56919419419423,0
3150,4,1,1,46,0.02127659574468085,0.02127659574468085,0.9787234042553191,47,1150,700,450,0.6086956521739131,16,7,9,387.64822865666906,0.41483580018501387,0.320870636848019,0.23458712393965472,132567.32840874136,877.898007079118,133445.22641582048,3119,0,725.468085106383,37,10,19,32.563617972742755,0.6441441441441441,42.543859649122815,1029.8245614035104,27.83309625414893,0
3151,4,1,0,47,0.02127659574468085,0.0,1.0,47,1100,700,400,0.6363636363636364,15,7,8,386.15696429121454,0.4127929386370644,0.3312348755979022,0.2349184017717233,132765.01092884352,853.6267168744249,133618.63764571794,3120,0,726.4468085106383,37,10,14,32.40271571443771,0.6461148648648649,42.35197368421053,1030.5921052631581,27.853840682788057,0
3152,4,0,0,47,0.0,0.0,1.0,47,1700,1200,500,0.7058823529411765,22,12,10,380.23926550443247,0.4120413197656491,0.328613284479395,0.23211190078325591,132893.2574169954,706.2469181459561,133599.50433514133,3121,1,727.4468085106383,38,9,15,32.42604393327117,0.6455592105263158,42.2275641025641,1031.0897435897434,27.13394062078272,0
3153,4,0,0,47,0.0,0.0,1.0,47,900,500,400,0.5555555555555556,13,5,8,380.5430418663843,0.4111162503854456,0.3311357506742587,0.2331550515394548,133030.99203740232,724.8036744831695,133755.7957118855,3122,2,728.4468085106383,38,9,17,32.27958436895885,0.6469298245614035,42.0940170940171,1031.6239316239319,27.147998200629786,0
3154,4,0,0,47,0.0,0.0,1.0,47,1450,1200,250,0.8275862068965517,17,12,5,385.95274177234114,0.41105843354918287,0.3361649255605539,0.23681903303921695,133086.1058605451,872.9894897362965,133959.0953502814,3123,3,729.4468085106383,38,9,17,32.08458445502864,0.6474780701754386,42.0405982905983,1031.8376068376078,27.15362123256863,0
3155,4,0,1,46,0.0,0.02127659574468085,0.9787234042553191,47,850,500,350,0.5882352941176471,12,5,7,384.73034096610996,0.41094279987665744,0.3380773746456289,0.23624350689076007,133113.66705246916,842.5733024691433,133956.2403549383,3124,4,730.4468085106383,38,9,17,32.08838043965905,0.6477521929824561,42.01388888888889,1031.9444444444448,27.15643274853802,0
3156,4,0,0,46,0.0,0.0,1.0,46,1150,700,450,0.6086956521739131,16,7,9,388.0852916286966,0.4106582125603864,0.3355512034697614,0.23860528086877364,133160.8178117307,1135.5509627962606,134296.36877452696,3125,5,724.804347826087,37,9,17,31.954367187223344,0.6500563063063062,41.96820175438597,1032.1271929824575,27.895329540066417,0
3157,4,0,0,46,0.0,0.0,1.0,46,1250,900,350,0.72,16,9,7,388.3298253535193,0.4102053140096618,0.3305926671406283,0.23966515695802385,133302.3201850569,1153.0533433364094,134455.3735283933,3126,6,725.804347826087,37,9,18,31.805673532951083,0.6514639639639639,41.83114035087719,1032.675438596491,27.91014698909435,0
3158,4,0,0,46,0.0,0.0,1.0,46,1750,1400,350,0.8,21,14,7,361.5199243321748,0.41032608695652173,0.2886056971514237,0.21943418662952957,132680.27181440455,393.4205717143843,133073.69238611893,3127,7,726.804347826087,37,9,14,33.122694054207464,0.6452702702702702,42.434210526315795,1030.2631578947378,27.84495021337129,5
3159,4,0,0,46,0.0,0.0,1.0,46,900,700,200,0.7777777777777778,11,7,4,362.1527330709884,0.40994363929146543,0.2934250580604567,0.22014950746449863,132736.76155163127,414.1961949830717,133150.95774661432,3128,8,727.804347826087,37,9,14,33.04958501808895,0.6458333333333333,42.37938596491228,1030.482456140351,27.850877192982455,0
3160,4,0,0,46,0.0,0.0,1.0,46,1050,700,350,0.6666666666666666,14,7,7,362.5445201502563,0.40930958132045087,0.2947628143167009,0.22088665158344528,132821.5187004656,430.7427525777225,133252.26145304332,3129,9,728.804347826087,37,9,14,32.95427348154452,0.6466779279279278,42.29714912280702,1030.8114035087724,27.859767662399253,0
3161,4,0,0,46,0.0,0.0,1.0,46,1200,700,500,0.5833333333333334,17,7,10,358.317701739214,0.4094605475040258,0.29028821857588727,0.21905261398914738,132948.34270445266,327.54892157938764,133275.89162603204,3130,10,729.804347826087,38,8,15,32.93578852860942,0.6461074561403508,42.17414529914531,1031.3034188034203,27.139563652721588,0
3162,4,0,1,45,0.0,0.021739130434782608,0.9782608695652174,46,850,600,250,0.7058823529411765,11,6,5,358.1358779481991,0.4087359098228664,0.29410294852573715,0.21958845545052436,133058.5475221894,330.6079470742949,133389.15546926367,3131,11,730.804347826087,38,8,16,32.829812571191894,0.647203947368421,42.06730769230769,1031.7307692307695,27.1508097165992,0
3163,4,0,0,45,0.0,0.0,1.0,45,1550,1200,350,0.7741935483870968,19,12,7,359.05057675243995,0.40717592592592594,0.2980124223602483,0.22063794983642313,133141.23109796192,560.8871630506283,133702.11826101254,3132,12,746.2666666666667,38,7,17,32.72321428571429,0.6480263157894737,41.98717948717949,1032.0512820512824,27.159244264507432,0
3164,4,0,0,45,0.0,0.0,1.0,45,800,500,300,0.625,11,5,6,357.6511858032539,0.4067340067340068,0.30148546725533465,0.22042991451547508,133251.5158156185,531.5125283074142,133783.02834392592,3133,13,747.2666666666667,38,7,17,32.648661699779254,0.6491228070175438,41.88034188034189,1032.4786324786337,27.170490328385096,0
3165,4,0,0,45,0.0,0.0,1.0,45,1400,800,600,0.5714285714285714,20,8,12,358.3952040170566,0.4058712121212121,0.30029421229255693,0.22154506601259003,133361.84619037207,559.2492146979598,133921.09540507002,3134,14,748.2666666666667,38,7,17,32.51879051165358,0.6502192982456139,41.77350427350429,1032.9059829059847,27.181736392262756,0
3166,4,0,0,45,0.0,0.0,1.0,45,650,300,350,0.46153846153846156,10,3,7,359.0251419354712,0.40507154882154883,0.3069290777697349,0.22242999024073978,133444.62393390705,581.9950096793319,134026.61894358636,3135,15,749.2666666666667,38,7,17,32.4195188363837,0.6510416666666665,41.69337606837608,1033.226495726498,27.190170940170997,0
3167,4,0,0,45,0.0,0.0,1.0,45,1350,1200,150,0.8888888888888888,15,12,3,356.19413083527144,0.40471380471380475,0.30213172128539645,0.2216867630129224,133613.88991083796,518.499530430674,134132.38944126863,3136,16,750.2666666666667,37,8,18,32.323041503164,0.6545608108108107,41.5296052631579,1033.8815789473686,27.942745376955905,0
3168,4,0,0,45,0.0,0.0,1.0,45,950,600,350,0.631578947368421,13,6,7,369.14256138813346,0.40492424242424246,0.2669771752983432,0.2155954423698051,131218.63928153997,702.8288189499335,131921.4681004899,3137,17,751.2666666666667,38,7,18,34.40150330205074,0.6288377192982456,43.85683760683761,1024.5726495726499,26.96243814664868,7
3169,4,1,0,46,0.021739130434782608,0.0,1.0,46,1000,500,500,0.5,15,5,10,373.21957315454864,0.4082326892109501,0.2832780122662517,0.21175720166683176,130099.04308431929,511.1931797428365,130610.23626406213,3138,0,735.9130434782609,38,8,19,35.43302963661118,0.6175986842105263,44.951923076923066,1020.1923076923058,26.847165991902784,2
3170,4,1,1,46,0.02127659574468085,0.02127659574468085,0.9787234042553191,47,1250,800,450,0.64,17,8,9,366.7894360844041,0.4109235275979031,0.2786039190241971,0.20943654311796783,130346.55044100103,162.15300329664294,130508.70344429767,3139,0,721.2340425531914,37,10,20,35.345641397329906,0.6219031531531531,44.709429824561404,1021.162280701754,27.598980559506863,0
3171,4,1,1,46,0.02127659574468085,0.02127659574468085,0.9787234042553191,47,1050,500,550,0.47619047619047616,16,5,11,363.03795215125007,0.41100061671292015,0.2760727930413178,0.20789333744272848,130458.54403518373,72.28053343334096,130530.82456861707,3140,0,722.2127659574468,37,10,20,35.327783442452855,0.6230292792792793,44.599780701754376,1021.6008771929811,27.61083451872922,0
3172,4,0,0,46,0.0,0.0,1.0,46,1150,900,250,0.782608695652174,14,9,5,370.08282483272916,0.4071054750402576,0.27849919200540896,0.21117312603891472,130320.07250071016,445.84411269377256,130765.91661340393,3141,3,738.9130434782609,36,10,20,35.28845446858571,0.6235532407407407,44.73536036036036,1021.0585585585584,28.36273773773773,0
3173,4,1,1,46,0.02127659574468085,0.02127659574468085,0.9787234042553191,47,750,400,350,0.5333333333333333,11,4,7,360.7781335034535,0.41019118100524204,0.2694289634765852,0.20689793391499564,130514.55886667038,17.35978858878022,130531.91865525917,3142,0,724.1702127659574,37,10,14,35.32869674857817,0.6235923423423424,44.54495614035087,1021.8201754385955,27.616761498340416,0
3174,4,0,0,46,0.0,0.0,1.0,46,1350,1100,250,0.8148148148148148,16,11,5,369.9302794963433,0.4061996779388084,0.27435108503949035,0.21186916007517864,130463.84222059914,452.50512336662575,130916.34734396577,3143,5,740.9130434782609,36,10,21,35.146375293944736,0.625,44.594594594594604,1021.6216216216229,28.378378378378414,0
3175,4,0,0,46,0.0,0.0,1.0,46,950,600,350,0.631578947368421,13,6,7,370.3264956097406,0.4063405797101449,0.2773242304467589,0.21256881389363702,130550.14209733403,469.2353248518952,131019.37742218592,3144,6,741.9130434782609,36,10,17,35.04866850321395,0.6258680555555556,44.510135135135144,1021.9594594594612,28.38776276276281,0
3176,4,1,2,45,0.02127659574468085,0.0425531914893617,0.9574468085106383,47,650,300,350,0.46153846153846156,10,3,7,364.12898769892496,0.41013336416897933,0.27415057844604207,0.21018534636482528,130766.77439212079,123.19463681134417,130889.96902893213,3145,0,727.1063829787234,37,10,17,34.987403516295025,0.626126126126126,44.298245614035096,1022.8070175438608,27.64343290659083,0
3177,4,0,0,45,0.0,0.0,1.0,45,1350,800,550,0.5925925925925926,19,8,11,376.76952425491754,0.4059132996632997,0.27229203617746567,0.2168081568562664,130646.86381440768,844.7513449502893,131491.61515935799,3146,8,744.9333333333333,35,10,18,34.78586456092684,0.6288690476190475,44.41550925925927,1022.3379629629638,29.20965608465611,0
3178,4,0,2,43,0.0,0.044444444444444446,0.9555555555555556,45,1600,1300,300,0.8125,19,13,6,361.73334907913556,0.4059974747474748,0.21060445628536595,0.20046313195135074,129174.91455078138,345.37489149307027,129520.28944227446,3147,9,745.9333333333333,39,6,17,36.66626105816853,0.6065705128205128,45.85937500000001,1016.562500000001,26.065705128205156,3
3179,4,0,0,43,0.0,0.0,1.0,43,1050,700,350,0.6666666666666666,14,7,7,370.01319405879235,0.4019010705057217,0.21418336131459204,0.2044670405094113,129062.08070031164,950.9345423591817,130013.01524267082,3148,28,778.2325581395348,37,6,17,36.57096417395057,0.6089527027027027,45.9703947368421,1016.1184210526316,27.462660028449502,0
3180,4,0,0,43,0.0,0.0,1.0,43,1050,600,450,0.5714285714285714,15,6,9,369.0640523577388,0.4003091546696198,0.21078183067440381,0.20495209709974058,129257.13320444745,940.8322753154762,130197.96547976293,3149,29,779.2325581395348,37,6,18,36.39610739702395,0.6109234234234234,45.77850877192982,1016.8859649122801,27.48340445708865,0
3181,4,1,1,43,0.022727272727272728,0.022727272727272728,0.9772727272727273,44,700,400,300,0.5714285714285714,10,4,6,362.49835699671434,0.4056884249471459,0.20417322834645701,0.20227280904473932,129445.89548405634,584.7848865877511,130030.68037064408,3150,0,762.5,38,6,16,36.37073490813649,0.6110197368421053,45.59294871794871,1017.6282051282035,26.779689608636932,0
3182,4,2,2,43,0.044444444444444446,0.044444444444444446,0.9555555555555556,45,1050,700,350,0.6666666666666666,14,7,7,355.4629694748056,0.4059553872053872,0.20403172655166957,0.19952450720577766,129678.39084201379,219.1731770833237,129897.56401909712,3151,0,746.5111111111111,39,6,16,36.31323719915458,0.6116452991452992,45.36458333333333,1018.5416666666658,26.11645299145297,0
3183,4,1,0,44,0.022727272727272728,0.0,1.0,44,950,300,650,0.3157894736842105,16,3,13,363.02436994128027,0.40417988019732204,0.2160164075169324,0.2032680520294006,129581.83235627133,608.272609394391,130190.10496566573,3152,0,764.4545454545455,38,6,17,36.218957677509614,0.6123903508771931,45.4594017094017,1018.1623931623922,26.793747188484005,0
3184,4,0,0,44,0.0,0.0,1.0,44,950,900,50,0.9473684210526315,10,9,1,372.07014375271837,0.403761451726568,0.196260818107848,0.21671763349388215,131114.67013888902,993.6189641318038,132108.28910302083,3153,1,765.4545454545455,34,10,19,34.4317873609981,0.6357230392156862,43.95833333333334,1024.1666666666679,30.122549019607877,3
3185,4,0,0,44,0.0,0.0,1.0,44,1750,1200,550,0.6857142857142857,23,12,11,371.3506073043722,0.4032329105003523,0.19074427774868297,0.21700111725845567,131239.1643759644,947.1486786265319,132186.31305459095,3154,2,766.4545454545455,35,9,19,34.324169772958314,0.6348214285714285,43.83680555555555,1024.652777777777,29.275793650793627,0
3186,4,0,0,44,0.0,0.0,1.0,44,850,500,350,0.5882352941176471,12,5,7,371.77963078016535,0.4022639182522903,0.19515680351205145,0.21811419292474488,131390.93888168008,969.755230693854,132360.69411237392,3155,3,767.4545454545455,33,11,19,34.159594389991234,0.6407828282828283,43.68872549019608,1025.2450980392152,31.068033273915614,0
3187,4,0,1,43,0.0,0.022727272727272728,0.9772727272727273,44,1350,1000,350,0.7407407407407407,17,10,7,372.9323461520822,0.402583245243129,0.17017237841165644,0.21911011849518905,131446.7860510975,1004.1516632373246,132450.93771433484,3156,4,768.4545454545455,35,9,18,34.07355154251319,0.6369047619047619,43.63425925925927,1025.4629629629637,29.298941798941822,2
3188,4,0,0,43,0.0,0.0,1.0,43,1550,1400,150,0.9032258064516129,17,14,3,378.85896368583644,0.3989479512735327,0.1737867118893055,0.22225704327400728,131389.1439909299,1355.5909863945844,132744.7349773245,3157,37,787.2325581395348,34,9,19,33.97996013314756,0.6384803921568626,43.690476190476204,1025.2380952380968,30.154061624649906,0
3189,4,1,1,43,0.022727272727272728,0.022727272727272728,0.9772727272727273,44,750,400,350,0.5333333333333333,11,4,7,369.1495005902744,0.400997621564482,0.168316095900942,0.21841140231722128,131713.96933138304,924.429199888565,132638.3985312716,3158,0,770.3181818181819,35,9,15,33.90050080805803,0.6395833333333332,43.3738425925926,1026.504629629631,29.32870370370374,0
3190,4,1,1,43,0.022727272727272728,0.022727272727272728,0.9772727272727273,44,850,400,450,0.47058823529411764,13,4,9,367.169925286895,0.4005571705426357,0.16279527755342094,0.2175106048629388,131761.3363997446,875.7600083191555,132637.09640806378,3159,0,771.2954545454545,36,8,15,33.90346788051624,0.6380208333333333,43.327702702702716,1026.6891891891914,28.519144144144207,0
3191,4,0,0,43,0.0,0.0,1.0,43,1400,1000,400,0.7142857142857143,18,10,8,372.37422169835355,0.39765596160945,0.16883169892955863,0.2204261951300126,131732.43344696067,1210.7524754484389,132943.18592240912,3160,40,790.2325581395348,36,7,16,33.79908951294427,0.6377314814814814,43.355855855855864,1026.576576576578,28.516016016016053,0
3192,4,1,1,43,0.022727272727272728,0.022727272727272728,0.9772727272727273,44,800,500,300,0.625,11,5,6,366.2356190714558,0.40202167019027485,0.16887828347495404,0.21834352556855519,132003.33275623288,868.8644582948793,132872.19721452775,3161,0,773.25,37,7,17,33.68322307582871,0.6385135135135134,43.092105263157904,1027.63157894737,27.773826458037025,0
3193,4,0,0,43,0.0,0.0,1.0,43,1250,1100,150,0.88,14,11,3,373.30473935899147,0.39728682170542634,0.16976948094980715,0.22232587740936305,131963.74584043524,1252.5383491599928,133216.28418959523,3162,42,792.2325581395348,36,7,17,33.541575332456524,0.6400462962962962,43.13063063063064,1027.4774774774792,28.541041041041087,0
3194,4,0,0,43,0.0,0.0,1.0,43,900,600,300,0.6666666666666666,12,6,6,372.23520237256696,0.3962486157253599,0.16920082343109843,0.22236668372099436,132079.47812677556,1232.9262539566757,133312.40438073225,3163,43,793.2325581395348,36,7,18,33.45224401110137,0.6412037037037036,43.018018018018026,1027.927927927929,28.553553553553584,0
3195,4,1,2,42,0.022727272727272728,0.045454545454545456,0.9545454545454546,44,850,400,450,0.47058823529411764,13,4,9,360.90252476690256,0.39988548273431995,0.15764744633031058,0.21709674951362934,132341.5858725763,752.482494613743,133094.06836719005,3164,0,776.1818181818181,37,7,18,33.47941531685138,0.6418918918918918,42.76315789473685,1028.9473684210539,27.80938833570416,0
3196,4,0,0,42,0.0,0.0,1.0,42,1300,1000,300,0.7692307692307693,16,10,6,363.86501929789387,0.39554297328687577,0.15254515599343188,0.21853431632388312,132282.13168827622,1226.5680799042395,133508.69976818046,3165,45,799.1666666666666,36,6,19,33.4630997993067,0.6432291666666665,42.82094594594595,1028.716216216217,28.57545045045047,0
3197,4,1,0,43,0.023255813953488372,0.0,1.0,43,1150,500,650,0.43478260869565216,18,5,13,354.819216574084,0.39747139165743817,0.15380514042873528,0.21477424415484336,132576.73852237652,808.2563524955126,133384.99487487203,3166,0,781.5581395348837,35,8,21,33.399359406608234,0.6482142857142856,42.53472222222222,1029.8611111111109,29.424603174603167,0
3198,4,0,1,42,0.0,0.023255813953488372,0.9767441860465116,43,1200,900,300,0.75,15,9,6,355.03748573864107,0.3970791805094131,0.15202227876672625,0.21558961105357305,132695.96220207465,822.4081575788591,133518.37035965352,3167,1,782.5581395348837,35,8,17,33.273889762600156,0.6494047619047618,42.418981481481474,1030.3240740740732,29.437830687830665,0
3199,4,0,0,42,0.0,0.0,1.0,42,900,500,400,0.5555555555555556,13,5,8,362.5914664706473,0.39505903987611307,0.1502890173410405,0.21932980314483203,132551.19756235817,1212.3866213151796,133763.58418367335,3168,48,802.1666666666666,34,8,20,33.22495183044314,0.6501225490196079,42.5595238095238,1029.761904761904,30.28711484593835,0
3200,4,0,0,42,0.0,0.0,1.0,42,1650,1400,250,0.8484848484848485,19,14,5,362.5463040997124,0.3939096980255517,0.15120465317122145,0.22078418638886702,132803.95418645014,1229.5165520250205,134033.47073847515,3169,49,803.1666666666666,36,6,18,32.97188535634946,0.6484375,42.3141891891892,1030.7432432432447,28.631756756756797,0
3201,4,1,1,42,0.023255813953488372,0.023255813953488372,0.9767441860465116,43,600,300,300,0.5,9,3,6,353.1653764953621,0.39710225175341457,0.15394157752061544,0.21680622036515682,133104.23790252782,801.5616583949031,133905.79956092272,3170,0,785.4651162790698,37,6,19,32.91217281195764,0.6494932432432432,42.02302631578948,1031.907894736843,27.889402560455217,0
3202,4,0,0,42,0.0,0.0,1.0,42,1100,900,200,0.8181818181818182,13,9,4,355.49886072918395,0.3954582849399923,0.14955617934906318,0.2189026666949162,133217.40974386354,1071.727478647282,134289.13722251082,3171,1,789.6428571428571,37,5,19,32.73842715524873,0.6506193693693694,41.91337719298246,1032.3464912280706,27.901256519677585,0
3203,4,0,1,41,0.0,0.023809523809523808,0.9761904761904762,42,950,500,450,0.5263157894736842,14,5,9,355.31118663741785,0.3949501548586914,0.15411618420853124,0.21978901439994186,133387.25767784318,1078.7969615651004,134466.05463940828,3172,2,790.6428571428571,37,5,20,32.57295315430068,0.6523085585585585,41.74890350877193,1033.0043859649124,27.91903745851115,0
3204,4,0,0,41,0.0,0.0,1.0,41,1300,900,400,0.6923076923076923,17,9,8,359.2714151409118,0.39496951219512194,0.14771863218959203,0.22239918775322037,133414.04537983934,1386.3705766577446,134800.41595649708,3173,3,805.6829268292682,36,5,20,32.44381767313423,0.6545138888888888,41.722972972972975,1033.1081081081084,28.697447447447455,0
3205,4,1,0,42,0.023809523809523808,0.0,1.0,42,850,600,250,0.7058823529411765,11,6,5,353.25067650662976,0.39674070847851334,0.15506954543759566,0.22097325383434308,133801.3214404363,1053.106826464063,134854.42826690036,3174,0,787.4761904761905,35,7,19,32.211493642092705,0.6604166666666667,41.348379629629626,1034.6064814814808,29.560185185185166,0
3206,4,1,0,43,0.023255813953488372,0.0,1.0,43,700,400,300,0.5714285714285714,10,4,6,345.9118764458047,0.39917866371354743,0.1592733727631097,0.21805013897683803,134083.84471887437,676.2388655547511,134760.0835844291,3175,0,770.1395348837209,36,7,20,32.11894277119351,0.6611689814814814,41.075450450450454,1035.698198198199,28.769394394394414,0
3207,4,1,2,42,0.022727272727272728,0.045454545454545456,0.9545454545454546,44,900,600,300,0.6666666666666666,12,6,6,338.98744560283666,0.4010196441155744,0.1586821884346481,0.2149194046467883,134294.9408111149,304.85978858879236,134599.8005997037,3176,0,753.6136363636364,37,7,20,32.08758683310414,0.6613175675675675,40.87171052631579,1036.5131578947364,28.013869132290175,0
3208,4,0,0,42,0.0,0.0,1.0,42,1300,1000,300,0.7692307692307693,16,10,6,344.8835066162569,0.39767228029423146,0.15868012422360223,0.21792089703774492,134171.3334956579,854.6959966723552,135026.02949233024,3177,2,785.6190476190476,36,6,20,32.058197463768096,0.662037037037037,40.990990990990994,1036.0360360360366,28.778778778778797,0
3209,4,0,0,42,0.0,0.0,1.0,42,1800,1400,400,0.7777777777777778,22,14,8,347.88856967952177,0.3979626403406891,0.1578130817922303,0.22122637773543058,134404.7763980196,951.5770838405926,135356.3534818602,3178,3,786.6190476190476,36,6,22,31.74730306979437,0.6643518518518519,40.765765765765764,1036.9369369369367,28.8038038038038,0
3210,4,0,0,42,0.0,0.0,1.0,42,1050,800,250,0.7619047619047619,13,8,5,349.2935438025237,0.39747870692992643,0.14920723448330842,0.22319434213753572,134580.80317911954,1001.7203940481752,135582.5235731677,3179,4,787.6190476190476,35,7,22,31.53525283509945,0.6681547619047619,40.59606481481482,1037.615740740741,29.646164021164033,0
3211,4,0,1,41,0.0,0.023809523809523808,0.9761904761904762,42,900,600,300,0.6666666666666666,12,6,6,349.15466222138684,0.39749080526519553,0.14507957749844658,0.22347393691214684,134640.85708429795,1002.0965952932213,135642.95367959118,3180,5,788.6190476190476,35,7,22,31.47896453663433,0.66875,40.53819444444445,1037.847222222223,29.652777777777803,0
3212,4,0,0,41,0.0,0.0,1.0,41,1050,600,450,0.5714285714285714,15,6,9,362.3954828776125,0.39745934959349594,0.12197700746303308,0.23065521379922346,134437.04433094806,1543.8755193905888,135980.91985033866,3181,6,799.2926829268292,37,4,20,31.338989920349608,0.6627252252252251,40.73464912280702,1037.0614035087724,28.028686581318173,2
3213,4,0,1,40,0.0,0.024390243902439025,0.975609756097561,41,800,500,300,0.625,11,5,6,365.0300197491976,0.3970782520325203,0.12542674531839393,0.23325525308900336,134581.66099773246,1625.4135495380053,136207.07454727046,3182,7,800.2926829268292,34,7,21,31.126185559124973,0.670343137254902,40.595238095238095,1037.6190476190477,30.518207282913167,0
3214,4,0,0,40,0.0,0.0,1.0,40,950,700,250,0.7368421052631579,12,7,5,368.369458628695,0.3935363247863248,0.13812961354754671,0.23500134715287666,134521.57393880372,1910.727873143419,136432.30181194714,3183,8,821.0,36,4,22,31.09960739614996,0.6655092592592593,40.653153153153156,1037.3873873873877,28.816316316316325,0
3215,4,0,0,40,0.0,0.0,1.0,40,1150,700,450,0.6086956521739131,16,7,9,366.3627491798935,0.3931757478632478,0.13799610002294105,0.23450443813144703,134643.43112244885,1865.6738578070472,136509.10498025588,3184,9,822.0,34,6,22,31.029909382885982,0.6709558823529412,40.53571428571428,1037.8571428571418,30.52521008403358,0
3216,4,1,1,40,0.024390243902439025,0.024390243902439025,0.975609756097561,41,900,700,200,0.7777777777777778,11,7,4,355.63642082987786,0.39585873983739833,0.1393635059345244,0.22932417481099027,134911.2654320988,1395.8719135802498,136307.13734567905,3185,0,802.9268292682926,35,6,18,31.041109625668444,0.6714285714285715,40.27777777777778,1038.8888888888891,29.68253968253969,0
3217,4,0,1,39,0.0,0.025,0.975,40,800,600,200,0.75,10,6,4,365.3682152068001,0.392855235042735,0.1425361155698237,0.23466432791117137,134767.01388888876,1847.9166666666483,136614.93055555542,3186,11,824.0,34,6,22,30.932316746923483,0.6721813725490197,40.41666666666666,1038.3333333333321,30.539215686274474,0
3218,4,0,0,39,0.0,0.0,1.0,39,500,300,200,0.6,7,3,4,374.91111052105583,0.39206590193432295,0.14496808497753255,0.23978453805833078,134614.36106305255,2293.6839196462734,136908.04498269883,3187,12,844.4358974358975,33,6,22,30.837171311604465,0.672979797979798,40.56372549019607,1037.7450980392148,31.446821152703478,0
3219,4,0,0,39,0.0,0.0,1.0,39,800,600,200,0.75,10,6,4,373.17792221731264,0.391278677462888,0.14329912511730702,0.23909357043726448,134677.95589436742,2251.7679498269717,136929.72384419438,3188,13,845.4358974358975,33,6,22,30.818575364029893,0.6736111111111112,40.50245098039215,1037.9901960784302,31.454248366013037,0
3220,4,1,1,39,0.025,0.025,0.975,40,1100,700,400,0.6363636363636364,15,7,8,364.86758165640697,0.39340277777777777,0.1390499656199864,0.2351428742639444,134890.65334467115,1843.445294784574,136734.09863945574,3189,0,825.275,34,6,20,30.821921078768415,0.6734068627450981,40.297619047619044,1038.8095238095234,30.553221288515395,0
3221,4,0,0,39,0.0,0.0,1.0,39,1050,900,150,0.8571428571428571,12,9,3,375.79944238079656,0.3900134952766532,0.1479652956764803,0.24204225483431857,134868.83049788547,2336.726259131108,137205.55675701657,3190,15,847.4358974358975,33,6,21,30.559815950920246,0.6755050505050504,40.318627450980394,1038.7254901960787,31.47653000594178,0
3222,4,0,1,38,0.0,0.02564102564102564,0.9743589743589743,39,1000,800,200,0.8,12,8,4,351.1392207313982,0.39074448942869994,0.003273935610678347,0.21237835804536048,132546.94097490152,1510.6485426093031,134057.58951751082,3191,16,848.4358974358975,35,4,19,33.524057734816985,0.6479166666666666,42.56365740740741,1029.7453703703711,29.42129629629632,7
3223,4,0,0,38,0.0,0.0,1.0,38,400,300,100,0.75,5,3,2,355.3682049460706,0.3876985538169749,0.018508376386683123,0.21478543707746797,132520.55165816337,1818.7181122449142,134339.26977040828,3192,18,871.3421052631579,34,4,19,33.44172736732572,0.6498161764705882,42.58928571428572,1029.642857142858,30.283613445378176,0
3224,4,1,1,38,0.02564102564102564,0.02564102564102564,0.9743589743589743,39,800,500,300,0.625,11,5,6,347.87438930364436,0.3926563202878992,0.011428011877298694,0.21140789678978494,132725.77649444886,1434.3796885716908,134160.15618302056,3193,0,849.974358974359,35,4,17,33.42845576397469,0.6497023809523809,42.390046296296305,1030.439814814816,29.4411375661376,0
3225,4,0,0,38,0.0,0.0,1.0,38,650,500,150,0.7692307692307693,8,5,3,353.42529381433906,0.3873133001422475,0.018372088779674556,0.21430897458833048,132643.15653344675,1775.8893140589557,134419.0458475057,3194,20,873.3421052631579,34,4,17,33.368484918525375,0.6510416666666667,42.470238095238095,1030.1190476190477,30.29761904761905,0
3226,4,0,0,38,0.0,0.0,1.0,38,800,600,200,0.75,10,6,4,356.61079169812876,0.38673541963015645,0.013747689463955659,0.21677127899852544,132735.14739229018,1866.9571995464826,134602.10459183666,3195,21,874.3421052631579,34,4,18,33.193979128157736,0.6519607843137255,42.38095238095238,1030.4761904761901,30.30812324929971,0
3227,4,0,0,38,0.0,0.0,1.0,38,850,600,250,0.7058823529411765,11,6,5,358.13771310673076,0.3866761498340446,0.013015105299615026,0.21877213476237675,132919.22477324266,1920.6774376417304,134839.90221088438,3196,22,875.3421052631579,34,4,18,32.96967597937351,0.6537990196078431,42.202380952380956,1031.1904761904764,30.32913165266107,0
3228,4,0,0,38,0.0,0.0,1.0,38,800,600,200,0.75,10,6,4,358.68463640707654,0.38701695116168805,0.013672788689951698,0.21928616832706452,132949.9167375284,1937.418509070302,134887.3352465987,3197,23,876.3421052631579,34,4,18,32.9247470083497,0.6541053921568627,42.17261904761905,1031.3095238095243,30.332633053221304,0
3229,4,0,0,38,0.0,0.0,1.0,38,1050,700,350,0.6666666666666666,14,7,7,358.3368346227945,0.3868835941204362,0.01483375027323719,0.21997618148090536,133103.42970521544,1939.1723356009095,135042.60204081636,3198,24,877.3421052631579,34,4,18,32.77957237348101,0.6556372549019608,42.023809523809526,1031.9047619047622,30.350140056022415,0
3230,4,0,0,38,0.0,0.0,1.0,38,600,300,300,0.5,9,3,6,354.0424349988425,0.38592045993361784,0.0076895999223147715,0.21805795428337807,133226.3038548753,1833.5530045351477,135059.85685941044,3199,25,878.3421052631579,34,4,18,32.76709524907749,0.6568627450980392,41.904761904761905,1032.3809523809525,30.36414565826331,0
3231,4,0,0,38,0.0,0.0,1.0,38,950,600,350,0.631578947368421,13,6,7,379.9255270543905,0.3856833807491702,0.06924722874379596,0.22235562075787374,131298.46810967516,2376.727939600492,133675.19604927566,3200,26,879.3421052631579,35,3,18,34.04444287596462,0.6354166666666665,43.77893518518519,1024.88425925926,29.28240740740743,7
3232,4,0,0,38,0.0,0.0,1.0,38,1200,1000,200,0.8333333333333334,14,10,4,380.58293441101586,0.38559447605500236,0.07107369930382168,0.22382983682964125,131485.1878634421,2408.210423690045,133893.39828713212,3201,27,880.3421052631579,33,5,18,33.83854602302148,0.6417297979797979,43.59681372549021,1025.6127450980405,31.079174093880013,0
3233,4,0,0,38,0.0,0.0,1.0,38,1000,700,300,0.7,13,7,6,380.37742809341705,0.3860982693219535,0.06716624336761634,0.22426195971817536,131579.47063629387,2409.972126105365,133989.44276239924,3202,28,881.3421052631579,33,5,17,33.748407389711744,0.6426767676767676,43.50490196078432,1025.980392156864,31.09031491384436,0
3234,4,0,0,38,0.0,0.0,1.0,38,800,600,200,0.75,10,6,4,375.22332482388214,0.38578710289236606,0.06400671010222259,0.22213751180562988,131736.6836823578,2286.1352905132794,134022.8189728711,3203,29,882.3421052631579,33,5,17,33.72167343122042,0.6442550505050504,43.35171568627452,1026.5931372549026,31.10888294711826,0
3235,4,0,0,38,0.0,0.0,1.0,38,800,300,500,0.375,13,3,10,373.95751473982625,0.38572783309625414,0.05951745489484361,0.22212175273100532,131862.52170138893,2262.196180555565,134124.7178819445,3204,30,883.3421052631579,33,5,17,33.62702839756593,0.6455176767676767,43.22916666666667,1027.0833333333337,31.123737373737384,0
3236,4,1,0,39,0.02564102564102564,0.0,1.0,39,950,700,250,0.7368421052631579,12,7,5,363.0504206399514,0.39009784075573545,0.06737551807340214,0.21734096610278525,132159.87761488368,1796.1398319616242,133956.0174468453,3205,0,861.6666666666666,35,4,18,33.60723397868828,0.644047619047619,42.93981481481483,1028.240740740743,29.37830687830694,0
3237,4,0,0,39,0.0,0.0,1.0,39,950,500,450,0.5263157894736842,14,5,9,366.3920348725083,0.39035087719298245,0.0663100122924567,0.21968688406728154,132219.38898533973,1888.8261959876806,134108.2151813274,3206,1,862.6666666666666,35,4,18,33.46134368669818,0.6446428571428571,42.88194444444446,1028.472222222224,29.384920634920686,0
3238,4,1,1,39,0.025,0.025,0.975,40,900,400,500,0.4444444444444444,14,4,10,356.0232396140476,0.3958333333333333,0.0592467337264424,0.2151813416786792,132520.55165816328,1436.3203498992211,133956.8720080625,3207,0,842.075,34,6,19,33.42486607314911,0.6498161764705883,42.589285714285715,1029.6428571428573,30.28361344537816,0
3239,4,2,2,39,0.04878048780487805,0.04878048780487805,0.9512195121951219,41,600,100,500,0.16666666666666666,11,1,10,347.2439171467802,0.3955030487804878,0.06390112418644378,0.21119261190402527,132755.59413580247,1019.714506172832,133775.3086419753,3208,0,822.4878048780488,35,6,17,33.41475741239892,0.65,42.36111111111111,1030.5555555555554,29.44444444444444,0
3240,4,0,1,38,0.0,0.02564102564102564,0.9743589743589743,39,1300,800,500,0.6153846153846154,18,8,10,346.4722743688081,0.3884671614934773,0.08996218331256722,0.20841639888954488,132341.5858725764,1370.5380501693126,133712.1239227457,3209,4,865.6666666666666,37,2,17,33.85061452117081,0.6418918918918917,42.76315789473686,1028.9473684210545,27.809388335704178,4
3241,4,0,0,38,0.0,0.0,1.0,38,850,700,150,0.8235294117647058,10,7,3,348.5126520379113,0.3823346372688478,0.04057138223061463,0.201693373020157,130866.81909950498,1521.7484376268228,132388.5675371318,3210,36,889.3421052631579,36,2,20,35.28551251008878,0.6290509259259258,44.200450450450454,1023.1981981981988,28.42217217217219,3
3242,4,1,0,39,0.02564102564102564,0.0,1.0,39,900,600,300,0.6666666666666666,12,6,6,349.3906908775433,0.38332208726945566,0.06131680808047579,0.20449309878725067,131300.02891514683,1375.0015629809009,132675.03047812774,3211,0,867.5128205128206,37,2,21,34.825233586534,0.6314752252252254,43.777412280701746,1024.8903508771918,27.69973921289708,0
3243,4,0,0,39,0.0,0.0,1.0,39,1250,1000,250,0.8,15,10,5,344.8209666985579,0.38346266306792626,0.04991253269993101,0.20081736250135948,131109.19922017682,1241.840163635042,132351.03938381185,3212,1,868.5128205128206,38,1,17,35.135005911398565,0.6277412280701754,43.96367521367522,1024.1452991452995,26.95119208277104,3
3244,4,1,1,39,0.025,0.025,0.975,40,800,600,200,0.75,10,6,4,338.0243154413846,0.38846153846153847,0.04777783720183959,0.19813099216686536,131356.22409058549,880.6848022125588,132236.90889279803,3213,0,847.775,37,3,17,35.059788034370854,0.6320382882882883,43.72258771929824,1025.1096491228063,27.70566619250828,0
3245,4,0,0,39,0.0,0.0,1.0,39,1300,1100,200,0.8461538461538461,15,11,4,342.2418713717863,0.3849527665317139,0.051512409159467865,0.20075040761143065,131384.32618690372,1193.0435326254276,132577.36971952915,3214,3,870.5128205128206,37,2,19,34.92335115864528,0.6323198198198199,43.69517543859649,1025.2192982456145,27.708629682313905,0
3246,4,0,0,39,0.0,0.0,1.0,39,950,800,150,0.8421052631578947,11,8,3,341.95479720076463,0.38506522717049035,0.05102435253188986,0.2010247151614553,131468.65051025327,1191.2671446983786,132659.91765495166,3215,4,871.5128205128206,37,2,22,34.845660037777535,0.6331644144144144,43.61293859649123,1025.548245614036,27.717520151730703,0
3247,4,0,0,39,0.0,0.0,1.0,39,800,600,200,0.75,10,6,4,339.3262838775659,0.3853744939271255,0.05620206004821382,0.2005109859276526,131665.51246537405,1135.5138119421458,132801.02627731618,3216,5,872.5128205128206,37,2,16,34.71465455840456,0.6351351351351351,43.42105263157895,1026.3157894736848,27.73826458036986,0
3248,4,1,0,40,0.025,0.0,1.0,40,1250,800,450,0.64,17,8,9,329.37001906346035,0.3903445512820513,0.0796436175605797,0.1960516896815279,131942.7747938372,691.5988498264287,132634.37364366362,3217,0,851.675,39,1,17,34.69120703639866,0.6343482905982905,43.151041666666686,1027.3958333333364,26.343482905982984,2
3249,4,0,0,40,0.0,0.0,1.0,40,1250,900,350,0.72,16,9,7,328.14634832354545,0.3903044871794872,0.07560790273556228,0.19629117926990275,132130.12695312515,671.6037326389046,132801.73068576405,3218,1,852.675,39,1,20,34.534363390746385,0.6362179487179487,42.96875000000001,1028.1250000000011,26.362179487179517,0
3250,4,0,0,40,0.0,0.0,1.0,40,800,500,300,0.625,11,5,6,331.20211156418503,0.3894364316239316,0.07483795827425554,0.19868102366857648,132237.24500868077,759.4509548611318,132996.6959635419,3219,2,853.675,39,1,21,34.34820403753968,0.6372863247863247,42.86458333333334,1028.5416666666686,26.372863247863297,0
3251,4,0,0,40,0.0,0.0,1.0,40,1000,800,200,0.8,12,8,4,331.037222843125,0.38916933760683764,0.0769846091535038,0.19886396671524975,132290.82031250015,758.6371527777934,133049.45746527793,3220,3,854.675,39,1,21,34.29863642500337,0.6378205128205128,42.81250000000001,1028.7500000000011,26.378205128205156,0
3252,4,0,0,40,0.0,0.0,1.0,40,650,200,450,0.3076923076923077,11,2,9,330.2352431420902,0.38966346153846154,0.07574906367041234,0.19880523869596053,132371.20361328137,742.7273220486265,133113.93093533,3221,4,855.675,39,1,21,34.23855737760233,0.6386217948717948,42.73437500000001,1029.062500000001,26.386217948717974,0
3253,4,1,1,40,0.024390243902439025,0.024390243902439025,0.975609756097561,41,1000,600,400,0.6,14,6,8,324.56981725486156,0.39397865853658537,0.07969705708258101,0.19682403635040105,132645.51487508227,410.5515298837212,133056.066404966,3222,0,835.780487804878,38,3,16,34.109235635760214,0.6430921052631577,42.46794871794872,1030.1282051282058,27.108636977058048,0
3254,4,0,0,40,0.0,0.0,1.0,40,1500,1200,300,0.8,18,12,6,327.07728207678707,0.3898237179487179,0.07744765854151936,0.19802897047723178,132585.6784396702,673.1526692708433,133258.83110894106,3223,6,857.675,39,1,22,34.10465341694481,0.6407585470085471,42.52604166666667,1029.895833333334,26.407585470085486,0
3255,4,1,1,40,0.024390243902439025,0.024390243902439025,0.975609756097561,41,1150,800,350,0.6956521739130435,15,8,7,320.222455483257,0.39428353658536586,0.07951657156323111,0.19507605801601663,132816.6943969364,306.1776017912681,133122.87199872767,3224,0,837.7317073170732,40,1,17,34.0497551677676,0.64140625,42.301829268292686,1030.7926829268297,25.769817073170742,0
3256,4,0,0,40,0.0,0.0,1.0,40,1150,800,350,0.6956521739130435,15,8,7,328.53233858482275,0.39063835470085473,0.07111964430072781,0.20019433636917552,132827.1701388891,727.604166666691,133554.7743055558,3225,8,859.675,39,1,19,33.82511452438696,0.6431623931623931,42.29166666666668,1030.833333333335,26.431623931623978,0
3257,4,0,0,40,0.0,0.0,1.0,40,1250,1200,50,0.96,13,12,1,325.01942955081574,0.3903311965811966,0.06213261286738714,0.1987657425560612,132961.42713758696,643.0094401041858,133604.43657769114,3226,9,860.675,39,1,20,33.781204760461904,0.6444978632478632,42.16145833333334,1031.354166666668,26.44497863247867,0
3258,4,0,0,40,0.0,0.0,1.0,40,1250,1000,250,0.8,15,10,5,325.1732654185155,0.3901308760683761,0.0621618893823177,0.1998645604073608,133149.50086805577,659.331597222246,133808.832465278,3227,10,861.675,39,1,21,33.58901897456602,0.6463675213675213,41.97916666666668,1032.083333333335,26.46367521367526,0
3259,4,0,0,40,0.0,0.0,1.0,40,1100,800,300,0.7272727272727273,14,8,6,325.3098615679154,0.38967681623931627,0.06220742534301871,0.20052682511574493,133257.03125,669.965277777777,133926.99652777778,3228,11,862.675,39,1,21,33.47793919827817,0.6474358974358975,41.875,1032.5,26.474358974358974,0
3260,4,0,0,40,0.0,0.0,1.0,40,950,600,350,0.631578947368421,13,6,7,326.7279695113155,0.3886084401709402,0.0706442831215972,0.2022776530345338,133418.40820312526,718.3051215278074,134136.71332465307,3229,12,863.675,39,1,22,33.279979162465565,0.6490384615384615,41.718750000000014,1033.125000000002,26.490384615384666,0
3261,4,0,0,40,0.0,0.0,1.0,40,650,500,150,0.7692307692307693,8,5,3,329.05782341108994,0.38826121794871793,0.07410058926909979,0.2041678207732825,133499.82336410627,785.8431110860051,134285.66647519227,3230,13,864.675,38,2,23,33.13841793307832,0.6515899122807017,41.63995726495727,1033.4401709401714,27.195793972109772,0
3262,4,0,0,40,0.0,0.0,1.0,40,1250,900,350,0.72,16,9,7,326.2678084862994,0.38868856837606836,0.07030329647618072,0.20304138795639345,133610.2564673278,718.545113777488,134328.80158110528,3231,14,865.675,38,2,23,33.10017739657608,0.6526864035087719,41.53311965811966,1033.8675213675215,27.207040035987408,0
3263,4,0,0,40,0.0,0.0,1.0,40,1050,700,350,0.6666666666666666,14,7,7,322.79002458848447,0.3888221153846154,0.0676084710743805,0.20132779884127125,133693.11125721384,630.9605340054102,134324.07179121923,3232,15,866.675,38,2,23,33.10735192837466,0.6535087719298245,41.452991452991455,1034.1880341880344,27.21547458389564,0
3264,4,1,1,40,0.024390243902439025,0.024390243902439025,0.975609756097561,41,1300,900,400,0.6923076923076923,17,9,8,322.90240546649136,0.3904471544715447,0.07361722380048219,0.20344079310189228,134064.89257812512,457.97526041668027,134522.8678385418,3233,0,846.5121951219512,39,2,18,32.73360490846912,0.6554487179487178,41.09375000000001,1035.625000000001,26.554487179487204,0
3265,4,0,0,40,0.0,0.0,1.0,40,1100,800,300,0.7272727272727273,14,8,6,330.68850491219837,0.3877938034188034,0.08007687545144959,0.20796251142791147,133997.1318782417,862.2622406676885,134859.39411890937,3234,17,868.675,38,2,19,32.59961992226462,0.6565241228070176,41.159188034188034,1035.3632478632483,27.246401259559164,0
3266,4,1,0,41,0.024390243902439025,0.0,1.0,41,1350,900,450,0.6666666666666666,18,9,9,324.86481736127627,0.39016768292682924,0.09011057956238733,0.20618971061093253,134334.72222222228,528.1250000000053,134862.84722222228,3235,0,848.4634146341464,39,2,20,32.41392015005359,0.6581196581196581,40.833333333333336,1036.666666666667,26.58119658119659,0
3267,4,0,1,40,0.0,0.024390243902439025,0.975609756097561,41,1300,900,400,0.6923076923076923,17,9,8,323.6462270222655,0.3902947154471545,0.03957719527382042,0.19540445135254067,132480.48159105846,396.54215976330516,132877.02375082177,3236,1,849.4634146341464,38,3,21,34.298464092984624,0.6414473684210527,42.628205128205124,1029.487179487179,27.09176788124155,6
3268,4,2,2,40,0.047619047619047616,0.047619047619047616,0.9523809523809523,42,650,300,350,0.46153846153846156,10,3,7,316.0258718556422,0.39364353464963225,0.0441798674387377,0.1921600461135749,132746.64849175327,-9.724934895853494,132736.92355685742,3237,0,830.1666666666666,39,3,18,34.228010546177444,0.6423611111111112,42.36979166666666,1030.5208333333317,26.423611111111068,0
3269,4,1,1,40,0.024390243902439025,0.024390243902439025,0.975609756097561,41,850,700,150,0.8235294117647058,10,7,3,323.2609821142649,0.390625,0.05157314796545687,0.1960303389651407,132645.51487508192,375.82388231424665,133021.33875739618,3238,0,851.390243902439,38,3,18,34.14294233561504,0.643092105263158,42.46794871794871,1030.128205128203,27.108636977057973,0
3270,4,0,0,40,0.0,0.0,1.0,40,850,500,350,0.5882352941176471,12,5,7,327.85215060953976,0.3863648504273504,0.053410179959535675,0.19825238547161533,132539.10007165655,690.6457996691144,133229.74587132566,3239,22,873.675,37,3,22,34.13141571717602,0.6438626126126126,42.571271929824555,1029.714912280701,27.83013276434327,0
3271,4,0,0,40,0.0,0.0,1.0,40,950,600,350,0.631578947368421,13,6,7,329.7612630043166,0.38653846153846155,0.05361400894187773,0.19985660030080976,132623.7941001078,746.8379693751986,133370.632069483,3240,23,874.675,37,3,22,33.99732098502589,0.6447072072072071,42.4890350877193,1030.0438596491233,27.839023233760088,0
3272,4,2,1,41,0.047619047619047616,0.023809523809523808,0.9761904761904762,42,1150,800,350,0.6956521739130435,15,8,7,315.7201277999011,0.39413956639566394,0.05549147394121179,0.19405428202490232,133149.50086805577,7.595486111136381,133157.0963541669,3241,0,833.9761904761905,39,3,19,33.832929619162975,0.6463675213675213,41.97916666666668,1032.083333333335,26.46367521367526,0
3273,4,0,0,41,0.0,0.0,1.0,41,1150,1100,50,0.9565217391304348,12,11,1,323.23321811382965,0.3890497967479675,0.0497806469211004,0.1981881388777941,133058.54752218956,401.78850262986566,133460.33602481944,3242,1,855.3170731707318,38,3,20,33.7300662731697,0.647203947368421,42.0673076923077,1031.7307692307709,27.150809716599234,0
3274,4,0,1,40,0.0,0.024390243902439025,0.975609756097561,41,950,700,250,0.7368421052631579,12,7,5,324.7356665803218,0.388744918699187,0.049437021961067584,0.19940380187535467,133113.66705246916,445.3510802469217,133559.01813271607,3243,2,856.3170731707318,38,3,20,33.63615971287573,0.6477521929824561,42.01388888888889,1031.9444444444448,27.15643274853802,0
3275,4,0,0,40,0.0,0.0,1.0,40,750,500,250,0.6666666666666666,10,5,5,330.3396987234094,0.38838141025641026,0.03855328870470731,0.20279366632002652,133104.23790252782,793.9227695060138,133898.16067203385,3244,3,817.7,37,3,20,33.501022739347576,0.6494932432432432,42.02302631578948,1031.907894736843,27.889402560455217,0
3276,4,0,0,40,0.0,0.0,1.0,40,1150,900,250,0.782608695652174,14,9,5,330.39345860369804,0.38838141025641026,0.04162063104217584,0.20313478940800853,133160.81781173052,799.0926294629137,133959.91044119344,3245,4,818.7,37,3,20,33.442999929175976,0.6500563063063063,41.968201754385966,1032.127192982456,27.89532954006638,0
3277,4,0,0,40,0.0,0.0,1.0,40,700,600,100,0.8571428571428571,8,6,2,329.43077059673203,0.3880475427350427,0.045815632965165776,0.2030052444986143,133245.71021852872,779.0473991997478,134024.75761772846,3246,5,819.7,37,3,21,33.38289436420278,0.6509009009009008,41.8859649122807,1032.4561403508767,27.904220009483154,0
3278,4,0,0,40,0.0,0.0,1.0,40,600,300,300,0.5,9,3,6,328.98776369457477,0.3877403846153846,0.045343543046357127,0.20276388701175832,133251.51581561842,767.6236394185127,134019.13945503693,3247,6,820.7,38,2,21,33.38852097130242,0.6491228070175439,41.88034188034188,1032.4786324786328,27.170490328385075,0
3279,4,0,0,40,0.0,0.0,1.0,40,1400,1100,300,0.7857142857142857,17,11,6,331.00038937228425,0.3877003205128205,0.046841919548341604,0.20507138427131108,133445.31385633696,834.0901692708532,134279.4040256078,3248,7,821.7,39,1,21,33.14272692139666,0.6493055555555554,41.69270833333334,1033.229166666668,26.493055555555593,0
3280,4,0,0,40,0.0,0.0,1.0,40,1250,900,350,0.72,16,9,7,331.5064945924203,0.38735309829059833,0.04616343196521355,0.20632176485227244,133613.8899108378,858.7798799870886,134472.6697908249,3249,8,822.7,37,3,21,32.96114381164492,0.6545608108108109,41.52960526315788,1033.8815789473672,27.94274537695587,0
3281,4,0,1,39,0.0,0.025,0.975,40,800,500,300,0.625,11,5,6,331.5064945924203,0.38735309829059833,0.04616343196521355,0.20632176485227244,133613.8899108378,858.7744546398665,134472.66436547769,3250,9,823.7,37,3,21,32.96114381164492,0.6545608108108109,41.52960526315788,1033.8815789473672,27.94274537695587,0
3282,4,0,0,39,0.0,0.0,1.0,39,500,300,200,0.6,7,3,4,338.2089509732723,0.3871176338281601,0.056974470699960866,0.21034946950776687,133588.61395178956,1236.172997321636,134824.7869491112,3251,10,841.2307692307693,36,3,21,32.813180827886704,0.65625,41.55405405405405,1033.7837837837833,28.716216216216203,0
3283,4,0,0,39,0.0,0.0,1.0,39,1200,900,300,0.75,15,9,6,338.16458584008103,0.38725820962663066,0.05454931331646695,0.21065313617256573,133646.8288389739,1238.924904634344,134885.75374360822,3252,11,842.2307692307693,36,3,21,32.75611704058666,0.6568287037037038,41.49774774774774,1034.0090090090073,28.722472472472425,0
3284,4,0,0,39,0.0,0.0,1.0,39,1000,700,300,0.7,13,7,6,348.6811993180539,0.38703328834907785,0.03661168770610157,0.21737538719196806,133675.94103816658,1536.7174184319488,135212.65845659852,3253,12,843.2307692307693,36,3,21,32.45512541290064,0.6571180555555556,41.4695945945946,1034.121621621622,28.725600600600607,6
3285,4,0,0,39,0.0,0.0,1.0,39,850,700,150,0.8235294117647058,10,7,3,350.5664853521116,0.38703328834907785,0.014820946412029912,0.20610774577802943,131472.44953991132,1417.9669111678984,132890.41645107922,3254,13,844.2307692307693,36,3,21,34.62103327111012,0.6351273148148149,43.60923423423422,1025.5630630630615,28.48786286286282,4
3286,4,0,0,39,0.0,0.0,1.0,39,800,500,300,0.625,11,5,6,350.3398516244316,0.38725820962663066,0.016082636719299437,0.20644217647468105,131559.08230865982,1418.0778751724436,132977.16018383228,3255,14,845.2307692307693,36,3,15,34.539425539699955,0.6359953703703705,43.52477477477476,1025.9009009008994,28.497247247247206,0
3287,4,1,1,39,0.025,0.025,0.975,40,700,300,400,0.42857142857142855,11,3,8,343.277007211334,0.389730235042735,0.030553822152885823,0.20411925939004144,131903.67408366175,1055.8996959236997,132959.57377958545,3256,0,825.075,38,2,17,34.37337493499739,0.6356907894736844,43.18910256410255,1027.2435897435873,27.032726045883877,0
3288,4,0,0,39,0.0,0.0,1.0,39,1150,800,350,0.6956521739130435,15,8,7,357.5978918475371,0.38714574898785425,0.06727462073235957,0.2107190682232254,131559.0823086601,1610.8992098207327,133169.9815184808,3257,1,846.8461538461538,36,3,18,34.353274789608484,0.6359953703703705,43.52477477477478,1025.9009009009014,28.497247247247262,1
3289,4,0,0,39,0.0,0.0,1.0,39,900,600,300,0.6666666666666666,12,6,6,357.5978918475371,0.38714574898785425,0.06727462073235957,0.2107190682232254,131559.0823086601,1609.0500973946973,133168.1324060548,3258,2,847.8461538461538,36,3,18,34.353274789608484,0.6359953703703705,43.52477477477478,1025.9009009009014,28.497247247247262,0
3290,4,0,0,39,0.0,0.0,1.0,39,1100,1100,0,1.0,11,11,0,353.75550972156776,0.38762370670265406,0.06682871659830192,0.20908740049302021,131674.63705259326,1516.1256695885218,133190.76272218177,3259,3,848.8461538461538,36,3,18,34.33522602589422,0.6371527777777777,43.41216216216217,1026.3513513513524,28.50975975975979,0
3291,4,0,0,39,0.0,0.0,1.0,39,1150,600,550,0.5217391304347826,17,6,11,355.0427840849143,0.38790485829959515,0.06555081242512739,0.21048635274943103,131790.24252292837,1558.2349241133113,133348.4774470417,3260,4,849.8461538461538,36,3,18,34.185585289171605,0.6383101851851851,43.29954954954955,1026.8018018018022,28.522272272272282,0
3292,4,0,0,39,0.0,0.0,1.0,39,1300,1100,200,0.8461538461538461,15,11,4,351.9262877426909,0.38787674313990106,0.06696343259254256,0.20959369773918501,131963.74584043512,1488.3022380488674,133452.048078484,3261,5,850.8461538461538,36,3,19,34.09072227093379,0.6400462962962963,43.130630630630634,1027.4774774774783,28.541041041041062,0
3293,4,0,0,39,0.0,0.0,1.0,39,850,600,250,0.7058823529411765,11,6,5,351.9262877426909,0.38787674313990106,0.06696343259254256,0.20959369773918501,131963.74584043512,1488.3022380488674,133452.048078484,3262,6,851.8461538461538,36,3,19,34.09072227093379,0.6400462962962963,43.130630630630634,1027.4774774774783,28.541041041041062,0
3294,4,1,1,39,0.025,0.025,0.975,40,700,500,200,0.7142857142857143,9,5,4,341.37415269070414,0.39269497863247865,0.06594882729211071,0.20473718364698235,132228.78674207444,1027.8980070790947,133256.68474915353,3263,0,831.525,37,3,19,34.09514925373133,0.6407657657657657,42.872807017543856,1028.5087719298242,27.797534376481735,0
3295,4,1,1,39,0.025,0.025,0.975,40,1000,800,200,0.8,12,8,4,341.8808310603234,0.39221420940170937,0.06712489343563499,0.20565446914551774,132341.58587257622,1049.0102723915068,133390.59614496774,3264,0,832.5,37,3,19,33.968723358908775,0.6418918918918919,42.76315789473684,1028.947368421053,27.809388335704135,0
3296,4,1,2,38,0.025,0.05,0.95,40,800,500,300,0.625,11,5,6,343.3143731628788,0.39035790598290593,0.07306647491211304,0.20698086197045226,132426.21678064394,1092.7647208756478,133518.9815015196,3265,0,833.475,37,3,20,33.846787223465086,0.6427364864864864,42.680921052631575,1029.2763157894728,27.818278805120887,0
3297,4,0,0,38,0.0,0.0,1.0,38,750,500,250,0.6666666666666666,10,5,5,352.49435738392,0.3883653390232338,0.09225359008772882,0.2120303451887344,132340.06123944893,1729.824968549632,134069.88620799856,3266,1,871.0526315789474,36,2,20,33.69723833497502,0.6438078703703705,42.76463963963964,1028.9414414414416,28.58170670670671,0
3298,4,0,0,38,0.0,0.0,1.0,38,1150,900,250,0.782608695652174,14,9,5,351.58747070104425,0.3884690611664296,0.09407628382697664,0.2118100128369703,132398.00347222204,1709.9085149338296,134107.91198715588,3267,2,872.0526315789474,35,3,20,33.66228070175438,0.6464285714285715,42.70833333333332,1029.1666666666652,29.404761904761862,0
3299,4,0,0,38,0.0,0.0,1.0,38,850,500,350,0.5882352941176471,12,5,7,356.52255516153883,0.3886320531057373,0.09032573000798783,0.2152931519458173,132487.35592689048,1846.9461323302485,134334.30205922073,3268,3,873.0526315789474,35,3,20,33.44540472175379,0.6473214285714286,42.62152777777778,1029.5138888888891,29.41468253968255,0
3300,4,0,0,38,0.0,0.0,1.0,38,1250,1000,250,0.8,15,10,5,356.45610922439016,0.388809862494073,0.09445647159030401,0.2157650652978657,132576.73852237666,1851.5576774691485,134428.29619984582,3269,4,874.0526315789474,35,3,20,33.35721510451788,0.6482142857142856,42.53472222222223,1029.861111111112,29.4246031746032,0
3301,4,1,0,39,0.02564102564102564,0.0,1.0,39,550,300,250,0.5454545454545454,8,3,5,351.2208129844616,0.3916722896986055,0.09678892016412477,0.21421895688692524,132861.99787202754,1532.7797814706723,134394.77765349823,3270,0,852.6153846153846,36,3,16,33.20544329146186,0.6490162037037037,42.25788288288289,1030.9684684684694,28.638013013013037,0
3302,4,0,0,39,0.0,0.0,1.0,39,1150,1100,50,0.9565217391304348,12,11,1,363.67369541481776,0.3912505623031939,0.11796550895568658,0.21317391927789764,131357.78523930436,1782.8870970687183,133140.67233637307,3271,1,853.6153846153846,35,4,22,34.40087407323774,0.6360119047619048,43.721064814814795,1025.115740740738,29.289021164021083,4
3303,4,1,0,40,0.025,0.0,1.0,40,600,400,200,0.6666666666666666,8,4,4,358.20672022882513,0.39388354700854705,0.130868802106187,0.21203977023415355,131732.43344696023,1437.4885865595056,133169.92203351975,3272,0,833.25,36,4,19,34.16269014187509,0.6377314814814816,43.35585585585584,1026.5765765765748,28.516016016015968,0
3304,4,2,2,40,0.047619047619047616,0.047619047619047616,0.9523809523809523,42,850,700,150,0.8235294117647058,10,7,3,343.58514795687444,0.40346738288811457,0.12729772760167912,0.20552638850511182,132130.1269531247,679.5898437499698,132809.71679687468,3273,0,794.5238095238095,39,3,19,34.137537993920965,0.6362179487179489,42.968749999999986,1028.1249999999977,26.36217948717943,0
3305,4,0,0,40,0.0,0.0,1.0,40,1050,700,350,0.6666666666666666,14,7,7,354.6733094243939,0.39424412393162395,0.13005617977528194,0.21043949692513964,131821.37573964449,1350.704717291206,133172.08045693568,3274,2,835.25,38,2,19,34.16367561381607,0.6348684210526319,43.269230769230745,1026.923076923073,27.024291497975607,0
3306,4,0,1,39,0.0,0.025,0.975,40,1000,800,200,0.8,12,8,4,355.96902945911086,0.3942174145299145,0.13298314957353896,0.2115133652175455,131876.2384487542,1388.7713218642418,133265.00977061843,3275,3,836.25,38,2,20,34.07509014631439,0.6354166666666669,43.21581196581195,1027.13675213675,27.02991452991447,0
3307,4,0,0,39,0.0,0.0,1.0,39,1100,800,300,0.7272727272727273,14,8,6,362.16427873917416,0.3908569500674764,0.1345229586178005,0.21448097038803787,131749.9269606991,1743.0234543320598,133492.95041503114,3276,4,858.5641025641025,37,2,20,34.04346452347894,0.6359797297297298,43.338815789473664,1026.6447368421022,27.747155049786546,0
3308,4,0,0,39,0.0,0.0,1.0,39,900,500,400,0.5555555555555556,13,5,8,364.0051238257903,0.39119433198380565,0.13724846175742855,0.21637055837563435,131890.67790089233,1801.776508156324,133692.45440904866,3277,5,859.5641025641025,37,2,20,33.85416666666665,0.6373873873873874,43.2017543859649,1027.1929824561382,27.761972498814547,0
3309,4,0,0,39,0.0,0.0,1.0,39,1000,800,200,0.8,12,8,4,373.0503002946881,0.39133490778227625,0.13634370762668802,0.214340091210305,130587.70743580669,1946.0782667666663,132533.78570257337,3278,6,860.5641025641025,35,4,16,34.94095138338429,0.6282738095238095,44.473379629629626,1022.106481481481,29.20304232804231,8
3310,4,0,0,39,0.0,0.0,1.0,39,1200,900,300,0.75,15,9,6,354.40741736092485,0.39133490778227625,0.11265237494745728,0.1965350223546944,129201.38888888866,1357.986111111087,130559.37499999974,3279,7,861.5641025641025,37,2,18,36.82547814207651,0.6103603603603605,45.83333333333332,1016.6666666666648,27.47747747747743,5
3311,4,1,1,39,0.025,0.025,0.975,40,350,0,350,0.0,7,0,7,345.8564848536125,0.39606036324786326,0.10726399243935769,0.19272038064721747,129391.54071015022,950.1806879611111,130341.72139811133,3280,0,841.0,38,2,18,36.849382197486804,0.6104714912280702,45.64636752136751,1017.4145299145277,26.7740665766981,0
3312,4,0,0,39,0.0,0.0,1.0,39,800,600,200,0.75,10,6,4,352.7110689795294,0.39184098065677014,0.11319870380696173,0.19599863780596238,129282.86540516082,1319.899531558162,130602.76493671897,3281,9,863.5641025641025,38,1,18,36.78563924782015,0.6093750000000002,45.75320512820512,1016.9871794871774,26.762820512820458,0
3313,4,0,0,39,0.0,0.0,1.0,39,500,400,100,0.8,6,4,2,353.35913777275636,0.39181286549707606,0.10994936436112934,0.19649409997643902,129310.02995105536,1338.5761377748286,130648.60608883019,3282,10,864.5641025641025,38,1,18,36.74150910364144,0.6096491228070177,45.72649572649571,1017.0940170940153,26.765632028789877,0
3314,4,2,1,40,0.04878048780487805,0.024390243902439025,0.975609756097561,41,850,600,250,0.7058823529411765,11,6,5,337.9943815871605,0.4011432926829268,0.12027299172074324,0.19041616059303604,129822.0511930727,575.8247818758438,130397.87597494853,3283,0,823.3414634146342,40,1,15,36.61227729025394,0.6114583333333334,45.223577235772346,1019.1056910569089,25.47764227642272,0
3315,4,0,0,40,0.0,0.0,1.0,40,950,600,350,0.631578947368421,13,6,7,349.793072311848,0.39565972222222223,0.12224465801042883,0.19674100289144214,129757.97661675309,1077.6882595485722,130835.66487630166,3284,1,844.925,39,1,16,36.37675510343183,0.6124465811965814,45.286458333333314,1018.8541666666636,26.12446581196573,0
3316,4,1,0,41,0.024390243902439025,0.0,1.0,41,1250,700,550,0.56,18,7,11,351.66838215959876,0.3961890243902439,0.15041702896614773,0.199969076650435,130184.7910056841,956.3749669508579,131141.16597263498,3285,0,825.2926829268292,40,1,17,35.895696408417976,0.6151041666666668,44.867886178861774,1020.5284552845501,25.513211382113752,0
3317,4,1,1,41,0.023809523809523808,0.023809523809523808,0.9761904761904762,42,1000,600,400,0.6,14,6,8,344.64082931679604,0.400104045683314,0.14639044398344203,0.19754953808158843,130496.11363110553,594.8810025447516,131090.9946336503,3286,0,806.6190476190476,40,2,15,35.75960645845765,0.6182291666666668,44.563008130081286,1021.7479674796725,25.543699186991812,0
3318,4,0,0,41,0.0,0.0,1.0,41,800,600,200,0.75,10,6,4,351.18625420450263,0.39646849593495936,0.14942568760788588,0.20091787682201565,130422.14084201369,960.4926215277583,131382.63346354145,3287,2,827.2926829268292,39,2,18,35.667363518933996,0.6191239316239316,44.63541666666666,1021.4583333333317,26.191239316239272,0
3319,4,1,0,42,0.023809523809523808,0.0,1.0,42,1150,1000,150,0.8695652173913043,13,10,3,345.4834043209554,0.40015243902439024,0.15269557905630515,0.19904401611716496,130693.35322381239,630.4769187767425,131323.83014258914,3288,0,808.5714285714286,41,1,16,35.53844878884901,0.61864837398374,44.37003968253967,1022.5198412698389,24.939508323654607,0
3320,4,0,0,42,0.0,0.0,1.0,42,1050,600,450,0.5714285714285714,15,6,9,344.836736142366,0.4006847657762292,0.15832444142658542,0.19893239579695846,130744.07837498408,617.0722513542269,131361.1506263383,3289,1,809.5714285714286,41,1,16,35.50366589064572,0.6191565040650406,44.3204365079365,1022.7182539682526,24.944347657762258,0
3321,4,1,1,42,0.023255813953488372,0.023255813953488372,0.9767441860465116,43,900,800,100,0.8888888888888888,10,8,2,340.23537462502975,0.4028931339977852,0.16279069767441867,0.19748607129334111,130980.7290727718,312.8554849467913,131293.5845577186,3290,0,791.7209302325581,42,1,16,35.38215480247379,0.6200396825396827,44.08914728682169,1023.6434108527111,24.37246216315979,0
3322,4,0,0,42,0.0,0.0,1.0,42,900,600,300,0.6666666666666666,12,6,6,345.8407972472656,0.3992813588850174,0.16705433869612984,0.2006965886387675,130972.46334876542,659.1242283950603,131631.58757716048,3291,3,811.5714285714286,41,1,16,35.247060153776566,0.6214430894308943,44.09722222222222,1023.6111111111111,24.96612466124661,0
3323,4,0,0,42,0.0,0.0,1.0,42,1400,1100,300,0.7857142857142857,17,11,6,345.99764133186085,0.39894260549748356,0.16356769320162723,0.2018515053329263,131175.639526644,677.2923752834494,131852.93190192746,3292,4,812.5714285714286,41,1,17,35.03776873910517,0.6234756097560975,43.898809523809526,1024.404761904762,24.98548199767712,0
3324,4,0,1,41,0.0,0.023809523809523808,0.9761904761904762,42,1000,700,300,0.7,13,7,6,346.53576435117157,0.39977739063104917,0.15853579840609155,0.20283631623297188,131302.7046032534,700.2166202129025,132002.9212234663,3293,5,813.5714285714286,41,1,17,34.89568208950408,0.6247459349593496,43.77480158730159,1024.900793650794,24.997580332946193,0
3325,4,1,0,42,0.023809523809523808,0.0,1.0,42,950,600,350,0.631578947368421,13,6,7,344.63821679191915,0.4024874177313202,0.15691659596004714,0.20229314780134852,131410.2692513149,657.8075540086196,132068.0768053235,3294,0,813.8809523809524,38,4,18,34.83575596540586,0.6307565789473684,43.669871794871796,1025.3205128205127,26.982118758434545,0
3326,4,1,1,42,0.023255813953488372,0.023255813953488372,0.9767441860465116,43,1200,900,300,0.75,15,9,6,334.7135661143213,0.4042543373938723,0.1523245451426225,0.19779241101161693,131666.88484243845,214.1385129552551,131881.0233553937,3295,0,795.9302325581396,40,3,14,34.83162524342343,0.6299479166666666,43.41971544715447,1026.3211382113827,25.65802845528457,0
3327,4,0,1,41,0.0,0.023809523809523808,0.9761904761904762,42,1150,800,350,0.6956521739130435,15,8,7,340.11698317400595,0.4022333526906698,0.1620256224317138,0.20060792121341073,131595.18771701393,551.5516493055597,132146.7393663195,3296,2,815.8809523809524,39,3,14,34.765228426395936,0.6308760683760684,43.489583333333336,1026.041666666667,26.308760683760692,0
3328,4,1,0,42,0.023809523809523808,0.0,1.0,42,950,600,350,0.631578947368421,13,6,7,341.6126941200575,0.39805942702284164,0.1730848230898978,0.20191420966796178,131675.35942925338,596.3948567708235,132271.7542860242,3297,0,816.8095238095239,39,3,15,34.646068033424676,0.6316773504273505,43.41145833333333,1026.3541666666658,26.31677350427348,0
3329,4,0,1,41,0.0,0.023809523809523808,0.9761904761904762,42,1450,1100,350,0.7586206896551724,18,11,7,341.618356792252,0.39787795199380566,0.16415531729933353,0.2029130721669639,131862.52170138873,609.3315972222028,132471.85329861092,3298,1,817.8095238095239,39,3,18,34.45740365111561,0.6335470085470087,43.22916666666666,1027.083333333332,26.33547008547005,0
3330,4,1,2,40,0.023809523809523808,0.047619047619047616,0.9523809523809523,42,800,600,200,0.75,10,6,4,342.8543789694925,0.4018583042973287,0.1675932762889285,0.20465481895293305,132049.81689453128,654.7715928819456,132704.58848741322,3299,0,812.7380952380952,39,3,18,34.23712459038546,0.6354166666666666,43.046875,1027.8125000000002,26.35416666666667,0
3331,4,0,0,40,0.0,0.0,1.0,40,950,600,350,0.631578947368421,13,6,7,355.9213841515346,0.3946714743589744,0.162337177023276,0.21125219796978895,131834.36850761753,1384.5341835949314,133218.90269121245,3300,3,853.3,37,3,18,34.11853156808314,0.6368243243243243,43.25657894736841,1026.9736842105249,27.756045519203376,0
3332,4,0,0,40,0.0,0.0,1.0,40,1350,1100,250,0.8148148148148148,16,11,5,358.23087147723874,0.39413728632478634,0.16998399146211285,0.21325433708651398,131946.9993170977,1453.497710834119,133400.49702793182,3301,4,854.3,37,3,18,33.945659907506226,0.6379504504504503,43.14692982456141,1027.4122807017557,27.76789947842583,0
3333,4,0,0,40,0.0,0.0,1.0,40,1100,800,300,0.7272727272727273,14,8,6,355.51637860962575,0.3943376068376068,0.18031086701503707,0.2127426344749497,132144.2189543899,1395.8868353724388,133540.1057897623,3302,5,855.3,37,3,19,33.81667466496038,0.6399211711711711,42.95504385964913,1028.1798245614043,27.78864390706498,0
3334,4,0,0,40,0.0,0.0,1.0,40,1300,1100,200,0.8461538461538461,15,11,4,346.25009298763587,0.3943376068376068,0.14566545948392928,0.19970403535500986,130735.62349965703,1066.7236850417387,131802.34718469877,3303,6,856.3,35,5,18,35.476082692017506,0.6297619047619047,44.3287037037037,1022.6851851851849,29.21957671957671,5
3335,4,0,0,40,0.0,0.0,1.0,40,1200,900,300,0.75,15,9,6,346.23217922606915,0.3943108974358975,0.14506109979633397,0.19999999999999987,130794.81336805549,1057.0746527777676,131851.88802083326,3304,7,857.3,35,5,20,35.41666666666666,0.6303571428571428,44.27083333333333,1022.9166666666661,29.22619047619046,0
3336,4,0,0,40,0.0,0.0,1.0,40,1050,600,450,0.5714285714285714,15,6,9,343.03853510308073,0.3936298076923077,0.1516934298315047,0.19891736169944546,130942.8466461977,983.6884591477996,131926.53510534548,3305,8,858.3,35,5,20,35.34869859399147,0.6318452380952382,44.126157407407405,1023.4953703703702,29.242724867724863,0
3337,4,0,0,40,0.0,0.0,1.0,40,650,300,350,0.46153846153846156,10,3,7,343.7946332065103,0.39326923076923076,0.15302396563418497,0.19981651283474297,131031.7068008401,1009.5995156035576,132041.30631644366,3306,9,859.3,35,5,20,35.23956213731255,0.6327380952380952,44.03935185185185,1023.8425925925918,29.252645502645482,0
3338,4,0,0,40,0.0,0.0,1.0,40,550,200,350,0.36363636363636365,9,2,7,344.79558922574876,0.39290865384615387,0.14662391230647542,0.20086215727838377,131120.59709630048,1041.9607070901802,132162.55780339066,3307,10,860.3,35,5,20,35.124143029344175,0.6336309523809525,43.95254629629629,1024.189814814814,29.262566137566118,0
3339,4,1,1,40,0.024390243902439025,0.024390243902439025,0.975609756097561,41,900,500,400,0.5555555555555556,13,5,8,337.63400729978696,0.3946900406504065,0.13582764191917418,0.19790614091757636,131356.983567182,670.1169497199846,132027.100516902,3308,0,840.2926829268292,36,5,20,35.06902486359807,0.6339699074074074,43.721846846846844,1025.1126126126123,28.475350350350343,0
3340,4,0,0,40,0.0,0.0,1.0,40,1200,800,400,0.6666666666666666,16,8,8,357.11968275495343,0.39256143162393164,0.1394492648831045,0.19835201656630533,129263.69214965389,1253.5256473039822,130517.21779695786,3309,12,862.3,33,7,22,36.693078653490815,0.6193181818181819,45.772058823529406,1016.9117647058815,30.81550802139035,4
3341,4,2,1,41,0.047619047619047616,0.023809523809523808,0.9761904761904762,42,600,400,200,0.6666666666666666,8,4,4,348.7864998610324,0.4021244676732481,0.198012294747828,0.19015049939530196,128525.67361379018,581.9588559503079,129107.63246974048,3310,0,822.1904761904761,35,7,17,37.657064452307594,0.6074404761904761,46.49884259259259,1014.0046296296287,28.97156084656082,3
3342,4,2,1,42,0.046511627906976744,0.023255813953488372,0.9767441860465116,43,1100,600,500,0.5454545454545454,16,6,10,340.9139445678352,0.4073689553340716,0.19815418584015987,0.1874195197697319,128858.14868922983,185.9079518707952,129044.05664110063,3311,0,804.0232558139535,36,7,18,37.51779244306418,0.6087962962962963,46.171171171171174,1015.3153153153158,28.203203203203216,0
3343,4,1,0,43,0.023255813953488372,0.0,1.0,43,1450,1300,150,0.896551724137931,16,13,3,372.976256303571,0.4056155407899594,0.2485310119695323,0.19541914455130066,126926.22369382871,868.0935480147577,127794.31724184347,3312,0,805.0,37,6,17,38.685165034457754,0.5872747747747749,48.081140350877185,1007.6754385964899,27.234471313418645,5
3344,4,2,2,43,0.044444444444444446,0.044444444444444446,0.9555555555555556,45,1000,600,400,0.6,14,6,8,365.1397598044426,0.41323653198653204,0.26529209621993144,0.19460745440126873,127617.73003472216,319.8778710757053,127937.60790579786,3313,0,770.1777777777778,37,8,15,38.17225085910652,0.5943130630630631,47.39583333333333,1010.4166666666661,27.30855855855854,0
3345,4,1,0,44,0.022727272727272728,0.0,1.0,44,1000,700,300,0.7,13,7,6,376.91013792631287,0.4076594432699084,0.2812962487913644,0.20074277519381797,127590.03371229625,817.9954409049102,128408.02915320116,3314,0,788.5909090909091,37,7,16,37.903371680775635,0.5940315315315314,47.423245614035096,1010.307017543861,27.305595068753,0
3346,4,5,4,45,0.10204081632653061,0.08163265306122448,0.9183673469387755,49,1300,900,400,0.6923076923076923,17,9,8,343.3963568198767,0.4258786848072562,0.2738697944509083,0.18728087023201676,128540.34423828125,-968.3359378005739,127572.00830048068,3315,0,709.0204081632653,39,10,14,37.7787407978086,0.6001602564102564,46.484375,1014.0625,26.001602564102566,0
3347,4,1,0,46,0.021739130434782608,0.0,1.0,46,1250,900,350,0.72,16,9,7,366.68216356619934,0.4148148148148148,0.2931157809267886,0.19871522550852594,128287.09621783948,208.11799975651715,128495.214217596,3316,0,756.2391304347826,36,10,19,37.44743033941011,0.6030092592592593,46.734234234234236,1013.0630630630633,28.140640640640648,0
3348,4,4,4,46,0.08,0.08,0.92,50,1300,1000,300,0.7692307692307693,16,10,6,339.36725827547303,0.42486394557823126,0.2774402030655083,0.18759518761552454,129075.34490937582,-1239.21081742882,127836.13409194701,3317,0,696.66,41,9,16,37.33596521201472,0.6023882113821137,45.95734126984127,1016.1706349206352,24.784649632210613,0
3349,4,1,0,47,0.02127659574468085,0.0,1.0,47,950,600,350,0.631578947368421,13,6,7,356.73646007734555,0.4194996916435399,0.29677205269155693,0.19598385230630283,128830.99500868063,-208.25737847221197,128622.73763020842,3318,0,742.0851063829788,39,8,17,37.14387098980778,0.6030982905982906,46.19791666666667,1015.208333333334,26.030982905982924,0
3350,4,1,1,47,0.020833333333333332,0.020833333333333332,0.9791666666666666,48,950,600,350,0.631578947368421,13,6,7,357.3756913552972,0.42178265366430256,0.3147017326287791,0.19832105241996806,129229.25954380175,-361.7257533568246,128867.53379044493,3319,0,727.6041666666666,37,11,19,36.7216425824077,0.6106418918918919,45.80592105263157,1016.776315789472,27.480440967283027,0
3351,4,0,0,47,0.0,0.0,1.0,47,1250,900,350,0.72,16,9,7,363.141628594464,0.419345513413506,0.3147889780258113,0.2013785394932935,129201.3888888888,-16.319444444454973,129185.06944444435,3320,1,743.936170212766,36,11,19,36.60348360655738,0.6122685185185186,45.83333333333333,1016.666666666666,28.24074074074072,0
3352,4,1,0,48,0.020833333333333332,0.0,1.0,48,1200,800,400,0.6666666666666666,16,8,8,354.2501768246659,0.4211177600472813,0.2824463399006891,0.18625432490452976,127067.58838298461,-579.8957582176706,126487.69262476695,3321,0,729.4166666666666,42,6,19,39.01169309626782,0.5806051587301588,47.94089147286821,1008.2364341085256,24.005629383536323,6
3353,4,2,1,49,0.04,0.02,0.98,50,1450,1000,450,0.6896551724137931,19,10,9,343.30872332958717,0.42659013605442175,0.29057309471144155,0.1833806961458686,127707.59489225988,-1231.3643381494617,126476.23055411041,3322,0,701.2,40,10,18,38.631736376432734,0.5901041666666667,47.30691056910569,1010.7723577235771,25.269308943089428,0
3354,4,1,0,50,0.02,0.0,1.0,50,1300,800,500,0.6153846153846154,18,8,10,350.5015205378502,0.427406462585034,0.31929912641831515,0.18878554045627094,128041.65556423094,-1024.2410065106742,127017.41455772027,3323,0,702.18,40,10,19,38.10811828496837,0.5934895833333333,46.97662601626016,1012.0934959349593,25.302337398373982,0
3355,4,2,1,51,0.038461538461538464,0.019230769230769232,0.9807692307692307,52,1200,700,500,0.5833333333333334,17,7,10,332.5617384512978,0.431781045751634,0.2916165262735657,0.18062666970786173,128376.15258774544,-1842.2218917311093,126533.93069601433,3324,0,676.1346153846154,40,12,16,38.22076815082228,0.596875,46.646341463414636,1013.4146341463419,25.335365853658548,2
3356,4,2,1,52,0.03773584905660377,0.018867924528301886,0.9811320754716981,53,1500,1000,500,0.6666666666666666,20,10,10,328.2469462703807,0.432798137397194,0.29429313083568975,0.17961377846480406,128672.41753472234,-2152.734374999989,126519.68315972235,3325,0,664.3396226415094,41,12,17,38.028319644079396,0.5983231707317073,46.35416666666667,1014.5833333333343,24.745934959349615,0
3357,4,0,1,51,0.0,0.019230769230769232,0.9807692307692307,52,1450,900,550,0.6206896551724138,20,9,11,334.94787189490665,0.43048485419808946,0.30243318887685167,0.18293306849644878,128596.93877551006,-1785.3458049886704,126811.5929705214,3326,1,678.1153846153846,41,11,17,37.93525039123631,0.5975609756097562,46.42857142857142,1014.2857142857131,24.738675958188125,0
3358,4,1,0,52,0.019230769230769232,0.0,1.0,52,1300,900,400,0.6923076923076923,17,9,8,333.2192737558237,0.43119186777275015,0.3070307331448854,0.18291306915609354,128798.26467624068,-1816.3871567145566,126981.87751952613,3327,0,678.8653846153846,41,11,18,37.774058509252015,0.5995934959349594,46.23015873015872,1015.0793650793636,24.758033294618624,0
3359,4,0,0,52,0.0,0.0,1.0,52,1500,1200,300,0.8,18,12,6,335.95665123979904,0.43153751885369535,0.31366799167424353,0.1850020569522224,128924.17332963245,-1737.4132928634717,127186.76003676897,3328,1,679.8653846153846,41,11,20,37.576418058676026,0.6008638211382116,46.10615079365078,1015.5753968253943,24.770131629887665,0
3360,4,1,3,50,0.018867924528301886,0.05660377358490566,0.9433962264150944,53,1150,800,350,0.6956521739130435,15,8,7,332.01790921897276,0.4337506047411708,0.31635741686944674,0.18400422005368405,129176.76150959959,-2022.2003447809846,127154.5611648186,3329,0,668.0188679245283,42,11,20,37.41957392050329,0.601934523809524,45.85755813953487,1016.569767441859,24.204042081949023,0
3361,4,1,0,51,0.0196078431372549,0.0,1.0,51,1500,1000,500,0.6666666666666666,20,10,10,340.84873272577397,0.43251633986928106,0.3420234009673475,0.19029097821318888,129466.28146701358,-1374.3140588850947,128091.96740812849,3330,0,677.7843137254902,39,12,18,36.90080177413851,0.6095085470085472,45.57291666666665,1017.7083333333309,26.095085470085408,0
3362,4,1,0,52,0.019230769230769232,0.0,1.0,52,1350,900,450,0.6666666666666666,18,9,9,335.39949765035107,0.43410633484162897,0.34714923552562027,0.18882935221448954,129796.16057117081,-1693.2865894970355,128102.87398167378,3331,0,665.7307692307693,40,12,20,36.70464745187994,0.6111979166666668,45.24898373983738,1019.0040650406468,25.47510162601617,0
3363,4,0,0,52,0.0,0.0,1.0,52,1300,1000,300,0.7692307692307693,16,10,6,337.80890628215093,0.43410633484162897,0.3560625814863112,0.19056374184533006,129873.84018276141,-1625.4920186397158,128248.3481641217,3332,1,666.7307692307693,40,12,20,36.564473246925886,0.6119791666666667,45.17276422764227,1019.3089430894295,25.48272357723574,0
3364,4,0,0,52,0.0,0.0,1.0,52,1500,1100,400,0.7333333333333333,19,11,8,337.56149959326916,0.4339884992458522,0.36008576945529747,0.1908392240274815,129958.94451530583,-1626.1727607710025,128332.77175453483,3333,2,667.7307692307693,41,11,21,36.48448141661801,0.6112804878048781,45.0892857142857,1019.6428571428548,24.86933797909402,0
3365,4,1,1,52,0.018867924528301886,0.018867924528301886,0.9811320754716981,53,1300,900,400,0.6923076923076923,17,9,8,332.4420361854921,0.43626028059990324,0.35603470759880795,0.1892970263097421,130238.42047068694,-1940.6548618285174,128297.76560885842,3334,0,656.1132075471698,43,10,22,36.331930141942664,0.6111918604651163,44.81534090909091,1020.7386363636359,23.73810782241014,0
3366,4,0,0,52,0.0,0.0,1.0,52,1400,900,500,0.6428571428571429,19,9,10,339.15168830114584,0.43414561337355456,0.36036059061500536,0.19311480457104152,130237.8584895739,-1565.9220825070631,128671.93640706684,3335,4,669.7307692307693,42,10,22,36.16127934940826,0.6125992063492064,44.815891472868216,1020.7364341085267,24.3032484311554,0
3367,4,0,0,52,0.0,0.0,1.0,52,1200,900,300,0.75,15,9,6,338.35901707621804,0.43402777777777773,0.3570643642072209,0.19278595158993836,130262.58680555566,-1584.8887912384976,128677.69801431717,3336,5,670.7307692307693,39,13,22,36.15646258503401,0.6175213675213675,44.79166666666667,1020.8333333333343,26.1752136752137,0
3368,4,0,0,52,0.0,0.0,1.0,52,1750,1400,350,0.8,21,14,7,335.20295429409936,0.43391779788838614,0.3512630918291295,0.19164227211974627,130395.54172092032,-1658.2058376735927,128737.33588324672,3337,6,671.7307692307693,39,13,22,36.10243498215198,0.6188568376068375,44.66145833333334,1021.3541666666681,26.188568376068414,0
3369,4,0,0,52,0.0,0.0,1.0,52,1000,700,300,0.7,13,7,6,340.3072693154859,0.43391779788838614,0.3686244750955445,0.19153542626260536,129784.51063368049,-1566.6775173611165,128217.83311631938,3338,7,672.7307692307693,39,13,17,36.59144346759354,0.6127136752136753,45.260416666666664,1018.9583333333328,26.12713675213674,1
3370,4,1,1,52,0.018867924528301886,0.018867924528301886,0.9811320754716981,53,1300,800,500,0.6153846153846154,18,8,10,332.7308409752444,0.43526245766811805,0.3714187972496965,0.18869786337341826,130081.0994199881,-1943.6012790005952,128137.4981409875,3339,0,661.0188679245283,40,13,18,36.483861326957566,0.6140625,44.96951219512195,1020.1219512195121,25.503048780487802,0
3371,4,0,0,52,0.0,0.0,1.0,52,1800,1400,400,0.7777777777777778,22,14,8,341.6306051668358,0.4353396807440925,0.37764885206083765,0.19479011418912498,130290.57167830497,-1497.4975977455933,128793.07408055938,3340,1,667.9807692307693,37,15,18,36.04462016253177,0.6213400900900901,44.76425438596492,1020.9429824561413,27.59305357989571,0
3372,4,2,1,53,0.037037037037037035,0.018518518518518517,0.9814814814814815,54,1400,1100,300,0.7857142857142857,17,11,6,329.35736424696285,0.43685942231539715,0.38164062647312846,0.19038367712003673,130821.45317925356,-2182.598198784711,128638.85498046885,3341,0,644.2037037037037,39,15,18,35.821305535756714,0.6231303418803419,44.24479166666667,1023.020833333334,26.23130341880344,0
3373,4,0,1,52,0.0,0.018867924528301886,0.9811320754716981,53,1400,900,500,0.6428571428571429,19,9,10,338.4756754298831,0.43663824383164007,0.3952252760030115,0.195450308598655,130781.15297866898,-1746.7521824092285,129034.40079625975,3342,1,657.3584905660377,38,15,18,35.628829816865135,0.6244517543859649,44.284188034188034,1022.8632478632477,26.9174538911381,0
3374,4,1,0,53,0.018867924528301886,0.0,1.0,53,1600,1300,300,0.8125,19,13,6,339.85532225454506,0.4356555394291243,0.40156832487629424,0.19792546288773202,131109.19922017667,-1688.3681696983047,129420.83105047836,3343,0,657.8301886792453,38,15,20,35.26214444676263,0.6277412280701755,43.96367521367521,1024.1452991452984,26.951192082771012,0
3375,4,0,0,53,0.0,0.0,1.0,53,1450,1100,350,0.7586206896551724,18,11,7,341.6183812236784,0.4354438800193517,0.399628701952766,0.19981222559325526,131274.74500868077,-1630.8268229166456,129643.91818576412,3344,1,658.8301886792453,39,14,20,35.04989157687877,0.6276709401709402,43.80208333333334,1024.7916666666686,26.27670940170945,0
3376,4,0,0,53,0.0,0.0,1.0,53,1150,600,550,0.5217391304347826,17,6,11,343.04977196113396,0.43533805031446543,0.40006135910415686,0.20092915214866452,131328.12500000026,-1589.5833333332998,129738.54166666696,3345,2,659.8301886792453,39,14,20,34.95934959349596,0.6282051282051281,43.750000000000014,1025.000000000002,26.282051282051334,0
3377,4,0,0,53,0.0,0.0,1.0,53,1600,1300,300,0.8125,19,13,6,346.75944490059175,0.4345518867924529,0.4079681142847673,0.20402358037174348,131501.3239590942,-1480.1347800503204,130021.1891790439,3346,3,660.8301886792453,36,17,21,34.68951288244767,0.6354166666666666,43.58108108108108,1025.6756756756756,28.49099099099099,0
3378,4,0,0,53,0.0,0.0,1.0,53,1450,600,850,0.41379310344827586,23,6,17,350.0099407051993,0.4338413159167876,0.41085682331255247,0.2062477723042929,131559.08230866012,-1390.6026803830807,130168.47962827704,3347,4,661.8301886792453,36,17,18,34.54788693743138,0.6359953703703705,43.52477477477478,1025.9009009009017,28.49724724724727,0
3379,4,1,0,54,0.018518518518518517,0.0,1.0,54,1500,1300,200,0.8666666666666667,17,13,4,343.0828679876303,0.434733869089215,0.41112805817464726,0.20415129075303518,131931.11257213805,-1747.3391043904073,130183.77346774764,3348,0,650.5555555555555,38,16,20,34.35073488630061,0.6359649122807018,43.16239316239315,1027.350427350426,27.035537561853314,0
3380,4,0,0,54,0.0,0.0,1.0,54,950,700,250,0.7368421052631579,12,7,5,343.3265527946084,0.43477026554856746,0.4136226057623442,0.20459199410028114,131985.99810979588,-1737.140450361635,130248.85765943424,3349,1,651.5555555555555,38,16,20,34.2892233312539,0.636513157894737,43.10897435897434,1027.5641025641003,27.041160593792114,0
3381,4,0,0,54,0.0,0.0,1.0,54,1350,1000,350,0.7407407407407407,17,10,7,345.54743127002905,0.434464535290007,0.41326599326599367,0.2069629138751726,132178.18737900836,-1665.2333762510355,130512.95400275732,3350,2,652.5555555555555,38,16,20,34.03874458874459,0.6384320175438598,42.92200854700853,1028.3119658119633,27.060841205577983,0
3382,4,1,1,54,0.01818181818181818,0.01818181818181818,0.9818181818181818,55,1700,1400,300,0.8235294117647058,20,14,6,338.80247176646077,0.4350729517396184,0.40294442399705566,0.2041078305519897,132398.00347222216,-2028.28057655783,130369.72289566434,3351,0,641.6727272727272,37,18,20,33.99122807017544,0.642454954954955,42.70833333333333,1029.166666666666,27.8153153153153,0
3383,4,0,0,54,0.0,0.0,1.0,54,1000,700,300,0.7,13,7,6,343.6290019058598,0.4346901933379921,0.4062638260856526,0.20672151527564422,132344.4064670137,-1704.524739583353,130639.88172743034,3352,4,654.5555555555555,39,15,20,33.92091853951544,0.6383547008547009,42.76041666666666,1028.9583333333317,26.383547008546966,0
3384,4,0,0,54,0.0,0.0,1.0,54,1500,1200,300,0.8,18,12,6,340.6822795587532,0.43416608432331705,0.40797241824639086,0.20569012818472088,132480.48159105846,-1773.2386562089164,130707.24293484954,3353,5,655.5555555555555,38,16,20,33.86000415110003,0.6414473684210527,42.628205128205124,1029.487179487179,27.09176788124155,0
3385,4,1,1,54,0.01818181818181818,0.01818181818181818,0.9818181818181818,55,1850,1400,450,0.7567567567567568,23,14,9,334.33560383886805,0.43629349046015714,0.39397921395293256,0.20329330846821916,132746.64849175367,-2123.6138237846967,130623.03466796898,3354,0,644.6181818181818,39,16,17,33.756296539640815,0.6423611111111109,42.36979166666668,1030.520833333335,26.423611111111157,0
3386,4,1,1,54,0.01818181818181818,0.01818181818181818,0.9818181818181818,55,1300,800,500,0.6153846153846154,18,8,10,335.0701362476027,0.4340628507295174,0.3964955137800876,0.2046180924562014,132907.71620008702,-2093.318684895811,130814.3975151912,3355,0,645.6,39,16,17,33.57588729501298,0.6439636752136751,42.21354166666668,1031.145833333335,26.439636752136796,0
3387,4,0,0,54,0.0,0.0,1.0,54,1350,800,550,0.5925925925925926,19,8,11,345.2928541092802,0.433103307710226,0.4086453019503071,0.2104694093051452,132838.18354381275,-1626.3848938928847,131211.79864991986,3356,8,658.5555555555555,38,16,17,33.38212940891976,0.6450109649122806,42.28098290598292,1030.87606837607,27.128317588843945,0
3388,4,0,0,54,0.0,0.0,1.0,54,1500,1000,500,0.6666666666666666,20,10,10,347.9169769825146,0.4326374330305148,0.409087422136303,0.213165376252739,133030.9920374025,-1543.2518810723714,131487.7401563301,3357,9,659.5555555555555,38,16,18,33.12103010218173,0.6469298245614034,42.094017094017104,1031.6239316239332,27.14799820062982,0
3389,4,0,0,54,0.0,0.0,1.0,54,1550,1400,150,0.9032258064516129,17,14,3,350.90081401180487,0.43196045888655954,0.4138256268691043,0.2156298895263382,133141.23109796195,-1456.1267258382582,131685.1043721237,3358,10,660.5555555555555,38,16,19,32.93348861283643,0.6480263157894737,41.98717948717949,1032.0512820512827,27.15924426450744,0
3390,4,0,0,54,0.0,0.0,1.0,54,1400,900,500,0.6428571428571429,19,9,10,350.48533027608414,0.43180759375727934,0.4146737797400044,0.21601340763954585,133251.51581561842,-1459.4596939148198,131792.0561217036,3359,11,661.5555555555555,38,16,19,32.83362651766003,0.6491228070175439,41.88034188034188,1032.4786324786328,27.170490328385075,0
3391,4,0,0,54,0.0,0.0,1.0,54,800,500,300,0.625,11,5,6,349.5833789309054,0.43205508968087586,0.41320915428238325,0.2158013461221047,133310.81271701414,-1479.3511284721963,131831.46158854195,3360,12,662.5555555555555,39,15,20,32.7974749512474,0.6479700854700854,41.82291666666668,1032.7083333333353,26.479700854700905,0
3392,4,1,0,55,0.01818181818181818,0.0,1.0,55,600,400,200,0.6666666666666666,8,4,4,353.9937450920922,0.4329545454545454,0.44101827754345013,0.20970506653701163,131761.33639974456,-1639.7239326530614,130121.6124670915,3361,0,651.4909090909091,36,19,19,34.24166392453658,0.6380208333333333,43.327702702702716,1026.689189189191,28.519144144144192,4
3393,4,0,0,55,0.0,0.0,1.0,55,1000,700,300,0.7,13,7,6,357.1120440904891,0.4326739618406285,0.44457336523125957,0.21203527617872814,131848.06428049688,-1583.0936510835018,130264.97062941338,3362,1,652.4909090909091,36,19,19,34.07415021929823,0.6388888888888888,43.24324324324325,1027.0270270270282,28.52852852852856,0
3394,4,0,0,55,0.0,0.0,1.0,55,1650,1100,550,0.6666666666666666,22,11,11,356.85977657722196,0.4323232323232323,0.4467538161093618,0.2125318930476877,131963.7458404351,-1581.4894286177969,130382.25641181729,3363,2,653.4909090909091,36,19,20,33.96399605436211,0.6400462962962963,43.130630630630634,1027.477477477478,28.541041041041055,0
3395,4,0,1,54,0.0,0.01818181818181818,0.9818181818181818,55,2050,1600,450,0.7804878048780488,25,16,9,356.4934871110904,0.4324214365881032,0.441390009308098,0.21316855453785613,132116.03570329328,-1580.29874576793,130535.73695752535,3364,3,654.4909090909091,37,18,20,33.81994809442548,0.6396396396396395,42.98245614035088,1028.0701754385964,27.78568041725936,0
3396,4,0,0,54,0.0,0.0,1.0,54,1100,700,400,0.6363636363636364,15,7,8,362.7750347157067,0.4312834847426042,0.4463054287163877,0.2162196075624313,131992.6741564199,-1223.2706101371587,130769.40354628275,3365,4,666.8888888888889,36,18,20,33.78287671232878,0.6403356481481481,43.10247747747748,1027.59009009009,28.544169169169166,0
3397,4,0,0,54,0.0,0.0,1.0,54,1950,1500,450,0.7692307692307693,24,15,9,361.3499049018569,0.4308176100628931,0.449976266111658,0.21602902959063866,132108.41912436087,-1252.52706253551,130855.89206182536,3366,5,667.8888888888889,36,18,20,33.70280607587542,0.6414930555555556,42.98986486486486,1028.0405405405406,28.556681681681685,0
3398,4,0,0,54,0.0,0.0,1.0,54,1450,800,650,0.5517241379310345,21,8,13,357.4304563900841,0.43044636617749826,0.4483550280906645,0.21452687852817484,132256.9820161009,-1345.465311442,130911.51670465889,3367,6,668.8888888888889,37,17,21,33.65390594463989,0.6410472972972974,42.845394736842096,1028.6184210526299,27.800497866287294,0
3399,4,0,0,54,0.0,0.0,1.0,54,1250,600,650,0.48,19,6,13,357.6229224037,0.4298567435359888,0.448872785829308,0.2151239425536101,132341.58587257602,-1334.3230609418406,131007.26281163418,3368,7,669.8888888888889,37,17,21,33.56377877237851,0.6418918918918919,42.763157894736835,1028.9473684210514,27.809388335704092,0
3400,4,1,1,54,0.01818181818181818,0.01818181818181818,0.9818181818181818,55,1500,1000,500,0.6666666666666666,20,10,10,349.2344351876736,0.43034511784511786,0.4379970193740692,0.21218426839091706,132716.91243608456,-1730.112763246159,130986.7996728384,3369,0,658.6909090909091,36,19,18,33.402322404371574,0.6475694444444446,42.39864864864864,1030.405405405404,28.622372372372336,0
3401,4,0,0,54,0.0,0.0,1.0,54,950,800,150,0.8421052631578947,11,8,3,359.40251599494246,0.4289249941765665,0.44600534452186547,0.21754854335530552,132576.73852237628,-1270.3173225308954,131306.42119984538,3370,9,671.8888888888889,35,19,21,33.28135536075522,0.6482142857142859,42.53472222222221,1029.861111111109,29.424603174603117,0
3402,4,0,0,54,0.0,0.0,1.0,54,1200,800,400,0.6666666666666666,16,8,8,360.55866298750385,0.42853919170743066,0.44068082237950756,0.21876841576358316,132666.15125868033,-1233.213975694478,131432.93728298586,3371,10,672.8888888888889,35,19,18,33.16165318503537,0.649107142857143,42.44791666666665,1030.2083333333314,29.434523809523757,0
3403,4,0,0,54,0.0,0.0,1.0,54,1000,600,400,0.6,14,6,8,362.29533916355433,0.4285974260423946,0.43895085294142144,0.22069783109374908,132815.239465449,-1176.3315543553113,131638.9079110937,3372,11,673.8888888888889,35,19,18,32.967007261022516,0.6505952380952382,42.303240740740726,1030.7870370370351,29.451058201058146,0
3404,4,0,0,54,0.0,0.0,1.0,54,1050,700,350,0.6666666666666666,14,7,7,360.5703863492574,0.42862654320987653,0.42940750192983224,0.22018207228755907,132906.30290089236,-1215.5846029547865,131690.71829793756,3373,12,674.8888888888889,37,17,19,32.919945413299295,0.6475225225225226,42.21491228070174,1031.1403508771912,27.868658131815977,0
3405,4,0,0,54,0.0,0.0,1.0,54,1800,1300,500,0.7222222222222222,23,13,10,359.94993198067596,0.4276947938504542,0.42069188973630456,0.22102710699309253,133113.66705246904,-1217.1489197530946,131896.51813271595,3374,13,675.8888888888889,38,16,20,32.72768057424854,0.6477521929824561,42.013888888888886,1031.944444444444,27.156432748538,0
3406,4,1,1,54,0.01818181818181818,0.01818181818181818,0.9818181818181818,55,1850,1400,450,0.7567567567567568,23,14,9,351.9030923360228,0.4286054994388328,0.41536108751061973,0.21771728141178745,133393.4736784486,-1611.6848230220241,131781.78885542657,3375,0,664.5818181818182,40,15,21,32.6547384817183,0.6471354166666667,41.74288617886178,1033.0284552845521,25.825711382113802,0
3407,4,0,0,54,0.0,0.0,1.0,54,1200,700,500,0.5833333333333334,17,7,10,360.8401888543724,0.42692318891218267,0.4178739090002581,0.2232346945021092,133391.50526258675,-1173.3968098958387,132218.1084526909,3376,1,677.6296296296297,39,15,21,32.42590585190413,0.6487713675213675,41.744791666666664,1033.020833333333,26.487713675213666,0
3408,4,0,0,54,0.0,0.0,1.0,54,1600,1200,400,0.75,20,12,8,361.1877097566295,0.4267412066154204,0.4163296983986635,0.22410758159685532,133500.5497484803,-1156.1996088940853,132344.3501395862,3377,2,678.6296296296297,37,17,21,32.307581786030056,0.6534346846846846,41.63925438596491,1033.4429824561403,27.93089141773352,0
3409,4,0,1,53,0.0,0.018518518518518517,0.9814814814814815,54,1300,1000,300,0.7692307692307693,16,10,6,365.0902024300824,0.4263408455625437,0.4221860808623641,0.22704950056139966,133585.55036164977,-1045.844875346259,132539.70548630352,3378,3,679.6296296296297,37,17,21,32.12151746570499,0.6542792792792793,41.55701754385965,1033.7719298245618,27.939781887150318,0
3410,4,0,0,53,0.0,0.0,1.0,53,1850,1400,450,0.7567567567567568,23,14,9,365.61441308583323,0.4254958877600387,0.41756363847383726,0.22754972283738067,133613.88991083775,-829.7672120268011,132784.12269881094,3379,4,686.3018867924528,37,16,21,32.07955509598047,0.6545608108108109,41.52960526315788,1033.8815789473667,27.94274537695586,0
3411,4,0,0,53,0.0,0.0,1.0,53,850,500,350,0.5882352941176471,12,5,7,365.61441308583323,0.42534470246734396,0.41756363847383726,0.22754972283738067,133613.88991083775,-829.7672120268011,132784.12269881094,3380,5,687.3018867924528,37,16,21,32.07955509598047,0.6545608108108109,41.52960526315788,1033.8815789473667,27.94274537695586,0
3412,4,0,0,53,0.0,0.0,1.0,53,1450,800,650,0.5517241379310345,21,8,13,364.5360100889111,0.4248155539429124,0.4168547057788019,0.2274010348649874,133698.92659279777,-852.3853493382613,132846.5412434595,3381,6,688.3018867924528,37,16,21,32.022193949674865,0.6554054054054055,41.44736842105263,1034.2105263157891,27.951635846372678,0
3413,4,0,0,53,0.0,0.0,1.0,53,800,500,300,0.625,11,5,6,369.5441069049971,0.4241805757135946,0.41979382267950527,0.23105690183224975,133783.99032635044,-712.1829553324083,133071.80737101802,3382,7,689.3018867924528,37,16,17,31.807432432432442,0.65625,41.36513157894737,1034.5394736842109,27.960526315789483,0
3414,4,0,1,52,0.0,0.018867924528301886,0.9811320754716981,53,1150,900,250,0.782608695652174,14,9,5,381.30004783380014,0.4241805757135946,0.41833453802248255,0.22033903527495147,130809.21292914521,-620.1058125698053,130189.10711657541,3383,8,690.3018867924528,36,17,16,34.5052656685748,0.6284722222222223,44.25675675675675,1022.9729729729718,28.415915915915882,7
3415,4,0,0,52,0.0,0.0,1.0,52,1100,700,400,0.6363636363636364,15,7,8,388.08489540846506,0.4225663021618904,0.429744025075095,0.223661451463391,130706.03358892728,-254.99252507718188,130451.0410638501,3384,36,704.4230769230769,35,17,16,34.436544991511035,0.6294642857142858,44.35763888888888,1022.569444444443,29.2162698412698,0
3416,4,0,1,51,0.0,0.019230769230769232,0.9807692307692307,52,1400,1000,400,0.7142857142857143,18,10,8,386.96733504185534,0.422008547008547,0.42742686592438917,0.2237809190869036,130838.01442912505,-273.9924468387335,130564.02198228631,3385,37,705.4230769230769,36,16,16,34.33108603925884,0.6287615740740742,44.2286036036036,1023.0855855855854,28.41904404404404,0
3417,4,0,0,51,0.0,0.0,1.0,51,1400,900,500,0.6428571428571429,19,9,10,394.6464926412159,0.4218464052287582,0.4388926970267686,0.22814129159291735,130824.41332572441,125.8791741683749,130950.29249989279,3386,38,719.1176470588235,35,16,16,34.14849436210732,0.6306547619047619,44.241898148148145,1023.032407407407,29.229497354497344,0
3418,4,1,0,52,0.019230769230769232,0.0,1.0,52,1150,600,550,0.5217391304347826,17,6,11,383.27093807895,0.42479732277526394,0.43901798108014933,0.22336890476370133,131136.55495516444,-347.83391317849555,130788.72104198595,3387,0,706.2692307692307,38,14,17,34.122813879906815,0.6280153508771931,43.9369658119658,1024.2521367521344,26.954003598740382,0
3419,4,0,0,52,0.0,0.0,1.0,52,1000,700,300,0.7,13,7,6,382.6810539734338,0.4251665409753645,0.44033828826299404,0.22334319090391094,131191.27498584625,-359.11692325955744,130832.15806258669,3388,1,707.2692307692307,38,14,17,34.08245559147633,0.6285635964912281,43.883547008547005,1024.4658119658116,26.959626630679253,0
3420,4,0,1,51,0.0,0.019230769230769232,0.9807692307692307,52,1450,1100,350,0.7586206896551724,18,11,7,383.2181959453373,0.42476589994972347,0.4408375755585272,0.22398796158730142,131248.05908203125,-340.67111545138846,130907.38796657986,3389,2,708.2692307692307,39,13,18,34.01115262105656,0.6274038461538463,43.828125,1024.6875,26.27403846153846,0
3421,4,1,0,52,0.019230769230769232,0.0,1.0,52,1450,1200,250,0.8275862068965517,17,12,5,387.04313529673294,0.4272404474610357,0.44588349143804473,0.22793111681959763,131535.81700370807,-217.89534036349852,131317.92166334458,3390,0,701.25,35,17,20,33.6216339463688,0.6377976190476189,43.54745370370371,1025.8101851851857,29.308862433862448,0
3422,4,0,1,51,0.0,0.019230769230769232,0.9807692307692307,52,900,700,200,0.7777777777777778,11,7,4,385.25628071203835,0.42696549773755654,0.4406073513719846,0.22758610533468657,131654.5718262389,-255.8498638974499,131398.72196234146,3391,1,702.25,35,17,16,33.54725856170822,0.6389880952380952,43.43171296296297,1026.2731481481487,29.322089947089964,0
3423,4,2,2,51,0.03773584905660377,0.03773584905660377,0.9622641509433962,53,1100,700,400,0.6363636363636364,15,7,8,368.42122711887095,0.42954765360425734,0.41265521480572276,0.22034291290024222,132123.26189139107,-864.5971446051406,131258.66474678594,3392,0,665.2830188679245,38,15,16,33.506096504901464,0.6378837719298245,42.97542735042736,1028.098290598292,27.05521817363926,0
3424,4,0,1,50,0.0,0.0196078431372549,0.9803921568627451,51,1650,1200,450,0.7272727272727273,21,12,9,384.89292236028086,0.4256699346405229,0.42802292815481935,0.22844785239710994,131834.3685076179,-51.57692751613462,131782.79158010177,3393,3,692.3725490196078,37,14,16,33.37470638479608,0.6368243243243242,43.25657894736843,1026.9736842105278,27.756045519203454,0
3425,4,0,0,50,0.0,0.0,1.0,50,1500,1300,200,0.8666666666666667,17,13,4,378.5148865784494,0.4256632653061225,0.35592391304347815,0.21764605978260876,130617.28395061754,-109.47813002288592,130507.80582059466,3394,4,663.1,38,12,17,34.77128623188406,0.6228070175438596,44.44444444444446,1022.2222222222242,26.90058479532169,4
3426,4,0,0,50,0.0,0.0,1.0,50,1600,1200,400,0.75,20,12,8,376.72913568642736,0.42576530612244895,0.3542376423868743,0.21677216472540156,130644.58832137135,-156.47543191611453,130488.11288945524,3395,5,664.1,38,12,17,34.78920646532205,0.623081140350877,44.41773504273505,1022.3290598290613,26.903396311291086,0
3427,4,1,1,50,0.0196078431372549,0.0196078431372549,0.9803921568627451,51,1550,1400,150,0.9032258064516129,17,14,3,365.5153563112677,0.4266666666666667,0.3473417169469313,0.21192315218254373,130937.79047070228,-628.0453722982039,130309.74509840408,3396,0,652.0588235294117,40,11,17,34.7786962565783,0.6226562499999999,44.131097560975626,1023.4756097561002,25.586890243902506,0
3428,4,2,1,51,0.038461538461538464,0.019230769230769232,0.9807692307692307,52,1250,700,550,0.56,18,7,11,357.45579496432003,0.42863876319758676,0.3438470475211681,0.2089508152906886,131251.87119118506,-1016.6516085600659,130235.219582625,3397,0,640.4807692307693,41,11,18,34.667259657275636,0.6242378048780487,43.82440476190477,1024.7023809523828,24.992740998838606,0
3429,4,1,0,52,0.019230769230769232,0.0,1.0,52,950,600,350,0.631578947368421,13,6,7,359.41525833568573,0.42888229009552536,0.3596466479594944,0.21080122826107012,131380.2134972573,-955.9671808627388,130424.24631639456,3398,0,641.4615384615385,40,12,19,34.48734469997356,0.6270833333333332,43.69918699186994,1025.2032520325233,25.63008130081308,0
3430,4,1,1,52,0.018867924528301886,0.018867924528301886,0.9811320754716981,53,1850,1200,650,0.6486486486486487,25,12,13,355.1663426839767,0.4286858974358974,0.3558628330678877,0.21110174007749102,131887.99622858394,-1231.5645471151488,130656.43168146879,3399,0,630.3396226415094,41,12,14,34.08384843216792,0.630589430894309,43.204365079365076,1027.182539682539,25.053232675183878,0
3431,4,0,1,51,0.0,0.019230769230769232,0.9807692307692307,52,1350,1000,350,0.7407407407407407,17,10,7,372.5912213609081,0.42808886375062843,0.3413629153991744,0.21144393845348539,130107.01844346948,-703.6692281320161,129403.34921533747,3400,2,643.4615384615385,40,12,15,35.44094697347015,0.6143229166666667,44.94410569105691,1020.2235772357723,25.505589430894307,7
3432,4,0,0,51,0.0,0.0,1.0,51,1350,900,450,0.6666666666666666,18,9,9,371.29182578606355,0.42601307189542487,0.35085212776813957,0.21140549685517965,130236.00396050366,-528.8872612847033,129707.11669921895,3401,3,656.8235294117648,39,12,16,35.342998435214476,0.6172542735042734,44.81770833333334,1020.7291666666681,26.17254273504277,0
3433,4,4,3,52,0.07272727272727272,0.05454545454545454,0.9454545454545454,55,1500,1100,400,0.7333333333333333,19,11,8,348.06655676963084,0.43470819304152636,0.33934117363662186,0.20242263650988931,131055.13232565642,-1876.815556210478,129178.31676944594,3402,0,609.9818181818182,42,13,14,35.10654238036654,0.6207837301587302,44.01647286821705,1023.9341085271311,24.379383536360265,0
3434,4,1,1,52,0.018867924528301886,0.018867924528301886,0.9811320754716981,53,1500,1000,500,0.6666666666666666,20,10,10,360.7529340627431,0.42950229801644896,0.35407761914488156,0.2088798903437473,130885.78976014629,-1156.5134633815605,129729.27629676473,3403,0,633.9811320754717,40,13,14,34.95319793425367,0.6221354166666666,44.1819105691057,1023.2723577235789,25.581808943089474,0
3435,4,0,0,52,0.0,0.0,1.0,52,1000,800,200,0.8,12,8,4,370.9541606348071,0.42787675967823025,0.35950963496788324,0.21428057984904766,130794.81336805572,-696.2239583333171,130098.58940972241,3404,2,647.1730769230769,39,13,15,34.78445349626614,0.6228632478632479,44.27083333333334,1022.916666666668,26.228632478632512,0
3436,4,2,0,54,0.037037037037037035,0.0,1.0,54,1500,1300,200,0.8666666666666667,17,13,4,358.11716119679977,0.4299804914977871,0.3619528619528616,0.20933741697802732,131251.87119118473,-1399.2904974489888,129852.58069373574,3405,0,624.1666666666666,41,13,18,34.65031706844806,0.6242378048780488,43.82440476190476,1024.7023809523803,24.992740998838542,0
3437,4,2,2,54,0.03571428571428571,0.03571428571428571,0.9642857142857143,56,1600,1200,400,0.75,20,12,8,329.3347859032828,0.4339150432900433,0.30306760083317563,0.1909129532771938,130931.13864100708,-2570.9596915091142,128360.17894949797,3406,0,602.8392857142857,42,14,16,35.711157924635486,0.6195436507936508,44.1375968992248,1023.4496124031002,24.36784791435953,3
3438,4,0,0,54,0.0,0.0,1.0,54,1100,600,500,0.5454545454545454,16,6,10,346.7648954447412,0.42924528301886794,0.31708451397193804,0.2005713049198887,130845.55820302652,-1725.4707380637456,129120.08746496278,3407,1,626.1481481481482,41,13,16,35.35172032063094,0.6201727642276422,44.22123015873016,1023.1150793650788,24.954026325977534,0
3439,4,1,1,54,0.01818181818181818,0.01818181818181818,0.9818181818181818,55,1450,1100,350,0.7586206896551724,18,11,7,334.4718786151042,0.4314674523007856,0.3166443091528224,0.1951455132847064,131179.18469442942,-2224.8503320112914,128954.33436241813,3408,0,615.7454545454545,42,13,17,35.32936845756085,0.6220238095238095,43.895348837209305,1024.418604651163,24.390919158361022,0
3440,4,1,0,55,0.01818181818181818,0.0,1.0,55,1050,500,550,0.47619047619047616,16,5,11,337.76191420450766,0.4297558922558922,0.32993348115299326,0.19783197831978325,131328.12500000015,-2128.4722222222076,129199.65277777794,3409,0,616.7272727272727,42,13,18,35.09485094850948,0.6235119047619047,43.75000000000001,1025.0000000000011,24.404761904761934,0
3441,4,0,0,55,0.0,0.0,1.0,55,1550,1000,550,0.6451612903225806,21,10,11,337.1951815379492,0.42972783389450053,0.3267824472543419,0.19763438676195777,131354.16795764756,-2141.6014979509523,129212.56645969661,3410,1,617.7272727272727,40,15,18,35.083110273949984,0.6268229166666666,43.72459349593496,1025.1016260162603,25.62754065040651,0
3442,4,0,0,55,0.0,0.0,1.0,55,1750,1000,750,0.5714285714285714,25,10,15,336.9629230036546,0.4302048260381594,0.31966064448727405,0.19844245885641132,131536.54095611078,-2135.4125355277934,129401.12842058299,3411,2,618.7272727272727,40,15,18,34.90522422561257,0.6286458333333333,43.546747967479675,1025.8130081300815,25.645325203252035,0
3443,4,1,1,55,0.017857142857142856,0.017857142857142856,0.9821428571428571,56,1300,1100,200,0.8461538461538461,15,11,4,328.5518046517259,0.43104031385281383,0.3150839280537805,0.1946298011643222,131760.64819735757,-2541.9602505354073,129218.68794682216,3412,0,608.6607142857143,41,15,15,34.89538039102007,0.6293191056910569,43.32837301587301,1026.6865079365073,25.041134339914812,0
3444,4,1,2,54,0.017857142857142856,0.03571428571428571,0.9642857142857143,56,1600,1100,500,0.6875,21,11,10,329.27665576009065,0.4306344696969697,0.32427985341076027,0.19603146440338234,131949.619210459,-2510.4141315125407,129439.20507894646,3413,0,609.6428571428571,42,14,17,34.68672388317772,0.6297123015873016,43.144379844961236,1027.4224806201541,24.462440014765576,0
3445,4,0,0,54,0.0,0.0,1.0,54,1450,1000,450,0.6896551724137931,19,10,9,342.9391393165656,0.4294272653156301,0.3303742547336095,0.20376754150926052,131875.5693225756,-1754.9411519267887,130120.62817064882,3414,1,602.1666666666666,40,14,17,34.410350911909234,0.6320312500000002,43.216463414634134,1027.1341463414615,25.678353658536537,0
3446,4,0,0,54,0.0,0.0,1.0,54,1300,1000,300,0.7692307692307693,16,10,6,343.42875046991304,0.4293690309806662,0.3311588866539903,0.2043390958505206,131927.766262228,-1738.442416055275,130189.32384617272,3415,2,603.1666666666666,40,14,17,34.34522043063935,0.6325520833333333,43.16565040650406,1027.337398373982,25.68343495934955,0
3447,4,1,1,54,0.01818181818181818,0.01818181818181818,0.9818181818181818,55,1500,1000,500,0.6666666666666666,20,10,10,336.3285843050922,0.43096240179573514,0.32742004787919776,0.20166098516430786,132219.38898533914,-2106.168016975338,130113.2209683638,3416,0,593.1818181818181,41,14,19,34.23432928201666,0.6338922764227644,42.88194444444443,1028.4722222222194,25.0846883468834,0
3448,4,0,1,53,0.0,0.018518518518518517,0.9814814814814815,54,850,600,250,0.7058823529411765,11,6,5,337.5034829389578,0.4306137898905194,0.3186085390946507,0.20250208976337442,132244.89795918346,-1873.3772675737157,130371.52069160975,3417,1,588.425925925926,41,13,19,34.178481867283956,0.6341463414634148,42.85714285714285,1028.5714285714268,25.08710801393724,0
3449,4,1,1,53,0.018518518518518517,0.018518518518518517,0.9814814814814815,54,1450,1000,450,0.6896551724137931,19,10,9,331.4271273267128,0.43152370137433027,0.3169502309101484,0.19994195191734776,132450.30369034605,-2020.3866897740966,130429.91700057195,3418,0,586.925925925926,40,14,20,34.12849244742817,0.6377604166666668,42.65752032520324,1029.3699186991844,25.73424796747961,0
3450,4,0,2,51,0.0,0.03773584905660377,0.9622641509433962,53,1550,1100,450,0.7096774193548387,20,11,9,322.89948834258536,0.43115021770682144,0.2819265527260546,0.1932176845948358,132142.87682665663,-2066.226536911058,130076.65028974558,3419,1,592.3018867924528,41,12,18,34.65642287405121,0.6331300813008129,42.95634920634921,1028.1746031746036,25.077429345722038,2
3451,4,1,1,51,0.019230769230769232,0.019230769230769232,0.9807692307692307,52,700,400,300,0.5714285714285714,10,4,6,325.3497042668283,0.4323623680241327,0.2826955384767422,0.19492087966110327,132188.90587819743,-1798.4757130345788,130390.43016516285,3420,0,601.2692307692307,40,12,18,34.54722139868893,0.6351562500000001,42.911585365853654,1028.3536585365846,25.708841463414615,0
3452,4,0,0,51,0.0,0.0,1.0,51,1450,1100,350,0.7586206896551724,18,11,7,330.5094618235128,0.4297712418300654,0.28522377739097293,0.19742538554929917,132076.5842013888,-1469.4878472222313,130607.09635416656,3421,3,614.0588235294117,39,12,18,34.52742872584786,0.6356837606837608,43.02083333333333,1027.9166666666658,26.356837606837587,0
3453,4,0,0,51,0.0,0.0,1.0,51,1650,1300,350,0.7878787878787878,20,13,7,344.2239698018245,0.4303104575163399,0.2788549858446052,0.201913056314119,131384.32618690346,-1140.202995152379,130244.12319175109,3422,4,615.0588235294117,37,14,18,34.87254901960783,0.6323198198198199,43.69517543859648,1025.2192982456124,27.70862968231385,2
3454,4,0,1,50,0.0,0.0196078431372549,0.9803921568627451,51,1350,1100,250,0.8148148148148148,16,11,5,345.0018478738395,0.4300653594771242,0.24710091083636443,0.19582342082283838,130114.25212013988,-1222.0685167658337,128892.18360337404,3423,5,616.0588235294117,42,9,18,36.13729540633803,0.611359126984127,44.93701550387596,1020.2519379844949,24.291712809154642,5
3455,4,0,0,50,0.0,0.0,1.0,50,1200,700,500,0.5833333333333334,17,7,10,347.0484180092313,0.4283928571428572,0.2609115077857951,0.1973603638484461,130188.40889970551,-963.6637296436609,129224.74517006184,3424,8,629.28,42,8,18,36.00989840486136,0.6121031746031746,44.86434108527131,1020.5426356589144,24.298634182355105,0
3456,4,1,1,50,0.0196078431372549,0.0196078431372549,0.9803921568627451,51,1000,700,300,0.7,13,7,6,340.3170521910943,0.42990196078431375,0.2639745374975133,0.19507113128445067,130496.11363110594,-1317.9260784801513,129178.1875526258,3425,0,617.9215686274509,40,11,15,35.87005172070818,0.6182291666666666,44.56300813008131,1021.7479674796757,25.543699186991894,0
3457,4,0,0,50,0.0,0.0,1.0,50,1550,1100,450,0.7096774193548387,20,11,9,346.76785601138425,0.42744897959183675,0.27504026093160716,0.19907193887230515,130555.17713758699,-945.5322265624802,129609.6449110245,3426,1,631.1,39,11,16,35.645470220500805,0.6204594017094016,44.50520833333334,1021.9791666666681,26.204594017094053,0
3458,4,0,0,50,0.0,0.0,1.0,50,1350,700,650,0.5185185185185185,20,7,13,346.5409100452092,0.42735544217687077,0.2696383087111558,0.1994896793016855,130661.6550021705,-944.0782335069055,129717.5767686636,3427,2,632.1,39,11,17,35.54349210392257,0.6215277777777777,44.401041666666686,1022.3958333333362,26.215277777777853,0
3459,4,0,0,50,0.0,0.0,1.0,50,1550,1300,250,0.8387096774193549,18,13,5,346.70852271416663,0.42692176870748294,0.2681613527554243,0.19986127818467275,130714.91021050364,-936.0053168402592,129778.90489366339,3428,3,633.1,39,11,17,35.48531883467455,0.6220619658119657,44.34895833333334,1022.604166666668,26.22061965811969,0
3460,4,0,0,50,0.0,0.0,1.0,50,1350,1000,350,0.7407407407407407,17,10,7,345.4025825345007,0.42665816326530615,0.2696945010183298,0.1995207859111059,130794.81336805572,-964.6267361110922,129830.18663194463,3429,4,634.1,39,11,17,35.437881873727086,0.6228632478632478,44.27083333333334,1022.916666666668,26.228632478632512,0
3461,4,0,0,50,0.0,0.0,1.0,50,1200,900,300,0.75,15,9,6,342.3120134602651,0.42671768707482993,0.2726859298977251,0.19847002231193653,130937.7904707023,-1035.684261187093,129902.1062095152,3430,5,635.1,40,10,17,35.37239764339854,0.6226562499999999,44.131097560975626,1023.4756097561003,25.58689024390251,0
3462,4,2,0,52,0.038461538461538464,0.0,1.0,52,1300,700,600,0.5384615384615384,19,7,12,330.671494608394,0.4296285822021116,0.2836979034192071,0.1945612990789247,131501.9954949374,-1703.2077211405367,129798.78777379687,3431,0,611.6346153846154,42,10,20,35.10136199023776,0.6252480158730158,43.58042635658916,1025.678294573645,24.420911775562974,0
3463,4,0,3,49,0.0,0.057692307692307696,0.9423076923076923,52,2000,1500,500,0.75,25,15,10,332.0266446211773,0.4289922699849171,0.2730166396722906,0.19612349097506368,131651.11889497345,-1657.664146535649,129993.4547484378,3432,1,612.6346153846154,42,10,15,34.91643848550656,0.6267361111111109,43.43507751937985,1026.259689922482,24.434754521963857,0
3464,4,1,1,49,0.02,0.02,0.98,50,800,500,300,0.625,11,5,6,336.447926405819,0.4264625850340136,0.2582593559617057,0.1982454704821982,131557.019292092,-1147.5827310090565,130409.43656108296,3433,0,583.8,41,9,16,34.897797601779324,0.6272865853658536,43.52678571428572,1025.8928571428585,25.021777003484353,0
3465,4,0,0,49,0.0,0.0,1.0,49,900,200,700,0.2222222222222222,16,2,14,347.1149059253358,0.4235402494331066,0.2691564140519458,0.20414240271553005,131484.42147531267,-671.9594817899037,130812.46199352277,3434,9,596.7142857142857,40,9,19,34.697450125511956,0.6281249999999998,43.597560975609774,1025.6097560975638,25.640243902439096,0
3466,4,0,1,48,0.0,0.02040816326530612,0.9795918367346939,49,600,400,200,0.6666666666666666,8,4,4,346.228314911265,0.42346938775510207,0.27398085534362315,0.20403822761408208,131562.604569453,-689.8602229162209,130872.74434653677,3435,10,597.7142857142857,40,9,16,34.64132408783227,0.6289062499999998,43.52134146341465,1025.9146341463438,25.647865853658594,0
3467,4,1,0,49,0.02040816326530612,0.0,1.0,49,1600,1200,400,0.75,20,12,8,342.74545770155527,0.42334537981859416,0.28761271950640666,0.20337303875949636,131823.382710771,-763.626871405884,131059.75583936511,3436,0,597.9183673469388,40,9,17,34.467878937819556,0.6315104166666665,43.26727642276424,1026.9308943089452,25.67327235772363,0
3468,4,0,0,49,0.0,0.0,1.0,49,1100,700,400,0.6363636363636364,15,7,8,344.08672837717893,0.42284934807256236,0.2907734267908366,0.20473059076897607,131927.76626222828,-721.0813049441363,131206.68495728413,3437,1,598.9183673469388,40,9,17,34.32832129785341,0.6325520833333333,43.16565040650407,1027.3373983739846,25.683434959349615,0
3469,4,0,0,49,0.0,0.0,1.0,49,1450,900,550,0.6206896551724138,20,9,11,341.08347185811044,0.42217616213151926,0.29559252272337533,0.20378377541906592,132084.41904826823,-789.6375545310282,131294.78149373722,3438,2,599.9183673469388,40,9,18,34.24781677376835,0.6341145833333333,43.01321138211382,1027.9471544715448,25.69867886178862,0
3470,4,0,0,49,0.0,0.0,1.0,49,1700,1300,400,0.7647058823529411,21,13,8,341.73039177244726,0.42210530045351474,0.2966029411468174,0.20501797837160277,132241.1647849329,-761.8349899200247,131479.32979501286,3439,3,600.9183673469388,40,9,18,34.073543457497614,0.6356770833333334,42.860772357723576,1028.5569105691056,25.71392276422764,0
3471,4,0,0,49,0.0,0.0,1.0,49,650,400,250,0.6153846153846154,9,4,5,341.5358900801644,0.4222470238095238,0.297101887583723,0.2050430770694795,132267.29811124335,-765.1941222156107,131502.10398902773,3440,4,601.9183673469388,40,9,18,34.05227063162746,0.6359375,42.83536585365854,1028.6585365853662,25.716463414634156,0
3472,4,0,0,49,0.0,0.0,1.0,49,1150,800,350,0.6956521739130435,15,8,7,340.67710224595083,0.4222115929705215,0.29330258231910755,0.20466909828105395,132293.4340195154,-786.1312504131243,131507.30276910227,3441,5,602.9183673469388,40,9,18,34.048083572063604,0.6361979166666667,42.80995934959349,1028.7601626016253,25.719004065040632,0
3473,4,0,0,49,0.0,0.0,1.0,49,1350,800,550,0.5925925925925926,19,8,11,344.70324050549937,0.42139668367346944,0.297777410559366,0.20766268391428852,132398.00347222213,-672.3545219446194,131725.6489502775,3442,6,603.9183673469388,39,10,18,33.83940620782727,0.6388888888888891,42.70833333333333,1029.1666666666658,26.388888888888868,0
3474,4,0,0,49,0.0,0.0,1.0,49,1900,1400,500,0.7368421052631579,24,14,10,340.2333909099385,0.4207589285714286,0.2949931033094051,0.20611269676462785,132607.26631180174,-776.5160246876957,131830.75028711403,3443,7,604.9183673469388,40,9,18,33.744244367702684,0.6393229166666667,42.505081300813,1029.979674796747,25.74949186991868,0
3475,4,0,0,49,0.0,0.0,1.0,49,1100,700,400,0.6363636363636364,15,7,8,337.63076300627534,0.4203691893424036,0.29599887292195026,0.20525035592827512,132738.13950029734,-836.7041360962462,131901.4353642011,3444,8,605.9183673469388,40,9,17,33.679939184746885,0.640625,42.3780487804878,1030.487804878048,25.7621951219512,0
3476,4,0,0,49,0.0,0.0,1.0,49,1050,700,350,0.6666666666666666,14,7,7,337.16960003084915,0.41911139455782315,0.3007950814395157,0.2055437754034214,132842.8845264062,-841.883551457473,132001.00097494875,3445,9,606.9183673469388,40,9,17,33.58676721871714,0.6416666666666667,42.27642276422764,1030.894308943089,25.772357723577226,0
3477,4,0,0,49,0.0,0.0,1.0,49,900,600,300,0.6666666666666666,12,6,6,337.5579461028414,0.4196782879818594,0.3078961975014676,0.2063577130753998,132947.67086390383,-824.4914568048048,132123.17940709903,3446,10,607.9183673469388,40,9,17,33.4717021416371,0.6427083333333332,42.174796747967484,1031.3008130081307,25.78252032520327,0
3478,4,0,0,49,0.0,0.0,1.0,49,1400,900,500,0.6428571428571429,19,9,10,332.6774371546413,0.4189519557823129,0.3019740888279674,0.20423256933907058,133104.92782900395,-943.7987474386944,132161.12908156525,3447,11,608.9183673469388,40,9,18,33.44002363600551,0.6442708333333333,42.02235772357724,1031.9105691056914,25.797764227642283,0
3479,4,0,0,49,0.0,0.0,1.0,49,1100,1000,100,0.9090909090909091,12,10,2,332.24976125300424,0.41857993197278914,0.29473189295408986,0.2044010190821785,133183.59116803834,-949.9567263203004,132233.63444171805,3448,12,609.9183673469388,40,9,18,33.3723048144137,0.6450520833333333,41.94613821138212,1032.2154471544725,25.805386178861813,0
3480,4,0,0,49,0.0,0.0,1.0,49,1050,1000,50,0.9523809523809523,11,10,1,334.6805443610885,0.4179953231292517,0.30314157158926514,0.20633218026144803,133262.2777447289,-879.9416683190977,132382.3360764098,3449,13,610.9183673469388,40,9,18,33.23080708661418,0.6458333333333333,41.869918699187004,1032.5203252032538,25.813008130081347,0
3481,4,0,0,49,0.0,0.0,1.0,49,800,300,500,0.375,13,3,10,333.3567702026254,0.41753472222222227,0.3074334701908301,0.20624294395068124,133393.47367844894,-906.4764896886484,132486.9971887603,3450,14,611.9183673469388,40,9,18,33.13371044433515,0.6471354166666665,41.7428861788618,1033.0284552845549,25.825711382113873,0
3482,4,0,0,49,0.0,0.0,1.0,49,850,400,450,0.47058823529411764,13,4,9,333.55165064849075,0.41749929138322,0.30776642318184244,0.20665567532865387,133445.97012566947,-897.7752784387377,132548.19484723074,3451,15,612.9183673469388,40,9,18,33.0761696337825,0.6476562499999998,41.69207317073172,1033.2317073170748,25.83079268292687,0
3483,4,0,0,49,0.0,0.0,1.0,49,1350,700,650,0.5185185185185185,20,7,13,329.7857355861655,0.4173398526077097,0.30066313679124024,0.2052115000434293,133606.80474175364,-987.6737418229065,132619.13099993073,3452,16,613.9183673469388,39,10,18,33.012699412258605,0.6509081196581196,41.53645833333334,1033.854166666668,26.509081196581235,0
3484,4,0,1,48,0.0,0.02040816326530612,0.9795918367346939,49,1100,800,300,0.7272727272727273,14,8,6,329.4922478015127,0.41670209750566894,0.2944655114674344,0.2055942738121396,133708.6072794799,-988.8100874148848,132719.79719206502,3453,17,614.9183673469388,40,9,17,32.918590940355706,0.6502604166666666,41.43800813008131,1034.2479674796757,25.856199186991894,0
3485,4,0,0,48,0.0,0.0,1.0,48,850,400,450,0.47058823529411764,13,4,9,334.31799913354365,0.41539228723404253,0.28837144872053155,0.20818321577161597,133633.72938368077,-664.767795138864,132968.9615885419,3454,18,625.8125,39,9,19,32.86864463698033,0.6511752136752136,41.51041666666668,1033.958333333335,26.511752136752182,0
3486,4,0,0,48,0.0,0.0,1.0,48,850,800,50,0.9411764705882353,9,8,1,334.31799913354365,0.4153184101654846,0.28837144872053155,0.20818321577161597,133633.72938368077,-664.767795138864,132968.9615885419,3455,19,626.8125,39,9,19,32.86864463698033,0.6511752136752136,41.51041666666668,1033.958333333335,26.511752136752182,0
3487,4,1,0,49,0.02040816326530612,0.0,1.0,49,1200,800,400,0.6666666666666666,16,8,8,328.33030757206683,0.4172158446712018,0.2899862743330026,0.20604092314365394,133918.90290377763,-1006.0730839777777,132912.82981979987,3456,0,615.0,40,9,18,32.738708885616106,0.65234375,41.23475609756098,1035.0609756097572,25.87652439024393,0
3488,4,0,0,49,0.0,0.0,1.0,49,1200,800,400,0.6666666666666666,16,8,8,328.33030757206683,0.4172158446712018,0.2899862743330026,0.20604092314365394,133918.90290377763,-1006.0730839777777,132912.82981979987,3457,1,616.0,40,9,18,32.738708885616106,0.65234375,41.23475609756098,1035.0609756097572,25.87652439024393,0
3489,4,0,0,49,0.0,0.0,1.0,49,1600,1200,400,0.75,20,12,8,330.0689448562601,0.4171981292517007,0.29039543382745436,0.207650969105774,134010.95920138905,-953.4288194444243,133057.5303819446,3458,2,617.0,41,8,18,32.60186116700201,0.6516768292682926,41.14583333333334,1035.416666666668,25.254065040650442,0
3490,4,0,0,49,0.0,0.0,1.0,49,650,300,350,0.46153846153846156,10,3,7,331.8668252080853,0.41652494331065765,0.28789584799437007,0.20922038980509744,134088.01020408177,-900.1275510203966,133187.8826530614,3459,3,618.0,41,8,19,32.47844827586207,0.6524390243902438,41.07142857142858,1035.7142857142867,25.26132404181187,0
3491,4,0,0,49,0.0,0.0,1.0,49,950,600,350,0.631578947368421,13,6,7,331.79051591447194,0.4164363662131519,0.2863043541973991,0.2099062349319604,134216.47775140172,-893.6491205278161,133322.8286308739,3460,4,619.0,41,8,19,32.352301739269194,0.6537093495934958,40.94742063492065,1036.2103174603194,25.273422377080962,0
3492,4,0,0,49,0.0,0.0,1.0,49,1200,1000,200,0.8333333333333334,14,10,4,331.0053066786703,0.41615291950113376,0.2840849904512608,0.20988522617319147,134299.56625390626,-909.2261770626577,133390.3400768436,3461,5,620.0,42,7,19,32.28981645944346,0.6530257936507935,40.86724806201551,1036.5310077519398,24.67930970837952,0
3493,4,1,0,50,0.02,0.0,1.0,50,1100,900,200,0.8181818181818182,13,9,4,343.39161546191167,0.41822278911564625,0.2918795250506807,0.2047895074594092,132015.40577168344,-926.5748246240781,131088.83094705935,3462,0,608.58,41,9,18,34.257952022396,0.6318597560975611,43.08035714285713,1027.6785714285695,25.065331010452915,5
3494,4,0,1,49,0.0,0.02,0.98,50,1150,700,450,0.6086956521739131,16,7,9,345.6705327202497,0.4177976190476191,0.29792724114638625,0.20670419680207425,132117.3776947121,-866.1831341332886,131251.19456057882,3463,1,609.58,41,9,18,34.09676654122036,0.6328760162601625,42.98115079365079,1028.0753968253964,25.075009678668206,0
3495,4,1,0,50,0.02,0.0,1.0,50,1200,900,300,0.75,15,9,6,345.3075124773486,0.4209098639455782,0.3047991696938248,0.20833048733370393,132452.98603121116,-851.7046222732504,131601.2814089379,3464,0,600.7,38,12,19,33.768595398719945,0.6411732456140351,42.65491452991453,1029.3803418803416,27.088956365272146,0
3496,4,0,1,49,0.0,0.02,0.98,50,1100,700,400,0.6363636363636364,15,7,8,345.4272495647226,0.4204421768707483,0.30175601861217927,0.208989827980223,132558.85959201376,-842.111545138899,131716.74804687485,3465,1,601.7,39,11,19,33.6591307572999,0.6404914529914532,42.55208333333333,1029.7916666666656,26.404914529914503,0
3497,4,0,0,49,0.0,0.0,1.0,49,1600,1200,400,0.75,20,12,8,352.41778289748106,0.4206172052154195,0.3158963941086852,0.20713749687317604,131461.62245008672,-530.9814453125042,130930.64100477422,3466,2,611.8367346938776,39,10,17,34.58449720670392,0.6295405982905983,43.619791666666664,1025.5208333333328,26.29540598290597,3
3498,4,0,0,49,0.0,0.0,1.0,49,1550,1200,350,0.7741935483870968,19,12,7,354.5300327098467,0.4191468253968254,0.32051505133112945,0.20940227111854984,131648.63281250012,-465.3211805555411,131183.31163194458,3467,3,612.8367346938776,39,10,16,34.341588848288005,0.6314102564102564,43.43750000000001,1026.250000000001,26.314102564102587,0
3499,4,0,0,49,0.0,0.0,1.0,49,1050,500,550,0.47619047619047616,16,5,11,355.38591464609993,0.41916454081632654,0.3234903053975797,0.21020244915502234,131702.08875868065,-438.9865451388788,131263.10221354177,3468,4,613.8367346938776,39,10,16,34.26569582572221,0.6319444444444444,43.38541666666667,1026.4583333333342,26.319444444444464,0
3500,4,1,0,50,0.02,0.0,1.0,50,950,600,350,0.631578947368421,13,6,7,348.9964098900235,0.4210289115646258,0.325549075812988,0.20879933050605373,132136.6572993093,-776.95619753454,131359.70110177476,3469,0,602.54,40,10,17,33.99187835656156,0.6346354166666668,42.96239837398374,1028.1504065040651,25.70376016260163,0
3501,4,0,0,50,0.0,0.0,1.0,50,1250,500,750,0.4,20,5,15,346.1843256417067,0.4209438775510204,0.3225138339920952,0.2075465269842459,132215.03404058426,-845.8455201930132,131369.18852039124,3470,1,603.54,40,10,17,33.98530138339921,0.6354166666666667,42.886178861788615,1028.4552845528451,25.711382113821127,0
3502,4,0,1,49,0.0,0.02,0.98,50,1700,1300,400,0.7647058823529411,21,13,8,345.59494083807306,0.42017857142857146,0.31563894923958125,0.2080555511846807,132371.85723610286,-850.5911659726348,131521.26607013022,3471,2,604.54,40,10,18,33.84274804134571,0.6369791666666667,42.733739837398375,1029.0650406504067,25.726626016260166,0
3503,4,0,0,49,0.0,0.0,1.0,49,1300,800,500,0.6153846153846154,18,8,10,351.004175739773,0.419890873015873,0.32549833286880725,0.21221261634175276,132532.04345703128,-496.13728348959353,132035.90617354168,3472,3,614.8367346938776,39,10,18,33.542509694823806,0.640224358974359,42.578125,1029.6875000000002,26.402243589743595,0
3504,4,0,0,49,0.0,0.0,1.0,49,1100,600,500,0.5454545454545454,16,6,10,350.94678522428546,0.41969600340136054,0.32240274750676967,0.21263246398883182,132612.5,-492.0138888888878,132120.48611111112,3473,4,615.8367346938776,39,10,18,33.46312028047464,0.6410256410256411,42.5,1030.0,26.41025641025641,0
3505,4,0,0,49,0.0,0.0,1.0,49,1200,900,300,0.75,15,9,6,350.6835788238918,0.4191468253968254,0.31691754837991004,0.2132337212848654,132746.6484917534,-489.58604600694855,132257.06244574647,3474,5,616.8367346938776,39,10,15,33.33512331951885,0.6423611111111112,42.369791666666664,1030.520833333333,26.423611111111104,0
3506,4,0,0,49,0.0,0.0,1.0,49,1600,1300,300,0.8125,19,13,6,348.1380161276302,0.41877480158730157,0.31217725570422195,0.2121412443102851,132827.170138889,-551.5624999999892,132275.607638889,3475,6,617.8367346938776,39,10,15,33.319859876044184,0.6431623931623931,42.29166666666667,1030.8333333333342,26.431623931623953,0
3507,4,0,0,49,0.0,0.0,1.0,49,1050,500,550,0.47619047619047616,16,5,11,347.3823220435516,0.4186685090702948,0.30966299826993526,0.21183258418145592,132854.01611328125,-569.7726779513895,132284.24343532987,3476,7,618.8367346938776,39,10,15,33.31238843420565,0.6434294871794872,42.265625,1030.9375,26.434294871794872,0
3508,4,0,1,48,0.0,0.02040816326530612,0.9795918367346939,49,1250,900,350,0.72,16,9,7,346.26812118343656,0.4189342403628118,0.30959078572355936,0.2120651332145685,133015.14892578125,-588.2188585069446,132426.9300672743,3477,8,619.8367346938776,39,10,15,33.17944478104279,0.6450320512820513,42.109375,1031.5625,26.450320512820515,0
3509,4,0,0,48,0.0,0.0,1.0,48,1200,900,300,0.75,15,9,6,347.8961288219916,0.41839354314420807,0.3023199562510519,0.21336911182550022,133068.8815646702,-341.1702473958228,132727.7113172744,3478,9,623.5,39,9,15,33.08356469796399,0.6455662393162394,42.05729166666667,1031.770833333334,26.45566239316241,0
3510,4,2,2,48,0.04,0.04,0.96,50,1300,1000,300,0.7692307692307693,16,10,6,337.08103618230416,0.42293367346938776,0.28815554488718265,0.20884586507071354,133446.5951455812,-1003.5366866654213,132443.0584589158,3479,0,599.52,41,9,15,32.98437750040005,0.6460873983739838,41.691468253968246,1033.2341269841256,25.20083236546648,0
3511,4,0,0,48,0.0,0.0,1.0,48,1650,1200,450,0.7272727272727273,21,12,9,349.9470053845399,0.41835660460992913,0.2971925043735706,0.21509149685794177,133149.50086805562,-280.94618055554565,132868.5546875001,3480,11,625.5,39,9,16,32.94980487148434,0.6463675213675213,41.97916666666667,1032.083333333334,26.46367521367523,0
3512,4,0,0,48,0.0,0.0,1.0,48,1100,800,300,0.7272727272727273,14,8,6,337.62211507269836,0.4181257387706856,0.26507369185129104,0.19571705704708253,130931.13864100722,-758.9504086292784,130172.18823237794,3481,12,626.5,42,6,16,35.49911632897811,0.6195436507936507,44.13759689922481,1023.4496124031012,24.367847914359555,4
3513,4,0,0,48,0.0,0.0,1.0,48,900,700,200,0.7777777777777778,11,7,4,338.57853632198135,0.4179779846335698,0.2670666098699983,0.19652437679700088,130980.72907277223,-730.547292830941,130250.18177994128,3482,13,627.5,42,6,16,35.42455509276789,0.6200396825396824,44.089147286821714,1023.6434108527145,24.37246216315987,0
3514,4,1,0,49,0.02040816326530612,0.0,1.0,49,1050,600,450,0.5714285714285714,15,6,9,333.5533628225378,0.4173929988662131,0.27628236917977,0.1952432691091579,131303.86002245478,-1040.6311875860742,130263.22883486871,3483,0,615.6734693877551,43,6,17,35.227158982414,0.6218507751937984,43.77367424242425,1024.9053030303041,23.835007047216376,0
3515,4,0,0,49,0.0,0.0,1.0,49,1400,800,600,0.5714285714285714,20,8,12,334.53710325193026,0.4169501133786848,0.2754569035971901,0.19672608494985536,131480.69905045364,-1002.9610774664426,130477.73797298719,3484,1,616.6734693877551,41,8,17,35.02369897465661,0.6265243902439024,43.60119047619048,1025.595238095239,25.0145180023229,0
3516,4,0,0,49,0.0,0.0,1.0,49,1550,1000,550,0.6451612903225806,21,10,11,334.6023242668196,0.4167198129251701,0.2685756116233595,0.19742109754088505,131607.91175555866,-992.7373669375206,130615.17438862113,3485,2,617.6734693877551,41,8,15,34.893869444713005,0.6277947154471545,43.47718253968254,1026.0912698412694,25.026616337591935,0
3517,4,0,0,49,0.0,0.0,1.0,49,1400,1100,300,0.7857142857142857,17,11,6,339.91377802265794,0.41675524376417233,0.27522574143157863,0.19354274299657473,130236.65229030345,-933.0416256901667,129303.61066461328,3486,3,618.6734693877551,40,9,18,36.1430538961901,0.615625,44.81707317073171,1020.7317073170736,25.51829268292684,6
3518,4,0,0,49,0.0,0.0,1.0,49,1100,600,500,0.5454545454545454,16,6,10,339.01118492396165,0.4160643424036281,0.2733032524509227,0.19342865040706256,130317.12420784915,-964.2022973592184,129352.92191048992,3487,4,619.6734693877551,38,11,18,36.08458895748316,0.6197916666666667,44.73824786324785,1021.0470085470068,26.869658119658073,0
3519,4,1,0,50,0.02,0.0,1.0,50,900,600,300,0.6666666666666666,12,6,6,337.30754578464934,0.41703231292517007,0.2861585490116163,0.19404081209440485,130635.03146701382,-1187.1636284722317,129447.86783854158,3488,0,608.26,39,11,14,35.806416004347525,0.6212606837606838,44.42708333333333,1022.2916666666661,26.21260683760682,0
3520,4,2,2,50,0.038461538461538464,0.038461538461538464,0.9615384615384616,52,1650,1400,250,0.8484848484848485,19,14,5,326.04711313113984,0.42142722473604827,0.28501822274228106,0.18958491575360498,131048.63596190765,-1854.3941129692864,129194.24184893837,3489,0,585.8269230769231,41,11,14,35.67675532086684,0.6222052845528456,44.02281746031745,1023.9087301587281,24.973383662408,0
3521,4,0,0,50,0.0,0.0,1.0,50,800,700,100,0.875,9,7,2,340.84156756297534,0.41631802721088434,0.2839218081857058,0.19715817883413095,130848.09570312499,-1080.3059895833344,129767.78971354166,3490,2,610.26,39,11,17,35.50066177967827,0.6233974358974359,44.21875,1023.1249999999999,26.233974358974358,0
3522,4,2,3,49,0.038461538461538464,0.057692307692307696,0.9423076923076923,52,1850,1600,250,0.8648648648648649,21,16,5,317.27057932484803,0.42126225490196073,0.2651624710205971,0.18423832909696714,130997.85175933794,-2085.0104176508635,128912.84134168708,3491,0,587.75,41,11,18,35.95259149788417,0.6216971544715446,44.07242063492063,1023.710317460317,24.968544328300414,3
3523,4,1,2,48,0.02,0.04,0.96,50,850,500,350,0.5882352941176471,12,5,7,293.8739949454064,0.41914965986394553,0.1295564409030543,0.16995938417349557,130841.14521798215,-2286.6873816888187,128554.45783629332,3492,0,607.04,45,5,14,36.70899734395749,0.6145833333333333,44.225543478260875,1023.0978260869574,22.73550724637683,5
3524,4,0,0,48,0.0,0.0,1.0,48,1000,700,300,0.7,13,7,6,306.6387115473192,0.4150044326241135,0.13458198239925911,0.17635401657716096,130625.35085406624,-1589.0421437385214,129036.30871032772,3493,5,633.3125,43,5,15,36.599988420565076,0.6150678294573644,44.43655303030303,1022.253787878788,23.77334390415786,0
3525,4,0,0,48,0.0,0.0,1.0,48,1000,500,500,0.5,15,5,10,310.3076735591862,0.4138962765957446,0.13552178810604,0.1791359263555729,130770.59771184862,-1484.1760108184071,129286.42170103021,3494,6,634.3125,43,5,15,36.3597699287103,0.6165213178294573,44.29450757575758,1022.8219696969697,23.78655743481325,0
3526,4,1,1,48,0.02040816326530612,0.02040816326530612,0.9795918367346939,49,1100,500,600,0.45454545454545453,17,5,12,314.0663717762267,0.4158517573696145,0.12481716235982421,0.1804342096675184,130584.26852352619,-1453.944051741933,129130.32447178426,3495,0,622.3469387755102,42,7,13,36.45161800025281,0.6160714285714286,44.47674418604651,1022.0930232558137,24.33554817275747,6
3527,4,0,0,48,0.0,0.0,1.0,48,1500,1000,500,0.6666666666666666,20,10,10,319.4784705157332,0.41367464539007087,0.1281495776288959,0.18310009837738114,130490.5510381237,-1262.2156675169952,129228.3353706067,3496,8,636.3125,41,7,13,36.407964365472374,0.6166158536585366,44.56845238095239,1021.7261904761914,24.92015098722418,0
3528,4,0,0,48,0.0,0.0,1.0,48,1150,900,250,0.782608695652174,14,9,5,321.36411078498656,0.4134899527186761,0.1270748398369248,0.1845425345210106,130566.58340419491,-1208.1172052154307,129358.46619897948,3497,9,637.3125,41,7,13,36.283003300330016,0.6173780487804879,44.49404761904761,1022.0238095238087,24.927409988385577,0
3529,4,0,0,48,0.0,0.0,1.0,48,900,500,400,0.5555555555555556,13,5,8,322.0867390022529,0.4135176566193854,0.12943438804231766,0.18507862085556115,130591.9324471687,-1187.614067617788,129404.31837955091,3498,10,638.3125,41,7,13,36.23893930570384,0.6176321138211381,44.46924603174603,1022.123015873016,24.929829655439416,0
3530,4,0,0,48,0.0,0.0,1.0,48,950,700,250,0.7368421052631579,12,7,5,320.60311258435985,0.412963578605201,0.1340758075468036,0.18495229365596894,130744.07837498424,-1216.6083042013126,129527.47007078292,3499,11,639.3125,41,7,13,36.12327011995989,0.6191565040650406,44.320436507936506,1022.7182539682539,24.94434765776229,0
3531,4,0,2,46,0.0,0.041666666666666664,0.9583333333333334,48,1300,900,400,0.6923076923076923,17,9,8,314.1436312411473,0.41334219858156024,0.12953179526948455,0.182062117970993,130921.69390904515,-1374.3567334341083,129547.33717561104,3500,12,640.3125,41,7,13,36.10936086338374,0.6209349593495934,44.1468253968254,1023.4126984126988,24.961285327138995,0
3532,4,0,0,46,0.0,0.0,1.0,46,1050,700,350,0.6666666666666666,14,7,7,324.56405907599094,0.4127113526570048,0.13694471616015091,0.18760675881118968,130820.1845553039,-708.0939783320432,130112.09057697185,3501,18,661.804347826087,41,5,13,35.94517713990174,0.6199186991869917,44.24603174603176,1023.0158730158754,24.95160665892379,0
3533,4,0,0,46,0.0,0.0,1.0,46,1200,700,500,0.5833333333333334,17,7,10,324.69844076626146,0.4119061996779388,0.14215345220108433,0.18810423658433845,130906.34694617221,-698.9826520341193,130207.3642941381,3502,19,662.804347826087,42,4,14,35.85479594735348,0.6192956349206348,44.16182170542636,1023.3527131782954,24.365540789959415,0
3534,4,1,0,47,0.02127659574468085,0.0,1.0,47,950,400,550,0.42105263157894735,15,4,11,319.7452041425487,0.4151441566450817,0.14789939111360306,0.1862167142057978,131109.82090973668,-1015.6527096246439,130094.16820011204,3503,0,649.6808510638298,43,4,16,35.77641007859453,0.6199127906976744,43.96306818181819,1024.1477272727282,23.817389006342516,0
3535,4,0,0,47,0.0,0.0,1.0,47,1000,600,400,0.6,14,6,8,321.70726690241924,0.4154525131051496,0.14589890469595845,0.18747768312589275,131134.0679522499,-962.6434802571049,130171.4244719928,3504,1,650.6808510638298,43,4,16,35.70173816568047,0.6201550387596899,43.939393939393945,1024.2424242424252,23.819591261451748,0
3536,4,1,0,48,0.020833333333333332,0.0,1.0,48,1500,1000,500,0.6666666666666666,20,10,10,319.1202133916166,0.4169252364066194,0.1489646806589935,0.187785081744788,131506.13667052475,-1206.3162799076533,130299.8203906171,3505,0,638.1041666666666,41,7,19,35.39339313924622,0.6267784552845528,43.57638888888889,1025.694444444445,25.01693766937671,0
3537,4,0,0,48,0.0,0.0,1.0,48,1350,1100,250,0.8148148148148148,16,11,5,318.7065032997759,0.4166112588652482,0.1471628634048865,0.18791691317709702,131582.46429358778,-1212.7625818846072,130369.70171170316,3506,1,639.1041666666666,41,7,13,35.32722555276221,0.627540650406504,43.50198412698413,1025.9920634920632,25.024196670538124,0
3538,4,0,2,46,0.0,0.041666666666666664,0.9583333333333334,48,1400,1000,400,0.7142857142857143,18,10,8,322.0425132609572,0.41659278959810875,0.1302459386281587,0.18979952377294718,131565.50068587108,-1123.5435738081244,130441.95711206296,3507,2,640.1041666666666,44,4,10,35.25872442839951,0.6231060606060606,43.51851851851852,1025.925925925926,23.316498316498322,5
3539,4,0,0,46,0.0,0.0,1.0,46,1050,700,350,0.6666666666666666,14,7,7,330.8579772717013,0.41067834138486314,0.15848368332840312,0.19454449063576051,131477.14981070848,-499.9472312361078,130977.20257947237,3508,25,668.804347826087,42,4,16,35.12160651297554,0.625,43.604651162790695,1025.581395348837,24.418604651162788,0
3540,4,0,0,46,0.0,0.0,1.0,46,800,400,400,0.5,12,4,8,331.5948870713865,0.4102053140096618,0.1561615763384958,0.19535865717444453,131551.6939054894,-475.62618307193003,131076.06772241747,3509,26,669.804347826087,42,4,16,35.02762822329273,0.6257440476190477,43.531976744186046,1025.8720930232555,24.425526024363226,0
3541,4,0,0,46,0.0,0.0,1.0,46,700,400,300,0.5714285714285714,10,4,6,334.3344065832074,0.4098027375201288,0.1538324171876866,0.19748665365994114,131651.1188949731,-396.9002576467904,131254.2186373263,3510,27,670.804347826087,42,4,11,34.85722940861738,0.6267361111111112,43.43507751937984,1026.2596899224793,24.434754521963793,0
3542,4,0,0,46,0.0,0.0,1.0,46,1250,900,350,0.72,16,9,7,337.37739556747556,0.41000402576489536,0.1553700596149037,0.20006649473019233,131800.32680014716,-306.7098018448451,131493.6169983023,3511,28,671.804347826087,42,4,11,34.62890440690762,0.6282242063492064,43.28972868217054,1026.8410852713173,24.448597268364697,0
3543,4,0,0,46,0.0,0.0,1.0,46,900,500,400,0.5555555555555556,13,5,8,336.4621098279303,0.4099537037037037,0.1544710944838934,0.19978498050791219,131850.0815474581,-327.4886763115154,131522.5928711466,3512,29,672.804347826087,42,4,11,34.60232097367677,0.6287202380952381,43.241279069767444,1027.0348837209303,24.45321151716501,0
3544,4,0,0,46,0.0,0.0,1.0,46,1050,400,650,0.38095238095238093,17,4,13,336.83527037831584,0.4092391304347826,0.1581314680268311,0.20066298916245306,131974.50949462186,-309.2660822666735,131665.2434123552,3513,30,673.804347826087,42,4,13,34.46753583553377,0.6299603174603174,43.1201550387597,1027.5193798449625,24.464747139165773,0
3545,4,0,0,46,0.0,0.0,1.0,46,1400,1100,300,0.7857142857142857,17,11,6,335.08639997361036,0.4084943639291465,0.15897763787789376,0.20014620106531883,132074.09410492177,-348.75345532117626,131725.34064960058,3514,31,674.804347826087,42,4,14,34.41231460532933,0.6309523809523809,43.0232558139535,1027.9069767441874,24.47397563676637,0
3546,4,1,1,46,0.02127659574468085,0.02127659574468085,0.9787234042553191,47,1250,900,350,0.72,16,9,7,327.3802941161513,0.40999845821769965,0.16066758812921367,0.1971020904012411,132374.1812414268,-732.6603223593834,131641.5209190674,3515,0,661.4255319148937,44,3,14,34.30901715553956,0.631155303030303,42.73148148148149,1029.0740740740755,23.38804713804717,0
3547,4,0,0,46,0.0,0.0,1.0,46,1150,900,250,0.782608695652174,14,9,5,335.7070786068556,0.40753824476650563,0.16346561672228477,0.20198190011860995,132349.2784736572,-313.88207357665715,132035.39640008056,3516,33,676.804347826087,43,3,16,34.11980796367877,0.632267441860465,42.75568181818183,1028.977272727274,23.92970401691335,0
3548,4,0,0,46,0.0,0.0,1.0,46,1600,1200,400,0.75,20,12,8,333.2514989619375,0.40678341384863126,0.17233964194373375,0.2012960304986122,132497.74770333822,-368.9764262403087,132128.7712770979,3517,34,677.804347826087,42,4,17,34.03392156862744,0.6351686507936507,42.611434108527135,1029.5542635658921,24.51319675156886,0
3549,4,0,0,46,0.0,0.0,1.0,46,1850,1400,450,0.7567567567567568,23,14,9,332.92146309138457,0.4066727053140096,0.16796560339222855,0.2021675566562361,132697.34883908727,-364.4408952286411,132332.90794385862,3518,35,678.804347826087,42,4,12,33.842165898617516,0.6371527777777777,42.41763565891473,1030.3294573643416,24.531653746770036,0
3550,4,0,0,46,0.0,0.0,1.0,46,1200,900,300,0.75,15,9,6,337.0826067591939,0.40611916264090175,0.16953496737904072,0.20510358154981614,132772.23799651465,-248.95758217655134,132523.2804143381,3519,36,679.804347826087,42,4,13,33.65985802933433,0.6378968253968254,42.34496124031008,1030.6201550387598,24.53857511997047,0
3551,4,0,0,46,0.0,0.0,1.0,46,1050,800,250,0.7619047619047619,13,8,5,340.5156084963924,0.40574677938808373,0.17215781149748421,0.20760719534631056,132847.1482802265,-152.694493269644,132694.45378695687,3520,37,680.804347826087,42,4,13,33.49625591377636,0.638640873015873,42.27228682170542,1030.9108527131777,24.545496493170898,0
3552,4,0,0,46,0.0,0.0,1.0,46,750,600,150,0.8,9,6,3,340.8813386850587,0.40573671497584546,0.17174321673749615,0.20796889011519623,132872.12306952692,-141.2745628267644,132730.84850670016,3521,38,681.804347826087,42,4,14,33.461779448621556,0.638888888888889,42.24806201550387,1031.0077519379834,24.54780361757103,0
3553,4,0,0,46,0.0,0.0,1.0,46,750,500,250,0.6666666666666666,10,5,5,343.38303356564853,0.40528381642512074,0.1871496800539787,0.20381778012785792,131835.77609591978,-77.77530277490598,131758.00079314486,3522,39,682.804347826087,39,7,19,34.439027791865286,0.6332799145299146,43.255208333333314,1026.9791666666638,26.33279914529907,5
3554,4,0,0,46,0.0,0.0,1.0,46,1600,1200,400,0.75,20,12,8,343.5302072145278,0.4050523349436393,0.1834879569845087,0.20476891203452044,131996.29041883667,-131.05740017362052,131865.23301866304,3523,40,683.804347826087,39,7,19,34.27363152559555,0.6348824786324787,43.09895833333333,1027.6041666666656,26.34882478632476,0
3555,4,0,0,46,0.0,0.0,1.0,46,1250,1000,250,0.8,15,10,5,336.87707162428785,0.4050523349436393,0.1268459529794601,0.192863598448301,130448.74267578153,-410.35156249997135,130038.39111328156,3524,41,684.804347826087,39,7,21,36.005850412970325,0.6193910256410255,44.609375000000014,1021.5625000000022,26.193910256410312,3
3556,4,0,0,46,0.0,0.0,1.0,46,850,400,450,0.47058823529411764,13,4,9,348.05480984223357,0.40518317230273754,0.1647866056757119,0.19696280857546034,129996.88042534713,-144.88389756945492,129851.99652777768,3525,42,685.804347826087,39,7,17,36.17849846782431,0.6148504273504274,45.05208333333333,1019.7916666666658,26.14850427350425,2
3557,4,0,0,46,0.0,0.0,1.0,46,1300,1000,300,0.7692307692307693,16,10,6,349.2001883999538,0.40575684380032206,0.17663016415305965,0.19843345171046578,130158.86423631746,-109.70001735080359,130049.16421896666,3526,43,686.804347826087,40,6,19,35.98496165720546,0.6148437500000001,44.89329268292682,1020.4268292682909,25.510670731707272,0
3558,4,0,0,46,0.0,0.0,1.0,46,1150,700,450,0.6086956521739131,16,7,9,348.6880466472301,0.40578703703703706,0.17204968944099353,0.198671096345515,130262.58680555565,-115.71598833365545,130146.87081722199,3527,44,687.804347826087,39,7,20,35.892857142857146,0.6175213675213675,44.79166666666667,1020.8333333333342,26.175213675213698,0
3559,4,0,0,46,0.0,0.0,1.0,46,900,700,200,0.7777777777777778,11,7,4,346.6495957478753,0.4049114331723027,0.16915035890717522,0.19792573692701262,130344.39718934908,-163.23348126233043,130181.16370808675,3528,45,688.804347826087,38,8,20,35.86197426239799,0.6200657894736842,44.71153846153846,1021.1538461538458,26.87246963562752,0
3560,4,0,0,46,0.0,0.0,1.0,46,1700,1200,500,0.7058823529411765,22,12,10,346.8643056801692,0.40424718196457327,0.170154568150503,0.1984661655660141,130426.23325525963,-151.9590318869192,130274.27422337272,3529,46,689.804347826087,38,8,20,35.773585399016845,0.6208881578947368,44.631410256410255,1021.4743589743584,26.880904183535748,0
3561,4,1,1,46,0.02127659574468085,0.02127659574468085,0.9787234042553191,47,500,100,400,0.2,9,1,8,341.89043405913145,0.4062596361393771,0.17374621996293205,0.1968125871138048,130661.65500217004,-465.6060112847278,130196.0489908853,3530,0,676.1063829787234,39,8,16,35.66235778570218,0.6215277777777778,44.401041666666664,1022.3958333333325,26.215277777777754,0
3562,4,0,0,46,0.0,0.0,1.0,46,1400,1000,400,0.7142857142857143,18,10,8,343.3259482725397,0.4045390499194847,0.16745029234711706,0.19772194422266873,130677.89019639444,-226.9778860136065,130450.91231038084,3531,48,691.804347826087,40,6,16,35.609241957393245,0.6200520833333333,44.38516260162602,1022.4593495934967,25.561483739837417,0
3563,4,0,0,46,0.0,0.0,1.0,46,800,600,200,0.75,10,6,4,343.5088663583654,0.4044283413848631,0.16591032740492695,0.1981663628029317,130744.0783749842,-217.64997086798144,130526.42840411622,3532,49,692.804347826087,41,5,17,35.537616807320475,0.6191565040650406,44.320436507936506,1022.7182539682535,24.944347657762282,0
3564,4,0,0,46,0.0,0.0,1.0,46,800,600,200,0.75,10,6,4,344.1112155874284,0.4043679549114332,0.16057614070885684,0.1990363974398849,130845.55820302652,-194.91518250818945,130650.64302051833,3533,50,693.804347826087,41,5,17,35.419595817576536,0.6201727642276422,44.22123015873016,1023.1150793650788,24.954026325977534,0
3565,4,1,0,47,0.02127659574468085,0.0,1.0,47,950,400,550,0.42105263157894735,15,4,11,335.27745439585453,0.4084759481961147,0.16555457635654047,0.19538582687206688,131134.06795224975,-606.7407024793425,130527.32724977042,3534,0,680.0212765957447,43,4,18,35.35425912228798,0.6201550387596899,43.93939393939394,1024.242424242424,23.81959126145172,0
3566,4,0,0,47,0.0,0.0,1.0,47,1100,700,400,0.6363636363636364,15,7,8,336.2482875123284,0.40818686401480114,0.17007048617386666,0.19645847674822722,131233.23473936884,-574.6099108367723,130658.62482853206,3535,1,681.0212765957447,44,3,20,35.229343635158756,0.6197916666666667,43.84259259259259,1024.6296296296284,23.28703703703701,0
3567,4,0,0,47,0.0,0.0,1.0,47,1000,500,500,0.5,15,5,10,332.8045475576705,0.40830249768732657,0.17125064867669937,0.19492837785520717,131328.12500000015,-658.611968449918,130669.51303155023,3536,2,682.0212765957447,42,5,20,35.22188346883469,0.6235119047619047,43.75000000000001,1025.0000000000011,24.404761904761934,0
3568,4,0,0,47,0.0,0.0,1.0,47,1400,800,600,0.5714285714285714,20,8,12,332.59058280937876,0.40801341350601295,0.1590558352518534,0.19560047562425686,131484.4214753122,-653.9039262343914,130830.51754907782,3537,3,683.0212765957447,40,7,20,35.06985731272297,0.628125,43.59756097560975,1025.6097560975602,25.640243902439003,0
3569,4,0,0,47,0.0,0.0,1.0,47,1400,1100,300,0.7857142857142857,17,11,6,330.5094367364429,0.40785923527597906,0.1567196884123716,0.1947463296462426,131557.0192920919,-703.8327310090691,130853.18656108282,3538,4,684.0212765957447,41,6,15,35.050103955130055,0.6272865853658536,43.526785714285715,1025.8928571428576,25.02177700348433,0
3570,4,0,0,47,0.0,0.0,1.0,47,1250,800,450,0.64,17,8,9,329.29260504636295,0.4078977798334875,0.15656279508970705,0.19438175515278602,131626.2591265548,-731.2892479418413,130894.96987861296,3539,5,685.0212765957447,42,5,15,35.011606861819324,0.6264880952380953,43.45930232558139,1026.1627906976737,24.43244739756366,0
3571,4,0,0,47,0.0,0.0,1.0,47,1250,700,550,0.56,18,7,11,330.54741045646693,0.4078014184397163,0.16071231302887723,0.19550467442575958,131700.84547390474,-693.3253147346979,131007.52015917005,3540,6,686.0212765957447,42,5,16,34.904339343591694,0.6272321428571428,43.38662790697674,1026.4534883720926,24.43936877076411,0
3572,4,0,0,47,0.0,0.0,1.0,47,1000,700,300,0.7,13,7,6,329.1194079178766,0.4075508788159112,0.15616440506368856,0.19523910609745357,131813.89534550044,-723.4977617079956,131090.39758379245,3541,7,687.0212765957447,43,4,16,34.82724701832041,0.626937984496124,43.27651515151515,1026.893939393939,23.88125440451021,0
3573,4,1,0,48,0.020833333333333332,0.0,1.0,48,850,600,250,0.7058823529411765,11,6,5,324.68955441928426,0.4097406914893617,0.16463963963963968,0.1937663469921535,132040.8950617284,-1025.5401234567867,131015.35493827162,3542,0,673.6875,44,4,17,34.71283783783784,0.6278409090909091,43.05555555555556,1027.7777777777778,23.358585858585858,0
3574,4,0,1,47,0.0,0.020833333333333332,0.9791666666666666,48,1000,600,400,0.6,14,6,8,326.1414336924208,0.4100177304964539,0.16411668017652903,0.1949999105162601,132112.27816358034,-982.5424382715984,131129.73572530874,3543,1,674.6875,44,4,19,34.603823291002435,0.6285511363636364,42.986111111111114,1028.055555555556,23.364898989899004,0
3575,4,1,1,47,0.020833333333333332,0.020833333333333332,0.9791666666666666,48,1200,800,400,0.6666666666666666,16,8,8,325.94125652624984,0.4085309544917258,0.16625018347277232,0.1955130991999773,132234.91589378557,-979.8370713873046,131255.07882239827,3544,0,675.4791666666666,45,3,20,34.48581755467488,0.6284722222222221,42.86684782608696,1028.5326086956532,22.856280193236735,0
3576,4,0,0,47,0.0,0.0,1.0,47,1400,800,600,0.5714285714285714,20,8,12,332.4498475133241,0.4051803885291397,0.1664884996034346,0.19914714166574882,132183.68055555582,-611.1111111110861,131572.56944444473,3545,3,690.8510638297872,44,3,20,34.3699351701783,0.6292613636363635,42.91666666666668,1028.3333333333355,23.37121212121217,0
3577,4,0,0,47,0.0,0.0,1.0,47,850,600,250,0.7058823529411765,11,6,5,329.2235044472631,0.40512257169287696,0.16881493765048639,0.1974819277865124,132234.9158937857,-693.0315158317344,131541.88437795397,3546,4,691.8510638297872,45,2,20,34.401420079260234,0.6284722222222221,42.86684782608697,1028.5326086956545,22.856280193236767,0
3578,4,1,0,48,0.020833333333333332,0.0,1.0,48,1350,800,550,0.5925925925925926,19,8,11,330.40223454034475,0.4058344414893617,0.1762053270397841,0.1999944954380942,132576.73852237643,-838.7673319389171,131737.9711904375,3547,0,678.4166666666666,41,7,22,34.02801191278938,0.6374491869918699,42.534722222222214,1029.8611111111102,25.118563685636833,0
3579,4,1,3,46,0.02040816326530612,0.061224489795918366,0.9387755102040817,49,1500,1200,300,0.8,18,12,6,317.47780838689926,0.4080392573696145,0.1692022263450832,0.19401421623643844,132934.57031249988,-1359.2447916666804,131575.3255208332,3548,0,665.5510204081633,43,6,15,34.002525252525245,0.6380813953488373,42.18749999999999,1031.249999999999,23.982558139534863,0
3580,4,0,0,46,0.0,0.0,1.0,46,1600,1300,300,0.8125,19,13,6,331.7451147446596,0.4026066827697263,0.16849755595575,0.20167238989873193,132738.1395002975,-392.95413609623085,132345.18536420126,3549,7,706.9130434782609,40,6,18,33.83156640368179,0.640625,42.37804878048781,1030.4878048780492,25.76219512195123,0
3581,4,0,1,45,0.0,0.021739130434782608,0.9782608695652174,46,1450,900,550,0.6206896551724138,20,9,11,330.38753176663886,0.40211352657004834,0.1648916823663551,0.20143226077164864,132847.14828022648,-421.7917154918682,132425.35656473463,3550,8,707.9130434782609,42,4,18,33.757284519221734,0.6386408730158731,42.27228682170542,1030.9108527131775,24.545496493170894,0
3582,4,0,0,45,0.0,0.0,1.0,45,1350,1100,250,0.8148148148148148,16,11,5,340.6359972926904,0.39835858585858586,0.1682567178862049,0.2075981611652989,132832.28344868042,49.4914690413176,132881.77491772175,3551,68,724.4666666666667,41,4,20,33.50806386937414,0.639989837398374,42.28670634920635,1030.8531746031747,25.142760356174993,0
3583,4,0,0,45,0.0,0.0,1.0,45,1550,1200,350,0.7741935483870968,19,12,7,339.92449750025503,0.3979587542087542,0.1659259259259258,0.207731637361267,132934.5703125,37.54340277777669,132972.11371527778,3552,69,725.4666666666667,41,4,20,33.423821548821536,0.6410060975609756,42.1875,1031.25,25.152439024390244,0
3584,4,0,0,45,0.0,0.0,1.0,45,1600,1300,300,0.8125,19,13,6,336.0116551549661,0.3971380471380472,0.15534403743229852,0.2061862669773924,133088.07442247728,-56.17116638322386,133031.90325609405,3553,70,726.4666666666667,41,4,20,33.37088981828669,0.6425304878048781,42.038690476190474,1031.8452380952378,25.166957026713117,0
3585,4,0,0,45,0.0,0.0,1.0,45,1400,1000,400,0.7142857142857143,18,10,8,336.0376245236871,0.39684343434343433,0.17957030747459202,0.20107932682237228,132142.8768266563,-117.89710097004001,132024.97972568628,3554,71,727.4666666666667,41,4,17,34.31871542518976,0.633130081300813,42.956349206349195,1028.174603174601,25.077429345721978,2
3586,4,0,0,45,0.0,0.0,1.0,45,1350,800,550,0.5925925925925926,19,8,11,337.34405195411466,0.3959385521885522,0.18327348617377148,0.2023132936650271,132227.50521012687,-78.76752252639847,132148.73768760046,3555,72,728.4666666666667,43,2,18,34.2000621489734,0.6310562015503877,42.87405303030303,1028.503787878788,23.918692741367163,0
3587,4,0,0,45,0.0,0.0,1.0,45,1400,900,500,0.6428571428571429,19,9,10,339.79624371802055,0.3961279461279461,0.1885288823433151,0.20417845087127084,132300.56244260794,-8.95316804407355,132291.60927456387,3556,73,729.4666666666667,43,2,19,34.0635738831615,0.6317829457364341,42.803030303030305,1028.7878787878792,23.925299506694866,0
3588,4,2,2,45,0.0425531914893617,0.0425531914893617,0.9574468085106383,47,800,400,400,0.5,12,4,8,326.466003261957,0.40128738822078325,0.1860442248362162,0.19828514092857785,132704.48022959166,-735.1562646408591,131969.3239649508,3557,0,699.3829787234042,41,6,13,34.00129982668977,0.6387195121951219,42.41071428571428,1030.3571428571415,25.13066202090589,0
3589,4,0,0,45,0.0,0.0,1.0,45,750,600,150,0.8,9,6,3,338.2318668304664,0.3955808080808081,0.1954404424659386,0.20434497382349176,132505.23003472204,-36.5017361111295,132468.72829861092,3558,75,731.4666666666667,39,6,20,33.89821934439498,0.6399572649572651,42.60416666666666,1029.583333333332,26.39957264957261,0
3590,4,0,0,45,0.0,0.0,1.0,45,1150,700,450,0.6086956521739131,16,7,9,334.0348684878552,0.3957491582491583,0.19428659124791792,0.2024986499397665,132633.43578557714,-139.16154405448447,132494.27424152265,3559,76,732.4666666666667,40,5,15,33.87759800052617,0.6395833333333335,42.47967479674796,1030.0813008130065,25.752032520325162,0
3591,4,0,0,45,0.0,0.0,1.0,45,1150,900,250,0.782608695652174,14,9,5,322.09254143893764,0.3957491582491583,0.14059445441851248,0.18121772280958387,129770.27253123123,-623.9894201533652,129146.28311107786,3560,77,733.4666666666667,40,5,15,37.06986834231001,0.6109375000000001,45.27439024390243,1018.9024390243887,25.472560975609717,5
3592,4,1,1,45,0.021739130434782608,0.021739130434782608,0.9782608695652174,46,850,600,250,0.7058823529411765,11,6,5,317.1565547343935,0.39716183574879227,0.13786439789247584,0.17976867121163337,130060.1192444568,-950.1161344167543,129110.00311004005,3561,0,718.5,41,5,16,36.90227257991311,0.6122967479674798,44.99007936507935,1020.0396825396805,24.87901664730928,0
3593,4,2,0,47,0.0425531914893617,0.0,1.0,47,800,500,300,0.625,11,5,6,312.6171007582065,0.40329170521122415,0.14716277608522255,0.1785838199336832,130363.87963750282,-1249.0469104308709,129114.83272707195,3562,0,704.1702127659574,41,6,18,36.711110031733696,0.6153455284552847,44.6924603174603,1021.2301587301561,24.908052651955025,0
3594,4,0,0,47,0.0,0.0,1.0,47,1700,1100,600,0.6470588235294118,23,11,12,315.71299238252334,0.4041011409189022,0.15732536958326615,0.18129739395344202,130566.58340419475,-1155.6866496598907,129410.89675453486,3563,1,705.1702127659574,41,6,15,36.42739273927393,0.6173780487804879,44.494047619047606,1022.0238095238074,24.927409988385545,0
3595,4,1,2,46,0.020833333333333332,0.041666666666666664,0.9583333333333334,48,800,700,100,0.875,9,7,2,309.9547810851152,0.40612994976359335,0.15641678509395307,0.17887220964206593,130757.64607182544,-1494.2084873204865,129263.43758450495,3564,0,691.4583333333334,42,6,15,36.38184904468657,0.6178075396825398,44.30717054263565,1022.7713178294559,24.351698043558475,0
3596,4,2,0,48,0.041666666666666664,0.0,1.0,48,1050,500,550,0.47619047619047616,16,5,11,316.31572367970637,0.4056682180851064,0.18208562054388322,0.18383894039602708,131030.32889399653,-1310.609338381127,129719.7195556154,3565,0,692.375,42,6,17,35.94430247965172,0.6205357142857143,44.040697674418595,1023.8372093023238,24.37707641196009,0
3597,4,1,2,47,0.02040816326530612,0.04081632653061224,0.9591836734693877,49,1250,900,350,0.72,16,9,7,312.65708729565654,0.4083227040816326,0.18185316459516643,0.1825492189666327,131206.82253106328,-1595.4514068239396,129611.37112423935,3566,0,679.2244897959183,43,6,17,35.86023431001018,0.6208817829457366,43.868371212121204,1024.5265151515136,23.826198026779387,0
3598,4,0,0,47,0.0,0.0,1.0,47,1100,700,400,0.6363636363636364,15,7,8,318.7330919966036,0.4059127351218008,0.19275702344973,0.18620352015315347,131228.8220734929,-1034.6063562887175,130194.21571720418,3567,2,704.3829787234042,42,5,18,35.682452241346695,0.6225198412698414,43.84689922480619,1024.6124031007728,24.395533407161256,0
3599,4,0,0,47,0.0,0.0,1.0,47,800,500,300,0.625,11,5,6,320.24588538568327,0.40583564600678385,0.19148936170212827,0.18757259001161447,131328.12499999994,-988.4289931494532,130339.69600685048,3568,3,705.3829787234042,39,8,20,35.54369918699189,0.6282051282051282,43.75,1024.9999999999995,26.28205128205127,0
3600,4,0,0,47,0.0,0.0,1.0,47,1100,700,400,0.6363636363636364,15,7,8,320.06254383265673,0.4043709528214616,0.193315539803119,0.18812034292731364,131461.6224500867,-984.8117404513931,130476.8107096353,3569,4,706.3829787234042,39,8,20,35.41402149991536,0.6295405982905983,43.619791666666664,1025.5208333333326,26.295405982905965,0
3601,4,0,1,46,0.0,0.02127659574468085,0.9787234042553191,47,1500,1100,400,0.7333333333333333,19,11,8,316.5841459970756,0.40419750231267343,0.19355844637446662,0.18695126937301004,131640.81090124926,-1064.9212604930938,130575.88964075617,3570,5,707.3829787234042,40,7,15,35.3230012543738,0.6296875,43.44512195121951,1026.219512195122,25.65548780487805,0
3602,4,0,1,45,0.0,0.021739130434782608,0.9782608695652174,46,1150,800,350,0.6956521739130435,15,8,7,302.2192193530623,0.404579307568438,0.10379973803680231,0.16856239983166718,129428.42306193312,-1364.1969912283212,128064.2260707048,3571,6,720.1086956521739,41,5,16,37.92196792434438,0.6059451219512194,45.61011904761905,1017.5595238095239,24.818524970963995,6
3603,4,0,0,45,0.0,0.0,1.0,45,900,400,500,0.4444444444444444,14,4,10,302.8847860244364,0.40025252525252525,0.1054348179189808,0.1693678904303402,129529.39111118983,-1153.5036178823452,128375.88749330748,3572,7,736.9111111111112,41,4,16,37.80282542312313,0.6069613821138211,45.510912698412696,1017.9563492063492,24.828203639179247,0
3604,4,2,0,47,0.0425531914893617,0.0,1.0,47,1000,700,300,0.7,13,7,6,294.4148773711435,0.4044673142152328,0.1269643125202451,0.16691773994957684,130069.31889921956,-1741.131485307616,128328.18741391195,3573,0,706.5106382978723,43,4,19,37.47292362916202,0.6094961240310077,44.98106060606061,1020.0757575757584,23.722692036645544,0
3605,4,0,0,47,0.0,0.0,1.0,47,650,500,150,0.7692307692307693,8,5,3,295.3693394320265,0.4047178538390379,0.12896294862730984,0.16766645221499746,130117.62242452933,-1713.4487632001903,128404.17366132914,3574,1,707.5106382978723,43,4,20,37.39983602499843,0.6099806201550388,44.93371212121212,1020.265151515151,23.72709654686398,0
3606,4,0,0,47,0.0,0.0,1.0,47,850,400,450,0.47058823529411764,13,4,9,299.24189880281875,0.40448658649398705,0.12996156116552404,0.17018099965160827,130190.09452658682,-1608.3337817091417,128581.76074487768,3575,2,708.5106382978723,43,4,20,37.22791206581919,0.6107073643410853,44.86268939393939,1020.5492424242418,23.73370331219167,0
3607,4,0,0,47,0.0,0.0,1.0,47,1500,1200,300,0.8,18,12,6,301.151121110454,0.4049105766265803,0.13688912814145615,0.171820913220295,130315.76063368046,-1550.9718097164919,128764.78882396397,3576,3,709.5106382978723,39,8,20,37.052387267904535,0.6180555555555556,44.73958333333333,1021.0416666666658,26.180555555555536,0
3608,4,0,0,47,0.0,0.0,1.0,47,1350,900,450,0.6666666666666666,18,9,9,301.26637036330624,0.4047178538390379,0.135498662756522,0.17271314008729782,130501.95448133662,-1536.8299696180761,128965.12451171855,3577,4,710.5106382978723,39,8,12,36.86166190913106,0.6199252136752138,44.55729166666666,1021.7708333333319,26.1992521367521,0
3609,4,0,0,47,0.0,0.0,1.0,47,1050,900,150,0.8571428571428571,12,9,3,299.85828978185754,0.4047949429540549,0.13562203467746858,0.1722605116709357,130581.79253472203,-1568.7934027777978,129012.99913194423,3578,5,711.5106382978723,39,8,13,36.81716265796982,0.6207264957264957,44.47916666666666,1022.0833333333318,26.20726495726492,0
3610,4,0,0,47,0.0,0.0,1.0,47,1150,800,350,0.6956521739130435,15,8,7,301.7970451917297,0.4048527597903176,0.14193643459906502,0.17409185603363098,130741.54188368036,-1508.5177951389105,129233.02408854145,3579,6,712.5106382978723,39,8,14,36.606657839342716,0.6223290598290598,44.32291666666666,1022.7083333333318,26.223290598290557,0
3611,4,0,1,46,0.0,0.02127659574468085,0.9787234042553191,47,1700,1200,500,0.7058823529411765,22,12,10,303.31781271099777,0.40462149244526674,0.12464107335852992,0.1657041646780772,128607.98306439629,-1596.8686419190715,127011.11442247721,3580,7,713.5106382978723,40,7,12,38.726079551147166,0.59921875,46.41768292682927,1014.3292682926838,25.358231707317096,5
3612,4,0,1,45,0.0,0.021739130434782608,0.9782608695652174,46,900,700,200,0.7777777777777778,11,7,4,310.68923608377315,0.40208333333333335,0.1289205920976224,0.16933085240982368,128513.93771701398,-1214.4205729166567,127299.51714409732,3581,8,729.8695652173913,39,7,13,38.63476816656392,0.5998931623931624,46.51041666666667,1013.9583333333342,25.998931623931647,0
3613,4,3,3,45,0.0625,0.0625,0.9375,48,1400,1100,300,0.7857142857142857,17,11,6,290.6904939449032,0.41238179669030733,0.13679781082197473,0.16110057960781715,129176.76150959969,-2089.9086781143033,127086.85283148539,3582,0,695.5416666666666,42,6,14,38.46987894385665,0.6019345238095237,45.85755813953488,1016.5697674418598,24.20404208194904,0
3614,4,1,1,45,0.021739130434782608,0.021739130434782608,0.9782608695652174,46,1200,900,300,0.75,15,9,6,305.74133396881984,0.4044585346215781,0.14700389237188483,0.16900747349393563,129075.34490937598,-1307.2663729843594,127768.07853639162,3583,0,726.7608695652174,41,5,15,38.19020713332683,0.6023882113821137,45.95734126984128,1016.1706349206364,24.784649632210645,0
3615,4,2,1,46,0.0425531914893617,0.02127659574468085,0.9787234042553191,47,1050,600,450,0.5714285714285714,15,6,9,301.4792671526088,0.40870721554116557,0.15901992529607467,0.1682839119992323,129459.81744497338,-1593.9867984492357,127865.83064652415,3584,0,712.2553191489362,40,7,15,37.90901071832766,0.6078124999999999,45.57926829268293,1017.6829268292695,25.44207317073174,0
3616,4,1,1,46,0.02127659574468085,0.02127659574468085,0.9787234042553191,47,1050,600,450,0.5714285714285714,15,6,9,303.2426165632804,0.40818686401480114,0.16021998556079353,0.169937976396201,129614.99851279019,-1539.0417410271477,128075.95677176304,3585,0,713.2340425531914,40,7,16,37.7070858283433,0.6093749999999998,45.42682926829269,1018.2926829268307,25.457317073170767,0
3617,4,1,2,45,0.02127659574468085,0.0425531914893617,0.9574468085106383,47,1300,800,500,0.6153846153846154,18,8,10,299.6677500133196,0.4085144927536232,0.14847025935704283,0.16908765136665915,129883.08930342984,-1615.645372732414,128267.44393069742,3586,0,670.1489361702128,41,6,16,37.52706812652068,0.6105182926829267,45.16369047619048,1019.3452380952391,24.86207897793266,0
3618,4,3,1,47,0.0625,0.020833333333333332,0.9791666666666666,48,1500,900,600,0.6,21,9,12,285.9845025428491,0.4134068410165485,0.14883833111912415,0.16325594191747275,130336.78583769023,-2144.5862209754414,128192.19961671479,3587,0,650.5833333333334,42,6,18,37.418351047004485,0.6135912698412698,44.71899224806202,1021.1240310077534,24.312476928756034,0
3619,4,1,0,48,0.020833333333333332,0.0,1.0,48,1550,1200,350,0.7741935483870968,19,12,7,290.68752187908876,0.41237256205673756,0.16158030719635974,0.16689609653014428,130559.50969180044,-2009.5959339883273,128549.91375781212,3588,0,651.5625,42,6,12,37.0739309756329,0.6158234126984127,44.50096899224807,1021.9961240310083,24.33324104835734,0
3620,4,1,4,45,0.02040816326530612,0.08163265306122448,0.9183673469387755,49,1250,800,450,0.64,17,8,9,287.32210881896714,0.4152671485260771,0.1606056713688815,0.16617923253105574,130843.2514061065,-2281.1682162534394,128562.08318985306,3589,0,639.2448979591836,43,6,14,36.87446007651491,0.6172480620155039,44.22348484848485,1023.1060606060604,23.79316420014094,0
3621,4,2,2,45,0.0425531914893617,0.0425531914893617,0.9574468085106383,47,1200,800,400,0.6666666666666666,16,8,8,298.3257310926162,0.40984427998766576,0.1441367052756959,0.1718749754260251,130693.35322381239,-1602.1619701121456,129091.19125370024,3590,0,666.8085106382979,41,6,16,36.74394020245142,0.61864837398374,44.37003968253967,1022.5198412698389,24.939508323654607,0
3622,4,0,0,45,0.0,0.0,1.0,45,1250,1000,250,0.8,15,10,5,322.26275652551305,0.4057449494949495,0.17951356080489944,0.1798214854074699,129445.8954840565,-653.8061864155101,128792.08929764098,3591,3,697.4444444444445,38,7,16,37.39435695538057,0.6110197368421053,45.592948717948715,1017.6282051282049,26.77968960863697,2
3623,4,0,0,45,0.0,0.0,1.0,45,1200,800,400,0.6666666666666666,16,8,8,322.9360735097871,0.40614478114478114,0.17753524329240533,0.18069629151349148,129554.6392746913,-632.4266975308728,128922.21257716043,3592,4,698.4444444444445,38,7,16,37.26693951796269,0.6121162280701755,45.48611111111111,1018.0555555555552,26.79093567251461,0
3624,4,0,0,45,0.0,0.0,1.0,45,1000,600,400,0.6,14,6,8,322.66280751563846,0.40528198653198655,0.18608667984818528,0.18111348633110846,129678.39084201369,-631.5212673611359,129046.86957465255,3593,5,699.4444444444445,39,6,16,37.14844548987521,0.6116452991452993,45.36458333333332,1018.541666666665,26.11645299145295,0
3625,4,0,0,45,0.0,0.0,1.0,45,1250,1100,150,0.88,14,11,3,302.01725685945644,0.40492424242424246,0.12032767297507974,0.16678587617105292,129036.7037465709,-1205.737740054848,127830.96600651606,3594,6,700.4444444444445,44,1,17,38.32399222333608,0.5977746212121211,45.99537037037038,1016.0185185185205,23.09132996633001,4
3626,4,0,0,45,0.0,0.0,1.0,45,1150,900,250,0.782608695652174,14,9,5,303.3989202945465,0.40452441077441076,0.12151468221432649,0.16794805587863065,129130.79668209916,-1164.371141975278,127966.42554012388,3595,7,701.4444444444445,44,1,17,38.19349549057117,0.5987215909090908,45.90277777777779,1016.3888888888921,23.09974747474755,0
3627,4,1,1,45,0.021739130434782608,0.021739130434782608,0.9782608695652174,46,1050,800,250,0.7619047619047619,13,8,5,299.0840741535845,0.40881642512077293,0.12148575684230045,0.16646430697190745,129345.8421214995,-1462.9051324481834,127882.93698905132,3596,0,687.1739130434783,43,3,18,38.08531930739154,0.6022286821705425,45.6912878787879,1017.2348484848519,23.656624383368648,0
3628,4,1,1,45,0.021739130434782608,0.021739130434782608,0.9782608695652174,46,1300,800,500,0.6153846153846154,18,8,10,301.51653675410205,0.40645128824476645,0.12740781507980192,0.16802353064761824,129394.01113406832,-1397.1131772267747,127996.89795684155,3597,0,688.1521739130435,43,3,18,37.97468354430381,0.6027131782945736,45.64393939393941,1017.4242424242453,23.6610288935871,0
3629,4,1,0,46,0.021739130434782608,0.0,1.0,46,1450,1000,450,0.6896551724137931,19,10,9,301.41736225746024,0.4081521739130434,0.13261126552300762,0.16885821358865502,129601.7757630319,-1387.1549211247952,128214.6208419071,3598,0,689.1304347826087,44,2,12,37.76692885938589,0.6034564393939392,45.43981481481483,1018.2407407407436,23.14183501683508,0
3630,4,1,0,47,0.02127659574468085,0.0,1.0,47,1000,800,200,0.8,12,8,4,301.25226744741127,0.4119449583718779,0.15602836879432647,0.17022567883474202,129939.15406427221,-1571.1070415878987,128368.04702268432,3599,0,675.4468085106383,45,2,14,37.43003731343285,0.6055555555555555,45.108695652173914,1019.5652173913043,22.657004830917874,0
3631,4,0,0,47,0.0,0.0,1.0,47,850,400,450,0.47058823529411764,13,4,9,304.02868610001883,0.4115787850755473,0.15947712912438416,0.1718960783238529,129962.24307032395,-1497.5499993436274,128464.69307098033,3600,1,676.4468085106383,45,2,14,37.33593541796216,0.6057870370370371,45.08605072463768,1019.655797101449,22.659017713365532,0
3632,4,1,1,47,0.020833333333333332,0.020833333333333332,0.9791666666666666,48,1350,900,450,0.6666666666666666,18,9,9,297.6616605189222,0.4127788859338062,0.1510516183197268,0.16949932538154638,130239.96293571749,-1846.5112733262933,128393.45166239119,3601,0,663.3333333333334,46,2,16,37.217915870534426,0.607336956521739,44.81382978723404,1020.7446808510637,22.19010175763182,0
3633,4,0,0,47,0.0,0.0,1.0,47,1300,600,700,0.46153846153846156,20,6,14,302.5799313227123,0.4115595127967931,0.13829383350296465,0.17250985694892296,130287.31746890202,-1515.5285911608867,128771.78887774114,3602,3,678.4468085106383,42,5,17,37.04461686914704,0.6130952380952381,44.76744186046511,1020.9302325581389,24.307862679955687,0
3634,4,2,1,48,0.04081632653061224,0.02040816326530612,0.9795918367346939,49,1050,300,750,0.2857142857142857,18,3,15,296.5642442508372,0.4180484693877551,0.162511842127133,0.17167791845028815,130877.70168895744,-2037.270661865567,128840.43102709188,3603,0,651.7142857142857,44,5,13,36.603399390703736,0.6162405303030303,44.18981481481482,1023.2407407407404,23.255471380471374,0
3635,4,0,1,47,0.0,0.020833333333333332,0.9791666666666666,48,1150,600,550,0.5217391304347826,17,6,11,301.9818964817611,0.4153645833333333,0.15958468301712259,0.1747677767265894,130867.47378795035,-1696.07841554753,129171.39537240283,3604,1,665.8958333333334,43,5,14,36.4751079747031,0.6174903100775195,44.1998106060606,1023.2007575757561,23.795366455250143,0
3636,4,1,0,48,0.020833333333333332,0.0,1.0,48,1400,900,500,0.6428571428571429,19,9,10,321.989084347671,0.4173684988179669,0.1688198425105667,0.1833522412056917,130239.96293571766,-1212.8307177707238,129027.13221794694,3605,0,663.375,46,2,16,36.59711365873431,0.607336956521739,44.81382978723405,1020.744680851065,22.190101757631847,4
3637,4,1,2,47,0.02040816326530612,0.04081632653061224,0.9591836734693877,49,1450,900,550,0.6206896551724138,20,9,11,312.71871814864943,0.4196605725623583,0.16040217065619022,0.1791556768459089,130475.34722222247,-1639.577438886355,128835.76978333612,3606,0,650.8163265306123,44,5,16,36.59597607395323,0.612215909090909,44.58333333333334,1021.6666666666686,23.21969696969701,0
3638,4,2,1,48,0.04081632653061224,0.02040816326530612,0.9795918367346939,49,1250,700,550,0.56,18,7,11,313.27342829793724,0.41769416099773243,0.1721389026454483,0.180573681739166,130711.95130315505,-1610.283779149513,129101.66752400553,3607,0,651.7142857142857,44,5,12,36.343074671012936,0.6145833333333333,44.351851851851855,1022.5925925925928,23.240740740740748,0
3639,4,0,0,48,0.0,0.0,1.0,48,1150,800,350,0.6956521739130435,15,8,7,316.73800665266384,0.4153184101654846,0.17278776089909886,0.1822763070267675,130649.55305899905,-1323.6641988062427,129325.8888601928,3608,1,666.2916666666666,43,5,13,36.317463257996806,0.6153100775193798,44.41287878787879,1022.3484848484846,23.775546159267083,0
3640,4,0,0,48,0.0,0.0,1.0,48,1200,900,300,0.75,15,9,6,317.6094763177474,0.414311835106383,0.17217734469030654,0.18335114664393323,130770.59771184865,-1293.2037885961827,129477.39392325247,3609,2,667.2916666666666,43,5,13,36.173058821714044,0.6165213178294573,44.29450757575758,1022.82196969697,23.786557434813254,0
3641,4,0,1,47,0.0,0.020833333333333332,0.9791666666666666,48,1550,1300,250,0.8387096774193549,18,13,5,355.0734792539102,0.41448729314420807,0.24781750111373824,0.19262686741231377,128329.16802300353,-455.3658253343044,127873.80219766923,3610,3,668.2916666666666,39,9,18,37.6984381960865,0.5980235042735043,46.692708333333336,1013.2291666666671,25.980235042735053,8
3642,4,4,1,50,0.0784313725490196,0.0196078431372549,0.9803921568627451,51,1150,1000,150,0.8695652173913043,13,10,3,342.8336112197979,0.42287581699346405,0.27785661799763295,0.18952536008761292,129078.27546609272,-1349.5257383871249,127728.7497277056,3611,0,629.843137254902,42,9,15,37.24492228473347,0.6009424603174605,45.95445736434108,1016.182170542635,24.194813584348452,0
3643,4,1,0,51,0.0196078431372549,0.0,1.0,51,1650,1200,450,0.7272727272727273,21,12,9,344.4387143509682,0.4240359477124183,0.3015254024932661,0.19251663855688037,129511.53413973155,-1278.1253692107728,128233.40877052078,3612,0,630.8235294117648,40,11,15,36.76347011448348,0.6083333333333334,45.52845528455284,1017.8861788617879,25.4471544715447,0
3644,4,1,1,51,0.019230769230769232,0.019230769230769232,0.9807692307692307,52,1050,500,550,0.47619047619047616,16,5,11,336.9143110992085,0.42693407491201607,0.3037809965324323,0.18961352818082022,129781.9834675768,-1654.9184893865013,128127.0649781903,3613,0,619.6730769230769,41,11,16,36.68043926264889,0.6095020325203253,45.26289682539682,1018.9484126984123,24.852400309717375,0
3645,4,0,0,51,0.0,0.0,1.0,51,1450,1000,450,0.6896551724137931,19,10,9,344.9572183981111,0.4234967320261438,0.3092343082484392,0.1938257375124813,129718.50419723714,-1250.5331234714738,128467.97107376567,3614,1,632.7843137254902,40,11,16,36.54001230380421,0.6104166666666666,45.32520325203252,1018.6991869918702,25.467479674796756,0
3646,4,0,1,50,0.0,0.0196078431372549,0.9803921568627451,51,1250,900,350,0.72,16,9,7,346.0181853793027,0.42289215686274506,0.30859475820643434,0.19493653724627222,129822.05119307281,-1215.84188479081,128606.209308282,3615,2,633.7843137254902,40,11,16,36.40784968754154,0.6114583333333334,45.22357723577235,1019.1056910569098,25.477642276422745,0
3647,4,0,0,50,0.0,0.0,1.0,50,1450,1100,350,0.7586206896551724,18,11,7,349.7321994370535,0.4228061224489796,0.30661549197487736,0.1974205792095152,129899.73855054865,-913.9757460836802,128985.76280446496,3616,3,641.54,40,10,16,36.23434021200942,0.6122395833333333,45.14735772357724,1019.4105691056914,25.485264227642283,0
3648,4,0,0,50,0.0,0.0,1.0,50,1200,500,700,0.4166666666666667,19,5,14,346.9915319796809,0.422593537414966,0.3027632079057394,0.19633004744914845,129990.70443482965,-978.8652650081135,129011.83916982153,3617,4,642.54,42,8,17,36.21187286202965,0.6101190476190477,45.05813953488372,1019.7674418604652,24.28017718715393,0
3649,4,2,2,50,0.038461538461538464,0.038461538461538464,0.9615384615384616,52,1250,800,450,0.64,17,8,9,334.21412315086474,0.426195638511815,0.29744348044368474,0.19120791666379103,130422.1408420138,-1680.7955560156454,128741.34528599816,3618,0,618.7884615384615,39,13,18,36.100771636413086,0.6191239316239316,44.635416666666664,1021.4583333333326,26.191239316239297,0
3650,4,0,0,50,0.0,0.0,1.0,50,1250,800,450,0.64,17,8,9,344.31869813358776,0.42512755102040817,0.30241054613936,0.19659486957949987,130344.39718934892,-1023.9973701512362,129320.39981919769,3619,1,638.64,38,12,18,35.92147938899352,0.6200657894736843,44.71153846153845,1021.1538461538446,26.87246963562749,0
3651,4,0,0,50,0.0,0.0,1.0,50,1350,1200,150,0.8888888888888888,15,12,3,331.9561146015648,0.42512755102040817,0.2915962531064802,0.18069328152765746,128463.58861396571,-1439.0426049014734,127024.54600906423,3620,2,639.64,42,8,16,38.14698432422099,0.5947420634920635,46.56007751937985,1013.7596899224823,24.137135474344817,7
3652,4,1,1,50,0.0196078431372549,0.0196078431372549,0.9803921568627451,51,1150,1000,150,0.8695652173913043,13,10,3,327.23493196659297,0.4263235294117647,0.2930875812114526,0.17938500081258185,128744.48609855655,-1774.0613700929784,126970.42472846356,3621,0,628.0784313725491,43,8,16,37.98064212621691,0.596172480620155,46.28314393939394,1014.8674242424239,23.601568005637766,0
3653,4,2,2,50,0.038461538461538464,0.038461538461538464,0.9615384615384616,52,1550,1000,550,0.6451612903225806,21,10,11,319.50797367811515,0.43025703871292104,0.29049099538026835,0.17644494188072293,129036.7037465709,-2154.3488511659575,126882.35489540495,3622,0,616.9615384615385,44,8,17,37.87971991858804,0.5977746212121211,45.99537037037038,1016.0185185185205,23.09132996633001,0
3654,4,0,0,50,0.0,0.0,1.0,50,1150,700,450,0.6086956521739131,16,7,9,334.80857758871855,0.4249234693877551,0.29424809160305365,0.18428539354673165,128906.0152635058,-1368.2320773991944,127537.78318610661,3623,1,642.18,42,8,17,37.62404580152672,0.5992063492063493,46.12403100775194,1015.5038759689922,24.178663713547433,0
3655,4,6,1,55,0.10714285714285714,0.017857142857142856,0.9821428571428571,56,1850,1400,450,0.7567567567567568,23,14,9,304.4016422089057,0.4361201298701299,0.3108973563361055,0.1729349902183858,130149.48710452157,-3275.780437444092,126873.70666707748,3624,0,574.2678571428571,46,10,19,37.137271937445696,0.6064311594202899,44.90248226950353,1020.3900709219831,22.182392846130067,0
3656,4,0,1,54,0.0,0.01818181818181818,0.9818181818181818,55,1150,700,450,0.6086956521739131,16,7,9,309.26320264601605,0.4340909090909091,0.3181503449945531,0.1756858284320404,130147.0289608928,-2950.0626017381232,127196.96635915467,3625,1,585.709090909091,45,10,20,37.01573827489272,0.6076388888888891,44.90489130434781,1020.3804347826056,22.67512077294679,0
3657,4,1,1,54,0.01818181818181818,0.01818181818181818,0.9818181818181818,55,1500,1000,500,0.6666666666666666,20,10,10,312.156788800709,0.4334175084175084,0.31316117013823086,0.1782898614025382,130357.12555727,-2861.5763784760547,127495.54917879395,3626,0,586.6363636363636,44,11,21,36.72968235258559,0.611032196969697,44.69907407407406,1021.2037037037019,23.209175084175044,0
3658,4,0,0,54,0.0,0.0,1.0,54,1050,600,450,0.5714285714285714,15,6,9,320.61363248672217,0.43298683904029817,0.320679040974005,0.18278876635850594,130286.75538230292,-2445.6580183941905,127841.09736390873,3627,3,598.5,43,11,21,36.5849063166682,0.6116763565891474,44.767992424242415,1020.9280303030284,23.742512332628568,0
3659,4,1,1,54,0.01818181818181818,0.01818181818181818,0.9818181818181818,55,1300,800,500,0.6153846153846154,18,8,10,318.76797879466835,0.4337542087542088,0.31742513441634923,0.1834037130730553,130640.94757373101,-2671.169838820314,127969.7777349107,3628,0,588.6,44,11,14,36.274265616037205,0.6138731060606062,44.42129629629629,1022.3148148148139,23.234427609427588,0
3660,4,0,0,54,0.0,0.0,1.0,54,1400,1000,400,0.7142857142857143,18,10,8,325.4751481068537,0.4330232354996506,0.321239326799001,0.18683658501963626,130552.75769054164,-2301.664370982568,128251.09331955906,3629,5,600.5,43,11,14,36.19193229552756,0.6143410852713179,44.50757575757575,1021.9696969696957,23.766737138830134,0
3661,4,0,0,54,0.0,0.0,1.0,54,1200,1000,200,0.8333333333333334,14,10,4,327.0364430392278,0.4331833799208013,0.32126439147558106,0.188202848563513,130649.55305899905,-2254.56697658402,128394.98608241504,3630,6,601.5,43,11,15,36.05424848709399,0.6153100775193798,44.41287878787879,1022.3484848484846,23.775546159267083,0
3662,4,0,0,54,0.0,0.0,1.0,54,1300,600,700,0.46153846153846156,20,6,14,324.28298806543626,0.4327611809923131,0.3165229500661988,0.18685206537516436,130697.9641945017,-2323.3747273875233,128374.58946711419,3631,7,602.5,43,11,15,36.07573933444466,0.615794573643411,44.3655303030303,1022.5378787878778,23.77995066948553,0
3663,4,1,2,53,0.01818181818181818,0.03636363636363636,0.9636363636363636,55,1450,900,550,0.6206896551724138,20,9,11,350.7818816489762,0.43417508417508416,0.4026444466620098,0.18909011490072028,128074.22839506168,-2002.2755171666204,126071.95287789506,3632,0,592.5272727272727,44,11,15,38.067714050493954,0.5880681818181819,46.94444444444444,1012.222222222222,23.005050505050498,7
3664,4,2,1,54,0.03636363636363636,0.01818181818181818,0.9818181818181818,55,1700,1200,500,0.7058823529411765,22,12,10,353.644913497772,0.43424523007856336,0.4017519495780366,0.191689058208028,128295.24518140586,-1925.749952758882,126369.49522864698,3633,0,593.2,41,14,16,37.769291030160595,0.5945121951219512,46.726190476190474,1013.0952380952378,24.709639953542386,0
3665,4,3,3,54,0.05263157894736842,0.05263157894736842,0.9473684210526316,57,1900,1500,400,0.7894736842105263,23,15,8,340.936873229188,0.4374477861319967,0.3994390415924154,0.18734926795951407,128840.60890330852,-2614.6971311122766,126225.91177219624,3634,0,573.3333333333334,43,14,14,37.53507524173738,0.5971414728682172,46.18844696969696,1015.246212121211,23.610377026074673,0
3666,4,3,2,55,0.05263157894736842,0.03508771929824561,0.9649122807017544,57,1800,1300,500,0.7222222222222222,23,13,10,346.04222233138125,0.4354114452798663,0.4156004365591097,0.191781805097235,129177.85600994478,-2459.8015260631337,126718.05448388164,3635,0,574.2631578947369,44,13,16,37.06204268755504,0.5991950757575759,45.85648148148147,1016.5740740740713,23.103956228956164,0
3667,4,1,0,56,0.017857142857142856,0.0,1.0,56,2000,1500,500,0.75,25,15,10,344.2802408766714,0.43444940476190474,0.41171797384286624,0.19151614671342987,129324.56099580863,-2295.219654471588,127029.34134133704,3636,0,584.6607142857143,42,14,18,36.95758311898635,0.6034226190476191,45.71220930232558,1017.1511627906983,24.21788482834996,0
3668,4,2,3,55,0.034482758620689655,0.05172413793103448,0.9482758620689655,58,1350,800,550,0.5925925925925926,19,8,11,334.68946934822293,0.43715340794515023,0.4137539362985474,0.18840192379422976,129790.40745027429,-2912.1034807956166,126878.30396947867,3637,0,565.4655172413793,44,14,16,36.72857034681205,0.6053503787878789,45.254629629629626,1018.981481481481,23.15867003367002,0
3669,4,2,1,56,0.03508771929824561,0.017543859649122806,0.9824561403508771,57,1700,1300,400,0.7647058823529411,21,13,8,336.5463228740449,0.43568556808688386,0.41620261715955564,0.1901339949289947,129931.97123628254,-2654.374571330591,127277.59666495194,3638,0,570.7894736842105,44,13,17,36.53770471952291,0.6067708333333334,45.11574074074074,1019.5370370370367,23.17129629629629,0
3670,4,0,0,56,0.0,0.0,1.0,56,1350,800,550,0.5925925925925926,19,8,11,340.0304944221134,0.43521374458874457,0.41504459723125575,0.19171022584940836,129852.0640083362,-2369.2676947027085,127482.79631363349,3639,1,581.9821428571429,43,13,17,36.5299521508873,0.6073158914728682,45.19412878787879,1019.2234848484848,23.702871740662435,0
3671,4,0,1,55,0.0,0.017857142857142856,0.9821428571428571,56,1800,1400,400,0.7777777777777778,22,14,8,338.49400237123274,0.43507169913419913,0.4089365315219702,0.1914340030217139,129972.73875114774,-2401.001492194682,127571.73725895306,3640,2,582.9821428571429,43,13,17,36.446724863793946,0.6085271317829457,45.07575757575757,1019.6969696969688,23.713883016208577,0
3672,4,2,3,54,0.03508771929824561,0.05263157894736842,0.9473684210526316,57,1700,1300,400,0.7647058823529411,21,13,8,323.4732679333196,0.4381004594820384,0.3924793037680181,0.18466502200985313,130338.55273880361,-2966.501159261944,127372.05157954167,3641,0,568.0526315789474,41,16,17,36.45954775089865,0.6150914634146343,44.71726190476189,1021.1309523809505,24.90563298490123,0
3673,4,0,1,53,0.0,0.018518518518518517,0.9814814814814815,54,1300,800,500,0.6153846153846154,18,8,10,330.35231291821225,0.4353890053575588,0.3854137664346484,0.18764081031595856,130141.77755000281,-2201.4725558138275,127940.30499418898,3642,4,594.2407407407408,43,11,17,36.48308197989173,0.6102228682170543,44.910037878787875,1020.3598484848479,23.729298801973208,0
3674,4,1,1,53,0.018518518518518517,0.018518518518518517,0.9814814814814815,54,1950,1400,550,0.717948717948718,25,14,11,330.802504888493,0.4357893664104356,0.3750396167311587,0.18911064699256844,130392.29811124328,-2173.0120924004177,128219.28601884286,3643,0,594.7777777777778,40,14,17,36.21807628524047,0.6171875,44.66463414634146,1021.3414634146338,25.533536585365844,0
3675,4,1,0,54,0.018518518518518517,0.0,1.0,54,1550,1100,450,0.7096774193548387,20,11,9,331.07281802135395,0.43556370836245045,0.3791490834640563,0.19028173735193024,130599.97046235707,-2152.379949104372,128447.5905132527,3644,0,595.7592592592592,40,14,17,36.0011930801352,0.6192708333333334,44.46138211382114,1022.1544715447155,25.553861788617887,0
3676,4,0,0,54,0.0,0.0,1.0,54,1650,1100,550,0.6666666666666666,22,11,11,330.53907125563666,0.43517790589331473,0.37892083409692856,0.1904341088558883,130693.3532238125,-2160.148081223243,128533.20514258926,3645,1,596.7592592592592,41,13,18,35.920470715694854,0.6186483739837398,44.37003968253968,1022.5198412698398,24.939508323654632,0
3677,4,0,0,54,0.0,0.0,1.0,54,1550,1100,450,0.7096774193548387,20,11,9,340.6400533826267,0.43517790589331473,0.40740156990025755,0.1890304016351279,129228.54487407717,-1991.3029246119925,127237.24194946517,3646,2,597.7592592592592,38,16,19,37.14777941227979,0.6088267543859651,45.8066239316239,1016.7735042734997,26.757197480881572,2
3678,4,0,0,54,0.0,0.0,1.0,54,1550,1000,550,0.6451612903225806,21,10,11,342.21660795647875,0.4349668064290706,0.41204699119104804,0.1906691163668523,129386.78521050315,-1944.3386501736472,127442.4465603295,3647,3,598.7592592592592,39,15,19,36.94679789085696,0.6087072649572651,45.65104166666665,1017.3958333333308,26.087072649572583,0
3679,4,0,0,54,0.0,0.0,1.0,54,1000,600,400,0.6,14,6,8,342.4087034700078,0.4341224085720941,0.41182485530962887,0.19125617207206475,129485.67450137122,-1932.5956152092294,127553.078886162,3648,4,599.7592592592592,40,14,15,36.841404559826934,0.6080729166666669,45.55386178861787,1017.7845528455259,25.444613821138148,0
3680,4,1,1,54,0.01818181818181818,0.01818181818181818,0.9818181818181818,55,1300,900,400,0.6923076923076923,17,9,8,336.9423848177292,0.4357182940516274,0.40884922848113203,0.18938485767341268,129731.4453124995,-2257.5954861111586,127473.84982638835,3649,0,589.8363636363637,41,14,15,36.73099863667349,0.6089939024390245,45.31249999999998,1018.749999999996,24.84756097560966,0
3681,4,0,0,54,0.0,0.0,1.0,54,1300,1000,300,0.7692307692307693,16,10,6,347.9113687103942,0.4332852900069881,0.4200184723376754,0.19561477685483433,129744.3870732531,-1772.0905421706873,127972.29653108242,3650,6,601.7592592592592,40,14,16,36.438487115544476,0.6106770833333335,45.29979674796747,1018.8008130081281,25.4700203252032,0
3682,4,1,2,53,0.01818181818181818,0.03636363636363636,0.9636363636363636,55,1550,1000,550,0.6451612903225806,21,10,11,348.75175101163165,0.43316498316498314,0.43106521138436094,0.19782642428073569,130089.53788834793,-1926.2091746289389,128163.32871371899,3651,0,591.8,42,13,17,36.066718908308,0.6111111111111112,44.961240310077514,1020.155038759689,24.2894056847545,0
3683,4,0,0,53,0.0,0.0,1.0,53,1600,1400,200,0.875,18,14,4,363.7654583720381,0.4310595065312046,0.4386364534095246,0.20534222357512202,129899.73855054879,-1149.392412750328,128750.34613779846,3652,14,615.0,40,13,17,35.87669890007642,0.6122395833333333,45.147357723577244,1019.4105691056925,25.48526422764231,0
3684,4,0,0,53,0.0,0.0,1.0,53,1850,1400,450,0.7567567567567568,23,14,9,366.0929859361616,0.4309990324141268,0.43561668559224453,0.20734250603020998,130029.26911891079,-1079.4393218322352,128949.82979707855,3653,15,616.0,40,13,18,35.68569815331472,0.6135416666666667,45.020325203252035,1019.9186991869926,25.497967479674816,0
3685,4,1,1,53,0.018518518518518517,0.018518518518518517,0.9814814814814815,54,1100,900,200,0.8181818181818182,13,9,4,362.7288645514984,0.4323098648963429,0.4334648391887448,0.20681242591444096,130289.17236328138,-1347.6530112516584,128941.51935202972,3654,0,605.574074074074,39,15,18,35.507537496173875,0.6177884615384615,44.76562500000001,1020.937500000001,26.17788461538464,0
3686,4,0,0,53,0.0,0.0,1.0,53,950,600,350,0.631578947368421,13,6,7,370.1269644580878,0.43040940977261727,0.4415616622109835,0.21060538833159048,130210.7203570129,-961.1002668715832,129249.62009014132,3655,17,618.0,40,13,18,35.39841182913471,0.6153645833333334,44.84247967479674,1020.6300813008121,25.515752032520304,0
3687,4,0,1,52,0.0,0.018867924528301886,0.9811320754716981,53,1250,800,450,0.64,17,8,9,369.00390743748255,0.42978955007256897,0.43980666103287835,0.21039387467020193,130289.85407991821,-984.4862933157867,129305.36778660242,3656,18,619.0,38,15,18,35.346684456536906,0.6195175438596492,44.76495726495727,1020.9401709401711,26.866846603688714,0
3688,4,0,1,51,0.0,0.019230769230769232,0.9807692307692307,52,1300,900,400,0.6923076923076923,17,9,8,366.6287181560569,0.4305241327300151,0.4262639432130959,0.2093331713342649,130344.39718934921,-842.4001479289832,129501.99704142023,3657,19,618.9038461538462,38,14,18,35.351930320150664,0.6200657894736842,44.71153846153847,1021.1538461538469,26.87246963562755,0
3689,4,2,2,51,0.03773584905660377,0.03773584905660377,0.9622641509433962,53,1250,800,450,0.64,17,8,9,354.4757939252462,0.43449141267537494,0.40977542577252013,0.20462068316002305,130768.17626953124,-1329.1693793402776,129439.00689019095,3658,0,602.2264150943396,39,14,17,35.23281817564585,0.6225961538461539,44.296875,1022.8124999999999,26.225961538461537,0
3690,4,0,0,51,0.0,0.0,1.0,51,1250,1000,250,0.8,15,10,5,362.6255873450709,0.4332843137254902,0.3361017685954195,0.20580803202299724,130110.72137188207,-753.6107900191317,129357.11058186294,3659,1,622.0392156862745,41,10,18,35.69136522753792,0.6128048780487805,44.94047619047619,1020.2380952380952,24.883855981416957,6
3691,4,2,3,50,0.03773584905660377,0.05660377358490566,0.9433962264150944,53,1000,700,300,0.7,13,7,6,346.49251047631105,0.4346879535558781,0.3341985569962804,0.19895242228189647,130562.68376981532,-1551.7586997268565,129010.92507008847,3660,0,599.5283018867924,38,15,15,35.644905568332305,0.6222587719298245,44.49786324786326,1022.0085470085481,26.894961763382845,0
3692,4,1,0,51,0.0196078431372549,0.0,1.0,51,1450,1000,450,0.6896551724137931,19,10,9,363.15679926463446,0.4312091503267974,0.3442696099478866,0.2078113477855857,130430.54112803946,-726.6524315173829,129703.88869652207,3661,0,623.9803921568628,37,14,19,35.353155860884506,0.6227477477477477,44.627192982456144,1021.4912280701759,27.60787102892367,0
3693,4,0,0,51,0.0,0.0,1.0,51,1400,1100,300,0.7857142857142857,17,11,6,366.28506695647377,0.43107843137254903,0.35059328452411,0.2102079325144295,130542.57079101262,-636.8411434287468,129905.72964758388,3662,1,624.9803921568628,37,14,18,35.15960300429185,0.6238738738738738,44.51754385964912,1021.9298245614035,27.61972498814604,0
3694,4,0,0,51,0.0,0.0,1.0,51,1450,1000,450,0.6896551724137931,19,10,9,346.3361452953916,0.4311928104575163,0.23196810303568705,0.1965807694779072,130114.25212014,-1184.9898002376563,128929.26231990234,3663,2,625.9803921568628,42,9,18,36.103262418083396,0.611359126984127,44.93701550387597,1020.251937984496,24.291712809154667,7
3695,4,0,0,51,0.0,0.0,1.0,51,1000,600,400,0.6,14,6,8,345.93650140297234,0.43161764705882355,0.2290094809403871,0.19685300752444668,130213.1325209573,-1190.9048997956843,129022.22762116161,3664,3,626.9803921568628,42,9,18,36.01320453178899,0.6123511904761905,44.84011627906977,1020.6395348837211,24.300941306755266,0
3696,4,1,0,52,0.019230769230769232,0.0,1.0,52,1500,1300,200,0.8666666666666667,17,13,4,341.6533896941358,0.4323623680241327,0.23439004113065542,0.1962832219223172,130584.26852352617,-1477.0790141818443,129107.18950934433,3665,0,615.9038461538462,42,10,14,35.746705536594625,0.6160714285714286,44.47674418604651,1022.0930232558136,24.335548172757466,0
3697,4,0,1,51,0.0,0.019230769230769232,0.9807692307692307,52,2050,1500,550,0.7317073170731707,26,15,11,341.77281647693655,0.43174176721970836,0.2304048045946847,0.19710766694522366,130732.87080854528,-1463.81170752959,129269.0591010157,3666,1,616.9038461538462,42,10,14,35.59333743920156,0.6175595238095237,44.33139534883721,1022.6744186046521,24.349390919158385,0
3698,4,0,0,51,0.0,0.0,1.0,51,1350,1100,250,0.8148148148148148,16,11,5,347.4759820629973,0.43173202614379086,0.22851783577503926,0.200192003752002,130693.35322381284,-1117.4397478898788,129575.91347592296,3667,2,628.1764705882352,41,10,14,35.487512531936225,0.6186483739837398,44.37003968253969,1022.5198412698426,24.939508323654696,0
3699,4,0,1,50,0.0,0.0196078431372549,0.9803921568627451,51,1200,900,300,0.75,15,9,6,348.1564106023665,0.43174836601307187,0.22419777883022474,0.20084747828202565,130744.07837498434,-1096.122193090187,129647.95618189416,3668,3,629.1764705882352,41,10,14,35.41878859895884,0.6191565040650406,44.32043650793651,1022.7182539682547,24.944347657762307,0
3700,4,0,1,49,0.0,0.02,0.98,50,1550,1100,450,0.7096774193548387,20,11,9,347.16635154068035,0.43074829931972786,0.22683853459972858,0.20146582762636372,130972.4633487657,-906.1535493826879,130066.30979938302,3669,4,641.5,41,9,14,35.21313885119857,0.6214430894308942,44.097222222222236,1023.6111111111132,24.966124661246663,0
3701,4,0,1,48,0.0,0.02040816326530612,0.9795918367346939,49,1000,600,400,0.6,14,6,8,351.5585476842489,0.42933319160997735,0.22790331865761781,0.20341904931523133,130859.79327781117,-599.0242249983098,130260.76905281286,3670,5,655.4285714285714,40,9,14,35.21470666136936,0.6218749999999998,44.20731707317075,1023.1707317073198,25.579268292682993,0
3702,4,0,0,48,0.0,0.0,1.0,48,1200,700,500,0.5833333333333334,17,7,10,354.95832437420387,0.4280622044917258,0.23682783682659458,0.2052478719974221,130833.79937743771,-311.89076029476644,130521.90861714294,3671,6,669.3333333333334,40,8,15,35.154051190357926,0.6216145833333332,44.23272357723579,1023.0691056910596,25.576727642276488,0
3703,4,0,0,48,0.0,0.0,1.0,48,1000,600,400,0.6,14,6,8,353.0267275052779,0.42772975768321514,0.2356876861966235,0.20454425465927256,130911.78882444352,-356.92791988891145,130554.8609045546,3672,7,670.3333333333334,40,8,16,35.124544852697795,0.6223958333333331,44.15650406504067,1023.3739837398406,25.584349593496015,0
3704,4,0,0,48,0.0,0.0,1.0,48,1050,600,450,0.5714285714285714,15,6,9,352.24336262282674,0.4274896572104019,0.2438120039682541,0.20547529486331587,131171.9214753125,-359.112259567696,130812.8092157448,3673,8,671.3333333333334,40,8,16,34.88157242063494,0.6249999999999998,43.902439024390254,1024.3902439024405,25.60975609756101,0
3705,4,0,0,48,0.0,0.0,1.0,48,1400,800,600,0.5714285714285714,20,8,12,348.56786231263294,0.42712950650118203,0.23914435630474307,0.20402245452251352,131302.08462431442,-446.4626090620401,130855.62201525237,3674,9,672.3333333333334,40,8,17,34.844240621384905,0.6263020833333333,43.77540650406505,1024.8983739837415,25.622459349593537,0
3706,4,0,0,48,0.0,0.0,1.0,48,1050,700,350,0.6666666666666666,14,7,7,370.15198530365035,0.42712950650118203,0.27002937371995284,0.20599279949981747,129340.77222077922,-11.187534533945382,129329.58468624527,3675,10,673.3333333333334,37,11,19,36.28316894829506,0.6117680180180181,45.69627192982455,1017.2149122806998,27.492294926505398,5
3707,4,0,0,48,0.0,0.0,1.0,48,1450,1000,450,0.6896551724137931,19,10,9,366.86446245745117,0.4271387411347518,0.26018548445019074,0.20488784239049684,129480.23069598322,-99.66095337028531,129380.56974261293,3676,11,674.3333333333334,37,11,14,36.224682180564535,0.6131756756756757,45.55921052631578,1017.7631578947355,27.507112375533392,0
3708,4,0,0,48,0.0,0.0,1.0,48,1750,1300,450,0.7428571428571429,22,13,9,371.1331062786106,0.4266862440898345,0.21358629902207893,0.19487926316450707,127015.1708329202,-172.09302085399014,126843.0778120662,3677,12,675.3333333333334,40,8,17,38.640067883187136,0.5830729166666667,47.99288617886179,1008.0284552845527,25.200711382113816,6
3709,4,1,0,49,0.02040816326530612,0.0,1.0,49,1550,1200,350,0.7741935483870968,19,12,7,367.3100320195858,0.4298115079365079,0.22920348163429693,0.19446285916943107,127348.32523630117,-444.71327830656037,126903.61195799461,3678,0,662.530612244898,40,9,16,38.39399583836757,0.5864583333333333,47.66260162601626,1009.3495934959351,25.233739837398378,0
3710,4,4,3,50,0.07547169811320754,0.05660377358490566,0.9433962264150944,53,900,500,400,0.5555555555555556,13,5,8,343.6555003133967,0.43845246734397675,0.2342397691600122,0.18535696028250473,128097.6605366943,-1795.7068758573207,126301.95366083698,3679,0,613.4528301886793,44,9,17,38.22410744230008,0.5883049242424242,46.921296296296305,1012.3148148148164,23.007154882154918,0
3711,4,0,0,50,0.0,0.0,1.0,50,1750,1400,350,0.8,21,14,7,356.87301431683835,0.433937074829932,0.22242495585638622,0.19127042628527094,127843.36911848078,-875.2303004535062,126968.13881802728,3680,1,651.26,41,9,18,38.14989209338829,0.5899390243902438,47.17261904761905,1011.3095238095242,24.666085946573762,0
3712,4,2,2,50,0.038461538461538464,0.038461538461538464,0.9615384615384616,52,1500,1000,500,0.6666666666666666,20,10,10,341.2151704025211,0.4394482151835093,0.22989753077634623,0.18535356743976175,128381.94580078153,-1637.4092638357129,126744.53653694582,3681,0,627.1730769230769,39,13,15,37.995618768629875,0.5985576923076922,46.640625000000014,1013.4375000000022,25.98557692307698,0
3713,4,0,0,50,0.0,0.0,1.0,50,1050,800,250,0.7619047619047619,13,8,5,355.929872053647,0.4342091836734694,0.22377536018817978,0.19184112438263953,128069.20750070884,-883.2686720521301,127185.93882865671,3682,3,653.26,41,9,18,37.94257816328533,0.5922256097560974,46.94940476190477,1012.2023809523827,24.687862950058115,0
3714,4,1,2,49,0.0196078431372549,0.0392156862745098,0.9607843137254902,51,1550,1100,450,0.7096774193548387,20,11,9,347.3347624335631,0.4360294117647059,0.21987732698475715,0.18896285699367235,128442.17985243622,-1277.4246178035125,127164.75523463271,3683,0,641.4313725490196,38,13,16,37.7790805930298,0.6008771929824561,46.58119658119658,1013.6752136752134,26.675663517768772,0
3715,4,3,3,49,0.057692307692307696,0.057692307692307696,0.9423076923076923,52,1200,800,400,0.6666666666666666,16,8,8,341.75678017574376,0.44042232277526394,0.22086486187932497,0.1881302569132313,128910.32036675356,-1588.8047960069337,127321.51557074662,3684,0,628.6730769230769,39,13,16,37.443263411631975,0.6038995726495726,46.11979166666667,1015.520833333334,26.038995726495745,0
3716,4,1,1,49,0.02,0.02,0.98,50,1450,800,650,0.5517241379310345,21,8,13,357.0764255603972,0.434030612244898,0.22924805531547143,0.1957997271911751,128755.86718990459,-804.8630347799301,127951.00415512465,3685,0,654.8,37,13,16,37.211898588303086,0.6058558558558558,46.271929824561404,1014.9122807017544,27.430061640587958,0
3717,4,0,0,49,0.0,0.0,1.0,49,1400,1000,400,0.7142857142857143,18,10,8,366.10455182408054,0.43181335034013607,0.23396469106950346,0.20068942950356541,128743.83674214764,-373.25906988067976,128370.57767226697,3686,7,669.1632653061224,36,13,16,36.995117620949834,0.6076388888888888,46.28378378378379,1014.8648648648657,28.190690690690715,0
3718,4,1,2,48,0.02,0.04,0.96,50,1250,1000,250,0.8,15,10,5,355.8891535768349,0.4339030612244898,0.22170084178717886,0.1965237721718089,129034.22807979386,-815.623557248377,128218.60452254549,3687,0,656.76,37,13,16,36.958144470825246,0.6086711711711711,45.99780701754386,1016.0087719298251,27.45969653864392,0
3719,4,1,1,48,0.02040816326530612,0.02040816326530612,0.9795918367346939,49,1400,1100,300,0.7857142857142857,17,11,6,363.01142294248154,0.4338151927437642,0.23596232199948464,0.20101479162446872,129144.1504849445,-423.83963355245703,128720.31085139205,3688,0,670.1428571428571,36,13,17,36.66514328975552,0.6116898148148149,45.88963963963965,1016.4414414414423,28.234484484484508,0
3720,4,2,2,48,0.04,0.04,0.96,50,1200,700,500,0.5833333333333334,17,7,10,348.3972312852118,0.4370323129251701,0.22676671214188282,0.194942878268748,129554.63927469117,-972.7044753086658,128581.9347993825,3689,0,652.44,38,12,14,36.61891768985903,0.6121162280701755,45.4861111111111,1018.055555555554,26.79093567251458,0
3721,4,0,0,48,0.0,0.0,1.0,48,1600,1400,200,0.875,18,14,4,365.1131602816764,0.4335752807328605,0.2349522939504669,0.20291304310792738,129287.27027280664,-159.10323330086473,129128.16703950577,3690,2,680.625,36,12,18,36.46583065736537,0.6131365740740742,45.748873873873876,1017.0045045045049,28.250125125125138,0
3722,4,1,0,49,0.02040816326530612,0.0,1.0,49,1450,1000,450,0.6896551724137931,19,10,9,356.0623423452651,0.4341340702947846,0.23009160607192292,0.19998906652887016,129703.52055440136,-563.492132194523,129140.02842220683,3691,0,667.7142857142857,37,12,15,36.272425547183346,0.6154279279279279,45.33991228070175,1018.640350877193,27.530820293978188,0
3723,4,0,2,47,0.0,0.04081632653061224,0.9591836734693877,49,1800,1000,800,0.5555555555555556,26,10,16,356.0772881351539,0.4326814058956916,0.2291824882243707,0.20114256531474245,129927.00277970135,-547.1890389350726,129379.81374076627,3692,1,668.7142857142857,37,12,15,36.04493797949377,0.6176801801801803,45.12061403508771,1019.5175438596484,27.55452821242293,0
3724,4,0,0,47,0.0,0.0,1.0,47,1200,1000,200,0.8333333333333334,14,10,4,371.5431911725094,0.42824930619796486,0.22398298625161184,0.20845140328561879,129659.75265806344,234.83965384303008,129894.59231190647,3693,2,696.6382978723404,36,11,16,35.92275726079907,0.6168981481481481,45.38288288288288,1018.4684684684682,28.290790790790783,0
3725,4,0,0,47,0.0,0.0,1.0,47,1600,700,900,0.4375,25,7,18,370.7542482924354,0.4275940487203207,0.22956525010817042,0.20861843523320622,129774.47041636235,222.88724535346836,129997.35766171583,3694,3,697.6382978723404,36,11,16,35.82605732390215,0.6180555555555556,45.270270270270274,1018.9189189189192,28.30330330330331,0
3726,4,0,0,47,0.0,0.0,1.0,47,1100,600,500,0.5454545454545454,16,6,10,365.11998377650036,0.42688097440641376,0.22401759654836906,0.2063543279096403,129946.64216581464,89.22317587860164,130035.86534169325,3695,4,698.6382978723404,36,11,16,35.794492305426694,0.6197916666666665,45.10135135135136,1019.5945945945961,28.322072072072114,0
3727,4,0,0,47,0.0,0.0,1.0,47,2000,1600,400,0.8,24,16,8,366.0920822841213,0.4265148011100832,0.22247790976995163,0.20797243621168837,130147.65346004814,129.2050919162707,130276.85855196441,3696,5,699.6382978723404,36,11,17,35.565426921237545,0.6218171296296295,44.904279279279294,1020.3828828828849,28.343968968969026,0
3728,4,0,0,47,0.0,0.0,1.0,47,1050,700,350,0.6666666666666666,14,7,7,370.46331899704666,0.42628353376503236,0.22613659837373956,0.21092208061490156,130233.84871357857,249.37276803832404,130483.2214816169,3697,6,700.6382978723404,36,11,17,35.366330170638435,0.6226851851851851,44.81981981981983,1020.7207207207217,28.35335335335338,0
3729,4,1,0,48,0.020833333333333332,0.0,1.0,48,900,400,500,0.4444444444444444,14,4,10,363.1380291587436,0.4267693557919621,0.23470970568250937,0.2085526537146426,130570.58572108726,-116.97096702831413,130453.61475405894,3698,0,687.0208333333334,37,11,17,35.21159657404426,0.6241554054054053,44.49013157894737,1022.0394736842106,27.622688477951638,0
3730,4,0,0,48,0.0,0.0,1.0,48,1200,700,500,0.5833333333333334,17,7,10,363.1380291587436,0.4267970596926714,0.23470970568250937,0.2085526537146426,130570.58572108726,-116.97096702831413,130453.61475405894,3699,1,688.0208333333334,37,11,17,35.21159657404426,0.6241554054054053,44.49013157894737,1022.0394736842106,27.622688477951638,0
3731,4,0,0,48,0.0,0.0,1.0,48,1300,900,400,0.6923076923076923,17,9,8,364.9457510461371,0.4269355791962175,0.23288467038467076,0.21004655449099896,130654.64854570644,-63.628231763610586,130591.02031394283,3700,2,689.0208333333334,37,11,17,35.08016945516946,0.625,44.40789473684211,1022.3684210526321,27.631578947368435,0
3732,4,0,0,48,0.0,0.0,1.0,48,1550,1200,350,0.7741935483870968,19,12,7,362.46943855199765,0.42658466312056736,0.22960441680960564,0.2092274085899157,130766.77439212079,-120.20814096643448,130646.56625115435,3701,3,690.0208333333334,37,11,18,35.02983847913094,0.626126126126126,44.298245614035096,1022.8070175438608,27.64343290659083,0
3733,4,0,0,48,0.0,0.0,1.0,48,1600,1100,500,0.6875,21,11,10,359.12233060018934,0.42684323286052006,0.228381260933205,0.2086574487127547,131019.233381906,-189.61351088796,130829.61987101805,3702,4,691.0208333333334,37,11,19,34.859854164435404,0.6286599099099099,44.0515350877193,1023.793859649123,27.67010431484116,0
3734,4,1,1,48,0.02040816326530612,0.02040816326530612,0.9795918367346939,49,1250,800,450,0.64,17,8,9,351.9752699114701,0.4293154761904762,0.229689707409235,0.20586260908480633,131273.37643363298,-559.0035795163935,130714.37285411658,3703,0,677.8979591836735,38,11,20,34.78593272171252,0.6293859649122806,43.80341880341881,1024.7863247863258,26.968061178587522,0
3735,4,0,0,48,0.0,0.0,1.0,48,900,600,300,0.6666666666666666,12,6,6,359.80406327299437,0.4267231826241135,0.23558858682079276,0.20997185278948055,131187.67463306006,-159.62832313789949,131028.04630992215,3704,6,693.0208333333334,37,11,20,34.67201380712833,0.6303490990990992,43.88706140350877,1024.451754385964,27.687885253674704,0
3736,4,0,0,48,0.0,0.0,1.0,48,1750,1400,350,0.8,21,14,7,356.6096135783199,0.4262245124113475,0.22929477007504295,0.2084460715194322,131250.01161882828,-238.99681489191133,131011.01480393637,3705,7,694.0208333333334,40,8,20,34.690816225329755,0.62578125,43.82621951219513,1024.6951219512212,25.61737804878053,0
3737,4,0,0,48,0.0,0.0,1.0,48,1250,1100,150,0.88,14,11,3,357.00763089520035,0.4256242612293144,0.23969543890475165,0.20973622496333497,131443.5782911289,-214.63495295463298,131228.9433381743,3706,8,695.0208333333334,36,12,20,34.48504648949411,0.634837962962963,43.637387387387385,1025.45045045045,28.484734734734722,0
3738,4,0,0,48,0.0,0.0,1.0,48,1200,700,500,0.5833333333333334,17,7,10,355.4135153868397,0.425568853427896,0.23029625361284944,0.20959045557860814,131587.96623904307,-246.37166727538516,131341.5945717677,3707,9,696.0208333333334,36,12,16,34.3801448798156,0.6362847222222223,43.49662162162162,1026.0135135135133,28.50037537537537,0
3739,4,0,1,47,0.0,0.020833333333333332,0.9791666666666666,48,1200,1000,200,0.8333333333333334,14,10,4,353.79493231968024,0.42628915484633567,0.23445399843338377,0.2093696685446802,131721.7857898581,-279.4999422899664,131442.28584756816,3708,10,697.0208333333334,37,11,16,34.286655273089806,0.6356981981981983,43.366228070175424,1026.535087719296,27.74419155998097,0
3740,4,0,0,47,0.0,0.0,1.0,47,1100,900,200,0.8181818181818182,13,9,4,358.99477114679905,0.4268231575701511,0.23318850251781598,0.2128292797995134,131790.24252292843,62.40159077997566,131852.6441137084,3709,11,698.9787234042553,36,11,16,34.08413760327557,0.6383101851851851,43.29954954954955,1026.8018018018026,28.522272272272296,0
3741,4,0,0,47,0.0,0.0,1.0,47,1050,700,350,0.6666666666666666,14,7,7,358.98111080481726,0.42693879124267653,0.23063311898493843,0.21322612967081309,131862.52170138882,67.2309027777718,131929.7526041666,3710,12,699.9787234042553,37,10,16,34.01157876943881,0.6371058558558559,43.229166666666664,1027.0833333333328,27.759009009008995,0
3742,4,0,0,47,0.0,0.0,1.0,47,1350,600,750,0.4444444444444444,21,6,15,357.2440484800718,0.42676534073388833,0.23005971979381945,0.21266688273559534,131946.99931709742,27.456044167421965,131974.45536126485,3711,13,700.9787234042553,37,10,17,33.97100675916044,0.6379504504504505,43.1469298245614,1027.4122807017534,27.767899478425768,0
3743,4,0,0,47,0.0,0.0,1.0,47,800,300,500,0.375,13,3,10,355.2712542699605,0.4263798951588036,0.22948375666068732,0.21186324828411313,132013.44515897782,-19.88355157427904,131993.56160740354,3712,14,701.9787234042553,38,9,18,33.95471635998197,0.6367872807017545,43.08226495726495,1027.6709401709386,27.04397210976154,0
3744,4,1,1,47,0.020833333333333332,0.020833333333333332,0.9791666666666666,48,1400,1300,100,0.9285714285714286,15,13,2,347.69556160871673,0.427591238179669,0.22946202531645588,0.20872301950675223,132264.0313042533,-402.47667100696424,131861.55463324633,3713,0,688.3333333333334,39,9,19,33.89715189873418,0.6375534188034189,42.83854166666666,1028.645833333332,26.375534188034152,0
3745,4,0,1,46,0.0,0.02127659574468085,0.9787234042553191,47,1150,700,450,0.6086956521739131,16,7,9,352.4463922854387,0.4251850138760407,0.22796321797466135,0.21127524171427636,132210.4614257811,-80.57996961807069,132129.88145616304,3714,16,703.9787234042553,39,8,19,33.82889783584861,0.6370192307692308,42.89062499999999,1028.4374999999989,26.370192307692278,0
3746,4,0,0,46,0.0,0.0,1.0,46,1500,1100,400,0.7333333333333333,19,11,8,365.38077076115405,0.4241747181964573,0.2309765677908715,0.21963900264855835,132315.55103550255,469.11160420771824,132784.66263971027,3715,17,719.7826086956521,38,8,20,33.39044652128766,0.6398026315789476,42.78846153846152,1028.8461538461506,27.074898785425017,0
3747,4,0,1,45,0.0,0.021739130434782608,0.9782608695652174,46,1300,900,400,0.6923076923076923,17,9,8,362.52876303452473,0.42327898550724635,0.2207427434376814,0.21857412133329007,132427.7842747985,401.8532112602002,132829.6374860587,3716,18,720.7826086956521,35,11,20,33.350786198883014,0.6467261904761905,42.679398148148145,1029.2824074074072,29.408068783068774,0
3748,4,0,1,44,0.0,0.022222222222222223,0.9777777777777777,45,1650,1300,350,0.7878787878787878,20,13,7,370.3215661163846,0.4224537037037037,0.21530810020113367,0.2190448458890884,131703.53366457706,754.5317699456588,132458.06543452272,3717,19,735.1777777777778,36,9,15,33.88096544157983,0.6374421296296295,43.38400900900903,1026.4639639639665,28.51288788788796,3
3749,4,0,0,44,0.0,0.0,1.0,44,1100,800,300,0.7272727272727273,14,8,6,371.7815883550764,0.4224585976039465,0.21059808350035403,0.22024254327701337,131761.33639974456,997.287786096935,132758.6241858415,3718,20,745.7954545454545,36,8,16,33.785099265109125,0.6380208333333333,43.327702702702716,1026.689189189191,28.519144144144192,0
3750,4,1,0,45,0.022222222222222223,0.0,1.0,45,1150,800,350,0.6956521739130435,15,8,7,363.0638897948722,0.42390572390572395,0.20894008342813808,0.21709738716305652,132116.03570329354,593.3123653432112,132709.34806863675,3719,0,730.2,37,8,18,33.65107721843003,0.6396396396396395,42.98245614035089,1028.0701754385984,27.785680417259417,0
3751,4,0,0,45,0.0,0.0,1.0,45,950,600,350,0.631578947368421,13,6,7,363.38608616516495,0.4235900673400674,0.21028065062610324,0.2177762365586638,132200.5944737807,607.9713229070828,132808.56579668776,3720,1,731.2,37,8,18,33.55757099193234,0.6404842342342341,42.90021929824563,1028.39912280702,27.794570886676215,0
3752,4,0,0,45,0.0,0.0,1.0,45,1300,800,500,0.6153846153846154,18,8,10,363.38900817912076,0.4225589225589226,0.21340530814214986,0.21891971956156822,132398.00347222242,622.3958333333528,133020.39930555577,3721,2,732.2,37,8,20,33.358636977058026,0.6424549549549547,42.70833333333334,1029.1666666666683,27.81531531531536,0
3753,4,0,0,45,0.0,0.0,1.0,45,750,500,250,0.6666666666666666,10,5,5,364.47954945396225,0.4219907407407408,0.21031175059952067,0.2202724233656553,132517.14677640592,659.9579903977959,133177.1047668037,3722,3,733.2,35,10,21,33.21061900479617,0.6476190476190476,42.59259259259259,1029.6296296296289,29.417989417989396,0
3754,4,0,0,45,0.0,0.0,1.0,45,1100,700,400,0.6363636363636364,15,7,8,404.8527325977639,0.4216750841750842,0.25203624225083465,0.23234159284551478,130542.57079101262,1585.5889834573998,132128.15977447003,3723,4,734.2,37,8,17,34.17426680972819,0.6238738738738738,44.51754385964912,1021.9298245614035,27.61972498814604,7
3755,4,0,0,45,0.0,0.0,1.0,45,1100,800,300,0.7272727272727273,14,8,6,404.68909666954846,0.4215909090909091,0.25204258007605285,0.23241571596160568,130570.58572108718,1568.0984774161166,132138.6841985033,3724,5,735.2,37,8,17,34.149925794800254,0.6241554054054055,44.49013157894736,1022.03947368421,27.62268847795162,0
3756,4,0,0,45,0.0,0.0,1.0,45,1400,1000,400,0.7142857142857143,18,10,8,402.85630571192735,0.42127525252525255,0.2515373527274458,0.23237110472326203,130738.7384219183,1533.7850348184063,132272.5234567367,3725,6,736.2,37,8,17,34.025655802151455,0.6258445945945945,44.32565789473684,1022.6973684210528,27.640469416785212,0
3757,4,0,0,45,0.0,0.0,1.0,45,1350,1000,350,0.7407407407407407,17,10,7,402.56336111218246,0.4211279461279461,0.2484859310065608,0.23287778813005433,130850.90033712306,1535.1556488535032,132386.05598597656,3726,7,737.2,37,8,18,33.91908244918372,0.6269707207207207,44.21600877192983,1023.1359649122816,27.652323376007608,0
3758,4,0,1,44,0.0,0.022222222222222223,0.9777777777777777,45,1000,500,500,0.5,15,5,10,405.2866042280115,0.4211700336700337,0.2508453588607895,0.2346237339116506,130878.94833025559,1608.6969067405473,132487.64523699615,3727,8,738.2,37,8,18,33.820902986140865,0.6272522522522521,44.188596491228076,1023.2456140350888,27.65528686581321,0
3759,4,0,0,44,0.0,0.0,1.0,44,950,700,250,0.7368421052631579,12,7,5,407.15652081280655,0.42086196264975334,0.2591571168469531,0.23656629961600348,131019.23338190601,1869.067044667598,132888.3004265736,3728,9,750.4318181818181,37,7,18,33.63042643961302,0.6286599099099099,44.0515350877193,1023.7938596491231,27.670104314841165,0
3760,4,0,0,44,0.0,0.0,1.0,44,1200,800,400,0.6666666666666666,16,8,8,406.8335626993477,0.42079589499647635,0.2598928477581728,0.23707001304894615,131131.51552641197,1869.7403287550019,133001.25585516696,3729,10,751.4318181818181,37,7,18,33.524582485815216,0.629786036036036,43.94188596491228,1024.232456140351,27.68195827406354,0
3761,4,0,0,44,0.0,0.0,1.0,44,850,400,450,0.47058823529411764,13,4,9,409.22238202556775,0.41997004933051446,0.26746306544637566,0.23951168470838963,131300.02891514695,1946.182118536471,133246.21103368342,3730,11,752.4318181818181,37,7,18,33.29221051317714,0.6314752252252251,43.77741228070175,1024.8903508771928,27.6997392128971,0
3762,4,0,0,44,0.0,0.0,1.0,44,800,600,200,0.75,10,6,4,408.3435667933943,0.4203664552501762,0.268824962799477,0.23935296126981775,131356.9835671821,1927.758844341422,133284.7424115235,3731,12,753.4318181818181,36,8,18,33.25689333186862,0.6339699074074073,43.72184684684685,1025.112612612613,28.47535035035036,0
3763,4,0,0,44,0.0,0.0,1.0,44,1550,1200,350,0.7741935483870968,19,12,7,406.3581699986937,0.4201352184637068,0.2703988939576947,0.23890922234848963,131472.44953991158,1884.9808000568185,133357.4303399684,3732,13,754.4318181818181,36,8,18,33.19058599612019,0.6351273148148149,43.609234234234236,1025.5630630630635,28.487862862862876,0
3764,4,0,0,44,0.0,0.0,1.0,44,1600,1100,500,0.6875,21,11,10,407.3977881066029,0.42035544397463004,0.2713730634558025,0.2406102425803936,131645.74361100968,1926.4369521548615,133572.18056316453,3733,14,755.4318181818181,36,8,17,32.98813050952852,0.6368634259259259,43.44031531531532,1026.238738738739,28.506631631631635,0
3765,4,0,1,43,0.0,0.022727272727272728,0.9772727272727273,44,1150,700,450,0.6086956521739131,16,7,9,413.37346008553715,0.4194635306553911,0.2730836714552036,0.24525390907742445,131819.15181651246,2098.1077783864976,133917.25959489896,3734,15,756.4318181818181,36,8,17,32.65891727894141,0.6385995370370371,43.2713963963964,1026.9144144144145,28.525400400400404,0
3766,4,1,1,43,0.022727272727272728,0.022727272727272728,0.9772727272727273,44,900,700,200,0.7777777777777778,11,7,4,412.5965066254692,0.42207320295983086,0.26807123734140337,0.2459831081484667,132003.33275623262,2092.8227916281835,134096.1555478608,3735,0,751.3863636363636,37,7,17,32.49217527386541,0.6385135135135136,43.09210526315789,1027.6315789473679,27.773826458036968,0
3767,4,0,0,43,0.0,0.0,1.0,43,650,400,250,0.6153846153846154,9,4,5,418.04076984479093,0.41901993355481726,0.272586238138145,0.2486745379476728,131918.83710612878,2429.49044417513,134348.32755030392,3736,17,769.8604651162791,37,6,17,32.43798253104209,0.637668918918919,43.17434210526316,1027.3026315789473,27.7649359886202,0
3768,4,0,0,43,0.0,0.0,1.0,43,1000,800,200,0.8,12,8,4,413.63723701540226,0.41823551125876707,0.27119047737184987,0.24697041145110674,132059.67821829778,2324.9600838719407,134384.6383021697,3737,18,770.8604651162791,37,6,17,32.408345779105325,0.6390765765765766,43.037280701754376,1027.850877192981,27.779753437648136,0
3769,4,0,1,42,0.0,0.023255813953488372,0.9767441860465116,43,1050,500,550,0.47619047619047616,16,5,11,412.67043005742687,0.4182124400147656,0.2684836098103027,0.24676007348331827,132116.03570329316,2304.076254232056,134420.11195752522,3738,19,771.8604651162791,37,6,17,32.37610210466439,0.6396396396396395,42.98245614035087,1028.0701754385952,27.785680417259332,0
3770,4,1,0,43,0.023255813953488372,0.0,1.0,43,1500,1300,200,0.8666666666666667,17,13,4,407.43006972116905,0.41816629752676265,0.25267325489867853,0.2456458040698551,132427.78427479876,2191.913995780182,134619.69827057896,3739,0,742.3255813953489,35,8,18,32.19538307282881,0.6467261904761903,42.67939814814816,1029.2824074074092,29.408068783068835,0
3771,4,0,0,43,0.0,0.0,1.0,43,650,400,250,0.6153846153846154,9,4,5,407.12529727528545,0.4176587301587302,0.25847931799222734,0.24621387025695865,132542.91453615797,2192.3146964532334,134735.2292326112,3740,1,743.3255813953489,36,7,18,32.08684200933217,0.6458333333333333,42.56756756756758,1029.7297297297314,28.60360360360365,0
3772,4,0,0,43,0.0,0.0,1.0,43,850,600,250,0.7058823529411765,11,6,5,405.61920650858895,0.417797157622739,0.25865449413200703,0.2454922331913336,132571.90626014545,2154.7422845142623,134726.64854465972,3741,2,744.3255813953489,36,7,18,32.09631857116822,0.6461226851851851,42.53941441441442,1029.8423423423437,28.60673173173177,0
3773,4,0,1,42,0.0,0.023255813953488372,0.9767441860465116,43,750,500,250,0.6666666666666666,10,5,5,405.524662518789,0.4170819490586932,0.25430647177494214,0.24595895444570848,132652.0314543899,2158.734057594653,134810.76551198453,3742,3,745.3255813953489,37,6,16,32.01780645733547,0.6449887387387387,42.46162280701755,1030.1535087719303,27.841986723565686,0
3774,4,1,1,42,0.023255813953488372,0.023255813953488372,0.9767441860465116,43,1150,900,250,0.782608695652174,14,9,5,397.68871781510813,0.4193660022148394,0.24152603629564595,0.24294250027540704,132920.79863393988,1972.2203959383687,134893.01902987825,3743,0,718.9302325581396,38,5,17,31.9484735460699,0.6458333333333333,42.20085470085471,1031.196581196583,27.136752136752186,0
3775,4,1,2,41,0.023255813953488372,0.046511627906976744,0.9534883720930233,43,750,600,150,0.8,9,6,3,400.01394565111536,0.4203349944629014,0.2382715305962686,0.24490390902102244,133003.4394061839,2040.6461164073446,135044.08552259125,3744,0,719.9069767441861,38,5,17,31.805195926117733,0.6466557017543859,42.1207264957265,1031.517094017095,27.14518668466039,0
3776,4,0,0,41,0.0,0.0,1.0,41,1500,1300,200,0.8666666666666667,17,13,4,416.2330779270247,0.41559959349593495,0.25046255569481923,0.2532151909020136,132765.01092884367,2852.23782798555,135617.2487568292,3745,26,755.9024390243902,37,4,17,31.627810582686102,0.6461148648648647,42.351973684210535,1030.5921052631593,27.85384068278809,0
3777,4,0,0,41,0.0,0.0,1.0,41,850,800,50,0.9411764705882353,9,8,1,414.6964394358064,0.41529471544715446,0.24989948719012856,0.25304286956618355,132878.0384950178,2820.8098886195853,135698.84838363738,3746,27,756.9024390243902,37,4,17,31.553205537239897,0.6472409909909909,42.242324561403514,1031.0307017543867,27.86569464201045,0
3778,4,0,0,41,0.0,0.0,1.0,41,1450,1000,450,0.6896551724137931,19,10,9,413.94264788799103,0.4150660569105691,0.2456345975324521,0.25315634239495755,132962.8407298401,2807.798072483857,135770.63880232396,3747,28,757.9024390243902,37,4,17,31.486994117230143,0.6480855855855854,42.160087719298254,1031.3596491228082,27.874585111427248,0
3779,4,0,0,41,0.0,0.0,1.0,41,1500,1300,200,0.8666666666666667,17,13,4,409.43378045623325,0.41471036585365856,0.24137199541388665,0.2512269029000193,133086.1058605451,2697.989489736297,135784.0953502814,3748,29,758.9024390243902,38,3,17,31.478868985987443,0.6474780701754386,42.0405982905983,1031.8376068376078,27.15362123256863,0
3780,4,0,0,41,0.0,0.0,1.0,41,1050,600,450,0.5714285714285714,15,6,9,410.2906992335695,0.41427845528455287,0.2475833183960654,0.25231180428361033,133168.7979970233,2727.5838492585417,135896.38184628185,3749,30,759.9024390243902,38,3,17,31.373348169616662,0.6483004385964912,41.96047008547009,1032.1581196581208,27.162055780476862,0
3781,4,0,0,41,0.0,0.0,1.0,41,1000,900,100,0.9,11,9,2,375.73596768305174,0.41443089430894314,0.21120367329931922,0.21720930139636951,130824.41332572428,1638.9119924896397,132463.32531821393,3750,31,760.9024390243902,35,6,18,34.63214635893955,0.630654761904762,44.24189814814814,1023.032407407406,29.229497354497315,7
3782,4,0,0,41,0.0,0.0,1.0,41,900,600,300,0.6666666666666666,12,6,6,373.70577085534774,0.4142530487804878,0.20843712670327874,0.21618403892444182,130850.90033712279,1579.9473155201379,132430.84765264293,3751,32,761.9024390243902,37,4,18,34.65721341049547,0.6269707207207208,44.216008771929815,1023.1359649122793,27.652323376007548,0
3783,4,0,0,41,0.0,0.0,1.0,41,1400,1100,300,0.7857142857142857,17,11,6,379.36365582087024,0.41384654471544713,0.2142027009733638,0.2207400113215639,131075.36844269364,1745.0461920975354,132820.41463479117,3752,33,762.9024390243902,37,4,18,34.284876146625244,0.6292229729729731,43.99671052631577,1024.0131578947346,27.676031294452287,0
3784,4,0,0,41,0.0,0.0,1.0,41,1150,700,450,0.6086956521739131,16,7,9,378.6854311491014,0.413744918699187,0.21306347938238557,0.22082891996222873,131159.5935768697,1733.6454485995557,132893.23902546926,3753,34,763.9024390243902,37,4,18,34.2168878898166,0.6300675675675677,43.91447368421052,1024.342105263157,27.68492176386911,0
3785,4,0,0,41,0.0,0.0,1.0,41,1150,1000,150,0.8695652173913043,13,10,3,377.8190082185936,0.4133892276422764,0.21083587534281256,0.22113176392105158,131300.02891514695,1721.5293407586923,133021.55825590563,3754,35,764.9024390243902,37,4,18,34.09683588317107,0.6314752252252251,43.77741228070175,1024.8903508771928,27.6997392128971,0
3786,4,0,0,41,0.0,0.0,1.0,41,1050,1000,50,0.9523809523809523,11,10,1,380.52493618927247,0.4135670731707317,0.20946915351506457,0.2230515790753398,131357.78523930462,1796.9885806951647,133154.7738199998,3755,36,765.9024390243902,35,6,18,33.969012269015096,0.6360119047619048,43.72106481481481,1025.11574074074,29.289021164021143,0
3787,4,0,0,41,0.0,0.0,1.0,41,1050,900,150,0.8571428571428571,12,9,3,380.6644819958508,0.4141006097560975,0.20833590614387143,0.2201360164820055,130838.01442912519,1765.179497820062,132603.19392694524,3756,37,766.9024390243902,36,5,17,34.49229499174463,0.6287615740740741,44.22860360360361,1023.0855855855865,28.41904404404407,2
3788,4,1,1,41,0.023809523809523808,0.023809523809523808,0.9761904761904762,42,750,500,250,0.6666666666666666,10,5,5,373.341720906983,0.41574719318621756,0.20641791711990987,0.21758219321186914,131136.55495516473,1391.749420154871,132528.3043753196,3757,0,749.6190476190476,38,4,18,34.37706442752339,0.628015350877193,43.93696581196581,1024.2521367521367,26.95400359874044,0
3789,4,1,0,42,0.023809523809523808,0.0,1.0,42,1800,1500,300,0.8333333333333334,21,15,6,378.2361777554156,0.41549312814556716,0.15185641210446787,0.2094609426754958,129147.08547921662,1381.6962981225504,130528.78177733917,3758,0,750.5952380952381,38,4,19,36.2752697778712,0.6080043859649125,45.88675213675212,1016.4529914529893,26.748762932973403,6
3790,4,1,1,42,0.023255813953488372,0.023255813953488372,0.9767441860465116,43,1350,800,550,0.5925925925925926,19,8,11,366.82306914900596,0.4156746031746032,0.1534947174720016,0.2052529081574205,129554.63927469101,904.7374945211112,130459.37676921212,3759,0,734.1162790697674,38,5,17,36.14995452478399,0.6121162280701755,45.48611111111109,1018.0555555555527,26.790935672514546,0
3791,4,5,4,43,0.10638297872340426,0.0851063829787234,0.9148936170212766,47,1400,900,500,0.6428571428571429,19,9,10,339.185386842297,0.4265148011100832,0.14710931695163199,0.19403257388457168,130418.24811826611,-548.9491874508972,129869.29893081522,3760,0,672.531914893617,40,7,19,35.9777634066262,0.6174479166666667,44.63922764227642,1021.4430894308932,25.536077235772332,0
3792,4,1,0,44,0.022727272727272728,0.0,1.0,44,750,500,250,0.6666666666666666,10,5,5,350.35401915868397,0.4219961240310077,0.17671614100185562,0.19962031324157575,130262.58680555549,327.6041666666622,130590.19097222215,3761,0,716.5681818181819,39,5,20,35.85034013605441,0.6175213675213675,44.791666666666664,1020.8333333333328,26.175213675213662,0
3793,4,1,1,44,0.022222222222222223,0.022222222222222223,0.9777777777777777,45,900,700,200,0.7777777777777778,11,7,4,345.9362583123926,0.42373737373737375,0.17560706035788098,0.1981593848897141,130470.15587819749,26.8715091876484,130497.02738738514,3762,0,701.6222222222223,40,5,20,35.75280181703637,0.6179687500000001,44.58841463414634,1021.6463414634145,25.541158536585364,0
3794,4,0,0,44,0.0,0.0,1.0,44,1350,1100,250,0.8148148148148148,16,11,5,351.5167084889276,0.4218419661733615,0.1831877972134932,0.20124485464979056,130448.74267578125,370.98253038194525,130819.72520616319,3763,2,718.5681818181819,39,5,20,35.631967812107,0.6193910256410255,44.609375,1021.5625,26.193910256410255,0
3795,4,0,0,44,0.0,0.0,1.0,44,1000,800,200,0.8,12,8,4,349.9882421915665,0.42140151515151514,0.18390895529135198,0.20074910297981757,130522.07396597596,336.23824690991097,130858.31221288587,3764,3,719.5681818181819,40,4,16,35.59671805072103,0.6184895833333334,44.53760162601626,1021.8495934959351,25.546239837398378,0
3796,4,0,0,44,0.0,0.0,1.0,44,850,600,250,0.7058823529411765,11,6,5,350.0158417033264,0.42150061663143057,0.18541549919557454,0.20116910490583192,130599.97046235719,342.41171756231176,130942.3821799195,3765,4,720.5681818181819,40,4,16,35.517125671107586,0.6192708333333332,44.461382113821145,1022.1544715447164,25.553861788617912,0
3797,4,2,3,43,0.043478260869565216,0.06521739130434782,0.9347826086956522,46,1100,700,400,0.6363636363636364,15,7,8,349.54709969143613,0.427073268921095,0.13346581114728995,0.20138881124354302,130694.03863322776,-9.599821692327708,130684.43881153542,3766,0,690.195652173913,36,10,14,35.43387481644641,0.6273148148148149,44.369369369369366,1022.522522522522,28.403403403403388,7
3798,4,3,3,43,0.06521739130434782,0.06521739130434782,0.9347826086956522,46,950,600,350,0.631578947368421,13,6,7,348.5367738450952,0.42502012882447665,0.13475964482547442,0.20200906892246331,130924.43795146496,-73.60375578281356,130850.83419568215,3767,0,690.8913043478261,36,10,16,35.226626687206576,0.6296296296296295,44.14414414414414,1023.4234234234233,28.428428428428425,0
3799,4,4,3,44,0.0851063829787234,0.06382978723404255,0.9361702127659575,47,1000,600,400,0.6,14,6,8,343.86516968442055,0.4279024051803885,0.13625217717974114,0.20096435338967517,131243.84576263835,-373.9625413588999,130869.88322127945,3768,0,677.1063829787234,37,10,18,35.02351970750846,0.6309121621621623,43.83223684210525,1024.6710526315776,27.693812233285882,0
3800,4,0,0,44,0.0,0.0,1.0,44,1250,800,450,0.64,17,8,9,365.9750217457028,0.41967274489076817,0.14542678538380893,0.21205446541779183,130913.23329260966,782.1946802126122,131695.42797282228,3769,1,724.2727272727273,35,9,18,34.791808037397274,0.631547619047619,44.15509259259259,1023.379629629629,29.239417989417973,0
3801,4,0,0,44,0.0,0.0,1.0,44,1100,800,300,0.7272727272727273,14,8,6,365.60404298694135,0.4190891472868217,0.15362276825879184,0.2128555164483513,131097.3705969484,785.9457430403488,131883.31633998876,3770,2,725.2727272727273,36,8,20,34.614855948977336,0.6313657407407407,43.97522522522523,1024.0990990991,28.44719719719722,0
3802,4,1,0,45,0.022222222222222223,0.0,1.0,45,1200,800,400,0.6666666666666666,16,8,8,355.19945974723186,0.4201599326599326,0.15521699331653038,0.20885351113604675,131476.45968632132,340.47930122864386,131816.93898754998,3771,0,710.1333333333333,35,10,21,34.49819903697853,0.6372023809523808,43.60532407407408,1025.578703703705,29.302248677248716,0
3803,4,1,1,45,0.021739130434782608,0.021739130434782608,0.9782608695652174,46,1250,900,350,0.72,16,9,7,345.3571258727404,0.4222926731078905,0.15524066619608146,0.20443347788674687,131732.4334469605,-101.05308010713145,131631.38036685335,3772,0,695.6739130434783,36,10,17,34.49246745648675,0.6377314814814814,43.35585585585586,1026.5765765765768,28.516016016016025,0
3804,4,0,0,45,0.0,0.0,1.0,45,900,600,300,0.6666666666666666,12,6,6,353.4258883248485,0.42024410774410775,0.1600565674298393,0.20889257757410318,131674.63705259314,307.4451140329512,131982.0821666261,3773,2,712.1333333333333,36,9,18,34.34368371004315,0.6371527777777778,43.41216216216216,1026.3513513513515,28.509759759759763,0
3805,4,0,0,45,0.0,0.0,1.0,45,1050,700,350,0.6666666666666666,14,7,7,352.5259160317859,0.4200757575757576,0.15746937282867024,0.20851873618622524,131703.53366457688,285.78176994563034,131989.31543452252,3774,3,713.1333333333333,36,9,18,34.337630279758635,0.6374421296296295,43.38400900900901,1026.463963963965,28.512887887887914,0
3806,4,0,0,45,0.0,0.0,1.0,45,1600,1400,200,0.875,18,14,4,350.3702955385213,0.42022306397306397,0.15103408772378768,0.20755854349738154,131761.33639974447,233.05167498581045,131994.3880747303,3775,4,714.1333333333333,36,9,18,34.33466783664216,0.6380208333333333,43.32770270270271,1026.6891891891903,28.519144144144175,0
3807,4,0,0,45,0.0,0.0,1.0,45,1700,1200,500,0.7058823529411765,22,12,10,348.42597117750364,0.4194234006734007,0.15218107874174458,0.20757150514331751,131975.1645337988,196.7149747999284,132171.8795085987,3776,5,715.1333333333333,37,8,20,34.169134386227014,0.6382319819819819,43.119517543859644,1027.5219298245606,27.77086296823137,0
3808,4,0,0,45,0.0,0.0,1.0,45,1050,900,150,0.8571428571428571,12,9,3,348.42597117750364,0.4194234006734007,0.15218107874174458,0.20757150514331751,131975.1645337988,196.7149747999284,132171.8795085987,3777,6,716.1333333333333,37,8,20,34.169134386227014,0.6382319819819819,43.119517543859644,1027.5219298245606,27.77086296823137,0
3809,4,0,0,45,0.0,0.0,1.0,45,1500,800,700,0.5333333333333333,22,8,14,346.9132118517252,0.4194234006734007,0.15585351488064392,0.20717889579301324,132068.34781804716,163.25094510189206,132231.59876314906,3778,7,717.1333333333333,38,7,20,34.11417732044487,0.6373355263157896,43.028846153846146,1027.8846153846139,27.049595141700365,0
3810,4,0,0,45,0.0,0.0,1.0,45,1550,1100,450,0.7096774193548387,20,11,9,349.86297628975916,0.4189604377104377,0.15110003001131234,0.20969993834154538,132205.65440317037,250.77274636568717,132456.42714953606,3779,8,718.1333333333333,38,7,20,33.900157559387765,0.6387061403508772,42.89529914529914,1028.4188034188028,27.06365272154744,0
3811,4,0,0,45,0.0,0.0,1.0,45,1450,900,550,0.6206896551724138,20,9,11,348.2599626071149,0.4193602693602694,0.150978151726048,0.20889088224415553,132233.1242809008,210.30058349770187,132443.42486439852,3780,9,719.1333333333333,38,7,20,33.9137322114885,0.6389802631578947,42.868589743589745,1028.5256410256416,27.066464237516882,0
3812,4,0,1,44,0.0,0.022222222222222223,0.9777777777777777,45,1450,1200,250,0.8275862068965517,17,12,5,354.5585505635578,0.41889730639730643,0.15750989282294459,0.21328878204107582,132343.03232750748,384.6707438454247,132727.7030713529,3781,10,720.1333333333333,38,7,20,33.6411501055619,0.6400767543859649,42.761752136752136,1028.9529914529915,27.07771030139451,0
3813,4,1,0,45,0.022222222222222223,0.0,1.0,45,900,600,300,0.6666666666666666,12,6,6,344.22991505527926,0.4199915824915825,0.17146743420653165,0.20898204995625408,132687.90486009655,135.0634865935021,132822.96834669006,3782,0,717.8666666666667,36,9,16,33.56036178817359,0.6472800925925927,42.4268018018018,1030.2927927927924,28.619244244244232,0
3814,4,0,0,45,0.0,0.0,1.0,45,1550,1100,450,0.7096774193548387,20,11,9,344.17273613624167,0.41914983164983166,0.17732128982129036,0.20943277135098937,132774.93709926127,139.50267835401496,132914.43977761528,3783,1,718.8666666666667,36,9,17,33.474468240093245,0.6481481481481483,42.342342342342334,1030.6306306306294,28.628628628628594,0
3815,4,0,0,45,0.0,0.0,1.0,45,1200,900,300,0.75,15,9,6,344.76692005091104,0.419212962962963,0.1728222489170399,0.21060911853943914,132920.05423920543,165.28754261018054,133085.3417818156,3784,2,719.8666666666667,36,9,18,33.31353973280915,0.6495949074074074,42.20157657657658,1031.1936936936938,28.644269269269273,0
3816,4,0,1,44,0.0,0.022222222222222223,0.9777777777777777,45,1050,900,150,0.8571428571428571,12,9,3,342.8500195920424,0.4190025252525253,0.16348201508646865,0.21025380719560194,133065.2506391527,124.28475773071077,133189.5353968834,3785,3,720.8666666666667,36,9,20,33.21736520410392,0.6510416666666666,42.060810810810814,1031.756756756757,28.65990990990992,0
3817,4,0,0,44,0.0,0.0,1.0,44,1350,1100,250,0.8148148148148148,16,11,5,350.68522485548203,0.41714015151515155,0.1662274563519246,0.21455751332340425,132978.12328798397,526.6926132213364,133504.8159012053,3786,4,737.9318181818181,36,8,20,33.1026858827383,0.6501736111111112,42.145270270270274,1031.4189189189192,28.650525525525534,0
3818,4,0,0,44,0.0,0.0,1.0,44,1150,600,550,0.5217391304347826,17,6,11,353.1493620062454,0.4166005990133897,0.17020411401820978,0.2172461108824999,133181.46482631293,606.5898668939357,133788.05469320688,3787,5,738.9318181818181,36,8,20,32.83511528111136,0.6521990740740741,41.948198198198206,1032.2072072072083,28.672422422422454,0
3819,4,2,1,45,0.043478260869565216,0.021739130434782608,0.9782608695652174,46,1650,1300,350,0.7878787878787878,20,13,7,334.56150623845764,0.4201892109500805,0.17324190253866334,0.20945237155264781,133831.2596450617,-245.04243827160838,133586.2172067901,3788,0,707.7608695652174,38,8,16,32.66498881431766,0.6548793859649124,41.31944444444444,1034.7222222222222,27.22953216374269,0
3820,4,0,1,44,0.0,0.022222222222222223,0.9777777777777777,45,1050,600,450,0.5714285714285714,15,6,9,340.81321774895105,0.4170875420875421,0.18026470726767507,0.21325686489914464,133812.35091566626,121.00357802399799,133933.35449369025,3789,1,724.4888888888889,37,8,18,32.52216687862088,0.6565315315315315,41.33771929824561,1034.6491228070167,27.963489805595046,0
3821,4,0,0,44,0.0,0.0,1.0,44,1350,900,450,0.6666666666666666,18,9,9,347.7020308784998,0.41682082452431285,0.17694911228549337,0.21727828949999328,133763.29665814468,501.95398100803897,134265.2506391527,3790,2,695.6818181818181,36,8,19,32.39304376224689,0.6579861111111112,41.38513513513514,1034.45945945946,28.734984984985,0
3822,4,0,0,44,0.0,0.0,1.0,44,1500,1200,300,0.8,18,12,6,348.5886361144207,0.4160059901338971,0.17715598690133416,0.21834907820418645,133850.68081172407,531.7652534291228,134382.4460651532,3791,3,696.6818181818181,36,8,20,32.28271121268182,0.6588541666666665,41.300675675675684,1034.7972972972987,28.74436936936941,0
3823,4,0,0,44,0.0,0.0,1.0,44,1650,1300,350,0.7878787878787878,20,13,7,345.53920744917616,0.4153453136011276,0.17297993532628575,0.2171252176404839,133967.23740209828,458.1866072153501,134425.42400931363,3792,4,697.6818181818181,36,8,20,32.24509590630553,0.660011574074074,41.188063063063076,1035.2477477477496,28.756881881881935,0
3824,4,0,0,44,0.0,0.0,1.0,44,950,500,450,0.5263157894736842,14,5,9,345.5649566502329,0.41525722339675825,0.17481756877014631,0.2173135575541892,133996.38447569215,460.89095852611547,134457.27543421826,3793,5,698.6818181818181,36,8,21,32.215303458777456,0.6603009259259258,41.15990990990992,1035.3603603603622,28.76001001001006,0
3825,4,0,0,44,0.0,0.0,1.0,44,1050,900,150,0.8571428571428571,12,9,3,342.0274910120088,0.4148057610993658,0.1691732481935806,0.21560156510194994,134083.84471887446,372.0721988880991,134455.91691776257,3794,6,699.6818181818181,36,8,21,32.21951904606574,0.6611689814814814,41.07545045045046,1035.6981981981999,28.76939439439444,0
3826,4,0,0,44,0.0,0.0,1.0,44,1100,800,300,0.7272727272727273,14,8,6,342.0180162443966,0.4143212649753347,0.16607365237502258,0.2157669213591195,134113.0044740688,373.81274855938716,134486.8172226282,3795,7,700.6818181818181,36,8,22,32.19064832934696,0.6614583333333333,41.047297297297305,1035.8108108108117,28.77252252252255,0
3827,4,0,0,44,0.0,0.0,1.0,44,1700,1400,300,0.8235294117647058,20,14,6,339.03471599839287,0.4133412614517266,0.16176209191633895,0.21525197210215238,134346.39665002862,309.6184867299944,134656.01513675862,3796,8,701.6818181818181,36,8,22,32.035040553262355,0.6637731481481481,40.82207207207208,1036.7117117117134,28.797547547547595,0
3828,4,0,0,44,0.0,0.0,1.0,44,1000,600,400,0.6,14,6,8,345.46162955717256,0.4128127202255109,0.16802688193265647,0.22038729442386984,134521.57393880398,494.4084286990038,135015.982367503,3797,9,702.6818181818181,36,8,22,31.693714719930522,0.6655092592592591,40.65315315315317,1037.38738738739,28.81631631631639,0
3829,4,0,1,43,0.0,0.022727272727272728,0.9772727272727273,44,950,500,450,0.5263157894736842,14,5,9,343.7113460943417,0.41217406624383374,0.16732353376411968,0.2197987546328495,134609.20538359322,453.342235816918,135062.54761941012,3798,10,703.6818181818181,36,8,22,31.6517453427383,0.6663773148148147,40.5686936936937,1037.7252252252265,28.825700700700736,0
3830,4,0,0,43,0.0,0.0,1.0,43,1000,700,300,0.7,13,7,6,346.93570045064996,0.41145256552233295,0.16040076215472743,0.22186068561087727,134609.20538359322,740.1477913724736,135349.35317496568,3799,11,701.8139534883721,36,7,22,31.568095496473152,0.6663773148148147,40.5686936936937,1037.7252252252265,28.825700700700736,0
3831,4,1,0,44,0.022727272727272728,0.0,1.0,44,1450,1000,450,0.6896551724137931,19,10,9,339.8766085550967,0.41240530303030304,0.1690469796082794,0.21973741445328848,135006.20984341353,377.0905470914315,135383.30039050497,3800,0,686.8409090909091,37,7,18,31.355947105577826,0.6683558558558558,40.18640350877194,1039.2543859649136,28.087956377430096,0
3832,4,0,0,44,0.0,0.0,1.0,44,1350,800,550,0.5925925925925926,19,8,11,341.082967538283,0.41186575052854124,0.16847331025687762,0.22103948156052378,135091.68836805562,415.4947916666763,135507.1831597223,3801,1,687.8409090909091,37,7,18,31.239562458249836,0.6692004504504503,40.10416666666667,1039.583333333334,28.096846846846862,0
3833,4,0,0,44,0.0,0.0,1.0,44,900,700,200,0.7777777777777778,11,7,4,333.7938704144138,0.41186575052854124,0.13414925624947305,0.21118504560661405,134218.45465565397,179.7907421104332,134398.2453977644,3802,2,688.8409090909091,38,6,17,32.298432828126614,0.658717105263158,40.94551282051281,1036.2179487179471,27.2688933873144,3
3834,4,0,0,44,0.0,0.0,1.0,44,1250,900,350,0.72,16,9,7,335.9814146107424,0.41127114164904865,0.13314298766560095,0.2129308965208206,134280.73459201373,223.16623263886936,134503.9008246526,3803,3,689.8409090909091,39,5,17,32.17964824120602,0.6575854700854702,40.88541666666666,1036.458333333332,26.575854700854663,0
3835,4,0,0,44,0.0,0.0,1.0,44,1400,1200,200,0.8571428571428571,16,12,4,342.4883419585158,0.41058844256518673,0.12648531167049692,0.21819201111289702,134471.71512492554,410.99895069071545,134882.71407561627,3804,4,690.8409090909091,40,4,17,31.82053857208178,0.6578125000000001,40.70121951219512,1037.1951219512187,25.929878048780466,0
3836,4,0,1,43,0.0,0.022727272727272728,0.9772727272727273,44,1350,1100,250,0.8148148148148148,16,11,5,341.1235302656406,0.409982822410148,0.1271449434100036,0.2177942539388323,134550.78125000015,379.75721296848616,134930.53846296863,3805,5,691.8409090909091,37,7,17,31.77710843373494,0.6638513513513513,40.62500000000001,1037.5000000000011,28.040540540540572,0
3837,4,0,0,43,0.0,0.0,1.0,43,950,500,450,0.5263157894736842,14,5,9,347.1102501468496,0.4077380952380953,0.12466013248993213,0.2209609750934804,134442.73003472216,733.2899305555511,135176.01996527772,3806,6,708.5348837209302,39,4,17,31.729610285255127,0.6591880341880343,40.729166666666664,1037.083333333333,26.591880341880334,0
3838,4,0,0,43,0.0,0.0,1.0,43,1000,700,300,0.7,13,7,6,352.58112000928736,0.40676910299003327,0.12311396711778344,0.22529004436654473,134579.99173159653,890.2030514467274,135470.19478304326,3807,7,709.5348837209302,36,7,17,31.4507814195789,0.6660879629629629,40.59684684684685,1037.6126126126132,28.82257257257259,0
3839,4,1,1,43,0.022727272727272728,0.022727272727272728,0.9772727272727273,44,1050,600,450,0.5714285714285714,15,6,9,346.08812740258907,0.4092560782241015,0.11545531334888337,0.22252550269042257,134806.8651532204,531.0111043782892,135337.8762575987,3808,0,694.3863636363636,37,7,15,31.393090310773232,0.6663851351351351,40.37828947368422,1038.4868421052645,28.06721194879093,0
3840,4,0,0,43,0.0,0.0,1.0,43,1650,1200,450,0.7272727272727273,21,12,9,352.0730909880516,0.40646917681801403,0.12009410245871677,0.22659944997786496,134843.02873397068,894.920384911962,135737.94911888265,3809,9,711.5348837209302,36,7,15,31.20166070331417,0.6686921296296295,40.34346846846848,1038.626126126128,28.850725725725777,0
3841,4,0,0,43,0.0,0.0,1.0,43,900,500,400,0.5555555555555556,13,5,8,349.4359109247814,0.4052925433739387,0.11941697898734982,0.22562947166570754,134960.01649876242,831.9752607337242,135791.99175949613,3810,10,712.5348837209302,36,7,15,31.15358910443988,0.669849537037037,40.230855855855864,1039.0765765765777,28.86323823823827,0
3842,4,0,0,43,0.0,0.0,1.0,43,900,800,100,0.8888888888888888,10,8,2,355.9620006128935,0.4052925433739387,0.11581208555150835,0.22726804654515498,134550.78124999997,980.6701972242511,135531.45144722422,3811,11,713.5348837209302,37,6,18,31.392235609103093,0.6638513513513513,40.625,1037.4999999999998,28.040540540540533,1
3843,4,0,0,43,0.0,0.0,1.0,43,1050,600,450,0.5714285714285714,15,6,9,357.25816106215007,0.4047849760059062,0.11736262116242235,0.22863072984808983,134636.1154994805,1019.9702071791239,135656.08570665962,3812,12,714.5348837209302,37,6,18,31.273441627047013,0.6646959459459459,40.54276315789473,1037.8289473684204,28.049431009957306,0
3844,4,0,0,43,0.0,0.0,1.0,43,1050,500,550,0.47619047619047616,16,5,11,355.7482977647568,0.40448504983388706,0.11973956632045302,0.2283783479006427,134749.93657904342,987.4121123807174,135737.34869142415,3813,13,715.5348837209302,37,6,18,31.1990662512761,0.6658220720720721,40.43311403508771,1038.2675438596482,28.06128496917968,0
3845,4,0,0,43,0.0,0.0,1.0,43,1000,800,200,0.8,12,8,4,350.99330999530446,0.4039774824658546,0.11558290251505343,0.22581111624515918,134828.03397116298,864.7475847395723,135692.78155590256,3814,14,716.5348837209302,38,5,16,31.244642183588795,0.6647478070175439,40.35790598290598,1038.5683760683762,27.33074673864148,0
3846,4,0,0,43,0.0,0.0,1.0,43,650,500,150,0.7692307692307693,8,5,3,353.1699505276105,0.4039774824658546,0.11795796542718584,0.2277337267195279,134911.26543209862,929.3209876543078,135840.58641975292,3815,15,717.5348837209302,38,5,16,31.105169340463462,0.6655701754385965,40.27777777777777,1038.8888888888878,27.339181286549678,0
3847,4,0,0,43,0.0,0.0,1.0,43,650,300,350,0.46153846153846156,10,3,7,356.55380158368683,0.4033314876338132,0.11380453831459292,0.23044510485079892,134994.5225751516,1026.5620434290338,136021.08461858064,3816,16,718.5348837209302,38,5,16,30.93429800212467,0.6663925438596492,40.197649572649574,1039.209401709402,27.34761583445795,0
3848,4,0,1,42,0.0,0.023255813953488372,0.9767441860465116,43,1000,600,400,0.6,14,6,8,359.013225998241,0.4023394241417497,0.11479496120047905,0.23274868102524202,135105.57204918182,1100.9374543429037,136206.50950352472,3817,17,719.5348837209302,38,5,16,30.759728359538254,0.6674890350877192,40.090811965811966,1039.636752136752,27.35886189833558,0
3849,4,0,1,41,0.0,0.023809523809523808,0.9761904761904762,42,550,300,250,0.5454545454545454,8,3,5,361.00256625475396,0.4023785327138986,0.11360816871838919,0.2339484163131458,135091.6883680555,1353.6892361111059,136445.3776041666,3818,18,732.7619047619048,37,5,16,30.72186038744154,0.6692004504504505,40.104166666666664,1039.583333333333,28.096846846846837,0
3850,4,0,0,41,0.0,0.0,1.0,41,1200,800,400,0.6666666666666666,16,8,8,362.02521136975037,0.40243902439024387,0.10988728322212538,0.23479637853679702,135120.187221068,1583.3828678054758,136703.57008887347,3819,19,742.8048780487804,37,4,16,30.66687759263165,0.6694819819819819,40.07675438596491,1039.6929824561403,28.09981033665244,0
3851,4,0,1,40,0.0,0.024390243902439025,0.975609756097561,41,650,300,350,0.46153846153846156,10,3,7,361.5537083853502,0.4021341463414634,0.1044708592111212,0.23560587810166225,135291.24345952595,1583.0101569713702,136874.25361649733,3820,20,743.8048780487804,37,4,16,30.50871275997752,0.6711711711711712,39.91228070175438,1040.3508771929821,28.117591275486003,0
3852,4,0,0,40,0.0,0.0,1.0,40,1200,700,500,0.5833333333333334,17,7,10,359.7995322525396,0.4009081196581197,0.09499783573206377,0.23497579346612876,135369.87314595017,1741.2034077997118,137111.07655374988,3821,21,751.375,36,4,16,30.47604876817085,0.6739004629629628,39.83671171171172,1040.6531531531543,28.907032032032063,0
3853,4,0,1,39,0.0,0.025,0.975,40,1000,600,400,0.6,14,6,8,361.009956414544,0.4003205128205128,0.08743915630070309,0.23653699837366843,135487.0891795513,1782.4376318886602,137269.52681143995,3822,22,752.375,36,4,16,30.327879935100057,0.6750578703703705,39.72409909909911,1041.1036036036046,28.91954454454457,0
3854,4,0,0,39,0.0,0.0,1.0,39,1000,700,300,0.7,13,7,6,370.6280366894948,0.3984199280251912,0.08992179102264752,0.24240421337808202,135422.77688025124,2238.2955836334086,137661.07246388466,3823,23,771.025641025641,35,4,16,30.141614774454208,0.6764880952380952,39.78587962962963,1040.8564814814818,29.73875661375662,0
3855,4,0,0,39,0.0,0.0,1.0,39,1450,1100,350,0.7586206896551724,18,11,7,373.5521775825216,0.39766081871345027,0.09247639076489933,0.2453447075830316,135573.4056177127,2328.7481781550186,137902.15379586772,3824,24,772.025641025641,35,4,17,29.915444172779143,0.6779761904761903,39.64120370370371,1041.435185185186,29.755291005291024,0
3856,4,0,0,39,0.0,0.0,1.0,39,1200,1000,200,0.8333333333333334,14,10,4,373.14428867662184,0.39785762483130904,0.0903867396839626,0.24570245825501272,135664.68431122453,2324.5138210891396,137989.19813231367,3825,25,773.025641025641,34,5,17,29.83516169580619,0.6810661764705881,39.55357142857143,1041.7857142857147,30.64075630252102,0
3857,4,0,1,38,0.0,0.02564102564102564,0.9743589743589743,39,850,400,450,0.47058823529411764,13,4,9,373.4843912894404,0.39746401259559155,0.09249283029701161,0.24635334415647867,135726.70245181408,2338.360969387758,138065.06342120183,3826,26,774.025641025641,34,5,17,29.764556913820023,0.6816789215686274,39.49404761904762,1042.0238095238096,30.64775910364146,0
3858,4,0,0,38,0.0,0.0,1.0,38,850,700,150,0.8235294117647058,10,7,3,373.09241335948,0.39768551446183026,0.10225503807480307,0.24695164503317976,135850.78125000015,2536.979166666682,138387.76041666683,3827,27,790.2894736842105,34,4,17,29.651278976818535,0.6829044117647058,39.37500000000001,1042.5000000000011,30.661764705882387,0
3859,4,0,0,38,0.0,0.0,1.0,38,800,400,400,0.5,12,4,8,372.9999972236735,0.39777441915599815,0.10455110833368408,0.24732074002135931,135912.84190759645,2539.097930839016,138451.93983843547,3828,28,791.2894736842105,34,4,15,29.591943524755493,0.683517156862745,39.3154761904762,1042.7380952380959,30.66876750700282,0
3860,4,0,0,38,0.0,0.0,1.0,38,1200,1000,200,0.8333333333333334,14,10,4,372.62046245908124,0.3979077761972499,0.10790675318433074,0.24728448872284492,135943.87755102053,2531.0941043084035,138474.97165532893,3829,29,792.2894736842105,34,4,15,29.570966514459666,0.6838235294117647,39.28571428571429,1042.8571428571438,30.67226890756305,0
3861,4,0,0,38,0.0,0.0,1.0,38,950,700,250,0.7368421052631579,12,7,5,337.9690316805876,0.39777441915599815,0.07425318426181238,0.2172515743072781,134797.91843820858,1511.5043934240316,136309.4228316326,3830,30,793.2894736842105,34,4,18,31.61278612098284,0.6724877450980392,40.38690476190476,1038.4523809523807,30.542717086834728,5
3862,4,0,0,38,0.0,0.0,1.0,38,1300,1000,300,0.7692307692307693,16,10,6,336.9633877936618,0.39715208629682314,0.0679380004924317,0.21764440975622246,134971.3930148318,1496.083569101489,136467.47658393328,3831,31,794.2894736842105,35,3,18,31.466269399272292,0.6720238095238096,40.2199074074074,1039.120370370369,29.6891534391534,0
3863,4,0,1,37,0.0,0.02631578947368421,0.9736842105263158,38,650,400,250,0.6153846153846154,9,4,5,338.5502803121529,0.39682610241820765,0.06443983329523273,0.21885118552360103,135001.46182966806,1540.9565489968977,136542.41837866497,3832,32,795.2894736842105,35,3,18,31.395130304042766,0.6723214285714286,40.190972222222214,1039.23611111111,29.692460317460284,0
3864,4,0,0,37,0.0,0.0,1.0,37,300,200,100,0.6666666666666666,4,2,2,344.91829565698134,0.3947697697697698,0.07191307741387964,0.22228634031778574,134890.65334467115,1905.2508503401295,136795.90419501127,3833,33,816.4324324324324,34,3,18,31.3400087860035,0.6734068627450981,40.297619047619044,1038.8095238095234,30.553221288515395,0
3865,4,0,0,37,0.0,0.0,1.0,37,650,500,150,0.7692307692307693,8,5,3,344.05588649326165,0.3943943943943944,0.06710158434296387,0.2222993214803612,134983.4201388888,1888.368055555547,136871.78819444432,3834,34,817.4324324324324,34,3,18,31.27004811547716,0.6743259803921569,40.20833333333333,1039.1666666666658,30.563725490196052,0
3866,4,0,0,37,0.0,0.0,1.0,37,750,500,250,0.6666666666666666,10,5,5,345.88094198397397,0.39395645645645644,0.05881388086815775,0.22424486015932021,135107.1588010203,1946.1982709750453,137053.35707199536,3835,35,818.4324324324324,34,3,18,31.099469445398675,0.6755514705882353,40.08928571428571,1039.6428571428564,30.577731092436952,0
3867,4,0,0,37,0.0,0.0,1.0,37,950,600,350,0.631578947368421,13,6,7,344.3272939234453,0.3941128628628629,0.06008756323581754,0.22362073698299575,135169.04939058944,1908.4785997732297,137077.52799036267,3836,36,819.4324324324324,34,3,18,31.07827704636519,0.6761642156862746,40.0297619047619,1039.8809523809514,30.584733893557395,0
3868,4,0,0,37,0.0,0.0,1.0,37,1150,800,350,0.6956521739130435,15,8,7,345.6258805164892,0.3939877377377377,0.05746297974751702,0.22484983753332566,135230.9541524942,1947.8635204081493,137178.81767290234,3837,37,820.4324324324324,34,3,19,30.98293655335548,0.6767769607843138,39.97023809523809,1040.1190476190466,30.59173669467784,0
3869,4,0,0,37,0.0,0.0,1.0,37,1200,800,400,0.6666666666666666,16,8,8,346.5647252280772,0.3934246746746746,0.05613852781720974,0.22584855583655217,135292.87308673456,1977.5474773242477,137270.42056405882,3838,38,821.4324324324324,34,3,19,30.896937101880457,0.677389705882353,39.91071428571428,1040.3571428571418,30.598739495798288,0
3870,4,0,1,36,0.0,0.02702702702702703,0.972972972972973,37,850,700,150,0.8235294117647058,10,7,3,348.743124549554,0.39314314314314314,0.05196459039094026,0.2282492425944087,135447.7324263038,2047.2930839002224,137495.02551020402,3839,39,822.4324324324324,34,3,19,30.686280115888994,0.678921568627451,39.76190476190476,1040.9523809523805,30.616246498599427,0
3871,4,0,0,36,0.0,0.0,1.0,36,850,500,350,0.5882352941176471,12,5,7,356.7391306729879,0.3931712962962963,0.05864706421178001,0.2328264380126321,135346.60835075463,2456.6862805171254,137803.29463127174,3840,40,841.4444444444445,33,3,20,30.578823656420532,0.680239898989899,39.85906862745099,1040.563725490197,31.532234105763543,0
3872,4,0,1,35,0.0,0.027777777777777776,0.9722222222222222,36,650,400,250,0.6153846153846154,9,4,5,357.4259800418404,0.39292328042328045,0.061862144763699334,0.233481647885793,135378.4902441369,2477.5579104190697,137856.04815455596,3841,41,842.4444444444445,33,3,20,30.52922358298006,0.6805555555555556,39.82843137254902,1040.686274509804,31.535947712418302,0
3873,4,0,0,35,0.0,0.0,1.0,35,600,300,300,0.5,9,3,6,365.4360687414104,0.3917016806722689,0.06820522601564005,0.23801010042375353,135272.23186728408,2886.6705246913775,138158.90239197545,3842,42,859.6285714285714,32,3,20,30.426680017801512,0.6819661458333333,39.930555555555564,1040.2777777777787,32.508680555555586,0
3874,4,0,0,35,0.0,0.0,1.0,35,850,700,150,0.8235294117647058,10,7,3,364.277741880795,0.39037114845938375,0.07158624274452041,0.23855996678372957,135469.32591380988,2869.692027599233,138339.0179414091,3843,43,860.6285714285714,32,3,21,30.260511421063285,0.6839192708333333,39.74116161616162,1041.035353535354,32.532354797979814,0
3875,4,0,0,35,0.0,0.0,1.0,35,1000,700,300,0.7,13,7,6,363.72483327234,0.3897408963585434,0.0697311902452542,0.23885369624444763,135567.92674216928,2861.8843102744713,138429.81105244375,3844,44,861.6285714285714,32,3,21,30.17676002263175,0.6848958333333333,39.64646464646465,1041.4141414141423,32.544191919191945,0
3876,4,0,0,35,0.0,0.0,1.0,35,800,400,400,0.5,12,4,8,362.76281433683175,0.389390756302521,0.0763336045847256,0.2388791684830967,135666.5634405929,2842.9568730231726,138509.52031361609,3845,45,862.6285714285714,32,3,21,30.103674302104793,0.6858723958333333,39.55176767676768,1041.79292929293,32.55602904040406,0
3877,4,0,0,35,0.0,0.0,1.0,35,800,500,300,0.625,11,5,6,362.49863074806683,0.3888655462184874,0.07905696629796988,0.23914478014099094,135732.3411673554,2840.5575642791614,138572.89873163454,3846,46,863.6285714285714,32,3,21,30.045135102387015,0.6865234375,39.48863636363637,1042.0454545454547,32.56392045454546,0
3878,4,0,0,35,0.0,0.0,1.0,35,700,400,300,0.5714285714285714,10,4,6,363.6256084369929,0.388515406162465,0.07879983388704326,0.24055232558139533,135831.03764921942,2878.3287419650983,138709.3663911845,3847,47,864.6285714285714,32,3,21,29.91763565891472,0.6875,39.39393939393939,1042.424242424242,32.575757575757564,0
3879,4,0,0,35,0.0,0.0,1.0,35,800,700,100,0.875,9,7,2,364.5390268936983,0.38806022408963586,0.07467044943431533,0.24160218973420206,135896.8552316089,2907.941472808887,138804.7967044178,3848,48,865.6285714285714,32,3,18,29.82839872446921,0.6881510416666667,39.330808080808076,1042.6767676767668,32.58364898989896,0
3880,4,0,0,35,0.0,0.0,1.0,35,1350,1000,350,0.7407407407407407,17,10,7,367.09628756163505,0.38788515406162466,0.0752916774695358,0.2448790005405096,136127.34231519746,2994.3683999081713,139121.71071510564,3849,49,866.6285714285714,32,3,19,29.532667876588004,0.6904296875,39.109848484848484,1043.5606060606062,32.611268939393945,0
3881,4,0,1,34,0.0,0.02857142857142857,0.9714285714285714,35,950,500,450,0.5263157894736842,14,5,9,360.56666700783285,0.3872198879551821,0.06635342891691165,0.24164394944528175,136292.09551321287,2828.4773237424715,139120.57283695534,3850,50,867.6285714285714,32,3,19,29.539500201531645,0.6920572916666667,38.9520202020202,1044.1919191919187,32.63099747474746,0
3882,4,0,0,34,0.0,0.0,1.0,34,950,600,350,0.631578947368421,13,6,7,369.361078242716,0.385769459298871,0.08036867441587403,0.24673320026613424,136176.75781250003,3259.6788194444434,139436.43663194447,3851,51,891.5,31,3,19,29.424484364604123,0.6935483870967742,39.0625,1043.7500000000002,33.66935483870969,0
3883,4,0,0,34,0.0,0.0,1.0,34,1000,600,400,0.6,14,6,8,372.069166506452,0.3850638740344623,0.0788238228325373,0.24925836643402163,136278.70559692383,3341.020880805121,139619.72647772895,3852,52,892.5,31,3,19,29.2525304485181,0.6945564516129032,38.96484375,1044.140625,33.68195564516129,0
3884,4,0,0,34,0.0,0.0,1.0,34,950,800,150,0.8421052631578947,11,8,3,372.31360501489416,0.3845996732026144,0.07916972275194345,0.24966179868055616,136312.69666883675,3350.2143012152724,139662.91097005203,3853,53,893.5,31,3,19,29.212385702410643,0.6948924731182796,38.932291666666664,1044.270833333333,33.68615591397848,0
3885,4,0,0,34,0.0,0.0,1.0,34,1100,600,500,0.5454545454545454,16,6,10,371.39375982943466,0.3840983363042187,0.07645299176631903,0.24976463831614032,136414.6953158908,3332.7133178710883,139747.4086337619,3854,54,894.5,31,3,19,29.135116747683746,0.6959005376344086,38.834635416666664,1044.661458333333,33.6987567204301,0
3886,4,0,0,34,0.0,0.0,1.0,34,1100,900,200,0.8181818181818182,13,9,4,371.4720159936336,0.38331847890671417,0.07175004581271782,0.25029915435339284,136482.71560668945,3339.901902940538,139822.61750962998,3855,55,895.5,31,3,20,29.065550363447556,0.6965725806451613,38.76953125,1044.921875,33.70715725806452,0
3887,4,0,0,34,0.0,0.0,1.0,34,1150,900,250,0.782608695652174,14,9,5,370.7179331731068,0.3830770944741533,0.06856883261525848,0.2505154518109176,136584.77783203125,3326.8853081597226,139911.66314019097,3856,56,896.5,31,3,21,28.983972761999674,0.6975806451612903,38.671875,1045.3125,33.71975806451613,0
3888,4,0,0,34,0.0,0.0,1.0,34,800,500,300,0.625,11,5,6,368.4068506849093,0.382260101010101,0.07464260604640205,0.2499192419511145,136720.92013888902,3273.7847222222326,139994.70486111124,3857,57,897.5,31,3,22,28.909362549800782,0.6989247311827957,38.54166666666667,1045.8333333333344,33.73655913978498,0
3889,4,0,0,34,0.0,0.0,1.0,34,850,700,150,0.8235294117647058,10,7,3,366.172574947269,0.38149881164587046,0.07474285295947869,0.24912757321772283,136823.0713738335,3220.171271430117,140043.2426452636,3858,58,898.5,31,3,22,28.866547396805643,0.6999327956989247,38.444010416666664,1046.223958333333,33.74915994623655,0
3890,4,0,0,34,0.0,0.0,1.0,34,1350,900,450,0.6666666666666666,18,9,9,369.60491196659,0.38200014854426617,0.07729597623350903,0.2524429810789648,136959.33236016158,3324.1683959960833,140283.50075615768,3859,59,899.5,31,3,17,28.641751668947222,0.7012768817204302,38.31380208333333,1046.7447916666658,33.76596102150535,0
3891,4,0,0,34,0.0,0.0,1.0,34,900,600,300,0.6666666666666666,12,6,6,370.65088836426247,0.3805704099821747,0.07399565570353461,0.25414706693211964,137095.66116333008,3362.925720214844,140458.58688354492,3860,60,900.5,31,3,19,28.479345393509888,0.7026209677419355,38.18359375,1047.265625,33.78276209677419,0
3892,4,0,0,34,0.0,0.0,1.0,34,1050,800,250,0.7619047619047619,13,8,5,396.5690725548206,0.3805704099821747,0.06447508941434466,0.2509361895495307,134223.48684126625,3845.7767383430296,138069.26357960928,3861,61,901.5,32,2,20,30.66716420941472,0.6715494791666666,40.94065656565657,1036.2373737373741,32.38241792929294,7
3893,4,0,0,34,0.0,0.0,1.0,34,600,500,100,0.8333333333333334,7,5,2,396.5690725548206,0.3805704099821747,0.06447508941434466,0.2509361895495307,134223.48684126625,3845.7767383430296,138069.26357960928,3862,62,902.5,32,2,20,30.66716420941472,0.6715494791666666,40.94065656565657,1036.2373737373741,32.38241792929294,0
3894,4,0,0,34,0.0,0.0,1.0,34,1000,700,300,0.7,13,7,6,395.74509782056543,0.3806446821152703,0.07458955330792816,0.25153705443517677,134387.0842260994,3836.6059585756575,138223.69018467504,3863,63,903.5,32,2,20,30.524435785030033,0.6731770833333334,40.782828282828284,1036.868686868687,32.40214646464647,0
3895,4,0,0,34,0.0,0.0,1.0,34,550,300,250,0.5454545454545454,8,3,5,393.41919304282646,0.3803661616161616,0.07401107283288355,0.25028286850973924,134419.81565975404,3776.66708116518,138196.48274091922,3864,64,904.5,32,2,20,30.551919720767884,0.6735026041666667,40.75126262626262,1036.994949494949,32.406092171717155,0
3896,4,0,0,34,0.0,0.0,1.0,34,750,600,150,0.8,9,6,3,392.84083873677514,0.38016191325014853,0.07582049372816302,0.25058853502029066,134518.03387409443,3768.835450464233,138286.86932455865,3865,65,905.5,32,2,20,30.468496429730596,0.6744791666666667,40.656565656565654,1037.373737373737,32.41792929292928,0
3897,4,1,0,35,0.02857142857142857,0.0,1.0,35,950,800,150,0.8421052631578947,11,8,3,348.20156209404104,0.3830532212885154,0.052765054722530236,0.20927408285692586,132308.68115837208,2214.017891589529,134522.6990499616,3866,0,880.6,35,0,20,33.8392254471819,0.6455357142857141,42.7951388888889,1028.819444444446,29.39484126984131,8
3898,4,0,0,35,0.0,0.0,1.0,35,850,700,150,0.8235294117647058,10,7,3,351.1245007440301,0.38294817927170866,0.060388514870575394,0.21136411212695838,132368.2260186258,2295.545455032595,134663.7714736584,3867,1,881.6,35,0,20,33.70414370337045,0.6461309523809522,42.737268518518526,1029.050925925927,29.401455026455057,0
3899,4,0,0,35,0.0,0.0,1.0,35,1200,900,300,0.75,15,9,6,349.40212938482273,0.38259803921568625,0.0580746419071847,0.21083602322334694,132459.27047902488,2256.3135814060606,134715.58406043093,3868,2,882.6,34,1,20,33.6569041285995,0.649203431372549,42.64880952380952,1029.4047619047615,30.27661064425769,0
3900,4,0,0,35,0.0,0.0,1.0,35,1000,700,300,0.7,13,7,6,347.5429666635247,0.38147759103641454,0.057281553398058405,0.21057015039025312,132612.49999999988,2217.7083333333194,134830.2083333332,3869,3,883.6,34,1,21,33.55076860841423,0.6507352941176471,42.49999999999999,1029.999999999999,30.294117647058798,0
3901,4,0,0,35,0.0,0.0,1.0,35,850,500,350,0.5882352941176471,12,5,7,348.7630837840514,0.38098739495798317,0.055908370742011826,0.2120009307046873,132735.14739229018,2258.6238662131354,134993.77125850332,3870,4,884.6,34,1,16,33.39615103203941,0.6519607843137256,42.38095238095237,1030.47619047619,30.308123249299705,0
3902,4,0,0,35,0.0,0.0,1.0,35,1000,700,300,0.7,13,7,6,349.41566933515395,0.38053221288515404,0.051422633480133095,0.21326914109314749,132888.5363520405,2286.667375283412,135175.2037273239,3871,5,885.6,34,1,17,33.22533002347689,0.6534926470588237,42.23214285714284,1031.0714285714262,30.32563025210077,0
3903,4,0,0,35,0.0,0.0,1.0,35,1200,1000,200,0.8333333333333334,14,10,4,349.5006015747953,0.3794817927170868,0.052711747057466285,0.21419888353940397,133042.01388888867,2299.6527777777546,135341.66666666642,3872,6,886.6,34,1,17,33.06913031771675,0.6550245098039217,42.08333333333332,1031.666666666665,30.343137254901908,0
3904,4,0,0,35,0.0,0.0,1.0,35,800,500,300,0.625,11,5,6,350.32327257855627,0.377766106442577,0.06184160666919336,0.21558929003042282,133195.58000283432,2332.3022959183545,135527.88229875267,3873,7,887.6,34,1,17,32.89388959366471,0.6565563725490196,41.9345238095238,1032.2619047619037,30.36064425770305,0
3905,4,0,0,35,0.0,0.0,1.0,35,1000,800,200,0.8,12,8,4,347.8776503417516,0.37734593837535013,0.05770275833676397,0.21479278410780753,133318.49666950118,2275.7050736961446,135594.20174319734,3874,8,888.6,34,1,17,32.83381364073006,0.657781862745098,41.81547619047619,1032.7380952380956,30.37464985994399,0
3906,4,0,0,35,0.0,0.0,1.0,35,1100,800,300,0.7272727272727273,14,8,6,346.58447779669996,0.37692577030812324,0.06209405296857784,0.21470426001410114,133441.47002551015,2249.748441043081,135691.21846655323,3875,9,889.6,34,1,19,32.74402772976917,0.6590073529411764,41.69642857142857,1033.2142857142853,30.38865546218486,0
3907,4,0,0,35,0.0,0.0,1.0,35,900,700,200,0.7777777777777778,11,7,4,351.28509280879405,0.3773109243697479,0.06221739559680084,0.21815859626365885,133533.737244898,2381.682256235823,135915.41950113382,3876,10,890.6,34,1,19,32.53018697688703,0.6599264705882353,41.607142857142854,1033.5714285714287,30.39915966386555,0
3908,4,0,0,35,0.0,0.0,1.0,35,950,700,250,0.7368421052631579,12,7,5,355.2438601736253,0.3762955182072829,0.06729383901845365,0.221352092501299,133656.8098072562,2496.152210884346,136152.96201814056,3877,11,891.6,34,1,19,32.304618543249674,0.6611519607843137,41.488095238095234,1034.0476190476188,30.413165266106436,0
3909,4,0,0,35,0.0,0.0,1.0,35,850,600,250,0.7058823529411765,11,6,5,359.69150949267777,0.3755252100840336,0.0673023179352299,0.22487188615045833,133779.93905895695,2623.901643990933,136403.8407029479,3878,12,892.6,34,1,14,32.06631185270426,0.6623774509803921,41.36904761904762,1034.5238095238096,30.427170868347343,0
3910,4,0,0,35,0.0,0.0,1.0,35,850,600,250,0.7058823529411765,11,6,5,359.31867088185703,0.3751750700280112,0.0674194980028604,0.2248263908303975,133810.73022959195,2616.1387471655507,136426.8689767575,3879,13,893.6,34,1,14,32.04512330763626,0.6626838235294117,41.33928571428572,1034.642857142858,30.43067226890759,0
3911,4,0,0,35,0.0,0.0,1.0,35,650,300,350,0.46153846153846156,10,3,7,359.8417372354362,0.37514005602240896,0.06926426845902345,0.22553022507481232,133872.32320011334,2634.5698696145146,136506.89306972787,3880,14,894.6,34,1,14,31.969927911346296,0.663296568627451,41.279761904761905,1034.8809523809523,30.437675070028007,0
3912,4,0,0,35,0.0,0.0,1.0,35,600,500,100,0.8333333333333334,7,5,2,358.46810894069876,0.37538515406162465,0.06570048309178755,0.2248572683355292,133903.125,2600.0000000000014,136503.125,3881,15,895.6,34,1,14,31.974637681159436,0.6636029411764706,41.25,1035.0,30.441176470588236,0
3913,4,0,0,35,0.0,0.0,1.0,35,700,300,400,0.42857142857142855,11,3,8,360.1242600773908,0.37503501400560224,0.07203140656055473,0.22646425812675824,133995.55165816325,2651.009778911564,136646.56143707482,3882,16,896.6,34,1,15,31.839283661032532,0.6645220588235294,41.160714285714285,1035.3571428571427,30.451680672268903,0
3914,4,0,0,35,0.0,0.0,1.0,35,850,600,250,0.7058823529411765,11,6,5,361.36874091689793,0.3745798319327731,0.06801313628899841,0.22781942362152258,134088.01020408174,2691.0430839002383,136779.05328798198,3883,17,897.6,34,1,15,31.71455938697318,0.6654411764705882,41.07142857142858,1035.7142857142865,30.462184873949603,0
3915,4,0,0,35,0.0,0.0,1.0,35,750,500,250,0.6666666666666666,10,5,5,360.55453483427164,0.37342436974789917,0.07227373430704831,0.2282637982350793,134242.17864229047,2680.3252551020632,136922.50389739254,3884,18,898.6,34,1,16,31.581466590082314,0.6669730392156862,40.92261904761906,1036.3095238095254,30.47969187675075,0
3916,4,0,0,35,0.0,0.0,1.0,35,800,600,200,0.75,10,6,4,360.7025335755958,0.3731792717086835,0.0722799074848679,0.22912898358204697,134365.5771683674,2693.2008219954696,137058.77799036287,3885,19,899.6,34,1,17,31.454290580625404,0.6681985294117647,40.80357142857143,1036.7857142857147,30.493697478991606,0
3917,4,0,0,35,0.0,0.0,1.0,35,650,400,250,0.6153846153846154,9,4,5,358.69616315083385,0.3719187675070028,0.07423586514495639,0.22843281969079438,134458.16326530624,2645.9254535147566,137104.088718821,3886,20,900.6,34,1,19,31.413806626874816,0.6691176470588235,40.71428571428572,1037.142857142858,30.504201680672296,0
3918,4,0,0,35,0.0,0.0,1.0,35,700,400,300,0.5714285714285714,10,4,6,358.54260415154585,0.3709733893557423,0.0734366035570857,0.2289156626506025,134550.78125000012,2648.4375000000146,137199.21875000012,3887,21,901.6,34,1,19,31.32530120481927,0.6700367647058822,40.62500000000001,1037.500000000001,30.514705882352967,0
3919,4,0,1,34,0.0,0.02857142857142857,0.9714285714285714,35,950,800,150,0.8421052631578947,11,8,3,358.54260415154585,0.3709733893557423,0.0734366035570857,0.2289156626506025,134550.78125000012,2648.4375000000146,137199.21875000012,3888,22,902.6,34,1,19,31.32530120481927,0.6700367647058822,40.62500000000001,1037.500000000001,30.514705882352967,0
3920,4,0,0,34,0.0,0.0,1.0,34,550,200,350,0.36363636363636365,9,2,7,371.4907486643053,0.36998663101604273,0.07783586135943388,0.23635749738325965,134423.66667868133,3187.4297145328774,137611.09639321422,3889,23,897.3823529411765,33,1,19,31.11656030883164,0.6710858585858586,40.747549019607845,1037.009803921569,31.42453951277482,0
3921,4,0,0,34,0.0,0.0,1.0,34,750,600,150,0.8,9,6,3,370.52572220837874,0.3698566547831254,0.07429224791653666,0.2359487725394666,134455.43968966266,3163.839779171476,137619.27946883414,3890,24,898.3823529411765,33,1,19,31.109806412225772,0.6714015151515151,40.716911764705884,1037.1323529411766,31.428253119429595,0
3922,4,0,0,34,0.0,0.0,1.0,34,1100,900,200,0.8181818181818182,13,9,4,372.1168677250301,0.370153743315508,0.07216913936277414,0.23737522873341235,134518.9969753221,3211.3575607939415,137730.35453611604,3891,25,899.3823529411765,33,1,19,31.004996062216968,0.6720328282828282,40.65563725490197,1037.3774509803932,31.43568033273919,0
3923,4,0,0,34,0.0,0.0,1.0,34,400,300,100,0.75,5,3,2,369.4749214218438,0.3700794711824124,0.07453504609591532,0.2361014460134908,134582.56927924367,3144.9768418396907,137727.54612108337,3892,26,900.3823529411765,33,1,19,31.009975000984205,0.6726641414141414,40.594362745098046,1037.6225490196089,31.443107546048754,0
3924,4,0,0,34,0.0,0.0,1.0,34,800,300,500,0.375,13,3,10,367.12655297659717,0.36892825311942956,0.07430870377184284,0.23583497220399596,134773.3763005814,3095.7770148500513,137869.15331543147,3893,27,901.3823529411765,33,1,20,30.880320823006404,0.6745580808080809,40.41053921568627,1038.3578431372543,31.465389185977404,0
3925,4,0,0,34,0.0,0.0,1.0,34,800,700,100,0.875,9,7,2,364.5848898229358,0.36861259655377304,0.06959882325187716,0.23523216863918167,134932.48540224903,3038.8690647827634,137971.3544670318,3894,28,902.3823529411765,33,1,17,30.787528505150586,0.6761363636363638,40.257352941176464,1038.9705882352932,31.48395721925131,0
3926,4,0,0,34,0.0,0.0,1.0,34,850,600,250,0.7058823529411765,11,6,5,364.42446428696303,0.3684826203208556,0.06677556059565681,0.2357501053865548,135027.99591803632,3041.501015234523,138069.49693327086,3895,29,903.3823529411765,33,1,17,30.69643418622017,0.6770833333333334,40.16544117647059,1039.3382352941176,31.495098039215684,0
3927,4,0,0,34,0.0,0.0,1.0,34,950,800,150,0.8421052631578947,11,8,3,365.01861438307475,0.36755421865715987,0.07149593304255575,0.2365510241261744,135091.68836805553,3062.196180555551,138153.8845486111,3896,30,904.3823529411765,33,1,18,30.617484969939877,0.6777146464646465,40.104166666666664,1039.5833333333333,31.50252525252525,0
3928,4,0,0,34,0.0,0.0,1.0,34,950,800,150,0.8421052631578947,11,8,3,362.3200153501624,0.366198752228164,0.06443699063037123,0.2358414333046146,135250.98519800056,3000.827806612817,138251.8130046134,3897,31,905.3823529411765,33,1,19,30.52888391454602,0.6792929292929294,39.95098039215685,1040.196078431371,31.52109328579912,0
3929,4,0,0,34,0.0,0.0,1.0,34,1050,600,450,0.5714285714285714,15,6,9,360.31140888135224,0.3650289661319073,0.06539026350059607,0.23536649878618773,135378.49024413677,2955.682910419055,138334.17315455584,3898,32,906.3823529411765,33,1,19,30.45415292824619,0.6805555555555556,39.82843137254901,1040.686274509803,31.535947712418274,0
3930,4,1,1,34,0.02857142857142857,0.02857142857142857,0.9714285714285714,35,1050,800,250,0.7619047619047619,13,8,5,352.4583132854463,0.37100840336134455,0.059232570707980825,0.2265655023425902,134797.91843820867,2502.129393424045,137300.04783163272,3899,0,881.4571428571429,34,1,14,31.236625396461477,0.6724877450980391,40.386904761904766,1038.4523809523814,30.54271708683475,1
3931,4,0,0,34,0.0,0.0,1.0,34,750,500,250,0.6666666666666666,10,5,5,359.96481783752364,0.365084670231729,0.06391416070560463,0.23062798843296722,134677.95589436762,2895.865172049221,137573.82106641686,3900,34,908.3823529411765,33,1,20,31.16145218417946,0.673611111111111,40.50245098039216,1037.9901960784318,31.454248366013086,0
3932,4,0,0,34,0.0,0.0,1.0,34,750,600,150,0.8,9,6,3,353.22067428828484,0.3654374628639334,0.09204663285037684,0.21243845138427217,132334.94929834688,2548.688004613616,134883.6373029605,3901,35,909.3823529411765,33,1,17,33.68369858662855,0.6502525252525253,42.76960784313726,1028.9215686274515,31.179441473559137,5
3933,4,0,0,34,0.0,0.0,1.0,34,800,400,400,0.5,12,4,8,353.87010578099535,0.3651218062982769,0.09180714790976552,0.2133636050577587,132429.53619100826,2572.5707960880463,135002.1069870963,3902,36,910.3823529411765,33,1,17,33.571828987577895,0.651199494949495,42.677696078431374,1029.2892156862745,31.19058229352347,0
3934,4,0,0,34,0.0,0.0,1.0,34,800,600,200,0.75,10,6,4,353.0061272696915,0.3656602792632204,0.08942520368452,0.2137365629376432,132587.2561034218,2560.822760476738,135148.07886389853,3903,37,911.3823529411765,33,1,18,33.435467237823254,0.6527777777777778,42.52450980392157,1029.9019607843138,31.20915032679739,0
3935,4,0,0,34,0.0,0.0,1.0,34,900,500,400,0.5555555555555556,13,5,8,352.8773577160907,0.3661244800950683,0.08038656061782556,0.21455861901913273,132745.06987997395,2568.545901816601,135313.61578179055,3904,38,912.3823529411765,33,1,16,33.2801908669283,0.6543560606060606,42.37132352941176,1030.5147058823522,31.22771836007128,0
3936,4,0,0,34,0.0,0.0,1.0,34,900,700,200,0.7777777777777778,11,7,4,352.8121070616912,0.36629159239453357,0.08252916002349608,0.2150619887393441,132839.80320069208,2573.4981737793196,135413.3013744714,3905,39,913.3823529411765,33,1,16,33.186717387858614,0.6553030303030303,42.279411764705884,1030.8823529411768,31.23885918003566,0
3937,4,0,0,34,0.0,0.0,1.0,34,1150,900,250,0.782608695652174,14,9,5,352.00838830183204,0.3663287284610814,0.08348074758252322,0.21475319585085648,132871.38848339568,2554.368662293337,135425.75714568901,3906,40,914.3823529411765,33,1,16,33.175715163041325,0.6556186868686869,42.248774509803916,1031.0049019607834,31.242572786690406,0
3938,4,0,0,34,0.0,0.0,1.0,34,700,500,200,0.7142857142857143,9,5,4,350.0459136822776,0.3665144087938206,0.08205585264408821,0.21391694725028057,132934.57031249985,2506.6406249999854,135441.21093749983,3907,41,915.3823529411765,33,1,16,33.16287878787879,0.65625,42.18749999999999,1031.2499999999989,31.249999999999964,0
3939,4,0,0,34,0.0,0.0,1.0,34,700,400,300,0.5714285714285714,10,4,6,349.02476839552423,0.36606877599524656,0.07682980522611826,0.21365392549709997,132997.76715986623,2483.9029760188228,135481.67013588504,3908,42,916.3823529411765,33,1,16,33.12579204783971,0.6568813131313131,42.12622549019607,1031.4950980392143,31.257427213309526,0
3940,4,0,0,34,0.0,0.0,1.0,34,950,700,250,0.7368421052631579,12,7,5,352.3123882171733,0.36586452762923355,0.08205952214615064,0.2162150370837171,133092.5905901576,2578.0336889657774,135670.62427912338,3909,43,917.3823529411765,33,1,16,32.945863024544735,0.6578282828282829,42.03431372549019,1031.8627450980389,31.268568033273905,0
3941,4,0,0,34,0.0,0.0,1.0,34,750,600,150,0.8,9,6,3,350.94415432696184,0.3656231431966726,0.08253661193790118,0.21592422292885305,133187.4478115388,2548.2712478373614,135735.71905937616,3910,44,918.3823529411765,33,1,16,32.886021409632356,0.6587752525252526,41.94240196078431,1032.2303921568623,31.27970885323825,0
3942,4,0,0,34,0.0,0.0,1.0,34,1050,1000,50,0.9523809523809523,11,10,1,350.1403345662598,0.366198752228164,0.08586168861088228,0.215979682214883,133282.3388240099,2533.5045415224795,135815.84336553238,3911,45,919.3823529411765,33,1,16,32.8116346229923,0.6597222222222223,41.850490196078425,1032.5980392156857,31.290849673202597,0
3943,4,0,0,34,0.0,0.0,1.0,34,1150,1000,150,0.8695652173913043,13,10,3,392.75352816715383,0.36681149732620316,0.11791101507014212,0.2287276121876588,131108.39468293442,3498.656916810836,134607.05159974526,3912,46,920.3823529411765,33,1,17,33.908574647999664,0.6379419191919192,43.96446078431372,1024.1421568627447,31.034610814022567,6
3944,4,0,0,34,0.0,0.0,1.0,34,1050,800,250,0.7619047619047619,13,8,5,387.98711337567096,0.3656788472964943,0.1152623211446746,0.2268774994438712,131265.32613658195,3385.8509948096766,134651.17713139163,3913,47,921.3823529411765,33,1,18,33.871482101570614,0.6395202020202021,43.811274509803916,1024.7549019607832,31.05317884729646,0
3945,4,1,1,34,0.02857142857142857,0.02857142857142857,0.9714285714285714,35,950,500,450,0.5263157894736842,14,5,9,376.8942102776458,0.37356442577030813,0.10411332991978162,0.22184279465709522,131516.61169982693,2913.5849192618157,134430.19661908873,3914,0,896.0285714285715,33,2,18,33.90133412982875,0.6420454545454546,43.56617647058823,1025.7352941176466,31.082887700534744,0
3946,4,1,1,34,0.02857142857142857,0.02857142857142857,0.9714285714285714,35,1050,800,250,0.7619047619047619,13,8,5,375.3422850905789,0.37282913165266107,0.10576171708382409,0.2214757542680351,131610.90573637545,2879.827620386394,134490.73335676186,3915,0,897.0,33,2,15,33.845769138898845,0.6429924242424242,43.474264705882355,1026.102941176471,31.09402852049912,0
3947,4,0,0,34,0.0,0.0,1.0,34,600,500,100,0.8333333333333334,7,5,2,386.6015560171071,0.3654560308972074,0.1078769355562963,0.22720534283436636,131457.5760764207,3364.3406922762906,134821.91676869697,3916,50,924.3823529411765,32,2,19,33.71219116802102,0.6438802083333334,43.62373737373737,1025.50505050505,32.04703282828281,0
3948,4,1,1,34,0.02857142857142857,0.02857142857142857,0.9714285714285714,35,900,600,300,0.6666666666666666,12,6,6,374.8938586754671,0.37090336134453783,0.10069066662119064,0.22194246318900288,131736.68368235783,2877.4547349577238,134614.13841731555,3917,0,898.9428571428572,33,2,16,33.730129123393425,0.6442550505050504,43.35171568627452,1026.5931372549028,31.108882947118268,0
3949,4,0,0,34,0.0,0.0,1.0,34,750,500,250,0.6666666666666666,10,5,5,380.68926076714604,0.36402629233511585,0.10555676144996728,0.22525499927488357,131716.66953627192,3228.624311294774,134945.2938475667,3918,52,926.3823529411765,32,2,17,33.60162976629764,0.646484375,43.371212121212125,1026.5151515151524,32.07859848484851,0
3950,4,0,0,34,0.0,0.0,1.0,34,1350,1000,350,0.7407407407407407,17,10,7,376.9152420318466,0.364007724301842,0.09921512464634996,0.22350833779085938,131799.5951827422,3135.455263600537,134935.05044634274,3919,53,927.3823529411765,33,1,17,33.614666626884684,0.6448863636363636,43.29044117647059,1026.8382352941176,31.116310160427805,0
3951,4,0,0,34,0.0,0.0,1.0,34,650,300,350,0.46153846153846156,10,3,7,376.9198803533446,0.3634321152703506,0.0989738694666511,0.22388132652313122,131862.52170138893,3140.321180555567,135002.8428819445,3920,54,928.3823529411765,33,1,17,33.55096348884382,0.6455176767676767,43.22916666666667,1027.0833333333337,31.123737373737384,0
3952,4,1,1,34,0.02857142857142857,0.02857142857142857,0.9714285714285714,35,850,800,50,0.9411764705882353,9,8,1,366.0061210162662,0.367436974789916,0.08590724898694302,0.2191104029048862,132159.87761488353,2674.2648319616105,134834.14244684513,3921,0,902.8285714285714,35,0,17,33.53125469007956,0.644047619047619,42.939814814814824,1028.2407407407418,29.37830687830691,0
3953,4,0,0,34,0.0,0.0,1.0,34,1050,900,150,0.8571428571428571,12,9,3,376.26239577637176,0.3625222816399287,0.08846693646186798,0.22466455913784203,132061.2882653062,3137.9393424036407,135199.22760770985,3922,56,930.3823529411765,34,0,17,33.36711450853218,0.645220588235294,43.03571428571429,1027.8571428571436,30.231092436974812,0
3954,4,1,1,34,0.02857142857142857,0.02857142857142857,0.9714285714285714,35,600,400,200,0.6666666666666666,8,4,4,369.19623722388246,0.3676820728291317,0.07984185911961816,0.22189218070879593,132308.68115837197,2769.573447145071,135078.25460551705,3923,0,904.7714285714286,35,0,17,33.299232197097524,0.6455357142857142,42.79513888888889,1028.819444444445,29.394841269841287,0
3955,4,0,0,34,0.0,0.0,1.0,34,800,500,300,0.625,11,5,6,380.5749254401453,0.36090686274509803,0.09544609602146203,0.2281600819484674,132214.28748582763,3263.488520408159,135477.7760062358,3924,58,932.3823529411765,34,0,18,33.101825056912446,0.6467524509803921,42.88690476190476,1028.4523809523807,30.248599439775905,0
3956,4,0,0,34,0.0,0.0,1.0,34,650,300,350,0.46153846153846156,10,3,7,381.75305320994295,0.36090686274509803,0.06796561354512143,0.2180521676809334,130359.27456382,3159.093690850992,133518.368254671,3925,59,933.3823529411765,32,2,19,34.950698565776456,0.6328125,44.696969696969695,1021.212121212121,31.912878787878782,6
3957,4,1,1,34,0.02857142857142857,0.02857142857142857,0.9714285714285714,35,1050,600,450,0.5714285714285714,15,6,9,372.259314850278,0.36834733893557425,0.06378896882493978,0.2138183667941679,130575.52984429065,2721.591455209533,133297.12129950017,3926,0,907.6857142857143,33,2,19,34.973521183053556,0.6325757575757576,44.48529411764706,1022.0588235294117,30.971479500891263,0
3958,4,1,0,35,0.02857142857142857,0.0,1.0,35,550,400,150,0.7272727272727273,7,4,3,371.5261501295889,0.3639705882352941,0.05845743042004736,0.21443687752292864,130763.47588667824,2716.4101547481805,133479.88604142642,3927,0,908.6571428571428,33,2,20,34.80160156562025,0.6344696969696969,44.3014705882353,1022.7941176470591,30.993761140819974,0
3959,4,0,2,33,0.0,0.05714285714285714,0.9428571428571428,35,1100,700,400,0.6363636363636364,15,7,8,377.58306397075046,0.3641456582633053,0.02748574177145624,0.212735823846935,129825.09731833906,2803.9516051518617,132629.04892349092,3928,1,909.6571428571428,33,2,18,35.600549142215826,0.625,45.220588235294116,1019.1176470588232,30.88235294117646,6
3960,4,0,0,33,0.0,0.0,1.0,33,650,500,150,0.7692307692307693,8,5,3,387.89403131521135,0.35838857323232326,0.01692013067477771,0.21829182933847666,129779.68606519743,3468.153122130395,133247.83918732783,3929,63,869.4242424242424,32,1,18,35.38413878562578,0.626953125,45.265151515151516,1018.9393939393939,31.84185606060606,0
3961,4,0,0,33,0.0,0.0,1.0,33,900,500,400,0.5555555555555556,13,5,8,387.6402589267801,0.35838857323232326,0.014898082547692093,0.21832829935785367,129811.85154894914,3464.0599492398796,133275.91149818903,3930,64,870.4242424242424,32,1,19,35.357813984223355,0.6272786458333333,45.23358585858586,1019.0656565656569,31.84580176767678,0
3962,4,1,0,34,0.029411764705882353,0.0,1.0,34,600,400,200,0.6666666666666666,8,4,4,377.9419494639151,0.3658459595959596,0.023414265429962056,0.2148206561901721,130168.7771079633,3039.248275903498,133208.0253838668,3931,0,845.7941176470588,33,1,20,35.24165866058203,0.6284722222222222,44.88357843137255,1020.4656862745098,30.923202614379086,0
3963,4,0,0,34,0.0,0.0,1.0,34,850,700,150,0.8235294117647058,10,7,3,374.86350545719165,0.36579025549613786,0.013899813629824953,0.20870167396379227,129357.175200043,2898.2568303056214,132255.43203034863,3932,1,846.7941176470588,33,1,20,36.14662390073486,0.6202651515151516,45.680147058823515,1017.2794117647038,30.82664884135466,1
3964,4,1,0,35,0.02857142857142857,0.0,1.0,35,1000,700,300,0.7,13,7,6,365.8819320167773,0.37202380952380953,0.007692050879711587,0.2057304582259907,129746.60572562352,2494.387755102033,132240.99348072556,3933,0,823.5714285714286,34,1,18,35.97851912440602,0.6219362745098039,45.297619047619044,1018.8095238095233,29.964985994397743,0
3965,4,1,1,35,0.027777777777777776,0.027777777777777776,0.9722222222222222,36,1000,800,200,0.8,12,8,4,356.00590907144607,0.37620701058201056,0.008897963299052236,0.20222603700862526,130144.46159122068,2066.4394718792682,132210.90106309994,3934,0,801.6666666666666,35,1,20,35.82596037507563,0.6238095238095239,44.9074074074074,1020.370370370369,29.153439153439113,0
3966,4,2,1,36,0.05405405405405406,0.02702702702702703,0.972972972972973,37,700,500,200,0.7142857142857143,9,5,4,351.5957895635857,0.38141266266266266,0.02030394690113768,0.20155114482255376,130498.9979852535,1776.6332304526431,132275.63121570615,3935,0,780.9459459459459,35,2,16,35.5790288476061,0.6273809523809525,44.56018518518517,1021.7592592592571,29.19312169312163,0
3967,4,1,0,37,0.02702702702702703,0.0,1.0,37,950,600,350,0.631578947368421,13,6,7,350.8979377955241,0.3808183183183183,0.03000012234960181,0.2023847374909431,130735.62349965693,1774.9721364883242,132510.59563614524,3936,0,781.918918918919,35,2,19,35.35725064131584,0.6297619047619047,44.328703703703695,1022.6851851851841,29.21957671957669,0
3968,4,1,1,37,0.02631578947368421,0.02631578947368421,0.9736842105263158,38,850,700,150,0.8235294117647058,10,7,3,344.4999050619865,0.38409791370317686,0.02822608655382397,0.2002681033774668,131039.7137001866,1428.6337858128322,132468.34748599943,3937,0,762.3157894736842,36,2,20,35.21342022290658,0.6307870370370371,44.03153153153153,1023.8738738738733,28.440940940940926,0
3969,4,0,1,36,0.0,0.02702702702702703,0.972972972972973,37,700,500,200,0.7142857142857143,9,5,4,349.39809644710976,0.38116241241241244,0.03214388330877793,0.2024494081772831,130913.23329260954,1748.1669024348191,132661.40019504435,3938,2,783.918918918919,35,2,20,35.21592022920908,0.6315476190476191,44.15509259259258,1023.3796296296281,29.239417989417944,0
3970,4,2,1,37,0.05263157894736842,0.02631578947368421,0.9736842105263158,38,950,600,350,0.631578947368421,13,6,7,341.06722717627554,0.3838460170697013,0.03844552032901194,0.19931732177758058,131241.56832085454,1352.4395594919115,132594.00788034644,3939,0,764.1052631578947,36,2,21,35.09749239843206,0.6328125000000002,43.83445945945945,1024.6621621621614,28.462837837837817,0
3971,4,0,0,37,0.0,0.0,1.0,37,750,400,350,0.5333333333333333,11,4,7,351.002752702523,0.3765953453453454,0.03395171040900857,0.2049522669474094,131209.51753257847,1810.980366940972,133020.49789951943,3940,1,785.7567567567568,35,2,21,34.87535773459857,0.6345238095238097,43.86574074074072,1024.5370370370338,29.27248677248668,0
3972,4,0,0,37,0.0,0.0,1.0,37,1050,600,450,0.5714285714285714,15,6,9,348.3051455268795,0.37609484484484484,0.035286631199144214,0.20451011597357185,131422.3514543684,1755.1234171122276,133177.47487148063,3941,2,786.7567567567568,33,4,21,34.72956754710966,0.6410984848484849,43.65808823529411,1025.3676470588227,31.071746880570387,0
3973,4,0,0,37,0.0,0.0,1.0,37,1000,700,300,0.7,13,7,6,345.59272358040397,0.3766891891891892,0.03193251801209751,0.20325126518934652,131485.1878634419,1688.0648368415943,133173.2527002835,3942,3,787.7567567567568,33,4,21,34.73570617756003,0.641729797979798,43.59681372549019,1025.6127450980389,31.079174093879967,0
3974,4,1,1,37,0.02631578947368421,0.02631578947368421,0.9736842105263158,38,1000,800,200,0.8,12,8,4,334.597423680216,0.37946005215742057,0.021701982228298444,0.1981846278721279,131755.55555555545,1217.0138888888796,132972.56944444432,3943,0,768.0,34,4,19,34.74533279220779,0.6421568627450981,43.33333333333333,1026.6666666666658,30.196078431372523,0
3975,4,0,1,36,0.0,0.02702702702702703,0.972972972972973,37,1100,1000,100,0.9090909090909091,12,10,2,343.38456443981033,0.3766891891891892,0.030847466377552424,0.2031206999821929,131705.23356401385,1645.1088523644762,133350.34241637832,3944,5,789.7567567567568,33,4,20,34.57049904489017,0.6439393939393939,43.38235294117647,1026.4705882352941,31.10516934046346,0
3976,4,0,0,36,0.0,0.0,1.0,36,850,600,250,0.7058823529411765,11,6,5,351.07074649825205,0.3728835978835979,0.03440944020565029,0.20702473773909982,131587.09092184465,2039.275647893073,133626.36656973773,3945,6,812.4722222222222,32,4,20,34.49242144556568,0.6451822916666667,43.49747474747475,1026.0101010101007,32.06281565656565,0
3977,4,0,0,36,0.0,0.0,1.0,36,900,800,100,0.8888888888888888,10,8,2,348.86603295069017,0.37290013227513225,0.0357891316169936,0.20653362247547247,131736.68368235786,1991.6908460688342,133728.3745284267,3946,7,813.4722222222222,33,3,20,34.39812880506147,0.6442550505050504,43.35171568627452,1026.593137254903,31.108882947118275,0
3978,4,0,0,36,0.0,0.0,1.0,36,1000,700,300,0.7,13,7,6,350.4195123062637,0.373313492063492,0.036542031291434185,0.20796852075966654,131831.0565647829,2039.2349096501453,133870.29147443303,3947,8,814.4722222222222,33,3,20,34.263126491646766,0.6452020202020201,43.25980392156863,1026.9607843137264,31.120023767082618,0
3979,4,0,0,36,0.0,0.0,1.0,36,550,200,350,0.36363636363636365,9,2,7,349.9294380968444,0.37336309523809524,0.037919765607392186,0.20784965419487295,131862.5217013891,2028.515625000024,133891.03732638914,3948,9,815.4722222222222,33,3,20,34.24399932386748,0.6455176767676767,43.22916666666668,1027.083333333335,31.123737373737427,0
3980,4,0,0,36,0.0,0.0,1.0,36,1100,800,300,0.7272727272727273,14,8,6,353.2507844010399,0.37237103174603176,0.03376659511884883,0.2106942445225549,132019.9037029029,2127.226907920048,134147.13061082293,3949,10,816.4722222222222,33,3,21,34.000119246362985,0.6470959595959596,43.07598039215687,1027.6960784313737,31.142305407011325,0
3981,4,0,0,36,0.0,0.0,1.0,36,1000,500,500,0.5,15,5,10,353.2148720145802,0.37182539682539684,0.03226778453265533,0.21119882832005088,132114.37795859776,2132.952620386404,134247.33057898417,3950,11,817.4722222222222,33,3,21,33.905883696904674,0.6480429292929293,42.98406862745099,1028.063725490197,31.153446226975664,0
3982,4,1,1,36,0.02702702702702703,0.02702702702702703,0.972972972972973,37,900,700,200,0.7777777777777778,11,7,4,344.3458049886617,0.37578203203203203,0.03495495495495482,0.20779488232074475,132461.07266436022,1722.7870590638659,134183.8597234241,3951,0,796.3513513513514,33,4,22,33.78521825396826,0.6515151515151513,42.647058823529434,1029.4117647058854,31.194295900178346,0
3983,4,1,1,36,0.02702702702702703,0.02702702702702703,0.972972972972973,37,900,400,500,0.4444444444444444,14,4,10,346.0111265697477,0.3797234734734735,0.02850228037527347,0.2103837717516276,132745.0698799741,1786.2542351499487,134531.32411512404,3952,0,765.8918918918919,33,4,19,33.45708467118564,0.6543560606060606,42.37132352941177,1030.5147058823534,31.227718360071314,0
3984,4,0,1,35,0.0,0.027777777777777776,0.9722222222222222,36,800,600,200,0.75,10,6,4,355.1916085739304,0.37478505291005293,0.03349062385096202,0.21546530366949443,132658.02158261917,2223.8032152331443,134881.8247978523,3953,2,788.1666666666666,32,4,20,33.30805450014297,0.6559244791666666,42.45580808080808,1030.1767676767681,32.193023989899004,0
3985,4,0,0,35,0.0,0.0,1.0,35,900,800,100,0.8888888888888888,10,8,2,366.4736503106214,0.37356442577030813,0.03432905905725114,0.22196068713300274,132599.08888075093,2718.814425998269,135317.9033067492,3954,3,769.7428571428571,31,4,23,33.076801517067004,0.6579301075268817,42.513020833333336,1029.9479166666672,33.22412634408604,0
3986,4,1,1,35,0.027777777777777776,0.027777777777777776,0.9722222222222222,36,1050,800,250,0.7619047619047619,13,8,5,356.8600188060487,0.377364417989418,0.026961184604497035,0.21741829802481957,132820.66243240488,2279.6768186919735,135100.33925109686,3955,0,749.3333333333334,32,4,21,33.10162502041484,0.6575520833333334,42.2979797979798,1030.8080808080808,32.212752525252526,0
3987,4,0,0,35,0.0,0.0,1.0,35,700,500,200,0.7142857142857143,9,5,4,365.74402126729876,0.37342436974789917,0.032294054990883225,0.22211300385941157,132699.68880547408,2706.8235609266403,135406.5123664007,3956,5,771.7428571428571,31,4,21,32.99436054593706,0.6589381720430108,42.41536458333333,1030.3385416666658,33.23672715053761,0
3988,4,0,0,35,0.0,0.0,1.0,35,1200,1000,200,0.8333333333333334,14,10,4,363.02418120599975,0.3740546218487395,0.021471861471861864,0.2218481107369996,132934.57031249985,2651.692708333319,135586.26302083317,3957,6,772.7428571428571,31,4,21,32.82828282828284,0.6612903225806452,42.18749999999999,1031.2499999999989,33.26612903225803,0
3989,4,0,0,35,0.0,0.0,1.0,35,1200,800,400,0.6666666666666666,16,8,8,360.03458678069103,0.3746498599439776,0.021271239773442474,0.2208860843222077,133081.0950413222,2582.759412304856,135663.85445362705,3958,7,773.7428571428571,32,3,21,32.75819872736173,0.66015625,42.04545454545454,1031.818181818181,32.24431818181816,0
3990,4,0,0,35,0.0,0.0,1.0,35,900,700,200,0.7777777777777778,11,7,4,360.0724491873561,0.37349439775910365,0.0247194938655666,0.2212956541095826,133146.2430491787,2588.458766962554,135734.70181614126,3959,8,774.7428571428571,32,3,21,32.69181755158631,0.6608072916666667,41.98232323232323,1032.0707070707074,32.252209595959606,0
3991,4,0,0,35,0.0,0.0,1.0,35,550,300,250,0.5454545454545454,8,3,5,360.78576202033,0.3722689075630252,0.018532085198752046,0.2221680745072558,133219.07439446362,2612.70905420991,135831.78344867352,3960,9,775.7428571428571,33,2,21,32.6003086419753,0.6590909090909092,41.91176470588235,1032.35294117647,31.283422459893032,0
3992,4,0,0,35,0.0,0.0,1.0,35,950,600,350,0.631578947368421,13,6,7,359.37883723823757,0.372233893557423,0.019462700334371252,0.22152755190954013,133257.03124999974,2577.95138888886,135834.98263888858,3961,10,776.7428571428571,34,1,21,32.598533763788005,0.657169117647059,41.874999999999986,1032.499999999998,30.36764705882347,0
3993,4,0,0,35,0.0,0.0,1.0,35,650,500,150,0.7692307692307693,8,5,3,359.92326155021647,0.37230392156862746,0.02312062577192253,0.2222301988575178,133318.496669501,2596.8856292516857,135915.3822987527,3962,11,777.7428571428571,34,1,22,32.522814601344855,0.6577818627450981,41.81547619047618,1032.7380952380943,30.37464985994395,0
3994,4,0,0,35,0.0,0.0,1.0,35,650,400,250,0.6153846153846154,9,4,5,357.25119364977434,0.3712885154061625,0.019385638560563745,0.22112880588393286,133410.72137188193,2532.2278911564454,135942.94926303838,3963,12,778.7428571428571,34,1,22,32.499327802104936,0.6587009803921569,41.72619047619047,1033.095238095237,30.385154061624615,0
3995,4,0,0,35,0.0,0.0,1.0,35,800,300,500,0.375,13,3,10,357.6432172137817,0.37142857142857144,0.016835382614850403,0.22155499516048585,133441.47002550995,2544.88732993194,135986.3573554419,3964,13,779.7428571428571,34,1,22,32.45837654107614,0.6590073529411766,41.696428571428555,1033.2142857142837,30.388655462184815,0
3996,4,0,0,35,0.0,0.0,1.0,35,1050,800,250,0.7619047619047619,13,8,5,355.07665566357844,0.37090336134453783,0.012949128424048384,0.22033564659388924,133503.8825962369,2480.825973158852,135984.70856939573,3965,14,780.7428571428571,33,2,23,32.46212794972133,0.6619318181818183,41.636029411764696,1033.45588235294,31.316844919786064,0
3997,4,0,0,35,0.0,0.0,1.0,35,1350,1100,250,0.8148148148148148,16,11,5,354.24616088475324,0.3712885154061625,0.02909498016101697,0.21908723720577364,133379.97626133784,2449.8689058956893,135829.84516723352,3966,15,781.7428571428571,34,1,20,32.60775613691367,0.6583946078431373,41.75595238095238,1032.9761904761904,30.38165266106442,1
3998,4,0,0,35,0.0,0.0,1.0,35,1200,900,300,0.75,15,9,6,354.77367325702363,0.3709733893557423,0.029262672811059653,0.21995967741935488,133472.2222222223,2470.5179988662235,135942.74022108852,3967,16,782.7428571428571,33,2,20,32.50168010752687,0.6616161616161615,41.66666666666667,1033.3333333333342,31.31313131313134,0
3999,4,0,0,35,0.0,0.0,1.0,35,1250,800,450,0.64,17,8,9,353.194594078043,0.3696778711484594,0.020979920766599935,0.22010753211451461,133662.24078479435,2441.756175509423,136103.99696030378,3968,17,783.7428571428571,33,2,21,32.35215690922019,0.663510101010101,41.4828431372549,1034.0686274509808,31.335412953060025,0
4000,4,0,0,35,0.0,0.0,1.0,35,900,700,200,0.7777777777777778,11,7,4,353.66592695673893,0.3683823529411765,0.028277017309351837,0.22134925287588966,133820.6928374906,2465.563875672845,136286.25671316346,3969,18,784.7428571428571,33,2,20,32.18136819455961,0.6650883838383838,41.32965686274511,1034.6813725490213,31.353980986333976,0
4001,4,0,0,35,0.0,0.0,1.0,35,850,600,250,0.7058823529411765,11,6,5,354.69308074641714,0.36740196078431375,0.0323437367842343,0.22237439249469154,133884.09994052775,2497.552774173405,136381.65271470117,3970,19,785.7428571428571,33,2,20,32.09135089796724,0.6657196969696969,41.26838235294118,1034.9264705882358,31.36140819964351,0
4002,4,0,0,35,0.0,0.0,1.0,35,1050,600,450,0.5714285714285714,15,6,9,357.7781095758723,0.36645658263305325,0.04131493506493511,0.22488909744769123,133979.2387543253,2586.9677527873964,136566.2065071127,3971,20,786.7428571428571,33,2,20,31.91633128156567,0.6666666666666665,41.1764705882353,1035.2941176470592,31.372549019607856,0
4003,4,0,0,35,0.0,0.0,1.0,35,1050,600,450,0.5714285714285714,15,6,9,357.97148743865586,0.3671218487394958,0.04345886011763955,0.225789179987427,134106.1430699732,2601.235101883908,136707.3781718571,3972,21,787.7428571428571,33,2,21,31.784390282378922,0.6679292929292928,41.05392156862746,1035.784313725491,31.387403446227,0
4004,4,0,0,35,0.0,0.0,1.0,35,900,700,200,0.7777777777777778,11,7,4,360.51982859826654,0.3666666666666667,0.038401622032609994,0.22798767021677985,134201.36072964736,2676.4503135813284,136877.8110432287,3973,22,788.7428571428571,33,2,21,31.623176621328607,0.6688762626262625,40.962009803921575,1036.1519607843145,31.398544266191347,0
4005,4,1,0,36,0.027777777777777776,0.0,1.0,36,900,500,400,0.5555555555555556,13,5,8,352.09109530491446,0.3713624338624339,0.04116465863453822,0.22479662238698386,134550.78125,2275.2806913206464,136826.06194132066,3974,0,767.8055555555555,33,3,22,31.492637215528774,0.6723484848484849,40.625,1037.5,31.439393939393938,0
4006,4,0,0,36,0.0,0.0,1.0,36,1100,800,300,0.7272727272727273,14,8,6,355.7042637333528,0.3719411375661376,0.03751688768215744,0.2280977152221977,134709.7589418733,2383.3671244232933,137093.1260662966,3975,1,768.8055555555555,33,3,23,31.2402854838075,0.6739267676767677,40.47181372549019,1038.1127450980389,31.457961972667846,0
4007,4,0,0,36,0.0,0.0,1.0,36,700,300,400,0.42857142857142855,11,3,8,355.7042637333528,0.3719411375661376,0.03751688768215744,0.2280977152221977,134709.7589418733,2383.3671244232933,137093.1260662966,3976,2,769.8055555555555,33,3,23,31.2402854838075,0.6739267676767677,40.47181372549019,1038.1127450980389,31.457961972667846,0
4008,4,0,0,36,0.0,0.0,1.0,36,300,100,200,0.3333333333333333,5,1,4,356.58985751876344,0.37162698412698414,0.03968628685342601,0.2288658540074969,134741.56574394443,2409.495146097633,137151.06089004208,3977,3,770.8055555555555,33,3,23,31.18557208057917,0.6742424242424243,40.441176470588225,1038.2352941176455,31.46167557932259,0
4009,4,1,1,36,0.02702702702702703,0.02702702702702703,0.972972972972973,37,1200,900,300,0.75,15,9,6,340.43389634779953,0.3783158158158158,0.024224854536438745,0.21700599441242782,134492.36979800754,1757.1522958769679,136249.5220938845,3978,0,750.9459459459459,36,1,20,31.85321897730975,0.6652199074074073,40.68130630630631,1037.2747747747753,28.813188188188203,4
4010,4,0,0,36,0.0,0.0,1.0,36,600,400,200,0.6666666666666666,8,4,4,348.8435821925485,0.3731150793650793,0.02831107142414213,0.2218090598199463,134400.72183909902,2176.965851123124,136577.68769022214,3979,1,772.6944444444445,35,1,21,31.726592439632405,0.6663690476190476,40.76967592592593,1036.921296296297,29.62632275132277,0
4011,4,0,0,36,0.0,0.0,1.0,36,900,500,400,0.5555555555555556,13,5,8,349.13819722536067,0.372255291005291,0.029302905181713523,0.22236157678297502,134460.7355565201,2189.0757619598794,136649.81131848,3980,2,773.6944444444445,35,1,22,31.659064278540338,0.6669642857142857,40.71180555555556,1037.152777777778,29.632936507936517,0
4012,4,0,0,36,0.0,0.0,1.0,36,750,400,350,0.5333333333333333,11,4,7,350.47821809325643,0.3718915343915344,0.02688531905399394,0.22376686232107934,134550.78125000012,2231.423611111125,136782.20486111124,3981,3,774.6944444444445,35,1,22,31.534471218206154,0.6678571428571427,40.62500000000001,1037.500000000001,29.642857142857167,0
4013,4,0,0,36,0.0,0.0,1.0,36,1000,800,200,0.8,12,8,4,350.26793705418197,0.3709490740740741,0.033488807125779285,0.22455704985267738,134700.92438539522,2236.282980752747,136937.20736614798,3982,4,775.6944444444445,35,1,22,31.3901819229197,0.669345238095238,40.480324074074076,1038.0787037037037,29.659391534391535,0
4014,4,0,0,36,0.0,0.0,1.0,36,750,500,250,0.6666666666666666,10,5,5,348.1639713705828,0.3709656084656085,0.035084460296230136,0.22376268990951806,134791.0504543897,2185.877486282594,136976.9279406723,3983,5,776.6944444444445,35,1,15,31.354956159904884,0.6702380952380952,40.393518518518526,1038.425925925927,29.6693121693122,0
4015,4,0,0,36,0.0,0.0,1.0,36,500,400,100,0.8,6,4,2,346.94541476245547,0.3705853174603175,0.02754255648406101,0.2235344650030895,134881.2066642018,2159.2832379543865,137040.4899021562,3984,6,777.6944444444445,35,1,15,31.296773444753956,0.6711309523809523,40.30671296296296,1038.7731481481478,29.679232804232793,0
4016,4,1,1,36,0.02702702702702703,0.02702702702702703,0.972972972972973,37,950,900,50,0.9473684210526315,10,9,1,338.63682589570794,0.3735610610610611,0.02346459965868619,0.219721279936407,135135.5932579539,1752.377673281392,136887.9709312353,3985,0,757.6486486486486,36,1,15,31.25947687642153,0.6715856481481481,40.06193693693694,1039.7522522522524,28.88200700700701,0
4017,4,0,0,36,0.0,0.0,1.0,36,1050,800,250,0.7619047619047619,13,8,5,348.12150472534387,0.37055224867724873,0.02093617389798208,0.2254130666141539,135061.60950628007,2203.5701463906094,137265.1796526707,3986,8,779.6944444444445,35,1,15,31.086576290687745,0.6729166666666666,40.133101851851855,1039.467592592593,29.699074074074087,0
4018,4,0,0,36,0.0,0.0,1.0,36,600,400,200,0.6666666666666666,8,4,4,348.2633418151513,0.3700727513227513,0.014964875828633595,0.22606920974474867,135151.85613854605,2213.6874142661345,137365.5435528122,3987,9,780.6944444444445,35,1,15,30.993061739388548,0.6738095238095237,40.046296296296305,1039.8148148148157,29.708994708994734,0
4019,4,0,0,36,0.0,0.0,1.0,36,550,500,50,0.9090909090909091,6,5,1,347.4559357338458,0.3706679894179894,0.016847194401167442,0.22592178281507538,135212.03730495562,2196.044988854619,137408.08229381024,3988,10,781.6944444444445,35,1,15,30.954169448772163,0.6744047619047617,39.98842592592594,1040.046296296298,29.71560846560851,0
4020,4,0,0,36,0.0,0.0,1.0,36,800,400,400,0.5,12,4,8,346.2917178400752,0.37053571428571425,0.01806111852840875,0.2255413014454056,135272.23186728408,2168.730709876561,137440.96257716065,3989,11,782.6944444444445,35,1,15,30.924566088117494,0.6749999999999998,39.930555555555564,1040.2777777777787,29.72222222222225,0
4021,4,0,0,36,0.0,0.0,1.0,36,1050,1000,50,0.9523809523809523,11,10,1,346.0540137911237,0.36980820105820106,0.021276727227784065,0.22576383047766352,135332.4398255316,2166.466799554194,137498.90662508577,3990,12,783.6944444444445,35,1,15,30.870875046347802,0.675595238095238,39.87268518518519,1040.5092592592598,29.728835978835995,0
4022,4,0,0,36,0.0,0.0,1.0,36,1000,800,200,0.8,12,8,4,342.7208170829698,0.36960978835978836,0.02287439086478993,0.21083080599882537,133181.46482631261,1928.8120891161175,135110.27691542872,3991,13,784.6944444444445,36,0,18,33.104225761873586,0.6521990740740742,41.948198198198185,1032.2072072072056,28.672422422422375,4
4023,4,0,0,36,0.0,0.0,1.0,36,1000,500,500,0.5,15,5,10,344.3093561944328,0.36896494708994704,0.01378439283247923,0.21263711149219813,133326.80389426582,1981.133202459207,135307.937096725,3992,14,785.6944444444445,36,0,19,32.91762076109476,0.6536458333333335,41.80743243243243,1032.7702702702697,28.688063063063048,0
4024,4,0,0,36,0.0,0.0,1.0,36,650,500,150,0.7692307692307693,8,5,3,345.93313517329324,0.36855158730158727,0.020613811980718433,0.21414241444533,133414.04537983923,2030.4677988799522,135444.51317871918,3993,15,786.6944444444445,36,0,20,32.7883148027033,0.654513888888889,41.72297297297297,1033.1081081081074,28.69744744744743,0
4025,4,1,1,36,0.02702702702702703,0.02702702702702703,0.972972972972973,37,1000,700,300,0.7,13,7,6,340.8994239474032,0.37180930930930933,0.026258973226975124,0.21307405952740474,133771.3865847907,1720.5430886811375,135491.92967347187,3994,0,766.4054054054054,35,2,17,32.560882374878794,0.6601190476190477,41.37731481481481,1034.49074074074,29.556878306878286,0
4026,4,0,0,36,0.0,0.0,1.0,36,600,500,100,0.8333333333333334,7,5,2,350.04668283414037,0.367609126984127,0.031903665323354646,0.21793228963544856,133626.03635204077,2155.070153061217,135781.10650510198,3995,17,788.6944444444445,34,2,21,32.46977547495682,0.6608455882352942,41.51785714285714,1033.9285714285709,30.409663865546204,0
4027,4,0,1,35,0.0,0.027777777777777776,0.9722222222222222,36,1100,800,300,0.7272727272727273,14,8,6,368.03927392457,0.367609126984127,0.021484712098883474,0.216452613034064,131485.18786344212,2493.3121440978584,133978.50000754,3996,18,789.6944444444445,33,3,23,34.160169474648505,0.6417297979797979,43.59681372549021,1025.6127450980407,31.07917409388002,4
4028,4,0,0,35,0.0,0.0,1.0,35,1050,600,450,0.5714285714285714,15,6,9,368.74666483632484,0.36827731092436977,0.017737284810018794,0.21758391999115925,131610.90573637557,2706.2165092752975,134317.12224565085,3997,19,798.0571428571428,33,2,20,34.01496377244317,0.6429924242424241,43.47426470588236,1026.1029411764719,31.094028520499148,0
4029,4,0,0,35,0.0,0.0,1.0,35,700,600,100,0.8571428571428571,8,6,2,369.64014938364227,0.3680322128851541,0.0213040363028425,0.21829101628622152,131642.3445910227,2732.0591839677077,134374.4037749904,3998,20,799.0571428571428,33,2,20,33.96027386354591,0.6433080808080808,43.443627450980394,1026.2254901960785,31.097742127153893,0
4030,4,0,0,35,0.0,0.0,1.0,35,950,500,450,0.5263157894736842,14,5,9,369.4186053936794,0.36729691876750703,0.026347387092372943,0.21852049708880367,131705.23356401385,2730.8727412533644,134436.10630526723,3999,21,800.0571428571428,33,2,20,33.90241961158868,0.6439393939393939,43.38235294117647,1026.4705882352941,31.10516934046346,0
4031,4,0,0,35,0.0,0.0,1.0,35,900,500,400,0.5555555555555556,13,5,8,370.80783838987037,0.36782212885154064,0.021248956783628037,0.21756638744275988,131394.8652479383,2748.0836110773116,134142.9488590156,4000,22,801.0571428571428,31,4,22,34.180530861061726,0.6458333333333334,43.68489583333333,1025.260416666666,33.07291666666665,1
4032,4,1,0,36,0.027777777777777776,0.0,1.0,36,700,500,200,0.7142857142857143,9,5,4,363.35140593262537,0.3714781746031746,0.027928094125364344,0.21517919021399673,131749.07415378527,2374.242264819915,134123.3164186052,4001,0,779.7777777777778,32,4,21,34.01385643422295,0.6468098958333334,43.339646464646464,1026.6414141414139,32.08254419191918,0
4033,4,0,0,36,0.0,0.0,1.0,36,850,700,150,0.8235294117647058,10,7,3,363.35140593262537,0.3714781746031746,0.027928094125364344,0.21517919021399673,131749.07415378527,2374.242264819915,134123.3164186052,4002,1,780.7777777777778,32,4,21,34.01385643422295,0.6468098958333334,43.339646464646464,1026.6414141414139,32.08254419191918,0
4034,4,0,0,36,0.0,0.0,1.0,36,800,600,200,0.75,10,6,4,363.0668504274707,0.3716765873015873,0.02921587339456866,0.21601060377100673,131925.46323829767,2379.5524858227545,134305.01572412043,4003,2,781.7777777777778,33,3,21,33.84316970853711,0.6461489898989898,43.16789215686274,1027.3284313725483,31.131164587046918,0
4035,4,0,0,36,0.0,0.0,1.0,36,650,300,350,0.46153846153846156,10,3,7,361.55745585921574,0.3720568783068783,0.027287425784563446,0.21529103053435125,131956.93963860057,2342.0030757401078,134298.94271434066,4004,3,782.7777777777778,33,3,21,33.850190839694655,0.6464646464646464,43.13725490196079,1027.4509803921571,31.13487819370173,0
4036,4,0,0,36,0.0,0.0,1.0,36,950,600,350,0.631578947368421,13,6,7,358.84361051054213,0.3708498677248677,0.021420482330837043,0.21426388196044394,132061.2882653061,2277.869897959182,134339.15816326527,4005,4,783.7777777777778,34,2,21,33.814715079916624,0.6452205882352942,43.035714285714285,1027.8571428571427,30.231092436974784,0
4037,4,0,0,36,0.0,0.0,1.0,36,850,700,150,0.8235294117647058,10,7,3,359.63421372561385,0.3711474867724868,0.018489573282904237,0.21525715204075752,132153.07716836748,2305.3535997732542,134458.43076814074,4006,5,784.7777777777778,34,2,21,33.701902666821034,0.6461397058823529,42.94642857142858,1028.2142857142867,30.24159663865549,0
4038,4,0,0,36,0.0,0.0,1.0,36,800,700,100,0.875,9,7,2,359.1702414695983,0.3712962962962963,0.020537924825568155,0.21535673182853263,132219.38898533973,2297.8539737654582,134517.24295910518,4007,6,785.7777777777778,35,1,21,33.64702903443618,0.6446428571428571,42.88194444444446,1028.472222222224,29.384920634920686,0
4039,4,0,0,36,0.0,0.0,1.0,36,1300,900,400,0.6923076923076923,17,9,8,359.9776450011354,0.3704199735449736,0.01618678063959811,0.21669338129350676,132368.2260186257,2329.92045503258,134698.14647365827,4008,7,786.7777777777778,35,1,22,33.47638529599219,0.6461309523809524,42.73726851851852,1029.050925925926,29.401455026455032,0
4040,4,0,0,36,0.0,0.0,1.0,36,950,600,350,0.631578947368421,13,6,7,358.0558688163366,0.37025462962962963,0.02178742776142184,0.21589285817979106,132430.49178655236,2283.5130058210434,134714.0047923734,4009,8,787.7777777777778,32,4,22,33.46315832515537,0.6536458333333334,42.676767676767675,1029.292929292929,32.165404040404034,0
4041,4,0,0,36,0.0,0.0,1.0,36,750,500,250,0.6666666666666666,10,5,5,356.31936130615185,0.3701719576719577,0.021420199790124883,0.215031217818583,132462.9840864453,2239.82517727783,134702.80926372312,4010,9,788.7777777777778,32,4,22,33.47515229567847,0.6539713541666666,42.64520202020202,1029.4191919191921,32.169349747474755,0
4042,4,0,0,36,0.0,0.0,1.0,36,1100,900,200,0.8181818181818182,13,9,4,357.5165769504217,0.3697255291005291,0.021961134245489067,0.21664937485712277,132618.81134960105,2282.6846945886177,134901.49604418967,4011,10,789.7777777777778,33,3,22,33.287601626016254,0.6530934343434345,42.493872549019606,1030.024509803921,31.212863933452155,0
4043,4,0,0,36,0.0,0.0,1.0,36,700,600,100,0.8571428571428571,8,6,2,355.9316893611356,0.3691137566137566,0.024156887620255807,0.21623364480841256,132713.4996155325,2247.3880238369798,134960.88763936947,4012,11,790.7777777777778,33,3,17,33.23323025689819,0.6540404040404041,42.40196078431372,1030.392156862745,31.224004753416516,0
4044,4,0,0,36,0.0,0.0,1.0,36,400,300,100,0.75,5,3,2,355.8200282073806,0.3689318783068783,0.02563721409600861,0.21634783927663498,132745.06987997395,2246.6709018166025,134991.74078179055,4013,12,791.7777777777778,33,3,18,33.2043792365323,0.6543560606060608,42.37132352941176,1030.5147058823522,31.22771836007128,0
4045,4,1,0,37,0.02702702702702703,0.0,1.0,37,750,600,150,0.8,9,6,3,351.8912505781337,0.3729667167167167,0.04644285541146553,0.2167727869583529,133233.13185871037,1976.7146776405837,135209.84653635096,4014,0,771.3513513513514,35,2,19,32.815769805680105,0.6547619047619049,41.89814814814814,1032.407407407406,29.497354497354458,0
4046,4,1,0,38,0.02631578947368421,0.0,1.0,38,750,400,350,0.5333333333333333,11,4,7,345.133613743715,0.3789858937885254,0.04930589353171566,0.1994398058045744,130809.21292914549,1429.5456085465016,132238.758537692,4015,0,752.0263157894736,36,2,18,35.43019778364891,0.6284722222222221,44.256756756756765,1022.972972972974,28.415915915915946,8
4047,4,0,0,38,0.0,0.0,1.0,38,900,700,200,0.7777777777777778,11,7,4,346.52271548670154,0.37960822664770033,0.05165262926190661,0.20054174477147596,130866.81909950498,1469.66510429349,132336.48420379846,4016,1,753.0263157894736,36,2,18,35.336414997431945,0.6290509259259258,44.200450450450454,1023.1981981981988,28.42217217217219,0
4048,4,1,1,38,0.02564102564102564,0.02564102564102564,0.9743589743589743,39,800,500,300,0.625,11,5,6,340.29920193841485,0.38332208726945566,0.05635426444675029,0.19844414135509802,131159.5935768697,1126.7010041551127,132286.29458102482,4017,0,734.6923076923077,37,2,19,35.19990366088633,0.6300675675675675,43.91447368421052,1024.342105263157,27.68492176386911,0
4049,4,0,0,38,0.0,0.0,1.0,38,750,400,350,0.5333333333333333,11,4,7,341.24473597391767,0.37830429113323855,0.03817528402504067,0.1966054697108613,130694.03863322784,1319.7305413521703,132013.76917458003,4018,3,755.0263157894736,36,2,21,35.64610866372984,0.6273148148148149,44.36936936936937,1022.5225225225226,28.403403403403406,1
4050,4,1,0,39,0.02564102564102564,0.0,1.0,39,950,700,250,0.7368421052631579,12,7,5,337.3228360898533,0.38143837156995053,0.04865755229780944,0.19642115268573732,131103.44048168653,1044.8368728839484,132148.27735457048,4019,0,736.6410256410256,37,2,22,35.332798001427534,0.6295045045045045,43.96929824561403,1024.1228070175428,27.678994784257913,0
4051,4,0,0,39,0.0,0.0,1.0,39,1150,800,350,0.6956521739130435,15,8,7,336.9525459162131,0.38098852901484476,0.0521601685985249,0.19678028681506843,131215.75869498303,1042.6967913203985,132258.45548630343,4020,1,737.6410256410256,37,2,22,35.228934788812786,0.6306306306306306,43.859649122807014,1024.5614035087715,27.69084874348031,0
4052,4,0,0,39,0.0,0.0,1.0,39,1000,700,300,0.7,13,7,6,336.7704408751404,0.38135402609086816,0.04815509693558462,0.19725125822686798,131328.12500000003,1045.534202831641,132373.65920283168,4021,2,738.6410256410256,36,3,22,35.12025745257452,0.6336805555555556,43.75,1025.0000000000002,28.47222222222223,0
4053,4,0,0,39,0.0,0.0,1.0,39,1100,800,300,0.7272727272727273,14,8,6,338.02160951441846,0.3802856500224921,0.03883178056890557,0.19873226583910972,131472.44953991158,1088.1058000568187,132560.5553399684,4022,3,739.6410256410256,36,3,22,34.94267230335638,0.6351273148148149,43.609234234234236,1025.5630630630635,28.487862862862876,0
4054,4,0,0,39,0.0,0.0,1.0,39,1000,600,400,0.6,14,6,8,342.3386540416752,0.38000449842555106,0.04430337002768958,0.20203301914687452,131616.85333982625,1211.5072843113333,132828.3606241376,4023,4,740.6410256410256,36,3,18,34.68640254609306,0.6365740740740742,43.468468468468465,1026.1261261261257,28.50350350350349,0
4055,4,0,0,39,0.0,0.0,1.0,39,1200,800,400,0.6666666666666666,16,8,8,349.7466691686996,0.37983580746738643,0.0725676150333685,0.19053363320384395,128496.33487654333,1190.5442463860422,129686.87912292937,4024,5,741.6410256410256,35,4,15,37.66267123287672,0.607142857142857,46.527777777777786,1013.8888888888898,28.968253968253993,6
4056,4,0,0,39,0.0,0.0,1.0,39,1150,800,350,0.6956521739130435,15,8,7,349.34927587555876,0.3798076923076923,0.07803889420230492,0.19095499254168904,128629.57552146754,1187.3298129210461,129816.90533438859,4025,6,742.6410256410256,36,3,15,37.53677286856129,0.6064814814814814,46.396396396396405,1014.4144144144154,28.178178178178207,0
4057,4,1,1,39,0.025,0.025,0.975,40,900,500,400,0.5555555555555556,13,5,8,346.4600657791845,0.38366720085470085,0.07484889368591485,0.19118240080072338,129006.37846500851,939.1116737842467,129945.49013879277,4026,0,725.05,37,3,17,37.22600737542724,0.6083896396396395,46.02521929824562,1015.899122807018,27.456733048838323,0
4058,4,2,0,41,0.04878048780487805,0.0,1.0,41,1100,900,200,0.8181818181818182,13,9,4,340.0839032908314,0.39016768292682924,0.08508065682014676,0.189527840158296,129396.54659366366,601.2838084795528,129997.83040214321,4027,0,708.3170731707318,37,4,19,36.991122426985655,0.6123310810810809,45.64144736842106,1017.4342105263177,27.498221906116694,0
4059,4,2,2,41,0.046511627906976744,0.046511627906976744,0.9534883720930233,43,750,400,350,0.5333333333333333,11,4,7,327.5522172911395,0.4013012181616833,0.0829291822802436,0.18498289386199576,129917.22140842046,-89.0652126735767,129828.15619574688,4028,0,676.3255813953489,39,4,17,36.78189179523859,0.6140491452991451,45.13020833333335,1019.4791666666692,26.14049145299152,0
4060,4,0,0,41,0.0,0.0,1.0,41,1050,400,650,0.38095238095238093,17,4,13,340.0662946864091,0.3922256097560976,0.08571248503182649,0.19073283484585604,129647.68005540206,617.761234225954,130265.44128962801,4029,1,710.2926829268292,37,4,17,36.736469997128914,0.6148648648648647,45.39473684210528,1018.4210526315821,27.524893314367084,0
4061,4,0,0,41,0.0,0.0,1.0,41,1500,1100,400,0.7333333333333333,19,11,8,337.9937591136824,0.39148882113821143,0.08570836165695117,0.1902468808869447,129787.30384589518,573.4597424207786,130360.76358831595,4030,2,711.2926829268292,37,4,17,36.64754385020984,0.6162725225225223,45.25767543859651,1018.9692982456163,27.539710763395036,0
4062,4,1,1,41,0.023809523809523808,0.023809523809523808,0.9761904761904762,42,1300,1100,200,0.8461538461538461,15,11,4,330.1963682406892,0.3956881533101045,0.08051090560790364,0.18736635171201158,130103.13042534761,191.91623263892825,130295.04665798655,4031,0,695.3333333333334,39,3,17,36.526189503777815,0.6159188034188032,44.947916666666686,1020.2083333333364,26.159188034188112,0
4063,4,0,1,40,0.0,0.024390243902439025,0.975609756097561,41,1050,800,250,0.7619047619047619,13,8,5,344.0045551706115,0.390625,0.07503197820630958,0.19572814267688246,130208.06081753616,758.4332082329063,130966.49402576906,4032,4,713.2926829268292,38,3,17,36.06764018283959,0.6186951754385963,44.84508547008548,1020.6196581196596,26.858412055780516,0
4064,4,2,2,40,0.047619047619047616,0.047619047619047616,0.9523809523809523,42,900,800,100,0.8888888888888888,10,8,2,333.615959147479,0.3973577235772358,0.07350329119214294,0.19223590276944755,130699.20562358476,320.67958305940357,131019.88520664416,4033,0,689.8095238095239,38,4,17,35.835901856302016,0.6236293859649122,44.364316239316246,1022.5427350427361,26.909019343229897,0
4065,4,1,0,41,0.024390243902439025,0.0,1.0,41,700,400,300,0.5714285714285714,10,4,6,342.5026270583414,0.39621443089430897,0.07578369188517597,0.19727220489926098,130682.67549871112,751.8319338642625,131434.5074325754,4034,0,707.2682926829268,37,4,18,35.62544682752456,0.6252815315315315,44.38048245614035,1022.4780701754385,27.634542437174012,0
4066,4,2,2,41,0.046511627906976744,0.046511627906976744,0.9534883720930233,43,700,400,300,0.5714285714285714,10,4,6,328.17567849389656,0.40303156146179403,0.07402501561110353,0.1911506677104261,131114.67013888896,5.729166666671574,131120.39930555565,4035,0,675.3255813953489,39,4,18,35.555668565229176,0.6260683760683761,43.958333333333336,1024.1666666666672,26.260683760683776,0
4067,4,0,0,41,0.0,0.0,1.0,41,1250,1000,250,0.8,15,10,5,339.6995316761154,0.3958333333333333,0.07125515806749272,0.19679799684253163,130906.99932912044,693.8092730455512,131600.80860216598,4036,2,709.2682926829268,37,4,18,35.470351619700715,0.6275337837837838,44.161184210526315,1023.3552631578942,27.65825035561876,0
4068,4,2,1,42,0.046511627906976744,0.023255813953488372,0.9767441860465116,43,1400,1200,200,0.8571428571428571,16,12,4,328.4542752839397,0.4018318567737172,0.08323822124646485,0.19279361956574725,131410.26925131484,33.12924018153521,131443.39849149637,4037,0,677.2325581395348,38,5,19,35.250599145566305,0.6307565789473685,43.66987179487179,1025.320512820512,26.982118758434527,0
4069,4,0,0,42,0.0,0.0,1.0,42,1550,1100,450,0.7096774193548387,20,11,9,336.04179296504503,0.39854336043360433,0.08949009061320501,0.1969689481147463,131356.22409058549,428.2362121037108,131784.4603026892,4038,1,694.3571428571429,37,5,20,35.110595607373305,0.6320382882882883,43.72258771929824,1025.1096491228063,27.70566619250828,0
4070,4,0,0,42,0.0,0.0,1.0,42,1100,800,300,0.7272727272727273,14,8,6,335.6821780282309,0.3982409020518776,0.08411612265990542,0.1973372351412973,131468.650510253,426.33658914279357,131894.9870993958,4039,2,695.3571428571429,37,5,20,35.00648187747246,0.6331644144144146,43.61293859649122,1025.548245614034,27.717520151730646,0
4071,4,0,0,42,0.0,0.0,1.0,42,900,500,400,0.5555555555555556,13,5,8,335.44907918292665,0.3979747386759582,0.08771728894657782,0.19749063157685823,131524.88175448205,423.9800948368579,131948.8618493189,4040,3,696.3571428571429,37,5,20,34.9557945840014,0.6337274774774775,43.55811403508771,1025.7675438596484,27.72344713134185,0
4072,4,0,0,42,0.0,0.0,1.0,42,1900,1500,400,0.7894736842105263,23,15,8,332.0714101837675,0.3983376887340302,0.08330731605786212,0.19660346151915106,131739.10307774486,349.35794707428585,132088.46102481915,4041,4,697.3571428571429,38,4,18,34.82672494536371,0.634046052631579,43.34935897435897,1026.6025641025637,27.015856950067466,0
4073,4,0,1,41,0.0,0.023809523809523808,0.9761904761904762,42,1400,1000,400,0.7142857142857143,18,10,8,332.1180253139688,0.39866434378629506,0.07826455246615494,0.19719892386307478,131848.80566741532,357.8729956534335,132206.67866306874,4042,5,698.3571428571429,38,4,18,34.71514268872014,0.6351425438596492,43.24252136752136,1027.0299145299136,27.027103013945094,0
4074,4,0,2,39,0.0,0.04878048780487805,0.9512195121951219,41,600,400,200,0.6666666666666666,8,4,4,334.5293721501326,0.39880589430894314,0.06919362038878307,0.19906153728933637,131931.11257213823,626.9664511651755,132558.0790233034,4043,6,705.2439024390244,38,3,18,34.57042082640046,0.6359649122807017,43.162393162393165,1027.3504273504275,27.035537561853356,0
4075,4,0,1,38,0.0,0.02564102564102564,0.9743589743589743,39,800,600,200,0.75,10,6,4,341.4626860254799,0.3937809266756635,-0.005624551835176517,0.20362861604954094,132013.44515897823,1215.5331150924328,133228.97827407066,4044,7,732.8205128205128,38,1,15,34.30948296773747,0.6367872807017543,43.08226495726497,1027.6709401709418,27.043972109761626,6
4076,4,0,0,38,0.0,0.0,1.0,38,1200,900,300,0.75,15,9,6,338.4369750435606,0.39118065433854904,0.01716686405145862,0.20252224090513563,132144.21895439006,1344.497946483565,133488.71690087364,4045,8,752.8157894736842,37,1,15,34.25569211901463,0.639921171171171,42.95504385964914,1028.1798245614057,27.78864390706502,0
4077,4,0,0,38,0.0,0.0,1.0,38,1050,800,250,0.7619047619047619,13,8,5,337.41208455000833,0.39070649596965384,0.020761449514416164,0.20251201312627193,132256.9820161013,1325.0207996691538,133582.00281577045,4046,9,753.8157894736842,37,1,16,34.16868759549445,0.6410472972972971,42.84539473684212,1028.6184210526333,27.800497866287387,0
4078,4,0,0,38,0.0,0.0,1.0,38,850,700,150,0.8235294117647058,10,7,3,335.919235429642,0.390054528212423,0.024779182906653707,0.20221950125126326,132369.79316953314,1293.1119430978952,133662.90511263104,4047,10,754.8157894736842,37,1,16,34.093744450364056,0.6421734234234233,42.735745614035096,1029.057017543861,27.812351825509758,0
4079,4,0,0,38,0.0,0.0,1.0,38,750,500,250,0.6666666666666666,10,5,5,335.919235429642,0.390054528212423,0.024779182906653707,0.20221950125126326,132369.79316953314,1293.1119430978952,133662.90511263104,4048,11,755.8157894736842,37,1,16,34.093744450364056,0.6421734234234233,42.735745614035096,1029.057017543861,27.812351825509758,0
4080,4,0,0,38,0.0,0.0,1.0,38,950,700,250,0.7368421052631579,12,7,5,339.09819546092217,0.3898322664770033,0.020957345440278052,0.20489910266268102,132510.87474030486,1386.8397006771452,133897.714440982,4049,12,756.8157894736842,37,1,16,33.87025204117855,0.643581081081081,42.59868421052632,1029.605263157896,27.827169274537727,0
4081,4,1,0,39,0.02564102564102564,0.0,1.0,39,1100,900,200,0.8181818181818182,13,9,4,333.0939084623169,0.39192532613585246,0.030051884403192508,0.1975569634420266,131806.21831957917,996.3514013927426,132802.56972097192,4050,0,738.3846153846154,37,2,14,34.73293735540131,0.6365427927927928,43.28399122807018,1026.86403508772,27.753082029397834,5
4082,4,0,0,39,0.0,0.0,1.0,39,1300,800,500,0.6153846153846154,18,8,10,332.97812375282365,0.3919815564552407,0.032454361054766734,0.19778098193993013,131862.52170138882,981.4670138888837,132843.9887152777,4051,1,739.3846153846154,37,2,14,34.679259634888446,0.6371058558558559,43.229166666666664,1027.0833333333328,27.759009009008995,0
4083,4,1,0,40,0.025,0.0,1.0,40,1250,1100,150,0.88,14,11,3,333.89728149702114,0.39573985042735044,0.05101495171840931,0.20085975753265511,132343.03232750733,837.7957438454077,133180.82807135273,4052,0,721.875,38,2,15,34.172636970892604,0.640076754385965,42.76175213675213,1028.9529914529903,27.077710301394482,0
4084,4,0,0,40,0.0,0.0,1.0,40,750,400,350,0.5333333333333333,11,4,7,333.8023352651716,0.39527243589743594,0.05672478206724807,0.2015362971563404,132480.48159105846,844.4588264299731,133324.94041748843,4053,1,722.875,38,2,17,34.03707451224574,0.6414473684210527,42.628205128205124,1029.487179487179,27.09176788124155,0
4085,4,0,0,40,0.0,0.0,1.0,40,1200,800,400,0.6666666666666666,16,8,8,334.2895233097536,0.39416399572649574,0.06131131390646116,0.20286682651201693,132673.03040990917,870.2408183577834,133543.27122826697,4054,2,723.875,38,2,13,33.83131978291681,0.6433662280701755,42.441239316239304,1030.235042735041,27.111448493027392,0
4086,4,0,1,39,0.0,0.025,0.975,40,700,400,300,0.5714285714285714,10,4,6,334.2895233097536,0.39416399572649574,0.06131131390646116,0.20286682651201693,132673.03040990917,870.2408183577834,133543.27122826697,4055,3,724.875,38,2,13,33.83131978291681,0.6433662280701755,42.441239316239304,1030.235042735041,27.111448493027392,0
4087,4,0,0,39,0.0,0.0,1.0,39,800,500,300,0.625,11,5,6,340.23365898961436,0.3886077372919478,0.06623977115780377,0.20620354790635054,132623.79410010754,1224.6157471529496,133848.40984726048,4056,4,743.7692307692307,37,2,20,33.72764530551414,0.6447072072072073,42.48903508771929,1030.0438596491213,27.839023233760035,0
4088,4,0,0,39,0.0,0.0,1.0,39,950,600,350,0.631578947368421,13,6,7,336.1390796577469,0.38801731893837155,0.06266896914838216,0.2044900459354794,132765.01092884323,1125.501716874397,133890.51264571762,4057,5,744.7692307692307,37,2,13,33.691416640068084,0.6461148648648649,42.35197368421051,1030.5921052631559,27.853840682787997,0
4089,4,0,1,38,0.0,0.02564102564102564,0.9743589743589743,39,1450,1200,250,0.8275862068965517,17,12,5,339.996681864836,0.3869770580296896,0.07236418763428598,0.2076187530036954,132906.30290089227,1237.5403970452148,134143.84329793748,4058,6,745.7692307692307,37,2,13,33.45030483482207,0.6475225225225226,42.21491228070174,1031.1403508771905,27.86865813181596,0
4090,4,0,0,38,0.0,0.0,1.0,38,750,400,350,0.5333333333333333,11,4,7,343.5889159811633,0.3859649122807018,0.07288052116680488,0.20981234843421132,132906.30290089242,1533.0265081563402,134439.32940904875,4059,7,754.9736842105264,37,1,13,33.357702396143495,0.6475225225225225,42.214912280701746,1031.1403508771916,27.86865813181599,0
4091,4,0,0,38,0.0,0.0,1.0,38,1600,1400,200,0.875,18,14,4,343.43116098222913,0.38396455666192514,0.07049321487081173,0.2111507196816277,133160.81781173038,1546.314851685122,134707.1326634155,4060,8,755.9736842105264,37,1,14,33.10658575020363,0.6500563063063063,41.96820175438596,1032.127192982455,27.89532954006635,0
4092,4,0,0,38,0.0,0.0,1.0,38,800,500,300,0.625,11,5,6,341.8126743867953,0.3837126600284495,0.06975613028747807,0.21031532788740456,133189.1122749306,1505.1453331794294,134694.25760811003,4061,9,756.9736842105264,37,1,14,33.11999858366972,0.6503378378378378,41.940789473684205,1032.2368421052622,27.89829302987195,0
4093,4,0,0,38,0.0,0.0,1.0,38,1300,1000,300,0.7692307692307693,16,10,6,340.0678864592209,0.38283843053579897,0.07489104927924894,0.21019944163030557,133358.94217451505,1470.218721144941,134829.16089566,4062,10,757.9736842105264,37,1,14,32.99495753715497,0.6520270270270272,41.77631578947367,1032.8947368421036,27.916073968705504,0
4094,4,0,0,38,0.0,0.0,1.0,38,1150,1000,150,0.8695652173913043,13,10,3,336.9643319233225,0.3821420104314841,0.06907231466121533,0.20875837604953737,133443.8977016964,1393.1667676592451,134837.06446935565,4063,11,758.9736842105264,37,1,14,32.99009073543456,0.6528716216216217,41.6940789473684,1033.223684210524,27.92496443812227,0
4095,4,0,0,38,0.0,0.0,1.0,38,850,500,350,0.5882352941176471,12,5,7,348.68427687106345,0.38183084400189665,0.08316687485968544,0.21070854880582496,132513.92598257033,1645.6762104984505,134159.60219306877,4064,12,759.9736842105264,36,2,17,33.620438222319436,0.6455439814814816,42.59572072072071,1029.6171171171163,28.600475475475452,2
4096,4,0,0,38,0.0,0.0,1.0,38,1000,900,100,0.9,11,9,2,349.3080468641871,0.3816530346135609,0.07856752323674132,0.21141112432647194,132571.9062601453,1661.6867289586928,134233.59298910399,4065,13,760.9736842105264,36,2,17,33.54610898487334,0.6461226851851851,42.539414414414416,1029.8423423423426,28.606731731731738,0
4097,4,0,0,38,0.0,0.0,1.0,38,1150,700,450,0.6086956521739131,16,7,9,347.72068662841946,0.3812529634898056,0.07539755598002418,0.210938252074057,132658.9004545085,1625.648790682564,134284.54924519104,4066,14,761.9736842105264,36,2,14,33.499580964873914,0.6469907407407408,42.45495495495495,1030.1801801801796,28.6161161161161,0
4098,4,0,1,37,0.0,0.02631578947368421,0.9736842105263158,38,750,400,350,0.5333333333333333,11,4,7,347.1147446849481,0.38027501185395923,0.07493329039381691,0.21122301485084058,132774.93709926138,1617.6276783540284,134392.56477761542,4067,15,762.9736842105264,36,2,14,33.39866513694639,0.6481481481481481,42.34234234234234,1030.6306306306303,28.62862862862862,0
4099,4,0,0,37,0.0,0.0,1.0,37,700,300,400,0.42857142857142855,11,3,8,351.87416425830895,0.37875375375375375,0.09175904468094576,0.2146174532834654,132861.99787202728,1950.1408925817548,134812.13876460903,4068,16,782.8108108108108,36,1,14,33.188603677407606,0.6490162037037038,42.257882882882875,1030.9684684684673,28.63801301301298,0
4100,4,0,0,37,0.0,0.0,1.0,37,1300,1000,300,0.7692307692307693,16,10,6,353.30252092828147,0.3781281281281281,0.09977575829104235,0.21632694463255725,133007.16256797325,1998.3531673565344,135005.5157353298,4069,17,783.8108108108108,36,1,14,33.0060498544396,0.650462962962963,42.11711711711711,1031.5315315315306,28.653653653653627,0
4101,4,0,0,37,0.0,0.0,1.0,37,1550,1300,250,0.8387096774193549,18,13,5,353.84215058245303,0.3785660660660661,0.12335669777044256,0.20791243418262276,131450.177154195,1904.1459206034483,133354.32307479845,4070,18,784.8108108108108,34,3,20,34.559534865722455,0.639093137254902,43.63095238095238,1025.4761904761906,30.161064425770313,8
4102,4,0,0,37,0.0,0.0,1.0,37,1100,600,500,0.5454545454545454,16,6,10,353.23201894253907,0.37837837837837834,0.12636452608597515,0.2078857291809368,131511.22448979586,1890.795068027208,133402.01955782308,4071,19,785.8108108108108,34,3,20,34.51355037140205,0.6397058823529411,43.57142857142857,1025.714285714285,30.168067226890738,0
4103,4,0,0,37,0.0,0.0,1.0,37,750,500,250,0.6666666666666666,10,5,5,344.3717364002907,0.37837837837837834,0.09602285212041273,0.20170344560588466,131328.12500000015,1645.1388888889044,132973.26388888905,4072,20,786.8108108108108,34,3,19,34.92547425474255,0.6378676470588235,43.75000000000001,1025.0000000000011,30.147058823529445,3
4104,4,0,0,37,0.0,0.0,1.0,37,850,400,450,0.47058823529411764,13,4,9,346.8162140600752,0.3780655655655656,0.10277300058999983,0.2034592122265238,131389.14399092973,1713.577097505669,133102.7210884354,4073,21,787.8108108108108,34,3,19,34.801246322960196,0.6384803921568627,43.69047619047619,1025.2380952380954,30.154061624649867,0
4105,4,0,0,37,0.0,0.0,1.0,37,750,400,350,0.5333333333333333,11,4,7,351.59278878102305,0.37718968968968974,0.10503436011153311,0.20708647032987543,131541.7534722223,1849.8263888888996,133391.5798611112,4074,22,788.8108108108108,34,3,19,34.52477660438667,0.6400122549019608,43.54166666666667,1025.8333333333342,30.171568627451006,0
4106,4,1,1,37,0.02631578947368421,0.02631578947368421,0.9736842105263158,38,1400,900,500,0.6428571428571429,19,9,10,344.7452982731874,0.3835941204362257,0.09367994021565029,0.20477040005865246,131862.52170138902,1491.7968750000102,133354.31857638902,4075,0,769.0263157894736,35,3,15,34.37711291413115,0.6410714285714285,43.22916666666667,1027.0833333333344,29.345238095238127,0
4107,4,1,0,38,0.02631578947368421,0.0,1.0,38,1000,700,300,0.7,13,7,6,345.278682491973,0.3827643432906591,0.09901104569466912,0.2055693403407944,131951.69331114975,1512.0213638117361,133463.7146749615,4076,0,770.0,35,3,16,34.27361439675566,0.6419642857142855,43.142361111111114,1027.4305555555559,29.355158730158738,0
4108,4,0,0,38,0.0,0.0,1.0,38,900,800,100,0.8888888888888888,10,8,2,344.162177077027,0.382793978188715,0.09594786041576531,0.2052260557600351,132011.15779588904,1486.6494930984225,133497.80728898747,4077,1,771.0,35,3,16,34.24243064158877,0.6425595238095239,43.08449074074074,1027.662037037037,29.361772486772484,0
4109,4,2,1,39,0.05,0.025,0.975,40,1300,1000,300,0.7692307692307693,16,10,6,328.5343993527491,0.3898370726495726,0.09892825896762925,0.1986850891323772,132542.91453615797,709.5473407004907,133252.46187685846,4078,0,733.4,36,4,17,34.110026611256934,0.6458333333333333,42.56756756756758,1029.7297297297314,28.60360360360365,0
4110,4,1,1,39,0.025,0.025,0.975,40,950,700,250,0.7368421052631579,12,7,5,327.2257028299326,0.3909321581196581,0.10949353212014912,0.19458623606353626,131905.89871966562,632.6000831913019,132538.49880285692,4079,0,734.375,36,4,15,34.78335343126508,0.6394675925925926,43.18693693693694,1027.2522522522524,28.53478478478479,1
4111,4,0,0,39,0.0,0.0,1.0,39,1450,1100,350,0.7586206896551724,18,11,7,336.8781207287534,0.38838281601439495,0.11366211185868536,0.19978493897764038,131803.0907064472,1080.315500685873,132883.40620713308,4080,1,754.1794871794872,35,4,15,34.638938984069725,0.6404761904761904,43.28703703703704,1026.851851851852,29.338624338624342,0
4112,4,0,0,39,0.0,0.0,1.0,39,950,400,550,0.42105263157894735,15,4,11,336.1873531674681,0.3883265856950067,0.11286212097571124,0.19968718688139997,131862.5217013891,1066.1024305555793,132928.6241319447,4081,2,755.1794871794872,35,4,15,34.59685598377281,0.6410714285714285,43.22916666666668,1027.083333333335,29.345238095238145,0
4113,4,0,0,39,0.0,0.0,1.0,39,950,700,250,0.7368421052631579,12,7,5,336.157175163658,0.38838281601439495,0.11173420007222834,0.19982551437223478,131892.2422223295,1067.3047142918515,132959.54693662137,4082,3,756.1794871794872,35,4,16,34.56772300469484,0.6413690476190474,43.20023148148149,1027.199074074075,29.348544973545,0
4114,4,1,1,39,0.025,0.025,0.975,40,600,300,300,0.5,9,3,6,325.4967495192361,0.3912126068376069,0.10286418400876252,0.19474346809375,132137.36329234645,602.0564483402381,132739.4197406867,4083,0,738.25,36,4,16,34.595198977729105,0.6417824074074073,42.961711711711715,1028.1531531531534,28.559809809809817,0
4115,4,0,0,39,0.0,0.0,1.0,39,750,600,150,0.8,9,6,3,333.3123997507706,0.38776428250112466,0.10743298072952312,0.1987562657748216,132011.1577958892,1000.1911597651032,133011.34895565428,4084,5,758.1794871794872,35,4,16,34.52117824830123,0.6425595238095237,43.08449074074075,1027.662037037038,29.361772486772516,0
4116,4,0,0,39,0.0,0.0,1.0,39,1300,900,400,0.6923076923076923,17,9,8,331.22348115981663,0.3873706702654071,0.11114386544146715,0.1986253482227583,132224.21481870403,959.152945174925,133183.36776387895,4085,6,759.1794871794872,36,3,17,34.36074309281361,0.6426504629629628,42.87725225225226,1028.4909909909925,28.569194194194235,0
4117,4,0,0,39,0.0,0.0,1.0,39,850,500,350,0.5882352941176471,12,5,7,332.9242430399856,0.3865834457939721,0.10789101441465676,0.2001049923956126,132311.09487866264,1009.9142216541061,133321.00910031673,4086,7,760.1794871794872,36,3,17,34.22974131640397,0.6435185185185184,42.7927927927928,1028.8288288288304,28.57857857857862,0
4118,4,1,1,39,0.025,0.025,0.975,40,1050,700,350,0.6666666666666666,14,7,7,323.91155475796097,0.39098557692307695,0.09975399081565683,0.1961917271401534,132600.90115453317,590.2213446554941,133191.12249918867,4087,0,742.15,36,4,17,34.170903491508135,0.6464120370370369,42.511261261261275,1029.954954954957,28.609859859859917,0
4119,4,0,0,39,0.0,0.0,1.0,39,800,400,400,0.5,12,4,8,331.1646409714192,0.3866959064327486,0.10213180472818562,0.20029719991316897,132546.94097490134,978.9720239626149,133525.91299886396,4088,9,762.1794871794872,35,4,18,34.038276010640296,0.6479166666666667,42.563657407407405,1029.7453703703698,29.42129629629628,0
4120,4,1,0,40,0.025,0.0,1.0,40,1350,1100,250,0.8148148148148148,16,11,5,321.6364826510471,0.3894364316239316,0.10814226443934971,0.19678480591856656,132978.12328798397,554.1231687768933,133532.24645676085,4089,0,744.1,36,4,16,33.85172143974962,0.6501736111111112,42.145270270270274,1031.4189189189192,28.650525525525534,0
4121,4,0,0,40,0.0,0.0,1.0,40,1050,900,150,0.8571428571428571,12,9,3,321.97983218634425,0.3894230769230769,0.10835880362405881,0.19730148780328416,133036.2050183629,566.9949933041134,133603.200011667,4090,1,745.1,36,4,16,33.78474875377506,0.6507523148148149,42.08896396396396,1031.6441441441439,28.656781781781774,0
4122,4,0,1,39,0.0,0.025,0.975,40,700,300,400,0.42857142857142855,11,3,8,315.7774774294649,0.3902110042735043,0.0038373544093184275,0.18790323161891884,131931.11257213788,332.1747844984665,132263.28735663634,4091,2,746.1,38,2,18,35.05204000277316,0.6359649122807018,43.162393162393144,1027.3504273504245,27.03553756185328,8
4123,4,0,0,39,0.0,0.0,1.0,39,650,400,250,0.6153846153846154,9,4,5,322.2272613122266,0.3878486279802069,0.011324215915779812,0.19111198873901183,131806.21831957882,694.3113506078427,132500.52967018666,4092,13,766.1794871794872,37,2,18,35.01190158391172,0.6365427927927929,43.28399122807016,1026.864035087717,27.753082029397756,0
4124,4,1,1,39,0.025,0.025,0.975,40,1000,600,400,0.6,14,6,8,314.13819426925596,0.39066506410256413,0.005378299729785541,0.1877414723763217,132095.80342793473,299.2674318795928,132395.07085981432,4093,0,748.0,38,2,18,34.928852282962644,0.6376096491228072,43.00213675213674,1027.991452991452,27.05240665766979,0
4125,4,0,0,39,0.0,0.0,1.0,39,800,600,200,0.75,10,6,4,321.898722582778,0.386555330634278,0.014914634780206493,0.19205326077456267,132031.50398439908,700.1544946522087,132731.6584790513,4094,15,768.1794871794872,37,2,18,34.79397827092002,0.638795045045045,43.064692982456144,1027.7412280701758,27.776789947842587,0
4126,4,1,1,39,0.025,0.025,0.975,40,1300,1100,200,0.8461538461538461,15,11,4,314.86495666773425,0.38924946581196584,0.017352024922118403,0.18927275485082903,132315.55103550298,332.30604865220687,132647.8570841552,4095,0,749.95,38,2,19,34.68977154724817,0.6398026315789473,42.78846153846154,1028.846153846154,27.074898785425106,0
4127,4,0,0,39,0.0,0.0,1.0,39,1200,1000,200,0.8333333333333334,14,10,4,324.6134533735668,0.3853463787674314,0.014344323906204215,0.19483037786931723,132256.9820161011,786.4791330024574,133043.46114910356,4096,17,770.1794871794872,37,2,19,34.49781029030308,0.6410472972972973,42.8453947368421,1028.6184210526314,27.800497866287337,0
4128,4,0,0,39,0.0,0.0,1.0,39,1100,700,400,0.6363636363636364,15,7,8,320.83627934146057,0.38394062078272606,0.010633443984536584,0.19313973583191818,132369.79316953282,693.8063875423095,133063.59955707513,4097,18,771.1794871794872,37,2,19,34.48177499556031,0.6421734234234234,42.73574561403508,1029.0570175438586,27.81235182550969,0
4129,4,0,0,39,0.0,0.0,1.0,39,1300,800,500,0.6153846153846154,18,8,10,329.16914534999,0.38394062078272606,0.05315822388993108,0.19279907084785128,131328.12500000003,845.8333333333347,132173.95833333337,4098,19,772.1794871794872,37,2,17,35.315040650406495,0.6317567567567568,43.75,1025.0000000000002,27.70270270270271,3
4130,4,1,0,40,0.025,0.0,1.0,40,750,400,350,0.5333333333333333,11,4,7,322.2519990693116,0.3885950854700855,0.05059883357633854,0.18983212853150483,131547.23340821092,478.271787566655,132025.50519577757,4099,0,753.85,38,2,18,35.27173158369784,0.6321271929824561,43.53632478632478,1025.8547008547002,26.996176338281586,0
4131,4,0,1,39,0.0,0.025,0.975,40,950,600,350,0.631578947368421,13,6,7,320.10970543475844,0.3890491452991453,0.04947938359017101,0.1888411308965246,131602.0390459493,425.4179907224793,132027.45703667178,4100,1,754.85,38,2,15,35.271544842426756,0.6326754385964912,43.48290598290598,1026.068376068376,27.00179937022042,0
4132,4,1,0,40,0.025,0.0,1.0,40,1050,700,350,0.6666666666666666,14,7,7,319.55192646918454,0.39026442307692305,0.05175616609428624,0.18919127920162634,131739.10307774492,419.49683596317595,132158.5999137081,4101,0,755.8,38,2,16,35.14803829742947,0.634046052631579,43.34935897435897,1026.6025641025642,27.01585695006748,0
4133,4,0,0,40,0.0,0.0,1.0,40,850,700,150,0.8235294117647058,10,7,3,321.58407408203783,0.3902110042735043,0.051547383751170406,0.1909442683230776,131848.80566741523,480.09521787564273,132328.90088529087,4102,1,756.8,38,2,16,34.98560976455494,0.6351425438596492,43.242521367521356,1027.029914529913,27.027103013945077,0
4134,4,0,0,40,0.0,0.0,1.0,40,1250,1100,150,0.88,14,11,3,324.2536121254244,0.3902510683760683,0.05402370555209002,0.19322622313645182,131985.99810979617,559.3873274161715,132545.38543721233,4103,2,757.8,38,2,16,34.7791900603036,0.6365131578947368,43.10897435897436,1027.5641025641025,27.04116059379217,0
4135,4,0,0,40,0.0,0.0,1.0,40,750,600,150,0.8,9,6,3,328.83808017016105,0.3904246794871795,0.05194106641721219,0.19638430597871612,132068.34781804722,685.8203895463354,132754.16820759355,4104,3,758.8,38,2,16,34.57865606485812,0.6373355263157896,43.028846153846146,1027.8846153846143,27.049595141700376,0
4136,4,0,0,40,0.0,0.0,1.0,40,700,500,200,0.7142857142857143,9,5,4,330.0546949334893,0.3908386752136752,0.054925187032419,0.19754019801243156,132150.72320841538,723.3933267586976,132874.11653517408,4105,4,759.8,38,2,17,34.464619700748116,0.6381578947368423,42.94871794871794,1028.2051282051273,27.058029689608613,0
4137,4,0,0,40,0.0,0.0,1.0,40,1150,800,350,0.6956521739130435,15,8,7,333.8972814970211,0.3910122863247863,0.049800124597653594,0.20085975753265525,132343.03232750745,837.7957438454216,133180.82807135288,4106,5,760.8,38,2,17,34.172636970892626,0.6400767543859649,42.761752136752136,1028.9529914529912,27.077710301394507,0
4138,4,0,0,40,0.0,0.0,1.0,40,900,800,100,0.8888888888888888,10,8,2,335.5349796083928,0.390625,0.048432308970099536,0.20199205772425244,132370.51647308056,882.9877091094978,133253.50418219005,4107,6,761.8,38,2,17,34.10290351605757,0.6403508771929824,42.73504273504273,1029.0598290598289,27.080521817363916,0
4139,4,0,1,39,0.0,0.025,0.975,40,1100,600,500,0.5454545454545454,16,6,10,335.72279645066305,0.39117254273504276,0.049691293971152906,0.20284392410000257,132507.9800044744,897.1899198261386,133405.16992430054,4108,7,762.8,38,2,17,33.96004116080386,0.6417214912280702,42.60149572649573,1029.594017094017,27.094579397210975,0
4140,4,0,0,39,0.0,0.0,1.0,39,850,600,250,0.7058823529411765,11,6,5,342.47751142580296,0.3902103013945119,0.05196479240573382,0.2067859392139466,132482.65241468555,1274.4658212142454,133757.1182358998,4109,8,778.9230769230769,37,2,17,33.811619093265165,0.6432995495495495,42.62609649122808,1029.4956140350896,27.82420578473215,0
4141,4,1,1,39,0.025,0.025,0.975,40,550,300,250,0.5454545454545454,8,3,5,332.51018117961434,0.39278846153846153,0.05422670260184481,0.20238017147253895,132783.12108490412,830.347929907241,133613.46901481136,4110,0,760.425,38,2,16,33.76675823226563,0.6444627192982455,42.33440170940172,1030.6623931623947,27.122694556905124,0
4142,4,0,0,39,0.0,0.0,1.0,39,800,500,300,0.625,11,5,6,357.08467463410153,0.38874831309041835,0.06127927427566404,0.21045203164605575,131565.5006858711,1609.476498263003,133174.97718413413,4111,1,780.0512820512821,35,4,16,34.359957882069786,0.638095238095238,43.51851851851852,1025.9259259259263,29.312169312169324,3
4143,4,0,0,39,0.0,0.0,1.0,39,850,600,250,0.7058823529411765,11,6,5,356.2451769466071,0.3880454340980657,0.06299358323718329,0.2104481001989051,131654.5718262389,1580.2612472136614,133234.83307345258,4112,2,781.0512820512821,35,4,16,34.29159148152327,0.6389880952380952,43.43171296296297,1026.2731481481487,29.322089947089964,0
4144,4,0,0,39,0.0,0.0,1.0,39,1500,1100,400,0.7333333333333333,19,11,8,353.01382816711543,0.3879329734592893,0.05398719104760619,0.20935419007343925,131803.09070644728,1505.66272290811,133308.7534293554,4113,3,782.0512820512821,35,4,16,34.22471445746921,0.6404761904761904,43.287037037037045,1026.8518518518526,29.33862433862436,0
4145,4,0,0,39,0.0,0.0,1.0,39,500,100,400,0.2,9,1,8,351.58077003453104,0.38739878542510126,0.05003408788897756,0.20915756801786195,131921.9660922498,1476.2452846365054,133398.2113768863,4114,4,783.0512820512821,35,4,16,34.14169295478444,0.6416666666666666,43.171296296296305,1027.314814814816,29.351851851851883,0
4146,4,0,0,39,0.0,0.0,1.0,39,800,600,200,0.75,10,6,4,350.54155125112464,0.3873706702654071,0.046030796960164766,0.20870270626802376,131951.69331114978,1450.9102527006241,133402.6035638504,4115,5,784.0512820512821,35,4,16,34.13843359242987,0.6419642857142855,43.142361111111114,1027.430555555556,29.355158730158745,0
4147,4,0,1,38,0.0,0.02564102564102564,0.9743589743589743,39,1300,1200,100,0.9230769230769231,14,12,2,351.62977407483396,0.38765182186234814,0.042797697021222714,0.20772159938184903,131654.5718262389,1458.7334694358835,133113.3052956748,4116,6,785.0512820512821,35,4,15,34.41000808240294,0.6389880952380952,43.43171296296297,1026.2731481481487,29.322089947089964,2
4148,4,0,0,38,0.0,0.0,1.0,38,650,200,450,0.3076923076923077,11,2,9,360.46990487777293,0.3818604788999526,0.0566919037733542,0.21282538219495917,131633.3616780046,1889.9730725623658,133523.33475056698,4117,7,806.3157894736842,34,4,16,34.20461136890952,0.6409313725490196,43.452380952380956,1026.1904761904768,30.18207282913167,0
4149,4,1,1,38,0.02564102564102564,0.02564102564102564,0.9743589743589743,39,900,600,300,0.6666666666666666,12,6,6,348.8969047638897,0.385768106162843,0.05143802913319617,0.20772352941576447,131951.69331114966,1407.5074749228315,133359.2007860725,4118,0,786.6153846153846,35,4,17,34.180677593781674,0.6419642857142858,43.14236111111111,1027.4305555555552,29.35515873015872,0
4150,4,0,0,38,0.0,0.0,1.0,38,700,400,300,0.5714285714285714,10,4,6,359.56479731148903,0.3815493124703651,0.0550877192982453,0.21314408088052192,131786.1128826531,1877.1293934240407,133663.24227607716,4119,9,808.3157894736842,34,4,17,34.07367149758453,0.6424632352941178,43.30357142857143,1026.7857142857147,30.199579831932784,0
4151,4,0,0,38,0.0,0.0,1.0,38,1100,800,300,0.7272727272727273,14,8,6,350.88000756949464,0.3815493124703651,0.07929292327490689,0.20206479705794747,130676.44702717756,1570.3505444101409,132246.7975715877,4120,10,809.3157894736842,35,3,16,35.41760999169874,0.6291666666666667,44.38657407407407,1022.4537037037031,29.212962962962948,5
4152,4,0,0,38,0.0,0.0,1.0,38,750,500,250,0.6666666666666666,10,5,5,351.8884107910448,0.38217164532954007,0.07981096228179396,0.20311155363556246,130765.21675936629,1602.9528624399732,132368.16962180627,4121,11,810.3157894736842,35,3,17,35.301973709026456,0.6300595238095239,44.29976851851851,1022.8009259259248,29.222883597883566,0
4153,4,0,0,38,0.0,0.0,1.0,38,1350,1200,150,0.8888888888888888,15,12,3,350.3927119650254,0.38209755808440016,0.07238776652103018,0.20302571161171362,130913.23329260953,1574.2085691014859,132487.441861711,4122,12,811.3157894736842,35,3,17,35.19047349770038,0.6315476190476191,44.15509259259258,1023.379629629628,29.23941798941794,0
4154,4,0,0,38,0.0,0.0,1.0,38,650,400,250,0.6153846153846154,9,4,5,342.06929669758944,0.38199383594120434,0.07428786808568733,0.20207384768937542,131654.57182623885,1406.9973583247581,133061.56918456362,4123,13,812.3157894736842,35,3,16,34.655299612796526,0.6389880952380952,43.43171296296296,1026.273148148148,29.322089947089943,2
4155,4,0,0,38,0.0,0.0,1.0,38,700,500,200,0.7142857142857143,9,5,4,342.06929669758944,0.38199383594120434,0.07428786808568733,0.20207384768937542,131654.57182623885,1406.9973583247581,133061.56918456362,4124,14,813.3157894736842,35,3,16,34.655299612796526,0.6389880952380952,43.43171296296296,1026.273148148148,29.322089947089943,0
4156,4,0,0,38,0.0,0.0,1.0,38,900,700,200,0.7777777777777778,11,7,4,342.7703878641752,0.38254208155523944,0.06859186505818249,0.20359735086390185,131862.52170138902,1439.7135416666763,133302.2352430557,4125,15,814.3157894736842,35,3,16,34.42782285327923,0.6410714285714285,43.22916666666667,1027.0833333333344,29.345238095238127,0
4157,4,0,0,38,0.0,0.0,1.0,38,850,500,350,0.5882352941176471,12,5,7,341.600878286985,0.3824087245139877,0.06515810815617518,0.2035391004987822,131981.42387902958,1416.9940629286787,133398.41794195827,4126,16,815.3157894736842,35,3,16,34.3381579935421,0.6422619047619047,43.11342592592593,1027.546296296297,29.35846560846563,0
4158,4,1,1,38,0.02564102564102564,0.02564102564102564,0.9743589743589743,39,1050,700,350,0.6666666666666666,14,7,7,335.81900014037575,0.3871176338281601,0.058620892957912396,0.2013811509049281,132224.21481870406,1080.680722952702,133304.89554165676,4127,0,795.3846153846154,36,3,16,34.24258184605276,0.6426504629629628,42.87725225225226,1028.4909909909927,28.569194194194242,0
4159,4,0,0,38,0.0,0.0,1.0,38,1050,800,250,0.7619047619047619,13,8,5,342.3605180057492,0.3825717164532954,0.05297518898552056,0.20495490848807832,132159.8776148837,1449.2648319616228,133609.14244684533,4128,18,817.3157894736842,35,3,16,34.139088998949426,0.644047619047619,42.93981481481483,1028.2407407407431,29.378306878306947,0
4160,4,0,1,37,0.0,0.02631578947368421,0.9736842105263158,38,1250,900,350,0.72,16,9,7,341.9733314973821,0.3818012091038407,0.05478086501561541,0.20522893626130684,132253.17166829,1445.4115433000713,133698.58321159007,4129,19,818.3157894736842,36,2,16,34.055224071235685,0.6429398148148147,42.84909909909911,1028.6036036036044,28.572322322322343,0
4161,4,1,1,37,0.02631578947368421,0.02631578947368421,0.9736842105263158,38,1100,900,200,0.8181818181818182,13,9,4,336.0442233383925,0.38614272166903746,0.05982379361971657,0.20260186024491503,132426.97934420922,1300.2642845548387,133727.24362876406,4130,0,807.9473684210526,36,2,16,34.03309628008753,0.6446759259259258,42.68018018018019,1029.2792792792804,28.591091091091123,0
4162,4,1,1,37,0.02631578947368421,0.02631578947368421,0.9736842105263158,38,850,600,250,0.7058823529411765,11,6,5,335.9104621887031,0.3851499525841631,0.05572569178606557,0.20298938240524242,132513.92598257068,1302.5628246490019,133816.4888072197,4131,0,808.921052631579,36,2,16,33.94924167851545,0.6455439814814813,42.595720720720735,1029.6171171171193,28.600475475475534,0
4163,4,0,0,37,0.0,0.0,1.0,37,950,800,150,0.8421052631578947,11,8,3,337.4256645318267,0.38219469469469475,0.06520756339448663,0.18841619896032552,129473.85381235808,1373.8581435130498,130847.71195587113,4132,22,831.7837837837837,34,3,17,36.980202362849475,0.6191789215686274,45.56547619047618,1017.7380952380936,29.933473389355694,6
4164,4,2,0,39,0.05128205128205128,0.0,1.0,39,1000,700,300,0.7,13,7,6,325.20506399030296,0.39096941070625285,0.07091969736853287,0.18447292890971545,130090.20580969492,661.1987409707103,130751.40455066563,4133,0,790.0769230769231,36,3,19,36.66657467711668,0.6212384259259258,44.96058558558559,1020.1576576576583,28.33771271271273,0
4165,4,0,0,39,0.0,0.0,1.0,39,750,500,250,0.6666666666666666,10,5,5,325.6598977465177,0.3904071075123707,0.07271842407574036,0.18513989920821505,130176.38204082481,678.6454528853424,130855.02749371015,4134,1,791.0769230769231,36,3,19,36.56776465828001,0.6221064814814814,44.87612612612614,1020.4954954954972,28.347097097097144,0
4166,4,0,0,39,0.0,0.0,1.0,39,750,600,150,0.8,9,6,3,327.03040399833384,0.39023841655420605,0.06698063840920976,0.18633127669672528,130262.58680555577,719.9652777778012,130982.55208333356,4135,2,792.0769230769231,36,3,19,36.44557823129251,0.622974537037037,44.79166666666668,1020.8333333333351,28.35648148148153,0
4167,4,2,1,40,0.04878048780487805,0.024390243902439025,0.975609756097561,41,1050,800,250,0.7619047619047619,13,8,5,310.5657188250518,0.40020325203252033,0.06950658934086196,0.17908042533695157,130726.51855504417,-80.16495909124777,130646.35359595293,4136,0,754.390243902439,38,3,15,36.39760934670567,0.6239035087719298,44.337606837606835,1022.6495726495724,26.911830859199274,0
4168,4,0,0,40,0.0,0.0,1.0,40,1000,600,400,0.6,14,6,8,320.0994706786213,0.395045405982906,0.07336979836979829,0.18423502867947314,130654.64854570644,364.49676823638896,131019.14531394283,4137,1,774.25,37,3,15,36.22640497640499,0.625,44.40789473684211,1022.3684210526321,27.631578947368435,0
4169,4,0,0,40,0.0,0.0,1.0,40,600,300,300,0.5,9,3,6,322.51690249445437,0.39476495726495725,0.07968532218290969,0.18603062149448218,130738.7384219183,433.0905903739613,131171.82901229226,4138,2,775.25,37,3,15,36.07972820842714,0.6258445945945945,44.32565789473684,1022.6973684210528,27.640469416785212,0
4170,4,0,2,38,0.0,0.05,0.95,40,850,400,450,0.47058823529411764,13,4,9,324.37001746682716,0.3948317307692308,0.09250964423489094,0.1877804592432027,130878.94833025527,490.64135118496074,131369.58968144024,4139,3,776.25,37,3,15,35.89084154879268,0.6272522522522523,44.18859649122806,1023.2456140350862,27.65528686581314,0
4171,4,0,0,38,0.0,0.0,1.0,38,1000,700,300,0.7,13,7,6,339.09469031883276,0.3870465860597439,0.09558919949931521,0.19468180204910826,130558.13426997562,1254.3140217763653,131812.448291752,4140,4,817.7894736842105,35,3,15,35.83852397130993,0.6279761904761907,44.502314814814795,1021.9907407407377,29.199735449735364,0
4172,4,1,0,39,0.02564102564102564,0.0,1.0,39,1300,1000,300,0.7692307692307693,16,10,6,335.54932335076677,0.3915317139001349,0.10115857358565128,0.19404618731010276,130838.01442912495,980.5214420501401,131818.5358711751,4141,0,797.7948717948718,36,3,16,35.64621170427444,0.6287615740740742,44.228603603603595,1023.0855855855846,28.419044044044014,0
4173,4,0,0,39,0.0,0.0,1.0,39,800,400,400,0.5,12,4,8,335.2659977673971,0.3916160593792173,0.09886764129088377,0.19417221935706405,130895.62694028474,976.9705939047019,131872.59753418944,4142,1,798.7948717948718,36,3,17,35.59526429698105,0.6293402777777779,44.17229729729729,1023.3108108108097,28.425300300300268,0
4174,4,0,0,39,0.0,0.0,1.0,39,800,700,100,0.875,9,7,2,332.9574664524861,0.39155982905982906,0.09240248144418062,0.19312382977579093,130953.25213304508,920.3726107864535,131873.62474383155,4143,2,799.7948717948718,36,3,17,35.59614185645654,0.6299189814814815,44.11599099099099,1023.5360360360351,28.43155655655653,0
4175,4,2,1,40,0.04878048780487805,0.024390243902439025,0.975609756097561,41,450,100,350,0.2222222222222222,8,1,7,318.47053294012494,0.3975863821138212,0.09682919206523022,0.18720138675396553,131465.04635336762,173.5486750310391,131638.59502839867,4144,0,761.7317073170732,38,3,18,35.451392506163835,0.6313048245614036,43.61645299145299,1025.5341880341878,26.987741790373363,0
4176,4,0,0,40,0.0,0.0,1.0,40,1050,800,250,0.7619047619047619,13,8,5,323.13693968316284,0.39445779914529916,0.10059606543355049,0.18996227510098176,131468.65051025304,496.4754780316829,131965.1259882847,4145,1,781.775,37,3,19,35.32812555686231,0.6331644144144144,43.61293859649122,1025.5482456140342,27.717520151730653,0
4177,4,0,0,40,0.0,0.0,1.0,40,1000,700,300,0.7,13,7,6,320.59922739863913,0.3939369658119658,0.10262159273115934,0.18874800329227617,131524.88175448205,433.35509483685746,131958.2368493189,4146,2,782.775,37,3,19,35.33660698378762,0.6337274774774775,43.55811403508771,1025.7675438596484,27.72344713134185,0
4178,4,0,0,40,0.0,0.0,1.0,40,1100,900,200,0.8181818181818182,13,9,4,318.38804717027523,0.3942574786324786,0.0985444931097108,0.18827735373095028,131693.64762474975,385.93665839487346,132079.58428314462,4147,3,783.775,37,3,15,35.22360057686146,0.6354166666666667,43.393640350877185,1026.4254385964898,27.7412280701754,0
4179,4,1,1,40,0.024390243902439025,0.024390243902439025,0.975609756097561,41,1050,700,350,0.6666666666666666,14,7,7,310.77101613513946,0.39883130081300816,0.09104879570317803,0.18519179883443443,131985.99810979617,3.4845496383928776,131989.48265943455,4148,0,765.6341463414634,38,3,15,35.125545851528386,0.6365131578947368,43.10897435897436,1027.5641025641025,27.04116059379217,0
4180,4,0,0,40,0.0,0.0,1.0,40,1200,1100,100,0.9166666666666666,13,11,2,318.92096283585465,0.39413728632478634,0.09386208368915483,0.1895718007516678,131890.67790089254,412.5403970452421,132303.21829793777,4149,5,785.775,37,3,15,35.01192001138628,0.6373873873873874,43.20175438596491,1027.19298245614,27.761972498814597,0
4181,4,0,0,40,0.0,0.0,1.0,40,750,400,350,0.5333333333333333,11,4,7,317.8409868920732,0.393616452991453,0.09243677302315678,0.18935078755026186,131975.16453379887,389.4233081332758,132364.58784193214,4150,6,786.775,37,3,16,34.95480293814249,0.6382319819819819,43.11951754385965,1027.5219298245615,27.77086296823139,0
4182,4,0,1,39,0.0,0.025,0.975,40,900,700,200,0.7777777777777778,11,7,4,319.69923208191136,0.3932024572649573,0.08857721843003419,0.19116709183673453,132116.0357032932,447.47903200983376,132563.51473530303,4151,7,787.775,37,3,17,34.76562499999999,0.6396396396396395,42.98245614035087,1028.0701754385955,27.785680417259336,0
4183,4,0,0,39,0.0,0.0,1.0,39,900,600,300,0.6666666666666666,12,6,6,330.5015973042083,0.3888045434098066,0.08954133800759556,0.19743577095502707,132079.47812677544,930.4956984011061,133009.97382517654,4152,8,808.7179487179487,36,3,17,34.52472246567339,0.6412037037037037,43.01801801801802,1027.927927927928,28.553553553553556,0
4184,4,1,1,39,0.025,0.025,0.975,40,1050,700,350,0.6666666666666666,14,7,7,324.21793064340994,0.3922008547008547,0.08390973036342331,0.19488384645913587,132313.3815813518,579.674154547538,132893.05573589934,4153,0,789.475,37,3,17,34.451379267469534,0.6416103603603605,42.79057017543859,1028.8377192982443,27.806424845898494,0
4185,4,0,0,39,0.0,0.0,1.0,39,1650,1300,350,0.7878787878787878,20,13,7,331.9182415709157,0.38776428250112466,0.09052216339665753,0.19996050162930795,132398.00347222236,989.0625000000196,133387.0659722224,4154,10,810.7179487179487,36,3,17,34.16835357624832,0.6443865740740741,42.70833333333334,1029.1666666666679,28.587962962962997,0
4186,4,0,0,39,0.0,0.0,1.0,39,1000,700,300,0.7,13,7,6,330.176436429889,0.3877361673414305,0.08648727484868357,0.19937073856288304,132484.94059938335,948.6811135459974,133433.62171292934,4155,11,811.7179487179487,36,3,17,34.12592065922847,0.6452546296296295,42.62387387387388,1029.504504504506,28.59734734734739,0
4187,4,0,0,39,0.0,0.0,1.0,39,1050,900,150,0.8571428571428571,12,9,3,330.6467904704024,0.38812977957714795,0.08784960255709273,0.20011680336544221,132571.90626014533,966.8950622920264,133538.80132243736,4156,12,812.7179487179487,36,3,18,34.02656278476398,0.6461226851851851,42.539414414414416,1029.8423423423428,28.606731731731745,0
4188,4,1,1,39,0.025,0.025,0.975,40,900,500,400,0.5555555555555556,13,5,8,335.8797645059795,0.392721688034188,0.07601593412469265,0.19716331939079784,131412.43128895407,827.7552948984073,132240.18658385248,4157,0,793.375,37,3,19,35.058082023313,0.6326013513513514,43.667763157894726,1025.3289473684194,27.711593172119443,4
4189,4,0,0,39,0.0,0.0,1.0,39,700,600,100,0.8571428571428571,8,6,2,339.946936815933,0.38917004048583,0.08641276333246029,0.19926187803190193,131356.983567182,1130.880838608874,132487.86440579087,4158,1,812.7179487179487,36,3,19,35.009749533120946,0.6339699074074074,43.721846846846844,1025.1126126126123,28.475350350350343,0
4190,4,0,0,39,0.0,0.0,1.0,39,1250,900,350,0.72,16,9,7,337.1734204081632,0.3887764282501125,0.12259633699633699,0.18234038495497085,128203.13169795948,849.4465228961369,129052.57822085562,4159,2,813.7179487179487,35,4,18,38.28047619047618,0.6041666666666667,46.817129629629626,1012.7314814814811,28.935185185185173,5
4191,4,0,0,39,0.0,0.0,1.0,39,1050,900,150,0.8571428571428571,12,9,3,337.38733046426404,0.3893949617633828,0.12467267710585106,0.18299186436704873,128320.37278163573,858.7336033950553,129179.10638503078,4160,3,814.7179487179487,35,4,19,38.15541466758054,0.6053571428571429,46.701388888888886,1013.1944444444439,28.94841269841268,0
4192,4,2,2,39,0.04878048780487805,0.04878048780487805,0.9512195121951219,41,1050,800,250,0.7619047619047619,13,8,5,323.3066686979288,0.3976117886178862,0.11972552311566687,0.17745445749849934,128794.39153928345,128.01713510849314,128922.40867439193,4161,0,775.9268292682926,38,3,14,38.029549521103036,0.6044407894736842,46.233974358974365,1015.0641025641032,26.712213225371137,0
4193,4,2,1,40,0.04878048780487805,0.024390243902439025,0.975609756097561,41,1200,600,600,0.5,18,6,12,322.514945380934,0.398145325203252,0.12335425489074558,0.17799156213739412,129011.3768924867,121.61943439988923,129132.9963268866,4162,0,776.8780487804878,38,3,16,37.829074210397174,0.6066337719298245,46.02029914529915,1015.9188034188037,26.73470535312641,0
4194,4,0,0,40,0.0,0.0,1.0,40,1100,800,300,0.7272727272727273,14,8,6,328.90871431566825,0.39548611111111115,0.12870830184605442,0.18124220230255994,128950.68825263533,482.60101665895877,129433.28926929428,4163,1,797.3,37,3,16,37.72839522832775,0.6078265765765766,46.080043859649116,1015.6798245614027,27.4508060692271,0
4195,4,0,0,40,0.0,0.0,1.0,40,1200,800,400,0.6666666666666666,16,8,8,325.2833339138815,0.39563301282051283,0.12384548985757426,0.1798762493266022,129089.93632656202,398.1609726069525,129488.09729916898,4164,2,798.3,37,3,16,37.67893108905193,0.6092342342342343,45.94298245614035,1016.2280701754386,27.465623518255097,0
4196,4,3,3,40,0.06976744186046512,0.06976744186046512,0.9302325581395349,43,1350,1000,350,0.7407407407407407,17,10,7,303.87408328299153,0.4053156146179402,0.11075633606066582,0.17051657685678295,129666.7461910901,-719.5272737788241,128947.21891731129,4165,0,743.5348837209302,40,3,11,37.638653296081955,0.6098958333333333,45.37601626016261,1018.4959349593507,25.462398373983767,0
4197,4,0,0,40,0.0,0.0,1.0,40,900,600,300,0.6666666666666666,12,6,6,328.0312116302555,0.3963141025641026,0.13011590296495967,0.18229415745180455,129285.0098708255,481.90368671127703,129766.91355753677,4166,4,800.3,37,3,17,37.410938903863425,0.611204954954955,45.75109649122806,1016.9956140350865,27.48636794689423,0
4198,4,0,0,40,0.0,0.0,1.0,40,850,600,250,0.7058823529411765,11,6,5,328.02494937081536,0.39549946581196577,0.12979840403192,0.18291039916906582,129418.7166703192,490.51359668346674,129909.23026700267,4167,5,801.3,38,2,18,37.27534824303514,0.6107456140350876,45.61965811965812,1017.5213675213672,26.77687809266756,0
4199,4,0,0,40,0.0,0.0,1.0,40,850,600,250,0.7058823529411765,11,6,5,328.89753223649154,0.39539262820512816,0.12966617677934078,0.18365052122419814,129473.07715136248,516.6751132296052,129989.75226459208,4168,6,802.3,38,2,12,37.19797571558543,0.6112938596491228,45.56623931623932,1017.7350427350433,26.7825011246064,0
4200,4,0,0,40,0.0,0.0,1.0,40,1150,800,350,0.6956521739130435,15,8,7,332.5051212289467,0.3943910256410256,0.1309425154725692,0.18656688173487632,129663.42872242315,622.7508172620383,130286.1795396852,4169,7,803.3,38,2,14,36.9130039511871,0.6132127192982456,45.379273504273506,1018.4829059829062,26.80218173639227,0
4201,4,1,0,41,0.024390243902439025,0.0,1.0,41,550,400,150,0.7272727272727273,7,4,3,322.7073542258946,0.3987042682926829,0.1248517348271152,0.18237064567916042,129943.77170138896,186.76215277778752,130130.53385416674,4170,0,784.6829268292682,39,2,15,36.8784906688462,0.6143162393162394,45.10416666666667,1019.5833333333339,26.14316239316241,0
4202,4,2,3,40,0.046511627906976744,0.06976744186046512,0.9302325581395349,43,1150,700,450,0.6086956521739131,16,7,9,312.28416514829297,0.40623846437799926,0.12273575485380994,0.17839362908082837,130363.87963750311,-457.8849363819627,129905.99470112115,4171,0,749.1395348837209,41,2,15,36.71961012887768,0.6153455284552845,44.692460317460316,1021.2301587301583,24.90805265195508,0
4203,4,1,1,40,0.024390243902439025,0.024390243902439025,0.975609756097561,41,1250,700,550,0.56,18,7,11,326.3640149937526,0.39560467479674793,0.12722747635639653,0.18595158993830105,130262.58680555562,302.60416666667675,130565.19097222229,4172,0,786.439024390244,39,2,15,36.462585034013614,0.6175213675213675,44.79166666666667,1020.8333333333339,26.17521367521369,0
4204,4,1,1,40,0.024390243902439025,0.024390243902439025,0.975609756097561,41,1300,1000,300,0.7692307692307693,16,10,6,325.50153665275934,0.393114837398374,0.12961189083481206,0.18584109282510178,130342.3516167534,285.3271484374958,130627.6787651909,4173,0,787.4146341463414,39,2,15,36.403928219252634,0.6183226495726496,44.713541666666664,1021.1458333333327,26.18322649572648,0
4205,4,2,1,41,0.047619047619047616,0.023809523809523808,0.9761904761904762,42,600,200,400,0.3333333333333333,10,2,8,319.77347056193156,0.4000072590011614,0.13688700773608287,0.18378751810925212,130599.97046235723,-47.51883799324372,130552.451624364,4174,0,769.6190476190476,40,2,11,36.28993504341486,0.6192708333333332,44.461382113821145,1022.1544715447168,25.55386178861792,0
4206,4,1,0,42,0.023809523809523808,0.0,1.0,42,650,300,350,0.46153846153846156,10,3,7,320.34740806969523,0.40041860240030974,0.14885507020059285,0.18473673165646673,130729.84959556158,-24.206304944143938,130705.64329061743,4175,0,770.5952380952381,40,2,12,36.144166749478266,0.6205729166666667,44.334349593495936,1022.6626016260169,25.566565040650424,0
4207,4,0,1,41,0.0,0.023809523809523808,0.9761904761904762,42,850,600,250,0.7058823529411765,11,6,5,311.70239361280005,0.4005637824235386,0.11754410927717762,0.17700746786609214,130132.94004891257,-287.45021977659655,129845.48982913597,4176,1,771.5952380952381,40,2,16,36.96775398406376,0.6145833333333335,44.918699186991866,1020.3252032520315,25.508130081300788,4
4208,4,1,2,40,0.023809523809523808,0.047619047619047616,0.9523809523809523,42,800,400,400,0.5,12,4,8,313.9194315224088,0.39937814556716994,0.12368436024350027,0.1787418803974528,130236.65229030317,-223.23682992929807,130013.41546037387,4177,0,772.4285714285714,40,2,16,36.80638523828487,0.6156250000000001,44.817073170731696,1020.7317073170715,25.518292682926788,0
4209,4,1,1,40,0.024390243902439025,0.024390243902439025,0.975609756097561,41,1000,500,500,0.5,15,5,10,318.3030864451401,0.4010416666666667,0.10718863796455125,0.18123486020197122,130236.0039605034,90.90440538193425,130326.90836588533,4178,0,750.6341463414634,39,2,18,36.695177228968944,0.6172542735042736,44.81770833333333,1020.729166666666,26.172542735042718,0
4210,4,0,0,40,0.0,0.0,1.0,40,1100,900,200,0.8181818181818182,13,9,4,328.56752830240436,0.3968082264957265,0.11075392670157136,0.1865529069731246,130126.29323727051,551.0549072247518,130677.34814449526,4179,4,770.4,38,2,18,36.544284467713794,0.617872807017544,44.92521367521366,1020.299145299143,26.849977507872183,0
4211,4,0,1,39,0.0,0.025,0.975,40,1000,600,400,0.6,14,6,8,329.00452377672656,0.397142094017094,0.10942374123312093,0.18719358044306517,130208.06081753573,567.8082082328618,130775.8690257686,4180,5,771.4,38,2,19,36.45037335566488,0.6186951754385966,44.84508547008546,1020.6196581196562,26.858412055780423,0
4212,4,1,0,40,0.025,0.0,1.0,40,800,600,200,0.75,10,6,4,333.64421544620257,0.40081463675213674,0.11774825550187873,0.19078550441260697,130402.541226627,701.6221262240115,131104.163352851,4181,0,767.325,37,3,21,36.135153873680444,0.6224662162162165,44.65460526315787,1021.3815789473649,27.60490753911797,0
4213,4,0,0,40,0.0,0.0,1.0,40,900,500,400,0.5555555555555556,13,5,8,333.30675116571126,0.3999465811965812,0.10997531659154358,0.19100567695953818,130486.54994806054,698.409606802046,131184.95955486258,4182,1,768.325,37,3,21,36.05879301709951,0.623310810810811,44.57236842105261,1021.7105263157862,27.61379800853476,0
4214,4,0,0,40,0.0,0.0,1.0,40,700,500,200,0.7142857142857143,9,5,4,336.02939822063445,0.400133547008547,0.10642703862660974,0.19284445759952612,130542.57079101226,773.2283010156541,131315.7990920279,4183,2,769.325,37,3,12,35.932582260371944,0.623873873873874,44.5175438596491,1021.9298245614006,27.61972498814596,0
4215,4,0,1,39,0.0,0.025,0.975,40,1150,800,350,0.6956521739130435,15,8,7,336.73804306168415,0.3999332264957265,0.10957680250783741,0.19389789844165525,130671.89554569336,800.4396778434975,131472.33522353685,4184,3,770.325,38,2,13,35.78369905956113,0.6233552631578949,44.39102564102563,1022.4358974358954,26.906207827260406,0
4216,4,0,0,39,0.0,0.0,1.0,39,850,500,350,0.5882352941176471,12,5,7,342.7677438013378,0.3992914979757085,0.098423930524284,0.19771148710173658,130738.73842191833,1162.6044792628516,131901.34290118117,4185,4,768.025641025641,37,2,14,35.56196615560558,0.6258445945945945,44.32565789473684,1022.697368421053,27.64046941678522,0
4217,4,0,0,39,0.0,0.0,1.0,39,950,500,450,0.5263157894736842,14,5,9,341.4388923926666,0.3994883040935673,0.09424244922637182,0.19737452701509164,130822.85534972296,1133.6021660510853,131956.45751577403,4186,5,769.025641025641,37,2,15,35.51089674883887,0.6266891891891893,44.243421052631575,1023.0263157894733,27.64935988620198,0
4218,4,0,0,39,0.0,0.0,1.0,39,850,600,250,0.7058823529411765,11,6,5,341.94616131249416,0.39951641925326137,0.09347489201754122,0.19795543283921804,130878.94833025544,1150.7107956294217,132029.65912588488,4187,6,770.025641025641,37,2,15,35.441223746249456,0.6272522522522522,44.18859649122807,1023.2456140350876,27.655286865813178,0
4219,4,1,2,38,0.025,0.05,0.95,40,600,500,100,0.8333333333333334,7,5,2,331.5792481811902,0.4022302350427351,0.08492071771333243,0.1931056301983527,131109.19922017664,694.6179414128051,131803.81716158945,4188,0,751.75,38,2,15,35.47404200570276,0.6277412280701755,43.96367521367521,1024.1452991452982,26.951192082771005,0
4220,4,0,0,38,0.0,0.0,1.0,38,750,500,250,0.6666666666666666,10,5,5,347.01080724390863,0.3940996917970602,0.11910349121210673,0.19358623206144945,129436.83556241418,1389.4996920682365,130826.33525448242,4189,8,791.9473684210526,35,3,13,36.77396117682743,0.6166666666666667,45.60185185185185,1017.5925925925919,29.074074074074055,3
4221,4,3,1,40,0.07317073170731707,0.024390243902439025,0.975609756097561,41,1150,700,450,0.6086956521739131,16,7,9,328.5634982807019,0.40475101626016263,0.13320787218894847,0.18694919606006485,130209.423828125,356.41276041666583,130565.83658854167,4190,0,734.9268292682926,39,2,15,36.46024698918147,0.6169871794871795,44.84375,1020.625,26.169871794871796,0
4222,4,2,2,40,0.047619047619047616,0.047619047619047616,0.9523809523809523,42,650,400,250,0.6153846153846154,9,4,5,324.5522190345112,0.4070242934572203,0.1461127206475319,0.18635453345042788,130562.68376981495,74.90344950779192,130637.58721932274,4191,0,718.3809523809524,38,4,15,36.20548470276675,0.6222587719298247,44.497863247863236,1022.0085470085451,26.894961763382764,0
4223,4,1,0,41,0.024390243902439025,0.0,1.0,41,1300,1000,300,0.7692307692307693,16,10,6,329.1093236481119,0.40729166666666666,0.15103748403429473,0.18910443839888788,130589.98243343171,395.6761587770914,130985.6585922088,4192,0,732.8780487804878,38,3,16,36.06146127312637,0.6225328947368423,44.47115384615383,1022.1153846153827,26.897773279352176,0
4224,4,0,0,41,0.0,0.0,1.0,41,1100,800,300,0.7272727272727273,14,8,6,329.3411497649738,0.4068343495934959,0.1514931476484931,0.1900411589330978,130753.83434007221,412.523627547655,131166.35796761987,4193,1,733.8780487804878,38,3,17,35.89000313381385,0.6241776315789473,44.31089743589743,1022.7564102564094,26.91464237516867,0
4225,4,0,0,41,0.0,0.0,1.0,41,1000,600,400,0.6,14,6,8,328.85134862982176,0.4066819105691057,0.15190021756077265,0.18989281132580874,130781.15297866882,401.5117064796398,131182.66468514845,4194,2,734.8780487804878,38,3,17,35.87493907109534,0.624451754385965,44.28418803418803,1022.8632478632463,26.917453891138063,0
4226,4,0,0,41,0.0,0.0,1.0,41,850,700,150,0.8235294117647058,10,7,3,327.8461661672982,0.40584349593495933,0.14874075432483624,0.18958060913152433,130835.79881656784,378.80300788952326,131214.60182445735,4195,3,735.8780487804878,38,3,17,35.8454730576441,0.6250000000000002,44.23076923076922,1023.0769230769214,26.923076923076877,0
4227,4,1,1,41,0.023809523809523808,0.023809523809523808,0.9761904761904762,42,1000,500,500,0.5,15,5,10,322.81787619053966,0.4088632404181185,0.149075379465043,0.18763908368283935,131034.66932508671,60.06673177082328,131094.73605685754,4196,0,719.3333333333334,39,3,17,35.77349764302913,0.6252670940170941,44.03645833333333,1023.8541666666658,26.25267094017092,0
4228,4,0,0,41,0.0,0.0,1.0,41,1000,800,200,0.8,12,8,4,328.2636843886795,0.4059705284552846,0.15095521453178806,0.190226124183857,130917.78897518064,395.1111522024762,131312.90012738312,4197,5,737.8780487804878,38,3,17,35.75203570310052,0.6258223684210528,44.150641025641015,1023.3974358974345,26.931511470985118,0
4229,4,0,0,41,0.0,0.0,1.0,41,1250,1000,250,0.8,15,10,5,321.5387727952482,0.4063516260162601,0.1267684609000992,0.18158684185499663,129917.22140842004,154.68478732637698,130071.90619574641,4198,6,738.8780487804878,39,2,17,36.9351563298253,0.6140491452991453,45.13020833333333,1019.4791666666658,26.14049145299143,3
4230,4,2,0,43,0.046511627906976744,0.0,1.0,43,1100,700,400,0.6363636363636364,15,7,8,313.0024814568532,0.4121216315983758,0.13649980683771346,0.17929424194220775,130470.15587819758,-432.04504897205993,130038.11082922552,4199,0,705.4651162790698,40,3,20,36.593968632912244,0.61796875,44.588414634146346,1021.6463414634153,25.54115853658538,0
4231,4,0,0,43,0.0,0.0,1.0,43,1100,700,400,0.6363636363636364,15,7,8,314.404893595308,0.4111064968623108,0.14768435698668214,0.18118797476265724,130703.8686049973,-381.21281975012073,130322.65578524719,4200,1,706.4651162790698,40,3,17,36.32230172927849,0.6203124999999998,44.35975609756099,1022.5609756097583,25.564024390243958,0
4232,4,0,0,43,0.0,0.0,1.0,43,1350,900,450,0.6666666666666666,18,9,9,357.3138878892397,0.4111064968623108,0.11831191185154499,0.1957927787101782,128728.04763244443,658.7728914443887,129386.82052388882,4201,2,707.4651162790698,37,6,14,37.234265262020536,0.6055743243243243,46.29934210526315,1014.802631578946,27.427098150782324,7
4233,4,0,0,43,0.0,0.0,1.0,43,1250,800,450,0.64,17,8,9,356.49293436780835,0.41101421188630494,0.11571381556634686,0.19561678087983383,128783.6897530969,582.0950917589771,129365.78484485588,4202,3,708.4651162790698,37,6,15,37.19831388858879,0.6061373873873874,46.24451754385964,1015.0219298245597,27.433025130393506,0
4234,4,2,1,44,0.044444444444444446,0.022222222222222223,0.9777777777777777,45,1150,1000,150,0.8695652173913043,13,10,3,353.4969367208561,0.41759259259259257,0.17817616186031948,0.18679462930821603,127271.40472147854,22.900811347082538,127294.30553282562,4203,0,677.9333333333333,40,5,17,38.821465740087966,0.5856770833333333,47.73882113821138,1009.0447154471539,25.226117886178848,8
4235,4,0,1,43,0.0,0.022727272727272728,0.9772727272727273,44,1000,600,400,0.6,14,6,8,352.43594431090105,0.4192873502466526,0.17769177280046877,0.18706215505732401,127450.92207019606,183.65721462090005,127634.57928481695,4204,1,688.6136363636364,40,4,14,38.66411701556628,0.5875000000000001,47.560975609756085,1009.7560975609736,25.24390243902434,0
4236,4,1,1,43,0.022727272727272728,0.022727272727272728,0.9772727272727273,44,1200,800,400,0.6666666666666666,16,8,8,358.33110261288783,0.41990398167723747,0.18209927327574404,0.19128302820639656,127681.9159912254,350.4803481723767,128032.39633939778,4205,0,689.2727272727273,40,4,16,38.278448131389304,0.58984375,47.33231707317073,1010.6707317073165,25.26676829268291,0
4237,4,0,0,43,0.0,0.0,1.0,43,1200,800,400,0.6666666666666666,16,8,8,362.4036455189,0.4172203765227021,0.17905130854407258,0.19327530319839747,127644.04432508686,651.7333984375116,128295.77772352437,4206,1,706.1627906976744,39,4,16,38.214380819846774,0.5910790598290598,47.36979166666667,1010.5208333333338,25.91079059829061,0
4238,4,2,2,43,0.044444444444444446,0.044444444444444446,0.9555555555555556,45,1000,800,200,0.8,12,8,4,349.8707654282702,0.42249579124579123,0.18930589580271184,0.18881180122662578,128119.42087309447,-34.952030580761146,128084.4688425137,4207,0,675.7333333333333,41,4,17,38.04456557243183,0.5927337398373984,46.89980158730158,1012.4007936507925,24.69270228416567,0
4239,4,3,2,44,0.06521739130434782,0.043478260869565216,0.9565217391304348,46,1500,1000,500,0.6666666666666666,20,10,10,342.45007542365533,0.43008252818035425,0.20443530031330015,0.1876349063429276,128725.26584201398,-383.59721926964585,128341.66862274433,4208,0,660.6086956521739,39,7,15,37.61419626360089,0.6020299145299146,46.302083333333336,1014.7916666666674,26.020299145299166,0
4240,4,2,1,45,0.043478260869565216,0.021739130434782608,0.9782608695652174,46,1150,900,250,0.782608695652174,14,9,5,354.99938130533303,0.42914653784219,0.23710248924743182,0.19620504048915136,129069.04432508674,-36.113823784726634,129032.930501302,4209,0,661.5652173913044,39,7,16,36.94526311293354,0.6055021367521367,45.963541666666664,1016.1458333333328,26.055021367521356,0
4241,4,2,3,44,0.0425531914893617,0.06382978723404255,0.9361702127659575,47,1050,800,250,0.7619047619047619,13,8,5,346.56406844489004,0.42934782608695654,0.2340563125765367,0.19300248661654795,129368.6579043552,-432.89086696146603,128935.76703739374,4210,0,648.4468085106383,37,10,18,36.85465617589999,0.6120495495495495,45.66885964912281,1017.3245614035088,27.49525841631105,0
4242,4,1,2,43,0.022222222222222223,0.044444444444444446,0.9555555555555556,45,1450,1000,450,0.6896551724137931,19,10,9,360.4201560446645,0.42771464646464646,0.24760603991198105,0.20016760372998893,129260.23046339174,317.59848679699553,129577.82895018873,4211,0,674.4,35,10,20,36.61269823203582,0.6148809523809522,45.77546296296297,1016.898148148149,29.05423280423283,0
4243,4,0,0,43,0.0,0.0,1.0,43,1400,800,600,0.5714285714285714,20,8,12,375.85871885119457,0.4226190476190476,0.25101024546581363,0.20800139572026807,129119.9380547335,1106.1708990795291,130226.10895381303,4212,1,705.7441860465116,38,5,20,36.3633974561127,0.6077302631578949,45.913461538461526,1016.346153846152,26.745951417004,0
4244,4,1,1,43,0.022727272727272728,0.022727272727272728,0.9772727272727273,44,1200,800,400,0.6666666666666666,16,8,8,369.8026564318484,0.4230421952078929,0.2524646151679455,0.20641794973283625,129459.11864144576,774.9422409375967,130234.06088238336,4213,0,690.6818181818181,36,8,15,36.171434104238145,0.6148726851851851,45.57995495495497,1017.6801801801823,28.268893893893953,0
4245,4,2,2,43,0.044444444444444446,0.044444444444444446,0.9555555555555556,45,950,800,150,0.8421052631578947,11,8,3,367.50977987144825,0.42571548821548827,0.2546445735600025,0.20700823600759055,129815.23762119132,541.673880424766,130356.9115016161,4214,0,676.2888888888889,37,8,16,35.86722616741985,0.616554054054054,45.23026315789475,1019.0789473684225,27.54267425320061,0
4246,4,0,0,43,0.0,0.0,1.0,43,950,800,150,0.8421052631578947,11,8,3,378.83488471852445,0.4206579918789221,0.2526472718429662,0.21229231310532365,129613.56122470862,1220.4277049039936,130833.98892961262,4215,4,708.7441860465116,35,8,17,35.784174433583395,0.6184523809523809,45.42824074074075,1018.2870370370381,29.093915343915373,0
4247,4,1,1,43,0.022727272727272728,0.022727272727272728,0.9772727272727273,44,1200,900,300,0.75,15,9,6,373.031209879783,0.4234165785764623,0.25664478504822963,0.21129103614016248,130032.77084094247,901.2563661634811,130934.02720710594,4216,0,693.6136363636364,36,8,17,35.505226160244376,0.6206597222222221,45.0168918918919,1019.9324324324339,28.331456456456497,0
4248,4,1,0,44,0.022727272727272728,0.0,1.0,44,1250,900,350,0.72,16,9,7,373.81949201132045,0.4214785940803383,0.26963805381785244,0.21315201932979022,130292.12648158852,941.3502124927265,131233.47669408124,4217,0,694.5909090909091,35,9,19,35.22146487548652,0.625297619047619,44.762731481481474,1020.949074074073,29.169973544973516,0
4249,4,2,2,44,0.043478260869565216,0.043478260869565216,0.9565217391304348,46,1300,800,500,0.6153846153846154,18,8,10,357.21996877748137,0.4267612721417069,0.25807015552276025,0.2064201086930831,130808.47447083438,145.47983326029248,130953.95430409467,4218,0,665.3478260869565,38,8,16,35.121845082680586,0.6247258771929824,44.25747863247864,1022.9700854700865,26.92026540710754,0
4250,4,0,0,44,0.0,0.0,1.0,44,800,400,400,0.5,12,4,8,375.52889434109517,0.42014622973925303,0.2789643154025663,0.215875603162389,130607.69120049107,1009.3923737927205,131617.08357428378,4219,2,696.5909090909091,36,8,16,34.857331717527835,0.6264467592592593,44.45382882882883,1022.184684684685,28.394019019019026,0
4251,4,0,1,43,0.0,0.022727272727272728,0.9772727272727273,44,1300,900,400,0.6923076923076923,17,9,8,385.0092870123334,0.4201242071881606,0.22502973850279218,0.211966651421076,128915.32368517175,1171.9609812515341,130087.2846664233,4220,3,697.5909090909091,36,8,14,36.34005137872403,0.609375,46.11486486486487,1015.5405405405413,28.20945945945948,7
4252,4,3,1,45,0.06521739130434782,0.021739130434782608,0.9782608695652174,46,1200,900,300,0.75,15,9,6,355.74011889011723,0.4275462962962963,0.1461666879527086,0.1994655772506232,129636.22708013716,138.5673667096728,129774.79444684683,4221,0,661.9130434782609,38,8,14,36.34905231500908,0.6129385964912282,45.405982905982896,1018.376068376067,26.799370220422816,5
4253,4,0,1,44,0.0,0.022222222222222223,0.9777777777777777,45,1200,1000,200,0.8333333333333334,14,10,4,359.69480772370423,0.4262205387205387,0.1444097409202416,0.20131201264102427,129563.94184989604,320.6954303247029,129884.63728022075,4222,1,677.6222222222223,37,8,14,36.32191258301919,0.6140202702702704,45.47697368421052,1018.0921052631572,27.516002844950197,0
4254,4,0,2,42,0.0,0.045454545454545456,0.9545454545454546,44,1100,300,800,0.2727272727272727,19,3,16,362.6728343500201,0.424297480620155,0.1651887152882512,0.20317768080501092,129602.41280131463,600.6548778508036,130203.06767916543,4223,2,693.9090909090909,36,8,14,36.20696011206962,0.6163194444444446,45.43918918918918,1018.2432432432415,28.284534534534487,0
4255,4,1,1,42,0.023255813953488372,0.023255813953488372,0.9767441860465116,43,550,200,350,0.36363636363636365,9,2,7,358.89719582358373,0.42536452565522337,0.18233859164091792,0.20230136053245626,129843.17440221956,720.070237957799,130563.24464017736,4224,0,687.3488372093024,37,6,14,36.05825264479112,0.6168355855855857,45.202850877192965,1019.1885964912252,27.545637743006086,0
4256,4,1,0,43,0.023255813953488372,0.0,1.0,43,1350,1100,250,0.8148148148148148,16,11,5,357.1511937391636,0.42610280546327056,0.19159984801395158,0.20249878846921207,130071.79578493666,691.0594272773578,130762.85521221402,4225,0,688.3255813953489,38,5,17,35.87051389470744,0.6173245614035088,44.97863247863247,1020.085470085469,26.844354475933393,0
4257,4,0,0,43,0.0,0.0,1.0,43,800,600,200,0.75,10,6,4,357.28960731570606,0.42658730158730157,0.19076536488325813,0.20300256034933403,130153.5462437905,700.5018856380875,130854.04812942859,4226,1,689.3255813953489,38,5,17,35.78399295012738,0.6181469298245614,44.898504273504265,1020.4059829059818,26.852789023841627,0
4258,4,0,0,43,0.0,0.0,1.0,43,1450,1000,450,0.6896551724137931,19,10,9,356.0045802857208,0.4264719453672942,0.18831050272774474,0.20255579246393599,130208.06081753572,670.933208232863,130878.99402576858,4227,2,690.3255813953489,38,5,18,35.76145364457936,0.6186951754385966,44.84508547008546,1020.619658119656,26.858412055780423,0
4259,4,0,0,43,0.0,0.0,1.0,43,1150,900,250,0.782608695652174,14,9,5,355.8011002840257,0.4268410852713178,0.1832946693669013,0.20316221011312854,130346.55044100087,675.500627301292,131022.05106830217,4228,3,691.3255813953489,37,6,19,35.62616324850566,0.6219031531531534,44.70942982456139,1021.1622807017527,27.59898055950683,0
4260,4,0,0,43,0.0,0.0,1.0,43,950,900,50,0.9473684210526315,10,9,1,354.94577714621795,0.4269564414913252,0.1855721579348144,0.2029662316830578,130402.54122662709,657.1662675053469,131059.70749413244,4229,4,692.3255813953489,37,6,20,35.591228305600296,0.6224662162162165,44.654605263157876,1021.3815789473656,27.60490753911799,0
4261,4,0,0,43,0.0,0.0,1.0,43,1200,800,400,0.6666666666666666,16,8,8,359.30298955589586,0.42665651531930604,0.18225371793592227,0.2062009767648362,130542.57079101223,780.8671899045431,131323.43798091676,4230,5,693.3255813953489,37,6,13,35.337982832618025,0.623873873873874,44.5175438596491,1021.9298245614003,27.619724988145954,0
4262,4,0,0,43,0.0,0.0,1.0,43,900,600,300,0.6666666666666666,12,6,6,362.1373116825569,0.4266103728313031,0.18178099174584506,0.20827922003803045,130626.62459843396,860.954933248669,131487.57953168263,4231,6,694.3255813953489,37,6,13,35.180355929779374,0.6247184684684686,44.43530701754385,1022.2587719298231,27.628615457562784,0
4263,4,0,0,43,0.0,0.0,1.0,43,950,600,350,0.631578947368421,13,6,7,360.03075606294357,0.4264719453672942,0.18386729200794805,0.20766894630792065,130738.73842191834,813.9933681517405,131552.73179007007,4232,7,695.3255813953489,37,6,13,35.120595225331456,0.6258445945945945,44.32565789473684,1022.6973684210532,27.64046941678522,0
4264,4,0,0,43,0.0,0.0,1.0,43,1250,1000,250,0.8,15,10,5,360.36961415662756,0.42591823551125874,0.18727718887407985,0.20907708813872686,130963.11034404805,839.0251086872761,131802.13545273533,4233,8,696.3255813953489,37,6,14,34.88473040528478,0.6280968468468469,44.1063596491228,1023.5745614035078,27.66417733522994,0
4265,4,0,2,41,0.0,0.046511627906976744,0.9534883720930233,43,1450,1000,450,0.6896551724137931,19,10,9,361.79765271419933,0.4257798080472499,0.1881285270985773,0.21036528524565326,131047.2994094336,882.5210641735858,131929.8204736072,4234,9,697.3255813953489,37,6,14,34.762975655029635,0.6289414414414414,44.02412280701754,1023.9035087719293,27.673067804646738,0
4266,4,0,1,40,0.0,0.024390243902439025,0.975609756097561,41,1300,1000,300,0.7692307692307693,16,10,6,369.34721304751787,0.4234502032520325,0.17464639525933778,0.21384405439116608,130883.62328800155,1468.300298996916,132351.92358699845,4235,10,679.2926829268292,35,6,14,34.73553613844588,0.63125,44.18402777777778,1023.2638888888889,29.23611111111111,0
4267,4,1,1,40,0.024390243902439025,0.024390243902439025,0.975609756097561,41,900,600,300,0.6666666666666666,12,6,6,368.7320190927158,0.42520325203252035,0.17423651229163495,0.2141454175229855,131002.08340031284,1460.9325435099327,132463.01594382277,4236,0,679.390243902439,35,6,14,34.631265309967965,0.6324404761904763,44.06828703703703,1023.7268518518512,29.249338624338606,0
4268,4,0,0,40,0.0,0.0,1.0,40,1250,900,350,0.72,16,9,7,378.02883836939316,0.4216746794871795,0.1850267535186696,0.21914456665284374,130931.84700963713,1899.202806122444,132831.0498157596,4237,12,697.375,34,6,15,34.4645418944593,0.6338848039215685,44.13690476190476,1023.4523809523805,30.101540616246485,0
4269,4,0,0,40,0.0,0.0,1.0,40,1200,800,400,0.6666666666666666,16,8,8,380.1457529727343,0.4213808760683761,0.18611692236169253,0.22159715844020367,131145.1530612245,1970.8545918367395,133116.00765306124,4238,13,698.375,34,6,15,34.19412482566249,0.6360294117647058,43.92857142857143,1024.2857142857144,30.12605042016807,0
4270,4,0,0,40,0.0,0.0,1.0,40,1700,1300,400,0.7647058823529411,21,13,8,373.243224060703,0.42126068376068376,0.17888411518810954,0.21896257803888125,131389.14399092982,1808.0215419501267,133197.16553287994,4239,14,699.375,34,6,19,34.12389688806317,0.6384803921568627,43.6904761904762,1025.238095238096,30.154061624649884,0
4271,4,0,0,40,0.0,0.0,1.0,40,950,600,350,0.631578947368421,13,6,7,371.697787167505,0.42132745726495724,0.17729251305861848,0.21857859634457724,131480.6990504536,1774.2169784580612,133254.91602891166,4240,15,700.375,34,6,21,34.07090346295221,0.6393995098039215,43.60119047619048,1025.5952380952388,30.164565826330552,0
4272,4,0,0,40,0.0,0.0,1.0,40,950,700,250,0.7368421052631579,12,7,5,372.0437845764697,0.42136752136752137,0.17567896935933103,0.21895691584090604,131511.22448979603,1785.5867346938871,133296.8112244899,4241,16,701.375,34,6,21,34.031162952646234,0.6397058823529411,43.57142857142858,1025.7142857142865,30.168067226890777,0
4273,4,0,0,40,0.0,0.0,1.0,40,1050,600,450,0.5714285714285714,15,6,9,369.628362997755,0.42072649572649573,0.1725005799118533,0.2185826986122527,131694.45153061228,1735.600907029484,133430.05243764177,4242,17,702.375,34,6,13,33.90792932807547,0.6415441176470588,43.392857142857146,1026.4285714285718,30.189075630252113,0
4274,4,0,0,40,0.0,0.0,1.0,40,950,700,250,0.7368421052631579,12,7,5,363.6184551007407,0.42073985042735046,0.10198866702644405,0.20065068412795511,129006.37846500863,1381.8200071175943,130388.19847212623,4243,18,703.375,37,3,14,36.79022755891347,0.6083896396396395,46.025219298245624,1015.8991228070189,27.45673304883835,7
4275,4,0,0,40,0.0,0.0,1.0,40,1550,1100,450,0.7096774193548387,20,11,9,364.1060361227504,0.42072649572649573,0.10592680766249596,0.20235332998304995,129287.27027280674,1415.0023809266054,130702.27265373334,4244,19,704.375,36,4,17,36.49143690252096,0.6131365740740741,45.74887387387388,1017.0045045045057,28.25012512512516,0
4276,4,0,0,40,0.0,0.0,1.0,40,1350,900,450,0.6666666666666666,18,9,9,365.7795073574609,0.41944444444444445,0.1099894876618348,0.20417229203146264,129459.11864144576,1470.6985279198448,130929.8171693656,4245,20,705.375,36,4,15,36.273791081111,0.6148726851851851,45.57995495495497,1017.6801801801823,28.268893893893953,0
4277,4,0,0,40,0.0,0.0,1.0,40,950,800,150,0.8421052631578947,11,8,3,368.4045784061175,0.4185630341880342,0.11356219709208348,0.2061866492164443,129563.94184989658,1546.389874769206,131110.3317246658,4246,21,706.375,37,3,15,36.100228863758744,0.61402027027027,45.47697368421055,1018.0921052631616,27.51600284495031,0
4278,4,2,1,41,0.047619047619047616,0.023809523809523808,0.9761904761904762,42,900,500,400,0.5555555555555556,13,5,8,354.32419155025764,0.4258251064653504,0.11807500778088942,0.2007837085451466,130050.00000000044,815.9722222222662,130865.9722222227,4247,0,673.6904761904761,39,3,16,35.964733115468405,0.6153846153846152,45.00000000000002,1020.0000000000035,26.153846153846246,0
4279,4,0,0,41,0.0,0.0,1.0,41,1600,1200,400,0.75,20,12,8,359.9385448048592,0.4217987804878049,0.12487702666445144,0.20365224719397687,129990.07100820042,1157.6873995544256,131147.75840775485,4248,1,691.1219512195122,38,3,16,35.882442814737196,0.6165021929824559,45.0587606837607,1019.7649572649606,26.835919928025277,0
4280,4,1,1,41,0.023809523809523808,0.023809523809523808,0.9761904761904762,42,450,200,250,0.4444444444444444,7,2,5,353.2299583657645,0.4235385210994967,0.12769855850076217,0.20098415401090425,130209.42382812547,798.7738715278213,131008.19769965329,4249,0,675.6428571428571,39,3,16,35.8308668435735,0.6169871794871793,44.84375000000002,1020.6250000000038,26.16987179487189,0
4281,4,2,1,42,0.046511627906976744,0.023255813953488372,0.9767441860465116,43,1300,1000,300,0.7692307692307693,16,10,6,340.96822760394366,0.4255029531192322,0.12567414190222603,0.19600814451937945,130607.69120049127,306.65799879273584,130914.34919928401,4250,0,660.8837209302326,36,7,13,35.740516323307986,0.6264467592592592,44.45382882882884,1022.1846846846867,28.394019019019073,0
4282,4,0,0,42,0.0,0.0,1.0,42,650,500,150,0.7692307692307693,8,5,3,341.41543268561816,0.4233207510646535,0.1216739023451392,0.19099330415778776,129545.80213758703,476.86030955472125,130022.66244714175,4251,1,677.6190476190476,39,3,13,36.805591084279826,0.610309829059829,45.49479166666668,1018.0208333333352,26.10309829059834,4
4283,4,1,3,40,0.023255813953488372,0.06976744186046512,0.9302325581395349,43,850,500,350,0.5882352941176471,12,5,7,334.90774085186945,0.4260105204872647,0.1163266184085694,0.18848424144052345,129781.98346757694,92.99817728017908,129874.98164485712,4252,0,662.8372093023256,41,2,13,36.73155405186124,0.6095020325203251,45.26289682539683,1018.9484126984134,24.8524003097174,0
4284,4,3,3,40,0.06976744186046512,0.06976744186046512,0.9302325581395349,43,1000,800,200,0.8,12,8,4,339.4815724088096,0.424718530823182,0.12962983911655535,0.1920490414303883,129984.23450688158,225.45046375032922,130209.6849706319,4253,0,662.6046511627907,41,2,14,36.409893147841885,0.6115345528455283,45.064484126984134,1019.7420634920644,24.871757646147913,0
4285,4,0,0,40,0.0,0.0,1.0,40,950,600,350,0.631578947368421,13,6,7,358.00019599013,0.4168803418803419,0.13079223504721949,0.20045486884758754,129581.83235627146,1278.064276061073,130859.89663233254,4254,4,713.3,38,2,14,36.34684330185381,0.612390350877193,45.45940170940171,1018.1623931623932,26.79374718848403,0
4286,4,1,1,40,0.024390243902439025,0.024390243902439025,0.975609756097561,41,1600,1100,500,0.6875,21,11,10,353.94455702310836,0.41814024390243903,0.12957955675398125,0.19988778878160202,129917.22140842021,996.6986762152828,130913.9200846355,4255,0,696.8780487804878,39,2,14,36.10923078233031,0.6140491452991453,45.130208333333336,1019.4791666666673,26.14049145299147,0
4287,4,2,1,41,0.047619047619047616,0.023809523809523808,0.9761904761904762,42,900,600,300,0.6666666666666666,12,6,6,347.7940405395502,0.4219294425087108,0.1333290659687152,0.19789776482372257,130210.72035701307,657.3025109062089,130868.02286791928,4256,0,681.2380952380952,40,2,17,35.968253178001255,0.6153645833333332,44.84247967479675,1020.6300813008133,25.515752032520332,0
4288,4,1,1,41,0.023809523809523808,0.023809523809523808,0.9761904761904762,42,1300,1000,300,0.7692307692307693,16,10,6,343.9556608808533,0.4216874758033295,0.12294322478442132,0.19652553271727907,130371.67302441753,568.4356467455789,130940.1086711631,4257,0,682.2142857142857,38,4,18,35.90311922446559,0.6203399122807017,44.68482905982906,1021.2606837606846,26.875281151596965,0
4289,4,1,1,41,0.023809523809523808,0.023809523809523808,0.9761904761904762,42,650,400,250,0.6153846153846154,9,4,5,348.60881379962166,0.4191831204026326,0.14673913043478248,0.2004500679347827,130617.2839506174,706.8672839506291,131324.15123456804,4258,0,683.1904761904761,38,4,14,35.53555253623186,0.6228070175438596,44.44444444444445,1022.2222222222232,26.900584795321663,0
4290,4,0,0,41,0.0,0.0,1.0,41,1000,700,300,0.7,13,7,6,352.3396011428533,0.41824186991869916,0.1466031051642851,0.20249751922649073,130598.60365689448,1003.0119844567612,131601.61564135124,4259,1,699.219512195122,37,4,14,35.459128942287066,0.6244369369369369,44.46271929824562,1022.149122807018,27.625651967757243,0
4291,4,0,1,40,0.0,0.024390243902439025,0.975609756097561,41,1050,700,350,0.6666666666666666,14,7,7,350.5206846941211,0.418114837398374,0.14683303351043842,0.20233025661056678,130766.77439212051,967.2918590335375,131734.06625115406,4260,2,700.219512195122,37,4,15,35.335370211549474,0.6261261261261262,44.29824561403508,1022.8070175438585,27.64343290659077,0
4292,4,0,0,40,0.0,0.0,1.0,40,1450,1200,250,0.8275862068965517,17,12,5,360.83831434726073,0.41551816239316236,0.14515418502202682,0.20789415572799042,130694.03863322787,1431.8833191299486,132125.9219523578,4261,3,718.625,36,4,15,35.14523678414098,0.6273148148148149,44.36936936936937,1022.5225225225229,28.403403403403413,0
4293,4,0,1,39,0.0,0.025,0.975,40,1200,900,300,0.75,15,9,6,361.68228441756526,0.4155315170940171,0.14408510404051533,0.2088468016125079,130780.41459956595,1460.191821889478,132240.60642145542,4262,4,719.625,36,4,17,35.03614811552719,0.6281828703703702,44.28490990990992,1022.8603603603617,28.412787787787824,0
4294,4,0,0,39,0.0,0.0,1.0,39,750,300,450,0.4,12,3,9,360.72831468164134,0.4127305443094917,0.16029875012701966,0.20845140016336083,130809.21292914549,1637.317384952536,132446.53031409802,4263,5,737.5641025641025,36,3,17,35.03137384412153,0.6284722222222221,44.256756756756765,1022.972972972974,28.415915915915946,0
4295,4,0,0,39,0.0,0.0,1.0,39,1500,1200,300,0.8,18,12,6,363.4119967237241,0.41292735042735046,0.16436092049335915,0.21110405509363442,131010.89000740615,1722.1858260287415,132733.0758334349,4264,6,738.5641025641025,36,3,18,34.758506581600855,0.6304976851851851,44.05968468468469,1023.7612612612621,28.437812812812837,0
4296,4,0,0,39,0.0,0.0,1.0,39,1050,800,250,0.7619047619047619,13,8,5,362.90593361659563,0.41312415654520923,0.1562520343842786,0.2058587885180176,130090.20580969493,1665.007659686725,131755.21346938165,4265,7,739.5641025641025,36,3,17,35.70505390587629,0.6212384259259258,44.96058558558559,1020.1576576576584,28.337712712712733,6
4297,4,0,0,39,0.0,0.0,1.0,39,1100,700,400,0.6363636363636364,15,7,8,364.79776254217353,0.41256185335132706,0.1593059044515357,0.2076964145529057,130233.84871357832,1701.8033235938497,131935.65203717217,4266,8,740.5641025641025,36,3,17,35.51090394233597,0.6226851851851853,44.81981981981981,1020.7207207207198,28.353353353353327,0
4298,4,0,0,39,0.0,0.0,1.0,39,1000,700,300,0.7,13,7,6,363.5973637282483,0.4124775078722447,0.16083399834419798,0.20781490895567234,130384.14292800447,1681.4724689181662,132065.61539692263,4267,9,741.5641025641025,34,5,18,35.38898278742666,0.6283700980392157,44.672619047619044,1021.3095238095233,30.03851540616245,0
4299,4,0,0,39,0.0,0.0,1.0,39,1150,1000,150,0.8695652173913043,13,10,3,364.6868447662454,0.41292735042735046,0.16154174770043328,0.20909199656838243,130505.75573979596,1718.7464569161052,132224.50219671207,4268,10,742.5641025641025,34,5,16,35.2377762243194,0.629595588235294,44.55357142857143,1021.7857142857147,30.052521008403374,0
4300,4,0,0,39,0.0,0.0,1.0,39,800,500,300,0.625,11,5,6,362.65815308633273,0.41225258659469183,0.16024297156372636,0.2084192036411818,130597.00255102056,1672.4135487528524,132269.4160997734,4269,11,743.5641025641025,34,5,16,35.1970746952403,0.6305147058823529,44.46428571428572,1022.1428571428584,30.06302521008407,0
4301,4,1,0,40,0.025,0.0,1.0,40,1250,800,450,0.64,17,8,9,383.46326224767677,0.41676014957264956,0.1378868258178605,0.21576962666772234,129774.47041636212,2043.0155049906289,131817.48592135275,4270,0,725.95,36,4,15,35.50232095490716,0.6180555555555557,45.27027027027026,1018.9189189189174,28.30330330330326,8
4302,4,0,0,40,0.0,0.0,1.0,40,1200,900,300,0.75,15,9,6,383.84371661426724,0.4165731837606838,0.13761878453038712,0.21630047542709308,129831.84831791234,1967.0278386494433,131798.87615656178,4271,1,726.95,36,4,15,35.434162062615094,0.6186342592592593,45.213963963963955,1019.1441441441428,28.309559559559524,0
4303,4,1,0,41,0.024390243902439025,0.0,1.0,41,1000,600,400,0.6,14,6,8,379.1900042720857,0.4205030487804878,0.08654393725524079,0.21165781770270764,129459.11864144543,1643.0334895706417,131102.15213101608,4272,0,710.1951219512196,36,5,14,35.93260115820145,0.6148726851851853,45.57995495495495,1017.6801801801796,28.26889389389388,4
4304,4,0,1,40,0.0,0.024390243902439025,0.975609756097561,41,1350,1000,350,0.7407407407407407,17,10,7,375.26286157513425,0.41996951219512196,0.07836606903652532,0.2101743626409342,129591.85157933172,1526.2018120959913,131118.0533914277,4273,1,711.1951219512196,37,4,14,35.897228803216315,0.6143018018018019,45.44956140350875,1018.2017543859619,27.518966334755724,0
4305,4,1,1,40,0.024390243902439025,0.024390243902439025,0.975609756097561,41,1050,700,350,0.6666666666666666,14,7,7,373.9111161294914,0.4197154471544715,0.07481669908723632,0.21016383423829998,129731.44531249972,1501.60590277775,131233.05121527746,4274,0,712.0975609756098,37,4,14,35.78945126107702,0.6157094594594597,45.312499999999986,1018.7499999999978,27.533783783783726,0
4306,4,2,0,42,0.047619047619047616,0.0,1.0,42,1050,500,550,0.47619047619047616,16,5,11,371.6545194565797,0.42100996902826177,0.10033799952141664,0.21131214106245488,130180.80210387873,1276.456689677809,131457.25879355654,4275,0,696.0952380952381,38,4,17,35.38983982412059,0.6184210526315791,44.871794871794854,1020.5128205128182,26.855600539811004,0
4307,4,2,1,43,0.045454545454545456,0.022727272727272728,0.9772727272727273,44,1150,700,450,0.6086956521739131,16,7,9,358.58348897291796,0.4249911909795631,0.1063434143216111,0.2067489944992421,130722.82745160679,575.1122396684759,131297.93969127527,4276,0,665.4090909090909,36,8,13,35.17371434864001,0.6276041666666667,44.3412162162162,1022.6351351351333,28.40653153153148,0
4308,4,0,0,43,0.0,0.0,1.0,43,1300,800,500,0.6153846153846154,18,8,10,363.79707786954015,0.42160391288298266,0.10271650245322927,0.2099937588098432,130766.77439212041,914.5140812557445,131681.28847337616,4277,1,681.8837209302326,37,6,15,34.9958905088622,0.6261261261261262,44.298245614035075,1022.8070175438577,27.64343290659075,0
4309,4,1,0,44,0.022727272727272728,0.0,1.0,44,1000,500,500,0.5,15,5,10,357.83151968746927,0.42389006342494717,0.10946922289225158,0.20869152133597638,131163.91354372108,586.9165023011003,131750.83004602217,4278,0,667.3636363636364,38,6,16,34.74655819774718,0.6282894736842106,43.9102564102564,1024.3589743589732,26.956815114709823,0
4310,4,0,1,43,0.0,0.022727272727272728,0.9772727272727273,44,1750,1500,250,0.8571428571428571,20,15,5,356.6063413472915,0.42383500704721633,0.1061972271447933,0.20872023383432362,131300.74929003202,564.5359640952487,131865.28525412726,4279,1,668.3636363636364,38,6,18,34.6396243788874,0.6296600877192983,43.7767094017094,1024.8931623931614,26.97087269455688,0
4311,4,1,0,44,0.022727272727272728,0.0,1.0,44,950,400,550,0.42105263157894735,15,4,11,354.05383177696586,0.42491411205074,0.11445273776896636,0.20829053726048646,131496.7646295012,511.38953023828594,132008.1541597395,4280,0,667.6590909090909,37,7,20,34.507073622692616,0.633445945945946,43.585526315789465,1025.6578947368407,27.720483641536237,0
4312,4,1,1,44,0.022222222222222223,0.022222222222222223,0.9777777777777777,45,1400,1000,400,0.7142857142857143,18,10,8,348.21274286228845,0.426473063973064,0.12418096723868932,0.2070541448745148,131903.67408366204,186.10802925706236,132089.7821129191,4281,0,653.8,38,7,15,34.24661986479458,0.6356907894736842,43.18910256410256,1027.2435897435896,27.032726045883937,0
4313,4,0,0,44,0.0,0.0,1.0,44,1250,900,350,0.72,16,9,7,360.05614622083203,0.42332848837209297,0.12096304634733324,0.21402322194141835,131890.67790089245,697.6098414896721,132588.28774238212,4282,1,669.6363636363636,37,7,18,33.95557571875888,0.6373873873873874,43.201754385964904,1027.1929824561394,27.76197249881458,0
4314,4,0,0,44,0.0,0.0,1.0,44,1150,900,250,0.782608695652174,14,9,5,364.26281534575355,0.4231082628611698,0.12832227524929163,0.21716737311834608,132003.33275623262,816.7811249615188,132820.11388119415,4283,2,670.6363636363636,37,7,18,33.73390596101863,0.6385135135135136,43.09210526315789,1027.6315789473679,27.773826458036968,0
4315,4,0,0,44,0.0,0.0,1.0,44,1850,1400,450,0.7567567567567568,23,14,9,372.90707629811976,0.42249163143058494,0.1366277660925277,0.2234821385686941,132200.59447378034,1059.7074340181507,133260.30190779848,4284,3,671.6363636363636,37,7,18,33.31278654440772,0.6404842342342343,42.90021929824561,1028.399122807017,27.794570886676134,0
4316,4,0,1,43,0.0,0.022727272727272728,0.9772727272727273,44,1250,900,350,0.72,16,9,7,377.5613098470136,0.4223044397463002,0.14681309633360762,0.22728754925684566,132369.79316953302,1195.5424986534356,133565.33566818645,4285,4,672.6363636363636,37,7,19,33.02244272775706,0.6421734234234234,42.73574561403509,1029.0570175438602,27.812351825509733,0
4317,4,0,0,43,0.0,0.0,1.0,43,1600,1200,400,0.75,20,12,8,386.38740788435393,0.42100406053894424,0.15458687711483754,0.23296412333111052,132428.63520408166,1633.7574286986305,134062.39263278028,4286,5,689.046511627907,34,9,20,32.73599545069012,0.6488970588235294,42.67857142857143,1029.2857142857144,30.273109243697483,0
4318,4,0,0,43,0.0,0.0,1.0,43,1300,900,400,0.6923076923076923,17,9,8,388.1342495819841,0.4207272056109265,0.15113725258271016,0.23497196592958314,132581.84700963713,1691.911139455783,134273.7581490929,4287,6,690.046511627907,34,9,20,32.53646013948293,0.6504289215686274,42.529761904761905,1029.880952380952,30.29061624649859,0
4319,4,0,0,43,0.0,0.0,1.0,43,1350,1000,350,0.7407407407407407,17,10,7,380.9027659600157,0.41971207087486156,0.1468617099653977,0.23214273765632432,132832.97444403893,1519.2894752861298,134352.26391932505,4288,7,691.046511627907,36,7,17,32.46963986599664,0.6487268518518517,42.28603603603605,1030.8558558558584,28.634884884884954,0
4320,4,0,0,43,0.0,0.0,1.0,43,1150,900,250,0.782608695652174,14,9,5,381.33861074825984,0.4196659283868586,0.15505230462906727,0.2329498104484204,132920.0542392057,1537.5097648324322,134457.56400403814,4289,8,692.046511627907,36,7,17,32.37072731243858,0.6495949074074073,42.20157657657659,1031.1936936936959,28.64426926926933,0
4321,4,0,2,41,0.0,0.046511627906976744,0.9534883720930233,43,1450,1200,250,0.8275862068965517,17,12,5,381.6650410251121,0.41874307862679955,0.15153591934329347,0.23405723600214728,133065.25063915286,1557.2708688418365,134622.5215079947,4290,9,693.046511627907,36,7,17,32.216173688423204,0.6510416666666665,42.06081081081082,1031.7567567567583,28.659909909909953,0
4322,4,0,0,41,0.0,0.0,1.0,41,900,500,400,0.5555555555555556,13,5,8,388.71279660568797,0.4181910569105691,0.19014030176451824,0.2269713506301812,131209.5175325787,2001.8064971252377,133211.32402970394,4291,10,710.8048780487804,35,6,20,33.909474318421445,0.6345238095238095,43.86574074074073,1024.5370370370358,29.272486772486737,3
4323,4,0,0,41,0.0,0.0,1.0,41,900,700,200,0.7777777777777778,11,7,4,387.1979737543286,0.41824186991869916,0.19273663769952187,0.22661190070023654,131298.46810967507,1967.7001618226975,133266.16827149777,4292,11,711.8048780487804,35,6,20,33.8581074722379,0.6354166666666666,43.77893518518518,1024.8842592592591,29.282407407407405,0
4324,4,0,0,41,0.0,0.0,1.0,41,900,600,300,0.6666666666666666,12,6,6,385.65362149963323,0.41778455284552846,0.1902124161093386,0.22625373053758302,131390.93888168025,1934.2849803509346,133325.22386203118,4293,12,712.8048780487804,33,8,20,33.80398836560683,0.6407828282828282,43.688725490196084,1025.2450980392166,31.068033273915656,0
4325,4,0,0,41,0.0,0.0,1.0,41,1050,800,250,0.7619047619047619,13,8,5,382.0935962168311,0.41747967479674797,0.19099957895663788,0.22501631516742676,131535.81700370798,1851.798670053152,133387.61567376115,4294,13,713.8048780487804,35,6,20,33.748566136372176,0.637797619047619,43.5474537037037,1025.810185185185,29.30886243386243,0
4326,4,0,0,41,0.0,0.0,1.0,41,1200,800,400,0.6666666666666666,16,8,8,384.23297084511,0.4173272357723577,0.18646184657199605,0.2268048947744838,131624.87809713653,1914.9235896776486,133539.80168681417,4295,14,714.8048780487804,35,6,16,33.60356041807655,0.6386904761904761,43.46064814814815,1026.1574074074078,29.31878306878308,0
4327,4,0,0,41,0.0,0.0,1.0,41,1250,900,350,0.72,16,9,7,381.7349952092551,0.41747967479674797,0.23172151395553575,0.22007406770788573,130718.71456916085,1786.7733069307833,132505.48787609162,4296,15,715.8048780487804,34,7,17,34.58600116414435,0.6317401960784315,44.34523809523809,1022.6190476190463,30.077030812324892,4
4328,4,0,0,41,0.0,0.0,1.0,41,1050,600,450,0.5714285714285714,15,6,9,384.3631782355665,0.4163109756097561,0.2328915160299414,0.22316941050963074,130992.77388038531,1869.7597789115453,132862.53365929687,4297,16,716.8048780487804,34,7,17,34.240657828429654,0.6344975490196079,44.07738095238094,1023.6904761904748,30.108543417366906,0
4329,4,1,1,41,0.023809523809523808,0.023809523809523808,0.9761904761904762,42,1300,1000,300,0.7692307692307693,16,10,6,376.22211061391044,0.4192194154084398,0.2288362696144628,0.21969632621086999,131212.72243527303,1473.0254747991157,132685.74791007215,4298,0,700.7142857142857,36,6,17,34.226157763611056,0.6325231481481483,43.86261261261261,1024.5495495495488,28.45970970970969,0
4330,4,0,0,41,0.0,0.0,1.0,41,950,500,450,0.5263157894736842,14,5,9,385.0723579007371,0.41544715447154473,0.2356320143740196,0.2243583020568355,131126.20380092924,1898.6152960392744,133024.8190969685,4299,18,718.8048780487804,36,5,17,34.087181601612606,0.6316550925925927,43.94707207207207,1024.2117117117111,28.45032532532531,0
4331,4,1,1,41,0.023809523809523808,0.023809523809523808,0.9761904761904762,42,1150,1000,150,0.8695652173913043,13,10,3,376.62177846792775,0.4192073170731707,0.22195574370266669,0.2215001872099852,131485.187863442,1504.6584574892831,132989.84632093128,4300,0,702.6666666666666,33,9,18,33.94011132353527,0.6417297979797979,43.5968137254902,1025.6127450980398,31.079174093879995,0
4332,4,0,0,41,0.0,0.0,1.0,41,1300,1000,300,0.7692307692307693,16,10,6,387.935644263936,0.4144817073170732,0.22540351613627285,0.22777947617939312,131422.35145436847,1996.6829164263722,133419.03437079483,4301,20,720.8048780487804,33,8,18,33.7136717660651,0.6410984848484849,43.658088235294116,1025.3676470588234,31.071746880570405,0
4333,4,0,0,41,0.0,0.0,1.0,41,1350,800,550,0.5925925925925926,19,8,11,386.22252148983637,0.41394817073170737,0.2276800249140043,0.22711993328566144,131480.6990504535,1956.1614229024917,133436.86047335598,4302,21,721.8048780487804,34,7,18,33.698491004062696,0.6393995098039216,43.601190476190474,1025.5952380952378,30.164565826330524,0
4334,4,0,0,41,0.0,0.0,1.0,41,1400,800,600,0.5714285714285714,20,8,12,385.90129700415474,0.4132367886178862,0.23221957445845032,0.2274758808195489,131572.2859977324,1954.7831632653013,133527.0691609977,4303,22,722.8048780487804,34,7,17,33.61399590005415,0.6403186274509804,43.51190476190476,1025.9523809523807,30.1750700280112,0
4335,4,1,1,41,0.023809523809523808,0.023809523809523808,0.9761904761904762,42,1200,900,300,0.75,15,9,6,377.2430366528085,0.41621902826171114,0.22658211549604035,0.22442420866825258,131921.96609224967,1553.3286179698227,133475.2947102195,4304,0,706.5714285714286,35,7,17,33.48261228781733,0.6416666666666666,43.1712962962963,1027.314814814815,29.35185185185186,0
4336,4,2,2,41,0.046511627906976744,0.046511627906976744,0.9534883720930233,43,1100,800,300,0.7272727272727273,14,8,6,367.845939960783,0.4161821705426357,0.2277399254961343,0.22110816493606864,132313.38158135218,1134.1880434364684,133447.56962478865,4305,0,691.0930232558139,37,6,18,33.32922572737932,0.6416103603603602,42.79057017543861,1028.8377192982475,27.806424845898583,0
4337,4,0,0,41,0.0,0.0,1.0,41,1350,1000,350,0.7407407407407407,17,10,7,377.7475865088632,0.41509146341463415,0.22582530958285352,0.22722051994282347,132340.0612394492,1798.2277463274384,134138.28898577663,4306,1,708.9268292682926,36,5,19,33.04763598555325,0.6438078703703702,42.764639639639654,1028.9414414414437,28.58170670670677,0
4338,4,0,1,40,0.0,0.024390243902439025,0.975609756097561,41,800,500,300,0.625,11,5,6,379.8325147208185,0.4141006097560975,0.23172142200256118,0.2290119890011295,132428.6352040817,1860.1656693234916,134288.80087340518,4307,2,709.9268292682926,34,7,19,32.90466689798752,0.6488970588235293,42.67857142857143,1029.2857142857147,30.27310924369749,0
4339,4,0,1,39,0.0,0.025,0.975,40,1000,600,400,0.6,14,6,8,380.9574589788617,0.4111912393162393,0.23684241847179255,0.23027371009643133,132524.15687475973,2097.213211264898,134621.37008602463,4308,3,726.625,33,7,20,32.77939776243751,0.6521464646464646,42.58578431372549,1029.6568627450981,31.201723113487823,0
4340,4,0,0,39,0.0,0.0,1.0,39,900,600,300,0.6666666666666666,12,6,6,381.54876939950265,0.40983468286099867,0.23296825295160017,0.23160148045787876,132681.93310565656,2324.925659602085,135006.85876525863,4309,4,736.7948717948718,33,6,16,32.605145513659245,0.6537247474747474,42.43259803921569,1030.269607843138,31.220291146761756,0
4341,4,0,0,39,0.0,0.0,1.0,39,1100,800,300,0.7272727272727273,14,8,6,384.5049381485,0.4099190283400809,0.2338539571064533,0.2343808362105205,132839.80320069208,2415.5120626682087,135255.3152633603,4310,5,737.7948717948718,33,6,16,32.3699278808052,0.6553030303030303,42.279411764705884,1030.8823529411768,31.23885918003566,0
4342,4,0,0,39,0.0,0.0,1.0,39,1300,900,400,0.6923076923076923,17,9,8,385.3076216712579,0.40930049482681063,0.23869463869463847,0.2354657687991021,132934.57031250003,2444.1406250000005,135378.71093750003,4311,6,738.7948717948718,33,6,16,32.25378787878787,0.65625,42.1875,1031.2500000000002,31.250000000000007,0
4343,4,1,1,39,0.025,0.025,0.975,40,750,400,350,0.5333333333333333,11,4,7,379.03101341662847,0.41069711538461534,0.24144569979248343,0.23383463800681617,133287.76218820864,2104.0391156462583,135391.8013038549,4312,0,721.3,34,6,17,32.06037199292905,0.6574754901960784,41.845238095238095,1032.6190476190477,30.371148459383758,0
4344,4,0,0,39,0.0,0.0,1.0,39,650,400,250,0.6153846153846154,9,4,5,387.858339774657,0.40983468286099867,0.24930872769352597,0.23802968082380557,133092.5905901577,2524.214244521347,135616.80483467903,4313,1,740.6153846153846,33,6,17,32.028899445764054,0.6578282828282829,42.0343137254902,1031.8627450980398,31.268568033273933,0
4345,4,0,0,39,0.0,0.0,1.0,39,1250,900,350,0.72,16,9,7,367.6961597815662,0.4096941070625281,0.18844065079203776,0.21247785721728657,130809.21292914529,1819.609051619176,132628.82198076445,4314,2,741.6153846153846,36,3,17,34.85317591369441,0.6284722222222223,44.25675675675675,1022.9729729729723,28.4159159159159,6
4346,4,0,0,39,0.0,0.0,1.0,39,1000,800,200,0.8,12,8,4,367.7270467961579,0.4093286099865047,0.19036732850711946,0.212654374293004,130838.01442912505,1822.5353309390457,132660.54976006408,4315,3,742.6153846153846,36,3,18,34.823197578425976,0.6287615740740742,44.2286036036036,1023.0855855855854,28.41904404404404,0
4347,4,0,0,39,0.0,0.0,1.0,39,950,500,450,0.5263157894736842,14,5,9,374.3440233236148,0.4093286099865047,0.19843014128728376,0.2132890365448507,130262.58680555588,1952.6041666667059,132215.1909722226,4316,4,743.6153846153846,36,3,21,35.23809523809525,0.6229745370370369,44.791666666666686,1020.833333333336,28.356481481481556,1
4348,4,1,0,40,0.025,0.0,1.0,40,1100,800,300,0.7272727272727273,14,8,6,363.83343851930675,0.4136752136752137,0.199417025130179,0.20952441954886306,130676.44702717777,1508.8922110768362,132185.33923825462,4317,0,726.0,35,5,20,35.08650290544112,0.6291666666666667,44.38657407407408,1022.4537037037047,29.21296296296299,0
4349,4,0,0,40,0.0,0.0,1.0,40,1400,1100,300,0.7857142857142857,17,11,6,351.04378116248904,0.41351495726495724,0.18301101928374686,0.2015004626217323,130550.14209733381,1165.76310262966,131715.90519996348,4318,1,727.0,36,4,16,35.5413223140496,0.6258680555555556,44.51013513513514,1021.9594594594594,28.387762762762762,1
4350,4,0,0,40,0.0,0.0,1.0,40,1000,500,500,0.5,15,5,10,348.3536746434318,0.41310096153846154,0.18506386258533358,0.20100051290417076,130751.61944038633,1109.5614195276326,131861.18085991396,4319,2,728.0,36,4,19,35.40611465903251,0.6278935185185186,44.31306306306306,1022.7477477477478,28.40965965965966,0
4351,4,1,0,41,0.024390243902439025,0.0,1.0,41,750,400,350,0.5333333333333333,11,4,7,339.31229116425817,0.4148119918699187,0.18256258143354387,0.1977240244395093,131131.51552641182,698.906995421653,131830.42252183348,4320,0,711.219512195122,37,4,20,35.25351943046784,0.6297860360360361,43.941885964912274,1024.2324561403498,27.681958274063508,0
4352,4,0,0,41,0.0,0.0,1.0,41,1050,800,250,0.7619047619047619,13,8,5,342.7794542866012,0.41394817073170737,0.18873931116544496,0.20062364177939013,131300.02891514695,801.3904518698027,132101.41936701676,4321,1,712.219512195122,37,4,22,34.994628401269566,0.6314752252252251,43.77741228070175,1024.8903508771928,27.6997392128971,0
4353,4,0,0,41,0.0,0.0,1.0,41,1300,900,400,0.6923076923076923,17,9,8,341.33442115052674,0.4143038617886179,0.19028685658272204,0.2002344571226071,131387.44882758922,769.4177698669935,132156.86659745622,4322,2,713.219512195122,35,6,22,34.94345977271017,0.6363095238095238,43.69212962962963,1025.231481481482,29.292328042328055,0
4354,4,0,0,41,0.0,0.0,1.0,41,1150,800,350,0.6956521739130435,15,8,7,340.78805964571427,0.4138719512195122,0.19426176307290488,0.20092967070604592,131581.1250216413,768.2552564250575,132349.38027806635,4323,3,714.219512195122,37,4,15,34.76218784510704,0.6342905405405406,43.50328947368421,1025.9868421052633,27.729374110953064,0
4355,4,1,0,42,0.023809523809523808,0.0,1.0,42,700,500,200,0.7142857142857143,9,5,4,338.9993696471726,0.4158560782036392,0.20838719263056227,0.20157569197016498,131903.6740836622,543.052473701523,132446.72655736373,4324,0,698.1904761904761,38,4,16,34.48322932917317,0.6356907894736842,43.18910256410257,1027.2435897435905,27.03272604588396,0
4356,4,0,0,42,0.0,0.0,1.0,42,1500,1000,500,0.6666666666666666,20,10,10,334.7766138739395,0.41601335656213706,0.20142292724950228,0.19949699332339227,131985.9981097963,437.1651051939648,132423.16321499026,4325,1,699.1904761904761,38,4,16,34.50886358910377,0.6365131578947367,43.108974358974365,1027.5641025641035,27.041160593792195,0
4357,4,0,1,41,0.0,0.023809523809523808,0.9761904761904762,42,950,600,350,0.631578947368421,13,6,7,333.9008510344554,0.4161706349206349,0.20077574641458606,0.1991191745877512,132013.44515897808,415.88033731463975,132429.32549629273,4326,2,700.1904761904761,38,4,16,34.50375991960357,0.6367872807017543,43.08226495726496,1027.6709401709406,27.043972109761597,0
4358,4,0,0,41,0.0,0.0,1.0,41,900,500,400,0.5555555555555556,13,5,8,341.4548805253945,0.41333841463414633,0.21155217742145416,0.20326761312089875,131946.99931709754,810.7893775007715,132757.7886945983,4327,3,718.1219512195122,37,4,17,34.3765563856279,0.6379504504504505,43.146929824561404,1027.4122807017543,27.767899478425793,0
4359,4,0,0,41,0.0,0.0,1.0,41,900,600,300,0.6666666666666666,12,6,6,343.54837622587513,0.4136178861788618,0.21181932690005478,0.20481777239115173,132003.33275623288,869.9061249615468,132873.2388811944,4328,4,719.1219512195122,37,4,17,34.266076255512885,0.6385135135135134,43.092105263157904,1027.63157894737,27.773826458037025,0
4360,4,0,1,40,0.0,0.024390243902439025,0.975609756097561,41,1300,1100,200,0.8461538461538461,15,11,4,334.48043498985214,0.4135416666666667,0.15531025958614686,0.20256445685749072,132595.55975155812,678.2516014542841,133273.8113530124,4329,5,720.1219512195122,37,4,19,33.90412629972673,0.6444256756756757,42.51644736842105,1029.9342105263154,27.83605974395447,5
4361,4,0,0,40,0.0,0.0,1.0,40,1350,1000,350,0.7407407407407407,17,10,7,341.91409287793795,0.41128472222222223,0.1622621911218014,0.20709578102394854,132600.90115453306,1067.6233666098674,133668.5245211429,4330,6,738.7,36,4,19,33.707358408047234,0.646412037037037,42.51126126126127,1029.954954954956,28.609859859859892,0
4362,4,0,0,40,0.0,0.0,1.0,40,1150,900,250,0.782608695652174,14,9,5,344.0019110752783,0.41069711538461534,0.17191803278688522,0.2090051451752191,132716.91243608494,1130.9743020047306,133847.88673808967,4331,7,739.7,36,4,16,33.537112932604735,0.6475694444444444,42.39864864864866,1030.405405405407,28.622372372372418,0
4363,4,0,0,40,0.0,0.0,1.0,40,800,500,300,0.625,11,5,6,345.07276805245726,0.4104700854700855,0.17099497322696955,0.20981800002977008,132745.92318247317,1161.4006320509875,133907.32381452416,4332,8,740.7,36,4,16,33.48040287036026,0.6478587962962963,42.370495495495504,1030.5180180180193,28.625500500500536,0
4364,4,0,0,40,0.0,0.0,1.0,40,1150,700,450,0.6086956521739131,16,7,9,342.7272464244498,0.41038995726495725,0.16265701802293853,0.2090385037319014,132861.9978720275,1107.0853370262278,133969.08320905373,4333,9,741.7,36,4,16,33.424358274167126,0.6490162037037037,42.25788288288289,1030.9684684684692,28.638013013013033,0
4365,4,0,0,40,0.0,0.0,1.0,40,1250,800,450,0.64,17,8,9,339.431789050245,0.4087606837606838,0.16270456960680146,0.2082172838958803,133075.95245652506,1034.0417243767263,134109.9941809018,4334,10,742.7,37,3,16,33.29481048529933,0.6492117117117117,42.050438596491226,1031.7982456140348,27.88643907064959,0
4366,4,0,0,40,0.0,0.0,1.0,40,1200,900,300,0.75,15,9,6,339.20281752565614,0.40838675213675213,0.1595900594732369,0.20902707655900396,133245.71021852887,1039.4640658664275,134285.1742843953,4335,11,743.7,37,3,18,33.130664117813645,0.6509009009009008,41.885964912280706,1032.4561403508778,27.904220009483186,0
4367,4,0,0,40,0.0,0.0,1.0,40,900,700,200,0.7777777777777778,11,7,4,337.49683191894854,0.4082799145299145,0.15575530263838622,0.2081625322588792,133279.09412895388,996.25440590985,134275.34853486373,4336,12,744.7,38,2,18,33.141274357647866,0.6493969298245614,41.85363247863248,1032.5854700854698,27.173301844354466,0
4368,4,0,0,40,0.0,0.0,1.0,40,1050,700,350,0.6666666666666666,14,7,7,336.582936484393,0.40739850427350427,0.14964067831661665,0.2085261741665961,133444.62393390687,983.0366763459836,134427.66061025285,4337,13,745.7,38,2,18,32.99921586874849,0.6510416666666665,41.693376068376075,1033.2264957264965,27.19017094017096,0
4369,4,0,0,40,0.0,0.0,1.0,40,1050,600,450,0.5714285714285714,15,6,9,335.523735345244,0.40639690170940174,0.1545820958845998,0.20866212248251723,133585.55036164972,964.2274226667448,134549.77778431645,4338,14,746.7,37,3,19,32.885642059114694,0.6542792792792793,41.55701754385965,1033.7719298245613,27.939781887150307,0
4370,4,0,0,40,0.0,0.0,1.0,40,1250,900,350,0.72,16,9,7,336.62472091684674,0.4064236111111111,0.15349268602925603,0.21031242497546557,133755.6327427669,1005.0905086180231,134760.72325138492,4339,15,747.7,37,3,17,32.68717758462299,0.6559684684684686,41.392543859649116,1034.4298245614027,27.957562825983857,0
4371,4,0,0,40,0.0,0.0,1.0,40,800,400,400,0.5,12,4,8,337.5696623162295,0.4061832264957265,0.15366680796947896,0.21122727676498265,133812.35091566615,1034.1980224684291,134846.54893813457,4340,16,748.7,37,3,17,32.606065423201905,0.6565315315315317,41.3377192982456,1034.6491228070158,27.96348980559502,0
4372,4,0,0,40,0.0,0.0,1.0,40,1000,400,600,0.4,16,4,12,333.1365200471586,0.4058627136752137,0.15122291021671863,0.20934454469889524,133969.4793721235,926.0252301117594,134895.50460223525,4341,17,749.7,38,2,17,32.56385448916408,0.65625,41.18589743589743,1035.2564102564095,27.243589743589723,0
4373,4,0,0,40,0.0,0.0,1.0,40,900,700,200,0.7777777777777778,11,7,4,330.5305899028143,0.4062232905982906,0.14074522949974178,0.20849018016316107,134107.7704383995,865.3440947110797,134973.11453311058,4342,18,750.7,38,2,18,32.49333849063089,0.6576206140350876,41.052350427350426,1035.7905982905986,27.257647323436807,2
4374,4,0,0,40,0.0,0.0,1.0,40,1250,1000,250,0.8,15,10,5,334.1834413859071,0.40612980769230766,0.14173711340206196,0.21159134343624678,134246.1328438893,972.5669333041183,135218.69977719343,4343,19,751.7,38,2,19,32.26073883161512,0.6589912280701754,40.91880341880342,1036.3247863247866,27.271704903283858,0
4375,4,2,2,40,0.047619047619047616,0.047619047619047616,0.9523809523809523,42,700,500,200,0.7142857142857143,9,5,4,317.9732140844445,0.4102424506387921,0.1288498108176992,0.20378811002931824,134689.37194097455,166.21306340858467,134855.58500438315,4344,0,716.8571428571429,38,4,20,32.239776313983825,0.6633771929824561,40.491452991452995,1038.0341880341884,27.316689158794432,0
4376,4,0,1,39,0.0,0.025,0.975,40,1200,900,300,0.75,15,9,6,329.88835154990204,0.40502136752136747,0.1390259606469555,0.20998204777015736,134439.96006145453,870.0353614215829,135309.99542287612,4345,21,753.7,38,2,20,32.17888293671233,0.6609100877192982,40.73183760683761,1037.07264957265,27.291385515069738,0
4377,4,0,0,39,0.0,0.0,1.0,39,950,700,250,0.7368421052631579,12,7,5,339.7960984626654,0.40266531713900133,0.15381362135432797,0.21627129873888862,134437.04433094774,1336.2366305016706,135773.2809614494,4346,29,773.4871794871794,37,2,21,31.924913653344618,0.6627252252252254,40.73464912280701,1037.0614035087701,28.028686581318112,0
4378,4,0,0,39,0.0,0.0,1.0,39,700,300,400,0.42857142857142855,11,3,8,322.57922650309143,0.4025809716599191,0.11368964475049226,0.19893441885917537,133274.01369892628,803.5877625807602,134077.60146150703,4347,30,774.4871794871794,37,2,17,33.53144578952956,0.6511824324324326,41.85855263157893,1032.565789473682,27.9071834992887,3
4379,4,0,0,39,0.0,0.0,1.0,39,800,500,300,0.625,11,5,6,321.5167620052201,0.4020186684660369,0.10826936686809296,0.19873280171188776,133358.94217451502,775.4270544782731,134134.36922899328,4348,31,775.4871794871794,37,2,17,33.47399150743101,0.6520270270270272,41.77631578947367,1032.8947368421034,27.916073968705497,0
4380,4,0,0,39,0.0,0.0,1.0,39,850,800,50,0.9411764705882353,9,8,1,321.3522779499706,0.40196243814664867,0.10740223729717568,0.1990862929074666,133443.8977016964,776.5001009925776,134220.397802689,4349,32,776.4871794871794,37,2,18,33.39335933354556,0.6528716216216217,41.6940789473684,1033.223684210524,27.92496443812227,0
4381,4,0,0,39,0.0,0.0,1.0,39,1050,700,350,0.6666666666666666,14,7,7,337.39476234737344,0.40159694107062527,0.16104832841059857,0.19621307053017156,131054.49631090662,1043.4201274746147,132097.91643838122,4350,33,777.4871794871794,38,1,20,35.38036484418474,0.6271929824561404,44.01709401709402,1023.9316239316244,26.94556905083222,5
4382,4,0,0,39,0.0,0.0,1.0,39,1050,800,250,0.7619047619047619,13,8,5,345.3561016243229,0.40159694107062527,0.14526425954997402,0.19677266255339346,130262.58680555565,1204.5326082986421,131467.1194138543,4351,34,778.4871794871794,36,3,20,35.97789115646258,0.622974537037037,44.79166666666667,1020.8333333333342,28.356481481481506,3
4383,4,1,1,39,0.025,0.025,0.975,40,800,400,400,0.5,12,4,8,335.17168838415466,0.40625,0.13582734198948399,0.1922132285570421,130514.55886667038,748.9570108110017,131263.51587748138,4352,0,760.0,37,3,15,35.982826304682185,0.6235923423423424,44.54495614035087,1021.8201754385955,27.616761498340416,0
4384,4,1,0,40,0.025,0.0,1.0,40,700,400,300,0.5714285714285714,10,4,6,334.5508947113099,0.4056623931623931,0.13859296212852712,0.19213486688873183,130570.58572108715,736.5012551938923,131307.08697628105,4353,0,760.975,37,3,16,35.94202607016414,0.6241554054054055,44.49013157894736,1022.0394736842097,27.622688477951613,0
4385,4,0,0,40,0.0,0.0,1.0,40,800,700,100,0.875,9,7,2,334.3838414623484,0.40526175213675214,0.1382561132561131,0.19245647764166274,130654.64854570635,737.7606571252625,131392.40920283162,4354,1,761.975,37,3,16,35.861307736307715,0.625,44.4078947368421,1022.3684210526314,27.631578947368418,0
4386,4,1,0,41,0.024390243902439025,0.0,1.0,41,1500,1200,300,0.8,18,12,6,328.1996272540479,0.40764735772357724,0.14766975838772511,0.19100142241833937,131081.84633875743,404.202621630516,131486.04896038794,4355,0,744.3658536585366,38,3,18,35.58815858111633,0.6274671052631577,43.99038461538462,1024.038461538462,26.948380566801628,0
4387,4,1,0,42,0.023809523809523808,0.0,1.0,42,900,600,300,0.6666666666666666,12,6,6,319.25441205631546,0.4098915989159892,0.1480836236933798,0.1869918699186993,131328.12500000015,-14.583333333319388,131313.54166666683,4356,0,727.6190476190476,39,3,19,35.56910569105691,0.6282051282051282,43.75000000000001,1025.0000000000011,26.28205128205131,0
4388,4,1,1,42,0.023255813953488372,0.023255813953488372,0.9767441860465116,43,1000,700,300,0.7,13,7,6,314.35385518512686,0.4106912144702843,0.1557202314485837,0.18554223052298904,131621.90890842027,-324.8291015624901,131297.07980685777,4357,0,711.6744186046511,39,4,15,35.399219199404456,0.6311431623931624,43.46354166666667,1026.1458333333344,26.31143162393165,0
4389,4,0,0,42,0.0,0.0,1.0,42,1200,800,400,0.6666666666666666,16,8,8,318.9525927151624,0.4091173054587689,0.15479909939397585,0.1878885150460729,131547.23340821094,-8.533767988901332,131538.69964022204,4358,2,729.6190476190476,38,4,20,35.35634937165867,0.6321271929824561,43.53632478632478,1025.8547008547005,26.99617633828159,0
4390,4,0,0,42,0.0,0.0,1.0,42,850,600,250,0.7058823529411765,11,6,5,318.69647537925005,0.40871806039488967,0.16052899035720447,0.1881425719740441,131629.4461451713,-10.031891482215684,131619.4142536891,4359,3,730.6190476190476,38,4,15,35.28023598820058,0.6329495614035088,43.45619658119658,1026.1752136752136,27.004610886189834,0
4391,4,0,1,41,0.0,0.023809523809523808,0.9761904761904762,42,1050,800,250,0.7619047619047619,13,8,5,320.43084409157734,0.40807684862562915,0.16332263242375622,0.19012230082766918,131821.37573964504,47.926939513486786,131869.3026791585,4360,4,731.6190476190476,38,4,16,35.04278506034125,0.6348684210526315,43.269230769230774,1026.9230769230774,27.02429149797572,0
4392,4,0,1,40,0.0,0.024390243902439025,0.975609756097561,41,1250,1000,250,0.8,15,10,5,326.5855113870043,0.4049034552845528,0.16812935191191047,0.19341050873602297,131749.92696069946,405.5234543321028,132155.45041503158,4361,6,750.3658536585366,37,4,16,34.95663337961479,0.6359797297297298,43.338815789473685,1026.6447368421054,27.747155049786635,0
4393,4,0,0,40,0.0,0.0,1.0,40,1150,800,350,0.6956521739130435,15,8,7,337.8426442417633,0.4046741452991453,0.17742036050334464,0.19263800677806017,130292.12648158851,814.831637640033,131106.95811922854,4362,7,767.55,35,5,19,36.13972811094736,0.625297619047619,44.762731481481474,1020.9490740740729,29.169973544973512,3
4394,4,0,0,40,0.0,0.0,1.0,40,1000,700,300,0.7,13,7,6,335.8273282032345,0.404821047008547,0.17173062079611845,0.19191039946283128,130377.57087746526,756.8702570813955,131134.44113454665,4363,8,768.55,36,4,20,36.1046789429191,0.6241319444444444,44.67905405405405,1021.2837837837835,28.368993993993985,0
4395,4,0,1,39,0.0,0.025,0.975,40,1000,400,600,0.4,16,4,12,336.47832576477884,0.4049946581196581,0.17519287997354827,0.19285330699076678,130492.60567577711,781.5866964937902,131274.19237227092,4364,9,769.55,36,4,15,35.97165582864911,0.6252893518518519,44.56644144144144,1021.7342342342341,28.381506506506504,0
4396,4,0,0,39,0.0,0.0,1.0,39,1150,600,550,0.5217391304347826,17,6,11,340.8553875236298,0.404661493477283,0.16799052396878533,0.19599184782608692,130617.2839506171,1104.3209876543033,131721.6049382714,4365,10,757.025641025641,35,4,16,35.73369565217392,0.6285714285714286,44.444444444444436,1022.2222222222207,29.206349206349163,0
4397,4,0,0,39,0.0,0.0,1.0,39,850,600,250,0.7058823529411765,11,6,5,342.9241815860096,0.40395861448493026,0.17637891254190063,0.1976343864522109,130706.03358892743,1164.4519193672782,131870.48550829472,4366,11,758.025641025641,35,4,16,35.59104414261458,0.6294642857142857,44.357638888888886,1022.5694444444441,29.21626984126983,0
4398,4,0,1,38,0.0,0.02564102564102564,0.9743589743589743,39,1250,800,450,0.64,17,8,9,345.3587797917074,0.4039867296446244,0.18215769680204885,0.2002627993244634,130942.84664619763,1244.4523480366886,132187.29899423433,4367,12,759.025641025641,35,4,17,35.28932960156809,0.6318452380952382,44.126157407407405,1023.4953703703698,29.24272486772485,0
4399,4,0,0,38,0.0,0.0,1.0,38,1200,1100,100,0.9166666666666666,13,11,2,343.46879718379626,0.403864390706496,0.17868285031284925,0.19981841156700295,131068.5405633673,1403.590795187066,132472.13135855438,4368,13,771.6578947368421,36,2,17,35.210693207229,0.6310763888888891,44.00337837837837,1023.9864864864857,28.444069069069045,0
4400,4,0,0,38,0.0,0.0,1.0,38,950,600,350,0.631578947368421,13,6,7,344.08430889380634,0.4041459222380275,0.1777748197191904,0.2003266776619892,131097.37059694814,1421.709631929209,132519.08022887734,4369,14,772.6578947368421,36,2,17,35.165814456418154,0.6313657407407408,43.975225225225216,1024.0990990990979,28.447197197197163,0
4401,4,1,1,38,0.02564102564102564,0.02564102564102564,0.9743589743589743,39,950,800,150,0.8421052631578947,11,8,3,338.0924053142969,0.4071075123706703,0.17406712528663726,0.1980255516840881,131328.1249999999,1080.41123894163,132408.53623894154,4370,0,753.8205128205128,36,3,17,35.08638211382113,0.6336805555555556,43.74999999999999,1024.9999999999993,28.472222222222204,0
4402,4,0,0,38,0.0,0.0,1.0,38,1200,1000,200,0.8333333333333334,14,10,4,345.21235947247885,0.4040273826458037,0.17933326776323,0.20143661540225377,131183.87972009156,1457.2593285853236,132641.13904867688,4371,16,774.6578947368421,36,2,17,35.04955846249678,0.6322337962962964,43.89076576576576,1024.4369369369358,28.45658158158155,0
4403,4,1,1,38,0.02564102564102564,0.02564102564102564,0.9743589743589743,39,1300,1000,300,0.7692307692307693,16,10,6,338.65512449634616,0.4057017543859649,0.18140413397851152,0.19940591655056353,131530.20154867708,1108.754616102597,132638.9561647797,4372,0,755.7692307692307,36,3,18,34.86821641599884,0.6357060185185185,43.55292792792793,1025.7882882882886,28.49411911911913,0
4404,4,0,0,38,0.0,0.0,1.0,38,1150,800,350,0.6956521739130435,15,8,7,346.0777144217527,0.4010638928402086,0.18993173757285153,0.20317445142891402,131417.1157648536,1496.1070119599021,132913.2227768135,4373,1,776.1578947368421,35,3,18,34.79194886556046,0.6366071428571427,43.66319444444446,1025.347222222224,29.29563492063497,0
4405,4,1,1,38,0.02564102564102564,0.02564102564102564,0.9743589743589743,39,1000,800,200,0.8,12,8,4,337.83240862748056,0.4038461538461538,0.17869090929553977,0.1995247401051349,131645.7436110097,1094.8397299326384,132740.58334094234,4374,0,757.2307692307693,36,3,15,34.772897691941914,0.6368634259259258,43.44031531531532,1026.2387387387391,28.50663163163164,0
4406,4,1,1,38,0.02564102564102564,0.02564102564102564,0.9743589743589743,39,900,500,400,0.5555555555555556,13,5,8,338.01915012311446,0.4026934322986955,0.18351889338731375,0.20069887038559947,131848.06428049688,1113.4341266942736,132961.49840719116,4375,0,758.2051282051282,36,3,16,34.56437317251461,0.6388888888888888,43.24324324324325,1027.0270270270282,28.52852852852856,0
4407,4,0,0,38,0.0,0.0,1.0,38,1500,1200,300,0.8,18,12,6,345.26128231763596,0.40146396396396394,0.18968144044321278,0.20499888637609667,131848.06428049697,1504.4063489165105,133352.47062941347,4376,1,779.078947368421,36,2,16,34.37842653508772,0.6388888888888888,43.243243243243256,1027.027027027029,28.528528528528582,0
4408,4,0,0,38,0.0,0.0,1.0,38,800,400,400,0.5,12,4,8,343.34883402993273,0.40155286865813183,0.1925651115290965,0.20417392855417552,131905.89871966586,1457.9473054135526,133363.8460250794,4377,2,780.078947368421,36,2,16,34.36929036030112,0.6394675925925924,43.18693693693695,1027.2522522522543,28.53478478478484,0
4409,4,0,0,38,0.0,0.0,1.0,38,900,700,200,0.7777777777777778,11,7,4,343.3749070961703,0.4010490753911806,0.1986490228200921,0.20450082587111393,131963.74584043538,1462.6077936044517,133426.35363403984,4378,3,781.078947368421,36,2,16,34.31038104632471,0.6400462962962961,43.13063063063065,1027.4774774774803,28.54104104104112,0
4410,4,1,0,39,0.02564102564102564,0.0,1.0,39,1300,1000,300,0.7692307692307693,16,10,6,337.0111063079026,0.40204678362573104,0.18981955910443582,0.20257368420801097,132313.3815813521,1118.2158212142326,133431.59740256632,4379,0,762.025641025641,37,2,17,34.122326725638565,0.6416103603603602,42.7905701754386,1028.8377192982466,27.806424845898558,0
4411,4,0,0,39,0.0,0.0,1.0,39,750,600,150,0.8,9,6,3,336.3055070428779,0.40184997750787227,0.19007803790412514,0.20230069731348518,132341.58587257628,1101.4408279470758,133443.02670052336,4380,1,763.025641025641,37,2,17,34.112141233304925,0.6418918918918918,42.76315789473685,1028.9473684210536,27.809388335704153,0
4412,4,0,0,39,0.0,0.0,1.0,39,500,300,200,0.6,7,3,4,336.1929780599697,0.4018780926675663,0.1899209017888286,0.20224076025581306,132343.03232750745,1098.5596327343112,133441.59196024176,4381,2,764.025641025641,38,1,17,34.11358287474476,0.6400767543859649,42.761752136752136,1028.9529914529912,27.077710301394507,0
4413,4,0,0,39,0.0,0.0,1.0,39,700,400,300,0.5714285714285714,10,4,6,335.65352837536517,0.40235605038236616,0.19693391806289573,0.20237063239607625,132427.78427479859,1090.0048521762792,133517.78912697485,4382,3,765.025641025641,35,4,17,34.04234135462349,0.6467261904761905,42.67939814814815,1029.2824074074078,29.408068783068796,0
4414,4,0,0,39,0.0,0.0,1.0,39,1100,700,400,0.6363636363636364,15,7,8,336.2314680456982,0.4014563652721548,0.1959367373458849,0.2036843998732925,132606.5394188314,1117.2982842506879,133723.8377030821,4383,4,766.025641025641,35,4,17,33.84802131325618,0.6485119047619048,42.50578703703704,1029.9768518518517,29.42791005291005,0
4415,4,0,0,39,0.0,0.0,1.0,39,1150,900,250,0.782608695652174,14,9,5,335.96768084837754,0.40123144399460187,0.19625468164794024,0.2036861280347794,132636.34366426617,1112.3049554183867,133748.64861968457,4384,5,767.025641025641,35,4,16,33.824906367041194,0.6488095238095237,42.476851851851855,1030.092592592593,29.431216931216944,0
4416,4,0,0,39,0.0,0.0,1.0,39,600,400,200,0.6666666666666666,8,4,4,334.8202933718881,0.4008378317588844,0.19068353030617247,0.20363660465732836,132755.59413580224,1089.8533950617045,133845.44753086395,4385,6,768.025641025641,35,4,16,33.734838274932635,0.6500000000000001,42.3611111111111,1030.5555555555536,29.44444444444439,0
4417,4,1,1,39,0.025,0.025,0.975,40,650,300,350,0.46153846153846156,10,3,7,329.80754562269976,0.40201655982905987,0.18884825327510946,0.2019409838171077,133007.16256797337,773.3531673565468,133780.51573532991,4386,0,749.8,36,4,16,33.61194505094615,0.650462962962963,42.11711711711712,1031.5315315315315,28.653653653653652,0
4418,4,0,0,39,0.0,0.0,1.0,39,1250,900,350,0.72,16,9,7,338.07754819464475,0.40019118308591994,0.1949684991552767,0.20643816839383752,132904.73257726766,1186.4212266375114,134091.15380390518,4387,8,770.025641025641,35,4,16,33.50135162943839,0.6514880952380953,42.21643518518518,1031.1342592592591,29.460978835978832,0
4419,4,0,1,38,0.0,0.02564102564102564,0.9743589743589743,39,1050,500,550,0.47619047619047616,16,5,11,342.07307591414406,0.4000224921277553,0.20421923450866752,0.2097138513547919,133053.95474322676,1302.8351123113564,134356.7898555381,4388,9,771.025641025641,35,4,16,33.24872859172837,0.6529761904761906,42.071759259259245,1031.7129629629608,29.477513227513164,0
4420,4,0,0,38,0.0,0.0,1.0,38,1200,900,300,0.75,15,9,6,349.3583180741151,0.3969298245614035,0.21274586604968637,0.21428793650023725,133072.72002551,1698.012329931949,134770.73235544196,4389,14,792.078947368421,34,4,17,33.041998384677505,0.6553308823529413,42.053571428571416,1031.7857142857129,30.346638655462144,0
4421,4,0,0,38,0.0,0.0,1.0,38,1450,1000,450,0.6896551724137931,19,10,9,352.0035467054033,0.39608522996680895,0.2151438661213796,0.2171606517868183,133287.76218820846,1783.5530045351327,135071.31519274358,4390,15,793.078947368421,34,4,17,32.758098916301584,0.6574754901960785,41.84523809523809,1032.6190476190463,30.371148459383715,0
4422,4,1,0,39,0.02564102564102564,0.0,1.0,39,1050,800,250,0.7619047619047619,13,8,5,343.6172093763994,0.398897885739991,0.2111350389065958,0.21338676493263148,133532.02830289755,1376.7805855623883,134908.80888845993,4391,0,773.7179487179487,35,4,18,32.73002986188876,0.6577380952380953,41.60879629629628,1033.564814814813,29.53042328042323,0
4423,4,0,0,39,0.0,0.0,1.0,39,1600,1200,400,0.75,20,12,8,345.6396050691292,0.39777327935222667,0.20423858924138738,0.21551220316068864,133681.60211173262,1441.1312317815427,135122.73334351415,4392,1,774.7179487179487,35,4,19,32.52809643723186,0.6592261904761905,41.46412037037037,1034.143518518518,29.546957671957657,0
4424,4,0,0,39,0.0,0.0,1.0,39,1000,500,500,0.5,15,5,10,347.08741317783756,0.39709851551956815,0.21025124705625897,0.2171178716862623,133801.3214404363,1488.1509077074681,135289.47234814375,4393,2,775.7179487179487,35,4,16,32.37090744676885,0.6604166666666667,41.348379629629626,1034.6064814814808,29.560185185185166,0
4425,4,0,2,37,0.0,0.05128205128205128,0.9487179487179487,39,650,500,150,0.7692307692307693,8,5,3,350.05746709913785,0.39718286099865047,0.1496532071297887,0.21123146671362486,132459.27047902485,1498.5944509619585,133957.86492998683,4394,3,776.7179487179487,34,5,19,33.64003893450522,0.649203431372549,42.64880952380952,1029.4047619047612,30.276610644257683,5
4426,4,1,1,37,0.02631578947368421,0.02631578947368421,0.9736842105263158,38,850,600,250,0.7058823529411765,11,6,5,350.78296227023066,0.39681128496917967,0.1529017653394671,0.2120141048689882,132520.55165816314,1697.190334467108,134217.74199263024,4395,0,782.421052631579,34,4,19,33.55975642656183,0.6498161764705883,42.58928571428571,1029.6428571428562,30.283613445378123,0
4427,4,0,0,37,0.0,0.0,1.0,37,1250,900,350,0.72,16,9,7,361.71201814058975,0.3937374874874875,0.1630501930501933,0.21827449370552818,132461.07266435976,2182.552383698566,134643.6250480583,4396,21,804.5675675675676,33,4,21,33.33829365079365,0.6515151515151516,42.647058823529406,1029.4117647058815,31.19429590017823,0
4428,4,0,0,37,0.0,0.0,1.0,37,950,600,350,0.631578947368421,13,6,7,358.670835035243,0.3938938938938939,0.15603953468031162,0.2173123294625292,132612.49999999974,2112.8472222221935,134725.34722222193,4397,22,805.5675675675676,34,3,21,33.26422599784251,0.6507352941176472,42.499999999999986,1029.999999999998,30.294117647058762,0
4429,4,0,0,37,0.0,0.0,1.0,37,1050,700,350,0.6666666666666666,14,7,7,358.7928778503972,0.39311186186186187,0.1582289149856717,0.21845490410891227,132796.49234693852,2129.2871315192424,134925.77947845776,4398,23,806.5675675675676,34,3,16,33.07610495110493,0.6525735294117648,42.321428571428555,1030.7142857142837,30.31512605042011,0
4430,4,0,0,37,0.0,0.0,1.0,37,1250,1000,250,0.8,15,10,5,361.2963132756506,0.3928303303303304,0.16041506125772553,0.22088284840557235,132949.91673752829,2206.862953514733,135156.77969104302,4399,24,807.5675675675676,34,3,16,32.85741082765786,0.6541053921568627,42.172619047619044,1031.3095238095234,30.332633053221276,0
4431,4,0,0,37,0.0,0.0,1.0,37,1050,800,250,0.7619047619047619,13,8,5,363.55416407841,0.39286161161161165,0.16303520872048805,0.22317900100790783,133103.4297052154,2278.0612244897998,135381.4909297052,4400,25,808.5675675675676,34,3,17,32.64497769573912,0.6556372549019608,42.023809523809526,1031.904761904762,30.35014005602241,0
4432,4,0,0,37,0.0,0.0,1.0,37,1000,500,500,0.5,15,5,10,364.51910298008886,0.3935497997997998,0.15801614763552507,0.22414046970477805,133164.85969387757,2308.227040816329,135473.0867346939,4401,26,809.5675675675676,34,3,18,32.558391003460216,0.65625,41.964285714285715,1032.1428571428573,30.35714285714286,0
4433,4,0,0,37,0.0,0.0,1.0,37,1100,1000,100,0.9090909090909091,12,10,2,367.0855168633572,0.3927052052052052,0.1615079056001245,0.22665244546545382,133318.49666950124,2387.8578514739365,135706.35452097518,4402,27,810.5675675675676,34,3,18,32.3378962536023,0.657781862745098,41.8154761904762,1032.738095238096,30.374649859944004,0
4434,4,0,0,37,0.0,0.0,1.0,37,750,500,250,0.6666666666666666,10,5,5,366.5278226810111,0.392235985985986,0.16456082638655256,0.22649539811826597,133349.23469387766,2375.240929705228,135724.4756235829,4403,28,811.5675675675676,34,3,18,32.321442292915336,0.6580882352941175,41.78571428571429,1032.8571428571436,30.37815126050422,0
4435,4,0,0,37,0.0,0.0,1.0,37,600,300,300,0.5,9,3,6,370.00298479757896,0.39211086086086083,0.1676117873836509,0.22921169914762224,133441.47002551027,2474.7484410430943,135916.21846655337,4404,29,812.5675675675676,34,3,18,32.13911933018398,0.6590073529411764,41.69642857142858,1033.2142857142862,30.38865546218489,0
4436,4,0,0,37,0.0,0.0,1.0,37,700,500,200,0.7142857142857143,9,5,4,368.6957873291867,0.3920482982982983,0.16326452133898206,0.22898234685820043,133535.54672481742,2446.802250311897,135982.3489751293,4405,30,813.5675675675676,33,4,19,32.07849181882856,0.6622474747474747,41.60539215686275,1033.5784313725494,31.32055852644089,0
4437,4,0,0,37,0.0,0.0,1.0,37,300,200,100,0.6666666666666666,4,2,2,364.59611092119303,0.39220470470470475,0.12783904981214445,0.22459926170007172,133233.13185871037,2315.2563443072495,135548.38820301762,4406,31,814.5675675675676,35,2,17,32.487855007473826,0.6547619047619049,41.89814814814814,1032.407407407406,29.497354497354458,4
4438,4,0,1,36,0.0,0.02702702702702703,0.972972972972973,37,700,400,300,0.5714285714285714,10,4,6,361.983567391178,0.39229854854854856,0.12470158271685028,0.22337747732012786,133297.72973987495,2250.317547277003,135548.04728715195,4407,32,815.5675675675676,36,1,17,32.49045801526719,0.6533564814814815,41.835585585585584,1032.6576576576572,28.684934934934923,0
4439,4,0,0,36,0.0,0.0,1.0,36,1200,700,500,0.5833333333333334,17,7,10,361.6736892463436,0.3907738095238095,0.11470236761520636,0.22387651527134952,133412.42953746562,2450.3531164266005,135862.7826538922,4408,33,810.9722222222222,35,1,17,32.38339308387482,0.656547619047619,41.72453703703703,1033.101851851851,29.517195767195744,0
4440,4,0,0,36,0.0,0.0,1.0,36,1000,900,100,0.9,11,9,2,362.33619101731705,0.3900462962962963,0.11315237144539125,0.22502166025839404,133533.73724489805,2476.8345410437937,136010.57178594184,4409,34,811.9722222222222,34,2,17,32.2446344928204,0.6599264705882353,41.60714285714286,1033.5714285714294,30.399159663865568,0
4441,4,0,0,36,0.0,0.0,1.0,36,700,500,200,0.7142857142857143,9,5,4,361.388615552524,0.3899966931216931,0.10946997325553132,0.2246197100102052,133564.50007086172,2453.7379535147484,136018.23802437645,4410,35,812.9722222222222,34,2,17,32.238281699873305,0.6602328431372548,41.577380952380956,1033.6904761904766,30.402661064425782,0
4442,4,0,0,36,0.0,0.0,1.0,36,1000,800,200,0.8,12,8,4,365.5313237839346,0.38907076719576716,0.10900140646976086,0.2285228204088054,133779.93905895707,2580.1516439909483,136360.09070294801,4411,36,813.9722222222222,34,2,16,31.915276179516674,0.6623774509803921,41.36904761904763,1034.5238095238108,30.427170868347375,0
4443,4,0,0,36,0.0,0.0,1.0,36,800,500,300,0.625,11,5,6,365.511168369255,0.3884589947089947,0.11588716375950447,0.2294671197812761,133933.93034297053,2590.8694727891166,136524.79981575964,4412,37,814.9722222222222,34,2,16,31.761548782825372,0.6639093137254901,41.220238095238095,1035.1190476190477,30.44467787114846,0
4444,4,0,0,36,0.0,0.0,1.0,36,800,600,200,0.75,10,6,4,366.3596814915878,0.38812830687830685,0.11660663422360162,0.23077211218648241,134057.18714569157,2622.6296768707457,136679.8168225623,4413,38,815.9722222222222,34,2,17,31.616181936621068,0.6651348039215685,41.101190476190474,1035.5952380952378,30.45868347338935,0
4445,4,0,0,36,0.0,0.0,1.0,36,550,300,250,0.5454545454545454,8,3,5,364.13731862225734,0.3876984126984127,0.11283185840707999,0.22975770916115024,134118.83680555562,2567.534722222233,136686.37152777784,4414,39,816.9722222222222,34,2,17,31.612027353177794,0.6657475490196079,41.04166666666667,1035.833333333334,30.46568627450982,0
4446,4,0,0,36,0.0,0.0,1.0,36,750,400,350,0.5333333333333333,11,4,7,346.0569868654031,0.3876984126984127,0.12493922734582474,0.21198666143857967,133024.10361207544,2031.784095293193,135055.88770736865,4415,40,817.9722222222222,35,1,21,33.17590878492089,0.6526785714285714,42.100694444444436,1031.597222222221,29.474206349206316,4
4447,4,0,0,36,0.0,0.0,1.0,36,850,600,250,0.7058823529411765,11,6,5,344.09352174337454,0.3865079365079365,0.12003601111484996,0.21145981622230645,133143.52823055966,1962.765105238324,135106.293335798,4416,41,818.9722222222222,35,1,21,33.10682310941648,0.6538690476190477,41.984953703703695,1032.0601851851839,29.487433862433825,0
4448,4,0,0,36,0.0,0.0,1.0,36,1250,900,350,0.72,16,9,7,358.56094252367905,0.3865079365079365,0.1598755337512492,0.20208296438085704,129837.5868055557,2158.7676290295108,131996.3544345852,4417,42,819.9722222222222,34,2,24,36.072499318615435,0.6228553921568627,45.20833333333334,1019.1666666666678,29.975490196078464,8
4449,4,2,0,38,0.05263157894736842,0.0,1.0,38,1150,900,250,0.782608695652174,14,9,5,342.38013522745007,0.39534435751541014,0.15565366757025112,0.19574561083995046,130395.5417209202,1332.4408637152815,131727.9825846355,4418,0,777.7631578947369,31,7,27,35.919173890872,0.635752688172043,44.661458333333336,1021.3541666666672,32.94690860215056,0
4450,4,1,1,38,0.02564102564102564,0.02564102564102564,0.9743589743589743,39,1150,800,350,0.6956521739130435,15,8,7,332.73890275100604,0.3997694556905083,0.1522059894497534,0.19164435522600623,130681.82615294353,896.5854887256319,131578.41164166917,4419,0,758.7948717948718,32,7,21,35.87588499217914,0.6360677083333334,44.38131313131313,1022.4747474747471,31.952335858585847,0
4451,4,0,0,38,0.0,0.0,1.0,38,750,400,350,0.5333333333333333,11,4,7,339.0360779137072,0.39558143669985774,0.15388233991919864,0.19078302372540568,129776.92920918373,1199.8122165532955,130976.74142573703,4420,1,779.7368421052631,34,4,22,36.63151847957316,0.6222426470588235,45.267857142857146,1018.9285714285718,29.968487394957993,1
4452,4,1,1,38,0.02564102564102564,0.02564102564102564,0.9743589743589743,39,1250,800,450,0.64,17,8,9,329.5423321773988,0.39870107962213225,0.1442735797521093,0.18693324904164427,130090.20580969502,774.045963192949,130864.25177288798,4421,0,760.7179487179487,36,3,22,36.555957243257176,0.6212384259259258,44.9605855855856,1020.1576576576592,28.337712712712758,0
4453,4,2,1,39,0.05,0.025,0.975,40,950,700,250,0.7368421052631579,12,7,5,326.88920848599446,0.4024839743589744,0.14591654971391632,0.1801293716957621,128950.68825263517,430.8600865396356,129381.5483391748,4422,0,742.65,37,3,21,37.77967451149735,0.6078265765765767,46.08004385964911,1015.6798245614013,27.450806069227063,8
4454,4,1,1,39,0.025,0.025,0.975,40,650,400,250,0.6153846153846154,9,4,5,324.2630181466405,0.4042735042735042,0.1612121048656816,0.17943844269857942,129117.79495854468,373.6251779393348,129491.42013648401,4423,0,743.525,37,3,21,37.67655176754055,0.6095157657657658,45.91557017543858,1016.3377192982434,27.468587008060634,0
4455,4,3,1,41,0.07142857142857142,0.023809523809523808,0.9761904761904762,42,800,400,400,0.5,12,4,8,333.79552963656386,0.40658875338753386,0.16449061278947896,0.18063519816794588,128230.06071950353,203.12144809801023,128433.18216760154,4424,0,709.047619047619,36,6,21,38.338521977614704,0.6024305555555554,46.790540540540555,1012.8378378378397,28.134384384384436,5
4456,4,1,0,42,0.023809523809523808,0.0,1.0,42,900,800,100,0.8888888888888888,10,8,2,331.68639605196563,0.4065161633759195,0.16858264924286903,0.17987839091498145,128315.61872260812,112.10902625602859,128427.72774886416,4425,0,709.9761904761905,36,6,22,38.30466637027156,0.6032986111111109,46.7060810810811,1013.1756756756787,28.14376876876885,0
4457,4,2,5,39,0.045454545454545456,0.11363636363636363,0.8863636363636364,44,800,400,400,0.5,12,4,8,316.589306152106,0.4117886715997181,0.16070351903071156,0.1735303992578685,128740.17373666842,-648.4475445612902,128091.72619210713,4426,0,678.6590909090909,38,6,15,38.25512334631718,0.603892543859649,46.28739316239318,1014.8504273504298,26.706590193432362,0
4458,4,3,0,42,0.07142857142857142,0.0,1.0,42,1600,1300,300,0.8125,19,13,6,328.0855429292927,0.41457365466511803,0.17500901875901875,0.18044704861111108,128875.73964497057,56.453402366878095,128932.19304733745,4427,0,692.7380952380952,38,4,19,37.82552083333333,0.6052631578947367,46.15384615384616,1015.3846153846166,26.720647773279385,0
4459,4,1,1,42,0.023255813953488372,0.023255813953488372,0.9767441860465116,43,1500,1200,300,0.8,18,12,6,318.4627788228968,0.4180740125507567,0.16793747617232135,0.1766020864381521,129201.3888888891,-370.8333333333138,128830.55555555578,4428,0,677.6046511627907,39,4,19,37.73907103825136,0.6068376068376067,45.83333333333334,1016.6666666666683,26.06837606837611,0
4460,4,0,0,42,0.0,0.0,1.0,42,900,600,300,0.6666666666666666,12,6,6,322.0758209574489,0.4142469996128533,0.16997041642263944,0.17823777107435787,129119.93805473378,-82.71798980933295,129037.22006492445,4429,2,694.7380952380952,38,4,19,37.7299484915379,0.6077302631578947,45.91346153846154,1016.3461538461543,26.74595141700406,0
4461,4,3,1,44,0.06666666666666667,0.022222222222222223,0.9777777777777777,45,850,600,250,0.7058823529411765,11,6,5,307.68778304651295,0.4231060606060606,0.18102189781021893,0.173612958308782,129883.08930342969,-1007.3120393990964,128875.77726403059,4430,0,649.3555555555556,41,4,14,37.32268856447687,0.6105182926829269,45.163690476190474,1019.345238095238,24.862078977932633,0
4462,4,1,0,45,0.022222222222222223,0.0,1.0,45,1400,900,500,0.6428571428571429,19,9,10,368.6528698219059,0.4235900673400674,0.2979628628087261,0.2006001048560043,128450.01737313384,528.7115055220856,128978.72887865594,4431,0,650.3333333333334,37,8,12,37.23082296736974,0.6027590090090091,46.57346491228069,1013.7061403508756,27.397463252726368,5
4463,4,1,1,45,0.021739130434782608,0.021739130434782608,0.9782608695652174,46,1300,1100,200,0.8461538461538461,15,11,4,360.90637119113626,0.42736513687600647,0.29605491990846744,0.19795672784733184,128767.28121119118,94.58643801589864,128861.86764920708,4432,0,637.1739130434783,38,8,13,37.10307017543862,0.6041666666666667,46.26068376068375,1014.9572649572626,26.709401709401646,0
4464,4,2,1,46,0.0425531914893617,0.02127659574468085,0.9787234042553191,47,1500,800,700,0.5333333333333333,22,8,14,356.05807945039726,0.4286540240518039,0.30871131762606696,0.19814941830001997,129340.77222077936,-187.97358258555676,129152.7986381938,4433,0,624.5744680851063,37,10,17,36.64158222845029,0.6117680180180181,45.696271929824555,1017.2149122807008,27.492294926505426,0
4465,4,1,1,46,0.02127659574468085,0.02127659574468085,0.9787234042553191,47,1000,600,400,0.6,14,6,8,354.2624402548869,0.4283842121492445,0.3120078311443881,0.1977095434759832,129452.33298947736,-227.9801236919246,129224.35286578543,4434,0,625.4255319148937,37,10,12,36.57371242323025,0.6128941441441442,45.586622807017534,1017.6535087719285,27.504148885727798,0
4466,4,2,1,47,0.041666666666666664,0.020833333333333332,0.9791666666666666,48,1350,900,450,0.6666666666666666,18,9,9,344.7474188181773,0.4304724438534279,0.30630984832599406,0.19410867064272577,129799.47973738036,-650.3928793191639,129149.0868580612,4435,0,613.3541666666666,38,10,13,36.46313867337666,0.6145833333333334,45.245726495726494,1019.0170940170939,26.81623931623931,0
4467,4,0,0,47,0.0,0.0,1.0,47,950,700,250,0.7368421052631579,12,7,5,352.1300154126432,0.42713151403021893,0.3128717223191355,0.19834523413606686,129815.23762119106,-257.63167513081623,129557.60594606024,4436,1,627.4042553191489,37,10,14,36.25905602180619,0.6165540540540541,45.23026315789473,1019.0789473684205,27.542674253200552,0
4468,4,0,0,47,0.0,0.0,1.0,47,1200,900,300,0.75,15,9,6,350.49800667346324,0.42693879124267653,0.3106596993098032,0.19817256964997237,129962.83512309154,-289.65706954488905,129673.17805354665,4437,2,628.4042553191489,38,9,14,36.150766624755505,0.6162280701754386,45.085470085470085,1019.6581196581197,26.833108412055783,0
4469,4,2,5,44,0.04081632653061224,0.10204081632653061,0.8979591836734694,49,1000,600,400,0.6,14,6,8,336.18762257580414,0.4317956349206349,0.30254597506246905,0.19273316130017884,130501.95448133672,-1025.0263544891236,129476.9281268476,4438,0,603.7142857142857,39,10,10,35.969623984775886,0.6199252136752137,44.557291666666664,1021.7708333333327,26.19925213675212,0
4470,4,2,2,44,0.043478260869565216,0.043478260869565216,0.9565217391304348,46,1600,1100,500,0.6875,21,11,10,353.73991542634417,0.42891505636070854,0.2884188746748124,0.20140457937026518,130234.60493853869,13.835627308395203,130248.44056584708,4439,0,637.2173913043479,37,9,16,35.792311204210996,0.620777027027027,44.81907894736842,1020.7236842105256,27.587126600284474,0
4471,4,0,0,44,0.0,0.0,1.0,44,750,400,350,0.5333333333333333,11,4,7,373.82110611160044,0.4243415257223397,0.30543400860690006,0.21122451082341803,129937.87140185609,914.7037626457425,130852.57516450183,4440,5,667.1818181818181,35,9,16,35.58162579937187,0.6217261904761904,45.1099537037037,1019.5601851851848,29.130291005290992,0
4472,4,0,0,44,0.0,0.0,1.0,44,1150,700,450,0.6086956521739131,16,7,9,372.30252044726785,0.42445163847780126,0.30260469867211426,0.21068448989472557,129996.88042534729,879.6332465277835,130876.51367187507,4441,6,668.1818181818181,35,9,16,35.56030813755533,0.6223214285714285,45.052083333333336,1019.7916666666672,29.136904761904777,0
4473,4,1,0,45,0.022222222222222223,0.0,1.0,45,1050,800,250,0.7619047619047619,13,8,5,361.421685301118,0.42537878787878786,0.3012882995201933,0.20639634494574516,130351.21588059409,422.6224922839418,130773.83837287803,4442,0,654.3111111111111,35,10,17,35.47794117647057,0.6258928571428571,44.70486111111111,1021.1805555555552,29.17658730158729,0
4474,4,0,0,45,0.0,0.0,1.0,45,1350,1200,150,0.8888888888888888,15,12,3,363.2364706850903,0.42571548821548827,0.3049891758546044,0.20822412748103722,130498.9979852536,480.3990912208329,130979.39707647444,4443,1,655.3111111111111,35,10,12,35.281679504606565,0.6273809523809524,44.560185185185176,1021.7592592592579,29.193121693121654,0
4475,4,0,0,45,0.0,0.0,1.0,45,1200,700,500,0.5833333333333334,17,7,10,359.4943721498467,0.4259680134680135,0.29401361057650033,0.2068673478305922,130646.86381440732,393.3624560613564,131040.22627046867,4444,2,656.3111111111111,35,10,12,35.22739065625118,0.6288690476190477,44.415509259259245,1022.3379629629609,29.209656084656025,0
4476,4,1,0,46,0.021739130434782608,0.0,1.0,46,1450,1100,350,0.7586206896551724,18,11,7,351.5031142216364,0.4263586956521739,0.2963967571745887,0.20423052753499776,131019.23338190574,10.733711334234016,131029.96709323997,4445,0,643.0217391304348,37,9,14,35.05486683802793,0.6286599099099099,44.05153508771929,1023.7938596491209,27.670104314841105,0
4477,4,0,1,45,0.0,0.021739130434782608,0.9782608695652174,46,1450,1200,250,0.8275862068965517,17,12,5,351.5587962956227,0.42615740740740743,0.2948362292464728,0.20486030668729924,131131.5155264117,20.0875509771964,131151.6030773889,4446,1,644.0217391304348,37,9,14,34.939937729722004,0.6297860360360361,43.94188596491227,1024.2324561403489,27.681958274063483,0
4478,4,2,4,43,0.0425531914893617,0.0851063829787234,0.9148936170212766,47,1400,1000,400,0.7142857142857143,18,10,8,343.2730535073417,0.4277482269503546,0.289250104622661,0.20323541411904142,131739.10307774472,-355.3558831427193,131383.747194602,4447,0,587.5957446808511,38,9,12,34.53923405141012,0.634046052631579,43.349358974358964,1026.6025641025626,27.015856950067437,0
4479,4,1,1,43,0.022727272727272728,0.022727272727272728,0.9772727272727273,44,1200,800,400,0.6666666666666666,16,8,8,356.29127528716816,0.4245287174066244,0.2813863223449635,0.21007041353888012,131581.125021641,576.2413675361386,132157.36638917713,4448,0,574.2727272727273,37,7,13,34.364535463645765,0.6342905405405406,43.5032894736842,1025.986842105261,27.729374110953003,0
4480,4,1,1,43,0.022727272727272728,0.022727272727272728,0.9772727272727273,44,1050,800,250,0.7619047619047619,13,8,5,357.93690489630626,0.4226898343904158,0.2883457478319136,0.21166439461366537,131693.64762474992,627.603325061553,132321.25094981148,4449,0,575.25,37,7,13,34.20875173592563,0.6354166666666667,43.39364035087719,1026.4254385964912,27.74122807017544,0
4481,4,0,0,43,0.0,0.0,1.0,43,1000,600,400,0.6,14,6,8,362.98490882970754,0.4209348468069398,0.2937366994809929,0.21454244222269472,131674.63705259308,959.1812251440614,132633.81827773715,4450,3,589.6279069767442,36,7,13,34.09841086972425,0.6371527777777778,43.41216216216216,1026.351351351351,28.50975975975975,0
4482,4,1,0,44,0.022727272727272728,0.0,1.0,44,1500,1300,200,0.8666666666666667,17,13,4,357.10765979321997,0.4227779245947851,0.29728746823903673,0.2132182931784486,132059.67821829786,631.9045283163997,132691.58274661427,4451,0,577.2045454545455,37,7,15,33.86094516748454,0.6390765765765766,43.03728070175438,1027.850877192982,27.77975343764816,0
4483,4,0,2,42,0.0,0.045454545454545456,0.9545454545454546,44,1450,1000,450,0.6896551724137931,19,10,9,356.1632660643035,0.42259073291050037,0.3008049898709886,0.21344762124070932,132200.59447378034,616.9991006848164,132817.59357446517,4452,1,578.2045454545455,37,7,16,33.74326953833032,0.6404842342342343,42.90021929824561,1028.399122807017,27.794570886676134,0
4484,4,0,0,42,0.0,0.0,1.0,42,1300,900,400,0.6923076923076923,17,9,8,371.03725346968616,0.4216148857917151,0.3054054054054056,0.22142545771578023,132040.89506172828,1398.418209876531,133439.31327160483,4453,2,597.047619047619,35,7,16,33.52195945945946,0.6428571428571428,43.05555555555555,1027.777777777777,29.36507936507934,0
4485,4,0,0,42,0.0,0.0,1.0,42,1150,800,350,0.6956521739130435,15,8,7,372.9147220905992,0.4211914440572977,0.3087731433075427,0.22272062184846084,132070.63567654754,1450.2168799297042,133520.85255647724,4454,3,598.047619047619,35,7,16,33.44370472544383,0.6431547619047618,43.026620370370374,1027.893518518519,29.368386243386254,0
4486,4,1,0,43,0.023255813953488372,0.0,1.0,43,1050,1000,50,0.9523809523809523,11,10,1,367.4449644965664,0.4228497600590624,0.30674766408908005,0.22153817418765856,132427.78427479847,1132.389724794232,133560.1739995927,4455,0,585.1162790697674,35,8,19,33.224282206979275,0.6467261904761905,42.679398148148145,1029.282407407407,29.40806878306877,0
4487,4,0,0,43,0.0,0.0,1.0,43,1100,700,400,0.6363636363636364,15,7,8,363.4969722064077,0.4226421188630491,0.3048561151079139,0.21967860494213323,132517.14677640592,1033.9163237311286,133551.06310013705,4456,1,586.1162790697674,35,8,19,33.23591127098321,0.6476190476190476,42.59259259259259,1029.6296296296289,29.417989417989396,0
4488,4,0,0,43,0.0,0.0,1.0,43,1150,700,450,0.6086956521739131,16,7,9,363.4551193031184,0.42211148025101514,0.30126992422262866,0.22035085570829377,132636.34366426602,1041.4716220850407,133677.81528635108,4457,2,587.1162790697674,35,8,14,33.117041198501866,0.648809523809524,42.47685185185185,1030.092592592592,29.431216931216913,0
4489,4,0,0,43,0.0,0.0,1.0,43,1050,800,250,0.7619047619047619,13,8,5,363.78612646095155,0.42234219269102985,0.3051969832493089,0.2213677280166642,132774.93709926153,1060.3360116873764,133835.2731109489,4458,3,588.1162790697674,36,7,14,32.969114219114225,0.6481481481481481,42.34234234234235,1030.6306306306315,28.62862862862865,0
4490,4,1,1,43,0.022727272727272728,0.022727272727272728,0.9772727272727273,44,900,500,400,0.5555555555555556,13,5,8,356.06546046724907,0.4227669133192389,0.30717321997874625,0.2184208593870151,133075.95245652503,676.75005771006,133752.7025142351,4459,0,575.7272727272727,37,7,15,32.86574566064471,0.6492117117117117,42.050438596491226,1031.7982456140346,27.886439070649583,0
4491,4,0,0,43,0.0,0.0,1.0,43,1300,900,400,0.6923076923076923,17,9,8,363.6697010163124,0.4201965669988926,0.3183133190543379,0.22336924531591748,133123.35139193258,1082.585879798729,134205.9372717313,4460,1,590.0232558139535,36,7,17,32.621990033464286,0.6516203703703705,42.00450450450451,1031.9819819819827,28.666166166166185,0
4492,4,1,0,44,0.022727272727272728,0.0,1.0,44,900,500,400,0.5555555555555556,13,5,8,358.177055366744,0.4215887068357999,0.3235512630014854,0.22173089459037215,133415.57618690372,757.2796437365396,134172.85583064027,4461,0,577.5909090909091,37,7,18,32.47054765442581,0.6525900900900901,41.72149122807018,1033.11403508772,27.922000948316754,0
4493,4,1,1,44,0.022222222222222223,0.022222222222222223,0.9777777777777777,45,1150,800,350,0.6956521739130435,15,8,7,350.9967337315134,0.42319023569023567,0.3138591343491124,0.2184520265580487,133613.88991083784,379.61981090334496,133993.5097217412,4462,0,565.7333333333333,37,8,18,32.45737883126524,0.6545608108108107,41.52960526315789,1033.8815789473676,27.942745376955884,0
4494,4,0,0,44,0.0,0.0,1.0,44,1250,900,350,0.72,16,9,7,357.55194753326833,0.42162174066243835,0.32064102945109796,0.22185626927064261,133501.3153990139,746.7310638341075,134248.046462848,4463,2,579.5909090909091,36,8,18,32.40074824743016,0.6553819444444444,41.638513513513516,1033.4459459459463,28.706831831831842,0
4495,4,0,0,44,0.0,0.0,1.0,44,1400,1200,200,0.8571428571428571,16,12,4,357.2283257013157,0.42195207892882314,0.3218933534055006,0.2220039811518196,133559.51126379753,742.2481180504785,134301.759381848,4464,3,580.5909090909091,36,8,18,32.35079166212732,0.6559606481481481,41.582207207207205,1033.6711711711707,28.713088088088075,0
4496,4,0,0,44,0.0,0.0,1.0,44,800,500,300,0.625,11,5,6,355.73703203489697,0.4215776955602537,0.32461679359876605,0.22157200872450977,133642.23246575863,708.2982263773409,134350.53069213597,4465,4,581.5909090909091,37,7,18,32.306468716861076,0.6548423423423424,41.50219298245614,1033.9912280701749,27.945708866761482,0
4497,4,0,0,44,0.0,0.0,1.0,44,950,500,450,0.5263157894736842,14,5,9,357.7187651299494,0.4210381430584919,0.325111805073637,0.22314837253344452,133698.92659279768,765.3229839950574,134464.24957679273,4466,5,582.5909090909091,37,7,19,32.19845561210063,0.6554054054054055,41.44736842105262,1034.2105263157885,27.95163584637266,0
4498,4,0,0,44,0.0,0.0,1.0,44,1100,700,400,0.6363636363636364,15,7,8,358.3657575482059,0.42079589499647635,0.328719139668896,0.2238955335569387,133755.63274276702,786.6877308402617,134542.32047360728,4467,6,583.5909090909091,37,7,15,32.124938166914,0.6559684684684685,41.39254385964912,1034.4298245614034,27.957562825983874,0
4499,4,1,1,44,0.022222222222222223,0.022222222222222223,0.9777777777777777,45,850,600,250,0.7058823529411765,11,6,5,349.28266889277654,0.4225378787878788,0.3186958316137023,0.21982127447459676,134024.78723792822,362.5070768500225,134387.29431477824,4468,0,571.6,38,7,15,32.09068475718806,0.6567982456140351,41.13247863247863,1035.4700854700852,27.24921277552856,0
4500,4,0,0,44,0.0,0.0,1.0,44,1650,1200,450,0.7272727272727273,21,12,9,351.98095364610475,0.41999207188160675,0.230287451528417,0.2037424223727567,130874.7409396699,414.11336307605455,131288.85430274595,4469,8,585.5909090909091,39,5,14,35.188778886287274,0.62366452991453,44.19270833333332,1023.2291666666647,26.23664529914525,8
4501,4,1,0,45,0.022222222222222223,0.0,1.0,45,1050,600,450,0.5714285714285714,15,6,9,346.6183232552281,0.42087542087542085,0.2294797178130512,0.20219402189888297,131171.92147531227,93.31829598782973,131265.23977130008,4470,0,573.5555555555555,40,5,16,35.02562830687831,0.625,43.90243902439024,1024.3902439024384,25.60975609756096,0
4502,4,0,0,45,0.0,0.0,1.0,45,1350,1000,350,0.7407407407407407,17,10,7,350.08177934944064,0.4209385521885522,0.23143099478977325,0.20518738572328937,131354.1679576476,196.9401687157146,131551.1081263633,4471,1,574.5555555555555,40,5,17,34.752858464690526,0.6268229166666666,43.72459349593496,1025.1016260162605,25.627540650406512,0
4503,4,0,0,45,0.0,0.0,1.0,45,1050,700,350,0.6666666666666666,14,7,7,346.67457697373754,0.4210227272727273,0.22780310538486925,0.20360573234371454,131432.3123223612,112.84825500695442,131545.16057736814,4472,2,575.5555555555555,40,5,17,34.76131483316815,0.6276041666666666,43.648373983739845,1025.4065040650419,25.635162601626046,0
4504,4,0,2,43,0.0,0.044444444444444446,0.9555555555555556,45,1400,1100,300,0.7857142857142857,17,11,6,347.5479232580232,0.42045454545454547,0.22091904683286567,0.20481589522999122,131562.6045694529,144.86199930598633,131707.4665687589,4473,3,576.5555555555555,40,5,12,34.607478949975246,0.62890625,43.52134146341464,1025.914634146343,25.647865853658573,0
4505,4,0,0,43,0.0,0.0,1.0,43,650,400,250,0.6153846153846154,9,4,5,353.4054749871562,0.419827427094869,0.23115986187284143,0.20786322023438142,131488.33007812526,693.739149305585,132182.06922743085,4474,4,597.9302325581396,39,4,19,34.53221274290745,0.6298076923076922,43.593750000000014,1025.625000000002,26.298076923076977,0
4506,4,0,0,43,0.0,0.0,1.0,43,1250,900,350,0.72,16,9,7,355.61854209075193,0.4196197858988557,0.23199150041317407,0.2097510562631084,131595.18771701405,759.5377604166872,132354.72547743074,4475,5,598.9302325581396,39,4,13,34.3675972927242,0.6308760683760684,43.48958333333334,1026.041666666668,26.30876068376072,0
4507,4,1,0,44,0.022727272727272728,0.0,1.0,44,1450,1100,350,0.7586206896551724,18,11,7,351.3342416204334,0.4200140944326991,0.2419987054085153,0.20947475538123964,132006.08103642016,475.651274043236,132481.73231046338,4476,0,586.2954545454545,40,4,16,34.063282898206765,0.6333333333333333,43.08943089430895,1027.6422764227648,25.69105691056912,0
4508,4,0,1,43,0.0,0.022727272727272728,0.9772727272727273,44,1000,600,400,0.6,14,6,8,349.76588230928326,0.4197498238195913,0.23465223722293138,0.20882716255466907,132058.30379569053,437.8978286734234,132496.20162436395,4477,1,587.2954545454545,40,4,17,34.05098543273352,0.6338541666666666,43.03861788617887,1027.8455284552856,25.69613821138214,0
4509,4,0,0,43,0.0,0.0,1.0,43,1450,1100,350,0.7586206896551724,18,11,7,353.3947521134914,0.4181893687707641,0.2384988036162612,0.21064889604831386,131996.29041883687,729.3592664930611,132725.64968532993,4478,2,601.7906976744187,39,4,18,34.02021033958438,0.6348824786324787,43.098958333333336,1027.6041666666672,26.3488247863248,0
4510,4,1,1,43,0.022727272727272728,0.022727272727272728,0.9772727272727273,44,1150,800,350,0.6956521739130435,15,8,7,346.86274211780716,0.4200140944326991,0.23451903897644133,0.20766610797325286,132162.78029777252,368.46887599973627,132531.24917377226,4479,0,589.0909090909091,40,4,18,34.020433880213474,0.6348958333333334,42.9369918699187,1028.2520325203254,25.706300813008134,0
4511,4,0,0,43,0.0,0.0,1.0,43,1000,600,400,0.6,14,6,8,352.386240392374,0.41825858250276854,0.24060940744459414,0.2103445271598037,132049.81689453128,706.5077039930565,132756.32459852434,4480,4,603.7906976744187,39,4,19,33.992200432417825,0.6354166666666667,43.046875,1027.8125000000002,26.35416666666667,0
4512,4,0,0,43,0.0,0.0,1.0,43,950,800,150,0.8421052631578947,11,8,3,353.8831967739941,0.41828165374677,0.24388565989638478,0.21183632718957512,132156.90239800338,753.6214192708247,132910.5238172742,4481,5,604.7906976744187,39,4,19,33.845882720426836,0.6364850427350428,42.94270833333333,1028.2291666666658,26.364850427350405,0
4513,4,0,0,43,0.0,0.0,1.0,43,1250,800,450,0.64,17,8,9,351.46153577764693,0.4183047249907715,0.23789098292500843,0.21068486598255645,132210.4614257811,693.3783637152651,132903.83978949636,4482,6,605.7906976744187,39,4,19,33.85421941996691,0.6370192307692308,42.89062499999999,1028.4374999999989,26.370192307692278,0
4514,4,0,1,42,0.0,0.023255813953488372,0.9767441860465116,43,850,400,450,0.47058823529411764,13,4,9,351.7714583720147,0.41848929494278336,0.23570380800120594,0.2114696709884593,132317.61203342004,709.1118706597126,133026.72390407976,4483,7,606.7906976744187,39,4,19,33.73842006682193,0.6380876068376069,42.78645833333333,1028.8541666666658,26.380876068376047,0
4515,4,0,0,42,0.0,0.0,1.0,42,1100,800,300,0.7272727272727273,14,8,6,357.50817635698405,0.4181910569105691,0.2339860554813824,0.21490660039436688,132315.55103550298,1060.7782708744269,133376.32930637742,4484,8,617.2857142857143,38,4,19,33.59293873312565,0.6398026315789473,42.78846153846154,1028.846153846154,27.074898785425106,0
4516,4,0,0,42,0.0,0.0,1.0,42,1050,800,250,0.7619047619047619,13,8,5,355.3757008763341,0.41718689508323653,0.236150847181251,0.21471822127556311,132507.98000447443,1018.0232531594729,133526.0032576339,4485,9,618.2857142857143,38,4,19,33.454178340424065,0.6417214912280702,42.60149572649573,1029.5940170940173,27.094579397210982,0
4517,4,0,0,42,0.0,0.0,1.0,42,900,700,200,0.7777777777777778,11,7,4,355.32744305889526,0.4167997483546264,0.24077695795181842,0.2154759249040166,132645.51487508198,1026.5183267586915,133672.03320184068,4486,10,619.2857142857143,38,4,17,33.31712818917237,0.643092105263158,42.46794871794871,1030.1282051282035,27.108636977057987,0
4518,4,0,0,42,0.0,0.0,1.0,42,950,600,350,0.631578947368421,13,6,7,353.36401829488057,0.41716269841269843,0.23862104717470212,0.2147571491149414,132728.0700402694,980.2648339907764,133708.33487426018,4487,11,620.2857142857143,38,4,17,33.284733022291334,0.6439144736842106,42.387820512820504,1030.4487179487166,27.117071524966228,0
4519,4,0,0,42,0.0,0.0,1.0,42,1000,700,300,0.7,13,7,6,348.8104534596809,0.41725948509485095,0.18950217643568612,0.19932967879179866,130377.57087746523,699.5724267066424,131077.14330417188,4488,12,621.2857142857143,36,6,19,35.77319256073804,0.6241319444444444,44.67905405405405,1021.2837837837833,28.368993993993982,6
4520,4,0,0,42,0.0,0.0,1.0,42,1050,600,450,0.5714285714285714,15,6,9,345.6446021481297,0.4171747967479675,0.18258167464516717,0.19796009032120138,130463.84222059886,618.8245678110447,131082.6667884099,4489,13,622.2857142857143,36,6,19,35.7666446208113,0.625,44.59459459459459,1021.6216216216206,28.37837837837835,0
4521,4,0,0,42,0.0,0.0,1.0,42,1000,600,400,0.6,14,6,8,347.8376419213806,0.41719899341850564,0.17802052508971866,0.19980850873914222,130578.91506371224,684.0523800827698,131262.967443795,4490,14,623.2857142857143,36,6,16,35.594103496400756,0.6261574074074074,44.481981981981974,1022.072072072071,28.390890890890862,0
4522,4,0,0,42,0.0,0.0,1.0,42,1100,800,300,0.7272727272727273,14,8,6,348.13735743796866,0.4167876500193573,0.17906576663047669,0.20042733469748342,130665.2529852486,697.8911766496063,131363.1441618982,4491,15,624.2857142857143,36,6,17,35.499045416161856,0.627025462962963,44.397522522522515,1022.4099099099086,28.400275275275238,0
4523,4,0,0,42,0.0,0.0,1.0,42,1050,700,350,0.6666666666666666,14,7,7,343.0091513187,0.4170175183894696,0.13749477206189908,0.19667503136762854,130508.09500328718,582.9244762813995,131091.01947956858,4492,16,625.2857142857143,38,4,13,35.78915725637808,0.6217105263157896,44.551282051282044,1021.7948717948707,26.889338731443967,8
4524,4,0,0,42,0.0,0.0,1.0,42,1250,900,350,0.72,16,9,7,343.5071106982883,0.41751355013550134,0.1446013665158823,0.19765601577101136,130644.58832137109,575.4690125282998,131220.0573338994,4493,17,626.2857142857143,38,4,14,35.638302504615595,0.6230811403508772,44.41773504273504,1022.3290598290592,26.903396311291033,0
4525,4,0,0,42,0.0,0.0,1.0,42,1300,1000,300,0.7692307692307693,16,10,6,344.76463715680177,0.41733207510646536,0.14930182599355546,0.19936389887762893,130835.7988165681,621.5113412228849,131457.31015779098,4494,18,627.2857142857143,38,4,16,35.41275062656642,0.625,44.23076923076923,1023.0769230769234,26.923076923076934,0
4526,4,0,0,42,0.0,0.0,1.0,42,1400,1000,400,0.7142857142857143,18,10,8,342.9412643082119,0.417803910181959,0.14566220936877294,0.19929691545576686,131027.14913662436,586.92323672292,131614.07237334727,4495,19,628.2857142857143,38,4,16,35.26600925249573,0.6269188596491228,44.04380341880342,1023.8247863247867,26.942757534862807,0
4527,4,1,1,42,0.023255813953488372,0.023255813953488372,0.9767441860465116,43,750,500,250,0.6666666666666666,10,5,5,336.38841161378934,0.42045035068290887,0.1454345190119053,0.19689027851683985,131301.43364800367,233.65614149307905,131535.08978949676,4496,0,614.6511627906976,39,4,18,35.156964630551904,0.6279380341880341,43.77604166666668,1024.895833333335,26.279380341880387,0
4528,4,1,1,42,0.023255813953488372,0.023255813953488372,0.9767441860465116,43,1300,800,500,0.6153846153846154,18,8,10,329.7104820193895,0.42208840900701367,0.1549559044314308,0.1942551177439173,131553.00188519544,74.88615788030987,131627.88804307574,4497,0,615.1627906976744,37,6,19,35.07464015961238,0.634009009009009,43.530701754385966,1025.877192982456,27.726410621147462,0
4529,4,0,0,42,0.0,0.0,1.0,42,1250,1000,250,0.8,15,10,5,334.6336897070907,0.4191468253968254,0.1608599756443021,0.19733641080396783,131587.9662390431,406.75333272461546,131994.71957176772,4498,2,630.8095238095239,36,6,14,34.91315442871253,0.6362847222222222,43.49662162162162,1026.0135135135135,28.500375375375377,0
4530,4,0,0,42,0.0,0.0,1.0,42,850,500,350,0.5882352941176471,12,5,7,335.3893640984685,0.4184693186217576,0.16307238199723106,0.19838248239828304,131703.53366457685,434.3928810567401,132137.92654563359,4499,3,631.8095238095239,36,6,14,34.777381605412316,0.6374421296296295,43.38400900900901,1026.4639639639647,28.51288788788791,0
4531,4,0,1,41,0.0,0.023809523809523808,0.9761904761904762,42,1000,800,200,0.8,12,8,4,337.72710737720166,0.41809427022841655,0.17054051090889177,0.2006781072565119,131876.97991488117,507.6861912588329,132384.66610614,4500,4,632.8095238095239,36,6,15,34.54276760589118,0.6391782407407407,43.215090090090094,1027.13963963964,28.53165665665667,0
4532,4,0,0,41,0.0,0.0,1.0,41,1000,500,500,0.5,15,5,10,345.1106245238361,0.41547256097560975,0.17715366513448738,0.2046672099448848,131803.09070644728,897.329389574776,132700.42009602205,4501,42,649.1463414634146,35,6,15,34.4275999398858,0.6404761904761904,43.287037037037045,1026.8518518518526,29.33862433862436,0
4533,4,0,1,40,0.0,0.024390243902439025,0.975609756097561,41,850,500,350,0.5882352941176471,12,5,7,343.24515429576485,0.41476117886178865,0.17337457898120312,0.20451882415018813,131981.42387902958,860.3968407064581,132841.82071973605,4502,43,650.1463414634146,35,6,18,34.295918750469326,0.6422619047619047,43.11342592592593,1027.546296296297,29.35846560846563,0
4534,4,0,0,40,0.0,0.0,1.0,40,1350,1100,250,0.8148148148148148,16,11,5,350.9241750634103,0.4138888888888889,0.17345922150139015,0.20919733972012142,132000.11337868482,1264.4061791383215,133264.51955782314,4503,44,666.125,34,6,18,34.07982893110904,0.6446078431372548,43.095238095238095,1027.6190476190477,30.224089635854344,0
4535,4,0,0,40,0.0,0.0,1.0,40,1150,900,250,0.782608695652174,14,9,5,350.4685845558679,0.41334134615384616,0.17558545372663814,0.20947927106495426,132100.37964034645,1259.4066143690095,133359.78625471547,4504,45,667.125,35,5,18,33.99056143511221,0.6434523809523809,42.99768518518519,1028.00925925926,29.371693121693145,0
4536,4,1,1,40,0.024390243902439025,0.024390243902439025,0.975609756097561,41,900,500,400,0.5555555555555556,13,5,8,342.32747293102017,0.4140497967479675,0.1711935123072359,0.20591482028773783,132340.0612394492,860.7277463274391,133200.78898577663,4505,0,651.829268292683,36,5,18,33.95876655357338,0.6438078703703702,42.764639639639654,1028.9414414414437,28.58170670670677,0
4537,4,0,1,39,0.0,0.025,0.975,40,600,400,200,0.6666666666666666,8,4,4,350.2423856759218,0.41310096153846154,0.17704862674470978,0.20967340662701428,132159.87761488353,1257.5981652949442,133417.47578017847,4506,47,669.125,35,5,18,33.93647756265947,0.644047619047619,42.939814814814824,1028.2407407407418,29.37830687830691,0
4538,4,0,0,39,0.0,0.0,1.0,39,750,600,150,0.8,9,6,3,354.18331951100805,0.412814889788574,0.17751301677461107,0.21203265569648222,132159.87761488341,1561.7648319615964,133721.642446845,4507,48,681.5128205128206,35,4,19,33.835171844514484,0.644047619047619,42.93981481481482,1028.2407407407409,29.378306878306883,0
4539,4,0,0,39,0.0,0.0,1.0,39,1150,900,250,0.782608695652174,14,9,5,352.947726303616,0.4120838956365272,0.18088892734562023,0.21229399775636976,132338.45191400888,1541.7111411179674,133880.16305512685,4508,49,682.5128205128206,35,4,19,33.68719535058118,0.6458333333333333,42.7662037037037,1028.935185185185,29.39814814814814,0
4540,4,0,1,38,0.0,0.02564102564102564,0.9743589743589743,39,700,400,300,0.5714285714285714,10,4,6,354.53785507056375,0.41194331983805665,0.18000622858922544,0.21358743951811987,132398.0034722221,1588.0342292523912,133986.0377014745,4509,50,683.5128205128206,34,5,19,33.58636977058031,0.6485906862745099,42.70833333333333,1029.1666666666656,30.269607843137223,0
4541,4,2,2,38,0.05,0.05,0.95,40,1300,900,400,0.6923076923076923,17,9,8,343.6645947724558,0.41271367521367525,0.1692741663859889,0.20951543775758127,132845.06715374227,1130.8292341821011,133975.89638792438,4510,0,661.6,35,5,16,33.4171859211856,0.6508928571428572,42.27430555555556,1030.9027777777776,29.454365079365076,0
4542,4,0,0,38,0.0,0.0,1.0,38,950,500,450,0.5263157894736842,14,5,9,358.5711207985317,0.4102210763394974,0.18507477642225445,0.21710603020107064,132587.2561034218,1908.392204921182,134495.64830834296,4511,52,697.421052631579,33,5,20,33.292182294145626,0.6527777777777778,42.52450980392157,1029.9019607843138,31.20915032679739,0
4543,4,0,0,38,0.0,0.0,1.0,38,1000,600,400,0.6,14,6,8,359.2266943361542,0.40989509246088196,0.1829701332814473,0.21836139509647118,132735.14739229015,1936.4016439909124,134671.54903628107,4512,53,698.421052631579,34,4,17,33.126588493530484,0.6519607843137256,42.38095238095237,1030.4761904761897,30.308123249299697,0
4544,4,0,0,38,0.0,0.0,1.0,38,900,500,400,0.5555555555555556,13,5,8,358.7250820007464,0.4102358937885254,0.1834446666383016,0.21859257459848425,132827.17013888876,1929.687499999981,134756.85763888873,4513,54,699.421052631579,34,4,18,33.04702236593911,0.6528799019607844,42.29166666666666,1030.8333333333321,30.318627450980358,0
4545,4,0,0,38,0.0,0.0,1.0,38,800,500,300,0.625,11,5,6,357.31047852259996,0.40913940256045517,0.18761297182349823,0.2183564035415886,132934.57031249977,1899.7829861110822,134834.35329861086,4514,55,700.421052631579,35,3,18,32.97558922558922,0.6517857142857144,42.187499999999986,1031.2499999999982,29.464285714285662,0
4546,4,0,0,38,0.0,0.0,1.0,38,800,300,500,0.375,13,3,10,356.88672646809505,0.40860597439544805,0.19077766228857618,0.2184460512557459,132994.25582990382,1892.7769204389374,134887.03275034277,4515,56,701.421052631579,35,3,18,32.92657839616996,0.6523809523809525,42.12962962962962,1031.4814814814802,29.470899470899433,0
4547,4,0,0,38,0.0,0.0,1.0,38,750,500,250,0.6666666666666666,10,5,5,356.04604831712606,0.4073316737790422,0.18730302994534997,0.218980597164974,133173.39275763,1883.1720464677223,135056.56480409772,4516,57,702.421052631579,35,3,18,32.7684645286686,0.6541666666666668,41.9560185185185,1032.1759259259234,29.490740740740666,0
4548,4,0,0,38,0.0,0.0,1.0,38,1000,700,300,0.7,13,7,6,358.1227848255835,0.4073909435751541,0.1900152196226952,0.2209662161973617,133292.88435570966,1947.0437885802196,135239.92814428988,4517,58,703.421052631579,35,3,19,32.59498991257565,0.655357142857143,41.840277777777764,1032.638888888887,29.503968253968203,0
4549,4,1,0,39,0.02564102564102564,0.0,1.0,39,650,400,250,0.6153846153846154,9,4,5,351.0930479566722,0.4096941070625281,0.18894535848623262,0.2180292710885311,133532.02830289755,1576.5539266117705,135108.58222950934,4518,0,686.3589743589744,35,4,20,32.536860768943626,0.6577380952380953,41.60879629629628,1033.564814814813,29.53042328042323,0
4550,4,0,0,39,0.0,0.0,1.0,39,700,400,300,0.5714285714285714,10,4,6,354.92839970942316,0.40955353126405764,0.18989801571241216,0.2209460205299145,133621.7625412592,1685.2316690243188,135306.99421028353,4519,1,687.3589743589744,35,4,20,32.34787212209411,0.6586309523809525,41.521990740740726,1033.9120370370351,29.54034391534386,0
4551,4,0,0,39,0.0,0.0,1.0,39,1200,900,300,0.75,15,9,6,354.0810974240689,0.40977845254161044,0.18385203678992235,0.22077561796818207,133681.60211173235,1666.8256762259584,135348.42778795832,4520,2,688.3589743589744,35,4,20,32.30985357209477,0.6592261904761907,41.46412037037035,1034.1435185185157,29.546957671957593,0
4552,4,1,1,39,0.025,0.025,0.975,40,950,700,250,0.7368421052631579,12,7,5,345.53920744917656,0.4125934829059829,0.17942184270640715,0.21712521764048362,133967.2374020978,1258.186607215293,135225.42400931308,4521,0,672.125,36,4,16,32.245095906305515,0.6600115740740742,41.18806306306305,1035.2477477477457,28.756881881881824,0
4553,4,0,1,38,0.0,0.02564102564102564,0.9743589743589743,39,1250,1000,250,0.8,15,10,5,361.332190392343,0.4096378767431399,0.17142923157791357,0.21529578431565252,131981.42387902958,1737.8273962620135,133719.25127529158,4522,4,690.3589743589744,35,4,17,33.83128707666892,0.6422619047619047,43.11342592592593,1027.546296296297,29.35846560846563,4
4554,4,1,1,38,0.02564102564102564,0.02564102564102564,0.9743589743589743,39,1100,800,300,0.7272727272727273,14,8,6,360.3642876777891,0.4104813315339631,0.17248498024048464,0.21543978927377466,132108.41912436092,1721.431270797836,133829.85039515875,4523,0,691.2307692307693,36,3,17,33.72813743747034,0.6414930555555556,42.98986486486487,1028.0405405405413,28.556681681681702,0
4555,4,1,0,39,0.02564102564102564,0.0,1.0,39,850,600,250,0.7058823529411765,11,6,5,363.20880402189493,0.4096378767431399,0.18360490084628034,0.21814019886522104,132282.13168827622,1809.2069687931273,134091.33865706934,4524,0,692.2051282051282,36,3,19,33.47997628170042,0.6432291666666665,42.82094594594595,1028.716216216217,28.57545045045047,0
4556,4,0,0,39,0.0,0.0,1.0,39,1000,700,300,0.7,13,7,6,359.2512953931638,0.40949730094466935,0.1826789725136737,0.21659808609704445,132427.7842747985,1715.0213357556386,134142.80561055415,4525,1,693.2051282051282,35,4,19,33.43512219348551,0.6467261904761905,42.679398148148145,1029.2824074074072,29.408068783068774,0
4557,4,0,0,39,0.0,0.0,1.0,39,1450,1300,150,0.896551724137931,16,13,3,358.25656021945053,0.40882253711201083,0.18031728463383168,0.21651157335001564,132517.14677640592,1695.0274348422408,134212.17421124817,4526,2,694.2051282051282,35,4,20,33.37080335731416,0.6476190476190476,42.59259259259259,1029.6296296296289,29.417989417989396,0
4558,4,0,0,39,0.0,0.0,1.0,39,900,600,300,0.6666666666666666,12,6,6,358.4882051706077,0.40781039136302294,0.1841808788656749,0.21716722517448847,132606.53941883135,1707.5760620284518,134314.1154808598,4527,3,695.2051282051282,35,4,20,33.27492321234595,0.6485119047619048,42.50578703703703,1029.976851851851,29.42791005291003,0
4559,4,0,0,39,0.0,0.0,1.0,39,1300,900,400,0.6923076923076923,17,9,8,357.684716790316,0.4066295546558705,0.1905033451703111,0.217369763384586,132725.77649444877,1694.7963552383433,134420.5728496871,4528,4,696.2051282051282,35,4,17,33.175731963008715,0.649702380952381,42.3900462962963,1030.4398148148152,29.441137566137577,0
4560,4,0,0,39,0.0,0.0,1.0,39,1200,1100,100,0.9166666666666666,13,11,2,358.89855115464246,0.4052237966711651,0.18966474740237493,0.21950205829368682,132964.41139671206,1744.1469210819514,134708.55831779403,4529,5,697.2051282051282,35,4,19,32.90467306325516,0.6520833333333333,42.15856481481481,1031.3657407407402,29.467592592592577,0
4561,4,0,0,39,0.0,0.0,1.0,39,1100,700,400,0.6363636363636364,15,7,8,356.8538226557277,0.4045771479982006,0.194304295144631,0.21901216188844164,133094.29943034257,1699.041905080759,134793.34133542332,4530,6,698.2051282051282,36,3,20,32.8269944341373,0.6513310185185186,42.03265765765766,1031.8693693693697,28.663038038038046,0
4562,4,0,0,39,0.0,0.0,1.0,39,950,600,350,0.631578947368421,13,6,7,360.58607260220924,0.40443657219973006,0.20002629275019368,0.22199412542273023,133210.52629910313,1806.7721014933818,135017.2984005965,4531,7,699.2051282051282,36,3,20,32.61404130758881,0.6524884259259259,41.92004504504504,1032.3198198198197,28.675550550550547,0
4563,4,0,0,39,0.0,0.0,1.0,39,800,600,200,0.75,10,6,4,360.58607260220924,0.40443657219973006,0.20002629275019368,0.22199412542273023,133210.52629910313,1806.7721014933818,135017.2984005965,4532,8,700.2051282051282,36,3,20,32.61404130758881,0.6524884259259259,41.92004504504504,1032.3198198198197,28.675550550550547,0
4564,4,0,0,39,0.0,0.0,1.0,39,1450,1200,250,0.8275862068965517,17,12,5,364.92484205247894,0.4051394511920828,0.2112889835554177,0.22572188645633104,133384.96171424803,1935.0972171495773,135320.0589313976,4533,9,701.2051282051282,36,3,20,32.32698317526073,0.6542245370370371,41.751126126126124,1032.9954954954953,28.694319319319316,0
4565,4,0,0,39,0.0,0.0,1.0,39,900,600,300,0.6666666666666666,12,6,6,365.15491020528594,0.40468960863697706,0.21237689540784555,0.22658950388235302,133503.8825962371,1950.0052531007082,135453.8878493378,4534,10,702.2051282051282,33,6,20,32.20174216372189,0.6619318181818181,41.63602941176471,1033.4558823529417,31.31684491978611,0
4566,4,0,0,39,0.0,0.0,1.0,39,850,800,50,0.9411764705882353,9,8,1,368.59574255696134,0.4047177237966712,0.21985143037774635,0.22931221859959647,133598.88624567486,2048.7961361015196,135647.6823817764,4535,11,703.2051282051282,33,6,20,32.01754385964913,0.6628787878787878,41.54411764705883,1033.8235294117658,31.327985739750478,0
4567,4,0,1,38,0.0,0.02564102564102564,0.9743589743589743,39,1050,900,150,0.8571428571428571,12,9,3,365.60239308934393,0.40438034188034183,0.21163880625206555,0.22818632120403876,133718.36734693882,1977.5510204081681,135695.91836734698,4536,12,704.2051282051282,34,5,19,31.975138121546962,0.6617647058823529,41.42857142857143,1034.2857142857147,30.420168067226903,0
4568,4,0,0,38,0.0,0.0,1.0,38,1150,1000,150,0.8695652173913043,13,10,3,375.06189576021296,0.40362731152204834,0.1878053276799705,0.21203994304859547,129958.94451530601,2184.449404761893,132143.3939200679,4537,13,716.7894736842105,34,4,16,35.52855613932672,0.6240808823529412,45.08928571428571,1019.6428571428563,29.989495798319304,7
4569,4,1,1,38,0.02564102564102564,0.02564102564102564,0.9743589743589743,39,1000,700,300,0.7,13,7,6,364.0917707695201,0.4069950517318938,0.17400975889781867,0.2076097756728325,130292.97052154179,1688.0739795918182,131981.0445011336,4538,0,699.3846153846154,34,5,17,35.468895755597025,0.627450980392157,44.76190476190475,1020.9523809523797,30.028011204481757,0
4570,4,2,2,38,0.05,0.05,0.95,40,950,700,250,0.7368421052631579,12,7,5,355.59004814658505,0.40840010683760686,0.17042249641952223,0.20441360779142181,130607.69120049097,1288.5590404593727,131896.25024095035,4539,0,682.85,36,4,14,35.36686129778562,0.6264467592592593,44.453828828828826,1022.1846846846842,28.394019019019005,0
4571,4,0,0,38,0.0,0.0,1.0,38,750,600,150,0.8,9,6,3,372.2069084099334,0.4029753437648174,0.1795474346860393,0.2125692982916381,130353.74858276625,2103.7131519274167,132457.46173469367,4540,16,719.7894736842105,34,4,19,35.200027201367845,0.6280637254901962,44.70238095238094,1021.1904761904746,30.035014005602193,0
4572,4,1,1,38,0.02564102564102564,0.02564102564102564,0.9743589743589743,39,600,400,200,0.6666666666666666,8,4,4,365.1420180303507,0.40572986954565904,0.16950421931742032,0.21011722770437033,130646.86381440733,1740.9319005058017,132387.79571491314,4541,0,702.3076923076923,35,4,14,35.08304558662591,0.6288690476190478,44.415509259259245,1022.337962962961,29.20965608465603,0
4573,4,0,0,38,0.0,0.0,1.0,38,750,400,350,0.5333333333333333,11,4,7,373.9812468348145,0.4027234471313419,0.18019495447996836,0.21475779291484123,130566.58340419478,2165.8907312924907,132732.47413548728,4542,18,721.7894736842105,34,4,15,34.9386041545331,0.6302083333333335,44.494047619047606,1022.0238095238076,30.059523809523753,0
4574,4,1,0,39,0.02564102564102564,0.0,1.0,39,450,200,250,0.4444444444444444,7,2,5,366.30656025167485,0.4065452091767881,0.17956257721016855,0.21224656656260202,130913.23329260964,1790.8752357681665,132704.1085283778,4543,0,704.2564102564103,35,4,17,34.78332579356103,0.631547619047619,44.15509259259259,1023.3796296296289,29.23941798941797,0
4575,4,0,0,39,0.0,0.0,1.0,39,800,500,300,0.625,11,5,6,367.4067645119884,0.4063202878992353,0.17511849371657173,0.21337576047987744,131002.08340031283,1826.2103212877112,132828.29372160052,4544,1,705.2564102564103,35,4,17,34.66518277746371,0.6324404761904763,44.06828703703703,1023.726851851851,29.249338624338602,0
4576,4,0,0,39,0.0,0.0,1.0,39,900,400,500,0.4444444444444444,14,4,10,369.1961949365057,0.4048582995951417,0.17581424449928695,0.2155755090750626,131209.51753257887,1888.4109224965707,133097.92845507545,4545,2,706.2564102564103,35,4,17,34.40936134960085,0.6345238095238095,43.86574074074074,1024.5370370370372,29.272486772486776,0
4577,4,0,0,39,0.0,0.0,1.0,39,1400,1000,400,0.7142857142857143,18,10,8,366.3525103449515,0.4047739541160594,0.16828467403180047,0.21509162723933653,131419.6588010204,1829.2379657624354,133248.89676678285,4546,3,707.2564102564103,34,5,18,34.26966020356824,0.6387867647058822,43.660714285714285,1025.357142857143,30.157563025210084,0
4578,4,0,0,39,0.0,0.0,1.0,39,1350,1000,350,0.7407407407407407,17,10,7,336.8386196157028,0.4048301844354476,0.13013559656109974,0.19577361557953393,131031.70680084023,1027.307848936905,132059.01464977712,4547,4,708.2564102564103,35,4,18,35.41760871203557,0.6327380952380952,44.039351851851855,1023.8425925925928,29.25264550264551,3
4579,4,0,0,39,0.0,0.0,1.0,39,1050,700,350,0.6666666666666666,14,7,7,338.60980907976125,0.4040710751237067,0.11577127266723997,0.19786882110779688,131239.1643759644,1087.7736786265318,132326.93805459095,4548,5,709.2564102564103,35,4,19,35.162868519146045,0.6348214285714286,43.83680555555555,1024.652777777777,29.275793650793627,0
4580,4,0,0,39,0.0,0.0,1.0,39,1350,1100,250,0.8148148148148148,16,11,5,336.3827199351338,0.40283400809716596,0.11849099627002802,0.19778946790611956,131476.45968632118,1045.2818233453404,132521.74150966652,4549,6,710.2564102564103,35,4,19,34.98065022758907,0.637202380952381,43.605324074074076,1025.578703703704,29.302248677248684,0
4581,4,0,0,39,0.0,0.0,1.0,39,1400,900,500,0.6428571428571429,19,9,10,335.6415110323348,0.4030589293747189,0.11862445616958261,0.19781425224671625,131565.50068587094,1031.76868998627,132597.2693758572,4550,7,711.2564102564103,35,4,16,34.90993531889291,0.6380952380952382,43.51851851851851,1025.925925925925,29.312169312169285,0
4582,4,0,0,39,0.0,0.0,1.0,39,1200,700,500,0.5833333333333334,17,7,10,335.5381581046867,0.40345254161043637,0.11600186185821593,0.1985248782008316,131713.96933138277,1039.0125332218704,132752.98186460463,4551,8,712.2564102564103,35,4,16,34.76305577479612,0.6395833333333334,43.37384259259259,1026.5046296296289,29.32870370370368,0
4583,4,0,0,39,0.0,0.0,1.0,39,1050,900,150,0.8571428571428571,12,9,3,336.8665889014359,0.40235605038236616,0.12380977150502703,0.19993426376738715,131832.80452942807,1082.0134334276322,132914.8179628557,4552,9,713.2564102564103,35,4,17,34.60932510612721,0.6407738095238096,43.25810185185185,1026.967592592592,29.341931216931197,0
4584,4,0,0,39,0.0,0.0,1.0,39,800,400,400,0.5,12,4,8,337.7626264708434,0.40168128654970764,0.12768514345801396,0.2009370692061128,131921.96609224955,1111.6619513031428,133033.6280435527,4553,10,714.2564102564103,35,4,17,34.49658254468979,0.6416666666666667,43.17129629629629,1027.314814814814,29.35185185185183,0
4585,4,0,0,39,0.0,0.0,1.0,39,1100,700,400,0.6363636363636364,15,7,8,337.18042366691014,0.40134390463337827,0.12758142758142732,0.20122057541412375,132040.8950617283,1104.3209876543096,133145.2160493826,4554,11,715.2564102564103,35,4,17,34.39189189189189,0.6428571428571429,43.05555555555555,1027.7777777777771,29.365079365079346,0
4586,4,0,0,39,0.0,0.0,1.0,39,950,700,250,0.7368421052631579,12,7,5,338.9690171332907,0.401006522717049,0.13023169879733731,0.20260584186930589,132100.37964034622,1155.5871699245356,133255.96681027077,4555,12,716.2564102564103,35,4,17,34.28610297980934,0.643452380952381,42.997685185185176,1028.009259259258,29.371693121693085,0
4587,4,0,0,39,0.0,0.0,1.0,39,1050,700,350,0.6666666666666666,14,7,7,339.83461352435876,0.4005004498425551,0.13402109441713406,0.2040844625003042,132278.91375171472,1190.5907064471926,133469.50445816191,4556,13,717.2564102564103,35,4,17,34.08434593459347,0.6452380952380952,42.824074074074076,1028.703703703704,29.391534391534396,0
4588,4,2,0,41,0.04878048780487805,0.0,1.0,41,1200,900,300,0.75,15,9,6,318.4415601396435,0.4069359756097561,0.1036203472681907,0.18466526308340114,130945.12473518887,139.67396267076066,131084.79869785963,4557,0,683.219512195122,38,3,18,35.975774182324265,0.6260964912280702,44.123931623931625,1023.5042735042739,26.934322986954577,8
4589,4,0,0,41,0.0,0.0,1.0,41,1100,800,300,0.7272727272727273,14,8,6,319.98789213808453,0.4064532520325203,0.10493761168043747,0.1858256959070986,130999.80481591067,183.67028270875352,131183.4750986194,4558,1,684.219512195122,38,3,18,35.881079106658326,0.6266447368421052,44.070512820512825,1023.7179487179494,26.939946018893405,0
4590,4,0,0,41,0.0,0.0,1.0,41,1400,900,500,0.6428571428571429,19,9,10,318.1862561001781,0.406224593495935,0.10724683415448544,0.18504229845049203,131054.49631090669,139.94790525240768,131194.44421615909,4559,2,685.219512195122,38,3,18,35.87206976905955,0.6271929824561402,44.017094017094024,1023.9316239316249,26.945569050832233,0
4591,4,0,0,41,0.0,0.0,1.0,41,850,600,250,0.7058823529411765,11,6,5,317.17555445811047,0.40538617886178857,0.11043650117385528,0.18511237928781632,131191.27498584636,122.13307674045609,131313.40806258682,4560,3,686.219512195122,38,3,18,35.76015921020614,0.628563596491228,43.88354700854701,1024.4658119658125,26.959626630679274,0
4592,4,1,0,42,0.023809523809523808,0.0,1.0,42,1700,1200,500,0.7058823529411765,22,12,10,312.87361749041554,0.4078590785907859,0.12643161587752627,0.18505742057326313,131702.0887586809,-158.77821180551643,131543.3105468754,4561,0,670.8571428571429,39,3,12,35.35662336783709,0.6319444444444442,43.385416666666686,1026.4583333333362,26.319444444444517,0
4593,4,0,0,42,0.0,0.0,1.0,42,950,500,450,0.5263157894736842,14,5,9,313.52859211062855,0.40752032520325204,0.11873846718642844,0.18596659813637673,131809.03320312526,-134.81987847219295,131674.21332465307,4562,1,671.8571428571429,39,3,14,35.23238317440996,0.6330128205128204,43.281250000000014,1026.875000000002,26.330128205128258,0
4594,4,1,0,43,0.023255813953488372,0.0,1.0,43,1300,1000,300,0.7692307692307693,16,10,6,310.40244340639606,0.41096806939830194,0.13096791984557443,0.18609435588108586,132215.03404058435,-392.02607574855335,131823.0079648358,4563,0,657.2093023255813,40,3,17,34.905303030303045,0.6354166666666666,42.88617886178862,1028.4552845528458,25.711382113821145,0
4595,4,0,0,43,0.0,0.0,1.0,43,1000,700,300,0.7,13,7,6,311.0184576461966,0.41094499815430047,0.12674211825036852,0.18672175731285914,132267.29811124344,-372.48578888226336,131894.81232236116,4564,1,658.2093023255813,40,3,17,34.837071066324185,0.6359374999999999,42.835365853658544,1028.658536585367,25.716463414634177,0
4596,4,0,1,42,0.0,0.023255813953488372,0.9767441860465116,43,950,500,450,0.5263157894736842,14,5,9,328.8591270363759,0.4110603543743079,0.13457382869768786,0.18687461768943142,130158.8642363178,-39.21390623966312,130119.65033007813,4565,2,659.2093023255813,40,3,19,36.50387577598513,0.6148437499999999,44.893292682926834,1020.4268292682937,25.510670731707343,6
4597,4,0,0,42,0.0,0.0,1.0,42,1100,900,200,0.8181818181818182,13,9,4,337.5904375537747,0.40923828881145957,0.12621449650479954,0.18158103601314302,127986.37695312483,283.0398611007679,128269.4168142256,4566,3,675.3809523809524,39,3,18,38.49126690000687,0.5945512820512822,47.03124999999999,1011.8749999999986,25.945512820512786,6
4598,4,1,0,43,0.023255813953488372,0.0,1.0,43,1100,900,200,0.8181818181818182,13,9,4,343.5344845526022,0.4119601328903655,0.12608540827786485,0.18343445118563462,127692.92091836728,193.44728776927033,127886.36820613655,4567,0,660.6511627906976,41,2,15,38.64104829210837,0.5884146341463414,47.32142857142857,1010.7142857142851,24.651567944250857,3
4599,4,2,2,43,0.044444444444444446,0.044444444444444446,0.9555555555555556,45,1450,1100,350,0.7586206896551724,18,11,7,329.7979051182768,0.4179503367003367,0.12555178365280217,0.17820819542272184,128170.89979383671,-542.7123746634165,127628.1874191733,4568,0,632.2444444444444,39,6,17,38.50009001131571,0.5964209401709402,46.84895833333333,1012.6041666666658,25.96420940170938,0
4600,4,1,0,44,0.022727272727272728,0.0,1.0,44,800,400,400,0.5,12,4,8,337.87043003285976,0.4145525017618041,0.1398214045924535,0.1825733144727163,128171.57594601501,-138.9229034261142,128032.6530425889,4569,0,647.3409090909091,38,6,18,38.29504290637967,0.5981359649122808,46.848290598290596,1012.6068376068373,26.647548358074665,0
4601,4,3,3,44,0.06382978723404255,0.06382978723404255,0.9361702127659575,47,800,700,100,0.875,9,7,2,315.90976363233244,0.4250308356460068,0.14896259571622283,0.1724896972321136,128586.40861614354,-1258.7408015642218,127327.66781457931,4570,0,606.9574468085107,42,5,12,38.42871246138658,0.595982142857143,46.43895348837208,1014.2441860465091,24.148671096345453,2
4602,4,2,2,44,0.043478260869565216,0.043478260869565216,0.9565217391304348,46,1250,700,550,0.56,18,7,11,317.7922712946542,0.41939412238325285,0.15866079474928152,0.17400317723777942,128697.582042076,-1020.1806185437239,127677.40142353227,4571,0,620.9565217391304,41,5,13,38.267908356146535,0.5985772357723578,46.329365079365076,1014.6825396825388,24.748354626403387,0
4603,4,0,0,44,0.0,0.0,1.0,44,1000,600,400,0.6,14,6,8,332.4182527418086,0.41582980972515854,0.15474633280388672,0.18069439101551968,128408.33875868074,-262.94487847220313,128145.39388020853,4572,1,650.1136363636364,39,5,14,38.191589585474475,0.5988247863247863,46.61458333333334,1013.5416666666681,25.9882478632479,0
4604,4,0,0,44,0.0,0.0,1.0,44,1550,1300,250,0.8387096774193549,18,13,5,334.617228143122,0.41553250528541225,0.15743334734089753,0.18249292526461022,128540.34423828122,-197.63726128472348,128342.7069769965,4573,2,651.1136363636364,39,5,14,38.0013054271529,0.6001602564102564,46.484375,1014.0624999999998,26.00160256410256,0
4605,4,1,0,45,0.022222222222222223,0.0,1.0,45,1100,400,700,0.36363636363636365,18,4,14,335.05939390562185,0.4160563973063973,0.18220176959672796,0.18483740074396196,128994.83194527053,-355.8139582920327,128639.0179869785,4574,0,637.6222222222223,40,5,15,37.52730258770175,0.6031250000000001,46.036585365853654,1015.8536585365842,25.396341463414608,0
4606,4,1,1,45,0.021739130434782608,0.021739130434782608,0.9782608695652174,46,1350,1100,250,0.8148148148148148,16,11,5,326.64277243593193,0.4199677938808373,0.1740332968119509,0.1813814985506011,129254.34570312496,-755.6699429179896,128498.67576020697,4575,0,624.7391304347826,39,7,15,37.477378269480305,0.6073717948717949,45.78125,1016.8749999999997,26.07371794871794,0
4607,4,0,0,45,0.0,0.0,1.0,45,1350,900,450,0.6666666666666666,18,9,9,333.58543710612855,0.415530303030303,0.17372463869627186,0.18524306828332127,129255.70371283495,-376.4359156987556,128879.2677971362,4576,2,639.6222222222223,38,7,17,37.29950269664494,0.6091008771929826,45.77991452991452,1016.8803418803404,26.760008996851063,0
4608,4,0,0,45,0.0,0.0,1.0,45,850,600,250,0.7058823529411765,11,6,5,333.82647050765763,0.4155934343434344,0.1714485752292938,0.1858886346300534,129364.36760355021,-362.949950690342,129001.41765285988,4577,3,640.6222222222223,38,7,17,37.18297101449277,0.6101973684210527,45.67307692307692,1017.3076923076916,26.771255060728727,0
4609,4,0,1,44,0.0,0.022222222222222223,0.9777777777777777,45,1000,800,200,0.8,12,8,4,336.52616895015433,0.415530303030303,0.17388241605728783,0.1880401649025288,129500.2616722367,-283.95461227994747,129216.30705995674,4578,4,641.6222222222223,38,7,13,36.97626919981805,0.6115679824561404,45.53952991452991,1017.8418803418792,26.785312640575768,0
4610,4,3,3,44,0.06382978723404255,0.06382978723404255,0.9361702127659575,47,950,800,150,0.8421052631578947,11,8,3,317.54839262646186,0.42244835029293865,0.17354445322815537,0.18020736651085636,130107.01844346937,-1136.945084770983,128970.07335869838,4579,0,612.1276595744681,40,7,13,36.844846764285954,0.6143229166666667,44.944105691056905,1020.2235772357714,25.505589430894283,0
4611,4,2,1,45,0.043478260869565216,0.021739130434782608,0.9782608695652174,46,1400,1200,200,0.8571428571428571,16,12,4,337.6789646791826,0.420481078904992,0.19328195586208152,0.19266852927993683,130317.1242078491,-398.8367328804044,129918.2874749687,4580,0,626.3913043478261,38,8,14,36.11859544487461,0.6197916666666669,44.73824786324785,1021.0470085470065,26.869658119658066,0
4612,4,0,1,44,0.0,0.022222222222222223,0.9777777777777777,45,1400,800,600,0.5714285714285714,20,8,12,341.96472476718793,0.41550925925925924,0.1956027259017361,0.1947072828584352,130236.00396050328,-92.77615017363655,130143.22781032964,4581,1,641.3111111111111,39,6,14,36.091374119808144,0.6172542735042736,44.81770833333332,1020.729166666665,26.172542735042693,0
4613,4,2,2,44,0.043478260869565216,0.043478260869565216,0.9565217391304348,46,600,300,300,0.5,9,3,6,334.69495866714755,0.4195652173913043,0.1985570890840651,0.1919078288185008,130508.09500328706,-463.914282082129,130044.18072120493,4582,0,628.1086956521739,38,8,13,36.00154224173984,0.6217105263157896,44.55128205128204,1021.7948717948698,26.889338731443942,0
4614,4,3,3,44,0.06382978723404255,0.06382978723404255,0.9361702127659575,47,1400,1000,400,0.7142857142857143,18,10,8,327.59213191812944,0.4205403946962689,0.1907054092717697,0.18967942359307888,130885.7897601459,-824.5690189371604,130061.22074120873,4583,0,615.1489361702128,40,7,13,35.801511239116756,0.6221354166666667,44.18191056910568,1023.2723577235759,25.581808943089396,0
4615,4,0,0,44,0.0,0.0,1.0,44,850,500,350,0.5882352941176471,12,5,7,347.1824192345949,0.4129778893587033,0.2125869249300214,0.19938923781180862,130570.58572108705,266.36236630499127,130836.94808739204,4584,2,658.0909090909091,37,7,13,35.619278153273946,0.6241554054054055,44.490131578947356,1022.0394736842087,27.622688477951588,0
4616,4,1,2,43,0.022222222222222223,0.044444444444444446,0.9555555555555556,45,1550,1200,350,0.7741935483870968,19,12,7,338.85134626653775,0.4156355218855219,0.20212221995972768,0.1960069448191951,130848.09570312499,-132.3893229166673,130715.70638020831,4585,0,644.4444444444445,39,6,13,35.55156790877622,0.6233974358974359,44.21875,1023.1249999999999,26.233974358974358,0
4617,4,0,2,41,0.0,0.046511627906976744,0.9534883720930233,43,950,600,350,0.631578947368421,13,6,7,354.4590703591634,0.41258305647840526,0.21975434877486144,0.20415879129704717,130682.67549871097,664.3319338642468,131347.00743257522,4586,4,672.4883720930233,37,6,13,35.319816800714925,0.6252815315315317,44.38048245614034,1022.4780701754372,27.63454243717398,0
4618,4,1,0,42,0.023809523809523808,0.0,1.0,42,900,400,500,0.4444444444444444,14,4,10,360.8007480438922,0.40905681378242353,0.22190916913261582,0.2072549107117951,130578.91506371222,1022.5940467494357,131601.50911046166,4587,0,688.6428571428571,36,6,14,35.26287277802261,0.6261574074074074,44.481981981981974,1022.0720720720709,28.39089089089086,0
4619,4,2,0,44,0.045454545454545456,0.0,1.0,44,850,600,250,0.7058823529411765,11,6,5,346.8638084484065,0.41440935517970406,0.2180817774069057,0.20215096240698277,131136.55495516444,297.30497571039643,131433.85993087484,4588,0,658.2954545454545,38,6,16,35.05506588783423,0.6280153508771931,43.9369658119658,1024.2521367521344,26.954003598740382,0
4620,4,0,0,44,0.0,0.0,1.0,44,1000,600,400,0.6,14,6,8,347.33356234325515,0.4148277836504581,0.21734154178633358,0.2030028151391928,131246.00643080185,317.22859138721367,131563.23502218907,4589,1,659.2954545454545,38,6,17,34.93248879157543,0.6291118421052633,43.83012820512819,1024.679487179485,26.965249662618028,0
4621,4,0,0,44,0.0,0.0,1.0,44,1300,1000,300,0.7692307692307693,16,10,6,353.0232370483165,0.4141450845665962,0.22408731426745487,0.2070827029695795,131385.84530476423,476.5026465975043,131862.34795136173,4590,2,660.2954545454545,36,8,19,34.645485500878735,0.6342592592592593,43.693693693693696,1025.2252252252254,28.478478478478483,0
4622,4,0,0,44,0.0,0.0,1.0,44,1150,900,250,0.782608695652174,14,9,5,354.35072884233676,0.41403497181113463,0.22584541062801944,0.2084900799932819,131501.32395909433,519.5179977274711,132020.8419568218,4591,3,661.2954545454545,36,8,19,34.49485800029279,0.6354166666666665,43.58108108108109,1025.6756756756765,28.490990990991016,0
4623,4,0,0,44,0.0,0.0,1.0,44,1250,900,350,0.72,16,9,7,353.8804679027009,0.4138698026779422,0.21708137121877247,0.20884448338921077,131616.8533398265,515.3267287558064,132132.18006858233,4592,4,662.2954545454545,36,8,14,34.39031862745098,0.636574074074074,43.46846846846848,1026.1261261261277,28.50350350350355,0
4624,4,0,1,43,0.0,0.022727272727272728,0.9772727272727273,44,1150,700,450,0.6086956521739131,16,7,9,354.74106773911,0.4139028365045807,0.24115156729697484,0.20038775503270018,129927.00277970143,422.71118223205696,130349.71396193349,4593,5,663.2954545454545,37,7,15,36.07899548289956,0.6176801801801801,45.12061403508772,1019.5175438596491,27.554528212422948,3
4625,4,3,1,45,0.06521739130434782,0.021739130434782608,0.9782608695652174,46,950,700,250,0.7368421052631579,12,7,5,340.74745264723254,0.4167270531400966,0.23987241648039337,0.19512870413732417,130458.54403518386,-308.4510378193322,130150.09299736453,4594,0,635.2826086956521,37,9,18,35.89708328861222,0.6230292792792793,44.59978070175438,1021.6008771929821,27.610834518729245,0
4626,4,0,0,45,0.0,0.0,1.0,45,1350,1000,350,0.7407407407407407,17,10,7,348.4775528120798,0.4145622895622896,0.24967104054103761,0.19913944086028687,130377.57087746532,86.73136819252272,130464.30224565785,4595,1,650.4,36,9,18,35.781692211563204,0.6241319444444444,44.679054054054056,1021.283783783784,28.368993993994,0
4627,4,0,0,45,0.0,0.0,1.0,45,800,400,400,0.5,12,4,8,348.4521842980525,0.41390993265993264,0.24537761612599085,0.1997161508614168,130492.60567577698,94.08669649377651,130586.69237227076,4596,2,651.4,36,9,14,35.665803299166036,0.6252893518518519,44.566441441441434,1021.7342342342331,28.381506506506476,0
4628,4,1,2,44,0.021739130434782608,0.043478260869565216,0.9565217391304348,46,1200,700,500,0.5833333333333334,17,7,10,338.2757554877251,0.41582125603864734,0.24060135015503614,0.1957502664837426,130863.1260158703,-346.4354362992309,130516.69057957106,4597,0,638.2173913043479,38,8,15,35.55110333785807,0.6252741228070176,44.20405982905982,1023.1837606837597,26.925888439046307,0
4629,4,0,0,44,0.0,0.0,1.0,44,850,600,250,0.7058823529411765,11,6,5,353.03854472599795,0.4123612579281184,0.24555221637866254,0.20264546447744652,130550.14209733371,417.84643596297883,130967.98853329668,4598,1,668.0909090909091,36,8,16,35.49035812672176,0.6258680555555556,44.51013513513513,1021.9594594594586,28.387762762762737,0
4630,4,0,0,44,0.0,0.0,1.0,44,950,600,350,0.631578947368421,13,6,7,352.6071035532466,0.41189878435517974,0.24314753080858176,0.2033031814201287,130722.82745160679,418.75951120036234,131141.58696280717,4599,2,669.0909090909091,36,8,17,35.32650589142165,0.6276041666666667,44.3412162162162,1022.6351351351333,28.40653153153148,0
4631,4,2,1,45,0.043478260869565216,0.021739130434782608,0.9782608695652174,46,1250,700,550,0.56,18,7,11,337.9132931746294,0.41943438003220607,0.24077904628045865,0.19750760932613365,131248.05908203122,-329.9072265624995,130918.15185546872,4600,0,640.9565217391304,39,7,18,35.171736810003054,0.6274038461538463,43.828125,1024.6874999999998,26.274038461538456,0
4632,4,0,0,45,0.0,0.0,1.0,45,1000,700,300,0.7,13,7,6,343.88504329681655,0.4166666666666667,0.24529513345618503,0.20041494894143302,131136.55495516447,19.17997571039706,131155.73493087487,4601,1,656.2,38,7,18,35.13134105211918,0.6280153508771931,43.9369658119658,1024.2521367521347,26.954003598740385,0
4633,4,0,0,45,0.0,0.0,1.0,45,1350,900,450,0.6666666666666666,18,9,9,343.706231621966,0.416540404040404,0.24454612212619398,0.20061429008914142,131194.69536675338,18.48687065971197,131213.1822374131,4602,2,657.2,39,6,18,35.07721148957803,0.6268696581196582,43.88020833333333,1024.4791666666658,26.26869658119656,0
4634,4,0,0,45,0.0,0.0,1.0,45,1250,800,450,0.64,17,8,9,338.75338753387535,0.4163720538720539,0.24317976513098483,0.19841269841269818,131328.12499999977,-102.36273871530773,131225.76226128446,4603,3,658.2,38,7,18,35.069444444444436,0.6299342105263159,43.749999999999986,1024.9999999999982,26.97368421052627,0
4635,4,0,0,45,0.0,0.0,1.0,45,850,500,350,0.5882352941176471,12,5,7,339.05223292809455,0.41651936026936026,0.24255013663100433,0.1988719576514663,131382.88498064104,-90.86789575575398,131292.0170848853,4604,4,659.2,38,7,18,35.00655655134084,0.630482456140351,43.69658119658118,1025.2136752136723,26.97930724246506,0
4636,4,0,1,44,0.0,0.022222222222222223,0.9777777777777777,45,1300,1000,300,0.7692307692307693,16,10,6,341.13129273055876,0.41578282828282825,0.24792787788309112,0.20080941394887114,131519.83486969428,-26.89374223833761,131492.94112745594,4605,5,660.2,38,7,18,34.81516682290037,0.6318530701754388,43.563034188034166,1025.7478632478603,26.993364822312113,0
4637,4,1,2,43,0.022222222222222223,0.044444444444444446,0.9555555555555556,45,1100,500,600,0.45454545454545453,17,5,12,343.97809613838336,0.4174031986531987,0.2451800957734751,0.20321362801385645,131656.85609796166,57.414940828378974,131714.27103879003,4606,0,660.6666666666666,38,7,14,34.604023526962315,0.6332236842105264,43.42948717948717,1026.2820512820497,27.007422402159204,0
4638,4,2,1,44,0.044444444444444446,0.022222222222222223,0.9777777777777777,45,1100,800,300,0.7272727272727273,14,8,6,340.50050700539924,0.4188131313131313,0.2525807271802696,0.20232211831581617,131876.23844875433,-19.214789246854934,131857.02365950748,4607,0,659.8,38,7,15,34.472297344150896,0.6354166666666667,43.21581196581196,1027.136752136751,27.029914529914503,0
4639,4,0,0,44,0.0,0.0,1.0,44,1150,800,350,0.6956521739130435,15,8,7,343.3103484978955,0.4166666666666667,0.255002695213868,0.2038444953743215,131848.8056674152,253.0118845423085,132101.8175519575,4608,1,675.7954545454545,38,6,16,34.427771420645655,0.6351425438596492,43.242521367521356,1027.0299145299127,27.027103013945073,0
4640,4,0,0,44,0.0,0.0,1.0,44,1250,800,450,0.64,17,8,9,345.8403619573844,0.4166005990133897,0.25683921464830295,0.20594097590985508,131958.55391418267,327.31880981077126,132285.87272399344,4609,2,676.7954545454545,38,6,17,34.25227895046966,0.6362390350877194,43.13568376068375,1027.4572649572629,27.038349077822705,0
4641,4,0,0,44,0.0,0.0,1.0,44,1750,1200,550,0.6857142857142857,23,12,11,347.4559672426078,0.41599497885835096,0.25548200152943257,0.20740157463900857,132049.81689453125,376.29937065972206,132426.11626519097,4610,3,677.7954545454545,39,5,17,34.118885341711426,0.6354166666666667,43.046875,1027.8125,26.354166666666668,0
4642,4,0,0,44,0.0,0.0,1.0,44,1500,1100,400,0.7333333333333333,19,11,8,342.36155793912747,0.41554351656095845,0.24383136612223089,0.20537533554623003,132237.24500868062,254.5898437500064,132491.83485243062,4611,4,678.7954545454545,39,5,17,34.061255148200665,0.6372863247863249,42.864583333333336,1028.5416666666672,26.37286324786326,0
4643,4,1,0,45,0.022222222222222223,0.0,1.0,45,800,500,300,0.625,11,5,6,338.7773494954599,0.4164983164983165,0.25724794512447535,0.20547535174369558,132652.03145438977,-11.806306988695269,132640.22514740107,4612,0,664.6888888888889,37,8,16,33.73680592513749,0.6449887387387387,42.46162280701754,1030.1535087719294,27.84198672356566,0
4644,4,0,1,44,0.0,0.022222222222222223,0.9777777777777777,45,750,300,450,0.4,12,3,9,340.2448148943048,0.4159722222222222,0.2572273060462038,0.206831873892411,132736.76155163112,32.5989727608366,132769.36052439196,4613,1,665.6888888888889,37,8,16,33.61397815137973,0.6458333333333334,42.379385964912274,1030.4824561403498,27.850877192982427,0
4645,4,0,0,44,0.0,0.0,1.0,44,1150,900,250,0.782608695652174,14,9,5,350.71053291114475,0.41712914023960534,0.26497437221869036,0.21341109023954766,132774.9370992614,513.1137894651382,133288.05088872655,4614,2,659.5909090909091,36,8,17,33.3060168997669,0.6481481481481481,42.34234234234234,1030.6306306306305,28.628628628628626,0
4646,4,0,0,44,0.0,0.0,1.0,44,1350,1000,350,0.7407407407407407,17,10,7,347.1811500974906,0.4167107117688513,0.26505162213371536,0.2120059438647273,132906.30290089257,428.51261926746616,133334.81552016005,4615,3,660.5909090909091,37,7,18,33.265099957464926,0.6475225225225225,42.21491228070175,1031.1403508771928,27.86865813181602,0
4647,4,0,0,44,0.0,0.0,1.0,44,1450,1000,450,0.6896551724137931,19,10,9,345.7192216603072,0.4164244186046511,0.26249685887151286,0.2114327047423179,132962.84072983998,393.56196137273304,133356.40269121272,4616,4,661.5909090909091,37,7,18,33.246066340633625,0.6480855855855856,42.16008771929825,1031.3596491228072,27.874585111427223,0
4648,4,0,0,44,0.0,0.0,1.0,44,900,600,300,0.6666666666666666,12,6,6,343.9518502358558,0.41625924947145876,0.26013536362670187,0.21083016018691655,133047.67001625508,352.39845433211116,133400.0684705872,4617,5,662.5909090909091,37,7,19,33.2065708364332,0.6489301801801801,42.077850877192986,1031.6885964912287,27.88347558084402,0
4649,4,0,0,44,0.0,0.0,1.0,44,850,500,350,0.5882352941176471,12,5,7,344.03510538658105,0.4161931818181818,0.26070314235758985,0.21120119874710472,133104.23790252768,358.5061028393342,133462.744005367,4618,6,663.5909090909091,37,7,19,33.147712782913615,0.6494932432432432,42.02302631578947,1031.9078947368419,27.889402560455185,0
4650,4,0,1,43,0.0,0.022727272727272728,0.9772727272727273,44,1200,700,500,0.5833333333333334,17,7,10,349.90084078231564,0.4153893587033122,0.2690734157214605,0.21597327758632584,133306.67529585792,528.8235535831618,133835.49884944106,4619,7,664.5909090909091,38,6,19,32.79342540864887,0.649671052631579,41.82692307692307,1032.6923076923072,27.17611336032387,0
4651,4,0,0,43,0.0,0.0,1.0,43,900,600,300,0.6666666666666666,12,6,6,359.4085098834105,0.41242155777039496,0.27331447838061473,0.22131007982683526,133217.40974386354,975.8941453139494,134193.30388917748,4620,8,680.7674418604652,37,6,19,32.63752434059126,0.6506193693693694,41.91337719298246,1032.3464912280706,27.901256519677585,0
4652,4,0,1,42,0.0,0.023255813953488372,0.9767441860465116,43,700,400,300,0.5714285714285714,10,4,6,360.0029240555929,0.4121677740863787,0.2713556919703488,0.22218266964322242,133302.32018505692,997.8450100030764,134300.16519506,4621,9,681.7674418604652,37,6,19,32.53698591349897,0.651463963963964,41.83114035087719,1032.6754385964912,27.910146989094358,0
4653,4,0,0,42,0.0,0.0,1.0,42,1650,1000,650,0.6060606060606061,23,10,13,364.9001753070845,0.4108836624080527,0.2839123208320302,0.22642590577847055,133502.97796201822,1343.268425214048,134846.24638723227,4622,10,694.452380952381,34,8,20,32.20923088737857,0.6596200980392156,41.636904761904766,1033.4523809523816,30.395658263305343,0
4654,4,0,0,42,0.0,0.0,1.0,42,1100,700,400,0.6363636363636364,15,7,8,365.29896804129123,0.41073848238482386,0.2850044127239939,0.2278070448940918,133687.5868055556,1367.187500000006,135054.7743055556,4623,11,695.452380952381,34,8,20,32.01383293043243,0.6614583333333333,41.458333333333336,1034.166666666667,30.416666666666675,0
4655,4,0,1,41,0.0,0.023809523809523808,0.9761904761904762,42,750,500,250,0.6666666666666666,10,5,5,368.19906121438436,0.4103876306620209,0.2872325265281066,0.22980700027518486,133718.3673469388,1446.9954648526132,135165.3628117914,4624,12,696.452380952381,34,8,16,31.907995702885216,0.661764705882353,41.42857142857143,1034.2857142857144,30.420168067226896,0
4656,4,0,0,41,0.0,0.0,1.0,41,1100,600,500,0.5454545454545454,16,6,10,367.5439074164831,0.41016260162601625,0.2721024311692386,0.23055026919761218,133903.12500000003,1643.0555555555566,135546.1805555556,4625,13,686.0975609756098,34,7,16,31.739801395598487,0.6636029411764706,41.25,1035.0000000000002,30.441176470588243,0
4657,4,0,0,41,0.0,0.0,1.0,41,1250,900,350,0.72,16,9,7,364.9829412694912,0.4094512195121951,0.2726087212579611,0.22951964137532638,133995.55165816317,1581.2181122448808,135576.76977040805,4626,14,687.0975609756098,34,7,17,31.713521904104848,0.6645220588235294,41.16071428571428,1035.357142857142,30.451680672268882,0
4658,4,0,0,41,0.0,0.0,1.0,41,1450,1100,350,0.7586206896551724,18,11,7,369.6387622657923,0.4089176829268293,0.27733846123658346,0.2332289246174516,134118.8368055555,1715.104166666662,135833.94097222216,4627,15,688.0975609756098,34,7,18,31.469562885492078,0.6657475490196079,41.041666666666664,1035.833333333333,30.465686274509796,0
4659,4,0,1,40,0.0,0.024390243902439025,0.975609756097561,41,1000,700,300,0.7,13,7,6,369.79120907899,0.40815548780487804,0.2813732962697273,0.23391443923136102,134211.33786848068,1726.0345804988597,135937.37244897953,4628,16,689.0975609756098,34,7,18,31.37302772671569,0.6666666666666667,40.95238095238095,1036.190476190476,30.476190476190467,0
4660,4,0,0,40,0.0,0.0,1.0,40,1200,1000,200,0.8333333333333334,14,10,4,378.3611201385782,0.4086404914529915,0.2778513961192619,0.23864986473218386,134106.1430699731,2148.1101018838935,136254.25317185698,4629,17,698.525,33,7,19,31.25640873954882,0.6679292929292929,41.05392156862745,1035.7843137254904,31.387403446226983,0
4661,4,0,0,40,0.0,0.0,1.0,40,800,300,500,0.375,13,3,10,378.63108724974893,0.40769230769230774,0.27507096392667063,0.2394409755195683,134201.36072964728,2162.5614246924233,136363.9221543397,4630,18,699.525,33,7,19,31.154026217228463,0.6688762626262627,40.96200980392157,1036.1519607843138,31.398544266191326,0
4662,4,0,0,40,0.0,0.0,1.0,40,1000,500,500,0.5,15,5,10,383.4373263574763,0.4067307692307693,0.27937248877333953,0.24395839516067405,134423.66667868133,2308.6102700884326,136732.27694876975,4631,19,700.525,33,7,19,30.806842354053416,0.6710858585858586,40.747549019607845,1037.009803921569,31.42453951277482,0
4663,4,0,0,40,0.0,0.0,1.0,40,1050,700,350,0.6666666666666666,14,7,7,400.53970995466034,0.4065972222222222,0.3227154356060611,0.2517678176857865,133979.23875432528,2732.861159169556,136712.09991349484,4632,20,701.525,33,7,16,30.809560448232336,0.6666666666666666,41.1764705882353,1035.294117647059,31.37254901960785,1
4664,4,0,0,40,0.0,0.0,1.0,40,1050,800,250,0.7619047619047619,13,8,5,402.94078353420326,0.40661057692307695,0.3259054325955735,0.2534956574892392,134010.95920138882,2799.6961805555447,136810.65538194435,4633,21,702.525,33,7,16,30.71554325955735,0.6669823232323233,41.14583333333333,1035.416666666666,31.37626262626261,0
4665,4,0,0,40,0.0,0.0,1.0,40,950,700,250,0.7368421052631579,12,7,5,404.25271721784486,0.4059294871794872,0.3246095598674872,0.25498089297949444,134106.14306997307,2842.554546328336,136948.69761630142,4634,22,703.525,33,7,17,30.585955986748697,0.6679292929292929,41.05392156862745,1035.7843137254902,31.387403446226976,0
4666,4,0,0,40,0.0,0.0,1.0,40,1050,600,450,0.5714285714285714,15,6,9,407.15520891045776,0.4054487179487179,0.32650189214758774,0.25770242863374476,134233.10745866972,2930.7417820069177,137163.84924067665,4635,23,704.525,33,7,17,30.383258435824665,0.6691919191919192,40.931372549019606,1036.2745098039213,31.4022578728461,0
4667,4,0,0,40,0.0,0.0,1.0,40,500,400,100,0.8,6,4,2,405.96013037254016,0.40526175213675214,0.3280503665169072,0.2573921126454979,134296.61218041123,2903.8140378700296,137200.42621828127,4636,24,705.525,33,7,17,30.35045716087333,0.6698232323232324,40.87009803921568,1036.519607843136,31.40968508615564,0
4668,4,0,0,40,0.0,0.0,1.0,40,500,200,300,0.4,8,2,6,398.4576129246429,0.40500801282051285,0.29512433392539994,0.2498125123347149,133884.09994052773,2669.668066368713,136553.76800689643,4637,25,706.525,33,7,15,30.95902407736334,0.6657196969696969,41.26838235294118,1034.9264705882356,31.361408199643503,2
4669,4,0,0,40,0.0,0.0,1.0,40,600,300,300,0.5,9,3,6,403.08453661186655,0.40520833333333334,0.2959011041196722,0.24800445959691397,133187.4478115389,2737.160136726266,135924.60794826518,4638,26,707.525,33,7,16,31.540499228303453,0.6587752525252526,41.942401960784316,1032.2303921568632,31.27970885323828,1
4670,4,0,0,40,0.0,0.0,1.0,40,1050,800,250,0.7619047619047619,13,8,5,403.08453661186655,0.4048611111111111,0.2959011041196722,0.24800445959691397,133187.4478115389,2737.160136726266,135924.60794826518,4639,27,708.525,33,7,16,31.540499228303453,0.6587752525252526,41.942401960784316,1032.2303921568632,31.27970885323828,0
4671,4,1,1,40,0.024390243902439025,0.024390243902439025,0.975609756097561,41,1050,600,450,0.5714285714285714,15,6,9,390.90875036081917,0.4068089430894309,0.28419227862362706,0.24256460771138472,133502.9779620181,2237.4964569160943,135740.4744189342,4640,0,692.219512195122,34,7,17,31.537265292017043,0.6596200980392157,41.63690476190476,1033.4523809523807,30.395658263305315,0
4672,4,0,0,40,0.0,0.0,1.0,40,1350,1100,250,0.8148148148148148,16,11,5,400.01013158394636,0.4043402777777778,0.29682680901542113,0.24758336338125328,133408.91273788936,2672.9833477508782,136081.89608564024,4641,29,710.525,33,7,17,31.396797153024917,0.6609848484848484,41.727941176470594,1033.0882352941185,31.30570409982177,0
4673,4,1,2,39,0.024390243902439025,0.04878048780487805,0.9512195121951219,41,1700,1100,600,0.6470588235294118,23,11,12,388.5110233434097,0.4066056910569105,0.2801327978761321,0.24309210251098448,133810.73022959186,2197.3887471655353,136008.1189767574,4642,0,694.170731707317,34,7,14,31.290031833697697,0.6626838235294117,41.339285714285715,1034.6428571428573,30.430672268907568,0
4674,4,0,0,39,0.0,0.0,1.0,39,1100,900,200,0.8181818181818182,13,9,4,419.82253603557655,0.40488641475483583,0.248707765135735,0.23521951799862484,129606.62853529895,3082.356695742026,132688.98523104098,4643,31,717.7948717948718,33,6,15,34.747838688971804,0.622790404040404,45.435049019607845,1018.2598039215688,30.856357694592994,7
4675,4,0,0,39,0.0,0.0,1.0,39,900,700,200,0.7777777777777778,11,7,4,417.57102052935545,0.40452091767881243,0.24172827853809453,0.23470371153891356,129731.44531249999,3034.418402777777,132765.86371527775,4644,32,718.7948717948718,33,6,15,34.67748807089299,0.6240530303030303,45.3125,1018.7499999999999,30.871212121212118,0
4676,4,1,0,40,0.025,0.0,1.0,40,1100,700,400,0.6363636363636364,15,7,8,407.51638302999925,0.40739850427350427,0.23862310385064167,0.23128578824947643,130110.7213718821,2604.450113378683,132715.17148526077,4645,0,701.8,34,6,17,34.546382730455065,0.6256127450980392,44.94047619047619,1020.2380952380954,30.007002801120453,0
4677,4,1,0,41,0.024390243902439025,0.0,1.0,41,1150,900,250,0.782608695652174,14,9,5,399.16478166526036,0.4097052845528455,0.23366181358550642,0.22853280356879213,130450.3075740101,2214.4108623841867,132664.7184363943,4646,0,685.6585365853658,33,8,20,34.41348768394115,0.6313131313131313,44.60784313725491,1021.5686274509814,30.95662507427216,0
4678,4,2,2,41,0.046511627906976744,0.046511627906976744,0.9534883720930233,43,1200,1000,200,0.8333333333333334,14,10,4,385.326478235293,0.4168050941306755,0.21519434448090324,0.22299849562075616,130866.81909950497,1485.29010429349,132352.10920379846,4647,0,654.7209302325581,36,7,15,34.34381649424022,0.6290509259259258,44.200450450450454,1023.1981981981987,28.422172172172186,0
4679,4,0,0,41,0.0,0.0,1.0,41,1050,500,550,0.47619047619047616,16,5,11,402.7817218336737,0.4089176829268293,0.23125859111408986,0.2318424548999728,130657.85147392303,2325.318877551036,132983.17035147408,4648,2,687.6585365853658,34,7,15,34.10985289551313,0.6311274509803921,44.40476190476191,1022.3809523809534,30.070028011204514,0
4680,4,0,0,41,0.0,0.0,1.0,41,800,600,200,0.75,10,6,4,402.72223251760636,0.4092987804878048,0.23062396883137515,0.23199069450662152,130688.28125000025,2326.2152777778083,133014.49652777804,4649,3,688.6585365853658,34,7,16,34.08041293126868,0.6314338235294116,44.375000000000014,1022.5000000000019,30.073529411764763,0
4681,4,0,0,41,0.0,0.0,1.0,41,1000,700,300,0.7,13,7,6,414.25910793467807,0.4085873983739838,0.20396403556703624,0.23929555528932542,130794.81336805534,2636.5885416666424,133431.401909722,4650,4,689.6585365853658,35,6,16,33.677019687712146,0.6303571428571428,44.27083333333332,1022.9166666666649,29.226190476190425,3
4682,4,2,2,41,0.046511627906976744,0.046511627906976744,0.9534883720930233,43,850,600,250,0.7058823529411765,11,6,5,400.08473700467886,0.4132751937984496,0.19545833488869824,0.23382062960029515,131243.84576263835,1901.7319030855444,133145.5776657239,4651,0,658.5348837209302,37,6,16,33.58335562689495,0.6309121621621623,43.83223684210525,1024.6710526315776,27.693812233285882,0
4683,4,1,1,41,0.023809523809523808,0.023809523809523808,0.9761904761904762,42,750,600,150,0.8,9,6,3,408.82497182404626,0.41019405729771585,0.19209385601206197,0.23837640664817447,131155.0401753103,2323.8911208505656,133478.93129616088,4652,0,675.1904761904761,36,6,16,33.4496848431545,0.6319444444444444,43.91891891891891,1024.3243243243232,28.453453453453424,0
4684,4,1,3,39,0.023809523809523808,0.07142857142857142,0.9285714285714286,42,1050,700,350,0.6666666666666666,14,7,7,409.3981337219906,0.410774777390631,0.19143673738595157,0.23888998219813645,131183.87972009165,2341.2871063631146,133525.16682645475,4653,0,676.1666666666666,36,6,16,33.40570151331941,0.6322337962962963,43.890765765765764,1024.4369369369365,28.45658158158157,0
4685,4,0,0,39,0.0,0.0,1.0,39,750,600,150,0.8,9,6,3,433.9042728975251,0.404942645074224,0.20097551386482881,0.25084715167233645,130826.15460399837,3553.2054978854176,134379.3601018838,4654,9,704.025641025641,33,6,16,33.142668902731195,0.6351010101010102,44.24019607843137,1023.0392156862738,31.00118835412951,0
4686,4,2,2,39,0.04878048780487805,0.04878048780487805,0.9512195121951219,41,750,500,250,0.6666666666666666,10,5,5,416.4991447448624,0.41201727642276426,0.1875392635535036,0.24319593860696034,131209.5175325787,2729.730366941001,133939.2478995197,4655,0,670.6341463414634,35,6,16,33.197770748606715,0.6345238095238095,43.86574074074073,1024.5370370370358,29.272486772486737,0
4687,4,0,0,39,0.0,0.0,1.0,39,900,500,400,0.5555555555555556,13,5,8,438.04750921155033,0.40350877192982454,0.20984379605069337,0.2540675553426991,130951.55709342555,3672.6006824298333,134624.1577758554,4656,11,706.025641025641,33,6,16,32.90878432311622,0.6363636363636364,44.11764705882353,1023.5294117647055,31.016042780748652,0
4688,4,0,0,39,0.0,0.0,1.0,39,1050,800,250,0.7619047619047619,13,8,5,440.2215376347866,0.4031151596941071,0.20884821028464828,0.255744834867942,131014.28086553243,3735.0616349480943,134749.34250048053,4657,12,707.025641025641,33,6,16,32.78918282659006,0.6369949494949496,44.056372549019606,1023.7745098039212,31.023469994058217,0
4689,4,1,1,39,0.025,0.025,0.975,40,900,500,400,0.5555555555555556,13,5,8,430.9092578940904,0.40502136752136747,0.2016674635429121,0.25280412703660277,131390.93888167996,3323.889850057654,134714.82873173762,4658,0,690.325,33,7,16,32.64403538130529,0.6407828282828283,43.68872549019607,1025.2450980392143,31.068033273915585,0
4690,4,1,0,40,0.025,0.0,1.0,40,1350,1000,350,0.7407407407407407,17,10,7,428.62693548348693,0.4064636752136752,0.2114173933819139,0.25250077951669714,131548.0392907774,3277.0065900134346,134825.04588079083,4659,0,691.3,33,7,17,32.54278162704575,0.6423611111111112,43.53553921568626,1025.8578431372534,31.086601307189497,0
4691,4,0,0,40,0.0,0.0,1.0,40,1150,800,350,0.6956521739130435,15,8,7,431.6241731988694,0.40669070512820515,0.21685574396942964,0.2548956859215322,131642.34459102247,3364.0036284121234,135006.34821943459,4660,1,692.3,33,7,16,32.37003423294324,0.6433080808080809,43.44362745098038,1026.2254901960766,31.097742127153836,0
4692,4,0,0,40,0.0,0.0,1.0,40,950,500,450,0.5263157894736842,14,5,9,433.7172901255955,0.40647702991452994,0.21469921222248778,0.2569790280531991,131768.137555267,3430.023909073404,135198.1614643404,4661,2,693.3,33,7,16,32.18846980186201,0.6445707070707072,43.321078431372534,1026.715686274508,31.11259655377297,0
4693,4,1,0,41,0.024390243902439025,0.0,1.0,41,950,700,250,0.7368421052631579,12,7,5,425.38005233722936,0.41074695121951216,0.20372251909864314,0.25425475268231923,132100.3796403461,3038.573281035632,135138.95292138174,4662,0,677.3658536585366,35,6,17,32.06531937251369,0.6434523809523811,42.99768518518517,1028.009259259257,29.37169312169306,0
4694,4,0,0,41,0.0,0.0,1.0,41,1000,500,500,0.5,15,5,10,422.69119185689044,0.41023882113821136,0.19645577124163305,0.253643256045387,132249.14969403707,2980.1101412465564,135229.25983528362,4663,1,678.3658536585366,35,6,17,31.98363245939763,0.6449404761904762,42.85300925925925,1028.587962962962,29.388227513227484,0
4695,4,0,1,40,0.0,0.024390243902439025,0.975609756097561,41,950,800,150,0.8421052631578947,11,8,3,422.9950922441012,0.40988313008130084,0.20090053752376913,0.2542260564542131,132308.68115837176,2993.1845582561527,135301.86571662792,4664,2,679.3658536585366,35,6,18,31.915499493756318,0.6455357142857143,42.79513888888888,1028.8194444444432,29.394841269841233,0
4696,4,0,0,40,0.0,0.0,1.0,40,800,600,200,0.75,10,6,4,432.5083044123104,0.4092548076923077,0.21077455281809043,0.2599436320433418,132308.68115837182,3444.9206693672786,135753.6018277391,4665,3,695.675,35,5,18,31.670815052311855,0.6455357142857143,42.795138888888886,1028.819444444444,29.394841269841255,0
4697,4,0,0,40,0.0,0.0,1.0,40,800,400,400,0.5,12,4,8,435.18169450408993,0.4093883547008547,0.21366396761133633,0.2621704354695368,132398.00347222204,3523.497781635778,135921.50125385783,4666,4,696.675,33,7,18,31.511470985155192,0.6508838383838385,42.70833333333332,1029.1666666666652,31.186868686868642,0
4698,4,0,0,40,0.0,0.0,1.0,40,1050,700,350,0.6666666666666666,14,7,7,432.65098056498573,0.4090811965811966,0.21555272895467192,0.2612825195479045,132489.90929705199,3464.3778344670945,135954.2871315191,4667,5,697.675,34,6,18,31.48343547641072,0.6495098039215688,42.619047619047606,1029.523809523808,30.280112044817884,0
4699,4,1,1,40,0.024390243902439025,0.024390243902439025,0.975609756097561,41,1450,1200,250,0.8275862068965517,17,12,5,424.26074662880836,0.41183943089430897,0.21093083745522767,0.258167177735828,132774.9370992614,3066.238789465139,135841.17588872655,4668,0,681.6341463414634,36,5,15,31.410939321095576,0.6481481481481481,42.34234234234234,1030.6306306306305,28.628628628628626,0
4700,4,0,0,40,0.0,0.0,1.0,40,950,500,450,0.5263157894736842,14,5,9,432.081562587161,0.4082665598290598,0.20469348659003828,0.25060730630055333,130951.55709342561,3350.4515062266037,134302.0085996522,4669,7,699.675,33,7,19,33.06144236909323,0.6363636363636364,44.11764705882353,1023.529411764706,31.016042780748666,5
4701,4,1,1,40,0.024390243902439025,0.024390243902439025,0.975609756097561,41,1200,1000,200,0.8333333333333334,14,10,4,427.5721800132999,0.4102642276422764,0.19941979155474376,0.24985455509292032,131239.16437596444,3022.843123070977,134262.00749903542,4670,0,683.5853658536586,35,6,19,32.88398000677735,0.6348214285714286,43.83680555555555,1024.6527777777771,29.275793650793634,0
4702,4,0,0,40,0.0,0.0,1.0,40,1000,600,400,0.6,14,6,8,438.98322187445035,0.407545405982906,0.22620474484122077,0.25178534476470077,130520.50053884815,3464.3859084851133,133984.88644733327,4671,9,701.675,32,8,18,33.32483833765805,0.6344401041666666,44.53914141414142,1021.843434343435,31.932607323232343,2
4703,4,0,0,40,0.0,0.0,1.0,40,1000,800,200,0.8,12,8,4,438.29753303974826,0.40738514957264954,0.2237029030265596,0.25181110929430545,130585.01882779824,3447.0183208346157,134032.03714863287,4672,10,702.675,32,8,18,33.27645666049001,0.6350911458333333,44.476010101010104,1022.09595959596,31.94049873737375,0
4704,4,2,0,42,0.047619047619047616,0.0,1.0,42,700,500,200,0.7142857142857143,9,5,4,419.8356033182252,0.4137993612078978,0.23020852351629673,0.24531738206109735,131236.62308673467,2619.561366213156,133856.18445294784,4673,0,670.1666666666666,34,8,20,33.08474691142869,0.6369485294117647,43.839285714285715,1024.642857142857,30.136554621848738,0
4705,4,1,0,43,0.023255813953488372,0.0,1.0,43,950,600,350,0.631578947368421,13,6,7,412.63759462863686,0.41313676633444074,0.2294325322277646,0.2428473712650502,131511.2244897959,2253.3269557823096,133764.5514455782,4674,0,655.5581395348837,34,9,21,32.990221680594246,0.6397058823529411,43.57142857142857,1025.7142857142853,30.168067226890745,0
4706,4,0,2,41,0.0,0.046511627906976744,0.9534883720930233,43,1450,1100,350,0.7586206896551724,18,11,7,392.5320579139055,0.41244462901439644,0.21216603203574902,0.23206495263870097,131684.26890432098,1746.9986142605198,133431.2675185815,4675,1,656.5581395348837,35,8,16,33.330514208389715,0.6392857142857142,43.40277777777778,1026.388888888889,29.325396825396826,3
4707,4,0,0,41,0.0,0.0,1.0,41,1250,700,550,0.56,18,7,11,401.95037078549194,0.4084603658536585,0.23318217839218103,0.23689415469698136,131565.50068587105,2376.5603566529503,133942.061042524,4676,3,689.5121951219512,35,6,16,33.209235860409144,0.638095238095238,43.51851851851852,1025.9259259259259,29.31216931216931,0
4708,4,1,0,42,0.023809523809523808,0.0,1.0,42,1050,800,250,0.7619047619047619,13,8,5,396.9679241220385,0.4119362175764614,0.2336601563111813,0.23587911634639186,131876.97991488117,2070.186191258834,133947.16610614,4677,0,674.0714285714286,36,6,17,33.02155282680994,0.6391782407407407,43.215090090090094,1027.13963963964,28.53165665665667,0
4709,4,1,0,43,0.023255813953488372,0.0,1.0,43,1250,800,450,0.64,17,8,9,391.07486650837336,0.4132751937984496,0.22368603659866326,0.23524657354580622,132341.58587257622,1751.09360572484,134092.67947830106,4678,0,659.3720930232558,37,6,19,32.70327152600169,0.6418918918918919,42.76315789473684,1028.947368421053,27.809388335704135,0
4710,4,0,0,43,0.0,0.0,1.0,43,1000,600,400,0.6,14,6,8,394.0830648972,0.4123292727943891,0.21476908160209907,0.23823183055868513,132527.980642919,1845.4666739303107,134373.4473168493,4679,1,660.3720930232558,32,11,19,32.43766605354589,0.6546223958333335,42.5820707070707,1029.6717171717162,32.17724116161613,0
4711,4,0,0,43,0.0,0.0,1.0,43,1250,900,350,0.72,16,9,7,396.0478857659376,0.4112218530823182,0.22319426198909698,0.2406661798760846,132723.06596584534,1912.937933629223,134636.00389947457,4680,2,661.3720930232558,32,11,18,32.190193195278354,0.6565755208333334,42.39267676767677,1030.429292929293,32.20091540404041,0
4712,4,0,1,42,0.0,0.023255813953488372,0.9767441860465116,43,1250,800,450,0.64,17,8,9,393.88335122693366,0.41099114064230347,0.2138908272689728,0.24018353717460134,132853.20255905003,1865.732929037848,134718.93548808788,4681,3,662.3720930232558,32,11,18,32.114717289242705,0.6578776041666667,42.26641414141414,1030.934343434343,32.21669823232322,0
4713,4,0,0,42,0.0,0.0,1.0,42,900,800,100,0.8888888888888888,10,8,2,402.38737004235674,0.408415602013163,0.21961237325118788,0.24473067915690883,132755.5941358025,2283.8348765432174,135039.42901234573,4682,4,678.6904761904761,32,10,18,31.99404761904763,0.6569010416666666,42.361111111111114,1030.5555555555557,32.204861111111114,0
4714,4,0,1,41,0.0,0.023809523809523808,0.9761904761904762,42,1450,1300,150,0.896551724137931,16,13,3,402.3128808947806,0.40860917537746805,0.22301936345678186,0.24544294901869373,132871.3884833957,2291.174217848892,135162.5627012446,4683,5,679.6904761904761,33,9,18,31.879110701691825,0.6556186868686869,42.248774509803916,1031.0049019607836,31.242572786690413,0
4715,4,0,0,41,0.0,0.0,1.0,41,950,800,150,0.8421052631578947,11,8,3,401.8921973016672,0.4081808943089431,0.2119867747329014,0.24601648179550048,132997.76715986637,2490.1529760188373,135487.92013588522,4684,6,686.7073170731708,33,8,18,31.76247970377411,0.6568813131313131,42.12622549019608,1031.4950980392155,31.25742721330956,0
4716,4,0,1,40,0.0,0.024390243902439025,0.975609756097561,41,1300,900,400,0.6923076923076923,17,9,8,398.2938484887809,0.40805386178861786,0.2050634378077747,0.24443397990346455,133092.5905901576,2401.992022299111,135494.58261245672,4685,7,687.7073170731708,33,8,18,31.7596991290578,0.6578282828282829,42.03431372549019,1031.8627450980389,31.268568033273905,0
4717,4,0,0,40,0.0,0.0,1.0,40,950,700,250,0.7368421052631579,12,7,5,407.68851619130805,0.40379273504273505,0.21192138133725247,0.2488179688503903,132885.746671258,2835.19857667585,135720.94524793385,4686,8,705.7,32,8,18,31.7260592701445,0.658203125,42.234848484848484,1031.060606060606,32.22064393939394,0
4718,4,1,0,41,0.024390243902439025,0.0,1.0,41,900,600,300,0.6666666666666666,12,6,6,423.5263681050094,0.4054115853658537,0.2721087210872106,0.25060184662982,131716.66953627186,2967.4629820936707,134684.13251836554,4687,0,689.4634146341464,32,9,17,32.502306273062736,0.646484375,43.371212121212125,1026.515151515152,32.0785984848485,3
4719,4,0,0,41,0.0,0.0,1.0,41,900,700,200,0.7777777777777778,11,7,4,408.16538702111984,0.40538617886178857,0.262995279486568,0.2280436094957894,129495.73072059314,2372.8926425803884,131868.62336317354,4688,1,690.4634146341464,35,6,18,35.157967553635046,0.6172619047619048,45.543981481481474,1017.824074074073,29.0806878306878,5
4720,4,1,1,41,0.023809523809523808,0.023809523809523808,0.9761904761904762,42,850,600,250,0.7058823529411765,11,6,5,398.20343803943797,0.4086454703832753,0.25563729746512376,0.22422793471181546,129803.15778193736,1937.6127394286198,131740.77052136598,4689,0,675.0,36,6,18,35.09757063395586,0.6183449074074074,45.24211711711712,1019.0315315315316,28.306431431431434,0
4721,4,0,0,41,0.0,0.0,1.0,41,900,600,300,0.6666666666666666,12,6,6,406.97407459631785,0.40475101626016263,0.2576567736355855,0.22823230607858488,129643.02722318661,2352.27020640431,131995.29742959092,4690,3,692.4634146341464,35,6,18,35.03771735424481,0.61875,45.39930555555555,1018.4027777777768,29.097222222222193,0
4722,4,0,0,41,0.0,0.0,1.0,41,1250,1000,250,0.8,15,10,5,405.88093347350906,0.40503048780487805,0.25471792200884336,0.22847670961002395,129790.40745027438,2335.8903463648903,132126.29779663926,4691,4,693.4634146341464,35,6,18,34.91500075723159,0.6202380952380953,45.25462962962963,1018.9814814814816,29.113756613756617,0
4723,4,1,0,42,0.023809523809523808,0.0,1.0,42,1050,800,250,0.7619047619047619,13,8,5,396.60317107018466,0.4077864885791715,0.25141269666051613,0.22497358338915496,130090.20580969493,1918.8376298596008,132009.04343955455,4692,0,677.9285714285714,36,6,19,34.8456415351216,0.6212384259259258,44.96058558558559,1020.1576576576584,28.337712712712733,0
4724,4,1,1,42,0.023255813953488372,0.023255813953488372,0.9767441860465116,43,1300,1100,200,0.8461538461538461,15,11,4,388.91712452831524,0.41055278700627534,0.24864845457063445,0.22208441342712612,130348.82010388773,1539.091794497209,131887.91189838495,4693,0,663.1395348837209,36,7,19,34.778433318629624,0.6238425925925926,44.70720720720721,1021.1711711711716,28.365865865865878,0
4725,4,0,0,42,0.0,0.0,1.0,42,1550,1100,450,0.7096774193548387,20,11,9,396.9317653086015,0.4074961285327139,0.2563126814997141,0.22650271885850468,130321.66950660151,1945.7620670438994,132267.43157364542,4694,2,679.9285714285714,35,7,19,34.601469810322676,0.6255952380952381,44.7337962962963,1021.0648148148149,29.173280423280424,0
4726,4,0,0,42,0.0,0.0,1.0,42,1250,800,450,0.64,17,8,9,390.17691342658617,0.407508226867983,0.25422493720735484,0.20780867516257612,127590.03371229615,1556.5371075715643,129146.57081986772,4695,3,680.9285714285714,37,5,16,37.568283771072984,0.5940315315315314,47.42324561403509,1010.3070175438602,27.30559506875298,6
4727,4,0,0,42,0.0,0.0,1.0,42,1100,600,500,0.5454545454545454,16,6,10,388.3570437219045,0.4073872435152923,0.24864023057970286,0.20755151223607202,127728.54538175224,1520.8560566712981,129249.40143842353,4696,4,681.9285714285714,37,5,16,37.471865169758104,0.5954391891891891,47.28618421052632,1010.855263157896,27.320412517780973,0
4728,4,1,1,42,0.023255813953488372,0.023255813953488372,0.9767441860465116,43,750,500,250,0.6666666666666666,10,5,5,380.3195945952533,0.4102990033222591,0.24577330249795293,0.20456392812282898,127986.37695312513,1135.1453993055698,129121.52235243071,4697,0,667.046511627907,39,4,16,37.41035275547322,0.5945512820512819,47.03125000000001,1011.875000000001,25.945512820512846,0
4729,4,1,0,43,0.023255813953488372,0.0,1.0,43,1250,600,650,0.48,19,6,13,378.9395919760252,0.4105066445182724,0.25093877668243847,0.2042238499850826,128065.44189453138,1105.8132595486259,129171.25515408,4698,0,668.0232558139535,39,4,17,37.36417704366917,0.5953525641025641,46.95312500000001,1012.187500000001,25.953525641025667,0
4730,4,1,0,44,0.022727272727272728,0.0,1.0,44,850,600,250,0.7058823529411765,11,6,5,369.496698566296,0.41483879492600423,0.24562719501037855,0.20050023437763592,128338.88942992064,684.2324305916094,129023.12186051226,4699,0,653.8181818181819,37,7,18,37.3231387295747,0.601632882882883,46.68311403508771,1013.2675438596483,27.385609293504007,0
4731,4,1,1,44,0.022222222222222223,0.022222222222222223,0.9777777777777777,45,1350,1000,350,0.7407407407407407,17,10,7,363.7950475740312,0.4175715488215488,0.2482421349431989,0.1991332315164594,128685.96734832699,363.06352271895724,129049.03087104595,4700,0,640.2666666666667,38,7,17,37.112816327963195,0.6033442982456141,46.34081196581196,1014.636752136751,26.70096716149345,0
4732,4,1,1,44,0.022222222222222223,0.022222222222222223,0.9777777777777777,45,1100,800,300,0.7272727272727273,14,8,6,362.6574544175197,0.4160143097643098,0.2461772305821559,0.1993252625407567,128848.62075617258,345.58256172836946,129194.20331790094,4701,0,641.2222222222222,38,7,17,36.97560419516644,0.6049890350877194,46.18055555555554,1015.2777777777757,26.717836257309887,0
4733,4,0,0,44,0.0,0.0,1.0,44,1000,700,300,0.7,13,7,6,372.7054890016733,0.4130880021141649,0.25735788451482744,0.20340026014127227,128566.75347222242,783.5069444444653,129350.26041666689,4702,2,656.7954545454545,39,5,20,37.008696247603396,0.6004273504273504,46.45833333333334,1014.1666666666683,26.00427350427355,1
4734,4,0,0,44,0.0,0.0,1.0,44,1200,800,400,0.6666666666666666,16,8,8,370.0983211234999,0.41313204721634955,0.2517823482204511,0.20278390575844418,128725.26584201393,728.2009548611155,129453.46679687504,4703,3,657.7954545454545,39,5,20,36.912766030247056,0.6020299145299146,46.302083333333336,1014.7916666666671,26.020299145299155,0
4735,4,1,0,45,0.022222222222222223,0.0,1.0,45,1200,900,300,0.75,15,9,6,363.1497263137657,0.41544612794612795,0.2592970408151929,0.20072604275352907,129072.27143441392,374.5120092206889,129446.78344363462,4704,0,644.1555555555556,40,5,21,36.734923492349225,0.6039062500000001,45.96036585365853,1016.1585365853649,25.403963414634124,0
4736,4,0,0,45,0.0,0.0,1.0,45,1150,800,350,0.6956521739130435,15,8,7,365.3165999999999,0.4151304713804714,0.26048000000000004,0.2020556415929204,129098.08976138548,432.33504362483126,129530.4248050103,4705,1,645.1555555555556,40,5,21,36.65354166666666,0.6041666666666667,45.9349593495935,1016.2601626016265,25.40650406504066,0
4737,4,1,1,45,0.021739130434782608,0.021739130434782608,0.9782608695652174,46,1050,700,350,0.6666666666666666,14,7,7,362.3054265004792,0.4178743961352657,0.2585273319915218,0.2014550218878516,129307.31336805537,169.83088666631684,129477.14425472169,4706,0,632.1086956521739,39,7,21,36.516796394920114,0.607905982905983,45.72916666666666,1017.0833333333319,26.07905982905979,0
4738,4,2,3,44,0.0425531914893617,0.06382978723404255,0.9361702127659575,47,1200,900,300,0.75,15,9,6,355.8324521267662,0.4211763798951588,0.24607288704652652,0.1992781072027987,129589.12854658261,-177.5965240597666,129411.53202252284,4707,0,619.6170212765958,40,7,17,36.394600259506944,0.6091145833333333,45.45223577235772,1018.1910569105681,25.454776422764205,0
4739,4,2,3,43,0.043478260869565216,0.06521739130434782,0.9347826086956522,46,1300,1100,200,0.8461538461538461,15,11,4,354.92491249200236,0.4181561996779388,0.2481106072730508,0.19949227840067685,129731.44531249972,8.984374999971237,129740.4296874997,4708,0,631.4347826086956,39,7,17,36.27300613496932,0.6121794871794874,45.312499999999986,1018.7499999999978,26.121794871794815,0
4740,4,0,0,43,0.0,0.0,1.0,43,1000,500,500,0.5,15,5,10,371.6949752561954,0.4111987818383167,0.24586188610469017,0.20702172666242094,129373.18019032537,1017.4722019316512,130390.65239225702,4709,5,650.7906976744187,36,7,22,36.210888495314,0.6140046296296298,45.66441441441441,1017.3423423423416,28.25950950950949,0
4741,4,2,2,43,0.044444444444444446,0.044444444444444446,0.9555555555555556,45,950,700,250,0.7368421052631579,12,7,5,358.3054927245995,0.4165614478114478,0.23309915766663192,0.2016023294462832,129772.26382725155,299.622986521996,130071.88681377354,4710,0,622.8222222222222,38,7,17,36.14540736080528,0.6143092105263159,45.272435897435884,1018.9102564102543,26.81342780026985,0
4742,4,0,0,43,0.0,0.0,1.0,43,1150,800,350,0.6956521739130435,15,8,7,374.86490719711776,0.4101605758582503,0.2515332372916237,0.20970165600630877,129545.08562616687,1112.3813002191569,130657.46692638603,4711,7,652.7906976744187,36,7,17,35.95501474926254,0.6157407407407407,45.495495495495504,1018.0180180180193,28.278278278278314,0
4743,4,0,0,43,0.0,0.0,1.0,43,650,500,150,0.7692307692307693,8,5,3,377.64877012426757,0.4099298634182355,0.2538101619752904,0.2114131597952638,129573.74762854094,1186.6732864621658,130760.4209150031,4712,8,653.7906976744187,36,7,17,35.85494783025477,0.6160300925925926,45.467342342342356,1018.1306306306326,28.28140640640646,0
4744,4,0,1,42,0.0,0.023255813953488372,0.9767441860465116,43,1350,1100,250,0.8148148148148148,16,11,5,376.353370927642,0.4095376522702104,0.2465435063165522,0.21145916729263695,129717.10519641289,1163.8939615291288,130880.99915794202,4713,9,654.7906976744187,36,7,17,35.741856437467774,0.6174768518518517,45.32657657657659,1018.6936936936958,28.297047047047105,0
4745,4,1,3,40,0.023255813953488372,0.06976744186046512,0.9302325581395349,43,1000,800,200,0.8,12,8,4,374.18892357497936,0.40866094499815425,0.25360340085021194,0.2116762158909558,129982.903393352,1127.6325407817976,131110.5359341338,4714,0,655.2790697674419,37,6,19,35.52643369175627,0.6182432432432431,45.06578947368422,1019.7368421052647,27.56045519203418,0
4746,4,1,0,41,0.024390243902439025,0.0,1.0,41,1100,700,400,0.6363636363636364,15,7,8,391.57357842776435,0.4032012195121952,0.2657292270002576,0.21992591344880386,129701.96926708259,1957.5728470078996,131659.5421140905,4715,0,686.609756097561,35,6,20,35.3696786350036,0.619345238095238,45.34143518518519,1018.6342592592601,29.103835978836003,0
4747,4,0,0,41,0.0,0.0,1.0,41,750,600,150,0.8,9,6,3,391.8358533903365,0.4036077235772358,0.2626965569973734,0.22057051491358848,129790.40745027442,1971.3070130315568,131761.71446330598,4716,1,687.609756097561,35,6,20,35.27279266999849,0.6202380952380953,45.25462962962963,1018.981481481482,29.113756613756628,0
4748,4,2,1,42,0.046511627906976744,0.023255813953488372,0.9767441860465116,43,1300,900,400,0.6923076923076923,17,9,8,376.881275918164,0.4093300110741971,0.2568502813989395,0.21489343694805543,130291.32806793308,1221.7297314832692,131513.05779941636,4717,0,656.5813953488372,36,7,21,35.14412824472388,0.6232638888888888,44.76351351351353,1020.9459459459483,28.359609609609677,0
4749,4,0,0,42,0.0,0.0,1.0,42,850,600,250,0.7058823529411765,11,6,5,386.78531149715894,0.4068670150987224,0.2599607096813803,0.22006098284936165,130206.62607725458,1672.402085257008,131879.0281625116,4718,1,673.2142857142857,37,5,21,34.97752829107578,0.6204954954954953,44.84649122807018,1020.6140350877197,27.58416311047891,0
4750,4,1,2,41,0.023255813953488372,0.046511627906976744,0.9534883720930233,43,1000,500,500,0.5,15,5,10,379.2715969994492,0.41062200073827976,0.2553011461244583,0.21689743914155146,130406.3248214432,1291.9070606318082,131698.231882075,4719,0,658.5348837209302,36,7,21,34.9662348401323,0.6244212962962963,44.65090090090091,1021.3963963963974,28.37212212212215,0
4751,4,1,0,42,0.023809523809523808,0.0,1.0,42,1000,800,200,0.8,12,8,4,379.7923015202707,0.40916569879984516,0.2525287672563079,0.21754877647757484,130469.43486636224,1510.2573891889504,131979.6922555512,4720,0,652.547619047619,35,7,22,34.88881178958498,0.6270833333333334,44.58912037037037,1021.643518518518,29.1898148148148,0
4752,4,0,1,41,0.0,0.023809523809523808,0.9761904761904762,42,750,200,550,0.26666666666666666,13,2,11,376.40804156328517,0.4088511420828494,0.24686636109535587,0.21586132549712334,130514.5588666705,1425.3458996999068,131939.9047663704,4721,1,653.547619047619,37,5,16,34.929422863683506,0.6235923423423423,44.54495614035088,1021.8201754385964,27.61676149834044,0
4753,4,2,3,40,0.046511627906976744,0.06976744186046512,0.9302325581395349,43,1250,900,350,0.72,16,9,7,369.45230793089576,0.41205241786637137,0.2301298411164341,0.21379122374949802,130863.12601587058,1069.5367859230203,131932.6628017936,4722,0,639.2790697674419,38,5,16,34.7536197835091,0.6252741228070174,44.20405982905984,1023.1837606837621,26.92588843904637,0
4754,4,0,0,40,0.0,0.0,1.0,40,850,700,150,0.8235294117647058,10,7,3,392.5961046152364,0.4047409188034188,0.244274787535411,0.22454054589951145,130410.31867551869,2239.716622728053,132650.03529824674,4723,6,688.05,35,5,20,34.62193106704438,0.6264880952380951,44.64699074074074,1021.4120370370371,29.18320105820106,0
4755,4,1,1,40,0.024390243902439025,0.024390243902439025,0.975609756097561,41,800,500,300,0.625,11,5,6,389.461480307886,0.4075711382113821,0.2310103378536259,0.22455236207466142,130722.8274516072,1982.3011778670739,132705.12862947426,4724,0,672.2439024390244,36,5,16,34.38429137760159,0.6276041666666665,44.341216216216225,1022.6351351351366,28.40653153153157,0
4756,4,0,1,39,0.0,0.025,0.975,40,1250,1000,250,0.8,15,10,5,402.01782348540695,0.40502136752136747,0.24527623683912658,0.23133703158609756,130646.86381440745,2504.473567172482,133151.33738157994,4725,8,690.05,35,5,16,34.14055719083739,0.6288690476190477,44.41550925925925,1022.3379629629619,29.209656084656054,0
4757,4,1,0,40,0.025,0.0,1.0,40,1300,900,400,0.6923076923076923,17,9,8,405.9325918820847,0.4030048076923077,0.2712008141112623,0.23556875607645372,130972.4633487653,2633.19830246912,133605.66165123443,4726,0,690.825,35,5,18,33.70929443690636,0.6321428571428572,44.097222222222214,1023.6111111111102,29.24603174603172,0
4758,4,2,0,42,0.047619047619047616,0.0,1.0,42,1150,900,250,0.782608695652174,14,9,5,389.6522763013147,0.40993999225706546,0.22685223884755756,0.21691066455991745,129352.72285997722,1807.3491433610343,131160.07200333825,4727,0,658.8809523809524,34,8,18,35.775063389896616,0.617953431372549,45.6845238095238,1017.2619047619039,29.919467787114822,6
4759,4,2,1,43,0.045454545454545456,0.022727272727272728,0.9772727272727273,44,1100,900,200,0.8181818181818182,13,9,4,375.15191843960787,0.4147947498238196,0.2202461074836768,0.2114025443261801,129831.84831791259,941.3333942050266,130773.18171211761,4728,0,629.8863636363636,36,8,17,35.65561694290977,0.6186342592592593,45.21396396396397,1019.1441441441449,28.30955955955958,0
4760,4,0,0,43,0.0,0.0,1.0,43,1150,800,350,0.6956521739130435,15,8,7,382.16952491682184,0.41108342561830935,0.22478066409707087,0.21496730529346855,129760.92470689728,1318.134189600484,131079.05889649777,4729,1,645.5348837209302,35,8,17,35.54907891249197,0.6199404761904761,45.28356481481482,1018.8657407407406,29.110449735449734,0
4761,4,1,1,43,0.022727272727272728,0.022727272727272728,0.9772727272727273,44,700,500,200,0.7142857142857143,9,5,4,374.41086049582344,0.4145304792107118,0.2223538387407651,0.21191654704063612,130004.05811216628,934.9862531450492,130939.04436531133,4730,0,631.8409090909091,36,8,17,35.4992546378092,0.6203703703703705,45.04504504504505,1019.8198198198203,28.32832832832834,0
4762,4,0,0,43,0.0,0.0,1.0,43,1200,900,300,0.75,15,9,6,379.1655406244356,0.41152177925433736,0.22700356664827437,0.2142443391507795,129937.87140185611,1253.5926515346334,131191.46405339075,4731,3,647.5348837209302,35,8,17,35.44540148333145,0.6217261904761905,45.1099537037037,1019.560185185185,29.130291005291,0
4763,4,0,0,43,0.0,0.0,1.0,43,1200,900,300,0.75,15,9,6,379.75771250420485,0.41140642303433,0.22785050625529402,0.21522859937617725,130055.90284475726,1277.9464323988184,131333.84927715609,4732,4,648.5348837209302,35,8,17,35.310171526911,0.6229166666666668,44.994212962962955,1020.0231481481472,29.143518518518494,0
4764,4,1,1,43,0.022727272727272728,0.022727272727272728,0.9772727272727273,44,1150,700,450,0.6086956521739131,16,7,9,375.4425052677755,0.41413407329105006,0.2314853797652341,0.21454871331275743,130377.57087746546,989.8563681925364,131367.427245658,4733,0,634.7727272727273,36,8,17,35.09322049472563,0.6241319444444444,44.67905405405406,1021.2837837837851,28.36899399399403,0
4765,4,2,2,43,0.044444444444444446,0.044444444444444446,0.9555555555555556,45,1700,1400,300,0.8235294117647058,20,14,6,372.3937353103952,0.4137205387205387,0.232183497170092,0.21448867089372672,130682.67549871115,733.081933864262,131415.75743257542,4734,0,621.6222222222223,37,8,15,34.86137176050044,0.6252815315315314,44.38048245614035,1022.4780701754387,27.63454243717402,0
4766,4,2,2,43,0.044444444444444446,0.044444444444444446,0.9555555555555556,45,1450,1200,250,0.8275862068965517,17,12,5,362.08879723515525,0.41717171717171714,0.21682908938488898,0.20458338614654178,129935.6020915518,409.64517587115654,130345.24726742296,4735,0,622.5777777777778,38,7,15,35.882977051241745,0.615953947368421,45.112179487179496,1019.5512820512836,26.83029689608641,3
4767,4,1,1,43,0.022727272727272728,0.022727272727272728,0.9772727272727273,44,1050,600,450,0.5714285714285714,15,6,9,368.4373267985614,0.4151581219168428,0.2329093255636594,0.2081245604236347,129927.0027797016,773.991516620513,130700.99429632211,4736,0,637.7045454545455,37,7,16,35.72990607299061,0.6176801801801801,45.120614035087726,1019.5175438596503,27.554528212422984,0
4768,4,0,1,42,0.0,0.023255813953488372,0.9767441860465116,43,1000,600,400,0.6,14,6,8,375.11608387627655,0.41482096714654854,0.23210486683286602,0.21194391879403857,129935.6020915518,1148.186842537823,131083.78893408962,4737,1,644.6744186046511,38,5,16,35.55092738132662,0.615953947368421,45.112179487179496,1019.5512820512836,26.83029689608641,0
4769,4,0,0,42,0.0,0.0,1.0,42,850,500,350,0.5882352941176471,12,5,7,374.2959447967924,0.41469463801780876,0.2243233804784357,0.2117756249606039,129990.0710082002,1330.9512884433007,131321.0222966435,4738,2,651.0238095238095,38,4,16,35.516413480006996,0.616502192982456,45.058760683760696,1019.7649572649588,26.83591992802523,0
4770,4,1,0,43,0.023255813953488372,0.0,1.0,43,1000,800,200,0.8,12,8,4,366.2214038492824,0.4183739387227759,0.2259553968571557,0.20881529857217582,130291.32806793287,943.95068545277,131235.27875338565,4739,0,636.8604651162791,36,7,17,35.41620707404955,0.6232638888888888,44.763513513513516,1020.9459459459465,28.359609609609624,0
4771,4,1,2,42,0.022727272727272728,0.045454545454545456,0.9545454545454546,44,800,500,300,0.625,11,5,6,356.0305118203471,0.4212693798449612,0.21977726716821677,0.2045299403970286,130581.79253472232,498.2204861111228,131080.01302083343,4740,0,623.3636363636364,39,5,14,35.381845359423835,0.6207264957264957,44.47916666666667,1022.0833333333342,26.20726495726498,0
4772,4,3,4,41,0.06666666666666667,0.08888888888888889,0.9111111111111111,45,950,500,450,0.5263157894736842,14,5,9,348.6552682701872,0.42584175084175085,0.21608114521594257,0.20160325018242223,130833.79937743724,123.1786841496359,130956.97806158688,4741,0,610.1555555555556,40,5,14,35.315262739644396,0.6216145833333333,44.23272357723577,1023.0691056910558,25.576727642276396,0
4773,4,0,0,41,0.0,0.0,1.0,41,1000,700,300,0.7,13,7,6,379.06813838726777,0.41239837398373985,0.2343129779992612,0.21582540062673222,130234.6049385387,1673.5578495306181,131908.1627880693,4742,6,670.6341463414634,37,4,16,35.14598327783149,0.620777027027027,44.81907894736842,1020.7236842105257,27.587126600284478,0
4774,4,2,1,42,0.046511627906976744,0.023255813953488372,0.9767441860465116,43,1000,600,400,0.6,14,6,8,368.33806278914324,0.4191122185308232,0.1832535907328754,0.20944795167206015,130184.7910056847,999.5461830943458,131184.33718877906,4743,0,640.3953488372093,40,3,17,35.47039932284406,0.6151041666666666,44.8678861788618,1020.5284552845549,25.513211382113873,7
4775,4,2,2,42,0.045454545454545456,0.045454545454545456,0.9545454545454546,44,1000,800,200,0.8,12,8,4,356.7787971457693,0.4206747709654686,0.1974098786025391,0.20467836257309965,130528.56445312526,514.0113190623439,131042.5757721876,4744,0,626.4545454545455,39,5,13,35.416666666666686,0.6201923076923076,44.531250000000014,1021.875000000002,26.20192307692313,0
4776,4,0,1,41,0.0,0.023809523809523808,0.9761904761904762,42,1300,800,500,0.6153846153846154,18,8,10,369.3461057892541,0.4170780100658149,0.19582118561710393,0.21044138585666838,130262.58680555577,1222.3958333333576,131484.9826388891,4745,2,657.2857142857143,39,3,17,35.36564625850341,0.6175213675213674,44.79166666666668,1020.8333333333351,26.17521367521372,0
4777,4,2,2,41,0.046511627906976744,0.046511627906976744,0.9534883720930233,43,1200,1000,200,0.8333333333333334,14,10,4,357.83492315425735,0.421234772978959,0.18687580708218254,0.20599118890082377,130661.65500217052,751.0606553819831,131412.7156575525,4746,0,625.953488372093,39,4,15,35.254818305315,0.6215277777777777,44.401041666666686,1022.3958333333363,26.215277777777853,0
4778,4,1,1,41,0.023809523809523808,0.023809523809523808,0.9761904761904762,42,1350,1200,150,0.8888888888888888,15,12,3,356.7991378236747,0.4234296360820751,0.18637578261776278,0.20596183035218474,130768.17626953135,931.5945095486268,131699.77077908,4747,0,634.5952380952381,39,3,15,35.17340954611808,0.6225961538461537,44.29687500000001,1022.8125000000008,26.225961538461558,0
4779,4,2,1,42,0.046511627906976744,0.023255813953488372,0.9767441860465116,43,1000,700,300,0.7,13,7,6,363.09720794656334,0.4261489479512735,0.22211145449107805,0.20496500241485482,129899.73855054835,833.2464761385136,130732.98502668687,4748,0,620.7906976744187,40,3,18,35.8937294387399,0.6122395833333335,45.14735772357722,1019.410569105689,25.485264227642226,2
4780,4,0,1,41,0.0,0.023809523809523808,0.9761904761904762,42,1150,800,350,0.6956521739130435,15,8,7,369.46903282987205,0.4237925861401471,0.22703212874851642,0.2087969337955415,129943.77170138857,1202.03993055552,131145.8116319441,4749,1,636.452380952381,39,3,18,35.686554965263575,0.6143162393162396,45.10416666666665,1019.5833333333308,26.143162393162328,0
4781,4,0,0,41,0.0,0.0,1.0,41,1000,600,400,0.6,14,6,8,375.5452313685104,0.4202997967479675,0.23840287858033737,0.21233434171688717,129962.83512309121,1561.384597121746,131524.21972021295,4750,2,652.6585365853658,38,3,19,35.512276473875396,0.6162280701754387,45.08547008547007,1019.658119658117,26.83310841205571,0
4782,4,0,0,41,0.0,0.0,1.0,41,800,300,500,0.375,13,3,10,373.50167232121953,0.4201219512195122,0.24049475308326662,0.21176923796454844,130071.79578493652,1516.4066494995643,131588.2024344361,4751,3,653.6585365853658,38,3,20,35.453541753944975,0.6173245614035089,44.97863247863246,1020.0854700854677,26.84435447593336,0
4783,4,1,1,41,0.023809523809523808,0.023809523809523808,0.9761904761904762,42,1350,1200,150,0.8888888888888888,15,12,3,368.538433946222,0.4225585559427023,0.23871911307478366,0.21028369466343244,130318.55955678665,1205.7592203558697,131524.31877714253,4752,0,639.0714285714286,37,5,20,35.32941365979383,0.6216216216216216,44.73684210526316,1021.052631578947,27.59601706970127,0
4784,4,0,0,41,0.0,0.0,1.0,41,1150,1000,150,0.8695652173913043,13,10,3,374.3440233236156,0.42045223577235774,0.2472872075659538,0.21328903654485046,130262.58680555534,1552.604166666646,131815.190972222,4753,5,655.6585365853658,37,4,20,35.238095238095234,0.6210585585585586,44.79166666666666,1020.8333333333317,27.590090090090044,0
4785,4,0,0,41,0.0,0.0,1.0,41,800,600,200,0.75,10,6,4,371.29051338463336,0.42035060975609756,0.24561725843247184,0.2119949060292903,130344.3971893489,1479.1276298487646,131823.52481919766,4754,6,656.6585365853658,38,3,20,35.23292006695962,0.6200657894736843,44.71153846153845,1021.1538461538445,26.872469635627485,0
4786,4,1,1,41,0.023809523809523808,0.023809523809523808,0.9761904761904762,42,1000,700,300,0.7,13,7,6,366.61011854108415,0.42269163763066203,0.2400775453358761,0.2107524952105245,130608.410644531,1176.472981770804,131784.8836263018,4755,0,642.0,39,3,16,35.084517986344636,0.6209935897435899,44.453124999999986,1022.1874999999981,26.209935897435848,0
4787,4,0,0,41,0.0,0.0,1.0,41,1400,1000,400,0.7142857142857143,18,10,8,371.42465984199316,0.42037601626016263,0.2404399728713993,0.2132682050449283,130562.68376981509,1498.8400814522515,132061.52385126735,4756,8,658.6585365853658,38,3,16,35.00788382465676,0.6222587719298246,44.49786324786324,1022.0085470085463,26.8949617633828,0
4788,4,0,0,41,0.0,0.0,1.0,41,1000,600,400,0.6,14,6,8,367.82034539284126,0.41996951219512196,0.23335737275458635,0.2119451249701916,130699.20562358464,1414.7653910073766,132113.971014592,4757,9,659.6585365853658,38,3,16,34.96151568975725,0.6236293859649124,44.36431623931624,1022.5427350427351,26.909019343229872,0
4789,4,0,0,41,0.0,0.0,1.0,41,1200,800,400,0.6666666666666666,16,8,8,367.84650027827195,0.4199186991869919,0.2345009974700183,0.21226006914791432,130753.83434007237,1419.4680719921143,132173.30241206448,4758,10,660.6585365853658,38,3,16,34.90546328214771,0.6241776315789473,44.31089743589744,1022.7564102564106,26.9146423751687,0
4790,4,1,1,41,0.023809523809523808,0.023809523809523808,0.9761904761904762,42,850,400,450,0.47058823529411764,13,4,9,363.0884257664886,0.4232965543941154,0.2283369188131097,0.2109002983707476,131008.00781249997,1113.4982638888885,132121.50607638885,4759,0,645.9047619047619,39,3,16,34.76970560303895,0.625,44.0625,1023.7499999999998,26.249999999999993,0
4791,4,1,1,41,0.023809523809523808,0.023809523809523808,0.9761904761904762,42,1000,600,400,0.6,14,6,8,361.27859347038367,0.4221593108788231,0.22300360339416447,0.21043193904033256,131114.67013888896,1073.7847222222263,132188.45486111118,4760,0,646.8809523809524,39,3,17,34.70809601301872,0.6260683760683761,43.958333333333336,1024.1666666666672,26.260683760683776,0
4792,4,1,0,42,0.023809523809523808,0.0,1.0,42,1250,900,350,0.72,16,9,7,363.2097296582717,0.42096157568718545,0.23499806426635628,0.21273712737127382,131328.1250000003,1139.9305555555857,132468.05555555588,4761,0,647.8571428571429,39,3,18,34.442750677506766,0.6282051282051281,43.750000000000014,1025.0000000000023,26.28205128205134,0
4793,4,0,1,41,0.0,0.023809523809523808,0.9761904761904762,42,900,500,400,0.5555555555555556,13,5,8,360.1196522804794,0.4209252806813782,0.2311642306432895,0.21153172720857039,131437.65637555695,1066.6566221053372,132504.3129976623,4762,1,648.8571428571429,38,4,18,34.41124887129263,0.6310307017543859,43.64316239316239,1025.42735042735,26.984930274403943,0
4794,4,3,2,42,0.06818181818181818,0.045454545454545456,0.9545454545454546,44,1250,1000,250,0.8,15,10,5,345.20051638072465,0.4227779245947851,0.22513509139461108,0.2056760413155868,131979.9735297277,311.91100287527763,132291.88453260297,4763,0,619.8636363636364,40,4,17,34.24714832031122,0.6330729166666667,43.114837398373986,1027.5406504065043,25.688516260162608,0
4795,4,0,0,42,0.0,0.0,1.0,42,1100,900,200,0.8181818181818182,13,9,4,363.2339257575974,0.4188201703445606,0.2420189049402537,0.21551879594950754,131821.37573964475,1176.3991617356803,132997.7749013804,4764,1,650.3809523809524,38,4,17,33.94389825218476,0.6348684210526316,43.26923076923076,1026.9230769230753,27.024291497975668,0
4796,4,0,0,42,0.0,0.0,1.0,42,1000,700,300,0.7,13,7,6,362.94379616076463,0.41770712349980643,0.2428809102927858,0.21612572679121178,131958.55391418276,1178.7076986996728,133137.26161288243,4765,2,651.3809523809524,38,4,17,33.81295275727013,0.6362390350877194,43.135683760683754,1027.4572649572638,27.03834907782273,0
4797,4,0,0,42,0.0,0.0,1.0,42,1250,1100,150,0.88,14,11,3,367.4357206193395,0.41673925667828104,0.2426404002315885,0.21975350773896196,132123.26189139063,1309.3611887281515,133432.6230801188,4766,3,652.3809523809524,38,4,17,33.53142644359001,0.6378837719298247,42.97542735042734,1028.0982905982887,27.055218173639176,0
4798,4,0,0,42,0.0,0.0,1.0,42,1600,1200,400,0.75,20,12,8,367.2972584798461,0.4163037166085946,0.23920075976791466,0.22030970139473374,132233.12428090064,1313.7728057199074,133546.89708662053,4767,4,653.3809523809524,38,4,17,33.424223537966135,0.6389802631578948,42.86858974358974,1028.5256410256402,27.066464237516847,0
4799,4,0,0,42,0.0,0.0,1.0,42,1100,600,500,0.5454545454545454,16,6,10,369.30889991042795,0.41561411149825783,0.24278592940967036,0.2218387646436377,132288.07259706705,1371.0325124187382,133659.1051094858,4768,5,654.3809523809524,38,4,17,33.31710631079724,0.6395285087719298,42.815170940170944,1028.7393162393168,27.072087269455707,0
4800,4,0,0,42,0.0,0.0,1.0,42,650,300,350,0.46153846153846156,10,3,7,371.61229645974674,0.41502129307007357,0.2455982912321817,0.22354765941310556,132343.03232750748,1436.0596327343108,133779.09196024179,4769,6,655.3809523809524,38,4,17,33.20246253417782,0.6400767543859649,42.761752136752136,1028.9529914529915,27.07771030139451,0
4801,4,1,1,42,0.023255813953488372,0.023255813953488372,0.9767441860465116,43,1300,1000,300,0.7692307692307693,16,10,6,369.86065703083386,0.4194352159468439,0.2437961805512585,0.22432800986473106,132652.03145438986,1212.5763305875673,133864.60778497742,4770,0,641.1162790697674,37,6,15,32.936291467092445,0.6449887387387387,42.46162280701755,1030.15350877193,27.84198672356568,0
4802,4,0,1,41,0.0,0.023809523809523808,0.9761904761904762,42,600,500,100,0.8333333333333334,7,5,2,375.7242746044419,0.4141623112659698,0.24627001870693976,0.22754210904961464,132595.5597515582,1563.8741006848309,134159.43385224303,4771,8,657.3809523809524,37,5,19,32.84216526491358,0.6444256756756757,42.516447368421055,1029.934210526316,27.83605974395449,0
4803,4,0,0,41,0.0,0.0,1.0,41,1350,900,450,0.6666666666666666,18,9,9,381.4197908407608,0.4123729674796748,0.2559962460140559,0.23138118346228662,132658.9004545086,1919.746012904801,134578.6464674134,4772,9,672.0243902439024,36,5,15,32.63167723363941,0.6469907407407407,42.45495495495496,1030.1801801801805,28.616116116116125,0
4804,4,0,1,40,0.0,0.024390243902439025,0.975609756097561,41,1450,900,550,0.6206896551724138,20,9,11,378.23358800700055,0.4117886178861789,0.2560002984493954,0.2303374604809102,132803.95418645014,1846.183218691688,134650.13740514184,4773,10,673.0243902439024,36,5,15,32.56764630904257,0.6484375,42.3141891891892,1030.7432432432447,28.631756756756797,0
4805,4,0,0,40,0.0,0.0,1.0,40,850,600,250,0.7058823529411765,11,6,5,385.45633395639214,0.4088541666666667,0.2576780498764326,0.2340608652714736,132695.96220207473,2229.699824245541,134925.66202632026,4774,13,690.6,35,5,15,32.49035797199132,0.6494047619047618,42.41898148148148,1030.324074074074,29.437830687830683,0
4806,4,0,0,40,0.0,0.0,1.0,40,400,100,300,0.25,7,1,6,383.518579171885,0.40881410256410255,0.25633213523531384,0.23306934541756258,132725.77649444874,2180.5602441272317,134906.33673857598,4775,14,691.6,35,5,15,32.51022595379834,0.649702380952381,42.3900462962963,1030.439814814815,29.44113756613757,0
4807,4,0,0,40,0.0,0.0,1.0,40,1250,1000,250,0.8,15,10,5,383.2709612195466,0.4086538461538462,0.2629805591961558,0.23394859472841129,132891.02447041642,2186.6541372453617,135077.67860766177,4776,15,692.6,36,4,15,32.350143803698856,0.6493055555555556,42.22972972972973,1031.0810810810815,28.64114114114115,0
4808,4,0,0,40,0.0,0.0,1.0,40,1500,1200,300,0.8,18,12,6,380.20059154290163,0.4089075854700855,0.252757704569607,0.23322604735454391,133075.95245652506,2119.111168821173,135195.06362534623,4777,16,693.6,37,3,17,32.24318101310662,0.6492117117117117,42.050438596491226,1031.7982456140348,27.88643907064959,0
4809,4,0,0,40,0.0,0.0,1.0,40,1000,700,300,0.7,13,7,6,377.9846125508439,0.4094684829059829,0.24519332908434244,0.23257170866363683,133189.11227493064,2068.686999846096,135257.79927477674,4778,17,694.6,37,3,17,32.1865484030876,0.6503378378378378,41.940789473684205,1032.2368421052624,27.898293029871958,0
4810,4,0,0,40,0.0,0.0,1.0,40,900,700,200,0.7777777777777778,11,7,4,377.6167333723207,0.4097355769230769,0.23977646808962527,0.2328760169068203,133274.01369892666,2065.2995392813277,135339.31323820798,4779,18,695.6,37,3,17,32.11069962125235,0.6511824324324323,41.85855263157895,1032.5657894736848,27.90718349928878,0
4811,4,1,0,41,0.024390243902439025,0.0,1.0,41,900,600,300,0.6666666666666666,12,6,6,371.1366475085761,0.4113567073170732,0.22976339212962582,0.2309866303206839,133613.88991083778,1717.9495133117648,135331.83942414954,4780,0,679.609756097561,37,4,18,31.936821684872896,0.6545608108108109,41.52960526315788,1033.881578947367,27.942745376955862,0
4812,4,0,0,41,0.0,0.0,1.0,41,1100,600,500,0.5454545454545454,16,6,10,370.5322287866826,0.41122967479674793,0.23087327469605956,0.23096427294693994,133670.57802641182,1705.8514398660943,135376.4294662779,4781,1,680.609756097561,37,4,19,31.895588131339895,0.6551238738738739,41.474780701754376,1034.1008771929812,27.94867235656706,0
4813,4,0,0,41,0.0,0.0,1.0,41,750,500,250,0.6666666666666666,10,5,5,371.84059709317756,0.410619918699187,0.23001760813749317,0.2321358274242185,133727.278164916,1745.046192097554,135472.32435701357,4782,2,681.609756097561,37,4,15,31.80490034983568,0.6556869369369369,41.41995614035087,1034.3201754385955,27.954599336178255,0
4814,4,0,0,41,0.0,0.0,1.0,41,850,700,150,0.8235294117647058,10,7,3,373.4371985377318,0.40985772357723577,0.23603862111753093,0.23349105157080832,133783.99032635032,1791.9837113342464,135575.97403768456,4783,3,682.609756097561,37,4,15,31.7067435082141,0.65625,41.36513157894736,1034.5394736842097,27.96052631578945,0
4815,4,0,1,40,0.0,0.024390243902439025,0.975609756097561,41,700,600,100,0.8571428571428571,8,6,2,374.9973794863828,0.4092733739837398,0.23577149621236626,0.23482748972879833,133840.71451071466,1837.9834420206007,135678.69795273527,4784,4,683.609756097561,37,4,15,31.60951132068807,0.6568130630630632,41.31030701754385,1034.758771929823,27.966453295400623,0
4816,4,0,1,39,0.0,0.025,0.975,40,1150,600,550,0.5217391304347826,17,6,11,380.55522798559343,0.4062232905982906,0.24047839338195298,0.2379959754597445,133792.42153893757,2183.0810962990004,135975.50263523657,4785,24,701.6,36,4,15,31.5141867131091,0.658275462962963,41.35698198198198,1034.572072072072,28.73811311311311,0
4817,4,0,0,39,0.0,0.0,1.0,39,1250,700,550,0.56,18,7,11,393.3125514646086,0.40511133603238864,0.2325947398721857,0.23162319891234717,131535.81700370798,2549.080749429827,134084.8977531378,4786,25,705.3846153846154,35,4,17,33.46085317236451,0.6377976190476191,43.5474537037037,1025.810185185185,29.30886243386243,5
4818,4,0,0,39,0.0,0.0,1.0,39,950,500,450,0.5263157894736842,14,5,9,392.53205791390553,0.4066295546558705,0.23184483536310307,0.23206495263870106,131684.26890432098,2538.059413580249,134222.32831790124,4787,26,706.3846153846154,35,4,16,33.33051420838972,0.6392857142857142,43.40277777777778,1026.388888888889,29.325396825396826,0
4819,4,0,0,39,0.0,0.0,1.0,39,650,400,250,0.6153846153846154,9,4,5,396.1737180798943,0.4065452091767881,0.23608244442517345,0.23458350329563815,131743.67310742446,2638.6761616940958,134382.34926911857,4788,27,707.3846153846154,35,4,16,33.176907177752746,0.6398809523809523,43.344907407407405,1026.6203703703695,29.332010582010557,0
4820,4,0,0,39,0.0,0.0,1.0,39,1250,1000,250,0.8,15,10,5,397.03652449910743,0.4061234817813765,0.22950668111231476,0.23601467882984437,131892.24222232928,2673.207492069602,134565.44971439888,4789,28,708.3846153846154,35,4,18,33.00434272300468,0.6413690476190477,43.200231481481474,1027.1990740740732,29.34854497354495,0
4821,4,0,1,38,0.0,0.02564102564102564,0.9743589743589743,39,800,500,300,0.625,11,5,6,394.68319097529246,0.40553306342780027,0.23153362785103204,0.23505805707954117,131963.74584043512,2616.7744602710904,134580.5203007062,4790,29,709.3846153846154,36,3,18,32.99242839397924,0.6400462962962963,43.130630630630634,1027.4774774774783,28.541041041041062,0
4822,4,0,0,38,0.0,0.0,1.0,38,850,500,350,0.5882352941176471,12,5,7,401.58953244626014,0.40178994784257943,0.24682375748623908,0.2388070218366876,131905.89871966562,2994.4056387468577,134900.30435841248,4791,43,728.2894736842105,36,2,18,32.873593144778205,0.6394675925925927,43.18693693693694,1027.2522522522524,28.53478478478479,0
4823,4,0,1,37,0.0,0.02631578947368421,0.9736842105263158,38,850,500,350,0.5882352941176471,12,5,7,387.7773194671108,0.4015973210052157,0.20870329858877001,0.2233815826226033,130688.28125000003,2537.4227690528387,133225.70401905288,4792,44,729.2894736842105,34,4,16,34.46244227112197,0.6314338235294117,44.375,1022.5000000000002,30.073529411764714,4
4824,4,0,0,37,0.0,0.0,1.0,37,950,700,250,0.7368421052631579,12,7,5,390.9474409016058,0.4010885885885886,0.20465679528815994,0.22582963939139805,130794.81336805549,2826.77951388888,133621.59288194438,4793,45,740.2972972972973,33,4,17,34.27316700610997,0.6347853535353536,44.27083333333333,1022.9166666666661,30.99747474747473,0
4825,4,1,0,38,0.02631578947368421,0.0,1.0,38,750,600,150,0.8,9,6,3,383.8474055416409,0.40341986723565676,0.20630453138193094,0.2234002288544786,131084.1907596371,2463.2653061224405,133547.45606575953,4794,0,721.7894736842105,34,4,18,34.16114469503217,0.6354166666666667,43.988095238095234,1024.0476190476184,30.1190476190476,0
4826,4,0,0,38,0.0,0.0,1.0,38,900,700,200,0.7777777777777778,11,7,4,386.43384489629017,0.4030642484589853,0.20725366414641933,0.2252626559273497,131145.1530612245,2535.7851473922956,133680.9382086168,4795,1,722.7894736842105,34,4,18,34.033104757477155,0.6360294117647058,43.92857142857143,1024.2857142857144,30.12605042016807,0
4827,4,0,0,38,0.0,0.0,1.0,38,750,400,350,0.5333333333333333,11,4,7,386.43384489629017,0.4030642484589853,0.20725366414641933,0.2252626559273497,131145.1530612245,2535.7851473922956,133680.9382086168,4796,2,723.7894736842105,34,4,18,34.033104757477155,0.6360294117647058,43.92857142857143,1024.2857142857144,30.12605042016807,0
4828,4,0,0,38,0.0,0.0,1.0,38,900,600,300,0.6666666666666666,12,6,6,387.55564884988655,0.40220483641536275,0.2138882448411774,0.22647063757544847,131239.16437596444,2572.495900848756,133811.6602768132,4797,3,724.7894736842105,35,3,18,33.90905625211792,0.6348214285714285,43.83680555555555,1024.6527777777771,29.275793650793634,0
4829,4,1,1,38,0.02564102564102564,0.02564102564102564,0.9743589743589743,39,1050,800,250,0.7619047619047619,13,8,5,379.9583279210458,0.4047739541160594,0.2093935106010496,0.22341146275437196,131476.45968632106,2191.145297496562,133667.6049838176,4798,0,707.1794871794872,35,4,18,33.86339483880676,0.637202380952381,43.60532407407407,1025.578703703703,29.302248677248656,0
4830,4,0,0,38,0.0,0.0,1.0,38,700,400,300,0.5714285714285714,10,4,6,388.65754511203653,0.4021011142721669,0.21459135643988025,0.22764227642276424,131328.125,2608.3333333333344,133936.45833333334,4799,5,726.7894736842105,34,4,18,33.790650406504064,0.6378676470588236,43.75,1025.0,30.147058823529413,0
4831,4,0,0,38,0.0,0.0,1.0,38,600,500,100,0.8333333333333334,7,5,2,384.609208351471,0.40156768610715976,0.20942710128221864,0.22562042169386295,131387.44882758913,2506.564536179693,133894.01336376884,4800,6,727.7894736842105,35,3,18,33.83429291788966,0.6363095238095239,43.692129629629626,1025.2314814814813,29.292328042328037,0
4832,4,0,0,38,0.0,0.0,1.0,38,1600,1300,300,0.8125,19,13,6,389.6120564979885,0.40109352773826457,0.212147667747568,0.22926574001893574,131506.13667052463,2647.275270061724,134153.41194058635,4801,7,728.7894736842105,35,3,18,33.585815842924845,0.6375,43.576388888888886,1025.6944444444441,29.305555555555546,0
4833,4,0,0,38,0.0,0.0,1.0,38,1050,700,350,0.6666666666666666,14,7,7,385.88170087264115,0.40042674253200566,0.2052489106818478,0.22777810652042865,131624.87809713656,2558.3263674554278,134183.20446459198,4802,8,729.7894736842105,35,3,15,33.561264004812394,0.6386904761904761,43.46064814814815,1026.157407407408,29.318783068783087,0
4834,4,0,0,38,0.0,0.0,1.0,38,1200,800,400,0.6666666666666666,16,8,8,383.6546686511544,0.40016002844950216,0.20284222393639117,0.22717068831346718,131743.67310742452,2508.8150505829863,134252.4881580075,4803,9,730.7894736842105,35,3,17,33.498214956783166,0.6398809523809523,43.344907407407405,1026.62037037037,29.33201058201057,0
4835,4,1,1,38,0.02564102564102564,0.02564102564102564,0.9743589743589743,39,1100,700,400,0.6363636363636364,15,7,8,375.2536685492398,0.4022435897435897,0.19162494310423317,0.2238277764170173,132021.60564280508,2108.3183690447327,134129.9240118498,4804,0,713.025641025641,36,3,18,33.433094090145374,0.640625,43.07432432432433,1027.7027027027036,28.547297297297323,0
4836,4,0,0,38,0.0,0.0,1.0,38,1000,600,400,0.6,14,6,8,386.0659153754003,0.3992117117117117,0.19410006936909663,0.22985292627682274,131951.69331114966,2588.4102527006116,134540.10356385028,4805,11,732.7894736842105,35,3,18,33.225963163230816,0.6419642857142858,43.14236111111111,1027.4305555555552,29.35515873015872,0
4837,4,0,0,38,0.0,0.0,1.0,38,750,600,150,0.8,9,6,3,387.56128638205166,0.3987671882408725,0.19300715467009688,0.23110521570088896,132011.15779588907,2632.482826431757,134643.64062232082,4806,12,733.7894736842105,35,3,18,33.12744021473889,0.6425595238095239,43.08449074074074,1027.6620370370372,29.36177248677249,0
4838,4,0,0,38,0.0,0.0,1.0,38,1050,600,450,0.5714285714285714,15,6,9,387.801314828342,0.398456021811285,0.19352773826458036,0.231429816913688,132040.8950617284,2641.126543209881,134682.0216049383,4807,13,734.7894736842105,35,3,18,33.09121621621623,0.6428571428571428,43.05555555555556,1027.7777777777778,29.365079365079367,0
4839,4,0,0,38,0.0,0.0,1.0,38,1150,900,250,0.782608695652174,14,9,5,383.42825198900755,0.3989005452821242,0.1943462302589487,0.2296162290646814,132172.40521121875,2535.726858264071,134708.13206948282,4808,14,735.7894736842105,37,1,18,33.070750693111535,0.6402027027027027,42.92763157894736,1028.2894736842097,27.791607396870532,0
4840,4,1,0,39,0.02564102564102564,0.0,1.0,39,950,600,350,0.631578947368421,13,6,7,382.2750824896182,0.4033400809716599,0.1260552671595616,0.21486496015795778,129731.44531250001,2146.1883704601423,131877.63368296015,4809,0,717.8974358974359,37,2,17,35.57643149284252,0.6157094594594594,45.3125,1018.7500000000001,27.533783783783786,8
4841,4,2,0,41,0.04878048780487805,0.0,1.0,41,1250,900,350,0.72,16,9,7,367.5919701400184,0.4073424796747967,0.14416939833228648,0.21009803543179317,130384.14292800445,1391.058142006796,131775.20107001124,4810,0,683.829268292683,34,7,19,35.28698954812138,0.6283700980392157,44.672619047619044,1021.3095238095232,30.038515406162446,0
4842,4,0,0,41,0.0,0.0,1.0,41,1400,800,600,0.5714285714285714,20,8,12,367.6271170589831,0.40739329268292684,0.14281096939409732,0.21090187241804823,130528.564453125,1397.1679687499998,131925.732421875,4811,1,684.829268292683,35,6,17,35.1395259938838,0.6276785714285715,44.53125,1021.875,29.196428571428573,0
4843,4,0,0,41,0.0,0.0,1.0,41,750,400,350,0.5333333333333333,11,4,7,366.1189454274864,0.40719004065040654,0.14226746498403697,0.21030984485442197,130578.91506371237,1361.4829356383402,131940.3979993507,4812,2,685.829268292683,36,5,18,35.126983252534146,0.6261574074074074,44.48198198198198,1022.0720720720722,28.390890890890894,0
4844,4,0,0,41,0.0,0.0,1.0,41,1000,600,400,0.6,14,6,8,364.6387122768057,0.40764735772357724,0.13545378087009752,0.20996344623881044,130671.89554569361,1329.6063445101936,132001.5018902038,4813,3,686.829268292683,38,3,18,35.070532915360516,0.6233552631578947,44.39102564102564,1022.4358974358973,26.906207827260456,0
4845,4,0,0,41,0.0,0.0,1.0,41,1100,700,400,0.6363636363636364,15,7,8,364.8590161867232,0.4080030487804878,0.13443297077909722,0.21053618818297176,130753.83434007232,1341.3430719921148,132095.17741206443,4814,4,687.829268292683,38,3,18,34.981849994776994,0.6241776315789473,44.31089743589744,1022.7564102564103,26.914642375168693,0
4846,4,0,0,41,0.0,0.0,1.0,41,950,700,250,0.7368421052631579,12,7,5,364.8590161867232,0.4080030487804878,0.13443297077909722,0.21053618818297176,130753.83434007232,1341.3430719921148,132095.17741206443,4815,5,688.829268292683,38,3,18,34.981849994776994,0.6241776315789473,44.31089743589744,1022.7564102564103,26.914642375168693,0
4847,4,0,0,41,0.0,0.0,1.0,41,850,500,350,0.5882352941176471,12,5,7,362.81899890043445,0.40774898373983737,0.1363174475432758,0.20995272220359257,130863.1260158703,1295.9256748118796,132159.0516906822,4816,6,689.829268292683,38,3,18,34.92329713549823,0.6252741228070176,44.20405982905982,1023.1837606837597,26.925888439046307,0
4848,4,0,0,41,0.0,0.0,1.0,41,1000,600,400,0.6,14,6,8,364.95087164400053,0.40721544715447155,0.13839891451831776,0.21178645070994345,130972.46334876528,1359.702932098749,132332.166280864,4817,7,690.829268292683,38,3,18,34.758028041610125,0.6263706140350878,44.097222222222214,1023.61111111111,26.937134502923946,0
4849,4,0,1,40,0.0,0.024390243902439025,0.975609756097561,41,1300,900,400,0.6923076923076923,17,9,8,370.9733607703601,0.4070884146341463,0.14337982728878007,0.21604803379979753,131109.19922017658,1527.6040525239016,132636.8032727005,4818,8,691.829268292683,38,3,18,34.46540962514777,0.6277412280701755,43.9636752136752,1024.1452991452975,26.951192082770987,0
4850,4,0,0,40,0.0,0.0,1.0,40,950,700,250,0.7368421052631579,12,7,5,363.5312454793675,0.4060630341880342,0.13526324036352189,0.20977001886521954,130753.83434007263,1506.620849769922,132260.45518984256,4819,9,694.425,38,2,17,35.01579964483444,0.6241776315789471,44.31089743589745,1022.7564102564128,26.914642375168757,2
4851,4,1,1,40,0.024390243902439025,0.024390243902439025,0.975609756097561,41,1200,900,300,0.75,15,9,6,361.70338273539227,0.408739837398374,0.13745874996898477,0.21038723386324937,131061.33355034758,1281.065538194484,132342.39908854206,4820,0,678.4634146341464,39,2,18,34.75118684299765,0.6255341880341878,44.010416666666686,1023.9583333333362,26.255341880341955,0
4852,4,0,0,40,0.0,0.0,1.0,40,900,600,300,0.6666666666666666,12,6,6,371.30440373329367,0.40397970085470086,0.14203004381389528,0.2162408271073729,131109.19922017696,1736.2846080794998,132845.48382825646,4821,11,696.425,38,2,19,34.45693372279017,0.6277412280701753,43.963675213675224,1024.1452991453007,26.95119208277107,0
4853,4,0,0,40,0.0,0.0,1.0,40,900,500,400,0.5555555555555556,13,5,8,371.72952423320135,0.4037393162393162,0.1434136420525658,0.2167969998995095,131163.9135437213,1751.499835634463,132915.41337935577,4822,12,697.425,38,2,20,34.39064455569463,0.6282894736842104,43.910256410256416,1024.358974358975,26.95681511470987,0
4854,4,0,0,40,0.0,0.0,1.0,40,950,800,150,0.8421052631578947,11,8,3,371.37467593018647,0.40428685897435895,0.1432557430372028,0.21721665052325695,131274.74500868082,1750.4231770833678,133025.1681857642,4823,13,698.425,39,1,21,34.28754150572612,0.62767094017094,43.80208333333335,1024.791666666669,26.27670940170946,0
4855,4,0,0,40,0.0,0.0,1.0,40,1350,1000,350,0.7407407407407407,17,10,7,370.7084441959552,0.4045405982905983,0.1455546403075232,0.2176209145328286,131414.71021274658,1743.3411055692527,133158.05131831582,4824,14,699.425,36,4,21,34.163005674537786,0.6345486111111112,43.66554054054054,1025.3378378378382,28.481606606606615,0
4856,4,0,0,40,0.0,0.0,1.0,40,750,500,250,0.6666666666666666,10,5,5,372.85727041672214,0.4046073717948718,0.1459696903140788,0.21904763254288215,131443.57829112903,1801.9387630874212,133245.51705421644,4825,15,700.425,36,4,21,34.078720989823566,0.6348379629629629,43.63738738738739,1025.450450450451,28.484734734734747,0
4857,4,0,0,40,0.0,0.0,1.0,40,1150,700,450,0.6086956521739131,16,7,9,373.67546715838813,0.4044070512820513,0.14922861535082887,0.21969415619182966,131472.44953991158,1825.6058000568185,133298.0553399684,4826,16,701.425,36,4,21,34.02854031697228,0.6351273148148149,43.609234234234236,1025.5630630630635,28.487862862862876,0
4858,4,0,0,40,0.0,0.0,1.0,40,1450,1000,450,0.6896551724137931,19,10,9,372.9579587215112,0.40403311965811967,0.1488891936368626,0.22060426954877171,131703.53366457668,1823.9762143900605,133527.50987896675,4827,17,702.425,36,4,19,33.81331139147925,0.6374421296296298,43.384009009009006,1026.4639639639634,28.51288788788787,0
4859,4,1,1,40,0.024390243902439025,0.024390243902439025,0.975609756097561,41,950,700,250,0.7368421052631579,12,7,5,364.66684744502334,0.4061483739837399,0.14910988879464204,0.21773165783118764,132059.6782182978,1431.5573060941642,133491.23552439196,4828,0,686.2682926829268,37,4,19,33.66670222601521,0.6390765765765766,43.037280701754376,1027.8508771929812,27.77975343764814,0
4860,4,0,0,40,0.0,0.0,1.0,40,850,500,350,0.5882352941176471,12,5,7,372.28425047835646,0.40368589743589745,0.15218451924131138,0.22121202922560862,131876.97991488117,1819.1445245921673,133696.12443947335,4829,19,704.425,36,4,19,33.65539231809378,0.6391782407407407,43.215090090090094,1027.13963963964,28.53165665665667,0
4861,4,0,0,40,0.0,0.0,1.0,40,1400,900,500,0.6428571428571429,19,9,10,374.16292881473794,0.4029380341880342,0.1441422937890242,0.2236891537098718,132108.41912436084,1886.0146041311546,133994.433728492,4830,20,705.425,36,4,19,33.373498375141494,0.6414930555555556,42.98986486486486,1028.0405405405404,28.556681681681678,0
4862,4,0,0,40,0.0,0.0,1.0,40,1350,1100,250,0.8148148148148148,16,11,5,374.8934889995246,0.40200320512820514,0.1320716510903428,0.2253573220390399,132315.55103550287,1920.8477153188587,134236.39875082174,4831,21,706.425,38,2,21,33.14576843198338,0.6398026315789473,42.78846153846153,1028.8461538461531,27.07489878542508,0
4863,4,0,0,40,0.0,0.0,1.0,40,450,300,150,0.6666666666666666,6,3,3,374.22582946104353,0.402590811965812,0.1329578488372094,0.22528394933554816,132370.51647308053,1907.2932646650547,134277.80973774559,4832,22,707.425,38,2,21,33.10752353266888,0.6403508771929824,42.73504273504273,1029.0598290598286,27.080521817363913,0
4864,4,0,0,40,0.0,0.0,1.0,40,1400,1100,300,0.7857142857142857,17,11,6,376.01640018094855,0.40221688034188036,0.13874671916010506,0.22740039439514498,132542.91453615774,1967.667625812545,134510.5821619703,4833,23,708.425,36,4,21,32.887685914260715,0.6458333333333335,42.567567567567565,1029.7297297297293,28.60360360360359,0
4865,4,0,0,40,0.0,0.0,1.0,40,750,500,250,0.6666666666666666,10,5,5,373.99134261898826,0.40232371794871796,0.14003389459873228,0.22652482248962016,132600.90115453277,1918.317811054283,134519.21896558706,4834,24,709.425,36,4,22,32.88140535024418,0.6464120370370372,42.511261261261254,1029.9549549549538,28.609859859859828,0
4866,4,0,0,40,0.0,0.0,1.0,40,1000,800,200,0.8,12,8,4,372.47496818033864,0.4018162393162393,0.13703673335519873,0.22578055228267432,132629.8992193206,1880.263498295588,134510.1627176162,4835,25,710.425,36,4,14,32.89124849677491,0.646701388888889,42.483108108108105,1030.067567567567,28.612987987987974,0
4867,4,0,0,40,0.0,0.0,1.0,40,1100,900,200,0.8181818181818182,13,9,4,374.57349113954234,0.4015357905982906,0.14187062937062977,0.22793195418278522,132774.9370992613,1946.7943450206815,134721.731444282,4836,26,711.425,36,4,15,32.69116950757575,0.6481481481481483,42.342342342342334,1030.6306306306296,28.6286286286286,0
4868,4,0,0,40,0.0,0.0,1.0,40,1250,900,350,0.72,16,9,7,376.40344206893093,0.4016292735042735,0.14369019774611957,0.2301983599545097,132962.84072983972,2009.5341835949257,134972.37491343464,4837,27,712.425,37,3,16,32.45490467077751,0.6480855855855856,42.16008771929823,1031.3596491228052,27.874585111427166,0
4869,4,0,0,40,0.0,0.0,1.0,40,1050,700,350,0.6666666666666666,14,7,7,374.61650682557797,0.40076121794871794,0.1331995961313639,0.22962649594279236,133047.67001625494,1968.370676554319,135016.04069280927,4838,28,713.425,37,3,16,32.41566142345982,0.6489301801801801,42.07785087719298,1031.6885964912276,27.88347558084399,0
4870,4,0,0,40,0.0,0.0,1.0,40,1050,700,350,0.6666666666666666,14,7,7,372.76599133392324,0.400627670940171,0.13604323807500318,0.22918656279727107,133160.81781173052,1927.5648516851368,135088.38266341566,4839,29,714.425,37,3,16,32.34965384751586,0.6500563063063063,41.968201754385966,1032.127192982456,27.89532954006638,0
4871,4,1,1,40,0.024390243902439025,0.024390243902439025,0.975609756097561,41,1000,700,300,0.7,13,7,6,366.53151040039637,0.4037855691056911,0.13228093807466101,0.22674300537821068,133389.43591798158,1578.2862836949314,134967.72220167652,4840,0,697.9756097560976,38,3,16,32.28100113765643,0.6504934210526316,41.74679487179487,1033.0128205128203,27.184547908232116,0
4872,4,1,1,40,0.024390243902439025,0.024390243902439025,0.975609756097561,41,1200,900,300,0.75,15,9,6,369.7127535492409,0.40251524390243903,0.1315942551430891,0.22977763409521704,133561.9363667052,1675.9872990516938,135237.92366575688,4841,0,698.9512195121952,35,6,18,32.02573899899228,0.6580357142857143,41.57986111111111,1033.680555555555,29.53373015873014,0
4873,4,0,0,40,0.0,0.0,1.0,40,850,500,350,0.5882352941176471,12,5,7,378.1867845993756,0.39897168803418803,0.13004032258064502,0.23447580645161298,133472.22222222228,2095.4861111111213,135567.7083333334,4842,32,717.425,38,2,18,31.896841397849467,0.6513157894736842,41.66666666666667,1033.333333333334,27.192982456140367,0
4874,4,0,0,40,0.0,0.0,1.0,40,1200,1000,200,0.8333333333333334,14,10,4,392.07450693937204,0.39897168803418803,0.1475000000000002,0.23397994768962507,132040.89506172828,2353.9737654320875,134394.86882716036,4843,33,718.425,35,5,15,32.98141891891891,0.6428571428571428,43.05555555555555,1027.777777777777,29.36507936507934,2
4875,4,1,1,40,0.024390243902439025,0.024390243902439025,0.975609756097561,41,900,700,200,0.7777777777777778,11,7,4,379.45221196872643,0.40292174796747965,0.14456403673348528,0.2285968203811594,132398.0034722221,1848.2253086419669,134246.22878086407,4844,0,701.8780487804878,35,6,18,32.94534412955467,0.6464285714285715,42.70833333333333,1029.1666666666656,29.404761904761873,0
4876,4,0,0,40,0.0,0.0,1.0,40,1100,900,200,0.8181818181818182,13,9,4,387.05015243481637,0.40360576923076924,0.14269373905429084,0.23263751267397917,132311.0948786625,2242.2058883207596,134553.30076698324,4845,1,710.15,36,4,18,32.837583917104496,0.6435185185185186,42.792792792792795,1028.8288288288293,28.57857857857859,0
4877,4,0,0,40,0.0,0.0,1.0,40,1300,800,500,0.6153846153846154,18,8,10,389.37772995803743,0.4032719017094017,0.14576442696889114,0.23495807613029648,132459.27047902485,2315.395077406409,134774.66555643125,4846,2,711.15,34,6,19,32.62812728884777,0.649203431372549,42.64880952380952,1029.4047619047612,30.276610644257683,0
4878,4,0,0,40,0.0,0.0,1.0,40,550,200,350,0.36363636363636365,9,2,7,392.6846245082625,0.403392094017094,0.14835222016651217,0.23714641290135857,132489.90929705213,2405.3500566893313,134895.25935374145,4847,3,712.15,34,6,19,32.51209335491827,0.6495098039215687,42.61904761904761,1029.5238095238092,30.280112044817916,0
4879,4,0,0,40,0.0,0.0,1.0,40,1650,1200,450,0.7272727272727273,21,12,9,390.7452791654885,0.4025373931623932,0.14211165048543695,0.23674566914144293,132612.49999999988,2363.5416666666524,134976.04166666654,4848,4,713.15,34,6,19,32.43830906148867,0.6507352941176471,42.49999999999999,1029.999999999999,30.294117647058798,0
4880,4,0,0,40,0.0,0.0,1.0,40,800,600,200,0.75,10,6,4,386.4764132780202,0.4023370726495727,0.134231805929919,0.23505368741991062,132755.59413580247,2261.3811728394985,135016.97530864197,4849,5,714.15,35,5,17,32.40397574123989,0.65,42.36111111111111,1030.5555555555554,29.44444444444444,0
4881,4,0,1,39,0.0,0.025,0.975,40,1000,700,300,0.7,13,7,6,384.5773783519524,0.401963141025641,0.14390017474879846,0.23474603174603167,132891.02447041633,2221.3763594675693,135112.4008298839,4850,6,715.15,36,4,17,32.31646825396824,0.6493055555555556,42.229729729729726,1031.0810810810808,28.641141141141134,0
4882,4,0,1,38,0.0,0.02564102564102564,0.9743589743589743,39,1000,600,400,0.6,14,6,8,387.74851402219883,0.4016250562303194,0.15239542675555295,0.23657970978833856,132874.8981910149,2504.408864883381,135379.30705589827,4851,7,731.3076923076923,35,4,17,32.25097290824726,0.6511904761904763,42.24537037037036,1031.0185185185169,29.45767195767191,0
4883,4,0,1,37,0.0,0.02631578947368421,0.9736842105263158,38,1050,900,150,0.8571428571428571,12,9,3,390.4646771507237,0.40008594120436225,0.1579433460122257,0.23851939587302992,132919.22477324243,2780.0524376417025,135699.27721088415,4852,8,746.1315789473684,34,4,17,32.13629454321558,0.6537990196078433,42.20238095238094,1031.1904761904748,30.329131652661022,0
4884,4,0,0,37,0.0,0.0,1.0,37,950,800,150,0.8421052631578947,11,8,3,398.84741708034034,0.39627127127127126,0.1623935469357587,0.24271394917841235,132776.64389898098,3191.524293540923,135968.1681925219,4853,43,767.081081081081,33,4,18,32.064011097899325,0.6546717171717172,42.34068627450979,1030.6372549019593,31.23143196672604,0
4885,4,0,0,37,0.0,0.0,1.0,37,900,600,300,0.6666666666666666,12,6,6,398.22194087310424,0.39545795795795796,0.1594125620747915,0.24315235199610286,132902.97752066507,3184.9763312187497,136087.95385188382,4854,44,768.081081081081,33,4,18,31.952697884478248,0.6559343434343434,42.218137254901954,1031.1274509803916,31.2462863933452,0
4886,4,0,0,37,0.0,0.0,1.0,37,650,600,50,0.9230769230769231,7,6,1,410.47543803333747,0.39561436436436437,0.16285636556375893,0.24688512254155398,132336.75063775497,3465.4136164269416,135802.1642541819,4855,45,769.081081081081,34,3,21,32.20910949130316,0.6479779411764708,42.76785714285713,1028.9285714285702,30.26260504201677,2
4887,4,0,0,37,0.0,0.0,1.0,37,1050,600,450,0.5714285714285714,15,6,9,408.25705070244464,0.39480105105105107,0.16545764079282899,0.24638780479797937,132465.0149875218,3415.9977850189666,135881.01277254077,4856,46,770.081081081081,31,6,21,32.13645754279449,0.6565860215053763,42.64322916666667,1029.4270833333342,33.20732526881723,0
4888,4,0,0,37,0.0,0.0,1.0,37,1000,800,200,0.8,12,8,4,406.31212153558374,0.39458208208208206,0.17291282938014496,0.245870127714226,132565.56404961488,3372.5991143120764,135938.16316392695,4857,47,771.081081081081,31,6,21,32.08488746997092,0.6575940860215054,42.54557291666667,1029.8177083333342,33.219926075268845,0
4889,4,0,0,37,0.0,0.0,1.0,37,1350,900,450,0.6666666666666666,18,9,9,406.6284217588121,0.39470720720720726,0.17293471912453362,0.24694172689006005,132699.6888054743,3391.8930053711133,136091.5818108454,4858,48,772.081081081081,31,6,18,31.941241206453526,0.6589381720430106,42.41536458333334,1030.3385416666677,33.23672715053767,0
4890,4,0,0,37,0.0,0.0,1.0,37,950,600,350,0.631578947368421,13,6,7,403.83469464495477,0.39448823823823825,0.16858692720761703,0.24612465569700587,132833.8813781738,3328.5859849717876,136162.46736314558,4859,49,773.081081081081,31,6,18,31.87773672687467,0.6602822580645162,42.28515625,1030.8593749999998,33.25352822580644,0
4891,4,0,0,37,0.0,0.0,1.0,37,800,600,200,0.75,10,6,4,409.98511044409844,0.394019019019019,0.17494899595379287,0.25099706684220624,133001.71746148015,3505.7447645399493,136507.46222602008,4860,50,774.081081081081,31,6,18,31.5497980308003,0.6619623655913978,42.12239583333334,1031.5104166666677,33.27452956989251,0
4892,4,0,0,37,0.0,0.0,1.0,37,1000,600,400,0.6,14,6,8,412.49772892962676,0.39414414414414417,0.1714667721734855,0.2529900931918238,133068.88156467024,3578.1222873263982,136647.00385199665,4861,51,775.081081081081,31,6,18,31.417213528520946,0.6626344086021505,42.05729166666667,1031.7708333333342,33.28293010752691,0
4893,4,0,0,37,0.0,0.0,1.0,37,950,800,150,0.8421052631578947,11,8,3,412.2719792879801,0.3937374874874875,0.17497502548593746,0.25353607291045926,133169.65950859923,3580.423821343325,136750.08332994254,4862,52,776.081081081081,31,6,18,31.32135423237038,0.6636424731182795,41.95963541666667,1032.161458333334,33.29553091397852,0
4894,4,0,0,37,0.0,0.0,1.0,37,950,700,250,0.7368421052631579,12,7,5,411.6961878515789,0.3933621121121121,0.17348840282825617,0.2543561039747673,133341.78272625254,3579.2607259463484,136921.04345219888,4863,53,777.081081081081,32,5,18,31.16264262428689,0.6627604166666665,41.7929292929293,1032.8282828282838,32.27588383838387,0
4895,4,0,0,37,0.0,0.0,1.0,37,1150,800,350,0.6956521739130435,15,8,7,413.9568158168573,0.3923923923923924,0.16913687881429817,0.25665322580645167,133472.22222222228,3650.3472222222317,137122.5694444445,4864,54,778.081081081081,32,5,19,30.972782258064512,0.6640625,41.66666666666667,1033.333333333334,32.291666666666686,0
4896,4,0,0,37,0.0,0.0,1.0,37,1100,700,400,0.6363636363636364,15,7,8,412.2647164555285,0.39229854854854856,0.16893083559750255,0.25606864782660294,133539.5050048828,3610.7252332899316,137150.23023817275,4865,55,779.081081081081,31,6,19,30.948706643151098,0.6673387096774194,41.6015625,1033.59375,33.341733870967744,0
4897,4,0,0,37,0.0,0.0,1.0,37,1000,700,300,0.7,13,7,6,428.77723955131194,0.3917980480480481,0.21481893573803568,0.2495029675272117,131077.01965590141,3840.568531334083,134917.5881872355,4866,56,780.081081081081,33,4,15,33.01819052178075,0.6376262626262628,43.99509803921568,1024.019607843136,31.03089720736776,7
4898,4,0,0,37,0.0,0.0,1.0,37,1250,800,450,0.64,17,8,9,427.6344406034665,0.3901088588588589,0.21309970257338717,0.24965250862045915,131202.54229142616,3821.3451557093185,135023.88744713546,4867,57,781.081081081081,33,4,15,32.91965709728868,0.6388888888888891,43.87254901960783,1024.509803921567,31.045751633986878,0
4899,4,0,0,37,0.0,0.0,1.0,37,350,100,250,0.2857142857142857,6,1,5,432.61567147840594,0.38979604604604606,0.2159123601534796,0.2527672696876975,131233.93233672142,3954.7711517204807,135188.7034884419,4868,58,782.081081081081,33,4,15,32.76011143005221,0.6392045454545455,43.84191176470588,1024.6323529411761,31.0494652406417,0
4900,4,0,0,37,0.0,0.0,1.0,37,1350,1100,250,0.8148148148148148,16,11,5,433.2527191650807,0.38982732732732733,0.22100450719697617,0.2539704972540925,131359.5300635573,3982.3747176566694,135341.90478121396,4869,59,783.081081081081,33,4,16,32.615934449093444,0.6404671717171717,43.71936274509804,1025.1225490196077,31.06431966726084,0
4901,4,1,2,36,0.02631578947368421,0.05263157894736842,0.9473684210526316,38,500,400,100,0.8,6,4,2,426.03997400972366,0.3947368421052631,0.21152449038150434,0.25174027525276405,131663.90483276636,3618.817318594097,135282.72215136045,4870,0,763.4473684210526,34,4,15,32.49139697637552,0.6412377450980392,43.422619047619044,1026.3095238095232,30.18557422969186,0
4902,4,1,1,36,0.02702702702702703,0.02702702702702703,0.972972972972973,37,950,600,350,0.631578947368421,13,6,7,425.26164857237274,0.3928303303303304,0.20280770159002803,0.2516836784927638,131725.00177154187,3803.5182823129153,135528.5200538548,4871,0,771.6756756756756,34,3,15,32.44931191773937,0.6418504901960784,43.363095238095234,1026.5476190476184,30.192577030812306,0
4903,4,0,0,36,0.0,0.0,1.0,36,700,300,400,0.42857142857142855,11,3,8,431.505696986908,0.3876653439153439,0.20815416467590397,0.254406034871436,131579.47063629364,4155.458237216446,135734.9288735101,4872,62,794.1111111111111,33,3,15,32.43699235547062,0.6426767676767677,43.50490196078431,1025.980392156862,31.090314913844306,0
4904,4,0,0,36,0.0,0.0,1.0,36,1050,800,250,0.7619047619047619,13,8,5,428.40712856763645,0.3877810846560847,0.2015812373978565,0.25341370825441534,131705.23356401373,4084.6921856977947,135789.92574971152,4873,63,795.1111111111111,33,3,16,32.3886700095511,0.643939393939394,43.382352941176464,1026.4705882352932,31.10516934046343,0
4905,4,0,0,36,0.0,0.0,1.0,36,850,400,450,0.47058823529411764,13,4,9,429.25500619216666,0.38773148148148145,0.20345954473743477,0.25496713018402206,131862.521701389,4120.529513888899,135983.0512152779,4874,64,796.1111111111111,33,3,16,32.20715010141988,0.6455176767676767,43.22916666666667,1027.0833333333342,31.1237373737374,0
4906,4,0,0,36,0.0,0.0,1.0,36,600,200,400,0.3333333333333333,10,2,8,430.71070531489096,0.3877810846560847,0.20378986717569436,0.2560437682233628,131893.9905925605,4161.6307429834615,136055.62133554395,4875,65,797.1111111111111,33,3,16,32.1378151594687,0.6458333333333334,43.1985294117647,1027.2058823529408,31.127450980392144,0
4907,4,2,2,36,0.05263157894736842,0.05263157894736842,0.9473684210526316,38,900,500,400,0.5555555555555556,13,5,8,412.8899014899438,0.39386261261261263,0.19038994246750462,0.2487409894341859,132398.00347222236,3334.1208910034793,135732.12436322586,4876,0,756.1052631578947,34,4,16,32.08502024291499,0.6485906862745097,42.70833333333334,1029.1666666666679,30.26960784313729,0
4908,4,0,0,36,0.0,0.0,1.0,36,850,600,250,0.7058823529411765,11,6,5,429.36306356765976,0.38745039682539684,0.19991522280506535,0.2565169072083713,132082.88278546726,4142.302239523276,136225.18502499053,4877,67,799.1111111111111,33,3,16,31.980706564934046,0.6477272727272727,43.01470588235295,1027.9411764705892,31.149732620320886,0
4909,4,0,0,36,0.0,0.0,1.0,36,850,600,250,0.7058823529411765,11,6,5,428.17816203806956,0.3875661375661376,0.19900013243279036,0.2562350056704283,132145.87688629385,4116.395737216469,136262.2726235103,4878,68,800.1111111111111,33,3,16,31.947258641239575,0.6483585858585857,42.953431372549026,1028.1862745098047,31.157159833630445,0
4910,4,0,0,36,0.0,0.0,1.0,36,1000,800,200,0.8,12,8,4,421.43821249850544,0.3868716931216931,0.1939017933955396,0.25325510335898044,132303.42784325755,3951.544027537507,136254.97187079507,4879,69,801.1111111111111,33,3,16,31.960864601945612,0.6499368686868685,42.80024509803923,1028.7990196078445,31.175727866904378,0
4911,4,0,0,36,0.0,0.0,1.0,36,400,300,100,0.75,5,3,2,421.43821249850544,0.3868716931216931,0.1939017933955396,0.25325510335898044,132303.42784325755,3951.544027537507,136254.97187079507,4880,70,802.1111111111111,33,3,16,31.960864601945612,0.6499368686868685,42.80024509803923,1028.7990196078445,31.175727866904378,0
4912,4,0,0,36,0.0,0.0,1.0,36,600,300,300,0.5,9,3,6,403.2623957523391,0.3870701058201058,0.17746611138330892,0.24568911932254453,132820.6624324049,3512.3494986708274,136333.01193107574,4881,71,803.1111111111111,32,4,16,31.905826392291374,0.6575520833333334,42.2979797979798,1030.808080808081,32.21275252525253,1
4913,4,0,0,36,0.0,0.0,1.0,36,800,500,300,0.625,11,5,6,370.8322629283974,0.3867724867724868,0.12406197752634252,0.21095852621666547,130201.83000283434,2456.6078514739042,132658.43785430823,4882,72,804.1111111111111,34,2,20,35.389449434270375,0.6265318627450981,44.85119047619047,1020.595238095237,30.01750700280109,8
4914,4,0,0,36,0.0,0.0,1.0,36,800,700,100,0.875,9,7,2,371.67846730528964,0.3871693121693122,0.12709750566893452,0.2117702895111532,130262.58680555539,2483.159722222203,132745.74652777758,4883,73,805.1111111111111,34,2,20,35.30612244897958,0.6271446078431373,44.79166666666666,1020.833333333332,30.02450980392153,0
4915,4,0,0,36,0.0,0.0,1.0,36,500,400,100,0.8,6,4,2,375.0846252645356,0.3873842592592593,0.12997512437810954,0.21387804164020324,130292.97052154191,2574.1780045351425,132867.14852607704,4884,74,806.1111111111111,34,2,20,35.18831623134328,0.6274509803921569,44.76190476190476,1020.9523809523806,30.028011204481782,0
4916,4,0,0,36,0.0,0.0,1.0,36,650,500,150,0.7692307692307693,8,5,3,376.2024462367768,0.387119708994709,0.12756793865443883,0.21485117069367984,130353.7485827664,2607.8798185940973,132961.6284013605,4885,75,807.1111111111111,34,2,20,35.098022071967044,0.6280637254901962,44.70238095238095,1021.1904761904759,30.035014005602232,0
4917,4,1,0,37,0.02702702702702703,0.0,1.0,37,800,600,200,0.75,10,6,4,368.82533919737796,0.39339339339339335,0.12609349956565863,0.212724588586686,130735.62349965695,2243.7221364883244,132979.34563614527,4886,0,786.2702702702703,35,2,19,34.89889844575223,0.6297619047619047,44.328703703703695,1022.6851851851843,29.219576719576693,0
4918,4,0,0,37,0.0,0.0,1.0,37,800,400,400,0.5,12,4,8,366.77835059760537,0.3926739239239239,0.1204734545610211,0.21203099025063643,130824.41332572428,2196.7125075016947,133021.12583322596,4887,1,787.2702702702703,35,2,19,34.861244673228505,0.630654761904762,44.24189814814814,1023.032407407406,29.229497354497315,0
4919,4,0,0,37,0.0,0.0,1.0,37,850,600,250,0.7058823529411765,11,6,5,368.22976315102346,0.39311186186186187,0.1181939601028148,0.21352497019963912,130942.84664619755,2243.410681370009,133186.25732756755,4888,2,788.2702702702703,35,2,19,34.70412096196614,0.6318452380952382,44.1261574074074,1023.4953703703691,29.24272486772483,0
4920,4,0,0,37,0.0,0.0,1.0,37,700,500,200,0.7142857142857143,9,5,4,369.811237386523,0.393018018018018,0.12020976200080735,0.21460699366446218,130972.46334876513,2287.0177469135497,133259.48109567867,4889,3,789.2702702702703,35,2,19,34.6336499321574,0.6321428571428573,44.09722222222221,1023.6111111111087,29.246031746031676,0
4921,4,0,0,37,0.0,0.0,1.0,37,400,300,100,0.75,5,3,2,371.71384189935304,0.39314314314314314,0.12222510809283027,0.21587714586997833,131002.0834003126,2339.0575435099036,133341.1409438225,4890,4,790.2702702702703,35,2,19,34.5549510081025,0.6324404761904763,44.06828703703702,1023.7268518518491,29.249338624338545,0
4922,4,0,0,37,0.0,0.0,1.0,37,1350,1100,250,0.8148148148148148,16,11,5,370.67086411994313,0.39258008008008005,0.1197971217178091,0.21626946725943377,131179.8740381727,2324.911452974934,133504.78549114763,4891,5,791.2702702702703,35,2,20,34.401597747900425,0.6342261904761907,43.89467592592591,1024.421296296294,29.26917989417983,0
4923,4,0,0,37,0.0,0.0,1.0,37,950,700,250,0.7368421052631579,12,7,5,371.51172394810385,0.3923611111111111,0.12071176463404232,0.21692755807312736,131209.51753257864,2349.174811385431,133558.69234396407,4892,6,792.2702702702703,35,2,20,34.35005271878294,0.6345238095238097,43.865740740740726,1024.5370370370351,29.27248677248672,0
4924,4,1,0,38,0.02631578947368421,0.0,1.0,38,950,600,350,0.631578947368421,13,6,7,363.5922919018527,0.3946775723091513,0.12489309571689478,0.21392755779341546,131501.32395909406,1962.5735532829985,133463.89751237707,4893,0,772.3947368421053,36,2,21,34.257886839408584,0.6354166666666667,43.581081081081074,1025.6756756756745,28.49099099099096,0
4925,4,0,1,37,0.0,0.02631578947368421,0.9736842105263158,38,750,400,350,0.5333333333333333,11,4,7,364.319154963875,0.39421823138928397,0.12144660300735399,0.21484218905345395,131587.96623904296,1988.003332724601,133575.96957176755,4894,1,773.3947368421053,36,2,18,34.15171221600262,0.6362847222222223,43.496621621621614,1026.0135135135124,28.500375375375345,0
4926,4,0,0,37,0.0,0.0,1.0,37,1000,800,200,0.8,12,8,4,370.05478065152033,0.39176676676676675,0.12893426097353422,0.2175882821070418,131476.45968632106,2330.698490011993,133807.15817633306,4895,2,793.027027027027,35,2,21,34.117316518075455,0.637202380952381,43.60532407407407,1025.578703703703,29.302248677248656,0
4927,4,0,1,36,0.0,0.02702702702702703,0.972972972972973,37,1000,600,400,0.6,14,6,8,370.21470242506666,0.3910472972972973,0.1290027475292057,0.21802079120221693,131535.817003708,2339.2986700531524,133875.11567376117,4896,3,794.027027027027,35,2,22,34.0532033923803,0.6377976190476191,43.5474537037037,1025.8101851851852,29.308862433862434,0
4928,4,0,0,36,0.0,0.0,1.0,36,950,600,350,0.631578947368421,13,6,7,375.3440943368083,0.3922453703703704,0.12078303930671619,0.2208992292900235,131511.22448979603,2672.3922902494437,134183.61678004547,4897,4,797.2222222222222,34,2,22,33.946533580934684,0.6397058823529411,43.57142857142858,1025.7142857142865,30.168067226890777,0
4929,4,0,0,36,0.0,0.0,1.0,36,550,200,350,0.36363636363636365,9,2,7,378.6292223497408,0.39143518518518516,0.12414755514303066,0.22336791700427236,131602.82206632668,2765.7348356009297,134368.5569019276,4898,5,798.2222222222222,34,2,18,33.76962718026068,0.6406249999999998,43.48214285714287,1026.0714285714298,30.178571428571466,0
4930,4,0,0,36,0.0,0.0,1.0,36,850,700,150,0.8235294117647058,10,7,3,378.60476633954346,0.3912202380952381,0.12316318638824386,0.22353240314019654,131633.36167800473,2767.4036281179356,134400.76530612266,4899,6,799.2222222222222,34,2,19,33.739365815931954,0.6409313725490196,43.45238095238096,1026.1904761904777,30.182072829131698,0
4931,4,1,0,37,0.02702702702702703,0.0,1.0,37,1000,600,400,0.6,14,6,8,371.52670164677784,0.39395645645645644,0.1301242670920526,0.22137007095436884,131981.42387902958,2406.9246184842355,134388.34849751383,4900,0,778.5945945945946,35,2,20,33.569403769617786,0.6422619047619047,43.11342592592593,1027.546296296297,29.35846560846563,0
4932,4,0,0,37,0.0,0.0,1.0,37,750,200,550,0.26666666666666666,13,2,11,371.16780591650695,0.3928928928928929,0.13634620885240123,0.221851443617121,132100.37964034645,2406.2816143690106,134506.66125471547,4901,1,779.5945945945946,35,2,21,33.45858665465736,0.6434523809523809,42.99768518518519,1028.00925925926,29.371693121693145,0
4933,4,0,0,37,0.0,0.0,1.0,37,850,300,550,0.35294117647058826,14,3,11,371.2606994630476,0.3929241741741742,0.13704564537522645,0.2222560683308435,132159.87761488356,2413.1537208504988,134573.03133573406,4902,2,780.5945945945946,35,2,21,33.396180399219574,0.644047619047619,42.939814814814824,1028.240740740742,29.378306878306915,0
4934,4,0,0,37,0.0,0.0,1.0,37,650,400,250,0.6153846153846154,9,4,5,369.1963089472815,0.39229854854854856,0.1390795544053105,0.22154271422110006,132249.14969403727,2365.179585691017,134614.3292797283,4903,3,781.5945945945946,35,2,23,33.35923727542101,0.6449404761904761,42.85300925925926,1028.5879629629635,29.38822751322753,0
4935,4,0,0,37,0.0,0.0,1.0,37,950,700,250,0.7368421052631579,12,7,5,371.89593934077357,0.3913601101101101,0.1415033321212631,0.22423216041085126,132429.5361910083,2450.1688006319437,134879.70499164023,4904,4,782.5945945945946,33,4,23,33.10798408540698,0.651199494949495,42.677696078431374,1029.2892156862747,31.190582293523477,0
4936,4,0,0,37,0.0,0.0,1.0,37,1050,800,250,0.7619047619047619,13,8,5,371.86961451247134,0.39129754754754753,0.13791505791505765,0.2244040777230432,132461.07266435993,2451.649605920803,134912.72227028073,4905,5,783.5945945945946,33,4,23,33.0768849206349,0.6515151515151515,42.64705882352941,1029.411764705883,31.19429590017827,0
4937,4,1,1,37,0.02631578947368421,0.02631578947368421,0.9736842105263158,38,1100,700,400,0.6363636363636364,15,7,8,350.39594223901463,0.39414414414414417,0.10505017039000397,0.21176102596183935,132517.14677640604,1686.694101508921,134203.84087791495,4906,0,763.9473684210526,35,3,17,33.57314148681056,0.6476190476190475,42.592592592592595,1029.6296296296298,29.41798941798942,5
4938,4,0,0,37,0.0,0.0,1.0,37,850,600,250,0.7058823529411765,11,6,5,358.2013672811518,0.39117242242242245,0.1074329013260309,0.21596994571219236,132428.63520408166,2087.2236394557863,134515.85884353745,4907,7,785.5945945945946,34,3,18,33.46128267406894,0.6488970588235294,42.67857142857143,1029.2857142857144,30.273109243697483,0
4939,4,0,0,37,0.0,0.0,1.0,37,800,600,200,0.75,10,6,4,362.2460689598309,0.3908596096096096,0.11568905013233843,0.21894243539018696,132520.55165816317,2201.0097789115525,134721.5614370747,4908,8,786.5945945945946,34,3,18,33.26468377847149,0.6498161764705883,42.58928571428571,1029.6428571428564,30.28361344537813,0
4940,4,0,0,37,0.0,0.0,1.0,37,1250,800,450,0.64,17,8,9,361.9365832470182,0.3905155155155155,0.11938759568817381,0.2189336674885806,132551.19756235805,2195.0255102040546,134746.2230725621,4909,9,787.5945945945946,34,3,19,33.24181117533718,0.6501225490196079,42.559523809523796,1029.761904761903,30.287114845938323,0
4941,4,0,0,37,0.0,0.0,1.0,37,1250,1000,250,0.8,15,10,5,362.239529936796,0.3897647647647648,0.11449790442163943,0.21983316213695847,132673.8166099771,2211.9401927437348,134885.75680272083,4910,10,788.5945945945946,34,3,16,33.11065210692549,0.6513480392156864,42.440476190476176,1030.2380952380934,30.301120448179216,0
4942,4,0,0,37,0.0,0.0,1.0,37,900,600,300,0.6666666666666666,12,6,6,362.3880824158027,0.3892017017017017,0.10852016257421715,0.2206438830911405,132796.4923469387,2224.7732426303805,135021.26558956908,4911,11,789.5945945945946,34,3,16,32.98346423346424,0.6525735294117647,42.32142857142857,1030.714285714285,30.31512605042015,0
4943,4,0,0,37,0.0,0.0,1.0,37,650,300,350,0.46153846153846156,10,3,7,362.3880824158027,0.38895145145145144,0.10852016257421715,0.2206438830911405,132796.4923469387,2224.7732426303805,135021.26558956908,4912,12,790.5945945945946,34,3,16,32.98346423346424,0.6525735294117647,42.32142857142857,1030.714285714285,30.31512605042015,0
4944,4,0,0,37,0.0,0.0,1.0,37,650,400,250,0.6153846153846154,9,4,5,371.3866732918698,0.3890765765765766,0.14984350793123125,0.21891999660939368,131572.28599773248,2374.553571428581,133946.83956916106,4913,13,791.5945945945946,34,3,17,33.98627871896032,0.6403186274509803,43.511904761904766,1025.9523809523814,30.17507002801122,2
4945,4,0,0,37,0.0,0.0,1.0,37,450,100,350,0.2222222222222222,8,1,7,371.3866732918698,0.3890765765765766,0.14984350793123125,0.21891999660939368,131572.28599773248,2372.8387188208712,133945.12471655334,4914,14,792.5945945945946,34,3,17,33.98627871896032,0.6403186274509803,43.511904761904766,1025.9523809523814,30.17507002801122,0
4946,4,0,0,37,0.0,0.0,1.0,37,1100,500,600,0.45454545454545453,17,5,12,369.0108241824203,0.389014014014014,0.14402292328286936,0.21804265354877667,131663.90483276668,2317.081207483014,133980.9860402497,4915,15,793.5945945945946,34,3,18,33.95463596643853,0.6412377450980391,43.42261904761906,1026.3095238095257,30.18557422969193,0
4947,4,1,1,37,0.02631578947368421,0.02631578947368421,0.9736842105263158,38,600,300,300,0.5,9,3,6,359.19260464193627,0.39266239924134666,0.13552260934025173,0.21351871173457357,131892.24222232937,1874.9436031807254,133767.1858255101,4916,0,773.6842105263158,35,3,18,33.9761737089202,0.6413690476190477,43.20023148148148,1027.199074074074,29.348544973544968,0
4948,4,0,1,36,0.0,0.02702702702702703,0.972972972972973,37,800,700,100,0.875,9,7,2,366.28197791200233,0.38904529529529525,0.14094925262732305,0.2167775906338503,131725.0017715421,2249.698837868501,133974.7006094106,4917,17,795.5945945945946,34,3,18,33.962947929954765,0.6418504901960783,43.36309523809525,1026.5476190476202,30.19257703081236,0
4949,4,0,0,36,0.0,0.0,1.0,36,650,400,250,0.6153846153846154,9,4,5,368.38917557525986,0.3869047619047619,0.14487570356472812,0.20242415523877688,128838.54875283455,2292.5453514739374,131131.0941043085,4918,18,818.0277777777778,34,2,16,36.840408067542214,0.6127450980392156,46.1904761904762,1015.238095238096,29.85994397759106,7
4950,4,1,0,37,0.02702702702702703,0.0,1.0,37,800,600,200,0.75,10,6,4,361.1260413867237,0.3907032032032032,0.15042091271599434,0.20026080476900143,129201.38888888898,1932.10742630386,131133.49631519284,4919,0,796.8918918918919,34,3,18,36.654713114754074,0.616421568627451,45.833333333333336,1016.6666666666674,29.901960784313747,0
4951,4,3,1,39,0.075,0.025,0.975,40,600,400,200,0.6666666666666666,8,4,4,338.582322898676,0.4006410256410256,0.14490103270223753,0.19098672777100076,129871.11418898118,794.4127039088908,130665.52689289008,4920,0,738.05,37,3,15,36.547529403327594,0.617117117117117,45.175438596491226,1019.2982456140348,27.54860123281175,0
4952,4,2,0,41,0.04878048780487805,0.0,1.0,41,1000,600,400,0.6,14,6,8,332.3615160349854,0.40520833333333334,0.15550024888003966,0.18936877076411973,130262.58680555563,458.85416666667777,130721.4409722223,4921,0,721.0,38,3,17,36.30952380952382,0.6192434210526315,44.79166666666667,1020.833333333334,26.864035087719316,0
4953,4,2,2,41,0.046511627906976744,0.046511627906976744,0.9534883720930233,43,850,700,150,0.8235294117647058,10,7,3,316.77252587852604,0.41087578442229605,0.13552637662397715,0.18230730036258425,130651.9143697535,-322.6126148456532,130329.30175490785,4922,0,688.4186046511628,40,3,10,36.314198144466545,0.6197916666666667,44.41056910569106,1022.3577235772361,25.558943089430905,0
4954,4,1,1,41,0.023809523809523808,0.023809523809523808,0.9761904761904762,42,800,600,200,0.75,10,6,4,325.2079501623681,0.40684281842818426,0.14520510730779668,0.1873381008681813,130688.28125000026,100.17361111114059,130788.4548611114,4923,0,705.7857142857143,39,3,11,36.06187177397448,0.6217948717948717,44.375000000000014,1022.500000000002,26.21794871794877,0
4955,4,0,0,41,0.0,0.0,1.0,41,850,600,250,0.7058823529411765,11,6,5,331.6218931792238,0.40266768292682925,0.14720844542475708,0.1902797485458475,130535.3879597671,457.67849642049384,130993.0664561876,4924,1,723.9512195121952,38,3,11,36.05244816170064,0.6219846491228069,44.524572649572654,1021.9017094017105,26.892150247413433,0
4956,4,1,1,41,0.023809523809523808,0.023809523809523808,0.9761904761904762,42,900,400,500,0.4444444444444444,14,4,10,324.9197971914743,0.4062620983352691,0.13385403031096366,0.18794830671464452,130848.09570312512,103.02734375001455,130951.12304687513,4925,0,707.6904761904761,39,3,11,35.90791081246183,0.6233974358974359,44.21875000000001,1023.1250000000009,26.233974358974383,0
4957,4,0,2,39,0.0,0.04878048780487805,0.9512195121951219,41,1100,1000,100,0.9090909090909091,12,10,2,329.8469686436208,0.40238821138211384,0.13427626651449298,0.19046772483679297,130781.15297866912,427.55337314633704,131208.70635181546,4926,3,725.9512195121952,38,3,11,35.849479493071506,0.6244517543859648,44.28418803418804,1022.8632478632488,26.917453891138127,0
4958,4,1,2,38,0.025,0.05,0.95,40,900,500,400,0.5555555555555556,13,5,8,338.7533875338754,0.40184294871794873,0.10630081300813021,0.1984126984126984,131328.125,897.5694444444442,132225.69444444444,4927,0,744.775,37,3,16,35.06944444444445,0.6317567567567568,43.75,1025.0,27.7027027027027,2
4959,4,0,0,38,0.0,0.0,1.0,38,750,400,350,0.5333333333333333,11,4,7,349.84432256264967,0.39421823138928397,0.12930520761616027,0.20413943568649284,131183.87972009167,1578.7871063631148,132762.66682645478,4928,5,784.7631578947369,36,2,18,34.930929610494296,0.6322337962962963,43.890765765765764,1024.4369369369367,28.456581581581574,0
4960,4,0,0,38,0.0,0.0,1.0,38,750,500,250,0.6666666666666666,10,5,5,350.4211318381159,0.3939366998577525,0.12723444134627626,0.20462974694885605,131212.72243527306,1595.9421414657804,132808.66457673884,4929,6,785.7631578947369,36,2,18,34.88701729317798,0.6325231481481481,43.86261261261261,1024.549549549549,28.459709709709696,0
4961,4,0,0,38,0.0,0.0,1.0,38,1100,900,200,0.8181818181818182,13,9,4,352.56604530955065,0.3932550972024656,0.13715226200520525,0.206823180751788,131387.44882758908,1664.6013736928794,133052.05020128196,4930,7,786.7631578947369,35,3,20,34.655584405810195,0.6363095238095238,43.692129629629626,1025.2314814814808,29.292328042328023,0
4962,4,0,0,38,0.0,0.0,1.0,38,1300,1000,300,0.7692307692307693,16,10,6,350.3368508967792,0.39319582740635367,0.13995296297616044,0.20615439393408092,131506.13667052475,1614.2891589506253,133120.42582947537,4931,8,787.7631578947369,35,3,20,34.592924847664186,0.6375,43.57638888888889,1025.694444444445,29.30555555555557,0
4963,4,0,0,38,0.0,0.0,1.0,38,700,400,300,0.5714285714285714,10,4,6,352.19665541498136,0.39306247036510195,0.14531124766230308,0.2077327578345847,131595.18771701376,1669.476996527767,133264.66471354154,4932,9,788.7631578947369,35,3,14,34.45537225042301,0.6383928571428572,43.48958333333333,1026.0416666666656,29.31547619047616,0
4964,4,0,0,38,0.0,0.0,1.0,38,1400,1100,300,0.7857142857142857,17,11,6,352.6845280153119,0.39387743006164055,0.14427412082957614,0.20915889923474917,131803.09070644723,1696.9821673525405,133500.07287379977,4933,10,789.7631578947369,35,3,17,34.23316801923653,0.6404761904761904,43.28703703703704,1026.8518518518522,29.33862433862435,0
4965,4,0,0,38,0.0,0.0,1.0,38,1100,600,500,0.5454545454545454,16,6,10,338.9714700907901,0.39377370791844474,0.09950657894736836,0.18743128346196647,129086.92476260052,1241.4310910635459,130328.35585366406,4934,11,790.7631578947369,36,2,19,37.334238327423165,0.6111111111111112,45.94594594594595,1016.2162162162168,28.228228228228247,8
4966,4,1,1,38,0.02564102564102564,0.02564102564102564,0.9743589743589743,39,1000,600,400,0.6,14,6,8,333.1141856589886,0.39811066126855604,0.1028819899751936,0.18553351129736784,129373.18019032561,819.2590394448689,130192.43922977048,4935,0,771.4615384615385,36,3,20,37.192135266769974,0.6140046296296295,45.66441441441442,1017.3423423423435,28.25950950950954,0
4967,4,1,1,38,0.02564102564102564,0.02564102564102564,0.9743589743589743,39,950,700,250,0.7368421052631579,12,7,5,333.19726820585845,0.39718286099865047,0.10447604539871347,0.18625665475032507,129516.42679419294,830.9039191218335,130347.33071331478,4936,0,772.4358974358975,36,3,16,37.04456613932219,0.6154513888888888,45.52364864864865,1017.9054054054062,28.27515015015017,0
4968,4,2,1,39,0.05,0.025,0.975,40,1200,800,400,0.6666666666666666,16,8,8,321.9425540181667,0.40089476495726495,0.10930676562331954,0.18173041437200313,129899.05698147492,364.0068338334704,130263.06381530839,4937,0,754.075,37,3,17,36.943256785342925,0.6173986486486487,45.148026315789465,1019.407894736841,27.55156472261732,0
4969,4,1,0,40,0.025,0.0,1.0,40,1000,900,100,0.9,11,9,2,322.37712022800895,0.4001736111111111,0.11329475227820307,0.1826548585647952,130044.55133912252,384.6775924099504,130429.22893153247,4938,0,755.05,38,2,18,36.784897524527786,0.6170504385964912,45.005341880341874,1019.9786324786314,26.841542959963984,0
4970,4,0,0,40,0.0,0.0,1.0,40,1050,800,250,0.7619047619047619,13,8,5,325.2980120025611,0.4000400641025641,0.1160923940786116,0.18471269725014955,130129.69970703099,466.1865234374704,130595.88623046846,4939,1,756.05,39,1,19,36.62423430321591,0.6161858974358976,44.921874999999986,1020.312499999998,26.16185897435892,0
4971,4,1,0,41,0.024390243902439025,0.0,1.0,41,950,700,250,0.7368421052631579,12,7,5,324.786790686513,0.40261686991869916,0.1355831087866528,0.18658126406417216,130581.79253472202,282.31608072914753,130864.10861545116,4940,0,738.5853658536586,39,2,16,36.18018752547901,0.6207264957264957,44.47916666666666,1022.0833333333317,26.207264957264915,0
4972,4,0,0,41,0.0,0.0,1.0,41,1100,700,400,0.6363636363636364,15,7,8,320.9632921217774,0.4019563008130081,0.13607842650000657,0.18476567226834256,130661.65500216994,187.518988715258,130849.17399088519,4941,1,739.5853658536586,39,2,16,36.19725335371031,0.6215277777777779,44.40104166666666,1022.3958333333317,26.215277777777736,0
4973,4,0,0,41,0.0,0.0,1.0,41,1050,600,450,0.5714285714285714,15,6,9,323.37534781007844,0.40203252032520326,0.13995200453124967,0.18653931638069016,130741.54188368036,255.7183159722036,130997.26019965256,4942,2,740.5853658536586,39,2,16,36.054950091668374,0.6223290598290598,44.32291666666666,1022.7083333333318,26.223290598290557,0
4974,4,0,1,40,0.0,0.024390243902439025,0.975609756097561,41,1250,1000,250,0.8,15,10,5,325.0443399118949,0.4024644308943089,0.13965097190937326,0.18789055104618707,130821.45317925341,304.55457899305077,131126.00775824647,4943,3,741.5853658536586,39,2,16,35.93161337949293,0.623130341880342,44.244791666666664,1023.0208333333328,26.231303418803407,0
4975,4,1,0,41,0.024390243902439025,0.0,1.0,41,750,500,250,0.6666666666666666,10,5,5,323.97082546570203,0.4025660569105691,0.14832716635347487,0.18796279689461684,130963.79469892247,285.6897349461227,131249.4844338686,4944,0,742.439024390244,40,1,17,35.815462006883784,0.6229166666666668,44.105691056910565,1023.5772357723567,25.58943089430892,0
4976,4,0,0,41,0.0,0.0,1.0,41,900,600,300,0.6666666666666666,12,6,6,326.0450786080956,0.40233739837398375,0.15348857479045308,0.18942203701833646,131015.81090124926,343.4120728402414,131359.2229740895,4945,1,743.439024390244,40,1,17,35.709913308186074,0.6234375,44.05487804878049,1023.7804878048781,25.594512195121954,0
4977,4,0,0,41,0.0,0.0,1.0,41,750,400,350,0.5333333333333333,11,4,7,328.76525986765375,0.4019563008130081,0.16241608139439134,0.19152001670209362,131119.87428944433,421.5319089166653,131541.406198361,4946,2,744.439024390244,40,1,17,35.535324469140676,0.6244791666666667,43.95325203252033,1024.1869918699203,25.604674796748007,0
4978,4,1,1,41,0.023809523809523808,0.023809523809523808,0.9761904761904762,42,500,300,200,0.6,7,3,4,322.4945560433922,0.4042295780100658,0.15536421007594403,0.18902831375860027,131356.2240905856,72.9944165455272,131429.21850713113,4947,0,727.6904761904761,37,5,19,35.45778068955681,0.6320382882882882,43.72258771929825,1025.1096491228072,27.705666192508303,0
4979,4,1,0,42,0.023809523809523808,0.0,1.0,42,1200,1000,200,0.8333333333333334,14,10,4,324.6778449752676,0.4053184281842819,0.16233951352617204,0.19100858879865742,131496.76462950135,138.81723222529783,131635.58186172665,4948,0,728.6666666666666,37,5,20,35.260316442163784,0.6334459459459459,43.58552631578947,1025.6578947368419,27.720483641536266,0
4980,4,0,1,41,0.0,0.023809523809523808,0.9761904761904762,42,950,500,450,0.5263157894736842,14,5,9,325.84647087762545,0.40541521486643434,0.16180363463311664,0.19250191877309158,131656.8560979619,179.9843852728537,131836.84048323476,4949,1,729.6666666666666,38,4,14,35.06922756610451,0.6332236842105262,43.42948717948718,1026.2820512820515,27.00742240215925,0
4981,4,1,1,41,0.023809523809523808,0.023809523809523808,0.9761904761904762,42,850,200,650,0.23529411764705882,15,2,13,323.3055509528902,0.4045925280681378,0.1565163950676023,0.1912758456622766,131711.6845642488,116.62374899555505,131828.30831324437,4950,0,730.6190476190476,38,4,14,35.079274215931164,0.6337719298245613,43.37606837606838,1026.4957264957275,27.013045434098093,0
4982,4,0,0,41,0.0,0.0,1.0,41,1000,500,500,0.5,15,5,10,331.7444663598509,0.4000254065040651,0.15414842609964574,0.19603082103082095,131665.51246537393,535.8610341643534,132201.37349953828,4951,7,749.439024390244,37,4,15,34.909188034188034,0.6351351351351351,43.421052631578945,1026.315789473684,27.738264580369837,0
4983,4,1,0,42,0.023809523809523808,0.0,1.0,42,1300,800,500,0.6153846153846154,18,8,10,322.32071937076614,0.40275358110723963,0.15646327454557718,0.19226216549649225,132023.0523003473,110.75303819445355,132133.80533854177,4952,0,732.5714285714286,39,3,16,34.79162443408338,0.6351495726495726,43.07291666666667,1027.7083333333342,26.35149572649575,0
4984,4,0,0,42,0.0,0.0,1.0,42,1550,1300,250,0.8387096774193549,18,13,5,322.13135182342353,0.40141066589237323,0.15788712011577455,0.1928880104939216,132168.37841907586,115.11568168933167,132283.49410076518,4953,1,733.5714285714286,41,1,17,34.65056681138447,0.6333841463414633,42.93154761904761,1028.2738095238085,25.079849012775817,0
4985,4,1,1,42,0.023255813953488372,0.023255813953488372,0.9767441860465116,43,600,300,300,0.5,9,3,6,317.4804728479869,0.40436969361387964,0.1655992272828588,0.19183665637339767,132510.87474030486,-185.08047364258402,132325.79426666227,4954,0,717.4883720930233,37,6,18,34.426695065672696,0.643581081081081,42.59868421052632,1029.605263157896,27.827169274537727,0
4986,4,0,1,41,0.0,0.023809523809523808,0.9761904761904762,42,1150,900,250,0.782608695652174,14,9,5,326.900382745492,0.40298344947735193,0.16025981602441952,0.1973925560805343,132484.9405993833,261.87555799044316,132746.81615737375,4955,1,735.1666666666666,36,6,19,34.21023845985562,0.6452546296296295,42.62387387387388,1029.5045045045056,28.597347347347377,0
4987,4,1,1,41,0.023809523809523808,0.023809523809523808,0.9761904761904762,42,1150,900,250,0.782608695652174,14,9,5,323.2416545183711,0.4048586914440573,0.15892439120785573,0.19649580007526865,132736.76155163138,181.2100838719753,132917.97163550335,4956,0,735.3809523809524,37,5,16,34.05201461303823,0.6458333333333333,42.37938596491229,1030.4824561403518,27.85087719298248,0
4988,4,0,1,40,0.0,0.024390243902439025,0.975609756097561,41,1100,800,300,0.7272727272727273,14,8,6,326.56628548428506,0.40091463414634143,0.15540016368575493,0.1982584569273875,132687.90486009684,466.27924377082644,133154.18410386765,4957,3,754.3170731707318,36,5,16,34.01532954421248,0.6472800925925926,42.426801801801815,1030.292792792795,28.619244244244303,0
4989,4,0,0,40,0.0,0.0,1.0,40,1400,1100,300,0.7857142857142857,17,11,6,331.19683257630265,0.4005475427350427,0.15323767269459743,0.2012727235786227,132725.77649444874,791.671355238343,133517.44784968707,4958,4,753.0,35,5,16,33.85808622561683,0.649702380952381,42.3900462962963,1030.439814814815,29.44113756613757,0
4990,4,0,0,40,0.0,0.0,1.0,40,600,500,100,0.8333333333333334,7,5,2,331.57605575339477,0.3995592948717949,0.15814247221286637,0.20214564877450272,132845.06715374222,809.6486786265325,133654.71583236876,4959,5,754.0,35,5,16,33.728738632536206,0.6508928571428572,42.27430555555555,1030.9027777777771,29.45436507936506,0
4991,4,1,1,40,0.024390243902439025,0.024390243902439025,0.975609756097561,41,600,200,400,0.3333333333333333,10,2,8,325.8497230065992,0.4032774390243902,0.1569609607051985,0.2001398700826055,133123.35139193246,475.6414353542695,133598.99282728674,4960,0,736.5853658536586,36,5,16,33.59772843008875,0.6516203703703705,42.0045045045045,1031.9819819819818,28.66616616616616,0
4992,4,0,0,40,0.0,0.0,1.0,40,1050,900,150,0.8571428571428571,12,9,3,335.9830731971337,0.39977297008547014,0.17002346393102674,0.20620314130645254,133094.29943034257,943.4863495252026,134037.78577986776,4961,7,756.0,36,4,17,33.365391611189935,0.6513310185185186,42.03265765765766,1031.8693693693697,28.663038038038046,0
4993,4,0,0,40,0.0,0.0,1.0,40,950,700,250,0.7368421052631579,12,7,5,334.92727904016033,0.39935897435897433,0.17145962732919218,0.2058140913185719,133141.23109796192,918.5260519395168,134059.75714990144,4962,8,757.0,38,2,17,33.34562629399587,0.6480263157894737,41.98717948717949,1032.0512820512824,27.159244264507432,0
4994,4,0,0,40,0.0,0.0,1.0,40,1250,800,450,0.64,17,8,9,338.4301691639488,0.39877136752136755,0.17856602441238767,0.20876529352347373,133283.92062717007,1021.4599609374902,134305.38058810757,4963,9,758.0,39,1,17,33.11234826322339,0.6477029914529915,41.84895833333333,1032.604166666666,26.4770299145299,0
4995,4,0,0,40,0.0,0.0,1.0,40,900,700,200,0.7777777777777778,11,7,4,339.2400711137965,0.3982638888888889,0.17694150277357568,0.20956793178151362,133337.70751953125,1046.6986762152783,134384.40619574653,4964,10,759.0,39,1,18,33.03759035131955,0.6482371794871795,41.796875,1032.8125,26.482371794871796,0
4996,4,0,1,39,0.0,0.025,0.975,40,1300,1000,300,0.7692307692307693,16,10,6,341.2963856880334,0.39687500000000003,0.1828565980167809,0.21176990746849786,133501.3153990139,1112.9067365771639,134614.22213559106,4965,11,760.0,36,4,19,32.82072935963095,0.6553819444444444,41.638513513513516,1033.4459459459463,28.706831831831842,0
4997,4,0,0,39,0.0,0.0,1.0,39,800,400,400,0.5,12,4,8,342.85920632624493,0.3972672064777328,0.19778824975375509,0.21274425665650062,133502.12358807027,1354.4864272548155,134856.6100153251,4966,12,776.5128205128206,35,4,19,32.779543248590734,0.6574404761904761,41.63773148148149,1033.449074074075,29.52711640211643,0
4998,4,0,0,39,0.0,0.0,1.0,39,1050,800,250,0.7619047619047619,13,8,5,377.92186262410416,0.397576473234368,0.24838780675690542,0.21688619209708448,130542.57079101267,2071.080801230034,132613.6515922427,4967,13,777.5128205128206,37,2,13,34.86230329041488,0.6238738738738738,44.51754385964912,1021.9298245614038,27.61972498814605,8
4999,4,1,0,40,0.025,0.0,1.0,40,650,400,250,0.6153846153846154,9,4,5,369.1206424793732,0.4016292735042735,0.2447347812467371,0.21359929867220284,130863.1260158704,1660.8562303674494,132523.98224623784,4968,0,759.05,38,2,14,34.76210365110856,0.6252741228070176,44.20405982905983,1023.1837606837605,26.92588843904633,0
5000,4,1,0,41,0.024390243902439025,0.0,1.0,41,1100,800,300,0.7272727272727273,14,8,6,360.1886087112375,0.40444613821138214,0.23869667500415193,0.21082068537238963,131301.43364800356,1258.6561414930652,132560.08978949662,4969,0,741.5121951219512,39,2,16,34.54714655960972,0.6279380341880341,43.77604166666667,1024.8958333333342,26.279380341880362,0
