period,mktsize,entries,exits,surviv,entryrate,exitrate,survivrate,firms,totresinv,totinninv,totimiinv,costshareinn,firmsres,firmsinn,firmsimi,hindex,div,gini,pcm,cs,totprofits,ts,maxage,minage,avgage,actfirms,inactfirms,profitablefirms,wmc,avgproxopt,price,totoutput,avgoutput,magtechshock
1,4,40,24,16,1.0,0.6,0.4,40,0,0,0,0,0,0,0,349.3478914291563,0.5006410256410256,0.015427941351770613,0.14808890657903948,117842.76305566267,1233.6241587362824,119076.38721439896,0,0,0.0,35,5,16,48.782756188659775,0.4967261904761905,57.26273148148148,970.9490740740736,27.741402116402103,0
2,4,32,32,16,0.6666666666666666,0.6666666666666666,0.33333333333333337,48,150,0,150,0.0,3,0,3,327.7934889729829,0.4974512411347518,0.021711388966937806,0.1533005292056303,122168.99112654323,-790.7600308641987,121378.23109567903,1,0,0.3333333333333333,44,4,8,44.74571508850799,0.5276988636363636,52.84722222222222,988.6111111111113,22.46843434343435,0
3,4,28,25,19,0.6363636363636364,0.5681818181818182,0.43181818181818177,44,350,300,50,0.8571428571428571,4,3,1,326.5381234411234,0.49795190274841433,-0.12712511452713005,0.1559350503919373,123063.1172839504,-763.0401234568076,122300.07716049359,2,0,0.5681818181818182,44,0,14,43.844484882418826,0.5369318181818181,51.944444444444436,992.2222222222204,22.55050505050501,0
4,4,15,17,17,0.4411764705882353,0.5,0.5,34,450,400,50,0.8888888888888888,5,4,1,351.92302276038856,0.49299985145573383,-0.02722268756730939,0.17069185729591202,123723.51367630366,1908.2305839001988,125631.74426020385,3,0,1.1176470588235294,34,0,14,42.52672410354592,0.5603553921568627,51.27976190476189,994.8809523809508,29.26120448179267,0
5,4,14,12,19,0.45161290322580644,0.3870967741935484,0.6129032258064516,31,500,300,200,0.6,7,3,4,382.5180357908069,0.49659498207885305,-0.1140198673539603,0.18557589279222583,123733.69216918955,3266.0737779405526,126999.7659471301,4,0,1.3225806451612903,31,0,17,41.75514221524232,0.5675403225806452,51.26953125000001,994.9218750000008,32.09425403225809,0
6,4,9,8,20,0.32142857142857145,0.2857142857142857,0.7142857142857143,28,800,700,100,0.875,9,7,2,397.68350890340594,0.492201278659612,-0.06403248718423793,0.19529553207931605,124246.82762336511,4282.182875875296,128529.01049924041,5,0,2.0,28,0,18,40.842220300715766,0.5814732142857143,50.754310344827594,996.9827586206902,35.60652709359608,0
7,4,7,4,23,0.25925925925925924,0.14814814814814814,0.8518518518518519,27,500,400,100,0.8,6,4,2,403.128911002837,0.48818850902184235,-0.06302861777314328,0.2003112050008913,124739.71896701377,4657.237413194426,129396.9563802082,6,0,2.5185185185185186,27,0,22,40.19269204031976,0.589891975308642,50.26041666666666,998.9583333333323,36.99845679012342,0
8,4,2,1,24,0.08,0.04,0.96,25,850,500,350,0.5882352941176471,12,5,7,468.5606949401119,0.4850694444444445,-0.011749515816656064,0.2247060422483696,123243.39455950042,6549.402120315593,129792.796679816,7,0,3.48,25,0,15,40.131401979771894,0.5816666666666667,51.76282051282052,992.9487179487187,39.71794871794875,8
9,4,4,2,26,0.14285714285714285,0.07142857142857142,0.9285714285714286,28,900,500,400,0.5555555555555556,13,5,8,434.84917712295163,0.48506393298059963,-0.035910347958889144,0.21049132895420103,123638.7836074781,5152.844662438925,128791.62826991701,8,0,3.7857142857142856,28,0,17,40.5530675142059,0.5751488095238095,51.36494252873565,994.5402298850593,35.5192939244664,8
10,4,5,2,29,0.16129032258064516,0.06451612903225806,0.935483870967742,31,700,500,200,0.7142857142857143,9,5,4,395.6697827325847,0.48655913978494625,-0.03522422673915426,0.19752617632124755,124934.90431043845,3686.593288845496,128621.49759928395,9,0,4.032258064516129,31,0,20,40.175935573500034,0.5799731182795699,50.06510416666667,999.739583333334,32.249663978494645,0
11,4,4,6,27,0.12121212121212122,0.18181818181818182,0.8181818181818181,33,550,300,250,0.5454545454545454,8,3,5,373.8069404936023,0.48603219696969696,-0.007083033124044569,0.19108626173528281,125917.07996951851,2813.752638068871,128730.83260758738,10,0,4.545454545454546,32,1,16,39.70520400889,0.5875651041666667,49.084595959595966,1003.661616161617,31.36442550505053,0
12,4,2,3,26,0.06896551724137931,0.10344827586206896,0.896551724137931,29,750,400,350,0.5333333333333333,11,4,7,412.10505421875456,0.4804495073891626,-0.0034116867577107524,0.20856463339053677,125503.37932685959,4544.115388426482,130047.49471528607,11,0,5.448275862068965,28,1,17,39.17377640760921,0.5944940476190477,49.49712643678161,1002.011494252874,35.7861247947455,0
13,4,3,0,29,0.10344827586206896,0.0,1.0,29,800,600,200,0.75,10,6,4,397.5930244404572,0.4792179802955665,-0.044921530384026576,0.2040450787600385,126078.70611496898,4225.602816358004,130304.30893132699,12,0,5.724137931034483,29,0,21,38.940989028718946,0.5973419540229885,48.9236111111111,1004.3055555555543,34.6312260536398,0
14,4,0,3,26,0.0,0.10344827586206896,0.896551724137931,29,850,700,150,0.8235294117647058,10,7,3,396.6241190935598,0.4789614121510673,-0.045474912529911204,0.2040667764952211,126183.34297839493,4209.471450617267,130392.81442901219,13,1,6.724137931034483,29,0,21,38.85701778637914,0.5984195402298851,48.819444444444436,1004.722222222221,34.64559386973176,0
15,4,0,1,25,0.0,0.038461538461538464,0.9615384615384616,26,450,200,250,0.4444444444444444,7,2,5,434.85213756338453,0.47775641025641025,-0.05756793252943515,0.22027533395761462,125540.7069234873,5718.328951379375,131259.03587486668,14,2,7.653846153846154,26,0,21,38.565085720151956,0.6017628205128205,49.45987654320988,1002.1604938271607,38.54463437796772,0
16,4,1,0,26,0.038461538461538464,0.0,1.0,26,650,600,50,0.9230769230769231,7,6,1,434.6532544378697,0.47685897435897434,-0.06486390532544362,0.22141427537979283,125772.79568663328,5733.510992988897,131506.30667962218,15,0,8.23076923076923,26,0,22,38.32852564102566,0.6041666666666667,49.228395061728406,1003.0864197530876,38.5802469135803,0
17,4,7,8,25,0.21212121212121213,0.24242424242424243,0.7575757575757576,33,800,600,200,0.75,10,6,4,354.4840958293729,0.4778251262626263,-0.07071074513780928,0.1892187921232905,127679.65032980115,2452.0810805940205,130131.73141039518,16,0,7.2727272727272725,33,0,15,38.37797077725234,0.603219696969697,47.33455882352942,1010.6617647058833,30.626114081996466,0
18,4,3,6,22,0.10714285714285714,0.21428571428571427,0.7857142857142857,28,950,700,250,0.7368421052631579,12,7,5,407.5323412040266,0.4753086419753086,-0.08096596698593872,0.2128764315827294,126802.42807834593,4735.218077024708,131537.64615537063,17,0,8.642857142857142,28,0,17,37.942522586780775,0.6078869047619048,48.20402298850575,1007.1839080459773,35.970853858784906,0
19,4,2,0,24,0.08333333333333333,0.0,1.0,24,450,200,250,0.4444444444444444,7,2,5,463.00488120018355,0.4729393115942029,-0.04237229509103968,0.23693104498459686,125960.17013888882,6864.034722222216,132824.20486111104,18,0,10.375,24,0,21,37.42217333554709,0.6141493055555556,49.041666666666664,1003.8333333333327,41.826388888888864,0
20,4,2,4,22,0.07692307692307693,0.15384615384615385,0.8461538461538461,26,850,700,150,0.8235294117647058,10,7,3,435.4625445897741,0.4751602564102564,-0.06477453580901882,0.22712974448027767,126742.13927469125,5838.290895061708,132580.43016975294,19,0,10.5,26,0,18,37.30172413793102,0.6141826923076923,48.26388888888888,1006.9444444444435,38.72863247863244,0
21,4,1,0,23,0.043478260869565216,0.0,1.0,23,1000,800,200,0.8,12,8,4,481.5215434134313,0.473731884057971,-0.04833255684636084,0.24743194051421957,126131.01912133486,7546.960599922828,133677.9797212577,20,0,12.08695652173913,23,0,22,36.77915082382762,0.6204710144927537,48.87152777777777,1004.5138888888887,43.67451690821255,0
22,4,0,0,23,0.0,0.0,1.0,23,700,600,100,0.8571428571428571,8,6,2,481.1314898169628,0.4733201581027668,-0.04760294813712884,0.24749403836184544,126174.62158203108,7541.3167317708085,133715.9383138019,21,1,13.08695652173913,23,0,22,36.743455158113015,0.6209239130434783,48.828124999999986,1004.6874999999986,43.68206521739125,0
23,4,0,0,23,0.0,0.0,1.0,23,600,400,200,0.6666666666666666,8,4,4,486.2129771230611,0.4715085638998682,-0.019674520281758312,0.23522195379737282,123614.96913580252,7420.640432098774,131035.6095679013,22,2,14.08695652173913,23,0,20,39.30109404096835,0.5942028985507246,51.38888888888889,994.4444444444448,43.23671497584542,8
24,4,6,4,25,0.20689655172413793,0.13793103448275862,0.8620689655172413,29,500,400,100,0.8,6,4,2,397.5172998042022,0.47665229885057475,-0.043013836117284376,0.20126928547981168,125521.37586805543,4179.383680555535,129700.75954861096,23,0,11.96551724137931,29,0,18,39.52053014553013,0.5915948275862069,49.47916666666666,1002.0833333333323,34.55459770114939,0
25,4,7,2,30,0.21875,0.0625,0.9375,32,700,400,300,0.5714285714285714,10,4,6,365.4679949119613,0.4757854502688172,-0.003746242014280421,0.19181663401592294,126996.54571280998,2882.634584481182,129879.18029729117,24,0,11.03125,32,0,18,38.80198546912189,0.5986328125,48.01136363636364,1007.954545454546,31.49857954545456,0
26,4,2,4,28,0.0625,0.125,0.875,32,800,600,200,0.75,10,6,4,375.9810670710426,0.474588373655914,0.024417506297229163,0.19087529875601564,125632.11024385293,3047.0589735741605,128679.1692174271,25,0,11.40625,32,0,17,39.9454240134341,0.5846354166666667,49.368686868686886,1002.5252525252547,31.32891414141421,8
27,4,1,1,28,0.034482758620689655,0.034482758620689655,0.9655172413793104,29,1100,700,400,0.6363636363636364,15,7,8,423.9697684451737,0.4725985221674877,0.05731847941986756,0.2029545837292468,123166.49546682088,4643.77411265431,127810.26957947519,26,0,13.344827586206897,29,0,17,41.31905578098036,0.5671695402298851,51.84027777777777,992.638888888888,34.228927203065105,8
28,4,3,2,29,0.0967741935483871,0.06451612903225806,0.935483870967742,31,1250,900,350,0.72,16,9,7,397.46483807246136,0.4752688172043011,0.04289833566598644,0.19446297576281824,124090.2031792536,3664.2985026041856,127754.50168185779,27,0,12.64516129032258,31,0,20,41.01106464540862,0.571236559139785,50.91145833333334,996.3541666666678,32.14045698924735,0
29,4,6,2,33,0.17142857142857143,0.05714285714285714,0.9428571428571428,35,1100,800,300,0.7272727272727273,14,8,6,361.1599750657129,0.4765056022408964,0.09313780522031978,0.17847614301791062,124510.2845059593,2112.0344526444196,126622.31895860372,28,0,11.857142857142858,33,2,19,41.4789006221349,0.5707070707070707,50.490196078431374,998.0392156862749,30.243612596553785,8
30,4,5,6,32,0.13157894736842105,0.15789473684210525,0.8421052631578947,38,1300,1000,300,0.7692307692307693,16,10,6,331.1971727794515,0.4785591512565197,0.10121912284643275,0.16809106226241038,125620.13660620085,721.9679864096837,126342.10459261053,29,0,11.473684210526315,36,2,17,41.08018797274022,0.5758101851851851,49.380630630630634,1002.4774774774779,27.84659659659661,0
31,4,8,5,35,0.2,0.125,0.875,40,1100,700,400,0.6363636363636364,15,7,8,315.87599153314665,0.4786858974358974,0.12110564010743108,0.16410859653140666,126581.54776398005,-1.7589379920627835,126579.78882598798,30,0,11.5,36,4,17,40.47672336615936,0.5856481481481481,48.423423423423415,1006.306306306305,27.952952952952916,0
32,4,1,3,33,0.027777777777777776,0.08333333333333333,0.9166666666666666,36,1000,500,500,0.5,15,5,10,350.08275422921196,0.4756117724867725,0.14576847688227823,0.1791308393763984,125956.684630594,1619.0526138117084,127575.73724440571,31,0,13.75,35,1,22,40.25964199239016,0.58125,49.04513888888888,1003.8194444444433,28.680555555555525,0
33,4,4,5,32,0.10810810810810811,0.13513513513513514,0.8648648648648649,37,1300,900,400,0.6923076923076923,17,9,8,334.9705774251702,0.47566316316316315,0.11940241235082683,0.17390487226029117,126552.4092970522,1078.32700499182,127630.73630204402,32,0,13.594594594594595,34,3,17,40.02627583215018,0.5894607843137255,48.452380952380956,1006.1904761904766,29.593837535014018,0
34,4,3,4,31,0.08571428571428572,0.11428571428571428,0.8857142857142857,35,1300,1100,200,0.8461538461538461,15,11,4,342.407209767623,0.4731442577030813,0.12207634118772281,0.1783687525834511,126690.7278000049,1675.9637218858238,128366.69152189072,33,0,14.685714285714285,33,2,19,39.69707344288903,0.5931186868686869,48.31495098039216,1006.7401960784321,30.507278669043394,0
35,4,6,5,32,0.16216216216216217,0.13513513513513514,0.8648648648648649,37,900,600,300,0.6666666666666666,12,6,6,326.9144008851692,0.47566316316316315,0.13409468129908086,0.1739822494466926,127559.26354595345,940.192043895759,128499.45558984921,34,0,14.216216216216216,35,2,21,39.197601588756505,0.5976190476190476,47.45370370370371,1010.1851851851859,28.862433862433882,0
36,4,2,0,34,0.058823529411764705,0.0,1.0,34,1000,900,100,0.9,11,9,2,341.2300933345189,0.4719622697563874,0.1254551339105099,0.18107611522204026,127442.37075617285,1897.434413580244,129339.80516975309,35,0,14.970588235294118,32,2,23,38.95575424117375,0.6031901041666667,47.56944444444444,1009.7222222222224,31.55381944444445,0
37,4,0,1,33,0.0,0.029411764705882353,0.9705882352941176,34,1500,1100,400,0.7333333333333333,19,11,8,344.032444047841,0.47105243612596553,0.11433988887908986,0.1835757121439278,127665.57621671243,1984.2200413222904,129649.79625803472,36,1,15.970588235294118,32,2,24,38.656453023488254,0.60546875,47.34848484848484,1010.6060606060594,31.581439393939355,0
38,4,1,2,32,0.029411764705882353,0.058823529411764705,0.9411764705882353,34,1550,1400,150,0.9032258064516129,17,14,3,335.518522573039,0.47016117052881756,0.08165040632501586,0.18031589009911173,127952.84162649195,1786.109676308508,129738.95130280046,36,0,15.882352941176471,32,2,25,38.577935854236856,0.6083984375,47.06439393939392,1011.7424242424223,31.616950757575697,0
39,4,1,2,31,0.030303030303030304,0.06060606060606061,0.9393939393939394,33,1150,900,250,0.782608695652174,14,9,5,360.3811103860459,0.46772411616161613,0.028849488308948068,0.18759001525418137,126659.88592128035,2529.1660659361896,129189.05198721655,37,0,16.21212121212121,33,0,19,39.27643860076292,0.5928030303030303,48.34558823529412,1006.6176470588241,30.50356506238861,8
40,4,1,0,32,0.03125,0.0,1.0,32,1400,1000,400,0.7142857142857143,18,10,8,362.21049771572035,0.466796875,0.057528676194058104,0.1892176254275246,126805.71697084483,2786.072371441694,129591.78934228653,38,0,17.46875,32,0,20,39.08032468346496,0.5966796875,48.20075757575758,1007.1969696969699,31.474905303030308,0
41,4,1,3,30,0.030303030303030304,0.09090909090909091,0.9090909090909091,33,850,600,250,0.7058823529411765,11,6,5,351.06891605764645,0.4669744318181818,0.049336338592536944,0.18469277757815317,127092.01388888893,2323.6111111111204,129415.62500000006,39,0,17.90909090909091,33,0,21,39.06680440771349,0.5972222222222222,47.91666666666667,1008.3333333333338,30.55555555555557,0
42,4,1,0,31,0.03225806451612903,0.0,1.0,31,1050,800,250,0.7619047619047619,13,8,5,370.1530300152625,0.46729390681003585,0.07867617337094912,0.19426132917614525,126993.56291029164,3201.4104207356436,130194.97333102729,40,0,19.451612903225808,31,0,22,38.686996727382336,0.6011424731182795,48.01432291666665,1007.9427083333314,32.51428091397843,0
43,4,1,1,31,0.03125,0.03125,0.96875,32,1150,800,350,0.6956521739130435,15,8,7,358.2584872353267,0.4666708669354838,0.07337517193947729,0.19011235052560752,127442.37075617262,2731.4621913579927,130173.83294753061,41,0,19.8125,32,0,20,38.52590554791377,0.6031901041666667,47.56944444444443,1009.7222222222205,31.55381944444439,0
44,4,1,0,32,0.03125,0.0,1.0,32,550,200,350,0.36363636363636365,9,2,7,358.6512590781076,0.4651377688172043,0.09276611694152992,0.19137631184407783,127665.57621671226,2757.4839302111654,130423.06014692342,42,0,20.53125,32,0,21,38.28710644677663,0.60546875,47.34848484848483,1010.6060606060579,31.58143939393931,0
45,4,2,5,29,0.058823529411764705,0.14705882352941177,0.8529411764705882,34,1150,700,450,0.6086956521739131,16,7,9,344.39982535674267,0.4625482768865122,0.11126490262810895,0.1882380315500194,128627.12762188203,2059.8320578231196,130686.95967970515,43,0,20.264705882352942,34,0,22,37.664788952783304,0.6106004901960784,46.39880952380952,1014.4047619047615,29.835434173669455,0
46,4,2,0,31,0.06451612903225806,0.0,1.0,31,800,500,300,0.625,11,5,6,356.2337818581102,0.45940860215053764,0.09930650954170006,0.19557736361731204,128804.55864800363,2976.9070095486322,131781.46565755227,44,0,20.161290322580644,31,0,24,37.183598426543526,0.6196236559139785,46.22395833333334,1015.104166666668,32.74529569892477,0
47,4,0,1,30,0.0,0.03225806451612903,0.967741935483871,31,900,700,200,0.7777777777777778,11,7,4,383.3892316806258,0.459005376344086,0.09973250222914842,0.2013703820672593,127026.37566460494,3540.1089138454754,130566.48457845041,45,1,21.161290322580644,31,0,21,38.31966330836133,0.601478494623656,47.98177083333333,1008.0729166666658,32.518481182795675,8
48,4,4,2,32,0.11764705882352941,0.058823529411764705,0.9411764705882353,34,950,700,250,0.7368421052631579,12,7,5,349.0910767751094,0.46351381461675584,0.0849542720899612,0.18894811719360044,128237.60880730968,2153.337942531865,130390.94674984155,46,0,18.970588235294116,33,1,24,37.9435117967332,0.6089015151515151,46.783088235294116,1012.8676470588234,30.692959001782526,0
49,4,0,0,32,0.0,0.0,1.0,32,1000,700,300,0.7,13,7,6,369.2471570648807,0.46228158602150543,0.09984403138667375,0.19906570034829277,128078.62175835489,3058.533393012133,131137.155151367,47,1,20.9375,31,1,24,37.59593945630735,0.612231182795699,46.94010416666666,1012.2395833333321,32.6528897849462,0
50,4,1,0,33,0.030303030303030304,0.0,1.0,33,1350,900,450,0.6666666666666666,18,9,9,356.3458735772516,0.4623974116161616,0.09496005612510428,0.19475392845711847,128624.38303489449,2566.9536271809097,131191.3366620754,48,0,21.272727272727273,32,1,21,37.36463778939506,0.615234375,46.401515151515156,1014.3939393939402,31.69981060606063,0
51,4,0,3,30,0.0,0.09090909090909091,0.9090909090909091,33,1350,1000,350,0.7407407407407407,17,10,7,360.0077968367121,0.46192392676767674,0.09443690637720503,0.1977091999021286,128816.57483930199,2674.9942607896987,131491.5691000917,49,1,22.272727272727273,32,1,21,37.075559701492544,0.6171875,46.212121212121204,1015.1515151515141,31.723484848484816,0
52,4,1,0,31,0.03225806451612903,0.0,1.0,31,850,400,450,0.47058823529411764,13,4,9,374.50874160770115,0.4595878136200717,0.09037042733071043,0.20536786549598765,128757.66210327779,3444.174001329625,132201.8361046074,50,0,22.93548387096774,30,1,22,36.767757029973964,0.621875,46.27016129032258,1014.9193548387093,33.83064516129031,0
53,4,2,2,31,0.06060606060606061,0.06060606060606061,0.9393939393939394,33,1150,900,250,0.782608695652174,14,9,5,352.507053700646,0.459793244949495,0.0746805607244756,0.19692026056000736,129490.3760617539,2529.2541896235034,132019.63025137738,51,0,22.484848484848484,32,1,20,36.57967373774965,0.6240234375,45.54924242424242,1017.8030303030303,31.806344696969695,0
54,4,0,1,30,0.0,0.03225806451612903,0.967741935483871,31,1050,800,250,0.7619047619047619,13,8,5,392.3912301072334,0.45658602150537636,0.030925086643561972,0.2064319080129356,127092.01388888873,3773.9583333333126,130865.97222222204,52,1,23.548387096774192,31,0,20,38.025137741046834,0.6021505376344086,47.91666666666666,1008.333333333332,32.52688172043006,8
55,4,0,1,29,0.0,0.03333333333333333,0.9666666666666667,30,1150,900,250,0.782608695652174,14,9,5,400.92889829929675,0.4561781609195403,0.045454545454545636,0.2109234638878908,127092.01388888882,4190.972222222216,131282.98611111104,53,2,25.066666666666666,30,0,21,37.80991735537192,0.6048611111111111,47.916666666666664,1008.3333333333327,33.61111111111109,0
56,4,2,0,31,0.06451612903225806,0.0,1.0,31,1000,500,500,0.5,15,5,10,400.54041875172715,0.45698924731182794,0.06887974103093475,0.2039235192098184,125749.81901380744,3873.5770331488607,129623.3960469563,54,0,25.129032258064516,31,0,18,39.207803236834124,0.5883736559139785,49.25130208333333,1002.9947916666661,32.354670698924714,8
57,4,4,2,33,0.11428571428571428,0.05714285714285714,0.9428571428571428,35,1300,900,400,0.6923076923076923,17,9,8,363.34193302095343,0.4615896358543417,0.07330733782346699,0.19016467403564158,126882.03124999977,2220.6558227538762,129102.68707275364,55,0,23.142857142857142,34,1,17,38.97332506203473,0.5928308823529411,48.124999999999986,1007.4999999999982,29.632352941176418,0
58,4,1,1,33,0.029411764705882353,0.029411764705882353,0.9705882352941176,34,1250,1100,150,0.88,14,11,3,376.8599329274491,0.4586675579322638,0.09885571249776515,0.19780937768527532,126999.35308835522,2772.193537341376,129771.54662569659,56,0,24.794117647058822,33,1,18,38.51203140830799,0.5962752525252526,48.008578431372534,1007.965686274508,30.54441473559115,0
59,4,3,1,35,0.08333333333333333,0.027777777777777776,0.9722222222222222,36,1200,900,300,0.75,15,9,6,371.30989939304357,0.4598048941798942,0.13418725221104033,0.19992202957467814,128027.37054183811,2307.566015089162,130334.93655692728,57,0,23.944444444444443,35,1,18,37.59625648063435,0.6023809523809525,46.99074074074074,1012.0370370370368,28.91534391534391,0
60,4,0,0,35,0.0,0.0,1.0,35,1400,1100,300,0.7857142857142857,17,11,6,383.82580837254693,0.4569677871148459,0.14570453666817929,0.20633368408338246,127963.79145408167,2823.1611394557867,130786.95259353745,58,1,25.62857142857143,34,1,18,37.3448346864337,0.6038602941176471,47.05357142857143,1011.7857142857147,29.75840336134455,0
61,4,1,0,36,0.027777777777777776,0.0,1.0,36,1050,800,250,0.7619047619047619,13,8,5,374.93170653564346,0.4567625661375661,0.1467329220927578,0.20335515235520568,128320.37278163564,2422.2752700617075,130742.64805169735,59,0,25.88888888888889,35,1,19,37.204420836189165,0.6053571428571429,46.70138888888888,1013.1944444444432,28.948412698412664,0
62,4,0,0,36,0.0,0.0,1.0,36,1000,700,300,0.7,13,7,6,376.37434194054106,0.4559854497354497,0.1469440955969099,0.20488892859274072,128466.99948827588,2470.336478695129,130937.335966971,60,1,26.88888888888889,35,1,15,37.017757925181705,0.606845238095238,46.55671296296296,1013.773148148148,28.96494708994709,0
63,4,1,5,32,0.02702702702702703,0.13513513513513514,0.8648648648648649,37,800,300,500,0.375,13,3,10,371.58569071915394,0.4535785785785786,0.16715784933870048,0.20546502898588526,129086.92476260052,2193.3708201444792,131280.295582745,61,0,27.135135135135137,36,1,18,36.50566083037826,0.6111111111111112,45.94594594594595,1016.2162162162168,28.228228228228247,0
64,4,2,2,32,0.058823529411764705,0.058823529411764705,0.9411764705882353,34,950,800,150,0.8421052631578947,11,8,3,390.88388095070945,0.4534128045157457,0.1706002769582755,0.2182248866793392,129466.28146701407,3321.357963220847,132787.6394302349,62,0,25.852941176470587,31,3,18,35.62777209143637,0.6263440860215054,45.57291666666668,1017.7083333333348,32.829301075268866,0
65,4,1,1,32,0.030303030303030304,0.030303030303030304,0.9696969696969697,33,1050,500,550,0.47619047619047616,16,5,11,394.99550963861293,0.4495738636363636,0.18567202366674662,0.22211171832794419,129748.56197248246,3650.0198722395817,133398.58184472204,63,0,26.696969696969695,30,3,19,35.23499340369394,0.6319444444444444,45.29569892473119,1018.8172043010761,33.960573476702535,0
66,4,0,0,32,0.0,0.0,1.0,32,1050,500,550,0.47619047619047616,16,5,11,404.8453140350901,0.44915574596774194,0.18587230706299418,0.22734575291985837,129696.07445987653,4101.36959876543,133797.44405864197,64,1,27.6875,29,3,19,35.03772384328697,0.6343390804597702,45.34722222222222,1018.6111111111111,35.12452107279693,0
67,4,0,0,32,0.0,0.0,1.0,32,1050,500,550,0.47619047619047616,16,5,11,402.40851145973295,0.44850470430107525,0.18554155313351495,0.2272060364703418,129908.3719135804,4055.2469135802694,133963.61882716068,65,2,28.6875,29,3,19,34.88306085376931,0.6364942528735632,45.1388888888889,1019.4444444444457,35.15325670498088,0
68,4,0,2,30,0.0,0.0625,0.9375,32,1050,700,350,0.6666666666666666,14,7,7,400.44694348327573,0.4476226478494623,0.1874489379084967,0.22691993464052285,130050.0,4015.625,134065.625,66,3,29.6875,29,3,20,34.78860294117648,0.6379310344827587,45.0,1020.0,35.172413793103445,0
69,4,0,0,30,0.0,0.0,1.0,30,1000,500,500,0.5,15,5,10,423.5836645121847,0.44578544061302683,0.18391744548286626,0.23854448475159856,129807.25623582758,4996.846655328789,134804.10289115636,67,4,30.933333333333334,27,3,20,34.446797118380076,0.6419753086419753,45.238095238095234,1019.0476190476184,37.74250440917105,0
70,4,0,0,30,0.0,0.0,1.0,30,750,200,550,0.26666666666666666,13,2,11,425.43022475466125,0.4450191570881226,0.18626456219466347,0.24035452825311113,129932.78504425946,5055.466788875678,134988.25183313515,68,5,31.933333333333334,28,2,20,34.27136180007518,0.6398809523809523,45.11494252873563,1019.5402298850573,36.41215106732348,0
71,4,0,1,29,0.0,0.03333333333333333,0.9666666666666667,30,1250,1000,250,0.8,15,10,5,421.7190634592752,0.4446599616858238,0.17772925764192138,0.2389292602950833,130042.67251701011,4968.294812722944,135010.96732973304,69,6,32.93333333333333,28,2,21,34.25365074893177,0.6409970238095238,45.007183908045974,1019.9712643678157,36.42754515599342,0
72,4,0,0,29,0.0,0.0,1.0,29,900,500,400,0.5555555555555556,13,5,8,425.1706784876082,0.444376026272578,0.17677814619369192,0.24179242028002237,130189.2613992931,5270.531320187599,135459.7927194807,70,7,33.689655172413794,28,1,21,34.01585011028204,0.6424851190476191,44.86350574712643,1020.5459770114936,36.44807060755334,0
73,4,1,0,30,0.03333333333333333,0.0,1.0,30,650,400,250,0.6153846153846154,9,4,5,412.6768585169823,0.4466235632183908,0.16675103112110956,0.23669014659457874,130519.38829435849,4772.486870788729,135291.8751651472,71,0,33.53333333333333,28,2,20,33.99799634420697,0.6458333333333333,44.540229885057464,1021.8390804597695,36.4942528735632,0
74,4,0,1,29,0.0,0.03333333333333333,0.9666666666666667,30,800,400,400,0.5,12,4,8,409.4201821397193,0.44578544061302683,0.16546732255797547,0.23549107485239315,130629.52348807635,4696.472659862591,135325.99614793895,72,1,34.53333333333333,28,2,20,33.96902084797376,0.6469494047619048,44.43247126436781,1022.2701149425286,36.50964696223316,0
75,4,0,0,29,0.0,0.0,1.0,29,1000,700,300,0.7,13,7,6,414.6670649979129,0.44524835796387524,0.15072027305124713,0.23858984393095994,130642.63791454081,5034.639845521537,135677.27776006234,73,2,34.55172413793103,27,2,20,33.821567200388145,0.650462962962963,44.419642857142854,1022.3214285714286,37.863756613756614,0
76,4,1,0,30,0.03333333333333333,0.0,1.0,30,1000,700,300,0.7,13,7,6,413.86457478186026,0.4460727969348659,0.17324381108979603,0.22506584700134247,128425.93557098764,4630.1890432098735,133056.12461419753,74,0,34.36666666666667,29,1,20,36.10977893486799,0.6214080459770115,46.59722222222222,1013.611111111111,34.95210727969348,8
77,4,1,0,31,0.03225806451612903,0.0,1.0,31,1350,1200,150,0.8888888888888888,15,12,3,399.02414282904857,0.4469982078853047,0.17068807241519202,0.21956499629085655,128894.11212640186,4086.372521389749,132980.4846477916,75,0,34.225806451612904,30,1,21,36.00595632031767,0.6232638888888888,46.13575268817204,1015.4569892473115,33.84856630824372,0
78,4,0,0,31,0.0,0.0,1.0,31,1050,900,150,0.8571428571428571,12,9,3,395.0526791217989,0.44565412186379927,0.1656559794135597,0.21813025576929707,129030.63441221524,3994.7795626662,133025.41397488143,76,1,35.225806451612904,30,1,22,35.967059134806185,0.6246527777777777,46.001344086021504,1015.9946236559136,33.866487455197124,0
79,4,1,2,30,0.03125,0.0625,0.9375,32,550,200,350,0.36363636363636365,9,2,7,384.4752374347979,0.44747563844086025,0.15778590170229134,0.2141058467625143,129366.91496107307,3547.675069173171,132914.59003024624,77,0,35.09375,31,1,23,35.892236230214614,0.6253360215053764,45.670572916666664,1017.3177083333328,32.816700268817186,0
80,4,1,1,30,0.03225806451612903,0.03225806451612903,0.967741935483871,31,1200,900,300,0.75,15,9,6,387.48035787343576,0.44681899641577066,0.15455409222798355,0.2161837722520104,129440.63484579144,3831.1407026823967,133271.77554847384,78,0,35.903225806451616,30,1,21,35.74054506229914,0.6288194444444444,45.598118279569896,1017.6075268817206,33.920250896057354,0
81,4,1,0,31,0.03225806451612903,0.0,1.0,31,950,600,350,0.631578947368421,13,6,7,387.79637235969454,0.4475358422939068,0.16089438751399587,0.2174931986209776,129645.87894915602,3855.2403095733634,133501.1192587294,79,0,36.87096774193548,30,1,22,35.5230742158286,0.6309027777777778,45.39650537634409,1018.4139784946241,33.94713261648747,0
82,4,1,1,31,0.03125,0.03125,0.96875,32,750,400,350,0.5333333333333333,11,4,7,376.03804602901073,0.44816868279569894,0.15497351289252026,0.213160785281568,130063.28158908413,3381.7484537760365,133445.03004286016,80,0,36.6875,31,1,23,35.39751936005448,0.6323924731182795,44.986979166666664,1020.0520833333327,32.904905913978475,0
83,4,0,0,31,0.0,0.0,1.0,31,1100,900,200,0.8181818181818182,13,9,4,375.8566774169849,0.4456093189964158,0.12506633864179606,0.21433397873647836,130295.81917656786,3594.5107354058064,133890.32991197368,81,1,36.29032258064516,31,0,24,35.16571546996556,0.634744623655914,44.75911458333333,1020.9635416666661,32.934307795698906,0
84,4,0,0,31,0.0,0.0,1.0,31,1050,700,350,0.6666666666666666,14,7,7,374.36059445145963,0.4453853046594982,0.12110143067519008,0.21366344844893329,130329.0557861327,3558.012559678806,133887.0683458115,82,2,37.29032258064516,31,0,24,35.17013091898326,0.6350806451612903,44.72656249999999,1021.0937499999991,32.9385080645161,0
85,4,0,1,30,0.0,0.03225806451612903,0.967741935483871,31,900,800,100,0.8888888888888888,10,8,2,375.8509896070319,0.44534050179211465,0.12003306832063121,0.2146976920238856,130362.29663425009,3599.359639485658,133961.65627373575,83,3,38.29032258064516,31,0,24,35.09830953291683,0.6354166666666667,44.69401041666666,1021.2239583333322,32.9427083333333,0
86,4,1,2,29,0.03225806451612903,0.06451612903225806,0.935483870967742,31,1000,500,500,0.5,15,5,10,376.1478281019286,0.44534050179211465,0.10522508302916744,0.21579006980584303,130528.56445312478,3619.607204861083,134148.17165798586,84,0,37.354838709677416,31,0,20,34.92184845395855,0.6370967741935484,44.531249999999986,1021.8749999999983,32.9637096774193,0
87,4,0,0,29,0.0,0.0,1.0,29,1200,1100,100,0.9166666666666666,13,11,2,389.82726089698707,0.44278530377668307,0.08944141306182107,0.22333094479425533,130475.34722222228,4372.569444444449,134847.91666666672,85,5,38.96551724137931,29,0,24,34.62649537792278,0.6422413793103448,44.583333333333336,1021.6666666666671,35.22988505747128,0
88,4,0,0,29,0.0,0.0,1.0,29,750,400,350,0.5333333333333333,11,4,7,388.9195140138894,0.4425800492610838,0.09249757510156487,0.22342378638783844,130581.79253472215,4357.161458333328,134938.95399305547,86,6,39.96551724137931,29,0,22,34.54146283462427,0.6433189655172413,44.479166666666664,1022.0833333333327,35.2442528735632,0
89,4,0,0,29,0.0,0.0,1.0,29,1100,800,300,0.7272727272727273,14,8,6,387.1084853001089,0.44160509031198686,0.08767041170437428,0.22320123549449492,130723.78713348757,4320.857445987642,135044.64457947522,87,7,40.96551724137931,29,0,22,34.44347299560867,0.6447557471264368,44.34027777777777,1022.6388888888882,35.2634099616858,0
90,4,0,1,28,0.0,0.034482758620689655,0.9655172413793104,29,950,600,350,0.631578947368421,13,6,7,386.44501288668437,0.44170771756978655,0.08425270193734469,0.22364025215523997,130865.85889274691,4314.491705246921,135180.35059799382,88,8,41.96551724137931,29,0,22,34.31617913216597,0.6461925287356323,44.20138888888889,1023.1944444444445,35.28256704980843,0
91,4,0,1,27,0.0,0.03571428571428571,0.9642857142857143,28,1050,800,250,0.7619047619047619,13,8,5,395.51709395714033,0.43874007936507936,0.08714606786667445,0.22836059950372142,130776.44266498227,4744.863712181283,135521.30637716356,89,9,44.07142857142857,28,0,22,34.17497775904856,0.6484375,44.288793103448285,1022.8448275862078,36.53017241379313,0
92,4,0,0,27,0.0,0.0,1.0,27,650,300,350,0.46153846153846156,10,3,7,400.6537221929558,0.4379748338081671,0.06215584219657533,0.23143644423146043,130794.81336805559,5080.685763888892,135875.4991319445,90,10,44.25925925925926,27,0,22,34.02494908350305,0.6520061728395061,44.270833333333336,1022.916666666667,37.88580246913581,0
93,4,0,0,27,0.0,0.0,1.0,27,600,400,200,0.6666666666666666,8,4,4,399.94456859504123,0.43803418803418803,0.05912996632996603,0.23125474424650222,130832.87107160586,5065.179235756826,135898.0503073627,91,11,45.25925925925926,27,0,23,34.00439393939395,0.652391975308642,44.23363095238096,1023.0654761904773,37.89131393298064,0
94,4,0,0,27,0.0,0.0,1.0,27,850,500,350,0.5882352941176471,12,5,7,398.22860606282114,0.43744064577397906,0.057914808351108515,0.2304898901757543,130870.93431122464,5023.309948979617,135894.24426020426,92,12,46.25925925925926,27,0,23,34.00959860383944,0.6527777777777778,44.196428571428584,1023.2142857142869,37.89682539682544,0
95,4,0,0,27,0.0,0.0,1.0,27,450,300,150,0.6666666666666666,6,3,3,398.4906560105167,0.43714387464387466,0.055192024946278284,0.2308694390382753,130909.00308691201,5033.202903557283,135942.2059904693,93,13,47.25925925925926,27,0,23,33.96421041151665,0.6531635802469136,44.159226190476204,1023.3630952380965,37.90233686067024,0
96,4,0,0,27,0.0,0.0,1.0,27,900,700,200,0.7777777777777778,11,7,4,398.314765009206,0.4365503323836657,0.060000107681456694,0.23122424206736977,130985.15724649256,5034.664425666131,136019.8216721587,94,14,48.25925925925926,27,0,23,33.8913420070747,0.6539351851851851,44.084821428571445,1023.6607142857159,37.91335978835985,0
97,4,0,0,27,0.0,0.0,1.0,27,650,400,250,0.6153846153846154,9,4,5,396.7653569480766,0.4357193732193732,0.05244715722843907,0.2307812697514554,131061.33355034738,5000.119357638912,136061.4529079863,95,15,49.25925925925926,27,0,23,33.85363682604274,0.6547067901234568,44.01041666666668,1023.9583333333346,37.92438271604943,0
98,4,0,0,27,0.0,0.0,1.0,27,600,300,300,0.5,9,3,6,396.6350691327489,0.43530389363722694,0.0557546794105932,0.23093422553059054,131099.43000637775,4999.726296768734,136099.15630314648,96,16,50.25925925925926,27,0,23,33.818294100552166,0.6550925925925926,43.9732142857143,1024.1071428571443,37.929894179894234,0
99,4,1,0,28,0.03571428571428571,0.0,1.0,28,800,500,300,0.625,11,5,6,385.68441470230334,0.43603946208112876,0.05324375162587813,0.22699101702883298,131512.27715434672,4544.447128088268,136056.724282435,97,0,49.42857142857143,28,0,24,33.68031236867911,0.6558779761904762,43.57040229885058,1025.7183908045981,36.63279967159279,0
100,4,0,0,28,0.0,0.0,1.0,28,900,600,300,0.6666666666666666,12,6,6,389.5612693933998,0.4347718253968254,0.05524389512209771,0.23016014452250258,131659.69177318682,4657.903331021294,136317.5951042081,98,1,50.42857142857143,28,0,23,33.431623034206005,0.6573660714285714,43.426724137931046,1026.293103448277,36.65332512315275,0
101,4,0,0,28,0.0,0.0,1.0,28,550,200,350,0.36363636363636365,9,2,7,390.0053483044054,0.43468915343915343,0.05915053591425323,0.23064554704359913,131696.5583300307,4672.472420399036,136369.03075042975,99,2,51.42857142857143,28,0,23,33.382908734602466,0.6577380952380952,43.39080459770117,1026.4367816091979,36.65845648604278,0
102,4,0,0,28,0.0,0.0,1.0,28,700,600,100,0.8571428571428571,8,6,2,389.2897848924411,0.43427579365079366,0.057531631653640725,0.23089245581960807,131807.18896568244,4662.238447945574,136469.427413628,100,3,52.42857142857143,28,0,23,33.2893171960263,0.6588541666666667,43.2830459770115,1026.8678160919544,36.67385057471266,0
103,4,0,0,28,0.0,0.0,1.0,28,550,300,250,0.5454545454545454,8,3,5,390.7727517238003,0.4338073192239859,0.056783216783216295,0.23244801787231076,131917.86604901584,4709.981503501137,136627.84755251696,101,4,53.42857142857143,28,0,23,33.139277389277375,0.6599702380952381,43.175287356321846,1027.2988505747137,36.68924466338263,0
104,4,0,1,27,0.0,0.03571428571428571,0.9642857142857143,28,850,600,250,0.7058823529411765,11,6,5,391.13338356851835,0.43383487654320985,0.05807879017919526,0.2328888281347608,131954.76873183393,4722.383034416716,136677.15176625064,102,5,54.42857142857143,28,0,23,33.09269099892789,0.6603422619047619,43.13936781609196,1027.4425287356332,36.694376026272614,0
105,4,0,0,27,0.0,0.0,1.0,27,750,600,150,0.8,9,6,3,406.625824422236,0.43275166191832853,0.057095635188941785,0.24152594149417148,131862.52170138882,5323.74131944444,137186.26302083326,103,6,55.44444444444444,27,0,23,32.788201487491555,0.6628086419753086,43.229166666666664,1027.0833333333328,38.040123456790106,0
106,4,0,0,27,0.0,0.0,1.0,27,1100,800,300,0.7272727272727273,14,8,6,406.0827586134576,0.4322174738841405,0.060374929600129024,0.24193282555875092,131977.176450007,5318.731177366768,137295.9076273738,104,7,56.44444444444444,27,0,23,32.68600651701667,0.663966049382716,43.11755952380952,1027.5297619047612,38.05665784832449,0
107,4,0,0,27,0.0,0.0,1.0,27,900,800,100,0.8888888888888888,10,8,2,405.22213161523905,0.4317426400759734,0.05795516089420838,0.24190745575336675,132053.6406294288,5302.2115486819675,137355.85217811074,105,8,57.44444444444444,27,0,23,32.630694705853976,0.6647376543209876,43.04315476190476,1027.8273809523805,38.06768077601409,0
108,4,0,0,27,0.0,0.0,1.0,27,700,500,200,0.7142857142857143,9,5,4,405.81216844230477,0.4309710351377018,0.05702953315109638,0.24299498127697766,132168.3784190758,5327.107249149634,137495.48566822545,106,9,58.44444444444444,27,0,24,32.49939700916548,0.6658950617283951,42.931547619047606,1028.273809523808,38.08421516754844,0
109,4,0,0,27,0.0,0.0,1.0,27,800,700,100,0.875,9,7,2,408.2604302206618,0.43049620132953464,0.05220438143915662,0.24520454857649276,132283.1660333402,5401.196455144526,137684.36248848474,107,10,59.44444444444444,27,0,25,32.32029630165389,0.6670524691358024,42.81994047619046,1028.7202380952365,38.100749559082836,0
110,4,0,0,27,0.0,0.0,1.0,27,750,500,250,0.6666666666666666,10,5,5,410.26733760592714,0.42907169990503324,0.04948268106162845,0.24716105460649737,132398.00347222207,5463.715277777757,137861.71874999983,108,11,60.44444444444444,27,0,25,32.15249662618084,0.6682098765432098,42.70833333333332,1029.1666666666654,38.117283950617235,0
111,4,0,0,27,0.0,0.0,1.0,27,700,400,300,0.5714285714285714,10,4,6,410.45055860661904,0.42812203228869894,0.05426530896319881,0.24777460422692746,132474.58944515293,5474.853847789097,137949.443292942,109,12,61.44444444444444,27,0,25,32.070323793003766,0.6689814814814814,42.63392857142856,1029.4642857142846,38.12830687830684,0
112,4,0,0,27,0.0,0.0,1.0,27,850,600,250,0.7058823529411765,11,6,5,432.08912933502444,0.4283594491927825,0.03606294781046415,0.24239491812859898,129655.65653344676,5804.559948979603,135460.21648242636,110,13,62.44444444444444,27,0,21,34.38534969803233,0.6404320987654322,45.386904761904766,1018.4523809523813,37.7204585537919,8
113,4,1,0,28,0.03571428571428571,0.0,1.0,28,700,400,300,0.5714285714285714,10,4,6,421.88336341273845,0.4281305114638448,0.05684331148727417,0.24060218141339665,130299.25724996714,5394.217779759571,135693.47502972672,111,0,61.17857142857143,28,0,22,33.98741673702973,0.6436011904761905,44.755747126436795,1020.9770114942543,36.46346469622337,0
114,4,0,0,28,0.0,0.0,1.0,28,650,500,150,0.7692307692307693,8,5,3,421.30000706203725,0.42796516754850084,0.057410161588551833,0.24072350885827665,130372.61362135028,5385.196607874226,135757.8102292245,112,1,62.17857142857143,28,0,22,33.927440911648844,0.6443452380952381,44.68390804597701,1021.2643678160922,36.47372742200329,0
115,4,0,1,27,0.0,0.03571428571428571,0.9642857142857143,28,1050,800,250,0.7619047619047619,13,8,5,419.1728719991315,0.4271108906525573,0.05578379572895109,0.24018842004720592,130482.68688482635,5338.960521535219,135821.64740636156,113,2,63.17857142857143,28,0,22,33.86947452303942,0.6454613095238095,44.57614942528736,1021.6954022988513,36.48912151067326,0
116,4,0,0,27,0.0,0.0,1.0,27,750,600,150,0.8,9,6,3,424.5704054923259,0.42610398860398857,0.0498357684902031,0.2435693378877026,130528.56445312497,5683.713107638889,136212.27756076385,114,3,63.925925925925924,27,0,18,33.684802922188254,0.6493055555555556,44.53125,1021.8749999999998,37.847222222222214,0
117,4,0,0,27,0.0,0.0,1.0,27,850,700,150,0.8235294117647058,10,7,3,457.9157853871559,0.4258072174738841,0.049193565987908805,0.24359971404451516,127542.56129535148,6280.750425170067,133823.31172052154,115,4,64.92592592592592,27,0,17,35.90650166961304,0.6188271604938271,47.470238095238095,1010.1190476190477,37.41181657848325,8
118,4,2,0,29,0.06896551724137931,0.0,1.0,29,500,100,400,0.2,9,1,8,431.6524893947376,0.43467775041050905,0.036900194435639744,0.232887860488397,128109.37741126544,5259.74633487654,133369.12374614197,116,0,61.37931034482759,29,0,19,35.985017377783876,0.6181752873563218,46.90972222222222,1012.3611111111112,34.90900383141763,0
119,4,1,1,29,0.03333333333333333,0.03333333333333333,0.9666666666666667,30,600,300,300,0.5,9,3,6,420.3584520784674,0.43603927203065135,0.03576448746850547,0.22854528385895634,128416.85319473353,4796.221925945203,133213.07512067872,117,0,60.3,30,0,16,35.95455951907351,0.6184027777777779,46.60618279569893,1013.5752688172047,33.785842293906825,0
120,4,0,2,27,0.0,0.06896551724137931,0.9310344827586207,29,1100,600,500,0.5454545454545454,16,6,10,432.4122787832387,0.434061986863711,0.013743474235757835,0.22097674161864794,125904.40779320979,5088.522376543193,130992.93016975297,118,2,63.37931034482759,29,0,17,38.24787803302886,0.5955459770114943,49.097222222222214,1003.6111111111104,34.60727969348657,7
121,4,5,0,32,0.15625,0.0,1.0,32,1050,800,250,0.7619047619047619,13,8,5,395.1211788271191,0.4400831653225807,0.06852631084970606,0.20868561401239308,127251.20722694107,3655.9294013365916,130907.13662827766,119,0,58.15625,32,0,19,37.79225587118842,0.6012369791666667,47.75883838383838,1008.9646464646461,31.53014520202019,0
122,4,2,1,33,0.058823529411764705,0.029411764705882353,0.9705882352941176,34,950,500,450,0.5263157894736842,14,5,9,397.60572380315165,0.4436460190136661,0.09283301175609893,0.20495063110682862,126259.28316332646,3275.4991658010226,129534.78232912748,120,0,55.6764705882353,33,1,20,38.753785107507206,0.588699494949495,48.7438725490196,1005.0245098039204,30.455288175876376,8
123,4,1,0,34,0.029411764705882353,0.0,1.0,34,1350,1100,250,0.8148148148148148,16,11,5,391.5626668082512,0.4453357100415924,0.12105504324417216,0.20412936995536746,126721.57343329486,3123.8874471357117,129845.46088043058,121,0,56.61764705882353,33,1,18,38.42806718597858,0.5934343434343434,48.28431372549019,1006.862745098039,30.51099227569815,0
124,4,2,1,35,0.05555555555555555,0.027777777777777776,0.9722222222222222,36,550,300,250,0.5454545454545454,8,3,5,369.02983319025094,0.4486276455026455,0.11774015964767415,0.1951507109141458,127302.17013888882,2196.2003796616596,129498.37051855048,122,0,54.416666666666664,34,2,20,38.39801816680429,0.5971200980392157,47.70833333333333,1009.1666666666661,29.68137254901959,0
125,4,1,1,35,0.027777777777777776,0.027777777777777776,0.9722222222222222,36,1150,800,350,0.6956521739130435,15,8,7,369.4218431744164,0.4463293650793651,0.11817015034836786,0.19637687452955807,127512.49999999991,2221.1805555555425,129733.68055555546,123,0,55.30555555555556,34,2,17,38.17209845984596,0.5992647058823529,47.49999999999999,1009.9999999999993,29.705882352941156,0
126,4,2,0,37,0.05405405405405406,0.0,1.0,37,950,600,350,0.631578947368421,13,6,7,361.6622527022051,0.4477602602602602,0.11857377459849117,0.19401881070377977,127880.99500868065,1849.9457465277878,129730.94075520843,124,0,54.729729729729726,35,2,21,37.99025918297288,0.6008928571428571,47.13541666666667,1011.4583333333342,28.898809523809547,0
127,4,0,0,37,0.0,0.0,1.0,37,1200,800,400,0.6666666666666666,16,8,8,362.619730921418,0.44719719719719725,0.12398490220748037,0.1951005727659051,127998.08873724705,1882.9264992712579,129881.0152365183,125,1,55.729729729729726,35,2,21,37.84611022151054,0.6020833333333333,47.019675925925924,1011.921296296296,28.912037037037027,0
128,4,1,0,38,0.02631578947368421,0.0,1.0,38,950,600,350,0.631578947368421,13,6,7,355.76178872740104,0.4496947605500237,0.12076407466410166,0.1930994705708862,128349.69142500425,1532.4668852880634,129882.1583102923,126,0,55.23684210526316,35,3,22,37.66002760327433,0.6056547619047619,46.6724537037037,1013.3101851851849,28.95171957671957,0
129,4,0,2,36,0.0,0.05263157894736842,0.9473684210526316,38,1000,800,200,0.8,12,8,4,353.9238789558577,0.44987256993835945,0.12070644236490558,0.19238432079555826,128408.33875868046,1489.3554687499902,129897.69422743045,127,1,56.23684210526316,35,3,17,37.64666837958206,0.60625,46.61458333333333,1013.5416666666658,28.95833333333331,0
130,4,1,0,37,0.02702702702702703,0.0,1.0,37,500,100,400,0.2,9,1,8,364.4402369168352,0.4454767267267267,0.13548753734352226,0.19798849629055632,128385.7160572562,1957.7841553287922,130343.50021258499,128,0,58.486486486486484,34,3,18,37.403334116449344,0.6081495098039216,46.63690476190476,1013.4523809523806,29.807422969187666,0
131,4,1,0,38,0.02631578947368421,0.0,1.0,38,1850,1400,450,0.7567567567567568,23,14,9,355.6878879378946,0.44665718349928873,0.1365133403796852,0.19511959427779937,128772.40997331787,1560.5573056164192,130332.96727893429,129,0,57.921052631578945,36,2,19,37.23025074891822,0.6079282407407407,46.25563063063063,1014.9774774774772,28.193818818818812,0
132,4,0,4,34,0.0,0.10526315789473684,0.8947368421052632,38,1150,900,250,0.782608695652174,14,9,5,358.0920717501923,0.4464052868658132,0.1350931677018632,0.19686329993291052,128858.1486892297,1628.6162852041139,130486.76497443381,130,1,58.921052631578945,36,2,19,37.08176205264714,0.6087962962962963,46.17117117117117,1015.3153153153148,28.203203203203188,0
133,4,0,0,34,0.0,0.0,1.0,34,800,700,100,0.875,9,7,2,389.96606889202775,0.4417520796197267,0.13301272652630347,0.21142484708038053,128304.38220589745,3206.87111009082,131511.25331598826,131,2,62.470588235294116,32,2,21,36.84000083084082,0.6119791666666667,46.71717171717172,1013.1313131313138,31.660353535353558,0
134,4,0,0,34,0.0,0.0,1.0,34,1000,800,200,0.8,12,8,4,387.2409315458299,0.4413250148544266,0.12391634117207384,0.21045246834924694,128400.34060618813,3144.3735014284266,131544.71410761654,132,3,63.470588235294116,32,2,20,36.81065985631826,0.6129557291666667,46.62247474747475,1013.5101010101008,31.67219065656565,0
135,4,0,0,34,0.0,0.0,1.0,34,700,300,400,0.42857142857142855,11,3,8,384.25391856834926,0.4414364230540701,0.12275593838581411,0.20950055804632814,128528.34093778701,3077.5037304866933,131605.8446682737,133,4,64.47058823529412,32,2,20,36.755229734777735,0.6142578125,46.496212121212125,1014.015151515152,31.6879734848485,0
136,4,0,0,34,0.0,0.0,1.0,34,800,600,200,0.75,10,6,4,385.23076003753926,0.44091651812240046,0.12628422463221578,0.21037108738147875,128592.36501696256,3107.5469021018293,131699.91191906438,134,5,65.47058823529412,32,2,20,36.664903108012766,0.6149088541666667,46.43308080808081,1014.2676767676768,31.6958648989899,0
137,4,0,0,34,0.0,0.0,1.0,34,950,700,250,0.7368421052631579,12,7,5,384.59151340124254,0.4400438205585264,0.1256551401048227,0.21052979575561198,128688.43102744612,3098.495689215377,131786.9267166615,135,6,66.47058823529412,32,2,20,36.58277335324374,0.6158854166666667,46.338383838383834,1014.6464646464641,31.707702020202003,0
138,4,0,0,34,0.0,0.0,1.0,34,1150,900,250,0.782608695652174,14,9,5,393.18148972067627,0.439263963161022,0.1159536778362178,0.21322317046866618,128314.69859232291,3300.7825092055714,131615.48110152848,136,7,67.47058823529412,30,4,21,36.747976916954094,0.6173611111111111,46.70698924731183,1013.1720430107534,33.77240143369178,8
139,4,1,1,34,0.02857142857142857,0.02857142857142857,0.9714285714285714,35,1000,600,400,0.6,14,6,8,382.4980283084798,0.4420518207282913,0.1200271305750582,0.20947344586141814,128705.44645521369,2845.9159003363634,131551.36235555005,137,0,66.51428571428572,31,4,21,36.61846635869797,0.6186155913978495,46.32161458333333,1014.7135416666661,32.7326948924731,0
140,4,0,1,33,0.0,0.029411764705882353,0.9705882352941176,34,1150,900,250,0.782608695652174,14,9,5,383.8227109350813,0.44024806892453955,0.11683991370336311,0.21107542312212715,128870.65463595914,3092.696804470482,131963.35144042963,138,1,66.91176470588235,31,3,21,36.41585449260495,0.6202956989247312,46.158854166666664,1015.3645833333328,32.75369623655912,0
141,4,0,1,32,0.0,0.030303030303030304,0.9696969696969697,33,1000,800,200,0.8,12,8,4,384.79001341727735,0.4403409090909091,0.10322596165411757,0.21228050521224684,128996.49706613483,3327.312767371959,132323.8098335068,139,2,67.39393939393939,30,3,21,36.262624592043764,0.6243055555555556,46.03494623655914,1015.8602150537636,33.86200716845879,0
142,4,2,1,33,0.058823529411764705,0.029411764705882353,0.9705882352941176,34,1150,800,350,0.6956521739130435,15,8,7,364.58963425642423,0.4427176173499703,0.09922959634058248,0.20400320756485427,129554.63927469142,2646.855709876551,132201.49498456798,140,0,64.44117647058823,32,2,18,36.206798544793074,0.6246744791666667,45.486111111111114,1018.0555555555561,31.81423611111113,0
143,4,1,0,34,0.029411764705882353,0.0,1.0,34,750,600,150,0.8,9,6,3,363.82678850421684,0.44123217468805703,0.1032638417955507,0.2042443077845177,129683.21352731875,2636.445420110207,132319.65894742895,141,0,65.41176470588235,32,2,20,36.095357629850014,0.6259765625,45.35984848484849,1018.5606060606069,31.830018939393966,0
144,4,0,0,34,0.0,0.0,1.0,34,1050,700,350,0.6666666666666666,14,7,7,362.7141668384689,0.440786541889483,0.099024589387124,0.20395404963202834,129747.52456700856,2612.253054535262,132359.77762154382,142,1,66.41176470588235,32,2,20,36.05826826950883,0.6266276041666667,45.29671717171718,1018.813131313132,31.837910353535374,0
145,4,0,0,34,0.0,0.0,1.0,34,1300,900,400,0.6923076923076923,17,9,8,362.1385424953753,0.4402295008912656,0.09305044618466618,0.20463741991953527,129940.55333958288,2611.296519487835,132551.84985907073,143,2,67.41176470588235,32,2,20,35.87667698658411,0.6285807291666667,45.107323232323246,1019.5707070707085,31.86158459595964,0
146,4,0,0,34,0.0,0.0,1.0,34,1000,500,500,0.5,15,5,10,368.04699575289845,0.44047088532382656,0.08940576958762159,0.19570602187067032,127524.87775134569,2587.0296280276903,130111.90737937338,144,3,68.41176470588235,33,1,17,38.19410741729354,0.6016414141414141,47.48774509803922,1010.0490196078435,30.607546048722533,6
147,4,0,0,34,0.0,0.0,1.0,34,400,400,0,1.0,4,4,0,372.86066908347544,0.4403409090909091,0.04631177834071276,0.19161999401111285,126136.14843149271,2606.2417399557894,128742.3901714485,145,4,69.41176470588235,33,1,21,39.50263816030255,0.5874368686868687,48.86642156862745,1004.5343137254903,30.44043374925728,8
148,4,3,1,36,0.08108108108108109,0.02702702702702703,0.972972972972973,37,1150,800,350,0.6956521739130435,15,8,7,351.0689160576465,0.4446008508508508,0.05874469510833169,0.18469277757815306,127092.01388888883,1523.6111111111063,128615.62499999994,146,0,64.70270270270271,36,1,18,39.0668044077135,0.5908564814814814,47.916666666666664,1008.3333333333328,28.009259259259245,0
149,4,2,2,36,0.05263157894736842,0.05263157894736842,0.9473684210526316,38,1350,1000,350,0.7407407407407407,17,10,7,345.3262305741464,0.4487316263632053,0.07463040263129272,0.18430062925315058,127673.1316967722,1217.776262888591,128890.90795966079,147,0,63.26315789473684,37,1,16,38.616031065784234,0.5948761261261262,47.34100877192983,1010.6359649122817,27.314485538169777,0
150,4,0,2,34,0.0,0.05555555555555555,0.9444444444444444,36,1300,900,400,0.6923076923076923,17,9,8,356.5166544706671,0.4447585978835979,0.08078724921071401,0.18973642440365732,127559.26354595325,1895.400377229065,129454.6639231823,148,1,67.75,35,1,16,38.450007638252345,0.5976190476190476,47.453703703703695,1010.1851851851842,28.862433862433836,0
151,4,0,1,33,0.0,0.029411764705882353,0.9705882352941176,34,800,400,400,0.5,12,4,8,375.2994765161112,0.4420491681521093,0.09539182355798115,0.19864823191431188,127339.27455786237,2758.0726163014256,130097.34717416379,149,2,71.76470588235294,33,1,16,38.201695807026056,0.5997474747474747,47.67156862745098,1009.3137254901962,30.585264408793826,0
152,4,3,1,35,0.08333333333333333,0.027777777777777776,0.9722222222222222,36,1000,800,200,0.8,12,8,4,354.1126860742771,0.44872685185185185,0.09019204389574798,0.19122085048010978,128144.53125000013,1875.5208333333478,130020.05208333347,150,0,66.77777777777777,35,1,20,37.91152263374486,0.6035714285714286,46.87500000000001,1012.500000000001,28.92857142857146,0
153,4,2,3,34,0.05405405405405406,0.08108108108108109,0.9189189189189189,37,1200,700,500,0.5833333333333334,17,7,10,351.90087711512416,0.4498561061061061,0.12005146862543348,0.192764668916984,128715.26668137748,1659.003048656783,130374.26973003427,151,0,63.891891891891895,36,1,17,37.38463174638405,0.607349537037037,46.311936936936945,1014.7522522522536,28.1875625625626,0
154,4,1,2,33,0.02857142857142857,0.05714285714285714,0.9428571428571428,35,1250,1000,250,0.8,15,10,5,370.1398092889755,0.44390756302521006,0.1233478107759125,0.2020000663249703,128566.75347222241,2517.534722222243,131084.28819444464,152,0,68.42857142857143,34,1,18,37.073746918652425,0.6099877450980392,46.45833333333334,1014.1666666666682,29.828431372549066,0
155,4,0,0,33,0.0,0.0,1.0,33,900,700,200,0.7777777777777778,11,7,4,383.5431490439916,0.4440104166666667,0.125746447419546,0.20944949804693294,128592.36501696249,3264.1441243240374,131856.50914128651,153,1,68.39393939393939,32,1,18,36.70769534005559,0.6149088541666667,46.4330808080808,1014.2676767676762,31.695864898989882,0
156,4,0,0,33,0.0,0.0,1.0,33,800,400,400,0.5,12,4,8,386.61513483004927,0.44408933080808083,0.12488498725432495,0.21163754928435116,128688.43102744613,3350.579022548711,132039.01004999483,154,2,69.39393939393939,32,1,18,36.53144184503069,0.6158854166666667,46.338383838383834,1014.6464646464642,31.707702020202007,0
157,4,2,0,35,0.05714285714285714,0.0,1.0,35,900,800,100,0.8888888888888888,10,8,2,370.28208913057654,0.44873949579831934,0.11745028183384365,0.20549573250579958,129231.64859693882,2570.432964852613,131802.08156179142,155,0,66.37142857142857,34,1,20,36.39113296647543,0.6167279411764706,45.80357142857143,1016.7857142857147,29.90546218487396,0
158,4,2,1,36,0.05405405405405406,0.02702702702702703,0.972972972972973,37,1100,700,400,0.6363636363636364,15,7,8,355.40358901813295,0.4522647647647648,0.10828133913557725,0.20012738500467264,129803.1577819376,1826.5016283175398,131629.65941025515,156,0,63.729729729729726,36,1,19,36.18793052639334,0.6183449074074074,45.24211711711713,1019.0315315315336,28.306431431431488,0
159,4,0,0,36,0.0,0.0,1.0,36,1000,800,200,0.8,12,8,4,367.47988102549147,0.44872685185185185,0.11025577901501071,0.20639377363786557,129701.96926708259,2332.5728470078993,132034.5421140905,157,1,66.47222222222223,35,1,19,35.98324527515814,0.6193452380952381,45.34143518518519,1018.6342592592601,29.103835978836003,0
160,4,0,1,35,0.0,0.027777777777777776,0.9722222222222222,36,1600,1100,500,0.6875,21,11,10,367.0521724241007,0.4484292328042328,0.10777020632216572,0.2067750721813314,129819.89354263127,2330.1347897376677,132150.02833236894,158,2,67.47222222222223,35,1,19,35.874148211243615,0.6205357142857143,45.22569444444445,1019.097222222223,29.11706349206351,0
161,4,0,0,35,0.0,0.0,1.0,35,1250,1000,250,0.8,15,10,5,376.25203845298284,0.44597338935574227,0.11294361165826472,0.21156142871751804,129746.60572562354,2763.4849773242568,132510.09070294778,159,3,70.22857142857143,34,1,20,35.714390044402904,0.6219362745098039,45.297619047619044,1018.8095238095234,29.964985994397747,0
162,4,1,0,36,0.027777777777777776,0.0,1.0,36,1200,900,300,0.75,15,9,6,367.19405669404773,0.4451388888888889,0.11530344836275219,0.2090564484173534,130233.05047850215,2364.1604241683717,132597.21090267051,160,0,69.25,35,1,21,35.45056601277545,0.624702380952381,44.82060185185185,1020.7175925925919,29.16335978835977,0
163,4,0,0,36,0.0,0.0,1.0,36,900,500,400,0.5555555555555556,13,5,8,370.2550410811981,0.4449570105820106,0.11362046858608266,0.21162011974920705,130384.14292800447,2455.080588208784,132839.22351621324,161,1,70.25,34,2,22,35.218994055251194,0.6283700980392157,44.672619047619044,1021.3095238095233,30.03851540616245,0
164,4,1,1,36,0.02702702702702703,0.02702702702702703,0.972972972972973,37,1050,800,250,0.7619047619047619,13,8,5,360.50124232104577,0.445508008008008,0.11130071007871445,0.2082424823289804,130794.81336805546,2030.3385416666563,132825.1519097221,162,0,69.32432432432432,35,2,20,35.05176510522742,0.6303571428571428,44.27083333333333,1022.9166666666658,29.226190476190453,0
165,4,1,0,37,0.02702702702702703,0.0,1.0,37,1000,700,300,0.7,13,7,6,359.9431749773582,0.44494494494494496,0.11871353429648135,0.20871983582457557,130942.84664619763,2026.3967924811332,132969.24343867876,163,0,70.10810810810811,35,2,21,34.916153077763965,0.6318452380952381,44.126157407407405,1023.4953703703698,29.24272486772485,0
166,4,0,0,37,0.0,0.0,1.0,37,1000,500,500,0.5,15,5,10,362.90385174621656,0.4445382882882883,0.12454977866981909,0.2110854948322668,131061.33355034732,2112.5325520833435,133173.86610243068,164,1,71.10810810810811,35,2,21,34.720456086809094,0.6330357142857144,44.01041666666667,1023.9583333333342,29.255952380952404,0
167,4,0,1,36,0.0,0.02702702702702703,0.972972972972973,37,1200,1000,200,0.8333333333333334,14,10,4,359.77557762900466,0.44394394394394393,0.12032567979704556,0.21023717417488944,131239.1643759644,2043.3292341820875,133282.49361014648,165,2,72.10810810810811,35,2,22,34.62067943070145,0.6348214285714286,43.83680555555555,1024.652777777777,29.275793650793627,0
168,4,1,1,36,0.02702702702702703,0.02702702702702703,0.972972972972973,37,850,600,250,0.7058823529411765,11,6,5,357.9218719016459,0.44228603603603606,0.1256866622720283,0.20963995354239243,131328.12499999988,2001.0416666666524,133329.16666666654,166,0,72.83783783783784,35,2,23,34.57825203252033,0.6357142857142857,43.74999999999999,1024.999999999999,29.28571428571426,0
169,4,0,0,36,0.0,0.0,1.0,36,500,200,300,0.4,8,2,6,372.3296690852322,0.4420138888888889,0.12479474548440095,0.20427816979541127,128778.1250000001,2389.5833333333494,131167.70833333346,167,1,74.55555555555556,34,2,20,36.80213464696223,0.6121323529411764,46.25000000000001,1015.0000000000008,29.852941176470612,8
170,4,1,1,36,0.02702702702702703,0.02702702702702703,0.972972972972973,37,650,500,150,0.7692307692307693,8,5,3,364.4828262774924,0.4433495995995996,0.1348581558101032,0.20182144895138313,129142.56071030517,2014.049104080931,131156.60981438612,168,0,73.51351351351352,35,2,21,36.629374478099145,0.6136904761904762,45.8912037037037,1016.4351851851849,29.04100529100528,0
171,4,2,3,35,0.05263157894736842,0.07894736842105263,0.9210526315789473,38,800,500,300,0.625,11,5,6,350.92410231949356,0.44606448553816974,0.12257234951185225,0.19717139314174767,129717.10519641262,1504.1851352259446,131221.29033163856,169,0,68.71052631578948,36,2,18,36.38947232662689,0.6174768518518519,45.32657657657658,1018.6936936936936,28.297047047047045,0
172,4,0,0,35,0.0,0.0,1.0,35,1100,700,400,0.6363636363636364,15,7,8,373.7719957999883,0.4427521008403361,0.144808244868464,0.20842369920263953,129419.51600646385,2674.678158640905,132094.19416510477,170,1,75.31428571428572,33,2,22,36.11081837889919,0.6208964646464646,45.618872549019606,1017.5245098039215,30.83407605466429,0
173,4,0,1,34,0.0,0.02857142857142857,0.9714285714285714,35,1550,1100,450,0.7096774193548387,20,11,9,377.9624299319398,0.4417016806722689,0.15419424720182917,0.21176600339207607,129606.62853529888,2797.2872512975673,132403.91578659645,171,2,76.31428571428572,33,2,18,35.81345027480241,0.622790404040404,45.43504901960784,1018.2598039215683,30.85635769459298,0
174,4,0,0,34,0.0,0.0,1.0,34,900,700,200,0.7777777777777778,11,7,4,384.19010298566207,0.4411021984551396,0.15018168021363887,0.21479477186341236,129522.50567544125,3152.252958881747,132674.758634323,172,3,78.32352941176471,32,2,18,35.74071777061111,0.6243489583333333,45.51767676767677,1017.9292929292926,31.810290404040394,0
175,4,0,0,34,0.0,0.0,1.0,34,950,700,250,0.7368421052631579,12,7,5,384.5104122378121,0.4415849673202614,0.15027573529411842,0.21532583085317472,129586.77685950405,3165.4929981634496,132752.2698576675,173,4,79.32352941176471,32,2,19,35.66700768849209,0.625,45.45454545454545,1018.1818181818176,31.8181818181818,0
176,4,1,0,35,0.02857142857142857,0.0,1.0,35,1150,900,250,0.782608695652174,14,9,5,377.62734391591613,0.4417016806722689,0.15288907199505664,0.2137833167393369,130012.5027032871,2819.2552143406283,132831.75791762772,174,0,78.02857142857142,33,2,20,35.40865577184972,0.6268939393939394,45.03676470588235,1019.8529411764698,30.904634581105146,0
177,4,1,1,35,0.027777777777777776,0.027777777777777776,0.9722222222222222,36,850,600,250,0.7058823529411765,11,6,5,369.9221572135507,0.4434193121693122,0.15492287368380175,0.21142985920953034,130384.14292800447,2446.396683673463,132830.53961167793,175,0,76.83333333333333,34,2,21,35.22749349185997,0.6283700980392157,44.672619047619044,1021.3095238095233,30.03851540616245,0
178,4,0,0,35,0.0,0.0,1.0,35,1200,1100,100,0.9166666666666666,13,11,2,378.00916284881276,0.4425770308123249,0.16209912536443172,0.21537731371618424,130262.58680555565,2848.090277777788,133110.67708333343,176,1,79.68571428571428,33,2,21,35.14455782312925,0.6294191919191919,44.79166666666667,1020.8333333333342,30.93434343434346,0
179,4,0,0,35,0.0,0.0,1.0,35,1000,600,400,0.6,14,6,8,376.98659032404754,0.4418767507002801,0.1636248307075141,0.21531386272585923,130356.43029423773,2828.5252366878053,133184.95553092554,177,2,80.68571428571428,33,2,21,35.07527801112045,0.6303661616161615,44.69975490196078,1021.2009803921563,30.945484254307768,0
180,4,1,0,36,0.027777777777777776,0.0,1.0,36,1000,600,400,0.6,14,6,8,368.1828779120162,0.44229497354497355,0.16188988499501988,0.21209408037466856,130688.28125000001,2423.4375000000014,133111.71875000003,178,0,79.41666666666667,34,2,17,34.96332518337408,0.6314338235294117,44.375,1022.5000000000001,30.07352941176471,0
181,4,0,2,34,0.0,0.05555555555555555,0.9444444444444444,36,1050,600,450,0.5714285714285714,15,6,9,375.83953145391456,0.44098875661375664,0.16069489685124894,0.21770327576670162,130901.38888888896,2639.5833333333444,133540.9722222223,179,1,80.41666666666667,34,2,18,34.551438653637355,0.633578431372549,44.16666666666667,1023.3333333333339,30.098039215686292,0
182,4,2,0,36,0.05555555555555555,0.0,1.0,36,900,700,200,0.7777777777777778,11,7,4,381.92124425315205,0.44226190476190474,0.16545613015688598,0.22280896995243227,131175.6395266441,2819.752692743783,133995.3922193879,180,0,80.33333333333333,34,2,20,34.11776099167152,0.6363357843137255,43.89880952380953,1024.4047619047628,30.12955182072832,0
183,4,0,1,35,0.0,0.027777777777777776,0.9722222222222222,36,1100,700,400,0.6363636363636364,15,7,8,382.3782140260424,0.44118716931216934,0.16531165311653062,0.2239643825009678,131328.12500000006,2843.4913548752843,134171.61635487535,181,1,81.33333333333333,33,3,20,33.951558265582634,0.6401515151515151,43.75,1025.0000000000005,31.060606060606073,0
184,4,0,1,34,0.0,0.02857142857142857,0.9714285714285714,35,1100,900,200,0.8181818181818182,13,9,4,394.6082521376356,0.43925070028011204,0.17789241728019656,0.23093833538327826,131296.7236910083,3362.1541294213775,134658.87782042965,182,2,84.28571428571429,33,2,20,33.67000976523575,0.6398358585858586,43.78063725490196,1024.8774509803925,31.05689245395129,0
185,4,0,0,34,0.0,0.0,1.0,34,800,500,300,0.625,11,5,6,393.25128308410416,0.4387811942959002,0.15904009225014448,0.23071109637318474,131390.93888168014,3533.931060169163,134924.8699418493,183,3,83.3529411764706,33,1,20,33.609251733205824,0.6407828282828283,43.68872549019608,1025.2450980392157,31.068033273915628,0
186,4,0,0,34,0.0,0.0,1.0,34,650,400,250,0.6153846153846154,9,4,5,396.09746185477775,0.4377599524658348,0.16768114821505153,0.23295429783996044,131485.187863442,3616.189836841608,135101.3777002836,184,4,84.3529411764706,33,1,20,33.44074859600909,0.641729797979798,43.5968137254902,1025.6127450980398,31.079174093879995,0
187,4,0,0,34,0.0,0.0,1.0,34,950,500,450,0.5263157894736842,14,5,9,394.71515296851584,0.4372586155674391,0.1662590484222366,0.23233233687387303,131516.6116998268,3582.319900999595,135098.9316008264,185,5,85.3529411764706,33,1,20,33.444344882516916,0.6420454545454546,43.566176470588225,1025.7352941176457,31.08288770053472,0
188,4,0,1,33,0.0,0.029411764705882353,0.9705882352941176,34,1050,700,350,0.6666666666666666,14,7,7,397.66484100222874,0.43636734997029114,0.17036625971143193,0.2348409998979311,131642.34459102261,3669.9064061899167,135312.25099721254,186,6,86.3529411764706,33,1,18,33.24128254119895,0.6433080808080809,43.44362745098039,1026.2254901960778,31.09774212715387,0
189,4,0,0,33,0.0,0.0,1.0,33,950,600,350,0.631578947368421,13,6,7,407.7321584569615,0.4353298611111111,0.17816928208457372,0.23962377648244879,131457.57607642084,4119.896247831862,135577.4723242527,187,7,89.72727272727273,32,1,19,33.17045267996387,0.6438802083333333,43.62373737373738,1025.505050505051,32.047032828282845,0
190,4,0,0,33,0.0,0.0,1.0,33,1000,700,300,0.7,13,7,6,406.062008959573,0.43461963383838387,0.18146036005814592,0.24026813193896138,131716.66953627186,4097.0270890725515,135813.6966253444,188,8,90.72727272727273,32,1,18,32.95049200492006,0.646484375,43.371212121212125,1026.515151515152,32.0785984848485,0
191,4,1,0,34,0.029411764705882353,0.0,1.0,34,1050,500,550,0.47619047619047616,16,5,11,399.65995198815915,0.43475193107546045,0.18891038717954145,0.2393680697453707,132177.37956855533,3765.2010344578994,135942.58060301322,189,0,89.02941176470588,33,1,19,32.64844774162794,0.6486742424242424,42.92279411764706,1028.3088235294115,31.160873440285197,0
192,4,0,1,33,0.0,0.029411764705882353,0.9705882352941176,34,1000,500,500,0.5,15,5,10,399.79336334074065,0.43380496137849084,0.19086119440629967,0.24044878786596435,132334.949298347,3781.3268935025208,136116.27619184952,190,1,90.02941176470588,33,1,19,32.485707479752264,0.6502525252525253,42.769607843137265,1028.9215686274524,31.179441473559166,0
193,4,0,0,33,0.0,0.0,1.0,33,700,200,500,0.2857142857142857,12,2,10,411.2247384348195,0.43150252525252525,0.20288561322070553,0.24688636286134702,132268.09007052873,4278.382148505281,136546.472219034,191,2,93.45454545454545,32,1,19,32.25931835849597,0.6520182291666667,42.83459595959597,1028.6616161616178,32.145675505050555,0
194,4,0,0,33,0.0,0.0,1.0,33,1250,800,450,0.64,17,8,9,388.9798027367424,0.4294902146464647,0.17146477523836023,0.22238757818272642,130395.54172092007,3549.7026546039533,133945.24437552402,192,3,94.45454545454545,31,2,21,34.72930477647459,0.635752688172043,44.66145833333333,1021.3541666666661,32.946908602150515,8
195,4,0,1,32,0.0,0.030303030303030304,0.9696969696969697,33,1100,900,200,0.8181818181818182,13,9,4,411.1797903789304,0.4292929292929293,0.18554396423248876,0.22801788375558874,129201.38888888892,4064.1981336805597,133265.58702256947,193,4,95.45454545454545,29,4,19,35.382513661202196,0.6293103448275862,45.833333333333336,1016.666666666667,35.05747126436783,8
196,4,1,0,33,0.030303030303030304,0.0,1.0,33,1150,700,450,0.6086956521739131,16,7,9,414.0548857993576,0.43138415404040403,0.17521653885290278,0.2308497787949843,129413.28124999999,4116.840277777778,133530.12152777775,194,0,94.18181818181819,29,4,21,35.09247884247885,0.6314655172413793,45.625,1017.4999999999999,35.08620689655172,0
197,4,0,1,32,0.0,0.030303030303030304,0.9696969696969697,33,1150,800,350,0.6956521739130435,15,8,7,465.0270482229971,0.4318576388888889,0.14062597224814888,0.25445862076921294,128672.4175347222,5370.008680555549,134042.42621527775,195,1,95.18181818181819,29,4,14,34.55894934976044,0.6239224137931034,46.354166666666664,1014.5833333333331,34.98563218390804,8
198,4,1,0,33,0.030303030303030304,0.0,1.0,33,900,500,400,0.5555555555555556,13,5,8,463.6616375002012,0.43162089646464646,0.1568481202010532,0.25552053918907097,128954.40055941363,5358.241705246921,134312.64226466054,196,0,96.12121212121212,29,4,15,34.30292515611468,0.6267959770114943,46.07638888888889,1015.6944444444448,35.02394636015327,0
199,4,0,0,33,0.0,0.0,1.0,33,900,600,300,0.6666666666666666,12,6,6,461.86230619993773,0.43087121212121215,0.15351547454868486,0.25543813261261866,129095.5078125,5324.869791666666,134420.37760416666,197,1,97.12121212121212,29,4,15,34.203310783107824,0.6282327586206897,45.9375,1016.25,35.043103448275865,0
200,4,0,0,33,0.0,0.0,1.0,33,1200,900,300,0.75,15,9,6,462.75204137497263,0.4296875,0.1458682387010033,0.2577687226670472,129377.95380015412,5373.982445987624,134751.93624614173,198,2,98.12121212121212,29,4,15,33.890073947667794,0.6311063218390804,45.65972222222221,1017.3611111111095,35.081417624521016,0
201,4,1,0,34,0.029411764705882353,0.0,1.0,34,800,300,500,0.375,13,3,10,451.4359719583746,0.43200386215092096,0.13507840809453975,0.25407098020908947,129782.79867976051,4917.724773095134,134700.52345285565,199,0,96.20588235294117,30,4,15,33.762311480455516,0.6322916666666667,45.26209677419354,1018.9516129032246,33.96505376344082,0
202,4,0,2,32,0.0,0.058823529411764705,0.9411764705882353,34,950,700,250,0.7368421052631579,12,7,5,411.4623740221217,0.431985294117647,0.09142085291775315,0.22237858865729304,128178.55568562844,3748.1305642270836,131926.68624985553,200,1,97.20588235294117,30,4,16,36.42487390496416,0.6159722222222221,46.84139784946237,1012.6344086021509,33.754480286738364,8
203,4,2,0,34,0.058823529411764705,0.0,1.0,34,700,400,300,0.5714285714285714,10,4,6,409.23232848975545,0.4341577540106952,0.11134982960438622,0.22287649485907754,128484.97884509768,3716.0414137472553,132201.02025884495,201,0,97.79411764705883,30,4,15,36.166534093419955,0.6190972222222222,46.538978494623656,1013.8440860215052,33.7948028673835,0
204,4,0,2,32,0.0,0.058823529411764705,0.9411764705882353,34,900,700,200,0.7777777777777778,11,7,4,408.87697890413193,0.43386066547831253,0.11311347600670496,0.22306412189672284,128553.12256113422,3712.4824762978337,132265.60503743205,202,1,98.79411764705883,30,4,15,36.105588690081724,0.6197916666666667,46.471774193548384,1014.1129032258063,33.80376344086021,0
205,4,2,0,34,0.058823529411764705,0.0,1.0,34,1350,1000,350,0.7407407407407407,17,10,7,402.95911144168593,0.438818330362448,0.11347539809784712,0.22230401199096805,128996.49706613479,3596.062767371945,132592.55983350673,203,0,93.82352941176471,30,4,18,35.80119299638351,0.6243055555555556,46.034946236559136,1015.8602150537632,33.862007168458774,0
206,4,1,0,35,0.02857142857142857,0.0,1.0,35,800,600,200,0.75,10,6,4,387.81566817092846,0.44107142857142856,0.11210445874294805,0.21637084920575528,129440.63484579143,3039.983849288943,132480.61869508037,204,0,92.11428571428571,30,5,16,35.73201470523489,0.6288194444444444,45.598118279569896,1017.6075268817204,33.92025089605735,0
207,4,1,0,36,0.027777777777777776,0.0,1.0,36,1100,800,300,0.7272727272727273,14,8,6,379.6158246841651,0.4414351851851852,0.10549773537631335,0.21380874536119307,129811.85154894913,2655.7266159065475,132467.57816485566,205,0,90.52777777777777,32,4,17,35.562249617973826,0.6272786458333333,45.23358585858586,1019.0656565656568,31.845801767676775,0
208,4,0,2,34,0.0,0.05555555555555555,0.9444444444444444,36,1600,1400,200,0.875,18,14,4,381.22715391532427,0.4414021164021164,0.10597650392747582,0.21577937786783982,130004.92814827568,2712.281750586671,132717.20989886235,206,1,91.52777777777777,32,4,17,35.324584210309105,0.6292317708333333,45.04419191919192,1019.8232323232322,31.869476010101007,0
209,4,0,0,34,0.0,0.0,1.0,34,900,700,200,0.7777777777777778,11,7,4,388.26952478235324,0.4390225787284611,0.09160151402333083,0.219094946127185,129885.535900104,3286.1190600069294,133171.65496011093,207,2,93.3529411764706,30,4,18,35.266679852320664,0.6333333333333333,45.16129032258064,1019.354838709677,33.9784946236559,0
210,4,0,1,33,0.0,0.029411764705882353,0.9705882352941176,34,800,500,300,0.625,11,5,6,390.5308689381989,0.4378156565656566,0.09904530907343845,0.2217292315714186,130125.41415553815,3363.598212221059,133489.01236775922,208,3,94.3529411764706,30,4,19,34.96465112194266,0.6357638888888889,44.9260752688172,1020.2956989247307,34.00985663082436,0
211,4,1,0,34,0.029411764705882353,0.0,1.0,34,750,400,350,0.5333333333333333,11,4,7,413.51316827994617,0.43783422459893045,0.14120538610023559,0.2221637128938723,127940.47948100924,3895.1941698462138,131835.67365085546,209,0,95.11764705882354,30,4,20,36.617897790177594,0.6135416666666667,47.0766129032258,1011.6935483870958,33.72311827956986,8
212,4,2,2,34,0.05555555555555555,0.05555555555555555,0.9444444444444444,36,1250,1000,250,0.8,15,10,5,390.6311152168911,0.4399470899470899,0.13435204780281396,0.21332017325202482,128592.36501696253,2846.435790990719,131438.80080795326,210,0,90.77777777777777,32,4,20,36.52796796547576,0.6149088541666667,46.43308080808081,1014.2676767676766,31.695864898989893,0
213,4,1,0,35,0.02857142857142857,0.0,1.0,35,500,300,200,0.6,7,3,4,396.1604734026732,0.43841036414565826,0.15159840801129842,0.2162364349918304,128573.35620456265,3187.136332194006,131760.49253675665,211,0,94.17142857142858,31,4,21,36.40724633029486,0.617271505376344,46.451822916666664,1014.1927083333327,32.71589381720428,0
214,4,0,0,35,0.0,0.0,1.0,35,1200,800,400,0.6666666666666666,16,8,8,392.29231489399626,0.4387254901960784,0.1509732761464866,0.2150159143659499,128738.47961425783,3100.623236762153,131839.10285101997,212,1,95.17142857142858,31,4,21,36.336177401419896,0.6189516129032258,46.2890625,1014.8437500000001,32.73689516129033,0
215,4,0,0,35,0.0,0.0,1.0,35,1150,900,250,0.782608695652174,14,9,5,407.7796945474763,0.43848039215686274,0.17270601653835227,0.21687646174977243,127532.86371618112,3418.9999964433287,130951.86371262444,213,2,96.17142857142858,30,5,19,37.182579285872706,0.609375,47.47983870967742,1010.0806451612908,33.669354838709694,8
216,4,0,1,34,0.0,0.02857142857142857,0.9714285714285714,35,1550,1200,350,0.7741935483870968,19,12,7,408.8162240262568,0.4374299719887955,0.17675461089900657,0.21852926943151926,127736.59030306975,3444.1581035379863,131180.74840660774,214,3,97.17142857142858,30,5,20,36.94654966094935,0.6114583333333333,47.278225806451616,1010.8870967741938,33.69623655913979,0
217,4,1,0,35,0.02857142857142857,0.0,1.0,35,850,600,250,0.7058823529411765,11,6,5,406.89019045553084,0.43795518207282913,0.1864617719597801,0.21916188370029663,128042.4850416233,3419.84622499711,131462.3312666204,215,0,98.02857142857142,30,5,23,36.68050022133688,0.6145833333333333,46.975806451612904,1012.0967741935483,33.736559139784944,0
218,4,1,1,35,0.027777777777777776,0.027777777777777776,0.9722222222222222,36,1350,800,550,0.5925925925925926,19,8,11,435.57511054591794,0.44029431216931214,0.17491023275109763,0.23347908099448897,127848.07205200198,3956.569489827391,131804.64154182936,216,0,96.27777777777777,31,5,18,36.15523475387322,0.6098790322580645,47.16796875,1011.3281250000002,32.623487903225815,8
219,4,0,1,34,0.0,0.02857142857142857,0.9714285714285714,35,1000,800,200,0.8,12,8,4,440.99339977367475,0.43735994397759104,0.19228928476469043,0.23592833236824898,127770.56054168109,4269.1947768528125,132039.7553185339,217,1,100.0,30,5,18,36.09827838340866,0.6118055555555555,47.244623655913976,1011.0215053763438,33.70071684587813,0
220,4,2,0,36,0.05555555555555555,0.0,1.0,36,1000,700,300,0.7,13,7,6,423.5302308337915,0.44260912698412697,0.2039195076623106,0.22951185020071857,128285.19483024674,3667.624608978537,131952.81943922528,218,0,97.77777777777777,29,7,20,36.00961977881365,0.6199712643678161,46.7361111111111,1013.0555555555541,34.93295019157083,0
221,4,0,1,35,0.0,0.027777777777777776,0.9722222222222222,36,750,700,50,0.9333333333333333,8,7,1,421.4675660655589,0.442526455026455,0.20023227476962902,0.22859523378797406,128320.37278163579,3616.5750385802426,131936.94782021604,219,1,98.77777777777777,29,7,20,36.02567397761023,0.6203304597701149,46.701388888888886,1013.1944444444443,34.93773946360153,0
222,4,1,1,35,0.027777777777777776,0.027777777777777776,0.9722222222222222,36,1100,700,400,0.6363636363636364,15,7,8,397.5384615384616,0.4427744708994709,0.1082905982905984,0.2189830508474575,128936.7675781249,3051.4648437499854,131988.23242187488,220,0,99.47222222222223,31,5,19,35.99999999999999,0.6209677419354839,46.09374999999999,1015.6249999999992,32.76209677419352,8
223,4,0,1,34,0.0,0.02857142857142857,0.9714285714285714,35,950,600,350,0.631578947368421,13,6,7,400.0089740291696,0.43893557422969187,0.14067117042895605,0.22089667546706354,129035.96878051746,3323.1090969509396,132359.0778774684,221,1,103.25714285714285,31,4,19,35.83570955615362,0.6219758064516129,45.99609374999999,1016.0156249999991,32.77469758064513,0
224,4,0,0,34,0.0,0.0,1.0,34,1100,900,200,0.8181818181818182,13,9,4,401.8771455797902,0.4371472073677956,0.15609004776203017,0.22247400987367283,129133.07354896507,3579.126199560625,132712.1997485257,222,2,106.82352941176471,30,4,19,35.68886097152428,0.6256944444444444,45.90053763440859,1016.3978494623644,33.87992831541215,0
225,4,0,0,34,0.0,0.0,1.0,34,1250,900,350,0.72,16,9,7,402.07023824473265,0.43605169340463457,0.14326790246409882,0.2237661417100627,129342.6311728396,3600.982571845182,132943.6137446848,223,3,107.82352941176471,29,5,21,35.469574913526294,0.6307471264367817,45.69444444444445,1017.222222222223,35.076628352490445,0
226,4,0,1,33,0.0,0.029411764705882353,0.9705882352941176,34,1150,900,250,0.782608695652174,14,9,5,400.7557325440007,0.4356617647058823,0.14274879006043695,0.22403804453203535,129519.29253472236,3581.1197916666865,133100.41232638905,224,4,108.82352941176471,29,5,17,35.32243484786466,0.6325431034482758,45.52083333333334,1017.9166666666678,35.10057471264371,0
227,4,1,0,34,0.029411764705882353,0.0,1.0,34,800,600,200,0.75,10,6,4,393.7218332603253,0.43701723113487817,0.13463696105145018,0.22230140431775314,129908.37191358043,3429.552469135825,133337.92438271624,225,0,106.05882352941177,29,5,18,35.10445049954585,0.6364942528735632,45.1388888888889,1019.4444444444459,35.1532567049809,0
228,4,1,2,33,0.02857142857142857,0.05714285714285714,0.9428571428571428,35,1050,700,350,0.6666666666666666,14,7,7,384.3083639685588,0.4375700280112045,0.13765721053522095,0.21974110291926863,130399.83171826231,3022.749197884162,133422.5809161465,226,0,104.0,30,5,19,34.84422292406895,0.6385416666666667,44.657258064516135,1021.3709677419362,34.045698924731205,0
229,4,1,0,34,0.029411764705882353,0.0,1.0,34,650,500,150,0.7692307692307693,8,5,3,394.00060710028265,0.4310940285204991,0.15679739451215124,0.2246934416442341,130298.0348186728,3467.5009645061705,133765.53578317896,227,0,107.61764705882354,29,5,20,34.70035255974244,0.6404454022988506,44.75694444444444,1020.972222222222,35.205938697318,0
230,4,0,0,34,0.0,0.0,1.0,34,800,400,400,0.5,12,4,8,395.29407142955836,0.4309640522875817,0.1601867185062522,0.2258428366139504,130368.9453125,3506.814236111111,133875.75954861112,228,1,108.61764705882354,29,5,20,34.59514823881409,0.6411637931034483,44.6875,1021.25,35.21551724137931,0
231,4,0,0,34,0.0,0.0,1.0,34,1000,600,400,0.6,14,6,8,394.25889710228205,0.4307598039215686,0.16224063734822214,0.22545722622785233,130404.4077932098,3482.6195987654196,133887.02739197522,229,2,109.61764705882354,29,5,20,34.58548635663131,0.6415229885057472,44.65277777777777,1021.3888888888882,35.22030651340994,0
232,4,0,1,33,0.0,0.029411764705882353,0.9705882352941176,34,1100,900,200,0.8181818181818182,13,9,4,394.99621759549893,0.4303884432560903,0.15893865020865627,0.22670687746237764,130546.305941358,3513.0594135802407,134059.36535493826,230,3,110.61764705882354,29,5,19,34.422284135181656,0.6429597701149425,44.513888888888886,1021.9444444444442,35.23946360153256,0
233,4,0,0,33,0.0,0.0,1.0,33,1200,800,400,0.6666666666666666,16,8,8,403.6983073966149,0.42720170454545453,0.1760064082898729,0.23154051308102605,130519.38829435846,3938.0912273748027,134457.47952173327,231,4,114.54545454545455,28,5,19,34.22736220472441,0.6458333333333333,44.540229885057464,1021.8390804597693,36.49425287356319,0
234,4,0,0,33,0.0,0.0,1.0,33,550,300,250,0.5454545454545454,8,3,5,402.84816795981465,0.42700441919191917,0.1782481073919293,0.23127191434206273,130556.09486474413,3918.8567264499657,134474.95159119408,232,5,115.54545454545455,28,5,19,34.21171329490605,0.6462053571428572,44.50431034482757,1021.9827586206877,36.49938423645313,0
235,4,0,0,33,0.0,0.0,1.0,33,800,400,400,0.5,12,4,8,402.41050375396316,0.4254261363636364,0.1864841162396662,0.23211977031772346,130739.70512947536,3922.2061203593476,134661.9112498347,233,6,116.54545454545455,28,5,20,34.0360705254285,0.6480654761904762,44.324712643678154,1022.7011494252863,36.525041050903084,0
236,4,0,0,33,0.0,0.0,1.0,33,1150,1000,150,0.8695652173913043,13,10,3,405.95996079402755,0.4244791666666667,0.18408176116684993,0.23506071876220028,130886.68623662302,4026.95080261593,134913.63703923894,234,7,117.54545454545455,28,5,20,33.79580876158382,0.6495535714285714,44.18103448275862,1023.2758620689651,36.54556650246304,0
237,4,0,0,33,0.0,0.0,1.0,33,1200,900,300,0.75,15,9,6,405.0136288088645,0.42384785353535354,0.1821584263689533,0.23518517565306926,130996.97625594531,4011.112143281813,135008.08839922713,235,8,118.54545454545455,28,5,20,33.70789473684212,0.6506696428571428,44.07327586206897,1023.7068965517242,36.560960591133004,0
238,4,0,0,33,0.0,0.0,1.0,33,1300,1100,200,0.8461538461538461,15,11,4,405.66857626828386,0.4234927398989899,0.18414852992456088,0.23579072385707905,131033.74991742623,4031.254954419324,135065.00487184557,236,9,119.54545454545455,28,5,20,33.65375619796051,0.6510416666666667,44.03735632183907,1023.8505747126428,36.56609195402296,0
239,4,0,0,33,0.0,0.0,1.0,33,850,600,250,0.7058823529411765,11,6,5,404.6556246687486,0.4234532828282828,0.17997287311164123,0.23542699077666687,131070.52873976078,4007.685336570204,135078.21407633097,237,10,120.54545454545455,28,5,20,33.64231093026517,0.6514136904761905,44.001436781609186,1023.9942528735625,36.57122331691294,0
240,4,0,0,33,0.0,0.0,1.0,33,950,900,50,0.9473684210526315,10,9,1,405.0927894283257,0.4233743686868687,0.18169491525423798,0.23617069739398402,131150.2338927467,4025.6028163580045,135175.8367091047,238,11,121.54545454545455,29,4,20,33.55014124293787,0.649066091954023,43.9236111111111,1024.3055555555538,35.32088122605358,0
241,4,0,1,32,0.0,0.030303030303030304,0.9696969696969697,33,600,300,300,0.5,9,3,6,405.1627661522083,0.42357165404040403,0.17725855546107727,0.23664970118011394,131221.37586805547,4033.2031249999964,135254.57899305547,239,12,122.54545454545455,29,4,20,33.47609122949709,0.6497844827586207,43.854166666666664,1024.5833333333328,35.33045977011493,0
242,4,0,0,32,0.0,0.0,1.0,32,850,400,450,0.47058823529411764,13,4,9,410.4825431920515,0.42456317204301075,0.16540147265077132,0.23950413526672054,131180.89617188528,4369.493575769575,135550.38974765484,240,13,121.8125,28,4,20,33.38096072931276,0.6525297619047619,43.893678160919535,1024.4252873563214,36.586617405582906,0
243,4,1,0,33,0.030303030303030304,0.0,1.0,33,950,800,150,0.8421052631578947,11,8,3,400.62400972441577,0.4266887626262626,0.1519828668488299,0.2359656248663902,131541.75347222213,3939.7569444444407,135481.51041666657,241,0,119.0909090909091,29,4,21,33.2673300839426,0.6530172413793103,43.541666666666664,1025.8333333333328,35.373563218390785,0
244,4,0,1,32,0.0,0.030303030303030304,0.9696969696969697,33,750,600,150,0.8,9,6,3,401.06896506566,0.42566287878787884,0.1597118077872206,0.23747013605980702,131741.75663371483,3967.505997803209,135709.26263151804,242,1,120.0909090909091,30,3,20,33.053209828052715,0.6520833333333333,43.346774193548384,1026.6129032258061,34.22043010752687,0
245,4,0,0,32,0.0,0.0,1.0,32,950,600,350,0.631578947368421,13,6,7,410.63830827170943,0.42328209005376344,0.16746296171018793,0.24299661620786292,131719.909818673,4417.8481867284145,136137.75800540144,243,16,124.8125,29,3,20,32.82976480404095,0.6548132183908046,43.368055555555564,1026.527777777779,35.3975095785441,0
246,4,0,0,32,0.0,0.0,1.0,32,1000,600,400,0.6,14,6,8,407.6955675604506,0.42275705645161293,0.16436359026369152,0.24216134314132806,131862.52170138896,4351.953125000011,136214.47482638896,244,17,125.8125,29,3,21,32.76073360378634,0.65625,43.22916666666667,1027.083333333334,35.416666666666686,0
247,4,0,0,32,0.0,0.0,1.0,32,1000,600,400,0.6,14,6,8,408.9481373265156,0.4225050403225807,0.16233108108108096,0.2440496948561465,132040.89506172843,4399.575617283956,136440.4706790124,245,18,126.8125,29,3,22,32.54786036036037,0.6580459770114943,43.05555555555556,1027.777777777778,35.44061302681993,0
248,4,0,0,32,0.0,0.0,1.0,32,700,500,200,0.7142857142857143,9,5,4,403.6772788428352,0.42164398521505375,0.15270509790681985,0.24204293520900377,132219.38898533958,4274.792631172852,136494.18161651245,246,19,127.8125,29,3,23,32.50267274364168,0.6598419540229885,42.88194444444445,1028.4722222222229,35.4645593869732,0
249,4,0,0,32,0.0,0.0,1.0,32,800,600,200,0.75,10,6,4,405.67570112153345,0.42145497311827956,0.1537689035916825,0.2434711703813677,132255.1022376544,4330.536265432113,136585.63850308652,247,20,128.8125,29,3,23,32.415158880187235,0.6602011494252873,42.84722222222223,1028.6111111111118,35.469348659003856,0
250,4,0,0,32,0.0,0.0,1.0,32,1150,800,350,0.6956521739130435,15,8,7,404.69438935239066,0.4210559475806452,0.15549089068825928,0.24380369309765992,132398.00347222234,4316.145833333353,136714.14930555568,248,21,129.8125,29,3,23,32.29588394062079,0.6616379310344828,42.70833333333334,1029.1666666666677,35.48850574712647,0
251,4,0,1,31,0.0,0.03125,0.96875,32,750,400,350,0.5333333333333333,11,4,7,404.66693313707776,0.4210769489247312,0.15908362569154,0.24401844112928264,132433.74083719138,4318.311149691363,136752.05198688275,249,22,130.8125,29,3,23,32.260463050420555,0.6619971264367817,42.673611111111114,1029.3055555555557,35.49329501915709,0
252,4,1,1,31,0.03125,0.03125,0.96875,32,1200,900,300,0.75,15,9,6,398.35514127331265,0.42227402553763443,0.13805592991913795,0.24227829083999836,132755.5941358025,4176.77469135803,136932.36882716054,250,0,125.96875,29,3,19,32.09793351302786,0.6652298850574713,42.361111111111114,1030.5555555555557,35.53639846743295,0
253,4,0,0,31,0.0,0.0,1.0,31,1000,700,300,0.7,13,7,6,412.4130257601311,0.4181003584229391,0.1501867098573808,0.2501693227326682,132656.9002675386,4741.886725459103,137398.7869929977,251,24,131.03225806451613,28,3,21,31.83548349604835,0.6674107142857143,42.456896551724135,1030.172413793103,36.79187192118225,0
254,4,0,0,31,0.0,0.0,1.0,31,900,500,400,0.5555555555555556,13,5,8,413.94712473276365,0.4175627240143369,0.1529064642066822,0.25159565920198124,132730.9172281674,4788.716309948459,137519.63353811586,252,25,132.03225806451613,28,3,21,31.72116099646775,0.6681547619047619,42.38505747126436,1030.4597701149416,36.8021346469622,0
255,4,0,0,31,0.0,0.0,1.0,31,650,400,250,0.6153846153846154,9,4,5,414.8506355546384,0.41706989247311826,0.15268067888052173,0.25289322940565245,132841.9813755119,4821.916080393705,137663.89745590562,253,26,133.03225806451613,28,3,21,31.585656213704997,0.6692708333333333,42.27729885057471,1030.8908045977007,36.817528735632166,0
256,4,0,0,31,0.0,0.0,1.0,31,800,700,100,0.875,9,7,2,419.8771986410321,0.41706989247311826,0.1255540881572239,0.25080800219066,132076.58420138882,4891.1892361111,136967.7734374999,254,27,134.03225806451613,29,2,19,32.23086407242265,0.6584051724137931,43.02083333333333,1027.916666666666,35.44540229885055,8
257,4,0,0,31,0.0,0.0,1.0,31,550,200,350,0.36363636363636365,9,2,7,419.6780956072348,0.4168010752688172,0.13053992932246317,0.2511622426661567,132147.9769483024,4891.922260802461,137039.8992091049,255,28,135.03225806451613,29,2,19,32.163621729929304,0.6591235632183908,42.951388888888886,1028.1944444444441,35.454980842911866,0
258,4,0,0,31,0.0,0.0,1.0,31,900,600,300,0.6666666666666666,12,6,6,420.393772660503,0.41626344086021505,0.09962885083650641,0.2460020339779422,131292.53713348764,4839.149305555554,136131.6864390432,256,29,136.03225806451613,29,2,21,33.013591498396345,0.6505028735632183,43.78472222222222,1024.861111111111,35.34003831417625,8
259,4,0,0,31,0.0,0.0,1.0,31,800,500,300,0.625,11,5,6,421.4111356963786,0.414426523297491,0.10115038914074592,0.24820914260394353,131541.75347222216,4886.631944444441,136428.3854166666,257,30,137.03225806451613,29,2,21,32.73422691578663,0.6530172413793103,43.541666666666664,1025.833333333333,35.37356321839079,0
260,4,0,0,31,0.0,0.0,1.0,31,1300,1100,200,0.8461538461538461,15,11,4,423.6240686587768,0.41321684587813623,0.10834169976864971,0.2504465493910691,131684.2689043211,4956.925154321003,136641.1940586421,258,31,138.03225806451613,29,2,17,32.53270184934597,0.6544540229885057,43.402777777777786,1026.3888888888898,35.39272030651344,0
261,4,0,0,31,0.0,0.0,1.0,31,850,400,450,0.47058823529411764,13,4,9,423.3458339957779,0.4127240143369176,0.11159876796356238,0.25122143632141103,131826.86149691354,4961.670524691352,136788.5320216049,259,32,139.03225806451613,29,2,18,32.39507258137228,0.6558908045977012,43.263888888888886,1026.9444444444441,35.411877394636,0
262,4,0,2,29,0.0,0.06451612903225806,0.935483870967742,31,850,400,450,0.47058823529411764,13,4,9,423.4296286458222,0.41245519713261647,0.11299262560671952,0.25197980394956915,131933.85657793196,4972.94077932097,136906.79735725294,260,33,140.03225806451613,29,2,18,32.284343878148796,0.6569683908045977,43.159722222222214,1027.3611111111102,35.426245210727934,0
263,4,0,0,29,0.0,0.0,1.0,29,800,400,400,0.5,12,4,8,463.1941439396081,0.4079433497536946,0.14947734313997119,0.2600954811539473,129693.54815493904,6214.658402423466,135908.20655736252,261,34,141.68965517241378,27,2,17,33.55444971999026,0.6408179012345678,45.34970238095238,1018.6011904761904,37.72597001763668,8
264,4,1,1,29,0.03333333333333333,0.03333333333333333,0.9666666666666667,30,650,400,250,0.6153846153846154,9,4,5,451.5880399387734,0.41065613026819925,0.15750492818924222,0.2565742607716137,130152.60643744231,5755.072086801445,135907.67852424376,262,0,137.93333333333334,28,2,18,33.379388435182584,0.6421130952380952,44.89942528735633,1020.4022988505757,36.442939244663414,0
265,4,0,0,29,0.0,0.0,1.0,29,700,400,300,0.5714285714285714,10,4,6,454.3843655588547,0.40866174055829224,0.13732766162850374,0.2583887213103337,130186.64301658155,6030.955038265296,136217.59805484687,263,1,136.58620689655172,27,2,18,33.27318460192476,0.6458333333333333,44.86607142857142,1020.5357142857137,37.79761904761902,0
266,4,0,0,29,0.0,0.0,1.0,29,600,300,300,0.5,9,3,6,454.85363532675694,0.40907224958949095,0.1365032602520726,0.2589079738345416,130224.61214303433,6046.627648455224,136271.23979148956,264,2,137.58620689655172,27,2,18,33.222317393206,0.6462191358024691,44.82886904761905,1020.6845238095241,37.803130511463856,0
267,4,0,0,29,0.0,0.0,1.0,29,600,500,100,0.8333333333333334,7,5,2,455.4464817012799,0.40876436781609193,0.09617801469228215,0.2418956441526666,127477.432966821,5811.829668209877,133289.26263503087,265,3,138.58620689655172,29,0,16,36.03627997065969,0.6117097701149425,47.53472222222222,1009.8611111111112,34.822796934865906,8
268,4,0,0,29,0.0,0.0,1.0,29,950,700,250,0.7368421052631579,12,7,5,454.5960380611142,0.4079946633825944,0.09467713580340509,0.24270692362221066,127687.90750385817,5809.2833719136015,133497.19087577178,266,4,139.58620689655172,29,0,18,35.8399466355183,0.6138649425287357,47.3263888888889,1010.6944444444457,34.85153256704985,0
269,4,0,0,29,0.0,0.0,1.0,29,900,700,200,0.7777777777777778,11,7,4,451.5016191445989,0.40743021346469627,0.0949353596316278,0.24147540674162674,127758.10426311748,5736.598186728421,133494.7024498459,267,5,140.58620689655172,29,0,18,35.84555456335578,0.6145833333333333,47.25694444444446,1010.9722222222238,34.861111111111164,0
270,4,1,0,30,0.03333333333333333,0.0,1.0,30,800,500,300,0.625,11,5,6,439.1268268725972,0.4128591954022989,0.09725651577503425,0.2371284865112027,128144.53125000019,5254.340277777808,133398.87152777798,268,0,136.86666666666667,30,0,19,35.75960219478739,0.615625,46.875000000000014,1012.5000000000015,33.75000000000005,0
271,4,0,0,30,0.0,0.0,1.0,30,1000,800,200,0.8,12,8,4,439.0595347568751,0.4126436781609195,0.09543524416135885,0.23769774812699815,128246.61810613963,5261.58009596488,133508.1982021045,269,1,137.86666666666667,30,0,19,35.656073071479135,0.6166666666666667,46.77419354838711,1012.9032258064532,33.763440860215105,0
272,4,0,0,30,0.0,0.0,1.0,30,1100,800,300,0.7272727272727273,14,8,6,416.70922162017337,0.4125478927203065,0.0002767362970894638,0.21314962103146934,125942.63065094214,4496.291117470204,130438.92176841234,270,2,138.86666666666667,30,0,17,38.602202731655055,0.5930555555555556,49.059139784946225,1003.7634408602138,33.45878136200712,8
273,4,3,1,32,0.09090909090909091,0.030303030303030304,0.9696969696969697,33,900,700,200,0.7777777777777778,11,7,4,388.12742046696553,0.42601799242424243,0.009023454346407611,0.2031060167828719,126875.85791822827,3248.799890667012,130124.65780889528,271,0,127.15151515151516,33,0,18,38.35540587114299,0.5950126262626263,48.13112745098037,1007.4754901960761,30.529560308972002,0
274,4,0,0,32,0.0,0.0,1.0,32,800,300,500,0.375,13,3,10,397.51331704931124,0.4204049059139785,0.01576992980696912,0.2078218377076933,126837.51179726534,3683.920008162397,130521.43180542774,272,1,132.125,32,0,18,38.15858193365086,0.5970052083333333,48.1691919191919,1007.3232323232304,31.47885101010095,0
275,4,0,0,32,0.0,0.0,1.0,32,1000,700,300,0.7,13,7,6,395.20611428332154,0.4191028225806452,0.01808757203708322,0.20726249699142374,126964.73095857547,3635.447594633174,130600.17855320865,273,2,133.125,32,0,20,38.08543180489432,0.5983072916666667,48.04292929292928,1007.8282828282813,31.49463383838379,0
276,4,5,1,36,0.13513513513513514,0.02702702702702703,0.972972972972973,37,950,800,150,0.8421052631578947,11,8,3,349.2256472435282,0.43327702702702703,0.028823889002093317,0.18941272093989084,128320.3727816355,1568.0730521757616,129888.44583381126,274,0,116.0,35,2,20,37.85555174777244,0.6053571428571429,46.70138888888887,1013.1944444444418,28.948412698412625,0
277,4,3,4,35,0.07692307692307693,0.10256410256410256,0.8974358974358975,39,1200,800,400,0.6666666666666666,16,8,8,333.65269313717636,0.4364035087719298,0.05077277357070109,0.18398562792992837,128978.53185595541,806.8069021237031,129785.33875807912,275,0,110.97435897435898,37,2,18,37.57960924006908,0.6081081081081081,46.052631578947356,1015.7894736842084,27.453769559032658,0
278,4,0,1,34,0.0,0.02857142857142857,0.9714285714285714,35,650,400,250,0.6153846153846154,9,4,5,362.58607102323737,0.4286414565826331,0.04837929366231242,0.19671008105118906,128330.72015570907,2306.186322568207,130636.90647827728,276,1,124.57142857142857,33,2,20,37.50655136268341,0.6098484848484849,46.69117647058822,1013.2352941176449,30.704099821746816,0
279,4,0,1,33,0.0,0.029411764705882353,0.9705882352941176,34,1000,900,100,0.9,11,9,2,362.56496290883496,0.42567216280451575,0.06162656915263964,0.1970419063824792,128400.34060618811,2510.69294587287,130911.03355206098,277,2,128.8235294117647,32,2,19,37.435893442963355,0.6129557291666667,46.62247474747475,1013.5101010101007,31.672190656565647,0
280,4,0,0,33,0.0,0.0,1.0,33,950,700,250,0.7368421052631579,12,7,5,371.03542830102396,0.42514993686868685,0.05506244355165224,0.20168573840050066,128408.33875868049,2928.80859374999,131337.14735243047,278,3,125.54545454545455,31,2,20,37.213086673518326,0.6155913978494624,46.61458333333333,1013.5416666666661,32.69489247311826,0
281,4,0,0,33,0.0,0.0,1.0,33,650,400,250,0.6153846153846154,9,4,5,368.4795612538503,0.42479482323232326,0.057050152312702274,0.20112735126883238,128573.35620456257,2875.3307766384364,131448.686981201,279,4,126.54545454545455,31,2,20,37.10909081182865,0.617271505376344,46.45182291666666,1014.1927083333321,32.71589381720426,0
282,4,1,0,34,0.029411764705882353,0.0,1.0,34,950,700,250,0.7368421052631579,12,7,5,359.1304942516528,0.426043523469994,0.06290356914780415,0.19821516626805594,129014.56921616681,2466.6132016532074,131481.18241782003,280,0,123.79411764705883,33,1,21,36.89585846401287,0.6167929292929293,46.0171568627451,1015.9313725490192,30.785799168152096,0
283,4,1,0,35,0.02857142857142857,0.0,1.0,35,950,500,450,0.5263157894736842,14,5,9,354.3208249967735,0.4281512605042017,0.06624799986235597,0.19757728743775754,129419.51600646383,2171.3411007785435,131590.85710724237,281,0,121.22857142857143,33,2,22,36.60561945481552,0.6208964646464646,45.618872549019606,1017.5245098039214,30.834076054664287,0
284,4,1,0,36,0.027777777777777776,0.0,1.0,36,600,300,300,0.5,9,3,6,362.4076072020744,0.43215939153439153,0.11749355839511999,0.18814920737542612,126552.40929705236,1972.711167800476,128525.12046485284,282,0,118.83333333333333,34,2,18,39.33610388073829,0.5894607843137255,48.45238095238096,1006.1904761904779,29.593837535014053,8
285,4,1,0,37,0.02702702702702703,0.0,1.0,37,700,300,400,0.42857142857142855,11,3,8,354.80720170800726,0.4335272772772773,0.11783001561340778,0.1859907468556063,126946.17419249407,1608.2833665552182,128554.45755904929,283,0,116.5945945945946,35,2,19,39.12237758891313,0.5913690476190476,48.061342592592595,1007.7546296296302,28.792989417989435,0
286,4,1,0,38,0.02631578947368421,0.0,1.0,38,1200,700,500,0.5833333333333334,17,7,10,347.8913701201689,0.43542555713608344,0.11236907297144594,0.18397224856573113,127302.17013888879,1257.632726766108,128559.8028656549,284,0,114.5,34,4,20,38.93132397467659,0.5971200980392157,47.70833333333333,1009.1666666666658,29.681372549019585,0
287,4,2,2,38,0.05,0.05,0.95,40,1050,700,350,0.6666666666666666,14,7,7,332.5933403108121,0.4400507478632478,0.11726614699331872,0.17820335298276205,127831.16731596457,503.15898668938814,128334.32630265396,285,0,109.725,36,4,18,38.776215664439505,0.5983796296296297,47.18468468468468,1011.2612612612609,28.09059059059058,0
288,4,1,0,39,0.02564102564102564,0.0,1.0,39,1050,700,350,0.6666666666666666,14,7,7,339.39310463830884,0.44025528565002253,0.12195701745890575,0.18180733017933193,127822.46823827582,876.4128675840074,128698.88110585982,286,0,111.2051282051282,35,4,19,38.613201518446445,0.600297619047619,47.19328703703703,1011.2268518518513,28.89219576719575,0
289,4,1,2,38,0.025,0.05,0.95,40,1300,800,500,0.6153846153846154,18,8,10,329.9431683527475,0.44043803418803423,0.1267009449694274,0.1786778325907864,128258.57688347128,463.6082450693884,128722.18512854067,287,0,109.4,36,4,20,38.406985362238274,0.6027199074074074,46.762387387387385,1012.9504504504501,28.137512512512505,0
290,4,4,2,40,0.09523809523809523,0.047619047619047616,0.9523809523809523,42,800,400,400,0.5,12,4,8,312.0383219773309,0.44581155632984903,0.13162245434733633,0.17173852057872202,128902.8613873365,-355.47348692381286,128547.38790041268,288,0,103.52380952380952,38,4,18,38.205330527792384,0.6055372807017544,46.12713675213675,1015.4914529914525,26.72345928924875,0
291,4,0,1,39,0.0,0.025,0.975,40,1550,1200,350,0.7741935483870968,19,12,7,326.8351069537386,0.44065170940170945,0.13672085988981308,0.17934277327034692,128783.6897530969,418.2062028700876,129201.89595596699,289,1,109.7,37,3,18,37.95089751899462,0.6061373873873874,46.24451754385964,1015.0219298245597,27.433025130393506,0
292,4,2,1,40,0.04878048780487805,0.024390243902439025,0.975609756097561,41,1250,800,450,0.64,17,8,9,331.02744057332245,0.443114837398374,0.1695514918291765,0.18448069796275404,129396.54659366321,367.43781740533086,129763.98441106854,290,0,107.90243902439025,37,4,20,37.221481301864436,0.6123310810810811,45.64144736842104,1017.434210526314,27.498221906116594,0
293,4,0,0,40,0.0,0.0,1.0,40,1000,700,300,0.7,13,7,6,337.47549230910704,0.4396233974358974,0.16501549701129026,0.1879626139038521,129373.18019032579,732.0555352650277,130105.23572559081,291,1,111.475,36,4,20,37.081211718692344,0.6140046296296297,45.66441441441443,1017.342342342345,28.259509509509584,0
294,4,0,1,39,0.0,0.025,0.975,40,700,400,300,0.5714285714285714,10,4,6,335.45567863806195,0.43975694444444446,0.16339641434262941,0.18710972297367473,129430.4693206722,683.6371844818018,130114.106505154,292,2,112.475,36,4,16,37.074387634646605,0.6145833333333333,45.60810810810812,1017.5675675675691,28.265765765765806,0
295,4,1,0,40,0.025,0.0,1.0,40,650,300,350,0.46153846153846156,10,3,7,332.7633490519739,0.44045138888888885,0.16518360800796383,0.18628566184389472,129573.7476285409,623.4788420177204,130197.22647055863,293,0,112.85,36,4,17,36.99742838181618,0.6160300925925926,45.467342342342356,1018.1306306306324,28.281406406406454,0
296,4,0,1,39,0.0,0.025,0.975,40,1450,1300,150,0.896551724137931,16,13,3,335.4664549618469,0.4399172008547008,0.17299336650082964,0.1883484844897524,129688.42734203827,701.2233940021472,130389.65073604042,294,1,113.85,36,4,18,36.81223512069286,0.6171875,45.35472972972975,1018.5810810810833,28.29391891891898,0
297,4,0,0,39,0.0,0.0,1.0,39,1000,600,400,0.6,14,6,8,343.4985260418621,0.43831533963112906,0.17173959263511507,0.19285811098998432,129688.4273420382,1109.556727335466,130797.98406937366,295,2,117.41025641025641,36,3,18,36.607702229592775,0.6171875,45.35472972972974,1018.5810810810827,28.293918918918965,0
298,4,2,3,38,0.04878048780487805,0.07317073170731707,0.926829268292683,41,900,400,500,0.4444444444444444,14,4,10,377.7990530612245,0.44143800813008127,0.16421463414634152,0.20431036553063747,128203.13169795947,1616.0681698809608,129819.19986784043,296,0,112.63414634146342,35,6,17,37.25190476190476,0.6041666666666667,46.817129629629626,1012.731481481481,28.93518518518517,8
299,4,1,0,39,0.02564102564102564,0.0,1.0,39,1200,700,500,0.5833333333333334,17,7,10,380.2259317509918,0.4392150247413405,0.19777637168941542,0.20609698593636566,128295.24518140598,1956.2358276644104,130251.48100907038,297,0,118.6923076923077,34,5,18,37.096063454759104,0.6072303921568627,46.72619047619048,1013.0952380952388,29.796918767507023,0
300,4,0,0,39,0.0,0.0,1.0,39,850,400,450,0.47058823529411764,13,4,9,381.7000774771747,0.43856837606837606,0.2003402743273559,0.20767898784141497,128446.04768990938,2005.5732709750637,130451.62096088444,298,1,119.6923076923077,34,5,15,36.90423761988647,0.6087622549019608,46.577380952380956,1013.6904761904768,29.81442577030814,0
301,4,0,0,39,0.0,0.0,1.0,39,1350,1000,350,0.7407407407407407,17,10,7,385.62261676475117,0.43882141250562307,0.2031118333935238,0.21060927530997953,128596.93877551024,2117.977607709755,130714.91638321998,299,2,120.6923076923077,34,5,16,36.650283646322386,0.6102941176470589,46.42857142857143,1014.2857142857146,29.83193277310925,0
302,4,0,0,39,0.0,0.0,1.0,39,1400,900,500,0.6428571428571429,19,9,10,379.16084297952614,0.438540260908682,0.20150279215273526,0.2080876466164233,128789.87295310354,1966.4153592249613,130756.2883123285,300,3,121.6923076923077,35,4,17,36.61678069175219,0.6101190476190477,46.238425925925924,1015.0462962962961,29.001322751322746,0
303,4,0,0,39,0.0,0.0,1.0,39,1000,700,300,0.7,13,7,6,375.87222417560974,0.43794984255510566,0.2004056273488688,0.20689478638122955,128907.38195516115,1890.5408736282543,130797.92282878941,301,4,122.6923076923077,35,4,17,36.58014208646759,0.6113095238095239,46.12268518518518,1015.509259259259,29.01455026455026,0
304,4,0,0,39,0.0,0.0,1.0,39,500,400,100,0.8,6,4,2,371.9849195078315,0.43733130904183537,0.2012247855456608,0.20505902346738253,128966.15655006861,1794.6930727023353,130760.84962277094,302,5,123.6923076923077,35,4,17,36.61880887268307,0.611904761904762,46.06481481481482,1015.7407407407409,29.021164021164026,0
305,4,1,0,40,0.025,0.0,1.0,40,1400,1100,300,0.7857142857142857,17,11,6,365.7845763876271,0.43956997863247865,0.20455929575905207,0.20328618519117908,129287.27027280662,1458.2578778102466,130745.52815061687,303,0,121.575,36,4,18,36.448759827261654,0.6131365740740741,45.748873873873876,1017.0045045045048,28.250125125125134,0
306,4,0,0,40,0.0,0.0,1.0,40,950,800,150,0.8421052631578947,11,8,3,365.99172809834715,0.43982371794871794,0.20174341377020144,0.2038452078693262,129373.18019032561,1469.9027574872348,130843.08294781284,304,1,122.575,36,4,19,36.355942365877056,0.6140046296296297,45.66441441441442,1017.3423423423435,28.25950950950954,0
307,4,1,0,41,0.024390243902439025,0.0,1.0,41,1050,900,150,0.8571428571428571,12,9,3,363.6342417171014,0.441260162601626,0.20494211616677527,0.2040965843691934,129675.59880203506,1230.897607917802,130906.49640995286,305,0,120.5609756097561,37,4,16,36.108008576452434,0.6151463963963963,45.3673245614035,1018.5307017543846,27.527856804172558,0
308,4,0,0,41,0.0,0.0,1.0,41,900,600,300,0.6666666666666666,12,6,6,362.5361218797178,0.44085365853658537,0.20449897750511248,0.20377030298756543,129731.44531249988,1206.4670138888737,130937.91232638876,306,1,121.5609756097561,37,4,16,36.079158145875915,0.6157094594594594,45.31249999999999,1018.7499999999991,27.533783783783758,0
309,4,0,0,41,0.0,0.0,1.0,41,1550,1100,450,0.7096774193548387,20,11,9,376.09628819122935,0.4407520325203252,0.18028641754307428,0.19900240491671853,127325.53155006861,1536.8371699245508,128862.36871999316,307,2,122.5609756097561,35,6,16,38.19571865443424,0.5952380952380952,47.68518518518518,1009.2592592592595,28.835978835978842,8
310,4,0,0,41,0.0,0.0,1.0,41,1500,1000,500,0.6666666666666666,20,10,10,374.41470953671876,0.4404725609756098,0.18496569272424757,0.19948033099545387,127603.50722343972,1355.326018586161,128958.83324202588,308,3,123.5609756097561,36,5,16,37.95256538861644,0.5960648148148149,47.40990990990991,1010.3603603603609,28.06556556556558,0
311,4,1,0,42,0.023809523809523808,0.0,1.0,42,1500,1100,400,0.7333333333333333,19,11,8,369.7797007944638,0.44192799070847855,0.18134924935618524,0.19871620845838786,127950.32035097342,1062.6862351877505,129013.00658616117,309,0,121.5952380952381,37,5,18,37.713932842021606,0.5976914414414414,47.06688596491228,1011.7324561403511,27.344120436225705,0
312,4,2,1,43,0.045454545454545456,0.022727272727272728,0.9772727272727273,44,1100,800,300,0.7272727272727273,14,8,6,354.5695260931745,0.44581351303735023,0.18581789130750548,0.19344571529442062,128555.01570001712,316.92732230761817,128871.94302232473,310,0,117.02272727272727,35,9,15,37.48050292931598,0.6077380952380953,46.469907407407405,1014.1203703703701,28.974867724867718,0
313,4,1,2,42,0.022727272727272728,0.045454545454545456,0.9545454545454546,44,900,500,400,0.5555555555555556,13,5,8,355.65024378386113,0.44513081395348836,0.1945210807446971,0.19446502724675885,128643.0620525764,350.3872760202396,128993.44932859663,311,0,118.0,35,9,16,37.36321068644227,0.6086309523809523,46.383101851851855,1014.4675925925933,28.98478835978838,0
314,4,1,1,42,0.023255813953488372,0.023255813953488372,0.9767441860465116,43,1250,700,550,0.56,18,7,11,361.19776705261,0.4425987449243263,0.21137021601501527,0.19852298324470546,128848.62075617304,707.9668209876725,129556.58757716071,312,0,121.0,35,8,17,37.012653898768804,0.6107142857142858,46.180555555555564,1015.2777777777794,29.007936507936556,0
315,4,0,0,42,0.0,0.0,1.0,42,1300,1000,300,0.7692307692307693,16,10,6,364.8898605725257,0.4420489740611692,0.20657532563969405,0.2006541341600952,128868.76594387778,1004.5812074830196,129873.3471513608,313,1,123.9047619047619,34,8,17,36.898376128502754,0.6130514705882353,46.1607142857143,1015.3571428571447,29.863445378151315,0
316,4,0,0,42,0.0,0.0,1.0,42,950,600,350,0.631578947368421,13,6,7,365.61524831405376,0.4420489740611692,0.2091683268877691,0.20166741524653037,128989.67013888908,1032.1180555555788,130021.78819444466,314,2,124.9047619047619,34,8,17,36.75656275635766,0.6142769607843137,46.04166666666668,1015.833333333335,29.877450980392204,0
317,4,1,1,42,0.023255813953488372,0.023255813953488372,0.9767441860465116,43,1100,600,500,0.5454545454545454,16,6,10,356.0984578596565,0.44183739387227755,0.20602283397063403,0.19823200797464283,129352.72285997747,612.634637188224,129965.35749716569,315,0,122.97674418604652,34,9,18,36.628388921396535,0.617953431372549,45.68452380952382,1017.261904761906,29.919467787114883,0
318,4,2,2,42,0.045454545454545456,0.045454545454545456,0.9545454545454546,44,1150,800,350,0.6956521739130435,15,8,7,347.694173128938,0.4419045102184637,0.2097290487794803,0.19572247443907734,129790.40745027429,225.47367969820965,130015.88112997249,316,0,120.86363636363636,35,9,17,36.397281538694536,0.6202380952380953,45.254629629629626,1018.981481481481,29.1137566137566,0
319,4,1,2,41,0.023255813953488372,0.046511627906976744,0.9534883720930233,43,1200,1000,200,0.8333333333333334,14,10,4,356.9973560325056,0.44282945736434104,0.22150102743077027,0.20042449988281605,129685.96938775509,659.5096371882023,130345.47902494328,317,0,124.62790697674419,34,9,19,36.26646018388654,0.6213235294117647,45.357142857142854,1018.5714285714284,29.957983193277308,0
320,4,0,1,40,0.0,0.024390243902439025,0.975609756097561,41,1150,800,350,0.6956521739130435,15,8,7,364.38722013444635,0.4404471544715447,0.23077893316515907,0.20513742284481504,129793.8762284937,1259.04594987503,131052.92217836872,318,1,128.46341463414635,33,8,20,35.96850571256765,0.6246843434343434,45.25122549019607,1018.9950980392144,30.87863933452165,0
321,4,0,0,40,0.0,0.0,1.0,40,1200,1000,200,0.8333333333333334,14,10,4,366.94461064018964,0.43975694444444446,0.22685051670271594,0.2077355816154868,130012.5027032871,1541.4774365628502,131553.98013984994,319,2,128.15,33,7,20,35.68102619562605,0.6268939393939394,45.03676470588235,1019.8529411764698,30.904634581105146,0
322,4,0,0,40,0.0,0.0,1.0,40,1300,900,400,0.6923076923076923,17,9,8,371.6407319128047,0.439690170940171,0.23025936599423624,0.21140874421925113,130200.04325259503,1677.52787389464,131877.57112648967,320,3,129.15,33,7,20,35.37063720781299,0.6287878787878788,44.85294117647058,1020.5882352941167,30.92691622103384,0
323,4,0,0,40,0.0,0.0,1.0,40,1450,1100,350,0.7586206896551724,18,11,7,376.32068105237124,0.4392761752136752,0.2357824312972523,0.21493353222819794,130356.43029423773,1811.1641255766938,132167.5944198144,321,4,130.15,33,7,20,35.09227869114765,0.6303661616161615,44.69975490196078,1021.2009803921563,30.945484254307768,0
324,4,1,1,40,0.024390243902439025,0.024390243902439025,0.975609756097561,41,1100,900,200,0.8181818181818182,13,9,4,367.9437539330044,0.4399644308943089,0.2362845708345287,0.21162310884278002,130627.42524092962,1412.7090419501008,132040.1342828797,322,0,127.95121951219512,34,7,19,35.03115174100384,0.6308210784313726,44.4345238095238,1022.261904761904,30.066526610644235,0
325,4,0,0,40,0.0,0.0,1.0,40,1700,1300,400,0.7647058823529411,21,13,8,367.5699500760261,0.43926282051282056,0.23461224965067595,0.21157444579443097,130657.8514739228,1605.1799886621184,132263.0314625849,323,1,129.125,34,6,19,35.00984901412824,0.6311274509803921,44.4047619047619,1022.3809523809515,30.070028011204457,0
326,4,0,0,40,0.0,0.0,1.0,40,1050,800,250,0.7619047619047619,13,8,5,366.7935615634503,0.43904914529914535,0.23731082654249191,0.21146018079396203,130718.71456916085,1589.3565759637038,132308.07114512456,324,2,130.125,34,6,19,34.96798603026776,0.6317401960784313,44.34523809523809,1022.6190476190463,30.077030812324892,0
327,4,0,2,38,0.0,0.05,0.95,40,800,500,300,0.625,11,5,6,366.23795877567244,0.4391826923076923,0.19989430351579873,0.19734692886545246,128059.03031409802,1435.3762589464964,129494.40657304451,325,3,131.125,36,4,19,37.69215435395342,0.6006944444444444,46.95945945945947,1012.1621621621633,28.11561561561565,8
328,4,1,0,39,0.02564102564102564,0.0,1.0,39,1400,1000,400,0.7142857142857143,18,10,8,360.0492511559976,0.43988978857399913,0.2044955273193796,0.1952832183779184,128320.37278163584,1440.3593592184616,129760.7321408543,326,0,131.05128205128204,35,4,21,37.581391363947915,0.6053571428571429,46.70138888888889,1013.1944444444448,28.94841269841271,0
329,4,0,1,38,0.0,0.02564102564102564,0.9743589743589743,39,1150,700,450,0.6086956521739131,16,7,9,362.2443235128536,0.43938371569950513,0.2066034422198797,0.1973420568390923,128496.33487654352,1509.413580246946,130005.74845679046,327,1,132.05128205128204,35,4,15,37.34589041095891,0.6071428571428572,46.52777777777779,1013.8888888888914,28.96825396825404,0
330,4,1,0,39,0.02564102564102564,0.0,1.0,39,1200,700,500,0.5833333333333334,17,7,10,362.7291851582809,0.4385964912280702,0.20923451287315764,0.19862877990522493,128701.77636584805,1536.7780939214827,130238.55445976954,328,0,133.0,35,4,17,37.12370727348768,0.6092261904761904,46.32523148148149,1014.6990740740753,28.99140211640215,0
331,4,0,1,38,0.0,0.02564102564102564,0.9743589743589743,39,600,300,300,0.5,9,3,6,363.04877723906407,0.43868083670715247,0.20954987834549832,0.19895072992700738,128731.13854595355,1547.1364883402107,130278.27503429377,329,1,134.0,35,4,17,37.085614355231144,0.6095238095238096,46.296296296296305,1014.8148148148164,28.99470899470904,0
332,4,1,0,39,0.02564102564102564,0.0,1.0,39,950,700,250,0.7368421052631579,12,7,5,363.7511184925891,0.4386246063877643,0.2150175635473104,0.2002228553107893,128907.38195516139,1578.0408736282848,130485.42282878967,330,0,134.66666666666666,35,4,18,36.88786946280678,0.6113095238095239,46.1226851851852,1015.509259259261,29.014550264550312,0
333,4,0,0,39,0.0,0.0,1.0,39,1000,500,500,0.5,15,5,10,361.6712819144736,0.43809041835357626,0.2196400091136934,0.19966984356259432,129024.94454089516,1532.9234182098903,130557.86795910505,331,1,135.66666666666666,35,4,19,36.82074504442926,0.6125,46.00694444444445,1015.9722222222231,29.027777777777803,0
334,4,0,2,37,0.0,0.05128205128205128,0.9487179487179487,39,1400,1100,300,0.7857142857142857,17,11,6,355.5210812302945,0.4380060728744939,0.21397346422271668,0.19700974832816895,129172.76810171678,1384.7284362065031,130557.49653792327,332,2,136.66666666666666,36,3,20,36.8263265758281,0.6119791666666667,45.8614864864865,1016.5540540540557,28.237612612612658,0
335,4,2,1,38,0.05128205128205128,0.02564102564102564,0.9743589743589743,39,650,300,350,0.46153846153846156,10,3,7,348.56786231517555,0.44250449842555106,0.2001311934228367,0.19489220273756955,129525.18332315245,1229.6664237866235,130754.84974693907,333,0,130.3846153846154,35,4,14,36.64451866590866,0.6175595238095238,45.5150462962963,1017.939814814815,29.083994708994716,0
336,4,1,0,39,0.02564102564102564,0.0,1.0,39,700,400,300,0.5714285714285714,10,4,6,351.41741609064263,0.444331983805668,0.20890982668053426,0.19737234709723986,129701.96926708263,1315.9061803412346,131017.87544742387,334,0,131.35897435897436,35,4,15,36.39228970192781,0.6193452380952381,45.34143518518519,1018.6342592592605,29.103835978836013,0
337,4,0,0,39,0.0,0.0,1.0,39,1300,900,400,0.6923076923076923,17,9,8,347.6609909771332,0.44337606837606836,0.20091731096841792,0.1958512492356792,129819.89354263146,1226.6625675154603,131046.55611014692,335,1,132.35897435897436,35,4,16,36.368185689948874,0.6205357142857143,45.22569444444446,1019.0972222222244,29.117063492063554,0
338,4,0,2,37,0.0,0.05128205128205128,0.9487179487179487,39,1050,800,250,0.7619047619047619,13,8,5,346.7649063903714,0.44323549257759787,0.20194381620196156,0.19593662991615005,129937.87140185611,1211.5787626457477,131149.45016450188,336,2,133.35897435897436,35,4,16,36.27126139932644,0.6217261904761905,45.1099537037037,1019.560185185185,29.130291005291,0
339,4,1,0,38,0.02631578947368421,0.0,1.0,38,1500,1300,200,0.8666666666666667,17,13,4,368.0303703703705,0.44081910858226653,0.16452631578947363,0.20001650563607087,128401.20525931333,1851.1086255174082,130252.31388483073,337,0,137.47368421052633,36,2,16,37.296527777777776,0.6041666666666667,46.62162162162162,1013.5135135135132,28.153153153153145,8
340,4,0,0,38,0.0,0.0,1.0,38,1100,800,300,0.7272727272727273,14,8,6,373.9041944468419,0.43938181602655285,0.17410727329036524,0.20423014429246225,128601.01814229762,2016.8920187078902,130617.91016100551,338,1,138.47368421052633,36,2,16,36.943257096332495,0.6061921296296297,46.424549549549546,1014.301801801801,28.17505005005003,0
341,4,0,0,38,0.0,0.0,1.0,38,750,300,450,0.4,12,3,9,373.1444721485613,0.438700213371266,0.18287882062274763,0.20440150994107503,128715.26668137721,2005.8780486567525,130721.14473003396,339,2,139.47368421052633,36,2,17,36.84570709873116,0.607349537037037,46.31193693693693,1014.7522522522514,28.18756256256254,0
342,4,0,0,38,0.0,0.0,1.0,38,550,200,350,0.36363636363636365,9,2,7,373.1444721485613,0.438700213371266,0.18287882062274763,0.20440150994107503,128715.26668137721,2005.8780486567525,130721.14473003396,340,3,140.47368421052633,36,2,17,36.84570709873116,0.607349537037037,46.31193693693693,1014.7522522522514,28.18756256256254,0
343,4,1,0,39,0.02564102564102564,0.0,1.0,39,750,600,150,0.8,9,6,3,361.60584901556496,0.44126743139901037,0.1837122627022274,0.19982119277443253,129062.08070031134,1533.9206534702632,130596.00135378161,341,0,137.84615384615384,37,2,18,36.7845356282148,0.6089527027027026,45.97039473684209,1016.1184210526292,27.462660028449438,0
344,4,0,0,39,0.0,0.0,1.0,39,1000,600,400,0.6,14,6,8,365.91573192572343,0.4405645524066577,0.19025806986972027,0.20263075477607267,129145.6565962604,1651.2854916897516,130796.94208795016,342,1,138.84615384615384,37,2,18,36.58980582524272,0.6097972972972974,45.88815789473684,1016.4473684210528,27.471550497866293,0
345,4,0,0,39,0.0,0.0,1.0,39,1500,1100,400,0.7333333333333333,19,11,8,366.92356370363973,0.439861673414305,0.19190691055812237,0.20363184909634752,129231.64859693882,1683.6634780874529,130915.31207502628,343,2,139.84615384615384,34,5,18,36.47650548335479,0.6167279411764706,45.80357142857143,1016.7857142857147,29.90546218487396,0
346,4,0,1,38,0.0,0.02564102564102564,0.9743589743589743,39,1000,600,400,0.6,14,6,8,363.7679901527584,0.43969298245614036,0.19133535004321534,0.20234594452247204,129322.44897959198,1608.673469387771,130931.12244897975,344,3,140.84615384615384,34,5,18,36.46418539325842,0.6176470588235294,45.71428571428572,1017.1428571428582,29.915966386554654,0
347,4,1,0,39,0.02564102564102564,0.0,1.0,39,950,500,450,0.5263157894736842,14,5,9,359.2707183850635,0.44152046783625726,0.18550714215082564,0.20185683107163416,129716.28578514732,1520.6526360544149,131236.93842120175,345,0,138.76923076923077,34,5,18,36.177739472556574,0.6216299019607843,45.32738095238095,1018.6904761904757,29.961484593837522,0
348,4,0,1,38,0.0,0.02564102564102564,0.9743589743589743,39,900,500,400,0.5555555555555556,13,5,8,360.6756048563191,0.4414923526765632,0.19080996884735213,0.20311731431382196,129807.25623582774,1563.6621315192804,131370.918367347,346,1,139.76923076923077,34,5,18,36.04945482866043,0.6225490196078431,45.23809523809524,1019.0476190476196,29.971988795518225,0
349,4,0,1,37,0.0,0.02631578947368421,0.9736842105263158,38,800,500,300,0.625,11,5,6,364.1607024826619,0.4396485301090564,0.19014565748345325,0.20550127023410997,129887.55076172623,1859.9883458285233,131747.53910755477,347,2,143.05263157894737,33,5,18,35.87901739200128,0.6256313131313131,45.15931372549019,1019.362745098039,30.88978015448603,0
350,4,0,0,37,0.0,0.0,1.0,37,1250,900,350,0.72,16,9,7,371.5067508740899,0.4395332832832833,0.19194212800160781,0.20906969871366124,129779.68606519731,2242.80589990816,132022.49196510547,348,3,146.54054054054055,32,5,18,35.80157992565057,0.626953125,45.26515151515151,1018.939393939393,31.84185606060603,0
351,4,0,0,37,0.0,0.0,1.0,37,1300,1000,300,0.7692307692307693,16,10,6,370.750508505917,0.4390953453453454,0.19196985446985404,0.20955463524247475,129950.0192233755,2235.8071414840238,132185.82636485953,349,4,147.54054054054055,33,4,19,35.64753605769229,0.6262626262626263,45.09803921568626,1019.6078431372539,30.897207367795573,0
352,4,0,1,36,0.0,0.02702702702702703,0.972972972972973,37,1250,1000,250,0.8,15,10,5,369.1542911761065,0.43865740740740744,0.19019836639439935,0.20951339572047878,130110.72137188194,2206.18622448978,132316.90759637172,350,5,148.54054054054055,34,3,20,35.5248444185142,0.6256127450980392,44.94047619047618,1020.238095238094,30.007002801120414,0
353,4,1,0,37,0.02702702702702703,0.0,1.0,37,1250,800,450,0.64,17,8,9,367.018573626975,0.4390953453453454,0.1868047377590054,0.20928348643985825,130293.86421388402,2164.142216322798,132458.00643020682,351,0,148.43243243243242,33,4,21,35.393285119833564,0.6297348484848485,44.7610294117647,1020.9558823529406,30.938057040998203,0
354,4,0,1,36,0.0,0.02702702702702703,0.972972972972973,37,800,600,200,0.75,10,6,4,365.5476786985266,0.4387825325325325,0.17971807200065548,0.2087661776215686,130353.7485827664,2130.102040816321,132483.85062358272,352,1,149.43243243243242,34,3,21,35.37003575036915,0.6280637254901961,44.70238095238095,1021.1904761904759,30.035014005602232,0
355,4,0,1,35,0.0,0.027777777777777776,0.9722222222222222,36,1300,1000,300,0.7692307692307693,16,10,6,374.25848963380696,0.43771494708994707,0.17251549690062018,0.2141005155180356,130419.01139285353,2562.0844446847127,132981.09583753825,353,2,146.44444444444446,33,3,22,35.08135872825435,0.6309974747474747,44.63848039215685,1021.4460784313711,30.952911467617305,0
356,4,0,0,35,0.0,0.0,1.0,35,700,500,200,0.7142857142857143,9,5,4,382.8473242690641,0.4372549019607843,0.18340546556201387,0.2184958582472772,130327.04132550237,2979.071810274454,133306.11313577683,354,3,150.25714285714287,32,3,22,34.95553563332098,0.6324869791666667,44.72853535353535,1021.0858585858575,31.908933080808048,0
357,4,0,0,35,0.0,0.0,1.0,35,1050,800,250,0.7619047619047619,13,8,5,383.19553967189273,0.43704481792717087,0.1811972452763555,0.21923988090138705,130423.7529971432,2995.560083154789,133419.313080298,355,4,151.25714285714287,32,3,22,34.84832097239391,0.6334635416666667,44.63383838383839,1021.4646464646469,31.920770202020215,0
358,4,0,0,35,0.0,0.0,1.0,35,650,600,50,0.9230769230769231,7,6,1,386.0632029243551,0.43686974789915967,0.18310291858678984,0.22106421619681219,130455.99819214875,3072.852100550964,133528.8502926997,356,5,152.25714285714287,32,3,22,34.742306266221725,0.6337890625,44.60227272727273,1021.590909090909,31.924715909090907,0
359,4,0,0,35,0.0,0.0,1.0,35,1200,1000,200,0.8333333333333334,14,10,4,381.35759572451747,0.4367296918767507,0.17723738740281525,0.21939896989889152,130638.16350682439,2963.9711889657938,133602.13469579018,357,6,153.25714285714287,33,2,19,34.6774354671142,0.6332070707070707,44.42401960784314,1022.3039215686282,30.978906714200853,0
360,4,0,0,35,0.0,0.0,1.0,35,700,300,400,0.42857142857142855,11,3,8,386.130551008908,0.4362044817927171,0.17691965355516737,0.22286622259476804,130763.47588667824,3098.3545991926253,133861.83048587086,358,7,154.25714285714287,33,2,19,34.428169182842076,0.634469696969697,44.3014705882353,1022.7941176470591,30.993761140819974,0
361,4,0,2,33,0.0,0.05714285714285714,0.9428571428571428,35,900,800,100,0.8888888888888888,10,8,2,389.1167835936018,0.4360294117647059,0.17524813471147938,0.2249547721218411,130826.15460399838,3181.330497885419,134007.4851018838,359,8,155.25714285714287,33,2,19,34.288152850982264,0.6351010101010102,44.24019607843137,1023.0392156862739,31.00118835412951,0
362,4,0,0,33,0.0,0.0,1.0,33,1000,600,400,0.6,14,6,8,398.81590297730077,0.43402777777777773,0.15962039233840675,0.2301762614170974,130761.51741875529,3829.9545288085765,134591.47194756387,360,15,158.78787878787878,31,2,19,34.10579779333757,0.6394489247311828,44.30338541666666,1022.7864583333322,32.99311155913975,0
363,4,1,0,34,0.029411764705882353,0.0,1.0,34,850,400,450,0.47058823529411764,13,4,9,388.29446185357665,0.4331736482471777,0.15556474068917514,0.2262819450112221,131134.06795224966,3383.7264692378158,134517.7944214875,361,0,155.08823529411765,32,2,20,33.996702416173555,0.640625,43.93939393939393,1024.2424242424233,32.00757575757573,0
364,4,0,1,33,0.0,0.029411764705882353,0.9705882352941176,34,1000,800,200,0.8,12,8,4,390.83780634889183,0.43172534165181226,0.15334348157007693,0.22834044625782973,131231.07854109266,3458.013372359947,134689.0919134526,362,1,156.08823529411765,32,2,20,33.83317929759703,0.6416015625,43.84469696969696,1024.6212121212113,32.019412878787854,0
365,4,0,0,33,0.0,0.0,1.0,33,1100,900,200,0.8181818181818182,13,9,4,394.60638508824115,0.43067392676767674,0.15693520571569364,0.23112659698025537,131328.1249999999,3764.6192033975994,135092.7442033975,363,2,156.3030303030303,30,3,20,33.6382113821138,0.6479166666666667,43.74999999999999,1024.9999999999993,34.16666666666664,0
366,4,2,0,35,0.05714285714285714,0.0,1.0,35,1000,700,300,0.7,13,7,6,377.14277640156376,0.4335434173669468,0.15546311410668245,0.22487656096207503,132008.45457415047,2957.2070133149523,134965.6615874654,364,0,148.31428571428572,32,3,20,33.39783757218332,0.6494140625,43.087121212121204,1027.651515151514,32.114109848484816,0
367,4,0,0,35,0.0,0.0,1.0,35,900,600,300,0.6666666666666666,12,6,6,377.83053323593884,0.43333333333333335,0.1561389961389965,0.22547951176983438,132040.89506172828,2977.816358024682,135018.71141975297,365,1,149.31428571428572,32,3,20,33.34740990990992,0.6497395833333333,43.05555555555555,1027.777777777777,32.11805555555553,0
368,4,0,1,34,0.0,0.02857142857142857,0.9714285714285714,35,800,500,300,0.625,11,5,6,377.1713918710551,0.43196778711484596,0.1580458439453578,0.22593664930528234,132183.68055555547,2971.180555555551,135154.86111111104,366,2,150.31428571428572,34,1,20,33.2202188006483,0.6464460784313726,42.916666666666664,1028.3333333333328,30.24509803921567,0
369,4,0,0,34,0.0,0.0,1.0,34,1200,900,300,0.75,15,9,6,393.797352056205,0.42996137849079025,0.1748584085683842,0.23605338417540514,132208.88600538252,3612.7018454440586,135821.5878508266,367,3,155.58823529411765,33,1,20,32.76731808071179,0.648989898989899,42.8921568627451,1028.4313725490194,31.16458704693998,0
370,4,0,0,34,0.0,0.0,1.0,34,950,700,250,0.7368421052631579,12,7,5,394.23891296597765,0.42953431372549017,0.17690967140241143,0.2367351248741495,132275.51197562352,3629.6308106575902,135905.14278628113,368,4,156.58823529411765,34,0,20,32.68863557458628,0.6473651960784313,42.82738095238095,1028.6904761904757,30.255602240896344,0
371,4,0,0,34,0.0,0.0,1.0,34,1050,800,250,0.7619047619047619,13,8,5,396.89205027050554,0.4285502079619727,0.18948274007957866,0.239322781178861,132432.58794369307,3712.515027689908,136145.102971383,369,5,157.58823529411765,30,4,21,32.461695830068784,0.6590277777777778,42.67473118279571,1029.3010752688185,34.31003584229395,0
372,4,0,0,34,0.0,0.0,1.0,34,350,300,50,0.8571428571428571,4,3,1,398.2570421031566,0.4281974153297683,0.18594425627673705,0.24036648427644414,132467.1769315817,3751.1972121054446,136218.37414368714,370,6,158.58823529411765,30,4,21,32.39163076119598,0.659375,42.641129032258064,1029.4354838709678,34.31451612903226,0
373,4,0,0,34,0.0,0.0,1.0,34,1350,1000,350,0.7407407407407407,17,10,7,395.76903062095585,0.427380421865716,0.1824481056325462,0.24013225232154933,132666.15125868062,3701.030815972232,136367.18207465284,371,7,159.58823529411765,31,3,18,32.25480283114258,0.6586021505376345,42.44791666666667,1030.208333333334,33.23252688172045,0
374,4,0,0,34,0.0,0.0,1.0,34,1000,700,300,0.7,13,7,6,402.1789170320706,0.42726901366607245,0.1825193948221029,0.24489602363275953,132800.32687717024,3881.898328993075,136682.2252061633,372,8,160.58823529411765,31,3,18,31.954269833249125,0.6599462365591398,42.31770833333334,1030.7291666666677,33.249327956989276,0
375,4,0,0,34,0.0,0.0,1.0,34,1000,800,200,0.8,12,8,4,402.1789170320706,0.42726901366607245,0.1825193948221029,0.24489602363275953,132800.32687717024,3881.898328993075,136682.2252061633,373,9,161.58823529411765,31,3,18,31.954269833249125,0.6599462365591398,42.31770833333334,1030.7291666666677,33.249327956989276,0
376,4,0,0,34,0.0,0.0,1.0,34,750,700,50,0.9333333333333333,8,7,1,398.2858891949802,0.4271947415329768,0.17712418300653598,0.2433969322858212,132934.5703125,3789.1927083333344,136723.76302083334,374,10,162.58823529411765,31,3,18,31.91919191919192,0.6612903225806452,42.1875,1031.25,33.266129032258064,0
377,4,0,0,34,0.0,0.0,1.0,34,650,400,250,0.6153846153846154,9,4,5,397.2875307402549,0.42687908496732024,0.17417215592208324,0.24300498308830593,132968.14176771385,3765.31694200305,136733.4587097169,375,11,163.58823529411765,31,3,18,31.91108551108867,0.6616263440860215,42.15494791666667,1031.3802083333342,33.27032930107529,0
378,4,0,0,34,0.0,0.0,1.0,34,650,600,50,0.9230769230769231,7,6,1,394.28362148010456,0.42580213903743314,0.1672931674154401,0.24176793949315392,133060.9790254951,3692.7529375720987,136753.7319630672,376,12,164.58823529411765,33,1,18,31.89499445698222,0.6575126262626263,42.06495098039216,1031.740196078432,31.264854426619152,0
379,4,0,0,34,0.0,0.0,1.0,34,550,200,350,0.36363636363636365,9,2,7,394.3805327209843,0.42552361853832443,0.169735922872712,0.2420323677485925,133092.5905901577,3697.825355632458,136790.41594579016,377,13,165.58823529411765,33,1,18,31.860649247822646,0.6578282828282829,42.0343137254902,1031.8627450980398,31.268568033273933,0
380,4,0,0,34,0.0,0.0,1.0,34,900,500,400,0.5555555555555556,13,5,8,389.7520292309865,0.42455808080808083,0.16537545706784584,0.2398537860512338,133195.58000283447,3582.649518140591,136778.22952097506,378,14,166.58823529411765,34,0,18,31.876369507553925,0.6565563725490196,41.93452380952381,1032.2619047619048,30.360644257703083,0
381,4,1,0,35,0.02857142857142857,0.0,1.0,35,1000,800,200,0.8,12,8,4,380.1378772112379,0.42591036414565825,0.16359447004608296,0.23568548387096772,133472.22222222234,3147.8564342403733,136620.07865646272,379,0,162.8,34,1,19,31.84643817204301,0.6593137254901961,41.66666666666667,1033.3333333333344,30.39215686274513,0
382,4,0,0,35,0.0,0.0,1.0,35,1050,700,350,0.6666666666666666,14,7,7,378.4991381603426,0.42538515406162464,0.15742030047636502,0.2352902387333885,133570.093692608,3111.233069329672,136681.32676193767,380,1,163.8,32,3,19,31.79049102235252,0.6650390625,41.5719696969697,1033.712121212122,32.30350378787881,0
383,4,0,0,35,0.0,0.0,1.0,35,1350,1100,250,0.8148148148148148,16,11,5,361.0832787863696,0.42489495798319327,0.10895539243365326,0.2113279863617518,131298.46810967516,2481.936272933824,133780.40438260898,381,2,164.8,35,0,19,34.52722096743836,0.6354166666666667,43.77893518518519,1024.88425925926,29.28240740740743,8
384,4,0,0,35,0.0,0.0,1.0,35,600,300,300,0.5,9,3,6,359.9721432378319,0.4245798319327731,0.10534698143570531,0.21100885809536926,131358.63272392304,2457.093059864133,133815.72578378717,382,3,165.8,34,1,19,34.49488057910424,0.6381740196078431,43.7202380952381,1025.1190476190486,30.150560224089666,0
385,4,0,0,35,0.0,0.0,1.0,35,850,600,250,0.7058823529411765,11,6,5,360.07755281347283,0.42408963585434173,0.11185749116783561,0.21140749573159137,131419.65880102068,2464.253826530639,133883.91262755133,383,4,166.8,34,1,19,34.4305120167189,0.6387867647058824,43.6607142857143,1025.357142857145,30.157563025210145,0
386,4,1,0,36,0.027777777777777776,0.0,1.0,36,750,600,150,0.8,9,6,3,350.0371685886655,0.42706679894179894,0.11070081808045473,0.2071033788000586,131713.96933138304,2020.9569776663434,133734.9263090494,384,0,163.13888888888889,35,1,17,34.39097324012477,0.6395833333333334,43.3738425925926,1026.504629629631,29.32870370370374,0
387,4,0,0,36,0.0,0.0,1.0,36,1150,700,450,0.6086956521739131,16,7,9,353.327885440147,0.4269675925925926,0.10688167599584242,0.20970423595387452,131832.80452942822,2116.041211205424,133948.84574063364,385,1,164.13888888888889,35,1,17,34.186694654194376,0.6407738095238096,43.258101851851855,1026.967592592593,29.34193121693123,0
388,4,0,0,36,0.0,0.0,1.0,36,1000,300,700,0.3,17,3,14,349.88369265623066,0.4267030423280423,0.10689609853178639,0.20831103552712024,131951.69331114984,2033.5491415895272,133985.24245273936,386,2,165.13888888888889,35,1,17,34.155331192970614,0.6419642857142858,43.14236111111112,1027.4305555555568,29.355158730158767,0
389,4,0,1,35,0.0,0.027777777777777776,0.9722222222222222,36,900,600,300,0.6666666666666666,12,6,6,350.1317827318436,0.4260912698412698,0.11009492515516639,0.20948251483235455,132137.36329234645,2053.098115006904,134190.46140735334,387,3,166.13888888888889,36,0,18,33.96198430083973,0.6417824074074074,42.961711711711715,1028.1531531531534,28.559809809809817,0
390,4,0,1,34,0.0,0.02857142857142857,0.9714285714285714,35,1450,1100,350,0.7586206896551724,18,11,7,359.7308099606049,0.4223389355742297,0.09674777162129633,0.20043524726798273,129388.34372597084,2428.572719298848,131816.9164452697,388,4,171.65714285714284,33,2,23,36.49973901871037,0.6205808080808081,45.649509803921575,1017.4019607843143,30.830362448009524,8
391,4,0,0,34,0.0,0.0,1.0,34,950,600,350,0.631578947368421,13,6,7,361.2439790773274,0.4206216577540107,0.10804618054325843,0.2017573131296038,129481.87183114687,2554.9093197328166,132036.7811508797,389,5,175.02941176470588,33,1,20,36.36601946618502,0.6215277777777778,45.5575980392157,1017.7696078431388,30.841503267973906,0
392,4,0,0,34,0.0,0.0,1.0,34,1050,800,250,0.7619047619047619,13,8,5,359.5193461274929,0.4207516339869281,0.10881527540857339,0.20121789581690588,129564.73922902501,2516.2060657596467,132080.94529478467,390,6,176.02941176470588,34,0,20,36.325567118802645,0.6200980392156863,45.47619047619048,1018.0952380952386,29.94397759103643,0
393,4,0,1,33,0.0,0.029411764705882353,0.9705882352941176,34,500,300,200,0.6,7,3,4,364.42095547734766,0.41973039215686275,0.10552824285763429,0.20443418190876775,129655.65653344664,2649.8476473922833,132305.50418083894,391,7,177.02941176470588,34,0,20,36.10827001753361,0.6210171568627452,45.38690476190476,1018.4523809523804,29.954481792717072,0
394,4,1,0,34,0.029411764705882353,0.0,1.0,34,1500,1200,300,0.8,18,12,6,362.8803807046512,0.41800356506238856,0.13315295765749724,0.20531263811862877,129989.2928004534,2634.11281179137,132623.40561224477,392,0,177.2058823529412,34,0,21,35.80823410382131,0.6243872549019608,45.0595238095238,1019.7619047619038,29.99299719887952,0
395,4,1,0,35,0.02857142857142857,0.0,1.0,35,900,500,400,0.5555555555555556,13,5,8,355.49969741695816,0.4203081232492997,0.13761055314045922,0.2028689890050067,130323.35778061228,2266.269841269849,132589.62762188213,393,0,173.11428571428573,34,1,22,35.65737825968678,0.6277573529411764,44.73214285714286,1021.0714285714289,30.031512605042025,0
396,4,1,0,36,0.027777777777777776,0.0,1.0,36,950,600,350,0.631578947368421,13,6,7,343.76102298727943,0.4222718253968254,0.1349927214454354,0.19849849788896765,130780.41459956583,1791.4418218894634,132571.8564214553,394,0,169.27777777777777,36,0,18,35.49442181364454,0.6281828703703703,44.28490990990991,1022.8603603603608,28.4127877877878,0
397,4,0,0,36,0.0,0.0,1.0,36,1300,1000,300,0.7692307692307693,16,10,6,342.56914493357243,0.4212797619047619,0.1346774489309419,0.1986988486471757,130953.2521330453,1772.10872189758,132725.36085494288,395,1,170.27777777777777,36,0,20,35.35019437415188,0.6299189814814814,44.115990990990994,1023.5360360360369,28.43155655655658,0
398,4,0,0,36,0.0,0.0,1.0,36,1250,1000,250,0.8,15,10,5,347.0639643836251,0.42103174603174603,0.13516848715881058,0.2020614399554855,131097.37059694814,1899.834631929209,132997.20522887734,396,2,171.27777777777777,36,0,21,35.08952789384943,0.6313657407407407,43.975225225225216,1024.0990990990979,28.447197197197163,0
399,4,1,0,37,0.02702702702702703,0.0,1.0,37,1050,800,250,0.7619047619047619,13,8,5,337.37307466208654,0.42398648648648646,0.12914776869183808,0.1983717859708523,131476.45968632094,1471.7293012285993,132948.18898754954,397,0,167.6216216216216,35,2,23,34.955258059662185,0.637202380952381,43.60532407407406,1025.578703703702,29.30224867724863,0
400,4,0,0,37,0.0,0.0,1.0,37,1100,700,400,0.6363636363636364,15,7,8,334.6336897070908,0.42357982982982983,0.1220028062306624,0.19733641080396785,131587.9662390431,1406.7533327246158,132994.71957176772,398,1,168.6216216216216,36,1,18,34.91315442871253,0.6362847222222222,43.49662162162162,1026.0135135135135,28.500375375375377,0
401,4,0,1,36,0.0,0.02702702702702703,0.972972972972973,37,900,500,400,0.5555555555555556,13,5,8,331.4474467729093,0.4232982982982983,-0.03750595229506071,0.196580452123388,131806.21831957917,1337.3669061634403,133143.5852257426,399,2,169.6216216216216,37,0,14,34.77520466275138,0.6365427927927928,43.28399122807018,1026.86403508772,27.753082029397834,8
402,4,0,2,34,0.0,0.05555555555555555,0.9444444444444444,36,1150,900,250,0.782608695652174,14,9,5,333.7397083718065,0.4208002645502646,-0.010593323586744585,0.19815795184576038,131848.06428049685,1600.586904472051,133448.6511849689,400,6,175.27777777777777,36,0,14,34.674250730994146,0.6388888888888888,43.24324324324325,1027.027027027028,28.528528528528554,0
403,4,0,0,34,0.0,0.0,1.0,34,1300,1000,300,0.7692307692307693,16,10,6,347.1712466365751,0.4183934937611408,0.003223253815036742,0.20546723814325266,131725.0017715421,2346.226615646277,134071.22838718837,401,7,179.05882352941177,34,0,15,34.453399822180984,0.6418504901960784,43.36309523809525,1026.5476190476202,30.19257703081236,0
404,4,0,0,34,0.0,0.0,1.0,34,650,400,250,0.6153846153846154,9,4,5,355.7451138934015,0.41854203802733214,-0.02365033074898637,0.1932990861956916,128392.81316080336,2365.0118503283443,130757.8250111317,402,8,180.05882352941177,33,1,18,37.61638452237001,0.610479797979798,46.6299019607843,1013.4803921568613,30.711527035056402,8
405,4,0,0,34,0.0,0.0,1.0,34,950,600,350,0.631578947368421,13,6,7,354.53993817206845,0.4178921568627451,-0.023517324251107752,0.1930947273533587,128485.98082768629,2310.682339725079,130796.66316741137,403,9,181.05882352941177,33,1,19,37.551749667593356,0.6114267676767677,46.53799019607842,1013.8480392156848,30.722667855020752,0
406,4,0,0,34,0.0,0.0,1.0,34,1050,500,550,0.47619047619047616,16,5,11,356.27945891212414,0.41752079619726673,-0.020184405122995575,0.19525812040048302,128734.59314025848,2373.0982374567425,131107.69137771524,404,10,182.05882352941177,33,1,20,37.25382904641147,0.6139520202020202,46.29289215686274,1014.8284313725484,30.752376708259042,0
407,4,0,1,33,0.0,0.029411764705882353,0.9705882352941176,34,1100,700,400,0.6363636363636364,15,7,8,356.4246646278271,0.4173165478312537,-0.01256852330502456,0.19579720966690436,128827.88470780462,2383.487120338321,131211.37182814293,405,11,183.05882352941177,33,1,20,37.15495734749716,0.6148989898989898,46.20098039215686,1015.196078431372,30.763517528223396,0
408,4,1,0,34,0.029411764705882353,0.0,1.0,34,950,800,150,0.8421052631578947,11,8,3,349.24917463904063,0.4162210338680927,0.01145189777345923,0.1932170383776894,129107.96215698292,2218.1698445309594,131326.13200151388,406,0,183.7058823529412,33,1,22,37.0517052534266,0.617739898989899,45.92524509803922,1016.2990196078434,30.796939988116467,0
409,4,1,0,35,0.02857142857142857,0.0,1.0,35,1200,1000,200,0.8333333333333334,14,10,4,343.1278000068398,0.4189775910364146,0.02131996658312474,0.1917478882391164,129504.14540816336,1887.2945011338006,131391.43990929716,407,0,179.42857142857142,34,1,16,36.80433723196882,0.6194852941176471,45.53571428571429,1017.8571428571436,29.936974789915986,0
410,4,0,0,35,0.0,0.0,1.0,35,1300,1000,300,0.7692307692307693,16,10,6,341.7032526967409,0.418312324929972,0.02324058919803651,0.19154191504376958,129625.34722222228,1858.6805555555661,131484.02777777784,408,1,180.42857142857142,34,1,16,36.717471358428796,0.6207107843137255,45.41666666666667,1018.3333333333338,29.95098039215688,0
411,4,1,1,35,0.027777777777777776,0.027777777777777776,0.9722222222222222,36,1050,700,350,0.6666666666666666,14,7,7,333.40382010828284,0.4189318783068783,0.025608279411208468,0.18838705909774628,129937.87140185623,1464.3565404235387,131402.22794227977,409,0,176.38888888888889,35,1,18,36.61182218942749,0.6217261904761905,45.10995370370371,1019.5601851851859,29.130291005291024,0
412,4,1,1,35,0.027777777777777776,0.027777777777777776,0.9722222222222222,36,1050,900,150,0.8571428571428571,12,9,3,334.03752275892856,0.4215773809523809,0.031080978856992125,0.18931657158034965,130055.90284475745,1488.710321287736,131544.6131660452,410,0,177.27777777777777,35,1,19,36.47606282385871,0.6229166666666667,44.99421296296297,1020.0231481481487,29.143518518518533,0
413,4,0,0,35,0.0,0.0,1.0,35,800,400,400,0.5,12,4,8,341.8449943194233,0.41988795518207284,0.03249391281144676,0.1934111110528522,129989.29280045368,1887.2378117913995,131876.5306122451,411,1,182.82857142857142,34,1,20,36.34451124601135,0.6243872549019608,45.05952380952382,1019.7619047619062,29.992997198879593,0
414,4,1,0,36,0.027777777777777776,0.0,1.0,36,1000,600,400,0.6,14,6,8,333.05179957275186,0.4218915343915344,0.0410564684250736,0.19065493609965203,130444.9422477325,1489.2715419501205,131934.21378968263,412,0,178.72222222222223,34,2,23,36.1073884162685,0.6289828431372548,44.61309523809524,1021.5476190476196,30.045518207282928,0
415,4,0,0,36,0.0,0.0,1.0,36,1450,1000,450,0.6896551724137931,19,10,9,333.4432062014471,0.421494708994709,0.038825972064930436,0.19143715934712469,130558.13426997601,1506.7445773319669,132064.878847308,413,1,179.72222222222223,35,1,16,35.982918082295214,0.6279761904761905,44.50231481481482,1021.9907407407409,29.199735449735453,0
416,4,1,0,37,0.02702702702702703,0.0,1.0,37,900,600,300,0.6666666666666666,12,6,6,325.6658482944197,0.42373623623623624,0.045436568706455294,0.18889450511474037,130953.25213304526,1129.4003885642474,132082.6525216095,414,0,175.83783783783784,36,1,18,35.7827227051014,0.6299189814814814,44.115990990990994,1023.5360360360365,28.431556556556572,0
417,4,0,1,36,0.0,0.02702702702702703,0.972972972972973,37,1050,900,150,0.8571428571428571,12,9,3,326.53744878709585,0.4231106106106106,0.034932447292244984,0.1901108552669556,131097.37059694814,1161.640187484765,132259.0107844329,415,1,176.83783783783784,36,1,18,35.61505754710067,0.6313657407407407,43.975225225225216,1024.0990990990979,28.447197197197163,0
418,4,0,1,35,0.0,0.027777777777777776,0.9722222222222222,36,850,800,50,0.9411764705882353,9,8,1,335.60065457452833,0.42041997354497357,0.02516487657810451,0.19490399144528542,131002.08340031261,1592.8769879543488,132594.96038826695,416,2,182.61111111111111,35,1,19,35.47920199736196,0.6324404761904762,44.06828703703702,1023.7268518518492,29.24933862433855,0
419,4,0,1,34,0.0,0.02857142857142857,0.9714285714285714,35,950,400,550,0.42105263157894735,15,4,11,344.7862763670996,0.41852240896358545,0.01914734480179514,0.1995581175336844,130870.93431122409,2024.5004251700211,132895.43473639412,417,3,188.62857142857143,34,1,19,35.37667248400233,0.6332720588235294,44.19642857142855,1023.2142857142825,30.094537815125957,0
420,4,0,1,33,0.0,0.029411764705882353,0.9705882352941176,34,950,600,350,0.631578947368421,13,6,7,355.73746186136304,0.41516265597147956,0.017752793148415824,0.20515750651230624,130732.14215986623,2501.2640871299286,133233.40624699616,418,4,194.88235294117646,33,1,20,35.23704313960455,0.6341540404040404,44.332107843137244,1022.6715686274496,30.99004753416514,0
421,4,0,0,33,0.0,0.0,1.0,33,1000,700,300,0.7,13,7,6,351.2098416787778,0.4122080176767677,0.038981771740392857,0.20370170817369077,130951.55709342533,2598.2951268742495,133549.8522202996,419,5,199.45454545454547,33,0,22,35.13080699233718,0.6363636363636364,44.117647058823515,1023.5294117647037,31.016042780748595,0
422,4,0,0,33,0.0,0.0,1.0,33,1150,900,250,0.782608695652174,14,9,5,351.99156734987525,0.41197127525252525,0.04070393870465683,0.20432144281261325,130982.91710219614,2620.976457372147,133603.89355956827,420,6,200.45454545454547,33,0,22,35.07908835149049,0.6366792929292929,44.08700980392156,1023.6519607843126,31.01975638740341,0
423,4,0,0,33,0.0,0.0,1.0,33,1100,900,200,0.8181818181818182,13,9,4,352.949789879331,0.4111032196969697,0.0441417526147061,0.2053794181219838,131077.01965590141,2652.7213091118583,133729.74096501328,421,7,201.45454545454547,33,0,23,34.95941040370192,0.6376262626262627,43.99509803921568,1024.019607843136,31.03089720736776,0
424,4,1,0,34,0.029411764705882353,0.0,1.0,34,700,500,200,0.7142857142857143,9,5,4,347.29146137392894,0.4116532976827094,0.06427849691408594,0.20438956497252514,131511.2244897958,2334.545068027192,133845.769557823,422,0,196.5,34,0,24,34.665883240482806,0.6397058823529411,43.57142857142856,1025.7142857142846,30.168067226890724,0
425,4,0,0,34,0.0,0.0,1.0,34,750,600,150,0.8,9,6,3,350.9259157177914,0.4111148247177659,0.05386526347399401,0.2070246726606189,131602.8220663265,2436.568168934234,134039.39023526074,423,1,197.5,34,0,18,34.48026646556058,0.640625,43.482142857142854,1026.0714285714282,30.178571428571416,0
426,4,0,0,34,0.0,0.0,1.0,34,1200,800,400,0.6666666666666666,16,8,8,354.95400126023935,0.4106691919191919,0.05215686274509812,0.21041087703570896,131786.1128826531,2555.601615646263,134341.71449829938,424,2,198.5,34,0,18,34.19202898550724,0.6424632352941176,43.30357142857143,1026.7857142857147,30.199579831932784,0
427,4,0,0,34,0.0,0.0,1.0,34,750,500,250,0.6666666666666666,10,5,5,357.84034475060133,0.410873440285205,0.04892868346040036,0.2122923530824408,131816.6737528346,2633.8647959183863,134450.538548753,425,3,199.5,34,0,18,34.08711067315866,0.6427696078431373,43.27380952380953,1026.904761904763,30.20308123249303,0
428,4,0,0,34,0.0,0.0,1.0,34,1500,1000,500,0.6666666666666666,20,10,10,361.77486018788176,0.409536541889483,0.04889467371749423,0.21566578681918486,132000.11337868485,2750.8645124716545,134750.9778911565,426,4,200.5,34,0,20,33.80106966326844,0.6446078431372548,43.095238095238095,1027.619047619048,30.22408963585435,0
429,4,0,0,34,0.0,0.0,1.0,34,850,600,250,0.7058823529411765,11,6,5,368.60981706307035,0.40905377302436124,0.0837412727710456,0.20625266863147365,129554.6392746913,2759.7844230284627,132314.42369771976,427,5,201.5,32,2,17,36.104479308776696,0.6246744791666667,45.48611111111111,1018.0555555555552,31.8142361111111,8
430,4,0,0,34,0.0,0.0,1.0,34,1200,900,300,0.75,15,9,6,369.7240759026896,0.40920231729055256,0.08978136258222613,0.20738486760995084,129651.0639858177,2787.023964391381,132438.0879502091,428,6,202.5,32,2,17,35.977921729068505,0.6256510416666667,45.39141414141414,1018.4343434343428,31.826073232323214,0
431,4,0,0,34,0.0,0.0,1.0,34,700,200,500,0.2857142857142857,12,2,10,350.01494985257733,0.40847816399286985,0.0708974670789757,0.18345984832830137,126942.00857426302,2086.320153061224,129028.32872732425,429,7,203.5,34,0,21,39.24739121874385,0.5934436274509804,48.06547619047619,1007.7380952380952,29.639355742296917,8
432,4,1,0,35,0.02857142857142857,0.0,1.0,35,900,800,100,0.8888888888888888,10,8,2,344.55841388924483,0.41053921568627455,0.07965225009687815,0.18248037422654,127362.24666950104,1776.835317460306,129139.08198696135,430,0,198.65714285714284,34,1,14,38.953836930455644,0.5977328431372548,47.64880952380952,1009.4047619047611,29.688375350140035,0
433,4,0,0,35,0.0,0.0,1.0,35,900,500,400,0.5555555555555556,13,5,8,347.31465135373014,0.41095938375350144,0.0774860645661073,0.1844878013421222,127482.4422477324,1855.30399659864,129337.74624433104,431,1,199.65714285714284,34,1,15,38.761100632637834,0.5989583333333333,47.529761904761905,1009.8809523809521,29.702380952380942,0
434,4,0,0,35,0.0,0.0,1.0,35,1100,800,300,0.7272727272727273,14,8,6,346.10679511175516,0.41011904761904766,0.07501683048337204,0.18453231638872963,127632.76643990926,1834.913548752831,129467.67998866209,432,2,200.65714285714284,34,1,17,38.637635485391144,0.6004901960784313,47.38095238095238,1010.4761904761901,29.719887955182063,0
435,4,2,0,37,0.05405405405405406,0.0,1.0,37,1050,700,350,0.6666666666666666,14,7,7,328.40225098242144,0.4190127627627627,0.06651815901247282,0.17721437658215652,128116.77781865583,1014.7676448522739,129131.5454635081,433,0,190.75675675675674,37,0,19,38.590630528177925,0.5993806306306306,46.90241228070176,1012.3903508771937,27.36190137505929,0
436,4,1,0,38,0.02631578947368421,0.0,1.0,38,1200,900,300,0.75,15,9,6,319.004613779917,0.4223713845424372,0.06758049636100671,0.17322212929224412,128366.66690712537,589.9148055170972,128956.58171264247,434,0,186.71052631578948,37,1,21,38.57390175286735,0.6019144144144144,46.65570175438597,1013.377192982457,27.388572783309648,0
437,4,1,3,36,0.02564102564102564,0.07692307692307693,0.9230769230769231,39,500,400,100,0.8,6,4,2,313.2035433034503,0.426984930274404,0.07483604809076017,0.1714405792941135,128685.96734832713,260.98018938563666,128946.94753771277,435,0,182.89743589743588,38,1,13,38.39611631743356,0.6033442982456141,46.340811965811966,1014.6367521367522,26.70096716149348,0
438,4,0,0,36,0.0,0.0,1.0,36,1150,900,250,0.782608695652174,14,9,5,335.89455597181575,0.4154761904761905,0.07540388320735136,0.18203056780255739,128287.09621783937,1418.1874442009462,129705.28366204031,436,1,199.0,36,0,19,38.22717504075884,0.6030092592592593,46.73423423423423,1013.0630630630624,28.140640640640623,0
439,4,0,0,36,0.0,0.0,1.0,36,1000,600,400,0.6,14,6,8,336.2560493827164,0.4145833333333333,0.07879629629629648,0.1827478529253891,128401.20525931318,1435.1364032951697,129836.34166260835,437,2,200.0,36,0,14,38.10162037037038,0.6041666666666667,46.621621621621614,1013.5135135135121,28.153153153153113,0
440,4,1,1,36,0.02702702702702703,0.02702702702702703,0.972972972972973,37,1300,900,400,0.6923076923076923,17,9,8,329.86829384835943,0.4163538538538538,0.08032489657206132,0.18100716041222648,128783.68975309697,1096.3312028701012,129880.02095596708,438,0,195.56756756756758,37,0,15,37.87392873861222,0.6061373873873874,46.244517543859644,1015.0219298245603,27.43302513039352,0
441,4,0,0,36,0.0,0.0,1.0,36,1050,800,250,0.7619047619047619,13,8,5,334.14629187376045,0.41223544973544973,0.08756748761186306,0.18343451126370752,128800.98637488841,1407.6743973703428,130208.66077225875,439,1,201.77777777777777,36,0,15,37.747762739442365,0.6082175925925926,46.22747747747748,1015.0900900900901,28.196946946946948,0
442,4,2,0,38,0.05263157894736842,0.0,1.0,38,700,500,200,0.7142857142857143,9,5,4,317.4605224172723,0.4174223565670934,0.08463682054174271,0.17641019923467646,129282.86540516079,608.4411982248282,129891.30660338562,440,0,192.10526315789474,38,0,19,37.68187309591345,0.609375,45.75320512820512,1016.9871794871772,26.76282051282045,0
443,4,2,2,38,0.05,0.05,0.95,40,900,600,300,0.6666666666666666,12,6,6,307.7316405718043,0.422275641025641,0.11261714855433747,0.17359664538443156,129873.84018276139,-6.742018639715525,129867.09816412166,441,0,183.45,40,0,15,37.33092389498173,0.6119791666666667,45.17276422764227,1019.3089430894292,25.48272357723573,0
444,4,2,0,40,0.05,0.0,1.0,40,1150,900,250,0.782608695652174,14,9,5,308.8650701183147,0.42252938034188037,0.12203596692238738,0.17504679326807002,130055.18297846832,33.90064197896052,130089.08362044729,442,0,184.35,40,0,17,37.118702467536785,0.6138020833333333,44.99491869918698,1020.0203252032506,25.500508130081265,0
445,4,1,1,40,0.024390243902439025,0.024390243902439025,0.975609756097561,41,1150,800,350,0.6956521739130435,15,8,7,301.4841796566092,0.4243394308943089,0.12121966149267704,0.17201093882386959,130315.76063368034,-342.0414706957913,129973.71916298455,443,0,180.82926829268294,39,2,19,37.04388560157792,0.6180555555555556,44.73958333333332,1021.0416666666649,26.18055555555551,0
446,4,0,2,38,0.0,0.05,0.95,40,950,700,250,0.7368421052631579,12,7,5,348.77018575093757,0.4229567307692308,0.0817005891805036,0.20234740111777527,130963.11034404818,1155.6266711872909,132118.73701523547,444,1,186.225,37,3,18,35.1815524013569,0.6280968468468469,44.10635964912281,1023.5745614035088,27.66417733522997,8
447,4,0,1,37,0.0,0.02631578947368421,0.9736842105263158,38,900,600,300,0.6666666666666666,12,6,6,362.1855609003949,0.41832622095779987,0.09221843653951534,0.2088950141067813,130735.62349965704,1870.1110253772267,132605.73452503426,445,3,196.94736842105263,35,3,18,35.0686585181832,0.6297619047619047,44.3287037037037,1022.685185185185,29.219576719576715,0
448,4,0,0,37,0.0,0.0,1.0,37,1100,500,600,0.45454545454545453,17,5,12,368.79033024458977,0.41397647647647645,0.11380330208100875,0.21412748479225063,130992.77388038566,2261.7736678004762,133254.54754818615,446,5,203.1891891891892,34,3,19,34.63920223281778,0.6344975490196079,44.07738095238096,1023.6904761904776,30.108543417366988,0
449,4,0,1,36,0.0,0.02702702702702703,0.972972972972973,37,750,400,350,0.5333333333333333,11,4,7,386.56554872291207,0.41397647647647645,0.056517388991615514,0.21371266346494702,129080.38548752855,2602.852182539706,131683.23767006825,447,6,204.1891891891892,34,3,19,36.13177522649172,0.6151960784313726,45.95238095238096,1016.1904761904779,29.88795518207288,8
450,4,0,0,36,0.0,0.0,1.0,36,1150,700,450,0.6086956521739131,16,7,9,385.05960100909834,0.411739417989418,0.07517009457648727,0.21369681950738867,129231.6485969389,2752.3774092970716,131984.02600623597,448,7,209.11111111111111,34,2,19,36.01549389220623,0.6167279411764706,45.80357142857144,1016.7857142857154,29.905462184873983,0
451,4,0,0,36,0.0,0.0,1.0,36,900,600,300,0.6666666666666666,12,6,6,383.7890328949341,0.41188822751322757,0.07656936965061534,0.2131551312736365,129261.9118480727,2721.8608276644172,131983.77267573713,449,8,210.11111111111111,34,2,19,36.01688714586748,0.6170343137254901,45.77380952380953,1016.904761904763,29.908963585434204,0
452,4,0,0,36,0.0,0.0,1.0,36,1000,700,300,0.7,13,7,6,382.3040727979783,0.4113260582010582,0.08102556101619984,0.2129837422510773,129383.00028344683,2692.7295918367504,132075.72987528358,450,9,211.11111111111111,34,2,19,35.93103986270381,0.6182598039215687,45.65476190476191,1017.3809523809534,29.9229691876751,0
453,4,1,1,36,0.02702702702702703,0.02702702702702703,0.972972972972973,37,1000,700,300,0.7,13,7,6,370.1281495680453,0.414695945945946,0.07950606519276238,0.2081941278369014,129760.92470689747,2205.6341896004988,131966.55889649797,451,0,206.3783783783784,35,2,18,35.85579253284864,0.6199404761904762,45.283564814814824,1018.8657407407422,29.110449735449777,0
454,4,0,0,36,0.0,0.0,1.0,36,700,500,200,0.7142857142857143,9,5,4,377.2809111811028,0.4130456349206349,0.10445625511038381,0.21263343519561695,129837.58680555562,2597.0486111111163,132434.63541666674,452,1,212.02777777777777,34,2,18,35.59553011719814,0.6228553921568627,45.208333333333336,1019.1666666666672,29.975490196078447,0
455,4,0,0,36,0.0,0.0,1.0,36,750,600,150,0.8,9,6,3,368.4857591694557,0.41335978835978837,0.09986225895316814,0.19385555156306133,127092.01388888874,2300.520833333315,129392.53472222206,453,2,213.02777777777777,33,3,20,38.62775482093662,0.5972222222222222,47.91666666666666,1008.3333333333321,30.555555555555518,8
456,4,1,1,36,0.02702702702702703,0.02702702702702703,0.972972972972973,37,1350,1000,350,0.7407407407407407,17,10,7,360.2048759090668,0.41769894894894893,0.0949739548465669,0.19062527702603405,127332.20663265295,1773.1363378684707,129105.34297052142,454,0,208.24324324324326,34,3,17,38.58983054179446,0.5974264705882353,47.67857142857142,1009.2857142857133,29.684873949579803,0
457,4,2,0,38,0.05263157894736842,0.0,1.0,38,1150,900,250,0.782608695652174,14,9,5,353.43327974697473,0.41807432432432434,0.1331205588341564,0.18974243642435853,127910.26341735243,1441.5487825788603,129351.81219993129,455,0,203.71052631578948,35,3,19,38.16838291380625,0.6011904761904762,47.106481481481474,1011.5740740740731,28.902116402116373,0
458,4,1,0,39,0.02564102564102564,0.0,1.0,39,1350,900,450,0.6666666666666666,18,9,9,346.1455604120998,0.4223178137651822,0.1153127998299408,0.1785951024415261,126298.39932838237,943.5260429348155,127241.92537131718,456,0,199.46153846153845,36,3,21,40.006488535364866,0.5827546296296297,48.70495495495495,1005.1801801801796,27.921671671671657,8
459,4,4,0,43,0.09302325581395349,0.0,1.0,43,1000,600,400,0.6,14,6,8,318.9958920237268,0.43170911775562937,0.1220517545956048,0.16793096624718065,127118.94729572984,-484.9444154527126,126634.00288027713,457,0,181.8139534883721,38,5,25,39.8477504679168,0.5874451754385965,47.88995726495725,1008.4401709401684,26.537899235267588,0
460,4,2,4,41,0.044444444444444446,0.08888888888888889,0.9111111111111111,45,750,400,350,0.5333333333333333,11,4,7,312.73806113141404,0.43596380471380475,0.14057942580603,0.16761576210166299,127843.36911848048,-1003.7025226757596,126839.66659580472,458,0,174.6888888888889,41,4,14,39.26574455562094,0.5899390243902439,47.17261904761904,1011.3095238095218,24.666085946573702,0
461,4,0,1,40,0.0,0.024390243902439025,0.975609756097561,41,1550,1300,250,0.8387096774193549,18,13,5,341.16497830976255,0.42812500000000003,0.13707518514002803,0.1802181475549044,127257.91229032002,483.1885772545321,127741.10086757455,459,1,192.6341463414634,37,4,23,39.1463812214736,0.5906531531531531,47.75219298245614,1008.9912280701748,27.270033191085805,0
462,4,2,0,42,0.047619047619047616,0.0,1.0,42,1450,1200,250,0.8275862068965517,17,12,5,326.44583472514864,0.4333744676732481,0.15083389932835267,0.1748619029809585,127820.2174761672,-54.724482248498475,127765.49299391871,460,0,188.11904761904762,38,4,20,38.942815636555736,0.5945723684210527,47.19551282051283,1011.2179487179503,26.61099865047238,0
463,4,0,0,42,0.0,0.0,1.0,42,1350,900,450,0.6666666666666666,18,9,9,327.812234446709,0.4334107626790554,0.14768543665882028,0.17594819930507066,127901.25739644995,-14.48060486519654,127886.77679158475,461,1,189.11904761904762,38,4,21,38.825517532741856,0.5953947368421053,47.11538461538463,1011.5384615384636,26.61943319838062,0
464,4,0,1,41,0.0,0.023809523809523808,0.9761904761904762,42,950,600,350,0.631578947368421,13,6,7,329.9600800724835,0.4332171893147503,0.14668717391959896,0.1778180772813831,128063.41428336647,51.1628862590664,128114.57716962554,462,2,190.11904761904762,38,4,22,38.60565758919147,0.5970394736842105,46.95512820512822,1012.1794871794893,26.636302294197087,0
465,4,2,0,43,0.046511627906976744,0.0,1.0,43,1100,800,300,0.7272727272727273,14,8,6,349.474623716987,0.43627722406792174,0.19696341282772956,0.18168051630320148,126607.70052596947,286.70590894145704,126894.40643491092,463,0,186.1627906976744,38,5,16,39.60456475583863,0.5822368421052632,48.397435897435884,1006.4102564102541,26.48448043184879,8
466,4,2,0,45,0.044444444444444446,0.0,1.0,45,1150,900,250,0.782608695652174,14,9,5,342.4513682341334,0.4412247474747475,0.21295148928358398,0.18062630991172918,127197.07031249997,-287.3132910092056,126909.75702149076,464,0,178.84444444444443,39,6,19,39.17630455734546,0.5865384615384616,47.8125,1008.7499999999998,25.86538461538461,0
467,4,3,3,45,0.0625,0.0625,0.9375,48,950,600,350,0.631578947368421,13,6,7,339.9994562145734,0.44462913711583923,0.2523170303726394,0.18348730984141848,128120.0048074033,-887.8536070548737,127232.15120034842,465,0,168.60416666666666,42,6,18,38.293812212863706,0.5912698412698413,46.899224806201545,1012.4031007751929,24.10483573274269,0
468,4,0,0,45,0.0,0.0,1.0,45,1500,1200,300,0.8,18,12,6,356.3179707367912,0.4388047138047138,0.25132710964671423,0.19140266215684276,127933.6805555556,117.01388888889386,128050.6944444445,466,1,180.48888888888888,39,6,19,38.071457990115334,0.594017094017094,47.083333333333336,1011.6666666666671,25.94017094017095,0
469,4,0,0,45,0.0,0.0,1.0,45,1150,800,350,0.6956521739130435,15,8,7,389.47231808863137,0.43842592592592594,0.25757348392107304,0.20058180823588403,126223.21605725636,915.596655328813,127138.81271258518,467,2,181.48888888888888,34,11,18,38.99542905658887,0.5860906862745099,48.77976190476191,1004.8809523809534,29.55532212885157,8
470,4,1,2,44,0.021739130434782608,0.043478260869565216,0.9565217391304348,46,1250,900,350,0.72,16,9,7,379.52319465089107,0.44058977455716586,0.2717439937749242,0.19772362238805197,126694.89590942314,416.73032830129506,127111.62623772443,468,0,178.52173913043478,36,10,15,38.75862229679344,0.5868055555555556,48.31081081081082,1006.7567567567585,27.965465465465513,0
471,4,0,0,44,0.0,0.0,1.0,44,1450,1100,350,0.7586206896551724,18,11,7,399.8407939601732,0.4374889887244538,0.28825260055292024,0.20743121852408994,126522.46492346948,1317.7685657596462,127840.23348922913,469,1,187.5,34,10,16,38.42543288762672,0.5891544117647058,48.48214285714286,1006.0714285714294,29.590336134453803,0
472,4,2,1,45,0.043478260869565216,0.021739130434782608,0.9782608695652174,46,1000,700,300,0.7,13,7,6,390.71412509703543,0.4386171497584541,0.29338183624192293,0.2057061123111643,127122.90833153091,737.5803415728709,127860.48867310378,470,0,180.30434782608697,33,13,18,38.03558046745248,0.5975378787878788,47.88602941176469,1008.4558823529393,30.55926916221028,0
473,4,2,2,45,0.0425531914893617,0.0425531914893617,0.9574468085106383,47,1550,1300,250,0.8387096774193549,18,13,5,367.00219429234994,0.4410268270120259,0.2944135234870724,0.196311339077996,127763.95486379013,-22.069642704065473,127741.88522108606,471,0,177.17021276595744,35,12,17,37.97521942377409,0.5997023809523809,47.2511574074074,1010.995370370369,28.88558201058197,0
474,4,3,0,48,0.0625,0.0,1.0,48,1000,500,500,0.5,15,5,10,361.494807977033,0.4426159869976359,0.3160991773308961,0.1957798613499374,128261.74554183791,-326.24300733027536,127935.50253450763,472,0,174.375,35,13,20,37.60473796465569,0.6047619047619048,46.759259259259245,1012.9629629629611,28.94179894179889,0
475,4,0,0,48,0.0,0.0,1.0,48,1050,700,350,0.6666666666666666,14,7,7,357.73368948984137,0.4421357860520094,0.3079902396562586,0.19428156135902716,128372.67324334459,-415.35399419690964,127957.31924914768,473,1,175.375,36,12,17,37.58658369448459,0.6038773148148149,46.64977477477477,1013.4009009009,28.150025025025,0
476,4,1,0,49,0.02040816326530612,0.0,1.0,49,1250,800,450,0.64,17,8,9,355.97313821665716,0.4439306972789116,0.3179388614717946,0.195605654999883,128839.34389667971,-627.3308854647637,128212.01301121495,474,0,172.77551020408163,37,12,18,37.15472783237931,0.6067004504504505,46.18969298245614,1015.2412280701751,27.43895211000473,0
477,4,0,2,47,0.0,0.04081632653061224,0.9591836734693877,49,1300,700,600,0.5384615384615384,19,7,12,355.16229010142985,0.4437535430839002,0.3150079204735978,0.19570900019093046,128950.68825263533,-640.3156500077077,128310.37260262763,475,1,173.77551020408163,37,12,18,37.06176454712295,0.6078265765765766,46.080043859649116,1015.6798245614027,27.4508060692271,0
478,4,0,0,47,0.0,0.0,1.0,47,1750,1500,250,0.8571428571428571,20,15,5,369.08897534143864,0.4396392229417206,0.31205188490402636,0.20241033300619582,128760.5040750384,104.81650270059612,128865.320577739,476,2,182.0,35,12,18,36.90236914129319,0.6098214285714285,46.2673611111111,1014.9305555555541,28.99801587301583,0
479,4,1,0,48,0.020833333333333332,0.0,1.0,48,1700,1200,500,0.7058823529411765,22,12,10,361.681335418622,0.4402426861702127,0.31684710377671954,0.20071424569727972,129230.01284646147,-251.98327550522072,128978.02957095625,477,0,179.1875,36,12,19,36.611427991287336,0.6125578703703703,45.80518018018019,1016.7792792792803,28.243868868868898,0
480,4,0,2,46,0.0,0.041666666666666664,0.9583333333333334,48,1650,1300,350,0.7878787878787878,20,13,7,361.2949363212953,0.439808658392435,0.3151889159471617,0.20122925121618931,129373.1801903258,-251.62502029052763,129121.55517003528,478,1,180.1875,36,12,20,36.47539849457604,0.6140046296296297,45.66441441441443,1017.3423423423451,28.259509509509584,0
481,4,0,0,46,0.0,0.0,1.0,46,1650,1400,250,0.8484848484848485,19,14,5,375.90701424348265,0.4392713365539453,0.31699928724162496,0.20845752608047707,129201.38888888904,513.5416666666854,129714.93055555572,479,2,185.06521739130434,34,12,20,36.27903005464481,0.616421568627451,45.83333333333334,1016.6666666666679,29.90196078431376,0
482,4,0,0,46,0.0,0.0,1.0,46,1500,1100,400,0.7333333333333333,19,11,8,375.8501925261959,0.4382850241545894,0.3211508711936162,0.20906666959269674,129322.448979592,521.1734693877731,129843.62244897976,480,3,186.06521739130434,34,12,20,36.15695224719101,0.6176470588235294,45.71428571428572,1017.1428571428584,29.915966386554658,0
483,4,1,0,47,0.02127659574468085,0.0,1.0,47,1550,1000,550,0.6451612903225806,21,10,11,335.8455876072154,0.44014030218933087,0.1732025777025592,0.18160184397768317,128198.62349559828,-785.6066887088338,127413.01680688944,481,0,183.08510638297872,38,9,15,38.31869571333121,0.5984100877192983,46.82158119658118,1012.7136752136722,26.650359874044007,7
484,4,0,0,47,0.0,0.0,1.0,47,1150,800,350,0.6956521739130435,15,8,7,330.05630068352787,0.4405835646006784,0.1626202878078924,0.16924163503134096,126043.83680555565,-1041.9490558112311,125001.88774974442,482,1,184.08510638297872,37,10,18,40.672544951590574,0.5782657657657657,48.958333333333336,1004.1666666666674,27.13963963963966,8
485,4,4,3,48,0.0784313725490196,0.058823529411764705,0.9411764705882353,51,1350,1000,350,0.7407407407407407,17,10,7,309.9368370577607,0.44849673202614376,0.19175128721230905,0.16285771983580516,127043.16522444566,-2324.9286401057625,124718.2365843399,483,0,170.5686274509804,42,9,18,40.15362681020119,0.5803571428571428,47.96511627906977,1008.1395348837211,24.00332225913622,0
486,4,1,0,49,0.02040816326530612,0.0,1.0,49,1600,1200,400,0.75,20,12,8,319.4666195809641,0.44874929138322,0.20083555008452403,0.16828486456925448,127144.53667534741,-1676.2941551082217,125468.24252023919,484,0,169.87755102040816,39,10,20,39.809698409419546,0.5860042735042735,47.86458333333334,1008.5416666666682,25.860042735042775,0
487,4,1,0,50,0.02,0.0,1.0,50,1650,1200,450,0.7272727272727273,21,12,9,316.6754467999361,0.4490476190476191,0.20776380645810266,0.1686165300823873,127579.22620670596,-1919.758307720236,125659.46789898573,485,0,167.46,40,10,15,39.43579619756568,0.5888020833333334,47.43394308943091,1010.2642276422788,25.25660569105697,0
488,4,1,1,50,0.0196078431372549,0.0196078431372549,0.9803921568627451,51,1150,700,450,0.6086956521739131,16,7,9,314.6396536091893,0.4501470588235294,0.22594019953999678,0.16884557411575246,127893.53820231807,-2151.9242882337953,125741.61391408427,486,0,165.15686274509804,41,10,17,39.16650320387081,0.5904471544715447,47.12301587301588,1011.5079365079374,24.670925280681402,0
489,4,0,0,50,0.0,0.0,1.0,50,1450,1100,350,0.7586206896551724,18,11,7,321.0131299045709,0.447687074829932,0.21644292604501625,0.17212945413848554,127861.72251966437,-1790.9416517945494,126070.78086786982,487,1,169.4,40,10,17,39.03779809753485,0.5916666666666667,47.154471544715456,1011.3821138211393,25.284552845528484,0
490,4,1,0,51,0.0196078431372549,0.0,1.0,51,1400,800,600,0.5714285714285714,20,8,12,315.47761456044014,0.4474346405228758,0.2167041155345586,0.17078613174242305,128244.99736237102,-2108.314830561838,126136.68253180919,488,0,167.05882352941177,41,10,21,38.78713679399282,0.5940040650406504,46.77579365079366,1012.8968253968267,24.704800619434796,0
491,4,0,0,51,0.0,0.0,1.0,51,1200,600,600,0.5,18,6,12,315.53372755375005,0.4472875816993464,0.2091605632072715,0.17146237024942115,128395.77034517539,-2097.360796170292,126298.4095490051,489,1,168.05882352941177,41,10,16,38.6322109109893,0.5955284552845528,46.62698412698414,1013.4920634920659,24.719318621757704,0
492,4,0,1,50,0.0,0.0196078431372549,0.9803921568627451,51,1600,1100,500,0.6875,21,11,10,318.1532003674763,0.4475490196078431,0.20184623413902236,0.17321297573549513,128471.19005298894,-2025.2959459246485,126445.89410706429,490,2,169.05882352941177,41,10,16,38.48906856509118,0.5962906504065041,46.552579365079374,1013.7896825396838,24.726577622919116,0
493,4,1,1,50,0.0196078431372549,0.0196078431372549,0.9803921568627451,51,1500,1100,400,0.7333333333333333,19,11,8,324.5296551955621,0.44764705882352945,0.2190925837536113,0.17780470503456935,128722.74900990516,-1845.1301295981007,126877.61888030707,491,0,170.0,41,10,18,38.07139423860267,0.5988313008130082,46.30456349206351,1014.7817460317482,24.750774293457273,0
494,4,4,5,49,0.07407407407407407,0.09259259259259259,0.9074074074074074,54,1800,1300,500,0.7222222222222222,23,13,10,303.90428547662407,0.4505008152806895,0.23978565109976313,0.17033227392393824,129620.41348363973,-2919.7837085140072,126700.62977512572,492,0,161.12962962962962,42,12,14,37.684762267262975,0.6063988095238095,45.42151162790697,1018.3139534883715,24.2455703211517,0
495,4,1,0,50,0.02,0.0,1.0,50,1200,900,300,0.75,15,9,6,330.11147754318654,0.4463095238095238,0.25500857959961865,0.18283365361288423,129152.1364776756,-1473.0794798990494,127679.05699777654,493,0,165.6,42,8,23,37.49304893549412,0.6016865079365079,45.88178294573643,1016.472868217054,24.201734957548904,0
496,4,0,1,49,0.0,0.02,0.98,50,1500,800,700,0.5333333333333333,22,8,14,333.58698059424614,0.4463690476190476,0.264022275927289,0.18511646030993759,129228.5448740772,-1378.170423934672,127850.37445014252,494,1,166.6,38,12,23,37.32706385065321,0.6088267543859649,45.8066239316239,1016.7735042735,26.757197480881576,0
497,4,0,0,49,0.0,0.0,1.0,49,2150,1900,250,0.8837209302325582,24,19,5,344.5393203505291,0.44488732993197283,0.27768383508990335,0.19228318894607696,129452.33298947758,-879.7162348030039,128572.61675467457,495,2,170.46938775510205,37,12,15,36.82108160040225,0.6128941441441442,45.58662280701755,1017.6535087719302,27.504148885727844,0
498,4,0,0,49,0.0,0.0,1.0,49,1400,900,500,0.6428571428571429,19,9,10,343.4140428111143,0.44435586734693877,0.2861625270263146,0.1926104848810165,129647.68005540186,-895.4332102185034,128752.24684518336,496,3,171.46938775510205,37,12,16,36.65123456790124,0.6148648648648649,45.394736842105274,1018.4210526315804,27.524893314367038,0
499,4,0,1,48,0.0,0.02040816326530612,0.9795918367346939,49,1550,900,650,0.5806451612903226,22,9,13,342.5528786041658,0.4437712585034013,0.27812353581751403,0.19300720076817132,129826.69850107768,-905.4981417561305,128921.20035932155,497,4,172.46938775510205,38,11,17,36.49142118321279,0.6148574561403508,45.219017094017104,1019.123931623933,26.819050832208763,0
500,4,1,0,49,0.02040816326530612,0.0,1.0,49,1550,800,750,0.5161290322580645,23,8,15,346.2489308590638,0.4440547052154195,0.29268876749232975,0.19590670095137916,129990.07100820022,-798.2153782233657,129191.85562997685,498,0,173.3673469387755,38,11,21,36.231447529247426,0.6165021929824561,45.058760683760696,1019.7649572649589,26.835919928025234,0
501,4,1,1,49,0.02,0.02,0.98,50,1800,1100,700,0.6111111111111112,25,11,14,342.15244050765693,0.4452465986394558,0.3004190098136508,0.19552492016155926,130377.57087746548,-1077.3431167954095,129300.22776067007,499,0,170.88,36,14,22,35.94318557724116,0.6241319444444444,44.67905405405406,1021.2837837837852,28.368993993994035,0
502,4,0,2,47,0.0,0.04081632653061224,0.9591836734693877,49,1450,1000,450,0.6896551724137931,19,10,9,351.68679716784646,0.44490504535147396,0.3048729695960011,0.2003796867584245,130262.58680555578,-637.673611111087,129624.9131944447,500,1,174.81632653061226,38,11,22,35.81632653061225,0.6192434210526316,44.79166666666668,1020.8333333333352,26.864035087719348,0
503,4,0,0,47,0.0,0.0,1.0,47,1150,800,350,0.6956521739130435,15,8,7,361.5480984703921,0.44393694110391607,0.2990797826603977,0.20511240903466652,130094.74068944302,7.10122345338354,130101.8419128964,501,2,178.48936170212767,37,10,22,35.7350781026082,0.6193693693693694,44.9561403508772,1020.1754385964922,27.572309151256547,0
504,4,0,0,47,0.0,0.0,1.0,47,1250,1100,150,0.88,14,11,3,368.4347062956503,0.4440140302189331,0.27302955752337876,0.20066652515303932,128486.82032962017,68.12540131469379,128554.94573093487,502,3,179.48936170212767,36,11,17,37.198711540597586,0.6050347222222222,46.53716216216216,1013.8513513513514,28.16253753753754,8
505,4,1,0,48,0.020833333333333332,0.0,1.0,48,1800,1300,500,0.7222222222222222,23,13,10,360.6363488353381,0.44580193557919623,0.2659313725490202,0.19821441428468578,128848.62075617284,-306.50077160493476,128542.11998456791,503,0,176.72916666666666,38,10,18,37.02690378476973,0.6049890350877193,46.18055555555556,1015.2777777777777,26.71783625730994,0
506,4,0,1,47,0.0,0.020833333333333332,0.9791666666666666,48,1500,1100,400,0.7333333333333333,19,11,8,407.62756354891656,0.44571882387706857,0.3903463648834016,0.22011888431641516,128144.53125000015,928.067129629644,129072.5983796298,504,1,177.72916666666666,34,14,19,36.55692729766804,0.6056985294117647,46.87500000000001,1012.5000000000011,29.779411764705916,8
507,4,1,0,48,0.020833333333333332,0.0,1.0,48,1950,1400,550,0.717948717948718,25,14,11,405.72008127241855,0.44739952718676124,0.39607950166966344,0.22090465404105275,128474.33302137595,824.9233669704952,129299.25638834645,505,0,178.3125,31,17,18,36.266482575562975,0.616263440860215,46.54947916666667,1013.802083333334,32.70329301075271,0
508,4,1,0,49,0.02040816326530612,0.0,1.0,49,1300,700,600,0.5384615384615384,19,7,12,398.66785594225667,0.44965277777777773,0.3979949010382673,0.21917473035710638,128858.9894061177,474.3874050845693,129333.37681120227,506,0,175.6530612244898,33,16,19,36.050970629651985,0.6152146464646464,46.170343137254896,1015.3186274509793,30.76723113487816,0
509,4,0,0,49,0.0,0.0,1.0,49,1850,1200,650,0.6486486486486487,25,12,13,397.99444698812744,0.4496350623582766,0.3908189104654278,0.22018465302685397,129107.96215698287,476.8504000864981,129584.81255706937,507,1,176.6530612244898,33,16,20,35.8132109409542,0.617739898989899,45.92524509803921,1016.2990196078431,30.796939988116456,0
510,4,0,0,49,0.0,0.0,1.0,49,1500,900,600,0.6,21,9,12,399.0175357719901,0.4490681689342404,0.392983220855708,0.22145335737917532,129233.48263251198,513.318946941403,129746.80157945339,508,2,177.6530612244898,32,17,20,35.658812450846476,0.6214192708333333,45.801767676767675,1016.7929292929292,31.774779040404038,0
511,4,0,0,49,0.0,0.0,1.0,49,1600,1100,500,0.6875,21,11,10,397.3766874727829,0.44954648526077096,0.39186624047209273,0.22106075777641387,129326.01042868115,478.2283256439685,129804.23875432512,509,3,178.6530612244898,33,16,20,35.6059236947791,0.619949494949495,45.71078431372548,1017.156862745097,30.82293523469991,0
512,4,0,0,49,0.0,0.0,1.0,49,1200,1000,200,0.8333333333333334,14,10,4,401.942656963265,0.44959963151927435,0.39933439351893973,0.22413229555177888,129419.51600646382,603.8448253075708,130023.3608317714,510,4,179.6530612244898,33,16,20,35.3942099241238,0.6208964646464646,45.618872549019606,1017.5245098039213,30.834076054664283,0
513,4,1,1,49,0.02,0.02,0.98,50,1350,800,550,0.5925925925925926,19,8,11,391.726700445926,0.450671768707483,0.39903470842584987,0.22009227680340032,129716.28578514735,162.66652494330327,129878.95231009065,511,0,177.04,34,16,19,35.35117447703634,0.6216299019607843,45.32738095238095,1018.6904761904759,29.961484593837525,0
514,4,0,0,49,0.0,0.0,1.0,49,1200,900,300,0.75,15,9,6,392.2122603732494,0.4500602324263039,0.39148670333888935,0.2207064258076688,129776.92920918371,380.0205498866284,130156.94975907034,512,1,177.26530612244898,34,15,19,35.27695018888499,0.6222426470588236,45.267857142857146,1018.9285714285717,29.96848739495799,0
515,4,0,0,49,0.0,0.0,1.0,49,1200,1000,200,0.8333333333333334,14,10,4,393.920293742355,0.44982993197278914,0.38804106416036777,0.22252858810089243,129928.59977324266,436.30243764172775,130364.9022108844,513,2,178.26530612244898,34,15,20,35.07876965592403,0.6237745098039216,45.11904761904762,1019.5238095238097,29.98599439775911,0
516,4,1,0,50,0.02,0.0,1.0,50,1800,1400,400,0.7777777777777778,22,14,8,386.74726377796776,0.44950680272108845,0.3935905044510388,0.2209047930392798,130359.27456381998,84.50468858341844,130443.7792524034,514,0,175.68,32,18,21,34.82319485657765,0.6328125,44.696969696969695,1021.2121212121209,31.91287878787878,0
517,4,2,0,52,0.038461538461538464,0.0,1.0,52,1350,1000,350,0.7407407407407407,17,10,7,370.5206206424788,0.4511610734037204,0.39551216840128367,0.21551584029086168,131061.33355034707,-687.8146701389078,130373.51888020817,515,0,169.8846153846154,35,17,20,34.52547473719905,0.6330357142857144,44.01041666666666,1023.9583333333321,29.255952380952348,0
518,4,0,1,51,0.0,0.019230769230769232,0.9807692307692307,52,1400,1000,400,0.7142857142857143,18,10,8,368.29759646538156,0.450862556561086,0.3927410311465007,0.21455335293760106,131120.59709630048,-741.7198484653751,130378.8772478351,516,1,170.8846153846154,35,17,20,34.522380118280786,0.6336309523809525,43.95254629629629,1024.189814814814,29.262566137566118,0
519,4,1,1,51,0.019230769230769232,0.019230769230769232,0.9807692307692307,52,1000,600,400,0.6,14,6,8,369.85777465410536,0.4519230769230769,0.3909329486600164,0.21596180878879545,131209.51753257882,-694.2279663923184,130515.28956618649,517,0,171.01923076923077,35,17,21,34.392416026510034,0.6345238095238095,43.86574074074074,1024.5370370370367,29.272486772486765,0
520,4,1,0,52,0.019230769230769232,0.0,1.0,52,1350,900,450,0.6666666666666666,18,9,9,372.78730543004116,0.4508154223227752,0.39654466872040084,0.21852598527836675,131359.53006355732,-606.0597816574584,130753.47028189986,518,0,171.8846153846154,33,19,22,34.16554592548315,0.6404671717171717,43.71936274509804,1025.122549019608,31.064319667260847,0
521,4,0,0,52,0.0,0.0,1.0,52,1150,800,350,0.6956521739130435,15,8,7,376.49663444775194,0.45090969079939663,0.3993250507705175,0.22179122638720125,131548.0392907775,-494.5211877643272,131053.51810301316,519,1,172.8846153846154,33,19,22,33.879738581611136,0.6423611111111112,43.53553921568627,1025.8578431372543,31.086601307189525,0
522,4,0,0,52,0.0,0.0,1.0,52,1400,900,500,0.6428571428571429,19,9,10,376.92238253996595,0.4504069255907491,0.40243635844494285,0.22271746812042814,131663.90483276645,-474.5854591836652,131189.31937358278,520,2,173.8846153846154,34,18,19,33.75164327417548,0.6412377450980392,43.42261904761905,1026.3095238095239,30.185574229691877,0
523,4,1,1,52,0.018867924528301886,0.018867924528301886,0.9811320754716981,53,1200,1000,200,0.8333333333333334,14,10,4,367.33935095464346,0.4513788098693759,0.3984487246010695,0.21927444448417477,132050.5402995901,-898.5280466277159,131152.0122529624,521,0,171.58490566037736,36,17,21,33.60724590044191,0.6409143518518519,43.04617117117117,1027.815315315315,28.550425425425416,0
524,4,0,1,51,0.0,0.019230769230769232,0.9807692307692307,52,1550,1000,550,0.6451612903225806,21,10,11,376.6252739225715,0.45068187531422826,0.41185031185031207,0.22476024411508283,132040.89506172828,-454.01234567902225,131586.88271604927,522,1,175.80769230769232,35,17,21,33.37837837837838,0.6428571428571428,43.05555555555555,1027.777777777777,29.36507936507934,0
525,4,1,2,50,0.019230769230769232,0.038461538461538464,0.9615384615384616,52,1250,900,350,0.72,16,9,7,372.625806476103,0.45156957013574656,0.4106558795535178,0.2241301366422566,132338.45191400874,-537.4555255487139,131800.99638846001,523,0,175.65384615384616,35,17,22,33.18100862392201,0.6458333333333333,42.766203703703695,1028.9351851851839,29.39814814814811,0
526,4,0,1,49,0.0,0.02,0.98,50,1400,1000,400,0.7142857142857143,18,10,8,379.8925833862185,0.4514200680272109,0.40144411015968506,0.22830540372904704,132306.1295351472,52.42346938773329,132358.55300453492,524,1,178.8,34,16,22,33.02669135231043,0.647671568627451,42.79761904761904,1028.8095238095223,30.259103641456537,0
527,4,0,1,48,0.0,0.02040816326530612,0.9795918367346939,49,1300,1100,200,0.8461538461538461,15,11,4,379.58319794304384,0.45128259637188206,0.38885398388473535,0.22907045246703428,132462.98408644524,256.2083972324788,132719.19248367773,525,2,178.3469387755102,32,17,23,32.876446297886275,0.6539713541666667,42.64520202020202,1029.4191919191917,32.16934974747474,0
528,4,0,0,48,0.0,0.0,1.0,48,1800,1500,300,0.8333333333333334,21,15,6,383.06628658353804,0.45105644208037826,0.3892796181565312,0.23180346293719986,132565.56404961474,556.2796698676166,133121.84371948236,526,3,179.70833333333334,31,17,23,32.68336178193619,0.6575940860215054,42.545572916666664,1029.817708333333,33.21992607526881,0
529,4,0,0,48,0.0,0.0,1.0,48,1250,900,350,0.72,16,9,7,386.67683431895347,0.45065011820330975,0.39273716247525203,0.2348253100511037,132699.6888054743,662.3791164822238,133362.0679219565,527,4,180.70833333333334,31,17,19,32.455163444121496,0.6589381720430108,42.41536458333334,1030.3385416666677,33.23672715053767,0
530,4,0,1,47,0.0,0.020833333333333332,0.9791666666666666,48,1050,700,350,0.6666666666666666,14,7,7,387.34940594872506,0.45025302895981084,0.393786997346397,0.2361992456737374,132853.20255905026,692.1218179267638,133545.32437697702,528,5,181.70833333333334,32,16,19,32.28311900387834,0.6578776041666667,42.26641414141415,1030.9343434343448,32.216698232323274,0
531,4,0,1,46,0.0,0.02127659574468085,0.9787234042553191,47,1300,700,600,0.5384615384615384,19,7,12,395.99281984720545,0.44806120875732347,0.4036398915342423,0.24134527750041018,132833.88137817394,1120.2526516384692,133954.1340298124,529,6,186.4255319148936,31,16,20,32.07983348069555,0.6602822580645161,42.28515625000001,1030.859375000001,33.253528225806484,0
532,4,1,0,47,0.02127659574468085,0.0,1.0,47,1450,1100,350,0.7586206896551724,18,11,7,391.32377031361995,0.4492368177613321,0.3914924841082541,0.24113447399054025,133243.9949526834,1028.3084953066011,134272.30344799,502,0,176.14893617021278,32,15,21,31.787075537075545,0.6617838541666667,41.88762626262626,1032.449494949495,32.264046717171716,0
533,4,0,0,47,0.0,0.0,1.0,47,1250,800,450,0.64,17,8,9,392.5468474285347,0.4489284613012643,0.3933998069784319,0.24231250302777246,133309.18281616672,1066.0198895520834,134375.2027057188,503,1,177.14893617021278,32,15,21,31.68989689041039,0.6624348958333333,41.82449494949495,1032.70202020202,32.27193813131313,0
534,4,0,1,46,0.0,0.02127659574468085,0.9787234042553191,47,1300,900,400,0.6923076923076923,17,9,8,391.70022300653284,0.44809975331483193,0.39274068141275364,0.24242747538876344,133406.99450311193,1051.1098995000505,134458.104402612,504,2,178.14893617021278,32,15,21,31.613348407072433,0.6634114583333333,41.72979797979798,1033.080808080808,32.28377525252525,0
535,4,0,2,44,0.0,0.043478260869565216,0.9565217391304348,46,1500,1200,300,0.8,18,12,6,400.7542929409076,0.4472624798711755,0.40287424690126294,0.24734492586103787,133304.0894402397,1484.4372219509448,134788.52666219065,505,3,182.7173913043478,31,15,22,31.483130542596577,0.664986559139785,41.82942708333333,1032.6822916666658,33.312331989247284,0
536,4,0,0,44,0.0,0.0,1.0,44,1300,700,600,0.5384615384615384,19,7,12,416.75461072712767,0.44524092670894994,0.3959793738760238,0.2561541366677651,133149.5008680553,2298.133680555521,135447.63454861083,506,4,188.6590909090909,29,15,22,31.226029471134442,0.6691810344827587,41.97916666666665,1032.0833333333312,35.589080459770045,0
537,4,0,0,44,0.0,0.0,1.0,44,1250,800,450,0.64,17,8,9,416.5986408094546,0.4444921599718112,0.3985296814819348,0.25704654725462983,133292.88435570966,2305.9268904320716,135598.81124614173,507,5,189.6590909090909,29,15,22,31.08537883882538,0.670617816091954,41.840277777777764,1032.638888888887,35.60823754789266,0
538,4,0,1,43,0.0,0.022727272727272728,0.9772727272727273,44,1300,1000,300,0.7692307692307693,16,10,6,395.45866509429317,0.44384249471458775,0.35582566009817795,0.23006434048000055,131068.54056336741,1566.4380174093037,132634.97858077672,508,6,190.6590909090909,36,8,18,33.87977015286485,0.6310763888888888,44.00337837837838,1023.9864864864865,28.44406906906907,8
539,4,0,1,42,0.0,0.023255813953488372,0.9767441860465116,43,1250,700,550,0.56,18,7,11,401.8603115016238,0.44292174234034704,0.3476596997350605,0.23392500237936614,131090.9636488339,1936.0510973936748,133027.01474622756,509,7,194.86046511627907,35,8,18,33.69311332127788,0.6333333333333333,43.981481481481474,1024.074074074073,29.259259259259228,0
540,4,0,0,42,0.0,0.0,1.0,42,1350,1100,250,0.8148148148148148,16,11,5,399.89424284486756,0.44192799070847855,0.3344947735191639,0.23422377080913667,131328.125,2103.6865569272977,133431.8115569273,510,8,190.57142857142858,33,9,18,33.50271002710027,0.6401515151515151,43.75,1025.0,31.060606060606062,0
541,4,1,1,42,0.023255813953488372,0.023255813953488372,0.9767441860465116,43,1500,1000,500,0.6666666666666666,20,10,10,390.0056443228775,0.4431063122923588,0.33173044507792815,0.2308180282083853,131725.001771542,1674.6988378684869,133399.7006094105,511,0,187.11627906976744,34,9,19,33.35411109822567,0.6418504901960784,43.36309523809524,1026.5476190476195,30.192577030812338,0
542,4,0,0,42,0.0,0.0,1.0,42,1500,1000,500,0.6666666666666666,20,10,10,399.20046335486734,0.44346447928765004,0.33092537313432824,0.2359424051232898,131673.78720023562,2112.8473724048617,133786.63457264047,512,1,186.57142857142858,33,9,19,33.1700248756219,0.6436237373737373,43.41299019607844,1026.3480392156873,31.101455733808706,0
543,4,0,1,41,0.0,0.023809523809523808,0.9761904761904762,42,1500,1200,300,0.8,18,12,6,399.01098988295973,0.4425450058072009,0.326253521126761,0.23718838146090207,131892.24222232937,2125.2908254029476,134017.53304773232,513,2,187.57142857142858,35,7,19,32.953638497652584,0.6413690476190477,43.20023148148148,1027.199074074074,29.348544973544968,0
544,4,0,0,41,0.0,0.0,1.0,41,1000,700,300,0.7,13,7,6,405.8146812214459,0.44275914634146346,0.3185913764782713,0.24094723020629152,131847.23816609988,2501.1089852607884,134348.34715136068,514,3,190.0487804878049,34,7,19,32.82451412232914,0.6430759803921569,43.24404761904763,1027.0238095238105,30.20658263305325,0
545,4,0,0,41,0.0,0.0,1.0,41,1200,800,400,0.6666666666666666,16,8,8,412.471761144621,0.4426575203252032,0.3068319475995973,0.23174792252885928,129716.2857851476,2500.860969387778,132217.14675453538,515,4,191.0487804878049,34,7,18,34.822854582992484,0.6216299019607843,45.32738095238096,1018.6904761904779,29.961484593837582,8
546,4,0,1,40,0.0,0.024390243902439025,0.975609756097561,41,1300,1000,300,0.7692307692307693,16,10,6,419.15169661964427,0.4426575203252032,0.3116414274244894,0.23701710187542155,129967.37423911184,2695.209083504802,132662.58332261664,516,5,192.0487804878049,35,6,18,34.39604615966704,0.6220238095238095,45.08101851851852,1019.6759259259263,29.133597883597893,0
547,4,1,0,41,0.024390243902439025,0.0,1.0,41,1000,700,300,0.7,13,7,6,415.5182167644335,0.44273373983739833,0.3270543919862603,0.23656908674277205,130233.05047850225,2622.840979723943,132855.8914582262,517,0,192.90243902439025,35,6,19,34.217433004497884,0.624702380952381,44.820601851851855,1020.7175925925927,29.16335978835979,0
548,4,1,0,42,0.023809523809523808,0.0,1.0,42,1100,600,500,0.5454545454545454,16,6,10,404.49278295007224,0.4437548393341076,0.32363705934219533,0.23264430858622015,130627.42524092959,2167.5768510207445,132795.00209195033,518,0,189.28571428571428,34,8,20,34.097084740499184,0.6308210784313726,44.4345238095238,1022.2619047619038,30.066526610644228,0
549,4,0,0,42,0.0,0.0,1.0,42,1150,500,650,0.43478260869565216,18,5,13,401.8215918666708,0.44295634920634924,0.31794803582513054,0.2320195643359164,130779.59183673467,2110.012755102038,132889.60459183672,519,1,190.28571428571428,34,8,20,34.01056215083799,0.6323529411764706,44.285714285714285,1022.8571428571427,30.08403361344537,0
550,4,0,0,42,0.0,0.0,1.0,42,1350,1200,150,0.8888888888888888,15,12,3,398.1342568249737,0.4422304490902052,0.3116349457674954,0.23068827646437834,130913.23329260953,2024.2085691014856,132937.441861711,520,2,191.28571428571428,35,7,20,33.969030385282366,0.631547619047619,44.15509259259258,1023.379629629628,29.23941798941794,0
551,4,0,0,42,0.0,0.0,1.0,42,1100,800,300,0.7272727272727273,14,8,6,397.5350082600809,0.4415771389856756,0.3104195148524702,0.23092592716245364,131010.89000740617,2016.2830482509648,133027.17305565713,521,3,192.28571428571428,36,6,20,33.88516114838851,0.6304976851851851,44.05968468468469,1023.7612612612622,28.43781281281284,0
552,4,0,0,42,0.0,0.0,1.0,42,800,600,200,0.75,10,6,4,401.9533595808218,0.4415529423151374,0.3117489986648865,0.2341938376289287,131126.20380092936,2141.323629372622,133267.52743030197,522,4,193.28571428571428,36,6,20,33.6549386109584,0.6316550925925926,43.947072072072075,1024.211711711712,28.450325325325334,0
553,4,0,0,42,0.0,0.0,1.0,42,1600,1300,300,0.8125,19,13,6,402.6711868340592,0.4414198606271777,0.3150961956038323,0.23567269912390806,131299.269603218,2174.0865443145744,133473.35614753258,523,5,194.28571428571428,36,6,20,33.460837636889714,0.6333912037037037,43.77815315315315,1024.8873873873868,28.469094094094075,0
554,4,1,1,42,0.023255813953488372,0.023255813953488372,0.9767441860465116,43,850,500,350,0.5882352941176471,12,5,7,394.43155452436224,0.4428525286083425,0.3171909566718829,0.23287671232876717,131633.36167800444,1784.0798059849637,133417.44148398942,524,0,190.74418604651163,34,9,18,33.33333333333334,0.6409313725490196,43.45238095238095,1026.1904761904755,30.18207282913163,0
555,4,0,0,42,0.0,0.0,1.0,42,1200,1000,200,0.8333333333333334,14,10,4,399.8223772980266,0.4415529423151374,0.31029684601113194,0.2368178696303697,131755.5555555556,2135.7638888888946,133891.3194444445,525,1,187.16666666666666,34,8,18,33.07122564935065,0.642156862745098,43.333333333333336,1026.666666666667,30.19607843137256,0
556,4,1,1,42,0.023255813953488372,0.023255813953488372,0.9767441860465116,43,1450,900,550,0.6206896551724138,20,9,11,396.76968743911186,0.44266795865633074,0.30005659249699823,0.22167678725155968,129495.73072059329,1699.7808427640598,131195.51156335734,526,0,183.7906976744186,35,8,19,35.44793798802213,0.6172619047619048,45.54398148148148,1017.8240740740741,29.080687830687832,8
557,4,1,0,43,0.023255813953488372,0.0,1.0,43,1000,500,500,0.5,15,5,10,394.17670007086525,0.4434985234403839,0.31224707585347056,0.22188821402966108,129790.40745027442,1632.0709019204464,131422.47835219486,527,0,184.5581395348837,35,8,20,35.213160684537335,0.6202380952380953,45.25462962962963,1018.981481481482,29.113756613756628,0
558,4,0,0,43,0.0,0.0,1.0,43,1400,1100,300,0.7857142857142857,17,11,6,394.5616189205945,0.44326781100036916,0.3159750446009142,0.2234496777588869,130026.38996056248,1660.684585048021,131687.0745456105,528,1,185.5581395348837,35,8,20,34.962740202753814,0.6226190476190476,45.02314814814815,1019.907407407408,29.140211640211657,0
559,4,1,0,44,0.022727272727272728,0.0,1.0,44,1750,1500,250,0.8571428571428571,20,15,5,389.8437418199577,0.44254316420014095,0.3247209292746214,0.2234766592718563,130498.99798525378,1375.057870370367,131874.05585562414,529,0,182.3181818181818,35,9,19,34.602023863464716,0.6273809523809524,44.56018518518518,1021.7592592592594,29.193121693121697,0
560,4,0,2,42,0.0,0.045454545454545456,0.9545454545454546,44,1350,900,450,0.6666666666666666,18,9,9,359.2285328375576,0.44257619802677944,0.25302571860816947,0.19670419188631666,128700.23108071687,480.048835064129,129180.279915781,530,1,183.3181818181818,37,7,16,37.21408760175779,0.6052927927927928,46.3267543859649,1014.6929824561381,27.424134660976705,7
561,4,3,0,45,0.06666666666666667,0.0,1.0,45,1750,1500,250,0.8571428571428571,20,15,5,349.5169026670835,0.44720117845117846,0.2550943396226417,0.19423422841445145,129285.00987082548,38.43309960755397,129323.44297043304,531,0,179.13333333333333,37,8,19,36.86466756513925,0.611204954954955,45.75109649122806,1016.9956140350864,27.486367946894227,0
562,4,0,0,45,0.0,0.0,1.0,45,1800,1300,500,0.7222222222222222,23,13,10,349.81121509852744,0.4465698653198653,0.254965214163404,0.19494884473869273,129396.54659366336,52.8726386965121,129449.41923235987,532,1,180.13333333333333,37,8,19,36.74369993174551,0.6123310810810811,45.64144736842105,1017.4342105263152,27.498221906116626,0
563,4,1,3,43,0.021739130434782608,0.06521739130434782,0.9347826086956522,46,1350,900,450,0.6666666666666666,18,9,9,336.18962784531675,0.4477153784219002,0.24633235529474518,0.18896175634064358,129731.44531250001,-477.1267361111112,129254.3185763889,533,0,177.19565217391303,39,7,14,36.75017041581458,0.6121794871794872,45.3125,1018.7500000000001,26.121794871794876,0
564,4,1,2,42,0.022727272727272728,0.045454545454545456,0.9545454545454546,44,1600,1300,300,0.8125,19,13,6,348.80187472120605,0.442477096546864,0.2491676785084802,0.19507690391034194,129536.03512619267,236.48237919359826,129772.51750538626,534,0,186.0909090909091,37,7,15,36.62753123653597,0.6137387387387387,45.50438596491228,1017.9824561403508,27.513039355144617,0
565,4,0,1,41,0.0,0.023809523809523808,0.9761904761904762,42,1300,1000,300,0.7692307692307693,16,10,6,331.5385005330944,0.4415287456445993,0.200356229448301,0.16835266715381803,125641.84746877052,-68.97805719921507,125572.8694115713,535,2,195.83333333333334,38,4,14,41.04925937766411,0.5723684210526316,49.35897435897436,1002.5641025641023,26.38326585695006,8
566,4,2,0,43,0.046511627906976744,0.0,1.0,43,1050,600,450,0.5714285714285714,15,6,9,329.0194027228236,0.4444444444444444,0.2156798766018031,0.16970474456229862,126285.33859303099,-289.2926117685655,125996.04598126242,536,0,186.97674418604652,38,5,13,40.45028167517006,0.5789473684210527,48.71794871794872,1005.1282051282059,26.450742240215945,0
567,4,0,0,43,0.0,0.0,1.0,43,1350,1000,350,0.7407407407407407,17,10,7,330.0742877040577,0.44398301956441494,0.21458201052972292,0.17080754646279786,126419.60612763894,-254.42771111841478,126165.17841652052,537,1,187.97674418604652,38,5,13,40.28581925705585,0.5803179824561404,48.58440170940171,1005.6623931623928,26.464799820062968,0
568,4,1,0,44,0.022727272727272728,0.0,1.0,44,1450,1100,350,0.7586206896551724,18,11,7,338.5075129251867,0.4457694679351656,0.23999924806376405,0.17716691910240306,126882.03125000013,-209.89583333331916,126672.13541666682,538,0,184.6818181818182,39,5,14,39.59884201819686,0.5833333333333333,48.12500000000001,1007.500000000001,25.83333333333336,0
569,4,1,0,45,0.022222222222222223,0.0,1.0,45,1450,900,550,0.6206896551724138,20,9,11,333.9828451532252,0.44770622895622897,0.248131286394919,0.17652310981937355,127280.60766171721,-497.74488183945465,126782.86277987776,539,0,181.55555555555554,38,7,16,39.304305629080645,0.5890899122807017,47.729700854700845,1009.0811965811947,26.554768331084073,0
570,4,0,1,44,0.0,0.022222222222222223,0.9777777777777777,45,1350,1200,150,0.8888888888888888,15,12,3,387.8911683514975,0.4476641414141414,0.2584935369292176,0.19179648590459972,124534.42555642113,880.180713398203,125414.60626981934,540,1,182.55555555555554,37,8,16,40.78680563184298,0.5627815315315315,50.46600877192982,998.1359649122801,26.976647700331895,8
571,4,2,1,45,0.043478260869565216,0.021739130434782608,0.9782608695652174,46,1550,1000,550,0.6451612903225806,21,10,11,374.51333896911257,0.44983896940418683,0.21713064331143772,0.17950811764381597,123220.6632653061,82.00643859805837,123302.66970390415,541,0,174.45652173913044,41,5,15,42.48975819344523,0.5426829268292683,51.785714285714285,992.8571428571427,24.216027874564457,8
572,4,6,2,49,0.11764705882352941,0.0392156862745098,0.9607843137254902,51,1350,1300,50,0.9629629629629629,14,13,1,366.53132350265037,0.4579738562091504,0.29818382471863103,0.18167894606516619,124636.8919855325,-1054.4772949066291,123582.41469062587,542,0,158.07843137254903,42,9,16,41.21340773087497,0.5558035714285714,50.363372093023244,998.5465116279051,23.77491694352155,0
573,4,5,1,53,0.09259259259259259,0.018518518518518517,0.9814814814814815,54,1900,1300,600,0.6842105263157895,25,13,12,360.33078416562915,0.4599493361285814,0.3460785306728791,0.1838524977812534,125839.82051234372,-1728.566973545278,124111.25353879844,543,0,150.2037037037037,40,14,14,40.12310510145517,0.57109375,49.161585365853654,1003.3536585365844,25.083841463414608,0
574,4,1,1,53,0.018518518518518517,0.018518518518518517,0.9814814814814815,54,1900,1300,600,0.6842105263157895,25,13,12,365.17966288459183,0.4606845446075006,0.3453972644844008,0.18725169947912076,126043.83680555574,-1594.1055877784213,124449.73121777731,544,0,151.1851851851852,39,15,16,39.79080221300139,0.5747863247863247,48.95833333333334,1004.1666666666681,25.747863247863286,0
575,4,2,3,52,0.03636363636363636,0.05454545454545454,0.9454545454545454,55,1850,1400,450,0.7567567567567568,23,14,9,351.0571749032541,0.46297699214365884,0.3357521580131415,0.1818321550190598,126457.07242853564,-2121.267481340422,124335.80494719523,545,0,149.34545454545454,37,18,15,39.71971637777535,0.5824887387387387,48.547149122807014,1005.8114035087714,27.18409198672355,0
576,4,3,2,53,0.05454545454545454,0.03636363636363636,0.9636363636363636,55,1300,1000,300,0.7692307692307693,16,10,6,351.4730914113662,0.465530303030303,0.33594120710607056,0.18344326465357366,126769.03558514138,-2088.8190335305676,124680.2165516108,546,0,149.87272727272727,38,17,17,39.3883938043709,0.5838815789473684,48.23717948717949,1007.0512820512823,26.501349527665326,0
577,4,1,1,53,0.018518518518518517,0.018518518518518517,0.9814814814814815,54,1800,1300,500,0.7222222222222222,23,13,10,366.11184709734175,0.4635817027719544,0.3534318408080517,0.1916924081468645,126898.60251471603,-1508.183647853191,125390.41886686283,547,0,153.59259259259258,37,17,18,38.88650832517139,0.5869932432432432,48.108552631578945,1007.5657894736839,27.23150782361308,0
578,4,2,3,52,0.03636363636363636,0.05454545454545454,0.9454545454545454,55,1500,900,600,0.6,21,9,12,358.5514997215299,0.4649691358024692,0.3468665679332943,0.18968940616908816,127319.21744379523,-1869.606166642878,125449.61127715236,548,0,151.23636363636365,36,19,14,38.64488023506658,0.5931712962962963,47.69144144144145,1009.2342342342349,28.034284284284304,0
579,4,1,0,53,0.018867924528301886,0.0,1.0,53,1350,900,450,0.6666666666666666,18,9,9,370.49595822782493,0.464048137397194,0.3601097959077646,0.1954747440625741,127208.74592764066,-1173.9347565157652,126034.8111711249,549,0,156.77358490566039,35,18,20,38.4570521646015,0.594047619047619,47.80092592592593,1008.7962962962968,28.822751322751337,0
580,4,1,0,54,0.018518518518518517,0.0,1.0,54,1750,1200,550,0.6857142857142857,23,12,11,354.50494331053665,0.4651030747728861,0.34451436355526566,0.18919930877204513,127673.13169677221,-1747.8487371114095,125925.2829596608,550,0,154.85185185185185,37,17,16,38.38412263570936,0.5948761261261262,47.34100877192983,1010.6359649122818,27.314485538169777,0
581,4,0,0,54,0.0,0.0,1.0,54,1950,1400,550,0.717948717948718,25,14,11,355.1479618484758,0.46489925460051246,0.34030690126134755,0.18993411880759573,127756.25673284105,-1725.5251615881652,126030.73157125288,551,1,155.85185185185185,37,17,16,38.28271872740419,0.5957207207207207,47.25877192982457,1010.9649122807032,27.32337600758657,0
582,4,0,5,49,0.0,0.09259259259259259,0.9074074074074074,54,1200,800,400,0.6666666666666666,16,8,8,359.781664403638,0.46463720009317494,0.3467840061681544,0.1928103597207875,127839.4088205025,-1601.1449436364983,126238.26387686601,552,2,156.85185185185185,37,17,16,38.0804103870758,0.5965653153153153,47.1765350877193,1011.2938596491231,27.332266477003326,0
583,4,2,0,51,0.0392156862745098,0.0,1.0,51,1450,1000,450,0.6896551724137931,19,10,9,368.8015793391375,0.46272875816993464,0.35284700501126776,0.19871656261988618,128056.6556954087,-754.5006269290384,127302.15506847967,553,0,153.3921568627451,35,16,18,37.629716981132084,0.6026785714285714,46.96180555555554,1012.1527777777758,28.918650793650738,0
584,4,0,1,50,0.0,0.0196078431372549,0.9803921568627451,51,1100,800,300,0.7272727272727273,14,8,6,370.6653114361495,0.46214052287581703,0.3549071343577008,0.199889233116535,128090.45041867567,-704.2626607129728,127386.18775796269,554,1,154.3921568627451,38,13,18,37.547933157431835,0.5973135964912281,46.92841880341881,1012.2863247863255,26.63911381016646,0
585,4,0,0,50,0.0,0.0,1.0,50,1200,800,400,0.6666666666666666,16,8,8,375.89936134141766,0.46006802721088436,0.35070654529692225,0.20214448172835683,127978.05574792248,-378.62611572791525,127599.42963219456,555,2,158.3,37,13,19,37.530703655541096,0.597972972972973,47.03947368421053,1011.8421052631583,27.347083926031303,0
586,4,2,2,50,0.038461538461538464,0.038461538461538464,0.9615384615384616,52,1200,700,500,0.5833333333333334,17,7,10,308.53761622992386,0.46182126696832576,0.24445266272189303,0.16515837104072395,127793.2098765432,-2450.596230464077,125342.61364607913,556,0,153.17307692307693,44,8,18,39.42307692307692,0.5852272727272727,47.22222222222222,1011.1111111111111,22.97979797979798,8
587,4,0,0,50,0.0,0.0,1.0,50,1250,700,550,0.56,18,7,11,308.2787577113789,0.4622363945578231,0.23947281713344237,0.16559752737239566,127933.68055555568,-2112.152777777773,125821.52777777791,557,1,156.44,44,6,18,39.28644975288301,0.5866477272727273,47.083333333333336,1011.6666666666677,22.992424242424264,0
588,4,1,0,51,0.0196078431372549,0.0,1.0,51,1450,800,650,0.5517241379310345,21,8,13,303.0024801299003,0.46305555555555555,0.24145192238966806,0.16430935301114058,128312.3773692178,-2423.859062930437,125888.51830628735,558,0,154.35294117647058,43,8,19,39.03450867682337,0.591812015503876,46.709280303030305,1013.1628787878792,23.561927413671608,0
589,4,0,3,48,0.0,0.058823529411764705,0.9411764705882353,51,1150,800,350,0.6956521739130435,15,8,7,299.60441146569957,0.4623366013071895,0.23617339312406593,0.16295557013866108,128432.33471074386,-2504.221189164368,125928.1135215795,559,1,155.35294117647058,43,8,14,38.99866093672148,0.5930232558139534,46.59090909090909,1013.6363636363641,23.572938689217768,0
590,4,0,2,46,0.0,0.041666666666666664,0.9583333333333334,48,1250,1100,150,0.88,14,11,3,317.1941946518991,0.46026337174940896,0.23225308641975295,0.1712848651120257,128144.53125000013,-1470.6597222222088,126673.87152777793,560,4,164.41666666666666,40,8,18,38.84602194787382,0.59453125,46.87500000000001,1012.500000000001,25.312500000000025,0
591,4,2,0,48,0.041666666666666664,0.0,1.0,48,1400,900,500,0.6428571428571429,19,9,10,315.4933808738606,0.4614915780141844,0.2380018872966565,0.17213277461674442,128556.44710696343,-1488.2583738184942,127068.18873314494,561,0,158.79166666666666,40,8,16,38.4697447974079,0.5986979166666666,46.46849593495935,1014.1260162601625,25.353150406504064,0
592,4,1,1,48,0.02040816326530612,0.02040816326530612,0.9795918367346939,49,1800,1100,700,0.6111111111111112,25,11,14,317.3606664987289,0.4625496031746032,0.2514202789926283,0.17487290116329304,128949.36244173588,-1615.3088781809124,127334.05356355497,562,0,156.53061224489795,41,8,17,38.0229699811161,0.6011178861788617,46.0813492063492,1015.6746031746027,24.77255129694153,0
593,4,1,1,48,0.02040816326530612,0.02040816326530612,0.9795918367346939,49,1400,900,500,0.6428571428571429,19,9,10,317.28498774504527,0.46240787981859416,0.2663754154213158,0.17606138816453515,129226.60506621601,-1599.667639046388,127626.93742716963,563,0,157.12244897959184,41,8,20,37.743418057046206,0.6039126016260163,45.80853174603173,1016.7658730158707,24.799167634533433,0
594,4,0,0,48,0.0,0.0,1.0,48,1350,900,450,0.6666666666666666,18,9,9,325.0578360431692,0.46087285756501184,0.26742602219334266,0.18014147002436642,129175.56023407006,-1202.0943841298435,127973.46584994021,564,1,161.25,40,8,20,37.59767902962445,0.6049479166666667,45.85873983739836,1016.5650406504043,25.414126016260106,0
595,4,0,0,48,0.0,0.0,1.0,48,1600,1100,500,0.6875,21,11,10,322.79096929048836,0.4608266843971631,0.26685021476376014,0.17982528623077756,129382.26176754881,-1247.314863011464,128134.94690453736,565,2,162.25,40,8,21,37.44547664236006,0.60703125,45.655487804878035,1017.3780487804856,25.43445121951214,0
596,4,0,1,47,0.0,0.020833333333333332,0.9791666666666666,48,1300,1100,200,0.8461538461538461,15,11,4,323.2313522232345,0.46071586879432624,0.2663225307100776,0.18030727185577955,129433.96297053652,-1232.577025084294,128201.38594545223,566,3,163.25,40,8,15,37.381820300276296,0.6075520833333333,45.60467479674796,1017.5813008130066,25.439532520325166,0
597,4,0,0,47,0.0,0.0,1.0,47,1500,1100,400,0.7333333333333333,19,11,8,328.72455556060123,0.46027983348751156,0.26094529746300843,0.18376981447014804,129519.29253472186,-884.7656250000375,128634.52690972181,567,4,166.82978723404256,39,8,15,37.15547823714013,0.6100427350427351,45.520833333333314,1017.9166666666637,26.100427350427275,0
598,4,0,2,45,0.0,0.0425531914893617,0.9574468085106383,47,1250,900,350,0.72,16,9,7,331.5243450006832,0.46001002158495224,0.2674025838353591,0.18583612366552035,129625.34722222204,-805.208333333354,128820.13888888869,568,5,167.82978723404256,39,8,16,36.97660938352428,0.6111111111111112,45.41666666666666,1018.3333333333319,26.111111111111075,0
599,4,0,1,44,0.0,0.022222222222222223,0.9777777777777777,45,1450,800,650,0.5517241379310345,21,8,13,343.3999194294264,0.4591540404040404,0.26252962723550977,0.19178327630228245,129480.23069598335,-107.29984225915976,129372.93085372419,569,6,173.0222222222222,37,8,16,36.82171586583351,0.6131756756756757,45.55921052631579,1017.7631578947365,27.50711237553342,0
600,4,1,0,45,0.022222222222222223,0.0,1.0,45,1300,800,500,0.6153846153846154,18,8,10,341.673222940741,0.46050084175084177,0.26478172467408223,0.1919071487980341,129703.52055440134,-136.75602108341172,129566.76453331794,570,0,166.84444444444443,37,8,17,36.63885898815931,0.615427927927928,45.33991228070175,1018.6403508771929,27.530820293978184,0
601,4,0,0,45,0.0,0.0,1.0,45,850,700,150,0.8235294117647058,10,7,3,340.7898093433868,0.46031144781144784,0.262122244944331,0.19154737559645535,129731.4453125,-157.76909722222217,129573.67621527778,571,1,167.84444444444443,37,8,17,36.63300954328561,0.6157094594594594,45.3125,1018.75,27.533783783783782,0
602,4,2,2,45,0.0425531914893617,0.0425531914893617,0.9574468085106383,47,1600,1100,500,0.6875,21,11,10,329.3007493272183,0.4615132593277829,0.25892351151767534,0.1874966904507505,130236.00396050367,-822.6372612847031,129413.36669921897,572,0,161.6595744680851,39,8,20,36.41453634724631,0.6172542735042735,44.81770833333334,1020.7291666666682,26.172542735042775,0
603,4,0,0,45,0.0,0.0,1.0,45,1300,900,400,0.6923076923076923,17,9,8,339.52301851315553,0.46085858585858586,0.2539279957012359,0.19275544156588836,130122.707527797,-164.06911261157398,129958.63841518543,573,1,166.46666666666667,37,8,21,36.26847125201506,0.6196509009009009,44.92872807017544,1020.2850877192982,27.575272641062114,0
604,4,0,0,45,0.0,0.0,1.0,45,1200,1000,200,0.8333333333333334,14,10,4,337.3530421855579,0.46056397306397306,0.2522457144186263,0.19207812664128854,130235.32238476149,-212.94355869676417,130022.37882606473,574,2,167.46666666666667,38,7,21,36.20974635405764,0.6189692982456141,44.81837606837607,1020.7264957264957,26.86122357174989,0
605,4,0,0,45,0.0,0.0,1.0,45,1650,1200,450,0.7272727272727273,21,12,9,335.1615269080321,0.46035353535353535,0.2495240195537911,0.1915299235998076,130377.57087746546,-260.48514689256876,130117.0857305729,575,3,168.46666666666667,36,9,21,36.12167824456942,0.6241319444444444,44.67905405405406,1021.2837837837851,28.36899399399403,0
606,4,0,0,45,0.0,0.0,1.0,45,1050,700,350,0.6666666666666666,14,7,7,335.9968673111674,0.4602693602693602,0.2509063296100331,0.19243456946003265,130463.84222059927,-232.9115433000233,130230.93067729924,576,4,169.46666666666667,36,9,21,36.01305298353909,0.625,44.59459459459461,1021.621621621624,28.378378378378443,0
607,4,0,1,44,0.0,0.022222222222222223,0.9777777777777777,45,1150,700,450,0.6086956521739131,16,7,9,367.79680312351127,0.4599747474747475,0.2896646132785763,0.2012551046305053,128672.41753472206,530.9448489874817,129203.36238370954,577,5,170.46666666666667,35,10,17,37.02515400410678,0.6089285714285715,46.35416666666666,1014.583333333332,28.9880952380952,8
608,4,1,0,45,0.022222222222222223,0.0,1.0,45,950,600,350,0.631578947368421,13,6,7,369.63541521409377,0.4602272727272727,0.31066968944546525,0.2036842862063143,128950.68825263514,532.9482388811663,129483.6364915163,578,0,171.33333333333334,37,8,18,36.69426301774084,0.6078265765765766,46.08004385964911,1015.6798245614011,27.450806069227056,0
609,4,0,1,44,0.0,0.022222222222222223,0.9777777777777777,45,1350,800,550,0.5925925925925926,19,8,11,368.6558731888996,0.45978535353535355,0.3024313048482239,0.20386053894479217,129089.93632656186,517.9526392736046,129607.88896583546,579,1,172.33333333333334,37,8,18,36.57702129190044,0.6092342342342343,45.94298245614034,1016.2280701754372,27.46562351825506,0
610,4,0,1,43,0.0,0.022727272727272728,0.9772727272727273,44,1100,700,400,0.6363636363636364,15,7,8,373.9392942696546,0.45744142001409444,0.3032972678916832,0.20676643330204433,129086.9247626005,854.1347090333677,129941.05947163387,580,2,177.0909090909091,36,8,18,36.4458665780142,0.6111111111111112,45.94594594594595,1016.2162162162166,28.22822822822824,0
611,4,0,1,42,0.0,0.023255813953488372,0.9767441860465116,43,1200,700,500,0.5833333333333334,17,7,10,376.9300707015101,0.45625692137320045,0.3027011271979241,0.20935513565469394,129263.69214965386,1144.8267034276732,130408.51885308154,581,3,179.7674418604651,33,10,18,36.18944323933479,0.6193181818181819,45.772058823529406,1016.9117647058813,30.815508021390343,0
612,4,0,0,42,0.0,0.0,1.0,42,1050,800,250,0.7619047619047619,13,8,5,376.8766652704289,0.4559741579558653,0.29597409376953987,0.2098224814493514,129357.17520004326,1350.340163638984,130707.51536368225,582,4,181.5,33,9,18,36.09542524996987,0.6202651515151515,45.68014705882353,1017.279411764706,30.826648841354725,0
613,4,0,0,42,0.0,0.0,1.0,42,1200,800,400,0.6666666666666666,16,8,8,356.0404071311285,0.455562814556717,0.22309288281278938,0.19308592784561565,128315.61872260775,839.3270734013137,129154.94579600907,583,5,182.5,36,6,16,37.68779407950799,0.6032986111111112,46.70608108108108,1013.1756756756757,28.14376876876877,8
614,4,1,0,43,0.023255813953488372,0.0,1.0,43,1600,1100,500,0.6875,21,11,10,350.30397976854323,0.4560723514211886,0.23100073217735884,0.19174852425716712,128685.96734832696,415.84130049673456,129101.80864882369,584,0,179.2325581395349,38,5,15,37.455029658488634,0.6033442982456141,46.34081196581196,1014.6367521367508,26.70096716149344,0
615,4,0,0,43,0.0,0.0,1.0,43,1250,900,350,0.72,16,9,7,346.55916929888275,0.455749354005168,0.2252296575880628,0.19021713850425664,128794.39153928333,326.9754684418121,129121.36700772514,585,1,180.2325581395349,38,5,15,37.439480054731085,0.6044407894736843,46.23397435897436,1015.0641025641023,26.712213225371112,0
616,4,1,2,42,0.022727272727272728,0.045454545454545456,0.9545454545454546,44,1100,700,400,0.6363636363636364,15,7,8,339.19442539028364,0.45629624735729385,0.22637575136293808,0.18746978015196683,129069.04432508671,-44.09993489583826,129024.94439019087,586,0,177.11363636363637,39,5,16,37.34676661541091,0.6055021367521367,45.963541666666664,1016.1458333333326,26.05502136752135,0
617,4,0,1,41,0.0,0.023809523809523808,0.9761904761904762,42,1300,1000,300,0.7692307692307693,16,10,6,348.79571711097395,0.4582365466511808,0.2187782712394113,0.19233592400690835,128978.53185595557,597.4319021237188,129575.96375807929,587,1,160.28571428571428,37,5,16,37.195056131260785,0.6081081081081081,46.05263157894736,1015.7894736842097,27.453769559032697,0
618,4,0,1,40,0.0,0.024390243902439025,0.975609756097561,41,1100,700,400,0.6363636363636364,15,7,8,354.31905447859145,0.45660569105691057,0.2298739927532314,0.1953519481293947,128972.5113627142,939.4836559532671,129911.99501866747,588,2,164.609756097561,36,5,16,37.06092941611236,0.6099537037037037,46.058558558558566,1015.7657657657668,28.215715715715746,0
619,4,1,0,41,0.024390243902439025,0.0,1.0,41,1150,700,450,0.6086956521739131,16,7,9,349.9263476355045,0.45762195121951216,0.21425271955676628,0.19419084159809333,129230.01284646163,844.4001856586615,130074.41303212028,589,0,157.46341463414635,36,5,17,36.9102336914387,0.6125578703703703,45.805180180180194,1016.7792792792817,28.243868868868937,0
620,4,1,1,41,0.023809523809523808,0.023809523809523808,0.9761904761904762,42,1300,800,500,0.6153846153846154,18,8,10,342.4223746959593,0.45772841656988,0.22132670182166825,0.19253182577244535,129745.05077069197,485.52167798964655,130230.57244868162,590,0,154.6904761904762,38,4,16,36.57761814876957,0.6140350877192983,45.29914529914531,1018.8034188034203,26.810616284300533,0
621,4,0,0,41,0.0,0.0,1.0,41,900,600,300,0.6666666666666666,12,6,6,350.58083499316166,0.4561737804878048,0.2217256708039146,0.1967701133686696,129675.59880203534,892.3559412511647,130567.95474328651,591,1,159.4390243902439,37,4,16,36.44039096422291,0.6151463963963963,45.367324561403514,1018.5307017543868,27.527856804172615,0
622,4,0,0,41,0.0,0.0,1.0,41,1050,700,350,0.6666666666666666,14,7,7,353.27720011140883,0.45594512195121956,0.21902921999517,0.19870773265346345,129759.37307633144,968.2056017236378,130727.57867805507,592,2,160.4390243902439,37,4,16,36.28659061558331,0.615990990990991,45.28508771929826,1018.8596491228091,27.536747273589434,0
623,4,0,0,41,0.0,0.0,1.0,41,1200,800,400,0.6666666666666666,16,8,8,351.6160782791849,0.4555132113821138,0.21410730028126435,0.19833877813612305,129871.11418898143,932.9543705755867,130804.06855955702,593,3,161.4390243902439,37,4,16,36.215397303499714,0.6171171171171171,45.17543859649124,1019.2982456140368,27.548601232811805,0
624,4,0,1,40,0.0,0.024390243902439025,0.975609756097561,41,1400,1000,400,0.7142857142857143,18,10,8,351.17675755732057,0.4548018292682927,0.2153348315549597,0.19880067084848713,130010.85820877596,931.3583266005128,130942.21653537647,594,4,162.4390243902439,37,4,16,36.08471759309036,0.6185247747747749,45.038377192982466,1019.8464912280716,27.563418681839774,0
625,4,0,1,39,0.0,0.025,0.975,40,1050,700,350,0.6666666666666666,14,7,7,360.7916213526562,0.4528044871794872,0.21780349055561632,0.20375836232723665,129917.93894823914,1374.6607671861452,131292.59971542528,595,5,167.3,36,4,16,35.933990574027035,0.6195023148148149,45.129504504504524,1019.4819819819849,28.318943943944024,0
626,4,0,0,39,0.0,0.0,1.0,39,1300,1000,300,0.7692307692307693,16,10,6,367.8845340005489,0.4506860098965362,0.22867323412282503,0.20771326765877182,129908.37191358047,1758.2561728395287,131666.62808642,596,6,172.15384615384616,35,4,16,35.76294277929154,0.6214285714285714,45.1388888888889,1019.4444444444463,29.12698412698418,0
627,4,0,0,39,0.0,0.0,1.0,39,1100,900,200,0.8181818181818182,13,9,4,390.97257855654686,0.45113585245164195,0.23168414385248837,0.21050888096665304,128027.37054183811,2242.3846879286693,130269.75522976679,597,7,173.15384615384616,35,4,16,37.0987724916133,0.6023809523809525,46.99074074074074,1012.0370370370368,28.91534391534391,7
628,4,1,1,39,0.025,0.025,0.975,40,1100,800,300,0.7272727272727273,14,8,6,381.4006769232584,0.45248397435897436,0.22606122902544712,0.20713486370744738,128372.67324334475,1792.284894691993,130164.95813803675,598,0,169.8,36,4,15,36.98698003481868,0.6038773148148149,46.64977477477478,1013.4009009009013,28.150025025025037,0
629,4,0,0,39,0.0,0.0,1.0,39,1400,1100,300,0.7857142857142857,17,11,6,390.5965395425944,0.45122019793072426,0.23112079876248148,0.21154089814831573,128261.74554183798,2219.718792866927,130481.46433470491,599,9,175.15384615384616,35,4,16,36.86776355880562,0.6047619047619048,46.75925925925925,1012.9629629629617,28.941798941798904,0
630,4,0,0,39,0.0,0.0,1.0,39,1500,1000,500,0.6666666666666666,20,10,10,385.9332069843262,0.4509109311740891,0.2225070899879713,0.21040204271248805,128525.67361379034,2120.4650795181824,130646.13869330852,600,10,176.15384615384616,35,4,15,36.71539112734467,0.6074404761904761,46.498842592592595,1014.00462962963,28.97156084656086,0
631,4,2,1,40,0.04878048780487805,0.024390243902439025,0.975609756097561,41,1150,800,350,0.6956521739130435,15,8,7,368.1805966138131,0.4525406504065041,0.21791283486605328,0.20417287630402386,129201.38888888907,1315.660499185548,130517.0493880746,601,0,168.5121951219512,36,5,17,36.47540983606557,0.6122685185185186,45.83333333333334,1016.6666666666681,28.24074074074078,0
632,4,0,0,40,0.0,0.0,1.0,40,1000,600,400,0.6,14,6,8,398.7205289909193,0.45209668803418807,0.2225927246790298,0.2010813603040534,125357.39795918361,2057.2774943310583,127414.67545351468,602,1,172.425,34,6,15,39.66060389919162,0.5772058823529411,49.64285714285714,1001.4285714285709,29.453781512605026,8
633,4,2,0,42,0.047619047619047616,0.0,1.0,42,1550,1200,350,0.7741935483870968,19,12,7,386.06018245740773,0.4546796360820751,0.23349249620436074,0.1982464856599605,126103.6157171203,1340.4655612245074,127444.0812783448,603,0,165.16666666666666,34,8,18,39.204792382758505,0.5848651960784313,48.89880952380953,1004.4047619047628,29.54131652661067,0
634,4,4,1,45,0.08695652173913043,0.021739130434782608,0.9782608695652174,46,1250,900,350,0.72,16,9,7,353.52581251800365,0.4606380837359098,0.24099223619360788,0.18662025249444383,127230.25504241709,-200.3057234839714,127029.94931893313,604,0,151.7173913043478,37,9,20,38.862963264862515,0.5903716216216216,47.779605263157904,1008.88157894737,27.26706970128027,0
635,4,4,3,46,0.08163265306122448,0.061224489795918366,0.9387755102040817,49,1250,700,550,0.56,18,7,11,343.3431881263825,0.4628153344671202,0.26276796080020315,0.18552746702482315,128170.89979383699,-995.4056852228381,127175.49410861415,605,0,143.3265306122449,39,10,19,38.15718976099853,0.5964209401709402,46.84895833333334,1012.6041666666681,25.96420940170944,0
636,4,0,0,46,0.0,0.0,1.0,46,1350,1100,250,0.8148148148148148,16,11,5,355.53263473268044,0.45927938808373586,0.2652164488905433,0.19105996625966493,127950.3203509735,-101.89709814556716,127848.42325282794,606,1,152.30434782608697,37,9,20,38.074288320508664,0.5976914414414414,47.06688596491229,1011.7324561403518,27.344120436225726,0
637,4,1,0,47,0.02127659574468085,0.0,1.0,47,1350,900,450,0.6666666666666666,18,9,9,346.23097597303007,0.46035692260252853,0.2566248194046863,0.1878520924558476,128333.90404704506,-513.3654302724822,127820.53861677258,607,0,150.04255319148936,38,9,21,37.9175892731618,0.5997807017543859,46.68803418803419,1013.247863247863,26.664417453891133,0
638,4,0,2,45,0.0,0.0425531914893617,0.9574468085106383,47,1500,1200,300,0.8,18,12,6,347.8326139988741,0.45920058587727414,0.2586417953949287,0.18949090165610308,128496.33487654323,-460.95679012345477,128035.37808641978,608,1,151.04255319148936,38,9,16,37.71118721461188,0.6014254385964912,46.52777777777778,1013.888888888889,26.681286549707607,0
639,4,1,1,45,0.021739130434782608,0.021739130434782608,0.9782608695652174,46,1200,900,300,0.75,15,9,6,352.3255826453705,0.457890499194847,0.27306535699409995,0.1931183329225835,128740.17373666806,-128.3086556724453,128611.86508099562,609,0,152.82608695652175,38,8,17,37.34844895953959,0.6038925438596492,46.28739316239316,1014.8504273504268,26.706590193432284,0
640,4,0,2,43,0.0,0.044444444444444446,0.9555555555555556,45,800,500,300,0.625,11,5,6,352.5311069006617,0.4581228956228956,0.25898562204459785,0.1935784690205411,128811.51532202198,82.013215604778,128893.52853762676,610,1,153.17777777777778,37,8,18,37.27046878375459,0.6064189189189189,46.21710526315788,1015.131578947367,27.435988620199108,0
641,4,0,2,41,0.0,0.046511627906976744,0.9534883720930233,43,900,600,300,0.6666666666666666,12,6,6,364.3907854923461,0.45648763381321517,0.26723883983662833,0.19895055783610138,128584.36113522365,770.9912712191203,129355.35240644276,611,2,160.58139534883722,35,8,18,37.20151489216022,0.6080357142857142,46.440972222222214,1014.2361111111102,28.978174603174576,0
642,4,2,0,43,0.046511627906976744,0.0,1.0,43,1150,800,350,0.6956521739130435,15,8,7,370.0136074873146,0.457687338501292,0.273570672909933,0.2032178679568712,128819.2451801482,932.9747245798901,129752.21990472809,612,0,161.2093023255814,35,8,20,36.81889655303463,0.6104166666666666,46.20949074074073,1015.162037037036,29.0046296296296,0
643,4,0,1,42,0.0,0.023255813953488372,0.9767441860465116,43,1300,1000,300,0.7692307692307693,16,10,6,372.0815253122946,0.457156699889258,0.2815026833631482,0.20496016224829788,128936.767578125,994.9978298611115,129931.76540798611,613,1,162.2093023255814,35,8,20,36.64636752136752,0.6116071428571428,46.09375,1015.625,29.017857142857142,0
644,4,0,0,42,0.0,0.0,1.0,42,1050,500,550,0.47619047619047616,16,5,11,379.4574222640872,0.4549578977932636,0.28392500870887116,0.20951437354140715,129029.71172185689,1392.2563610908114,130421.9680829477,614,2,165.47619047619048,36,6,20,36.364119190127845,0.6105324074074074,46.00225225225225,1015.9909909909902,28.22197197197195,0
645,4,1,2,41,0.023255813953488372,0.046511627906976744,0.9534883720930233,43,1500,1100,400,0.7333333333333333,19,11,8,374.9178914417479,0.4548265042451089,0.27935540691723615,0.20931130282205002,129466.28146701385,1108.073320892678,130574.35478790653,615,0,162.6046511627907,35,8,17,36.033990105765945,0.6169642857142856,45.572916666666664,1017.7083333333329,29.077380952380942,0
646,4,0,0,41,0.0,0.0,1.0,41,950,500,450,0.5263157894736842,14,5,9,384.9118443062745,0.4535569105691057,0.2885379556042751,0.21410721339536506,129322.44897959175,1755.548469387743,131077.9974489795,616,4,169.78048780487805,34,7,20,35.92652738764044,0.6176470588235294,45.71428571428571,1017.1428571428564,29.9159663865546,0
647,4,0,0,41,0.0,0.0,1.0,41,1400,900,500,0.6428571428571429,19,9,10,378.43766855531203,0.4521341463414634,0.2870919781219048,0.2115459546117172,129516.42679419294,1602.7789191218326,131119.20571331476,617,5,170.78048780487805,36,5,17,35.89330493786185,0.6154513888888888,45.52364864864865,1017.9054054054062,28.27515015015017,0
648,4,0,1,40,0.0,0.024390243902439025,0.975609756097561,41,900,400,500,0.4444444444444444,14,4,10,378.238064005136,0.4512957317073171,0.2926829268292681,0.21220750935871277,129659.75265806344,1608.4507649541401,131268.20342301758,618,6,171.78048780487805,36,5,17,35.75229433878815,0.6168981481481481,45.38288288288288,1018.4684684684682,28.290790790790783,0
649,4,1,2,39,0.024390243902439025,0.04878048780487805,0.9512195121951219,41,1250,800,450,0.64,17,8,9,381.21346148910277,0.45142276422764227,0.184202933931068,0.21266679907437772,129436.83556241432,1680.6761982828725,131117.51176069718,619,0,171.17073170731706,35,6,17,35.90385198665453,0.6166666666666667,45.601851851851855,1017.592592592593,29.074074074074083,8
650,4,0,0,39,0.0,0.0,1.0,39,1150,800,350,0.6956521739130435,15,8,7,402.3887190965595,0.44823999100314893,0.25294203301430973,0.21237791522889274,127223.34120008696,2505.627056273596,129728.96825636056,620,1,178.64102564102564,31,8,20,37.63766993632764,0.603494623655914,47.78645833333334,1008.8541666666679,32.54368279569896,7
651,4,0,0,39,0.0,0.0,1.0,39,1000,700,300,0.7,13,7,6,401.190893780024,0.4480994152046784,0.2537697171843516,0.2119173984936202,127256.18362426768,2410.804409450969,129666.98803371865,621,2,179.64102564102564,31,8,20,37.63402266959178,0.6038306451612903,47.75390625000001,1008.9843750000008,32.54788306451616,0
652,4,2,0,41,0.04878048780487805,0.0,1.0,41,1450,1000,450,0.6896551724137931,19,10,9,384.4077659914359,0.4509908536585366,0.24402058019127093,0.20693867871950983,128020.4804041716,1642.4133746636094,129662.8937788352,622,0,171.82926829268294,33,8,21,37.27193832243481,0.6066919191919191,46.99754901960785,1012.0098039215696,30.66696375519908,0
653,4,0,0,41,0.0,0.0,1.0,41,850,500,350,0.5882352941176471,12,5,7,386.2167216786168,0.45083841463414637,0.24878048780487827,0.20823434210609515,128082.49831795474,1693.5205209534965,129776.01883890823,623,1,172.82926829268294,33,8,21,37.16253026634382,0.6073232323232323,46.93627450980393,1012.2549019607852,30.674390968508643,0
654,4,1,0,42,0.023809523809523808,0.0,1.0,42,950,800,150,0.8421052631578947,11,8,3,380.69646215933074,0.451231610530391,0.2598415860368053,0.20772785217824358,128560.35098459349,1388.524195283736,129948.87517987723,624,0,169.6904761904762,32,10,16,36.812645252324025,0.6145833333333333,46.46464646464647,1014.1414141414149,31.691919191919215,0
655,4,0,0,42,0.0,0.0,1.0,42,1300,800,500,0.6153846153846154,18,8,10,384.2542431631082,0.4504210220673635,0.26373580791201534,0.21034517016748877,128688.4310274461,1489.815133659821,130178.24616110593,625,1,170.6904761904762,32,10,18,36.59132860461258,0.6158854166666667,46.338383838383834,1014.646464646464,31.707702020202,0
656,4,1,1,42,0.023255813953488372,0.023255813953488372,0.9767441860465116,43,1500,1200,300,0.8,18,12,6,376.62421188491396,0.4519425987449243,0.2561674194181838,0.20787048711890366,129014.56921616672,1118.002090542083,130132.5713067088,626,0,167.69767441860466,33,10,19,36.45154804985927,0.6167929292929293,46.01715686274509,1015.9313725490185,30.785799168152078,0
657,4,0,0,42,0.0,0.0,1.0,42,1400,1200,200,0.8571428571428571,16,12,4,385.0921030902393,0.45084446380178084,0.263751975986217,0.21199834258417452,128912.72454660217,1528.6544421487315,130441.3789887509,627,1,172.5952380952381,32,10,19,36.34060673877906,0.6181640625,46.11742424242423,1015.5303030303012,31.735321969696912,0
658,4,1,0,43,0.023255813953488372,0.0,1.0,43,1200,900,300,0.75,15,9,6,376.49412698085814,0.4528654485049834,0.25936712550981245,0.20963463587316997,129361.89746263114,1141.1217605346137,130503.01922316576,628,0,169.5581395348837,32,11,21,36.10033718091928,0.6227213541666667,45.67550505050504,1017.297979797978,31.79056186868681,0
659,4,1,1,43,0.022727272727272728,0.022727272727272728,0.9772727272727273,44,850,600,250,0.7058823529411765,11,6,5,365.7901329498774,0.45418208245243125,0.2548353571819282,0.20510904216015352,129637.82709775065,684.0476018838652,130321.87469963451,629,0,166.6818181818182,33,11,17,36.09155635780184,0.6231060606060606,45.40441176470587,1018.3823529411746,30.860071301247718,0
660,4,0,1,42,0.0,0.023255813953488372,0.9767441860465116,43,800,500,300,0.625,11,5,6,375.4907762049204,0.45175802879291255,0.2613598506163197,0.2100472645073583,129544.24267409153,1128.5336469146264,130672.77632100615,630,1,171.53488372093022,33,10,17,35.93994522691705,0.6221590909090908,45.496323529411754,1018.0147058823516,30.848930481283382,0
661,4,0,0,42,0.0,0.0,1.0,42,950,400,550,0.42105263157894735,15,4,11,383.1706836380388,0.451038037166086,0.27742346938775553,0.21457558283730147,129586.776859504,1530.770775941214,131117.5476354452,631,2,176.0,32,10,17,35.70110987103176,0.625,45.454545454545446,1018.181818181817,31.81818181818178,0
662,4,0,0,42,0.0,0.0,1.0,42,800,400,400,0.5,12,4,8,383.1706836380388,0.451038037166086,0.27742346938775553,0.21457558283730147,129586.776859504,1530.770775941214,131117.5476354452,632,3,177.0,32,10,17,35.70110987103176,0.625,45.454545454545446,1018.181818181817,31.81818181818178,0
663,4,0,1,41,0.0,0.023809523809523808,0.9761904761904762,42,1150,800,350,0.6956521739130435,15,8,7,387.0321774092256,0.45062669376693765,0.2829756592770969,0.21744955482852577,129715.36705438212,1640.8041908988776,131356.171245281,633,4,178.0,32,10,18,35.47166790613122,0.6263020833333333,45.32828282828282,1018.686868686868,31.833964646464626,0
664,4,0,1,40,0.0,0.024390243902439025,0.975609756097561,41,1350,1100,250,0.8148148148148148,16,11,5,399.6980632941289,0.4500762195121952,0.2969111511621376,0.2242782102644678,129665.12891981356,2165.380181206621,131830.50910102017,634,5,183.0,31,10,18,35.20039631807722,0.6283602150537635,45.37760416666668,1018.489583333335,32.8545026881721,0
665,4,0,1,39,0.0,0.025,0.975,40,1000,700,300,0.7,13,7,6,410.6354659993764,0.4485309829059829,0.3056391970417325,0.22930175136779357,129474.83090530707,2633.391504798253,132108.2224101053,635,6,188.375,30,10,18,35.11649278041908,0.6291666666666667,45.56451612903226,1017.7419354838718,33.924731182795725,0
666,4,1,0,40,0.025,0.0,1.0,40,450,300,150,0.6666666666666666,6,3,3,403.66935346129395,0.45077457264957266,0.26116711197473896,0.2133384760205576,127277.43686322538,2275.600129757744,129553.03699298312,636,0,187.025,33,7,16,37.54959112622458,0.5991161616161615,47.73284313725488,1009.0686274509779,30.57783719548418,8
667,4,1,1,40,0.024390243902439025,0.024390243902439025,0.975609756097561,41,1200,700,500,0.5833333333333334,17,7,10,395.14422275231334,0.4520579268292683,0.26266283871746476,0.21052034014431123,127602.69451530588,1884.2935090702615,129486.98802437614,637,0,183.4390243902439,34,7,16,37.429794587800956,0.6001838235294117,47.41071428571427,1010.3571428571408,29.71638655462179,0
668,4,0,0,40,0.0,0.0,1.0,40,750,400,350,0.5333333333333333,11,4,7,409.9097425424001,0.4513087606837607,0.27644382431448733,0.2179661998731908,127524.87775134544,2454.7379613609937,129979.61571270644,638,1,188.825,33,7,16,37.13702175847287,0.6016414141414141,47.487745098039206,1010.0490196078415,30.60754604872247,0
669,4,1,1,40,0.024390243902439025,0.024390243902439025,0.975609756097561,41,950,700,250,0.7368421052631579,12,7,5,401.6338363284286,0.45325203252032525,0.27517684075145854,0.21542178493979328,127873.46938775493,2071.662414965963,129945.13180272089,639,0,185.1951219512195,34,7,17,36.98725870998117,0.6029411764705883,47.14285714285713,1011.4285714285701,29.747899159663827,0
670,4,0,0,40,0.0,0.0,1.0,40,1150,900,250,0.782608695652174,14,9,5,400.07314437060506,0.4533386752136752,0.24325387436413126,0.20785607187244756,126582.35721371864,2128.440334467098,128710.79754818574,640,1,189.6,34,6,20,38.357683662604984,0.5897671568627452,48.42261904761904,1006.3095238095224,29.597338935574186,8
671,4,1,0,41,0.024390243902439025,0.0,1.0,41,1800,1300,500,0.7222222222222222,23,13,10,399.22136466088364,0.45452235772357724,0.26486595444466854,0.21002515271289982,127092.01388888895,1950.6412981859496,129042.6551870749,641,0,185.9512195121951,32,9,21,37.85296143250688,0.599609375,47.91666666666667,1008.3333333333339,31.510416666666686,0
672,4,0,0,41,0.0,0.0,1.0,41,1450,1200,250,0.8275862068965517,17,12,5,397.91032125011486,0.4542428861788618,0.2626655327420726,0.20981421231324113,127184.70848051226,1921.6216419165617,129106.33012242882,642,1,186.9512195121951,33,8,21,37.79044162313206,0.5981691919191919,47.82475490196078,1008.7009803921565,30.566696375519893,0
673,4,1,0,42,0.023809523809523808,0.0,1.0,42,1300,900,400,0.6923076923076923,17,9,8,386.9808632666583,0.4552724545102594,0.26188792943830075,0.20617116048613468,127602.69451530598,1475.960175736944,129078.65469104292,643,0,183.47619047619048,34,8,19,37.635992301952015,0.6001838235294117,47.41071428571428,1010.3571428571416,29.716386554621813,0
674,4,0,0,42,0.0,0.0,1.0,42,1050,700,350,0.6666666666666666,14,7,7,374.43414161980905,0.45477642276422764,0.23903712979909875,0.1895173488130298,125507.2703615779,999.9893681602288,126507.25972973813,644,1,184.47619047619048,36,6,14,40.11341499962538,0.5746527777777778,49.49324324324325,1002.027027027028,27.83408408408411,8
675,4,2,0,44,0.045454545454545456,0.0,1.0,44,950,600,350,0.631578947368421,13,6,7,339.7037560291832,0.4580029950669486,0.15924192086982836,0.17330649248268487,125834.72222222213,-239.60755519033046,125595.1146670318,645,0,177.04545454545453,39,5,18,40.645764119601345,0.5726495726495726,49.166666666666664,1003.3333333333326,25.726495726495706,8
676,4,3,2,45,0.06382978723404255,0.0425531914893617,0.9574468085106383,47,1200,800,400,0.6666666666666666,16,8,8,324.474129557105,0.46334412580943574,0.17492738273754038,0.16872322113566496,126617.30092789396,-1183.0186877992292,125434.28224009473,646,0,166.68085106382978,41,6,19,40.223735009035636,0.577489837398374,48.38789682539681,1006.4484126984098,24.547522260936823,0
677,4,1,0,46,0.021739130434782608,0.0,1.0,46,850,400,450,0.47058823529411764,13,4,9,326.358499740121,0.4607487922705314,0.19973789700894318,0.17043166097539605,126792.09183673425,-924.0646258503826,125868.02721088387,647,0,171.1304347826087,41,5,20,39.997044917257675,0.5792682926829269,48.214285714285694,1007.1428571428536,24.564459930313504,0
678,4,1,1,46,0.02127659574468085,0.02127659574468085,0.9787234042553191,47,1100,700,400,0.6363636363636364,15,7,8,323.260073767096,0.46197579401788463,0.2146299589183891,0.17047301762489686,127189.73938615447,-1176.9270927228104,126012.81229343166,648,0,168.46808510638297,42,5,22,39.66778738392572,0.5818452380952381,47.819767441860456,1008.7209302325564,24.017165005537056,0
679,4,1,0,47,0.02127659574468085,0.0,1.0,47,1850,1500,350,0.8108108108108109,22,15,7,340.9133876446456,0.46089654640764727,0.2632206315604835,0.1821276025885357,127713.43136621876,-692.1562930440996,127021.27507317466,649,0,168.89361702127658,43,4,16,38.686293798013864,0.5857558139534884,47.30113636363635,1010.7954545454526,23.506871035940758,0
680,4,2,1,48,0.04081632653061224,0.02040816326530612,0.9795918367346939,49,1300,1000,300,0.7692307692307693,16,10,6,320.00136227151233,0.4624255952380953,0.2849844201779752,0.16981094187692627,127442.37075617256,-1385.2545738317856,126057.11618234077,650,0,162.9591836734694,38,11,13,39.4916322787712,0.590734649122807,47.56944444444443,1009.7222222222199,26.571637426900523,8
681,4,3,0,51,0.058823529411764705,0.0,1.0,51,1400,800,600,0.5714285714285714,20,8,12,305.88007163620085,0.46375816993464053,0.29446799800024426,0.16506919142144258,128118.80845561488,-2362.201938330376,125756.60651728451,651,0,157.37254901960785,40,11,16,39.15859432510206,0.5942708333333333,46.90040650406503,1012.3983739837385,25.309959349593463,0
682,4,1,2,50,0.019230769230769232,0.038461538461538464,0.9615384615384616,52,2000,1600,400,0.8,24,16,8,319.765260684591,0.4639030291603821,0.2663705433690058,0.1684269652431797,127140.87194279222,-2229.2529433459276,124911.61899944629,652,0,155.32692307692307,42,10,13,39.80591852421215,0.5813492063492063,47.86821705426358,1008.5271317829483,24.012550756736864,8
683,4,0,1,49,0.0,0.02,0.98,50,1200,600,600,0.5,18,6,12,330.37021364009024,0.4620408163265306,0.2715045853068623,0.17391318991780486,127117.63340480233,-1600.8240589265365,125516.8093458758,653,1,162.38,40,10,14,39.56233833854009,0.5841145833333333,47.89126016260164,1008.4349593495958,25.210873983739894,0
684,4,0,0,49,0.0,0.0,1.0,49,1350,900,450,0.6666666666666666,18,9,9,335.83322003695264,0.46141581632653056,0.2665503972424397,0.17678902081839187,127117.63340480234,-1261.9351700376474,125855.6982347647,654,2,166.6326530612245,40,9,15,39.42461117269642,0.5841145833333333,47.89126016260164,1008.4349593495959,25.210873983739898,0
685,4,1,0,50,0.02,0.0,1.0,50,1600,900,700,0.5625,23,9,14,331.57554132514434,0.463078231292517,0.28074457877566683,0.1761304939699621,127483.1412249866,-1545.9416876990433,125937.19953728755,655,0,164.28,42,8,12,39.157751231369545,0.5848214285714286,47.52906976744187,1009.8837209302335,24.044850498338892,0
686,4,0,0,50,0.0,0.0,1.0,50,1750,1100,650,0.6285714285714286,24,11,13,327.7252633407759,0.46282312925170066,0.28177564717161996,0.17493216461843894,127678.9302400699,-1631.2777928008954,126047.65244726899,656,1,165.28,42,8,14,39.05480984340044,0.5868055555555556,47.335271317829466,1010.6589147286837,24.063307493540087,0
687,4,1,0,51,0.0196078431372549,0.0,1.0,51,2100,1600,500,0.7619047619047619,26,16,10,322.3387749026603,0.46299019607843134,0.28357001766191625,0.17395880073116263,128120.5622004846,-1940.3549880911678,126180.20721239342,657,0,163.01960784313727,43,8,16,38.74023711533067,0.5898740310077519,46.89867424242423,1012.4053030303,23.544309372797674,0
688,4,0,0,51,0.0,0.0,1.0,51,1550,1100,450,0.7096774193548387,20,11,9,316.55276104361894,0.4626797385620915,0.2720194428192091,0.17167404924647664,128316.28207439417,-2076.2230826207483,126240.05899177342,658,1,164.01960784313727,42,9,17,38.68731669217037,0.5932539682539683,46.70542635658913,1013.1782945736402,24.123292727943813,0
689,4,0,1,50,0.0,0.0196078431372549,0.9803921568627451,51,1700,1000,700,0.5882352941176471,24,10,14,317.8834490473297,0.46197712418300657,0.2769460264273931,0.17313974634993223,128488.14791967084,-2031.1488755183461,126456.99904415249,659,2,165.01960784313727,42,9,13,38.478646978240775,0.5949900793650793,46.53585271317827,1013.8565891472831,24.139442598744836,0
690,4,1,2,49,0.0196078431372549,0.0392156862745098,0.9607843137254902,51,2000,1500,500,0.75,25,15,10,328.6813155968201,0.46236928104575165,0.30949788806955825,0.18113762092985589,128955.22072741984,-1722.9656796466925,127232.25504777316,660,0,165.54901960784315,42,9,14,37.72956019843541,0.5997023809523809,46.07558139534882,1015.6976744186015,24.183277962347656,0
691,4,0,2,47,0.0,0.04081632653061224,0.9591836734693877,49,1450,900,550,0.6206896551724138,20,9,11,336.77298674123494,0.46141581632653056,0.31188698244319824,0.18521609453500965,128873.80248685087,-1119.7569247606739,127754.04556209019,661,1,172.20408163265307,41,8,14,37.606965477935205,0.6003556910569106,46.155753968253954,1015.3769841269813,24.765292295780032,0
692,4,1,1,47,0.020833333333333332,0.020833333333333332,0.9791666666666666,48,1300,900,400,0.6923076923076923,17,9,8,339.61323737723495,0.45769614361702127,0.30705670034343635,0.18747175781668782,129020.64252635662,-836.5763806266172,128184.06614573,662,0,175.29166666666666,40,8,15,37.38538228135107,0.6033854166666667,46.011178861788615,1015.9552845528451,25.398882113821127,0
693,4,0,0,47,0.0,0.0,1.0,47,1050,500,550,0.47619047619047616,16,5,11,346.80712575563604,0.45754316990440946,0.3086230338954574,0.19091037091991475,128910.32036675327,-458.59646267363246,128451.72390407963,663,1,179.74468085106383,39,8,16,37.31504513283414,0.6038995726495726,46.11979166666666,1015.5208333333317,26.038995726495685,0
694,4,0,1,46,0.0,0.02127659574468085,0.9787234042553191,47,1400,1100,300,0.7857142857142857,17,11,6,349.22559848728713,0.4562519272278754,0.31403365705389663,0.19340200851526348,129148.442925347,-379.6115451389095,128768.8313802081,664,2,180.74468085106383,39,8,16,37.01108492177359,0.6063034188034189,45.88541666666666,1016.4583333333316,26.06303418803414,0
695,4,0,0,46,0.0,0.0,1.0,46,1350,900,450,0.6666666666666666,18,9,9,348.5829204602914,0.4551731078904992,0.2952539402023433,0.19344530970104332,129230.01284646145,-190.5032407830002,129039.50960567845,665,3,171.82608695652175,36,10,17,36.94438291431314,0.6125578703703703,45.80518018018019,1016.7792792792802,28.243868868868894,0
696,4,0,0,46,0.0,0.0,1.0,46,1400,900,500,0.6428571428571429,19,9,10,348.67555733678876,0.4550020128824477,0.2983887219912733,0.19404098052869745,129340.77222077936,-180.40683190983236,129160.36538886953,666,4,172.82608695652175,37,9,18,36.8293225180554,0.6117680180180181,45.696271929824555,1017.2149122807008,27.492294926505426,0
697,4,0,0,46,0.0,0.0,1.0,46,1200,1000,200,0.8333333333333334,14,10,4,349.62657273821355,0.4543075684380032,0.2961220858615816,0.1957662302112322,129581.83235627133,-138.94961282783078,129442.88274344351,667,5,173.82608695652175,38,8,16,36.55998600909409,0.612390350877193,45.4594017094017,1018.1623931623922,26.793747188484005,0
698,4,0,2,44,0.0,0.043478260869565216,0.9565217391304348,46,1800,1300,500,0.7222222222222222,23,13,10,348.6069730677885,0.45379428341384864,0.2920977633888875,0.19587315781976206,129717.8405677003,-155.89124936080623,129561.9493183395,668,6,174.82608695652175,38,8,16,36.44773640971859,0.6137609649122807,45.3258547008547,1018.696581196581,26.807804768331078,0
699,4,0,1,43,0.0,0.022727272727272728,0.9772727272727273,44,1300,1000,300,0.7692307692307693,16,10,6,349.42878495399174,0.45303690979563077,0.2823824319945103,0.1967444953300574,129799.47973738034,271.13489845861204,130070.61463583895,669,7,175.52272727272728,38,6,16,36.34387887048298,0.6145833333333333,45.245726495726494,1019.0170940170938,26.816239316239308,0
700,4,0,0,43,0.0,0.0,1.0,43,1400,900,500,0.6428571428571429,19,9,10,359.79466711186626,0.4511812476928756,0.28815460312970864,0.2025809642805773,129799.47973738034,740.2321206808348,130539.71185806119,670,8,180.09302325581396,38,5,16,36.079803592646954,0.6145833333333333,45.245726495726494,1019.0170940170938,26.816239316239308,0
701,4,0,0,43,0.0,0.0,1.0,43,1100,600,500,0.5454545454545454,16,6,10,359.59887553207807,0.4505583241048357,0.28646772480738947,0.20335721505392906,129970.32470703125,747.4365234375007,130717.76123046875,671,9,181.09302325581396,39,4,16,35.91116304014711,0.6145833333333333,45.078125,1019.6875,26.145833333333332,0
702,4,0,1,42,0.0,0.023255813953488372,0.9767441860465116,43,1700,1100,600,0.6470588235294118,23,11,12,365.6257722510108,0.44995847176079734,0.25334409312107153,0.19889813850846744,128439.03165562487,792.4522607589322,129231.4839163838,672,10,182.09302325581396,42,1,18,37.318771309307586,0.5944940476190477,46.584302325581405,1013.6627906976761,24.13482834994467,8
703,4,0,2,40,0.0,0.047619047619047616,0.9523809523809523,42,1350,900,450,0.6666666666666666,18,9,9,373.5590509135766,0.4497677119628339,0.2612943210359788,0.20337772729279927,128471.19005298894,1198.3151651864644,129669.5052181754,673,11,184.78571428571428,41,1,18,37.08482157419188,0.5962906504065041,46.552579365079374,1013.7896825396838,24.726577622919116,0
704,4,0,0,40,0.0,0.0,1.0,40,1150,500,650,0.43478260869565216,18,5,13,373.5428773378419,0.4478899572649573,0.24546593186372712,0.2039364286559991,128582.21379469898,1606.194023068284,130188.40781776726,674,12,182.575,40,0,18,36.97165163660653,0.5989583333333333,46.44308943089431,1014.2276422764232,25.35569105691058,0
705,4,0,0,40,0.0,0.0,1.0,40,1600,1200,400,0.75,20,12,8,372.1520664357408,0.44752938034188033,0.24621758285771533,0.20410119096615814,128762.65290377742,1583.8574715777518,130346.51037535517,675,13,183.575,40,0,18,36.822452521611424,0.60078125,46.26524390243902,1014.939024390243,25.373475609756078,0
706,4,1,0,41,0.024390243902439025,0.0,1.0,41,850,800,50,0.9411764705882353,9,8,1,372.2117710292933,0.4480945121951219,0.25429828068772475,0.206408345752608,129201.38888888882,1419.5479294731879,130620.93681836201,676,0,180.0731707317073,39,2,19,36.37295081967213,0.6068376068376069,45.83333333333333,1016.6666666666661,26.068376068376054,0
707,4,0,0,41,0.0,0.0,1.0,41,1500,1000,500,0.6666666666666666,20,10,10,367.5289037778982,0.447484756097561,0.2088748538754095,0.1968264547409857,127811.68845221597,1203.5785049245815,129015.26695714054,677,1,181.0731707317073,37,4,17,37.912961758114655,0.5962837837837838,47.20394736842105,1011.1842105263149,27.3293029871977,7
708,4,1,2,40,0.023809523809523808,0.047619047619047616,0.9523809523809523,42,1650,1400,250,0.8484848484848485,19,14,5,360.18968450833813,0.44947735191637633,0.2121097911515808,0.1943711532119028,128117.48940755356,829.3196179414175,128946.80902549498,678,0,177.73809523809524,38,4,18,37.7853700576896,0.5975877192982456,46.901709401709404,1012.3931623931628,26.641925326135862,0
709,4,2,2,40,0.047619047619047616,0.047619047619047616,0.9523809523809523,42,1000,800,200,0.8,12,8,4,355.6104717616123,0.450505710414247,0.19833034813579586,0.19445083243134956,128644.60699445975,749.4767301459608,129394.08372460572,679,0,166.38095238095238,37,5,16,37.362642311572266,0.6047297297297297,46.38157894736842,1014.4736842105257,27.41820768136556,0
710,4,0,0,40,0.0,0.0,1.0,40,1650,1200,450,0.7272727272727273,21,12,9,371.30656835463975,0.44666132478632475,0.20624215093047127,0.20213015737838952,128466.99948827579,1540.128145361781,130007.12763363757,680,1,175.675,35,5,17,37.146197244738715,0.606845238095238,46.556712962962955,1013.7731481481474,28.964947089947067,0
711,4,1,1,40,0.024390243902439025,0.024390243902439025,0.975609756097561,41,1100,900,200,0.8181818181818182,13,9,4,364.13711206033133,0.4478404471544715,0.21183849513223363,0.19989841218707835,128800.98637488838,1180.2438418147885,129981.23021670317,681,0,172.3658536585366,36,5,18,36.98667813031582,0.6082175925925926,46.22747747747748,1015.0900900900899,28.19694694694694,0
712,4,1,0,41,0.024390243902439025,0.0,1.0,41,1150,800,350,0.6956521739130435,15,8,7,380.8708671239829,0.4496951219512195,0.24948281019448326,0.20338965457919703,127696.68104383699,1527.189127604186,129223.87017144117,682,0,159.0,39,2,15,37.69377597993748,0.5916132478632479,47.31770833333334,1010.7291666666681,25.916132478632516,8
713,4,0,0,41,0.0,0.0,1.0,41,950,500,450,0.5263157894736842,14,5,9,390.12433270439635,0.44931402439024387,0.22943231735403513,0.20117812976276567,126276.38996056232,1688.603421853558,127964.99338241588,683,1,160.0,35,6,16,38.92407492706894,0.5845238095238094,48.72685185185185,1005.0925925925918,28.716931216931194,8
714,4,1,3,39,0.023809523809523808,0.07142857142857142,0.9285714285714286,42,1050,600,450,0.5714285714285714,15,6,9,380.4056816398668,0.45112272551296945,0.2286135221684067,0.19777112139706146,126609.88004474058,1232.623544152252,127842.50358889284,684,0,157.16666666666666,36,6,17,38.824083398605055,0.5859375,48.39527027027027,1006.418918918918,27.956081081081056,0
715,4,3,0,42,0.07142857142857142,0.0,1.0,42,1300,900,400,0.6923076923076923,17,9,8,373.7191657718603,0.4533488192024777,0.26190476190476164,0.19757507047089343,127290.80590303158,1115.1190041392922,128405.92490717088,685,0,156.04761904761904,36,6,20,38.291392329725106,0.5928819444444444,47.719594594594604,1009.121621621623,28.031156156156197,0
716,4,2,1,43,0.045454545454545456,0.022727272727272728,0.9772727272727273,44,1100,800,300,0.7272727272727273,14,8,6,365.61208252042036,0.45502995066948554,0.27784459440487397,0.19652408176651076,127960.02739800373,556.7464192708564,128516.77381727459,686,0,149.9090909090909,39,5,17,37.809400631456114,0.594284188034188,47.05729166666668,1011.7708333333354,25.942841880341934,0
717,4,1,1,43,0.022727272727272728,0.022727272727272728,0.9772727272727273,44,1700,1400,300,0.8235294117647058,20,14,6,358.86550793808607,0.4537856765327695,0.27067467244719845,0.19391831723131028,128171.57594601513,399.4044620252904,128570.98040804043,687,0,150.86363636363637,38,6,18,37.76354892030667,0.5981359649122807,46.8482905982906,1012.6068376068382,26.64754835807469,0
718,4,0,0,43,0.0,0.0,1.0,43,1600,1100,500,0.6875,21,11,10,365.18464569225733,0.45150424510889625,0.27602808021191105,0.19747338334974726,128200.0471298859,763.3377577715963,128963.3848876575,688,1,155.30232558139534,37,6,18,37.57443698570808,0.6002252252252251,46.82017543859648,1012.7192982456123,27.37079184447601,0
719,4,2,2,43,0.044444444444444446,0.044444444444444446,0.9555555555555556,45,1350,900,450,0.6666666666666666,18,9,9,357.2684939015429,0.4535774410774411,0.29022119907917165,0.19644851527629695,128865.8177692676,207.93932596338144,129073.75709523098,689,0,149.35555555555555,40,5,18,37.094843692656745,0.6018229166666667,46.16361788617886,1015.3455284552842,25.383638211382106,0
720,4,1,0,44,0.022727272727272728,0.0,1.0,44,1450,1100,350,0.7586206896551724,18,11,7,357.22514156883165,0.45275061663143057,0.27849436934888216,0.19680860335385347,128943.21852898406,412.3518986714223,129355.57042765548,690,0,140.70454545454547,40,4,19,37.01700186778733,0.6026041666666666,46.08739837398374,1015.6504065040649,25.391260162601622,0
721,4,0,0,44,0.0,0.0,1.0,44,1100,700,400,0.6363636363636364,15,7,8,358.78814059342324,0.45247533474277657,0.28233697381941814,0.1980566008565683,129020.64252635665,458.21528604004914,129478.8578123967,691,1,141.70454545454547,40,4,20,36.898361175019176,0.6033854166666667,46.011178861788615,1015.9552845528453,25.398882113821134,0
722,4,1,0,45,0.022222222222222223,0.0,1.0,45,1100,800,300,0.7272727272727273,14,8,6,350.47466976695125,0.45410353535353537,0.2729666543620035,0.19463630184474595,129258.63997443384,61.00841255281932,129319.64838698666,692,0,139.53333333333333,36,9,21,36.86715577703951,0.6128472222222222,45.777027027027025,1016.8918918918915,28.246996996996987,0
723,4,1,1,45,0.021739130434782608,0.021739130434782608,0.9782608695652174,46,1200,900,300,0.75,15,9,6,342.58618186884496,0.45525362318840584,0.2719135084863986,0.19275778268337276,129772.26382725153,-308.3631245891162,129463.90070266242,693,0,137.47826086956522,38,8,17,36.54582153717102,0.6143092105263157,45.272435897435884,1018.9102564102542,26.813427800269846,0
724,4,0,0,45,0.0,0.0,1.0,45,1350,1000,350,0.7407407407407407,17,10,7,349.3638577343969,0.4532617845117845,0.28258306730274874,0.19664677952306187,129787.30384589493,68.59863130963842,129855.90247720457,694,1,141.51111111111112,37,8,17,36.357899314896514,0.6162725225225225,45.25767543859649,1018.9692982456144,27.539710763394982,0
725,4,0,2,43,0.0,0.044444444444444446,0.9555555555555556,45,1300,900,400,0.6923076923076923,17,9,8,351.14903457047023,0.45265151515151514,0.2852090800477891,0.19864270203804002,129982.903393352,128.67420744846507,130111.57760080046,695,2,142.51111111111112,37,8,17,36.113799283154115,0.6182432432432432,45.06578947368422,1019.7368421052647,27.56045519203418,0
726,4,0,0,43,0.0,0.0,1.0,43,1400,1000,400,0.7142857142857143,18,10,8,353.67377282222355,0.4500968992248062,0.282685547956933,0.19124888558466344,128200.0471298859,536.6454101261686,128736.69254001207,696,3,144.2325581395349,37,6,19,37.86586906308646,0.6002252252252251,46.82017543859648,1012.7192982456123,27.37079184447601,8
727,4,0,0,43,0.0,0.0,1.0,43,1450,1100,350,0.7586206896551724,18,11,7,353.3638799872567,0.4504660391288298,0.2799657706634453,0.19161280816210388,128311.11495844858,468.1026854416573,128779.21764389024,697,4,145.2325581395349,37,6,19,37.7601911976912,0.6013513513513513,46.710526315789465,1013.1578947368408,27.382645803698402,0
728,4,0,0,43,0.0,0.0,1.0,43,1300,1000,300,0.7692307692307693,16,10,6,351.98018025564136,0.4497277593207826,0.27781985015697463,0.19162019107548928,128469.25593770537,443.72637245232613,128912.98231015769,698,5,146.2325581395349,38,5,19,37.63370745073243,0.6011513157894737,46.554487179487175,1013.7820512820506,26.678475033738174,0
729,4,0,0,43,0.0,0.0,1.0,43,1350,900,450,0.6666666666666666,18,9,9,351.8093283102753,0.44954318936877075,0.2766305519092498,0.1924413238268647,128658.86843450935,452.67801702095323,129111.5464515303,699,6,147.2325581395349,38,5,19,37.44449417298512,0.6030701754385965,46.36752136752136,1014.5299145299136,26.698155645524043,0
730,4,0,1,42,0.0,0.023255813953488372,0.9767441860465116,43,1300,700,600,0.5384615384615384,19,7,12,353.56247929770325,0.44945090439276486,0.27467947698278894,0.1943264453884369,128848.62075617287,511.20756172839873,129359.82831790127,700,7,148.2325581395349,38,5,20,37.20645234838121,0.6049890350877193,46.18055555555556,1015.2777777777779,26.717836257309944,0
731,4,1,0,43,0.023255813953488372,0.0,1.0,43,1100,800,300,0.7272727272727273,14,8,6,350.3636291841103,0.44984311554079,0.289261753168192,0.19415899427413003,129174.23575726869,451.5908074001108,129625.8265646688,701,0,148.06976744186048,38,5,21,36.95590296023822,0.6082785087719298,45.86004273504274,1016.5598290598297,26.751574448942886,0
732,4,2,0,45,0.044444444444444446,0.0,1.0,45,1750,1300,450,0.7428571428571429,22,13,9,343.9221495299556,0.45113636363636367,0.3048352122429976,0.19422770210327067,129917.22140842045,-63.71513688279708,129853.50627153766,702,0,142.44444444444446,39,6,22,36.36467167330814,0.6140491452991452,45.13020833333335,1019.4791666666691,26.140491452991515,0
733,4,0,0,45,0.0,0.0,1.0,45,1300,900,400,0.6923076923076923,17,9,8,305.6064408253102,0.45073653198653196,0.2014060485045137,0.16424040310752558,127952.841626492,-1178.8990535683718,126773.94257292362,703,1,143.44444444444446,43,2,17,39.334518906776474,0.5881782945736433,47.06439393939393,1011.7424242424227,23.528893587033085,8
734,4,0,0,45,0.0,0.0,1.0,45,1650,1100,550,0.6666666666666666,22,11,11,308.1641743111645,0.450462962962963,0.20499324394553642,0.16620963791051171,128096.59539284873,-1105.0436897383058,126991.55170311042,704,2,144.44444444444446,43,2,17,39.123401933271,0.5896317829457365,46.92234848484848,1012.3106060606043,23.542107117688474,0
735,4,2,0,47,0.0425531914893617,0.0,1.0,47,1300,900,400,0.6923076923076923,17,9,8,302.2544642857146,0.45278291705211227,0.22166413373860272,0.16529541015624993,128649.44339424472,-1623.026281243451,127026.41711300127,705,0,139.25531914893617,45,2,17,38.7109375,0.5925925925925926,46.37681159420289,1014.4927536231869,22.544283413848596,0
736,4,1,0,48,0.020833333333333332,0.0,1.0,48,1600,1100,500,0.6875,21,11,10,302.70536565457206,0.4528294917257683,0.22940663176265308,0.16710036080931578,129021.19171570845,-1788.918596901565,127232.27311880689,706,0,137.33333333333334,46,2,18,38.32224403723096,0.5951086956521738,46.01063829787234,1015.9574468085106,22.086031452358924,0
737,4,0,1,47,0.0,0.020833333333333332,0.9791666666666666,48,1550,1200,350,0.7741935483870968,19,12,7,304.5909463728043,0.45244163711583923,0.2316531437212832,0.1683327592731472,129066.22922010919,-1737.5190194155575,127328.71020069363,707,1,138.33333333333334,46,2,18,38.22867591461641,0.5955615942028986,45.96631205673757,1016.1347517730459,22.089885908109693,0
738,4,0,0,47,0.0,0.0,1.0,47,1150,700,450,0.6086956521739131,16,7,9,304.5840601675769,0.4506051495528831,0.22701103652292676,0.16851248299212096,129109.31592627594,-1535.0720699432945,127574.24385633264,708,2,142.17021276595744,45,2,18,38.185160427807475,0.5972222222222222,45.92391304347826,1016.3043478260865,22.58454106280192,0
739,4,2,1,48,0.04081632653061224,0.02040816326530612,0.9795918367346939,49,1150,600,550,0.5217391304347826,17,6,11,294.72540218283143,0.4511940192743764,0.23506775198487406,0.16530773577812155,129648.92082475996,-2157.7354772638264,127491.18534749614,709,0,137.3265306122449,44,5,16,37.88961875321998,0.6039299242424243,45.39351851851852,1018.4259259259261,23.146043771043775,0
740,4,0,1,47,0.0,0.020833333333333332,0.9791666666666666,48,1400,900,500,0.6428571428571429,19,9,10,296.5473671367782,0.4505577718676123,0.23193282405723314,0.16603028762912483,129578.20644718791,-1914.7848079561045,127663.4216392318,710,1,141.1875,44,4,16,37.914734145749954,0.603219696969697,45.46296296296296,1018.148148148148,23.139730639730637,0
741,4,2,0,49,0.04081632653061224,0.0,1.0,49,1350,800,550,0.5925925925925926,19,8,11,288.2057379099956,0.45241638321995464,0.24002782931354494,0.1636264834585776,130123.92354547317,-2299.5077189666376,127824.41582650653,711,0,138.57142857142858,45,4,20,37.57620146780305,0.6074074074074074,44.92753623188404,1020.28985507246,22.67310789049911,0
742,4,0,0,49,0.0,0.0,1.0,49,1600,1200,400,0.75,20,12,8,289.3794252394838,0.4516723356009071,0.2423990004164931,0.164878974845752,130262.58680555521,-2260.9375000000364,128001.64930555518,712,1,139.57142857142858,45,4,20,37.406462585033985,0.6087962962962963,44.79166666666665,1020.8333333333306,22.685185185185126,0
743,4,0,2,47,0.0,0.04081632653061224,0.9591836734693877,49,1350,1000,350,0.7407407407407407,17,10,7,290.6171457780096,0.4510700113378685,0.24443463089386164,0.16617641662235444,130401.32390779216,-2220.627888048761,128180.6960197434,713,2,140.57142857142858,45,4,20,37.23505675771551,0.6101851851851852,44.65579710144926,1021.3768115942003,22.697262479871117,0
744,4,0,1,46,0.0,0.02127659574468085,0.9787234042553191,47,1850,1100,750,0.5945945945945946,26,11,15,299.8861938650435,0.45004625346901017,0.25235601061363866,0.1713975941088761,130383.45210808364,-1579.960560864329,128803.49154721931,714,3,146.87234042553192,43,4,20,37.01640009272139,0.6126453488372092,44.67329545454545,1021.3068181818178,23.75132135306553,0
745,4,0,0,46,0.0,0.0,1.0,46,1400,1000,400,0.7142857142857143,18,10,8,304.31291789955026,0.45030193236714977,0.25355719977233915,0.174162148778342,130435.75074364521,-1261.343218556577,129174.40752508864,715,4,149.3913043478261,42,4,20,36.85061341933853,0.6145833333333333,44.622093023255815,1021.5116279069767,24.32170542635659,0
746,4,0,1,45,0.0,0.021739130434782608,0.9782608695652174,46,1050,600,450,0.5714285714285714,15,6,9,302.10091822147103,0.4499899355877617,0.2520321181843661,0.17355993929194305,130584.26852352619,-1310.074514752725,129274.19400877347,716,5,150.3913043478261,42,4,16,36.75736316521299,0.6160714285714286,44.47674418604651,1022.0930232558137,24.33554817275747,0
747,4,0,0,45,0.0,0.0,1.0,45,1050,800,250,0.7619047619047619,13,8,5,305.19088672897806,0.4494318181818182,0.23424618591869617,0.17589729260791392,130708.0978926296,-1021.8159402980657,129686.28195233153,717,6,149.42222222222222,42,3,17,36.553586657822414,0.6173115079365079,44.35562015503876,1022.5775193798445,24.347083794758202,0
748,4,0,1,44,0.0,0.022222222222222223,0.9777777777777777,45,1950,1600,350,0.8205128205128205,23,16,7,311.4362029022335,0.4490740740740741,0.24327662574040776,0.18042115956393254,130906.3469461722,-846.2048742563422,130060.14207191585,718,7,150.42222222222222,42,3,17,36.1940946248777,0.6192956349206349,44.16182170542636,1023.3527131782953,24.36554078995941,0
749,4,1,1,44,0.022222222222222223,0.022222222222222223,0.9777777777777777,45,1400,1000,400,0.7142857142857143,18,10,8,316.93596216936123,0.44962121212121214,0.2575692605204527,0.1849142931597398,131179.1846944294,-684.9197764557368,130494.26491797366,719,0,150.6888888888889,42,3,18,35.77847143397655,0.6220238095238095,43.895348837209305,1024.4186046511627,24.390919158361015,0
750,4,0,0,44,0.0,0.0,1.0,44,1350,1000,350,0.7407407407407407,17,10,7,317.87324167637627,0.4484452078928823,0.25417304949553654,0.1854440165847606,131175.63952664402,-460.55484693877156,130715.08467970525,720,1,154.9318181818182,41,3,19,35.758037962424936,0.6234756097560976,43.898809523809526,1024.4047619047622,24.985481997677127,0
751,4,0,1,43,0.0,0.022727272727272728,0.9772727272727273,44,1250,800,450,0.64,17,8,9,318.1080263227166,0.4472559901338971,0.2584564549766364,0.18619682832521164,131302.70460325343,-446.31115756487463,130856.39344568855,721,2,155.9318181818182,41,3,20,35.62407237118059,0.6247459349593496,43.77480158730159,1024.9007936507942,24.9975803329462,0
752,4,0,1,42,0.0,0.023255813953488372,0.9767441860465116,43,900,500,400,0.5555555555555556,13,5,8,324.2827009914859,0.4461747877445552,0.26332006646493644,0.19058455071083763,131458.3656078557,-74.06522655166509,131384.30038130403,722,3,158.86046511627907,40,3,20,35.30910382188748,0.6278645833333334,43.62296747967479,1025.5081300813001,25.6377032520325,0
753,4,0,1,41,0.0,0.023809523809523808,0.9761904761904762,42,1050,800,250,0.7619047619047619,13,8,5,331.28783085514686,0.44509775454897405,0.2615419961788683,0.19471813103098012,131461.6224500866,310.3271484374797,131771.94959852408,723,4,156.8095238095238,39,3,20,35.12622735737263,0.6295405982905983,43.61979166666666,1025.5208333333317,26.29540598290594,0
754,4,0,0,41,0.0,0.0,1.0,41,1500,900,600,0.6,21,9,12,329.884439666756,0.4453506097560975,0.19992003198720454,0.18293591654247388,129201.38888888895,375.4394531250042,129576.82834201395,724,5,159.21951219512195,37,4,18,37.44877049180328,0.6103603603603603,45.833333333333336,1016.6666666666672,27.477477477477493,8
755,4,0,0,41,0.0,0.0,1.0,41,1750,1400,350,0.8,21,14,7,333.4750804593631,0.444385162601626,0.20182328964761465,0.18610837172238995,129452.33298947733,433.825431863629,129886.15842134097,725,6,160.21951219512195,37,4,17,37.10257066408074,0.6128941441441442,45.586622807017534,1017.6535087719283,27.50414888572779,0
756,4,0,0,41,0.0,0.0,1.0,41,1300,700,600,0.5384615384615384,19,7,12,334.4027393964844,0.4437245934959349,0.20361099583427444,0.18728973691409845,129591.85157933201,467.1740343182408,130059.02561365026,726,7,161.21951219512195,37,4,18,36.93732500538446,0.6143018018018018,45.44956140350877,1018.2017543859641,27.51896633475579,0
757,4,1,0,42,0.023809523809523808,0.0,1.0,42,1000,800,200,0.8,12,8,4,329.4583379296244,0.4446501161440186,0.21786811958647667,0.1862766811137639,129962.83512309153,163.4679304551099,130126.30305354664,727,0,158.35714285714286,38,4,20,36.68709835149482,0.6162280701754386,45.085470085470085,1019.6581196581196,26.83310841205578,0
758,4,0,0,42,0.0,0.0,1.0,42,1550,1000,550,0.6451612903225806,21,10,11,332.26731112192124,0.4437669376693767,0.1897542339740701,0.18199970709550223,128713.06911571343,198.6353093724984,128911.70442508593,728,1,159.35714285714286,38,4,15,37.884949463044876,0.6036184210526316,46.31410256410257,1014.7435897435904,26.703778677462907,8
759,4,0,1,41,0.0,0.023809523809523808,0.9761904761904762,42,1250,900,350,0.72,16,9,7,330.4024741089459,0.4442508710801394,0.18902963484244295,0.18127487093004355,128778.12500000023,109.72222222225085,128887.84722222248,729,2,160.35714285714286,39,3,15,37.86603721948552,0.6025641025641026,46.250000000000014,1015.0000000000018,26.02564102564107,0
760,4,1,1,41,0.023809523809523808,0.023809523809523808,0.9761904761904762,42,1350,800,550,0.5925925925925926,19,8,11,328.5321542373461,0.4437427409988386,0.2026848881662784,0.18133413131164908,129016.1254882814,77.18912760418144,129093.31461588558,730,0,161.28571428571428,39,3,18,37.671421613862414,0.6049679487179487,46.01562500000001,1015.9375000000011,26.049679487179517,0
761,4,2,2,41,0.046511627906976744,0.046511627906976744,0.9534883720930233,43,1400,800,600,0.5714285714285714,20,8,12,348.38019153309426,0.4464285714285714,0.23262871863641177,0.1870870574554322,127922.58795975671,333.9372075422092,128256.52516729893,731,0,158.2325581395349,37,6,20,38.283564563913565,0.5974099099099099,47.09429824561403,1011.6228070175428,27.341156946420075,8
762,4,3,1,43,0.06818181818181818,0.022727272727272728,0.9772727272727273,44,1000,800,200,0.8,12,8,4,341.0647157078503,0.449667459478506,0.23680251499242577,0.18607777328967506,128555.015700017,-30.306922844750545,128524.70877717224,732,0,151.1590909090909,35,9,18,37.822890512059644,0.6077380952380953,46.4699074074074,1014.1203703703692,28.974867724867693,0
763,4,3,0,46,0.06521739130434782,0.0,1.0,46,900,500,400,0.5555555555555556,13,5,8,329.6561602827538,0.45019122383252813,0.25896287736530366,0.18307473107953662,129258.63997443386,-676.1977063243228,128582.44226810953,733,0,145.52173913043478,36,10,21,37.39641011443335,0.6128472222222222,45.777027027027025,1016.8918918918916,28.24699699699699,0
764,4,1,0,47,0.02127659574468085,0.0,1.0,47,1050,900,150,0.8571428571428571,12,9,3,321.3266800828138,0.45095205057045945,0.2616352085949747,0.1797106564993277,129536.03512619255,-1075.3231763619701,128460.71194983058,734,0,143.40425531914894,37,10,18,37.32676288955908,0.6137387387387387,45.504385964912274,1017.9824561403499,27.513039355144592,0
765,4,1,1,47,0.020833333333333332,0.020833333333333332,0.9791666666666666,48,1350,700,650,0.5185185185185185,20,7,13,317.75561472510543,0.45077940307328607,0.268156290395835,0.1792848208215395,129881.14458917748,-1345.9074119731197,128535.23717720436,735,0,141.39583333333334,38,10,19,37.06809209377074,0.6154057017543859,45.16559829059829,1019.3376068376072,26.824673864147556,0
766,4,0,1,46,0.0,0.02127659574468085,0.9787234042553191,47,1650,1000,650,0.6060606060606061,23,10,13,322.0391719062844,0.4495259019426457,0.26163756988036235,0.1813958826483036,129815.23762119119,-1038.8816751308025,128776.35594606039,736,1,145.36170212765958,37,10,19,37.02567964995338,0.6165540540540541,45.23026315789474,1019.0789473684215,27.54267425320058,0
767,4,1,1,46,0.02127659574468085,0.02127659574468085,0.9787234042553191,47,2050,1300,750,0.6341463414634146,28,13,15,320.9769831314177,0.44933317915510335,0.26166716558086134,0.18301388180873474,130290.57167830525,-1035.945074445942,129254.6266038593,737,0,143.70212765957447,37,10,20,36.571774424515816,0.6213400900900901,44.76425438596493,1020.9429824561435,27.59305357989577,0
768,4,0,0,46,0.0,0.0,1.0,46,1200,900,300,0.75,15,9,6,328.69637650978746,0.44728260869565223,0.26095829636202295,0.18728049359278615,130262.58680555574,-636.6319444444208,129625.95486111131,738,1,147.69565217391303,37,9,22,36.40306122448981,0.6210585585585586,44.79166666666668,1020.8333333333348,27.590090090090133,0
769,4,0,0,46,0.0,0.0,1.0,46,1900,1400,500,0.7368421052631579,24,14,10,331.2113160163788,0.4464472624798712,0.2652939309649591,0.18953099631502388,130430.54112803961,-559.9857648507028,129870.5553631889,739,2,148.69565217391303,37,9,23,36.16895663374839,0.6227477477477478,44.62719298245615,1021.4912280701772,27.607871028923707,0
770,4,0,2,44,0.0,0.043478260869565216,0.9565217391304348,46,1550,1300,250,0.8387096774193549,18,13,5,332.0670303012839,0.4459541062801932,0.2685605813270151,0.1908464153186542,130598.60365689457,-526.501904432114,130072.10175246246,740,3,149.69565217391303,37,9,18,35.977168704855906,0.6244369369369369,44.462719298245624,1022.1491228070187,27.62565196775726,0
771,4,0,0,44,0.0,0.0,1.0,44,1600,1300,300,0.8125,19,13,6,336.7505364998779,0.4449326109936575,0.2589927697330212,0.19372759000924533,130636.47050766983,-1.6196940183397714,130634.85081365149,741,4,152.22727272727272,36,8,19,35.81919659249469,0.6267361111111112,44.42567567567568,1022.2972972972973,28.397147147147148,0
772,4,0,0,44,0.0,0.0,1.0,44,1350,1000,350,0.7407407407407407,17,10,7,336.0715875484424,0.4445582276250881,0.2544043162299059,0.19391373304415213,130751.61944038639,-11.619136027907814,130740.00030435849,742,5,153.22727272727272,36,8,19,35.7201515818836,0.6278935185185186,44.31306306306307,1022.7477477477482,28.409659659659674,0
773,4,0,0,44,0.0,0.0,1.0,44,1350,900,450,0.6666666666666666,18,9,9,335.60084281255416,0.4439085623678647,0.25375037503750386,0.19480278806935616,130982.06948502555,-8.46141749857992,130973.60806752698,743,6,154.22727272727272,36,8,19,35.49940410707737,0.6302083333333333,44.08783783783784,1023.6486486486485,28.434684684684683,0
774,4,1,0,45,0.022222222222222223,0.0,1.0,45,1350,1000,350,0.7407407407407407,17,10,7,331.2097902524528,0.44433922558922556,0.2628246733949098,0.19385209201563372,131300.02891514672,-302.4289925746707,130997.59992257204,744,0,151.77777777777777,37,8,20,35.2910693270568,0.6314752252252251,43.77741228070174,1024.890350877191,27.699739212897054,0
775,4,1,0,46,0.021739130434782608,0.0,1.0,46,1450,1000,450,0.6896551724137931,19,10,9,342.2979748868335,0.4451590177133655,0.24608042194683621,0.19573392486622784,130402.54122662733,-127.40073868883741,130275.1404879385,745,0,149.45652173913044,37,9,19,35.914184111647884,0.6224662162162162,44.65460526315789,1021.3815789473678,27.60490753911805,8
776,4,0,1,45,0.0,0.021739130434782608,0.9782608695652174,46,1150,800,350,0.6956521739130435,15,8,7,341.9549392178237,0.44480676328502416,0.24478568828914593,0.19596163121966048,130486.54994806091,-275.8959487534665,130210.65399930745,746,1,150.45652173913044,37,9,22,35.83789439793947,0.6233108108108107,44.57236842105263,1021.7105263157893,27.613798008534843,0
777,4,0,0,45,0.0,0.0,1.0,45,900,600,300,0.6666666666666666,12,6,6,343.6988332431679,0.4457070707070707,0.24222746668573714,0.19753147493790457,130598.6036568945,-22.682459987683046,130575.92119690681,747,2,152.7111111111111,37,8,13,35.67993277551312,0.6244369369369369,44.46271929824562,1022.1491228070181,27.625651967757246,0
778,4,0,1,44,0.0,0.022222222222222223,0.9777777777777777,45,1450,1000,450,0.6896551724137931,19,10,9,344.8274910335011,0.44564393939393937,0.244504021447721,0.19861126336549725,130682.67549871128,12.595822753167255,130695.27132146445,748,3,153.7111111111111,37,8,14,35.56601876675603,0.6252815315315315,44.380482456140356,1022.4780701754397,27.634542437174048,0
779,4,0,0,44,0.0,0.0,1.0,44,1500,1100,400,0.7333333333333333,19,11,8,347.7880309246387,0.4454171071176885,0.24364517032945043,0.20097369420607,130809.21292914549,298.7757182858708,131107.98864743137,749,4,156.0909090909091,36,8,16,35.362312857771904,0.6284722222222222,44.256756756756765,1022.972972972974,28.415915915915946,0
780,4,0,0,44,0.0,0.0,1.0,44,1000,700,300,0.7,13,7,6,346.8383592369145,0.44525193798449614,0.24471945908555037,0.20064158276749236,130850.90033712308,276.8223155201698,131127.72265264325,750,5,157.0909090909091,37,7,17,35.34443878826849,0.6269707207207207,44.21600877192983,1023.1359649122817,27.65232337600761,0
781,4,0,0,44,0.0,0.0,1.0,44,950,600,350,0.631578947368421,13,6,7,344.9307895127015,0.444899577167019,0.24300549429139218,0.19968325854420194,130878.94833025569,228.83579562945027,131107.78412588514,751,6,158.0909090909091,37,7,17,35.36487355336477,0.6272522522522522,44.18859649122808,1023.2456140350896,27.65528686581323,0
782,4,1,2,43,0.022222222222222223,0.044444444444444446,0.9555555555555556,45,1600,1200,400,0.75,20,12,8,338.7120099251803,0.4458333333333333,0.2375993511759935,0.1978226659672645,131218.6392815401,-110.9341898604543,131107.70509167964,752,0,155.55555555555554,38,7,19,35.1809610705596,0.6288377192982456,43.856837606837615,1024.572649572651,26.96243814664871,0
783,4,0,2,41,0.0,0.046511627906976744,0.9534883720930233,43,1100,700,400,0.6363636363636364,15,7,8,353.17791570062974,0.4424141749723145,0.2466119390763184,0.20469903685505897,130924.4379514651,647.9240219949797,131572.36197346007,753,1,163.13953488372093,36,7,20,35.10788035504695,0.6296296296296297,44.14414414414415,1023.4234234234243,28.428428428428454,0
784,4,0,1,40,0.0,0.024390243902439025,0.975609756097561,41,1550,1300,250,0.8387096774193549,18,13,5,368.11135532532165,0.44159044715447154,0.2517354705778847,0.21289024143107757,130840.48327664395,1432.773526077095,132273.25680272104,754,2,169.3658536585366,34,7,20,34.81086610813745,0.6329656862745099,44.226190476190474,1023.0952380952378,30.09103641456582,0
785,4,0,0,40,0.0,0.0,1.0,40,850,600,250,0.7058823529411765,11,6,5,378.0057325131387,0.44006410256410255,0.2562627291242361,0.21835389960464835,130794.8133680556,1888.2378472222276,132683.05121527784,755,3,172.875,33,7,21,34.60412423625254,0.6347853535353536,44.270833333333336,1022.9166666666671,30.99747474747476,0
786,4,2,0,42,0.047619047619047616,0.0,1.0,42,1150,900,250,0.782608695652174,14,9,5,357.7173556853345,0.4425087108013937,0.24692013358989717,0.20985435062412122,131389.14399092968,1001.1205002834474,132390.26449121314,756,0,165.5952380952381,34,8,23,34.521839681065195,0.6384803921568627,43.69047619047619,1025.238095238095,30.154061624649852,0
787,4,0,0,42,0.0,0.0,1.0,42,1400,1100,300,0.7857142857142857,17,11,6,354.04620809738753,0.4416134339914828,0.245474766686546,0.20849910580512585,131535.81700370798,913.9514478309308,132449.76845153893,757,1,166.5952380952381,35,7,23,34.467848546391366,0.6377976190476191,43.5474537037037,1025.810185185185,29.30886243386243,0
788,4,0,0,42,0.0,0.0,1.0,42,1200,700,500,0.5833333333333334,17,7,10,354.32096714075055,0.44099641889276037,0.24129793985471082,0.20963793579528464,131713.9693313829,933.8041998885528,132647.77353127144,758,2,167.5952380952381,35,7,18,34.2810397639719,0.6395833333333334,43.373842592592595,1026.5046296296298,29.32870370370371,0
789,4,1,1,42,0.023255813953488372,0.023255813953488372,0.9767441860465116,43,1400,1000,400,0.7142857142857143,18,10,8,346.6186524444446,0.4419066076042821,0.23345612403100757,0.20710961546632672,132087.85545792922,556.8228926207896,132644.67835055,759,0,164.67441860465115,37,6,21,34.1021111111111,0.6393581081081081,43.00986842105262,1027.9605263157882,27.782716927453738,0
790,4,0,1,41,0.0,0.023809523809523808,0.9761904761904762,42,1350,1100,250,0.8148148148148148,16,11,5,353.86334483720117,0.4401011420828494,0.23720567442491447,0.21123026476972748,132050.54029959004,945.5691755945054,132996.10947518455,760,1,169.52380952380952,36,6,21,33.953517037361685,0.6409143518518519,43.04617117117117,1027.8153153153146,28.550425425425406,0
791,4,0,1,40,0.0,0.024390243902439025,0.975609756097561,41,1200,800,400,0.6666666666666666,16,8,8,367.21971300539894,0.4404217479674797,0.13525784870918334,0.20833001279281932,130094.74068944316,1362.2827986096354,131457.0234880528,761,2,169.34146341463415,37,4,19,35.59042705646318,0.6193693693693694,44.956140350877206,1020.1754385964933,27.572309151256576,8
792,4,0,2,38,0.0,0.05,0.95,40,1050,600,450,0.5714285714285714,15,6,9,379.318219169113,0.438261217948718,0.15135791565467005,0.21501028968922578,130061.48674011865,1866.9383065498096,131928.42504666845,762,6,174.525,36,4,19,35.315696989769634,0.6209490740740741,44.988738738738746,1020.0450450450462,28.33458458458462,0
793,4,0,0,38,0.0,0.0,1.0,38,1250,1100,150,0.88,14,11,3,392.58408977021855,0.43644796111901374,0.17075149339954265,0.22177375625278056,129928.59977324268,2601.5802154195053,132530.1799886622,763,7,182.8421052631579,34,4,19,35.112826950023354,0.6237745098039216,45.11904761904762,1019.5238095238099,29.985994397759114,0
794,4,0,0,38,0.0,0.0,1.0,38,1150,800,350,0.6956521739130435,15,8,7,392.04232306633986,0.43584044570886676,0.16725835477946793,0.22233028897124202,130080.35891439911,2599.401218820863,132679.76013321997,764,8,183.8421052631579,34,4,20,34.971992064418245,0.6253063725490196,44.970238095238095,1020.1190476190478,30.00350140056023,0
795,4,1,1,38,0.02564102564102564,0.02564102564102564,0.9743589743589743,39,1400,1100,300,0.7857142857142857,17,11,6,384.2423356960283,0.4378936122357175,0.16178918062541414,0.2198119332893889,130419.01139285372,2222.7562133922243,132641.76760624594,765,0,180.10256410256412,33,6,22,34.826409718056404,0.6309974747474747,44.638480392156865,1021.4460784313726,30.95291146761735,0
796,4,0,0,38,0.0,0.0,1.0,38,1250,700,550,0.56,18,7,11,385.72575419170886,0.4373221906116643,0.1662584742018154,0.22119541529920692,130512.91120001921,2468.438220876587,132981.3494208958,766,1,183.76315789473685,33,5,16,34.69307187974735,0.6319444444444444,44.54656862745098,1021.813725490196,30.964052287581698,0
797,4,0,3,35,0.0,0.07894736842105263,0.9210526315789473,38,1300,1000,300,0.7692307692307693,16,10,6,385.4548049100189,0.43622569938359407,0.16656150026186478,0.2215767420919687,130606.84479827466,2468.6071763264104,133075.45197460108,767,2,184.76315789473685,33,5,16,34.60453882428166,0.6328914141414141,44.4546568627451,1022.1813725490192,30.975193107546037,0
798,4,0,0,35,0.0,0.0,1.0,35,950,600,350,0.631578947368421,13,6,7,404.82641971271903,0.4320028011204482,0.15350167755606603,0.23161568143393893,130423.75299714308,3559.796194265885,133983.54919140897,768,12,181.02857142857144,32,3,21,34.295941491553364,0.6334635416666667,44.63383838383838,1021.464646464646,31.920770202020186,0
799,4,0,0,35,0.0,0.0,1.0,35,1400,900,500,0.6428571428571429,19,9,10,407.5610465100305,0.43137254901960786,0.1535740760351587,0.23395738372001335,130552.75769054188,3641.6437098255433,134194.40140036744,769,13,182.02857142857144,32,3,16,34.094699777613066,0.634765625,44.507575757575765,1021.9696969696977,31.936553030303052,0
800,4,1,1,35,0.027777777777777776,0.027777777777777776,0.9722222222222222,36,1100,800,300,0.7272727272727273,14,8,6,394.5045112635864,0.43283730158730155,0.14041842896283896,0.22918572232934645,131014.28086553258,3137.144968281441,134151.42583381402,770,0,177.94444444444446,33,3,17,33.95928098316177,0.6369949494949495,44.05637254901961,1023.7745098039223,31.023469994058253,0
801,4,1,0,36,0.027777777777777776,0.0,1.0,36,1000,600,400,0.6,14,6,8,393.8920812252465,0.4349867724867725,0.1241892610313664,0.22995375691641504,131202.5422914265,3135.9284890426943,134338.47078046922,771,0,161.19444444444446,33,3,19,33.78389154704944,0.6388888888888888,43.87254901960785,1024.5098039215698,31.045751633986963,0
802,4,0,0,36,0.0,0.0,1.0,36,1300,1000,300,0.7692307692307693,16,10,6,393.8582267184304,0.43411044973544977,0.12154958875614152,0.230883389366566,131360.4817907613,3147.541356846418,134508.02314760772,772,1,162.19444444444446,32,4,19,33.624574044422566,0.6429036458333333,43.71843434343435,1025.1262626262637,32.03519570707074,0
803,4,0,0,36,0.0,0.0,1.0,36,650,500,150,0.7692307692307693,8,5,3,393.100111626101,0.43387896825396827,0.12363163656267084,0.23063388052051612,131392.84256708517,3130.108215998392,134522.95078308356,773,2,163.19444444444446,32,4,19,33.61119663382595,0.6432291666666667,43.6868686868687,1025.2525252525268,32.03914141414146,0
804,4,0,0,36,0.0,0.0,1.0,36,1150,700,450,0.6086956521739131,16,7,9,394.39702836766014,0.4332671957671958,0.125135075984516,0.23198313261625692,131489.9488094329,3171.8490141312377,134661.79782356415,774,3,164.19444444444446,32,4,19,33.47952316467643,0.6442057291666667,43.59217171717173,1025.6313131313148,32.050978535353586,0
805,4,0,2,34,0.0,0.05555555555555555,0.9444444444444444,36,1350,700,650,0.5185185185185185,20,7,13,405.31855877168863,0.4327215608465609,0.1552209840991614,0.21340008760115228,127123.84458537404,3119.9609733700804,130243.80555874412,775,4,165.19444444444446,32,4,19,37.666416259755444,0.5999348958333333,47.88510101010102,1008.4595959595968,31.5143623737374,8
806,4,1,0,35,0.02857142857142857,0.0,1.0,35,1200,1000,200,0.8333333333333334,14,10,4,415.33442812391826,0.4319327731092437,0.17645973958909678,0.21885581498284828,127157.66906738281,3562.591552734376,130720.26062011719,776,0,170.62857142857143,31,4,20,37.37896979085979,0.6028225806451613,47.8515625,1008.59375,32.53528225806452,0
807,4,0,1,34,0.0,0.02857142857142857,0.9714285714285714,35,950,500,450,0.5263157894736842,14,5,9,414.22163066975565,0.43151260504201683,0.17720650016983397,0.21877363190231444,127251.20722694117,3542.0405124477174,130793.24773938888,777,1,171.62857142857143,32,3,20,37.3104638551704,0.6012369791666667,47.75883838383839,1008.9646464646469,31.530145202020215,0
808,4,3,1,36,0.08108108108108109,0.02702702702702703,0.972972972972973,37,1100,700,400,0.6363636363636364,15,7,8,389.84533383076695,0.4377815315315315,0.16504191398440837,0.21036256230831096,128115.23604948999,2589.0253933041954,130704.26144279419,778,0,156.83783783783784,35,2,19,37.03710319728668,0.6032738095238095,46.90393518518519,1012.3842592592601,28.925264550264576,0
809,4,0,1,35,0.0,0.027777777777777776,0.9722222222222222,36,1250,800,450,0.64,17,8,9,397.5432525951557,0.4351521164021164,0.1725490196078432,0.2138682055100523,127993.90589569173,2976.6227324263223,130970.52862811805,779,1,162.13888888888889,34,2,19,36.966911764705905,0.6041666666666667,47.02380952380953,1011.9047619047628,29.761904761904788,0
810,4,2,2,35,0.05405405405405406,0.05405405405405406,0.9459459459459459,37,850,500,350,0.5882352941176471,12,5,7,381.85466417966734,0.440284034034034,0.16903865489712233,0.20870965961994514,128627.12762188211,2423.462301587306,131050.58992346942,780,0,153.05405405405406,34,3,17,36.71492978132456,0.6106004901960784,46.398809523809526,1014.4047619047622,29.835434173669476,0
811,4,0,0,35,0.0,0.0,1.0,35,1050,800,250,0.7619047619047619,13,8,5,395.0155518013213,0.4374299719887955,0.1760273363113778,0.21467771390042026,128400.34060618824,3144.026279206218,131544.36688539447,781,1,161.45714285714286,32,3,17,36.61366845230682,0.6129557291666667,46.622474747474755,1013.5101010101018,31.672190656565682,0
812,4,0,0,35,0.0,0.0,1.0,35,1050,500,550,0.47619047619047616,16,5,11,398.43691239963994,0.4370798319327731,0.1740968034580288,0.21723332270750234,128528.34093778703,3242.087063820027,131770.42800160704,782,2,162.45714285714286,32,3,18,36.39568546880836,0.6142578125,46.496212121212125,1014.0151515151521,31.687973484848502,0
813,4,0,1,34,0.0,0.02857142857142857,0.9714285714285714,35,800,500,300,0.625,11,5,6,370.1562333935591,0.43651960784313726,0.13832106038291592,0.19728106944601792,127617.73003472228,2447.6996527777837,130065.42968750006,783,3,163.45714285714286,35,0,17,38.04553264604811,0.5982142857142857,47.395833333333336,1010.4166666666672,28.869047619047635,8
814,4,1,1,34,0.02857142857142857,0.02857142857142857,0.9714285714285714,35,500,200,300,0.4,8,2,6,363.2736203258117,0.4374299719887955,0.12898332788492928,0.19502527282847645,127910.26341735267,2293.2848936899995,130203.54831104267,784,0,160.65714285714284,35,0,19,37.91952707856597,0.6011904761904762,47.10648148148149,1011.5740740740753,28.902116402116437,0
815,4,0,0,34,0.0,0.0,1.0,34,900,700,200,0.7777777777777778,11,7,4,369.9194222873282,0.4358845811051693,0.15103853048455562,0.19885801201897563,127963.79145408176,2667.2583616780234,130631.04981575978,785,1,166.2058823529412,34,0,20,37.69659175589287,0.6038602941176471,47.05357142857144,1011.7857142857154,29.75840336134457,0
816,4,1,0,35,0.02857142857142857,0.0,1.0,35,1000,700,300,0.7,13,7,6,362.6826913786369,0.4387955182072829,0.15488527451868994,0.19673628975931062,128325.39859693899,2308.4077380952635,130633.80633503426,786,0,162.42857142857142,34,1,21,37.509546469275044,0.6075367647058824,46.696428571428584,1013.2142857142875,29.80042016806728,0
817,4,2,0,37,0.05405405405405406,0.0,1.0,37,800,400,400,0.5,12,4,8,356.76778587931716,0.4418793793793794,0.127916736612389,0.1852890758921614,126567.3828125,1668.7384849773243,128236.12129747732,787,0,154.59459459459458,35,2,16,39.462560386473434,0.5875,48.4375,1006.25,28.75,8
818,4,1,1,37,0.02631578947368421,0.02631578947368421,0.9736842105263158,38,1150,900,250,0.782608695652174,14,9,5,351.98663072093194,0.44449383594120434,0.13568316389230262,0.18478782003419755,127006.86486740148,1340.9436886210929,128347.80855602257,788,0,151.5,36,2,19,39.13110267009273,0.5899884259259259,48.001126126126145,1007.995495495498,27.999874874874944,0
819,4,1,0,38,0.02631578947368421,0.0,1.0,38,1150,800,350,0.6956521739130435,15,8,7,351.5558953334225,0.44630156472261734,0.14410691945800158,0.18585795740901495,127290.8059030316,1349.9666473906527,128640.77255042226,789,0,152.3684210526316,36,2,21,38.850528214856965,0.5928819444444444,47.719594594594604,1009.1216216216233,28.0311561561562,0
820,4,0,0,38,0.0,0.0,1.0,38,1250,700,550,0.56,18,7,11,350.5383786810014,0.4464349217638692,0.1366641808135196,0.1855803596053053,127347.63215495921,1328.046500892808,128675.67865585203,790,1,153.3684210526316,36,2,17,38.817918107776414,0.5934606481481481,47.6632882882883,1009.3468468468485,28.037412412412458,0
821,4,1,2,37,0.02564102564102564,0.05128205128205128,0.9487179487179487,39,1250,900,350,0.72,16,9,7,340.68024953865694,0.4486898335582546,0.1404275915015769,0.18194614949289356,127700.83703639593,901.0306055709557,128601.86764196688,791,0,150.4102564102564,37,2,19,38.70506979098863,0.5951576576576576,47.313596491228076,1010.7456140350887,27.31744902797537,0
822,4,1,1,37,0.02631578947368421,0.02631578947368421,0.9736842105263158,38,1400,1100,300,0.7857142857142857,17,11,6,345.78148911215663,0.4487316263632053,0.1340648323493372,0.18487673780582675,127745.7710032669,1234.424585058043,128980.19558832495,792,0,150.3684210526316,36,2,21,38.530178975901386,0.5975115740740741,47.26914414414415,1010.9234234234244,28.081206206206232,0
823,4,2,0,39,0.05128205128205128,0.0,1.0,39,1100,800,300,0.7272727272727273,14,8,6,330.9608156412351,0.44925213675213677,0.14112230013532234,0.17950625651321997,128320.37278163577,695.045844690406,129015.41862632618,793,0,145.89743589743588,35,4,23,38.318197395476346,0.6053571428571429,46.701388888888886,1013.1944444444442,28.948412698412692,0
824,4,1,1,39,0.025,0.025,0.975,40,1150,700,450,0.6086956521739131,16,7,9,328.11742274942577,0.45018696581196577,0.15992846844848607,0.1805146309293212,128886.7346020008,457.99663683955913,129344.73123884035,794,0,143.225,36,4,19,37.81352815053048,0.6090856481481481,46.143018018018026,1015.4279279279292,28.206331331331366,0
825,4,1,0,40,0.025,0.0,1.0,40,1050,700,350,0.6666666666666666,14,7,7,326.92948453954693,0.45157585470085465,0.1637177213786989,0.180642053827332,129058.31665702868,438.5937880448032,129496.91044507349,795,0,144.175,36,4,22,37.66924341497653,0.6108217592592593,45.9740990990991,1016.1036036036039,28.225100100100107,0
826,4,0,2,38,0.0,0.05,0.95,40,1050,600,450,0.5714285714285714,15,6,9,341.5915298237726,0.4509214743589744,0.1650718875939441,0.17788722832172763,126677.74128818489,697.0695923976295,127374.81088058252,796,1,145.175,37,3,17,39.730943433903356,0.584740990990991,48.327850877192986,1006.6885964912286,27.20779990516834,8
827,4,0,0,38,0.0,0.0,1.0,38,1250,900,350,0.72,16,9,7,356.9968882360177,0.44997629208155526,0.1597670782990166,0.18435641921629325,126334.56173911194,1420.2090835048136,127754.77082261676,797,2,151.26315789473685,35,3,17,39.696542328651454,0.5851190476190475,48.66898148148149,1005.3240740740753,28.723544973545007,0
828,4,2,0,40,0.05,0.0,1.0,40,1300,1000,300,0.7692307692307693,16,10,6,349.4050299707902,0.4515090811965812,0.18259190776593415,0.1835674197457969,127036.73846760548,877.4550823330316,127914.19354993851,798,0,144.65,37,3,20,39.16548836197519,0.5884009009009009,47.97149122807018,1008.1140350877199,27.24632527264108,0
829,4,1,1,40,0.024390243902439025,0.024390243902439025,0.975609756097561,41,1500,1300,200,0.8666666666666667,17,13,4,341.02391234307873,0.4527947154471545,0.17665637934415757,0.18108752918352702,127469.3412594054,494.0186920154928,127963.35995142089,799,0,142.09756097560975,38,3,16,38.933338623219065,0.5910087719298245,47.542735042735046,1009.8290598290602,26.574448942870003,0
830,4,0,1,39,0.0,0.025,0.975,40,850,400,450,0.47058823529411764,13,4,9,349.14488457900376,0.450934829059829,0.17117139133268178,0.18506487923539955,127396.24361582423,895.9493546091284,128292.19297043336,800,2,146.65,37,3,17,38.80324300351183,0.5920608108108107,47.61513157894738,1009.5394736842117,27.284850640113827,0
831,4,1,1,39,0.025,0.025,0.975,40,1150,1000,150,0.8695652173913043,13,10,3,346.6860398684265,0.451829594017094,0.16883747423239637,0.18502635955224606,127673.1316967722,852.4984851108122,128525.63018188301,801,0,141.3,37,3,18,38.581674261328686,0.5948761261261262,47.34100877192983,1010.6359649122816,27.314485538169773,0
832,4,0,0,39,0.0,0.0,1.0,39,800,700,100,0.875,9,7,2,354.3014174294803,0.4503486279802069,0.17062947459914457,0.18823312271964376,127489.75326678064,1233.9600580310453,128723.71332481169,802,1,145.84615384615384,36,3,18,38.577209708593536,0.5949074074074074,47.52252252252254,1009.9099099099127,28.05305305305313,0
833,4,3,1,41,0.07142857142857142,0.023809523809523808,0.9761904761904762,42,1050,500,550,0.47619047619047616,16,5,11,343.01647756425075,0.45349399922570655,0.20575273431813934,0.1864869525875101,128415.10662073578,411.37664948520364,128826.48327022098,803,0,136.35714285714286,38,4,14,37.91613962966866,0.6006030701754386,46.60790598290599,1013.5683760683773,26.672852001799402,0
834,4,0,1,40,0.0,0.024390243902439025,0.975609756097561,41,1250,900,350,0.72,16,9,7,340.8265211743153,0.4531758130081301,0.19704194446788748,0.1858469143761833,128533.39489073562,561.517967066789,129094.91285780241,804,1,138.9512195121951,37,4,15,37.850976787773924,0.6036036036036037,46.49122807017544,1014.0350877192984,27.4063537221432,0
835,4,0,0,40,0.0,0.0,1.0,40,1500,1000,500,0.6666666666666666,20,10,10,350.08633922606396,0.45042735042735044,0.1947667962243198,0.19094654662208996,128543.91289515868,1000.2935790520282,129544.2064742107,805,2,143.125,36,4,16,37.60549694614103,0.6056134259259259,46.48085585585586,1014.0765765765766,28.168793793793796,0
836,4,1,0,41,0.024390243902439025,0.0,1.0,41,1150,700,450,0.6086956521739131,16,7,9,345.43060067235206,0.4510162601626016,0.20303087745903348,0.19048030265646831,128978.5318559556,710.6263465681631,129689.15820252377,806,0,140.609756097561,37,4,17,37.28051237766262,0.6081081081081081,46.05263157894736,1015.78947368421,27.4537695590327,0
837,4,0,0,41,0.0,0.0,1.0,41,1450,1000,450,0.6896551724137931,19,10,9,344.329481322225,0.4510416666666666,0.20311875249900035,0.190946348733234,129201.38888888895,697.761811326566,129899.15070021551,807,1,141.609756097561,36,5,17,37.0816256830601,0.6122685185185186,45.833333333333336,1016.6666666666672,28.240740740740755,0
838,4,0,0,41,0.0,0.0,1.0,41,1400,1000,400,0.7142857142857143,18,10,8,341.761026016297,0.4504319105691057,0.19617862521981233,0.19046249612043328,129396.54659366317,644.5393053631632,130041.08589902632,808,2,142.609756097561,37,4,17,36.948463376082216,0.6123310810810811,45.64144736842104,1017.4342105263137,27.498221906116587,0
839,4,1,3,39,0.023809523809523808,0.07142857142857142,0.9285714285714286,42,1650,1100,550,0.6666666666666666,22,11,11,339.20974669995115,0.45207849399922573,0.19535091529011228,0.19112355426880306,129826.69850107757,407.69630268829644,130234.39480376587,809,0,140.1904761904762,38,4,17,36.576597826466795,0.6148574561403508,45.2190170940171,1019.1239316239321,26.819050832208738,0
840,4,0,1,38,0.0,0.02564102564102564,0.9743589743589743,39,1200,600,600,0.5,18,6,12,358.3769250548884,0.44691857849752586,0.20497080881302754,0.20067739081526786,129584.09857521026,1487.990156678694,131072.08873188894,810,1,150.76923076923077,35,4,17,36.334948467280526,0.6181547619047619,45.45717592592594,1018.1712962962979,29.09060846560851,0
841,4,1,2,37,0.02564102564102564,0.05128205128205128,0.9487179487179487,39,850,600,250,0.7058823529411765,11,6,5,350.3577221736211,0.4486336032388664,0.20274163974504478,0.1981162729364316,129967.37423911193,1307.0146390603716,131274.3888781723,811,0,144.71794871794873,35,4,18,36.149735149451374,0.6220238095238095,45.081018518518526,1019.675925925927,29.133597883597915,0
842,4,1,0,38,0.02631578947368421,0.0,1.0,38,1300,900,400,0.6923076923076923,17,9,8,351.83131391501206,0.4480648411569464,0.19599783899267598,0.2001492935762041,130201.83000283432,1561.816184807238,131763.64618764157,812,0,139.5,34,4,19,35.87425638632916,0.626531862745098,44.85119047619047,1020.5952380952369,30.017507002801086,0
843,4,1,3,36,0.02564102564102564,0.07692307692307693,0.9230769230769231,39,1000,800,200,0.8,12,8,4,348.22289352850765,0.4478463787674314,0.20750828674758992,0.2005346180854521,130676.44702717754,1300.9060999656956,131977.35312714323,813,0,136.89743589743588,35,4,20,35.48552939400801,0.6291666666666667,44.38657407407407,1022.4537037037029,29.21296296296294,0
844,4,0,0,36,0.0,0.0,1.0,36,1550,1200,350,0.7741935483870968,19,12,7,358.6310807469134,0.44373346560846566,0.19107380762057047,0.2059905794372765,130575.52984429053,2165.688677431741,132741.21852172227,814,1,140.86111111111111,33,3,20,35.32174260591526,0.6325757575757576,44.48529411764705,1022.0588235294107,30.971479500891235,0
845,4,0,0,36,0.0,0.0,1.0,36,950,700,250,0.7368421052631579,12,7,5,369.7366846305206,0.4438161375661376,0.19337606837606813,0.20316459062687378,128838.54875283457,2327.2675736961583,131165.81632653074,815,2,141.86111111111111,34,2,14,36.80620700437774,0.6127450980392157,46.1904761904762,1015.2380952380961,29.859943977591062,7
846,4,3,2,37,0.07692307692307693,0.05128205128205128,0.9487179487179487,39,1350,900,450,0.6666666666666666,18,9,9,348.43566499817126,0.4473965362123257,0.1923297776010955,0.19542695993375697,129647.68005540172,1234.7751231148122,130882.45517851654,816,0,131.87179487179486,37,2,14,36.52338142405972,0.6148648648648649,45.39473684210527,1018.4210526315794,27.524893314367013,0
847,4,1,2,36,0.02631578947368421,0.05263157894736842,0.9473684210526316,38,1200,1000,200,0.8333333333333334,14,10,4,357.64945822148474,0.44625711237553345,0.20712115391331665,0.20036346971738955,129602.41280131497,1670.446544517511,131272.8593458325,817,0,136.31578947368422,36,2,15,36.33483558209837,0.6163194444444444,45.4391891891892,1018.2432432432444,28.284534534534565,0
848,4,0,0,36,0.0,0.0,1.0,36,950,800,150,0.8421052631578947,11,8,3,374.8885961869853,0.44335317460317464,0.2240914114816983,0.20869205566239668,129352.72285997731,2498.5721371882096,131851.2949971655,818,1,144.52777777777777,34,2,18,36.15052662375659,0.617953431372549,45.68452380952381,1017.2619047619046,29.91946778711484,0
849,4,0,0,36,0.0,0.0,1.0,36,950,400,550,0.42105263157894735,15,4,11,375.95558480079353,0.4428240740740741,0.2222904722904726,0.20960811371770288,129413.2812500001,2530.7291666666806,131944.01041666677,819,2,145.52777777777777,34,2,18,36.06162981162982,0.6185661764705883,45.62500000000001,1017.5000000000008,29.92647058823532,0
850,4,0,0,36,0.0,0.0,1.0,36,850,600,250,0.7058823529411765,11,6,5,374.29444099318357,0.44293981481481487,0.22161779233608914,0.20884261629306353,129443.56575963719,2490.001417233559,131933.56717687074,820,3,146.52777777777777,34,2,15,36.0730092809234,0.6188725490196079,45.595238095238095,1017.6190476190477,29.929971988795522,0
851,4,0,0,36,0.0,0.0,1.0,36,1650,1300,350,0.7878787878787878,20,13,7,369.02983319025117,0.44214616402116397,0.19086613450775358,0.19515071091414565,127302.17013888869,2195.6597222221994,129497.82986111089,821,4,147.52777777777777,34,2,21,38.39801816680429,0.5971200980392157,47.70833333333332,1009.166666666665,29.68137254901956,8
852,4,0,0,36,0.0,0.0,1.0,36,850,500,350,0.5882352941176471,12,5,7,366.0458014417946,0.4419312169312169,0.1876965408805038,0.19400427476415086,127392.29024943289,2126.2825963718565,129518.57284580474,822,5,148.52777777777777,34,2,13,38.38074882075471,0.5980392156862745,47.619047619047606,1009.5238095238077,29.691876750700228,0
853,4,1,0,37,0.02702702702702703,0.0,1.0,37,800,400,400,0.5,12,4,8,363.2185122569744,0.44313063063063063,0.20901395901396014,0.19442873303167413,127793.2098765429,1883.3719135802166,129676.5817901231,823,0,145.48648648648648,35,2,14,38.0408653846154,0.6,47.22222222222221,1011.1111111111086,28.88888888888882,0
854,4,0,0,37,0.0,0.0,1.0,37,1050,1000,50,0.9523809523809523,11,10,1,363.16196535832694,0.4430680680680681,0.21002323142645984,0.19453991976307156,127822.46823827564,1884.0517564728816,129706.51999474852,824,1,146.48648648648648,35,2,15,38.01230876349625,0.600297619047619,47.193287037037024,1011.2268518518498,28.89219576719571,0
855,4,1,0,38,0.02631578947368421,0.0,1.0,38,1100,800,300,0.7272727272727273,14,8,6,359.58939576167415,0.4441678520625889,0.22468922011256143,0.1949111947727289,128295.24518140573,1627.532391879059,129922.77757328478,825,0,143.60526315789474,34,4,17,37.618732863298085,0.6072303921568627,46.72619047619047,1013.0952380952368,29.796918767506966,0
856,4,0,0,38,0.0,0.0,1.0,38,1200,900,300,0.75,15,9,6,359.04970063878096,0.44385668563300146,0.21323606656655736,0.19565107487783065,128506.39349489777,1628.036422902472,130134.42991780024,826,1,144.60526315789474,34,4,16,37.41658839184376,0.609375,46.51785714285713,1013.92857142857,29.821428571428527,0
857,4,0,0,38,0.0,0.0,1.0,38,1200,900,300,0.75,15,9,6,357.6745788899415,0.4437529634898056,0.20459062659501015,0.19557190792079446,128643.06205257622,1602.470609353557,130245.53266192978,827,2,145.60526315789474,35,3,16,37.31187012740065,0.6086309523809523,46.38310185185185,1014.4675925925919,28.98478835978834,0
858,4,0,0,38,0.0,0.0,1.0,38,1200,600,600,0.5,18,6,12,353.69087132118847,0.44357515410146986,0.20141183889388392,0.19416379501152203,128800.98637488832,1511.1466195925525,130312.13299448087,828,3,146.60526315789474,36,2,17,37.25177501664077,0.6082175925925926,46.22747747747747,1015.0900900900895,28.19694694694693,0
859,4,1,0,39,0.02564102564102564,0.0,1.0,39,1500,1300,200,0.8666666666666667,17,13,4,343.6576189196455,0.4445569050832208,0.19272803699033259,0.19057377049180324,129201.38888888879,1080.208333333324,130281.59722222212,829,0,143.82051282051282,37,2,18,37.098702185792355,0.6103603603603603,45.83333333333333,1016.6666666666658,27.477477477477454,0
860,4,2,0,41,0.04878048780487805,0.0,1.0,41,950,600,350,0.631578947368421,13,6,7,342.5104009760381,0.44918699186991873,0.19755636702749135,0.18574840732859643,128315.61872260776,602.9076373670965,128918.52635997486,830,0,137.7560975609756,36,5,21,38.030500907709964,0.6032986111111112,46.70608108108108,1013.1756756756758,28.143768768768773,8
861,4,0,0,41,0.0,0.0,1.0,41,1300,1000,300,0.7692307692307693,16,10,6,345.1939673394264,0.448755081300813,0.1993109742907948,0.18796604369966619,128477.8068732685,669.9527739304224,129147.75964719892,831,1,138.7560975609756,37,4,17,37.79697526858462,0.6030405405405406,46.54605263157894,1013.8157894736827,27.400426742531966,0
862,4,0,0,41,0.0,0.0,1.0,41,1100,700,400,0.6363636363636364,15,7,8,344.8141475212289,0.4489329268292683,0.20130123480223183,0.18854731045309717,128644.60699445954,671.696098799596,129316.30309325914,832,2,139.7560975609756,37,4,19,37.63645698227408,0.6047297297297297,46.3815789473684,1014.473684210524,27.418207681365512,0
863,4,0,0,41,0.0,0.0,1.0,41,1450,1000,450,0.6896551724137931,19,10,9,350.2462600759715,0.4482215447154472,0.2043206478074071,0.1924587609521315,128839.34389667955,825.0996700907745,129664.44356677032,833,3,140.7560975609756,37,4,19,37.30008190229328,0.6067004504504505,46.18969298245613,1015.2412280701739,27.4389521100047,0
864,4,0,1,40,0.0,0.024390243902439025,0.975609756097561,41,1150,900,250,0.782608695652174,14,9,5,353.3092803718101,0.4480691056910569,0.2108536200540303,0.1947194973040459,128957.11343277419,912.3489891518445,129869.46242192603,834,4,141.7560975609756,38,3,19,37.10226675081519,0.6060855263157895,46.073717948717935,1015.7051282051258,26.72908232118752,0
865,4,0,0,40,0.0,0.0,1.0,40,1350,1000,350,0.7407407407407407,17,10,7,351.65641479900887,0.4477029914529915,0.2019315673289186,0.1946077646296084,129119.93805473363,1081.1708990795412,130201.10895381318,835,5,142.575,38,2,19,36.97834542205403,0.6077302631578947,45.91346153846153,1016.3461538461531,26.74595141700403,0
866,4,1,1,40,0.024390243902439025,0.024390243902439025,0.975609756097561,41,1500,1000,500,0.6666666666666666,20,10,10,344.87460034723097,0.4495934959349594,0.20297434307173612,0.19247030461952175,129452.33298947733,729.0156849865746,130181.34867446391,836,0,140.0731707317073,37,4,16,36.81255162877564,0.6128941441441442,45.586622807017534,1017.6535087719283,27.50414888572779,0
867,4,2,1,41,0.047619047619047616,0.023809523809523808,0.9761904761904762,42,600,400,200,0.6666666666666666,8,4,4,332.2293407879445,0.44869096012388693,0.2057758834605672,0.1876242676452169,129917.22140841992,232.46256510414185,130149.68397352406,837,0,136.3095238095238,39,3,18,36.662686046115596,0.6140491452991452,45.13020833333332,1019.4791666666649,26.14049145299141,0
868,4,0,0,41,0.0,0.0,1.0,41,1400,1100,300,0.7857142857142857,17,11,6,338.7310242494481,0.4469258130081301,0.22224833749332573,0.19192077676614117,130044.55133912252,610.0248146321726,130654.5761537547,838,1,140.14634146341464,38,3,19,36.36788170804093,0.6170504385964912,45.005341880341874,1019.9786324786314,26.841542959963984,0
869,4,0,0,41,0.0,0.0,1.0,41,850,400,450,0.47058823529411764,13,4,9,338.28160941836586,0.4469258130081301,0.22551080081002906,0.19220271573794234,130153.54624379062,605.7102189714353,130759.25646276206,839,2,141.14634146341464,38,3,19,36.26888981956515,0.6181469298245614,44.89850427350427,1020.4059829059828,26.852789023841652,0
870,4,1,0,42,0.023809523809523808,0.0,1.0,42,1100,900,200,0.8181818181818182,13,9,4,329.3173357258868,0.4486667634533488,0.21866165682590855,0.18831129418579723,130402.54122662742,188.85480392149213,130591.39603054892,840,0,138.76190476190476,37,5,20,36.24563875469674,0.6224662162162162,44.6546052631579,1021.3815789473684,27.604907539118066,0
871,4,0,0,42,0.0,0.0,1.0,42,1050,700,350,0.6666666666666666,14,7,7,326.3874818103115,0.44848528842431284,0.20924790517065217,0.1873110425167553,130542.57079101274,121.49218990460221,130664.06298091734,841,1,139.76190476190476,37,5,17,36.1789163090129,0.6238738738738738,44.51754385964913,1021.9298245614044,27.619724988146064,0
872,4,0,2,40,0.0,0.047619047619047616,0.9523809523809523,42,1200,900,300,0.75,15,9,6,325.74678005823404,0.44821912504839334,0.2089436375150655,0.18748536896685034,130654.64854570638,112.06621268081977,130766.7147583872,842,2,140.76190476190476,37,5,17,36.08206420706418,0.625,44.4078947368421,1022.3684210526317,27.631578947368425,0
873,4,0,1,39,0.0,0.025,0.975,40,1200,1000,200,0.8333333333333334,14,10,4,339.99798212846565,0.4451255341880342,0.21154355016538062,0.19443768587044033,130406.32482144305,867.5774592159723,131273.902280659,843,6,147.725,36,4,21,35.96908305769937,0.6244212962962963,44.6509009009009,1021.3963963963962,28.372122122122118,0
874,4,0,0,39,0.0,0.0,1.0,39,1300,1100,200,0.8461538461538461,15,11,4,340.3516366114681,0.4450348627980207,0.2026081214922415,0.19532495401594102,130542.57079101255,1086.0755232379079,131628.64631425045,844,7,150.89743589743588,37,2,17,35.82215665236051,0.6238738738738738,44.517543859649116,1021.9298245614029,27.619724988146025,0
875,4,0,0,39,0.0,0.0,1.0,39,1100,700,400,0.6363636363636364,15,7,8,340.69554018073984,0.44472559604138556,0.20064020064020105,0.1960892109040256,130654.64854570608,1102.691212680791,131757.33975838686,845,8,151.89743589743588,37,2,17,35.69998569998568,0.625,44.40789473684209,1022.3684210526292,27.631578947368357,0
876,4,0,0,39,0.0,0.0,1.0,39,900,700,200,0.7777777777777778,11,7,4,341.4875052725691,0.4446974808816914,0.136831523590353,0.18764586417321746,128839.3438966796,1001.1365275853899,129840.48042426498,846,9,152.89743589743588,37,2,19,37.522388126867554,0.6067004504504505,46.18969298245613,1015.2412280701742,27.43895211000471,8
877,4,0,0,39,0.0,0.0,1.0,39,1250,900,350,0.72,16,9,7,343.76855372874417,0.4442757534862798,0.1379274080839108,0.18969717988664764,129006.37846500843,1069.6672293397892,130076.04569434821,847,10,153.89743589743588,37,2,19,37.294364993703894,0.6083896396396397,46.02521929824561,1015.8991228070173,27.456733048838306,0
878,4,1,2,38,0.025,0.05,0.95,40,1450,1000,450,0.6896551724137931,19,10,9,336.69576427856225,0.4454861111111111,0.13865007541478103,0.1880391145627925,129480.23069598323,719.2363275238357,130199.46702350707,848,0,151.025,37,3,16,36.99229691876751,0.6131756756756757,45.55921052631578,1017.7631578947356,27.507112375533396,0
879,4,0,0,38,0.0,0.0,1.0,38,1150,900,250,0.782608695652174,14,9,5,350.34680766314426,0.44419748696064487,0.13499347047336063,0.19457313856690178,129260.23046339162,1457.1818201303133,130717.41228352193,849,12,156.3684210526316,35,3,20,36.8687874649063,0.6148809523809524,45.77546296296296,1016.898148148148,29.0542328042328,0
880,4,0,0,38,0.0,0.0,1.0,38,1450,1100,350,0.7586206896551724,18,11,7,349.39191630390724,0.44413821716453294,0.13752537561904532,0.19447786905605063,129348.51794249396,1438.6653109996525,130787.18325349361,850,13,157.3684210526316,35,3,20,36.80322467478288,0.6157738095238094,45.688657407407405,1017.24537037037,29.06415343915343,0
881,4,0,0,38,0.0,0.0,1.0,38,800,600,200,0.75,10,6,4,358.901818935541,0.444078947368421,0.038010354940320124,0.1901787159632924,127383.94445516133,1561.917813357358,128945.86226851869,851,14,158.3684210526316,35,3,17,38.569613238553856,0.5958333333333333,47.627314814814824,1009.490740740742,28.842592592592627,8
882,4,1,1,38,0.02564102564102564,0.02564102564102564,0.9743589743589743,39,1350,1100,250,0.8148148148148148,16,11,5,359.17228569151007,0.4460470085470085,0.0837356868852932,0.18080643373711922,125281.69005153811,1214.6795827672106,126496.36963430533,852,0,155.28205128205127,36,3,14,40.72904949381327,0.572337962962963,49.71846846846847,1001.1261261261268,27.809059059059077,8
883,4,2,0,40,0.05,0.0,1.0,40,1050,500,550,0.47619047619047616,16,5,11,348.5752423122867,0.44923878205128204,0.09844552507922621,0.1779036275738839,125851.2249562366,773.7242468836627,126624.94920312027,853,0,151.2,37,3,17,40.4062169890358,0.576295045045045,49.15021929824562,1003.3991228070181,27.11889521100049,0
884,4,5,4,41,0.1111111111111111,0.08888888888888889,0.9111111111111111,45,650,400,250,0.6153846153846154,9,4,5,327.50495184755124,0.45801767676767674,0.14894398530762154,0.17229608336327706,127092.01388888899,-675.1999413280896,126416.8139475609,854,0,135.2888888888889,41,4,17,39.66081267217631,0.5823170731707317,47.91666666666667,1008.3333333333343,24.59349593495937,0
885,4,3,2,42,0.06818181818181818,0.045454545454545456,0.9545454545454546,44,1150,800,350,0.6956521739130435,15,8,7,323.3808217234253,0.45533826638477803,0.15130519615829074,0.16148850816344648,124947.92209201407,-714.5073784722031,124233.41471354186,855,0,138.86363636363637,39,5,19,41.96924706536083,0.5635683760683761,50.05208333333334,999.7916666666681,25.635683760683797,8
886,4,5,2,45,0.10638297872340426,0.0425531914893617,0.9574468085106383,47,1150,900,250,0.782608695652174,14,9,5,302.58321888497585,0.4609543632439099,0.1833234383570368,0.15460554504152438,125897.9246007604,-1781.0801446727712,124116.84445608762,856,0,130.3404255319149,42,5,20,41.51198062502013,0.5687003968253967,49.10368217054265,1003.5852713178313,23.894887412329314,0
887,4,3,0,48,0.0625,0.0,1.0,48,1250,900,350,0.72,16,9,7,299.6189819284746,0.4627936613475177,0.2089438414734417,0.1548515238064809,126367.80876991997,-2027.3921472890588,124340.4166226309,857,0,124.875,41,7,17,41.10456750534452,0.5749491869918699,48.635912698412696,1005.4563492063489,24.523325590398755,0
888,4,2,5,45,0.04,0.1,0.9,50,1100,600,500,0.5454545454545454,16,6,10,291.14704053366535,0.46642006802721087,0.22610526315789548,0.15245100941329706,126901.11340679508,-2610.6232782369225,124290.49012855816,858,0,120.84,43,7,19,40.77224310776943,0.5775193798449613,48.1060606060606,1007.5757575757564,23.43199436222689,0
889,4,1,0,46,0.021739130434782608,0.0,1.0,46,1400,700,700,0.5,21,7,14,312.6202892484367,0.46391908212560384,0.2174115560996026,0.16246501422426823,126593.58859592007,-1284.8551432291747,125308.7334526909,740,0,113.43478260869566,39,7,20,40.54629006659076,0.5803952991452992,48.41145833333333,1006.3541666666661,25.803952991452977,0
890,4,4,3,47,0.08,0.06,0.94,50,1200,600,600,0.5,18,6,12,294.50326875046346,0.465765306122449,0.23511989257625254,0.1568177262508849,127581.01695360836,-2484.4154201572087,125096.60153345115,741,0,105.28,42,8,16,39.993965406995336,0.5858134920634921,47.43217054263565,1010.2713178294557,24.05407899593942,0
891,4,0,0,47,0.0,0.0,1.0,47,1850,1200,650,0.6486486486486487,25,12,13,306.00764667572673,0.4646160962072155,0.22910487424348913,0.16159808064875614,127245.76971379473,-1612.3642920880393,125633.40542170669,742,1,113.0,40,7,23,40.04562013161429,0.5854166666666667,47.764227642276424,1008.9430894308945,25.22357723577236,0
892,4,1,0,48,0.020833333333333332,0.0,1.0,48,1800,1200,600,0.6666666666666666,24,12,12,300.5997967226296,0.4652962470449173,0.23297240227853022,0.15991155330354315,127542.56129535151,-1932.1464002267592,125610.41489512475,743,0,111.625,41,7,19,39.87919858573953,0.586890243902439,47.470238095238095,1010.1190476190479,24.637049941927998,0
893,4,1,0,49,0.02040816326530612,0.0,1.0,49,1750,1300,450,0.7428571428571429,22,13,9,294.85852483598165,0.46511833900226757,0.24251264023524688,0.1581569004233285,127874.86948650904,-2259.000923922862,125615.86856258617,744,0,110.3265306122449,42,7,20,39.685723637989376,0.5887896825396826,47.14147286821704,1011.4341085271303,24.081764488741197,0
894,4,1,2,48,0.02,0.04,0.96,50,1600,1000,600,0.625,22,10,12,292.80766820775943,0.465765306122449,0.2548971193415632,0.15811614083219028,128144.53125000016,-2494.8076287482595,125649.7236212519,745,0,109.1,40,10,21,39.46330589849108,0.59453125,46.87500000000001,1012.5000000000013,25.312500000000032,0
895,4,3,2,49,0.058823529411764705,0.0392156862745098,0.9607843137254902,51,1250,600,650,0.48,19,6,13,282.03747817786217,0.46727124183006535,0.2518314070496235,0.1546218328917222,128747.91843820889,-2937.65235260768,125810.26608560121,746,0,107.0,41,10,15,39.12390029325513,0.5990853658536586,46.27976190476192,1014.8809523809546,24.753193960511087,0
896,4,1,0,50,0.02,0.0,1.0,50,1350,900,450,0.6666666666666666,18,9,9,288.48635182403086,0.46535714285714286,0.25494993992791315,0.15831877373727618,128788.44024720766,-2569.258543195157,126219.1817040125,747,0,110.12,40,10,18,38.9192030436524,0.6010416666666667,46.239837398374,1015.0406504065065,25.376016260162665,0
897,4,0,1,49,0.0,0.02,0.98,50,1400,1000,400,0.7142857142857143,18,10,8,288.6266551438501,0.46496598639455783,0.2555902360944373,0.15922251902968704,128994.83194527088,-2553.73062495867,126441.10132031221,748,1,111.12,40,10,19,38.706524276377216,0.603125,46.03658536585367,1015.8536585365871,25.39634146341468,0
898,4,0,2,47,0.0,0.04081632653061224,0.9591836734693877,49,1500,1200,300,0.8,18,12,6,328.17737891845263,0.46531320861678,0.261007933534519,0.17178197120367145,126887.15071220817,-1427.3924457994804,125459.75826640868,749,2,113.77551020408163,40,9,19,39.85378421088024,0.5817708333333333,48.11991869918698,1007.5203252032506,25.188008130081265,8
899,4,1,2,46,0.020833333333333332,0.041666666666666664,0.9583333333333334,48,1600,1100,500,0.6875,21,11,10,334.8276345572181,0.46587802895981084,0.2690030146425497,0.17558034495073635,126960.75439453124,-1098.0061848958335,125862.7482096354,750,0,116.77083333333333,39,9,20,39.61078811369508,0.5841346153846154,48.046875,1007.8124999999999,25.84134615384615,0
900,4,1,0,47,0.02127659574468085,0.0,1.0,47,1100,500,600,0.45454545454545453,17,5,12,340.2558873421216,0.4646353684859698,0.28032668919641,0.17963185001167178,127233.99233270445,-741.3735572301465,126492.6187754743,751,0,118.27659574468085,36,11,22,39.19382743609778,0.5923032407407407,47.77590090090091,1008.8963963963974,28.02489989989993,0
901,4,0,0,47,0.0,0.0,1.0,47,1250,900,350,0.72,16,9,7,340.1952982701849,0.46480881899475796,0.2751033797675979,0.18069196638226107,127479.27847991708,-726.429766851317,126752.84871306576,752,1,119.27659574468085,37,10,18,38.94408251900109,0.5929054054054055,47.53289473684212,1009.868421052633,27.29374110953062,0
902,4,1,0,48,0.020833333333333332,0.0,1.0,48,1350,1000,350,0.7407407407407407,17,10,7,335.17250033079824,0.46517619680851063,0.2823250061617548,0.17977779380349407,127874.24123612036,-1028.014167397165,126846.2270687232,753,0,117.77083333333333,38,10,19,38.66699235942396,0.5951206140350878,47.142094017094024,1011.4316239316249,26.616621682411182,0
903,4,2,2,48,0.04,0.04,0.96,50,1500,800,700,0.5333333333333333,22,8,14,321.78450535914106,0.46594387755102046,0.2864895635673621,0.17482519002501792,128388.03624260359,-1736.7731390167223,126651.26310358687,754,0,114.02,38,12,16,38.481709888256376,0.600328947368421,46.63461538461539,1013.4615384615388,26.67004048582997,0
904,4,2,3,47,0.04,0.06,0.94,50,1250,900,350,0.72,16,9,7,319.4595608932258,0.4656377551020408,0.28515068493150686,0.17403393988959315,128496.33487654322,-1790.1234567901222,126706.21141975309,755,0,114.84,38,12,17,38.43036529680366,0.6014254385964912,46.52777777777778,1013.8888888888889,26.681286549707604,0
905,4,0,1,46,0.0,0.02127659574468085,0.9787234042553191,47,1350,1100,250,0.8148148148148148,16,11,5,337.26713220573583,0.46380666049953745,0.29400386847195414,0.18319547205914521,128379.01341735241,-740.3956618655827,127638.61775548683,756,1,121.68085106382979,35,12,18,38.09863712501903,0.605952380952381,46.64351851851851,1013.4259259259248,28.955026455026424,0
906,4,1,1,46,0.02127659574468085,0.02127659574468085,0.9787234042553191,47,1650,1400,250,0.8484848484848485,19,14,5,330.6321826377628,0.464654640764724,0.2927970110871201,0.18145458333749556,128789.87295310343,-883.5846407750521,127906.28831232838,757,0,121.34042553191489,35,12,19,37.848251615355366,0.6101190476190477,46.23842592592592,1015.0462962962953,29.00132275132272,0
907,4,0,1,45,0.0,0.021739130434782608,0.9782608695652174,46,1400,1000,400,0.7142857142857143,18,10,8,340.17003247837306,0.46432165861513686,0.23918382998966092,0.1793350783348315,127177.19144397782,-464.0222003002674,126713.16924367755,758,1,124.52173913043478,36,10,21,39.25421458077483,0.591724537037037,47.83220720720721,1008.6711711711716,28.018643643643657,8
908,4,1,1,45,0.021739130434782608,0.021739130434782608,0.9782608695652174,46,1300,900,400,0.6923076923076923,17,9,8,341.98918829469125,0.4645229468599034,0.24787943451587058,0.18130887481146699,127404.47108848715,-485.8096694667644,126918.66141902038,759,0,124.45652173913044,36,10,16,38.97541364565903,0.5940393518518519,47.60698198198198,1009.5720720720722,28.043668668668673,0
909,4,1,1,45,0.021739130434782608,0.021739130434782608,0.9782608695652174,46,1250,800,450,0.64,17,8,9,334.0846316364032,0.4650462962962963,0.2492596434971237,0.178669391165176,127756.25673284075,-663.7196060326394,127092.5371268081,760,0,123.6304347826087,37,9,17,38.81507592190889,0.5957207207207207,47.258771929824555,1010.9649122807007,27.323376007586504,0
910,4,1,3,43,0.021739130434782608,0.06521739130434782,0.9347826086956522,46,1350,800,550,0.5925925925925926,19,8,11,336.19733079168896,0.4673208534621578,0.2579221660438882,0.18066935184711175,127950.32035097314,-596.6887648122777,127353.63158616086,761,0,121.93478260869566,37,9,18,38.56334218416963,0.5976914414414414,47.06688596491227,1011.732456140349,27.344120436225648,0
911,4,0,0,43,0.0,0.0,1.0,43,1250,900,350,0.72,16,9,7,350.52757299544027,0.46490863787375414,0.2644170703373294,0.1868893240945537,127632.76643990917,347.7607709750382,127980.52721088422,762,1,130.6046511627907,34,9,18,38.525958215519935,0.6004901960784313,47.38095238095237,1010.4761904761895,29.719887955182042,0
912,4,2,0,45,0.044444444444444446,0.0,1.0,45,950,500,450,0.5263157894736842,14,5,9,331.0877229001878,0.46647727272727274,0.26325204457292584,0.17916985437811592,128230.06071950312,-508.92023780538767,127721.14048169773,763,0,125.75555555555556,36,9,21,38.40708620561857,0.6024305555555556,46.79054054054053,1012.8378378378364,28.134384384384347,0
913,4,0,0,45,0.0,0.0,1.0,45,1400,1000,400,0.7142857142857143,18,10,8,330.34760403117247,0.4659090909090909,0.25823610030744204,0.1794084543558551,128372.67324334459,-518.4789941969109,127854.19424914768,764,1,126.75555555555556,36,9,17,38.28041078638367,0.6038773148148149,46.64977477477477,1013.4009009009,28.150025025025,0
914,4,1,1,45,0.021739130434782608,0.021739130434782608,0.9782608695652174,46,1450,1000,450,0.6896551724137931,19,10,9,326.16106542160077,0.4650764895330113,0.26060419611950536,0.1789729094610406,128783.68975309699,-799.1549082410094,127984.53484485598,765,0,124.97826086956522,37,9,18,37.96800169241295,0.6061373873873874,46.244517543859644,1015.0219298245604,27.433025130393524,0
915,4,0,1,44,0.0,0.022222222222222223,0.9777777777777777,45,1100,800,300,0.7272727272727273,14,8,6,335.04088105684133,0.46378367003367,0.25848407501942083,0.18352908080262578,128715.2666813772,-375.0247291210252,128340.24195225617,766,1,128.7111111111111,36,9,18,37.81234972071171,0.607349537037037,46.31193693693693,1014.7522522522513,28.187562562562537,0
916,4,0,0,44,0.0,0.0,1.0,44,1350,900,450,0.6666666666666666,18,9,9,339.0162549568645,0.46241851656095845,0.25584571055440963,0.18619358623836263,128819.24518014796,-65.63638653125122,128753.60879361672,767,2,131.97727272727272,35,9,21,37.60557994147379,0.6104166666666666,46.20949074074072,1015.1620370370341,29.004629629629544,0
917,4,2,1,45,0.043478260869565216,0.021739130434782608,0.9782608695652174,46,1550,1200,350,0.7741935483870968,19,12,7,323.22129185247496,0.4625905797101449,0.2539472101248772,0.18015449548964246,129401.82317029835,-834.3491317855614,128567.47403851278,768,0,127.19565217391305,36,10,24,37.41468363770525,0.6142939814814814,45.63626126126125,1017.4549549549523,28.262637637637564,0
918,4,0,1,44,0.0,0.022222222222222223,0.9777777777777777,45,1650,1100,550,0.6666666666666666,22,11,11,326.8301007492688,0.46064814814814814,0.24313899030128705,0.18269741995501787,129516.42679419267,-534.0266364337529,128982.40015775891,769,1,126.62222222222222,36,9,19,37.20659549360179,0.6154513888888888,45.52364864864864,1017.905405405404,28.27515015015011,0
919,4,0,0,44,0.0,0.0,1.0,44,1150,900,250,0.782608695652174,14,9,5,335.8512607923212,0.45900502114164904,0.2534694573996126,0.1872205728360999,129407.39300679437,-107.67278056414051,129299.72022623023,770,2,130.47727272727272,35,9,24,37.087764949000864,0.6163690476190475,45.63078703703703,1017.4768518518515,29.070767195767186,0
920,4,0,1,43,0.0,0.022727272727272728,0.9772727272727273,44,1400,1000,400,0.7142857142857143,18,10,8,340.2451939272903,0.4583663671599718,0.2562631774773656,0.19038147110588072,129554.63927469132,16.068672839499015,129570.70794753081,771,3,131.47727272727272,35,9,19,36.826398362892206,0.6178571428571429,45.48611111111111,1018.0555555555553,29.08730158730158,0
921,4,1,0,44,0.022727272727272728,0.0,1.0,44,1200,800,400,0.6666666666666666,16,8,8,342.70057238472225,0.4585645701198027,0.2638124399739752,0.19276633474138763,129760.9247068975,93.82863404494219,129854.75334094244,772,0,131.8409090909091,35,9,21,36.55441800143889,0.6199404761904762,45.283564814814824,1018.8657407407425,29.110449735449784,0
922,4,0,0,44,0.0,0.0,1.0,44,1700,1100,600,0.6470588235294118,23,11,12,346.0163548542117,0.4589499647639183,0.26261995666081916,0.19566136625581548,129967.37423911184,194.16741683813677,130161.54165594999,773,1,132.8409090909091,35,9,21,36.260404842981444,0.6220238095238095,45.08101851851852,1019.6759259259263,29.133597883597893,0
923,4,0,0,44,0.0,0.0,1.0,44,1150,500,650,0.43478260869565216,18,5,13,346.472151289071,0.4585425475687104,0.2652168308152427,0.19666143036787884,130114.93866008651,216.24054248112964,130331.17920256764,774,2,133.8409090909091,35,9,22,36.09909718283229,0.6235119047619048,44.93634259259259,1020.254629629629,29.150132275132258,0
924,4,0,1,43,0.0,0.022727272727272728,0.9772727272727273,44,1650,1100,550,0.6666666666666666,22,11,11,346.46802107052423,0.45817917547568715,0.25910695659151095,0.19726043611703706,130233.84871357844,224.37276803830846,130458.22148161674,775,3,134.8409090909091,36,8,23,35.978642615475145,0.6226851851851851,44.81981981981982,1020.7207207207207,28.353353353353352,0
925,4,1,0,44,0.022727272727272728,0.0,1.0,44,1100,400,700,0.36363636363636365,18,4,14,346.0000345047701,0.45782681465821,0.2557444953128405,0.19873555700893836,130575.52984429078,235.83707752104817,130811.36692181183,776,0,134.52272727272728,33,11,20,35.644484412470014,0.6325757575757576,44.485294117647065,1022.0588235294127,30.971479500891295,0
926,4,0,0,44,0.0,0.0,1.0,44,1200,800,400,0.6666666666666666,16,8,8,345.69737292443045,0.45691287878787884,0.2576874461987735,0.19904438801301053,130669.48596993939,234.41960423874792,130903.90557417813,777,1,135.52272727272728,33,11,20,35.55712873067242,0.6335227272727273,44.393382352941174,1022.4264705882348,30.9826203208556,0
927,4,0,1,43,0.0,0.022727272727272728,0.9772727272727273,44,1150,800,350,0.6956521739130435,15,8,7,346.9642031961886,0.456439393939394,0.25240725007080145,0.2002602517202897,130763.47588667824,274.049043637067,131037.5249303153,778,2,136.52272727272728,33,11,21,35.429646936656276,0.634469696969697,44.3014705882353,1022.7941176470591,30.993761140819974,0
928,4,0,1,42,0.0,0.023255813953488372,0.9767441860465116,43,1050,700,350,0.6666666666666666,14,7,7,353.522450989423,0.4566260612772241,0.2524104534840643,0.20344500964188758,130649.55305899905,637.5100436179983,131287.06310261704,779,3,139.69767441860466,32,11,22,35.37730023465482,0.6357421875,44.41287878787879,1022.3484848484846,31.948390151515145,0
929,4,0,0,42,0.0,0.0,1.0,42,1250,800,450,0.64,17,8,9,352.45415441283217,0.4553329461866047,0.2360100863155854,0.2035941056667066,130794.81336805558,819.8350694444476,131614.64843750003,780,4,137.9047619047619,33,9,22,35.2575526137135,0.6347853535353536,44.270833333333336,1022.9166666666669,30.997474747474755,0
930,4,1,0,43,0.023255813953488372,0.0,1.0,43,700,400,300,0.5714285714285714,10,4,6,345.25678262176393,0.4556570690291621,0.2384998202357751,0.20109980371665792,131114.67013888902,453.64583333335213,131568.31597222236,781,0,135.67441860465115,34,9,23,35.11832112828858,0.6357230392156863,43.95833333333334,1024.1666666666679,30.122549019607877,0
931,4,0,0,43,0.0,0.0,1.0,43,1750,1200,550,0.6857142857142857,23,12,11,347.0046473525432,0.45381136950904394,0.2436773429551511,0.2035793043303908,131390.93888168,518.8268935024817,131909.76577518246,782,1,136.67441860465115,33,10,24,34.79460514782055,0.6407828282828283,43.68872549019607,1025.2450980392146,31.068033273915592,0
932,4,0,0,43,0.0,0.0,1.0,43,1250,700,550,0.56,18,7,11,345.65360993189125,0.452796234772979,0.24627359114352165,0.2035883224048601,131541.7534722221,493.5763888888834,132035.32986111098,783,2,137.67441860465115,34,9,24,34.6770917952884,0.6400122549019608,43.541666666666664,1025.8333333333326,30.17156862745096,0
933,4,0,0,43,0.0,0.0,1.0,43,1550,1100,450,0.7096774193548387,20,11,9,341.6147597803593,0.45231173864894797,0.2408711085217372,0.20201662954912586,131694.4515306121,397.75368480723404,132092.20521541932,784,3,138.67441860465115,34,9,21,34.62677839635042,0.6415441176470589,43.39285714285713,1026.4285714285702,30.189075630252063,0
934,4,0,1,42,0.0,0.023255813953488372,0.9767441860465116,43,1550,1100,450,0.7096774193548387,20,11,9,341.6428449626663,0.45168881506090813,0.24325635290630276,0.20333639669157322,131938.95266439923,415.1998299319895,132354.1524943312,785,4,139.67441860465115,34,9,22,34.379828118964845,0.6439950980392157,43.15476190476191,1027.3809523809534,30.217086834733923,0
935,4,0,1,41,0.0,0.023809523809523808,0.9761904761904762,42,1300,1000,300,0.7692307692307693,16,10,6,349.2711346271738,0.4507960704607046,0.2507968704723271,0.20745863779662285,131862.52170138908,811.1545138889138,132673.67621527798,786,5,143.52380952380952,33,9,22,34.26090263691684,0.6455176767676767,43.22916666666668,1027.0833333333348,31.12373737373742,0
936,4,0,0,41,0.0,0.0,1.0,41,950,600,350,0.631578947368421,13,6,7,380.98630236222374,0.4500762195121952,0.3305167695411597,0.21241291104304805,129413.28125000001,1660.9375000000007,131074.21875000003,787,11,147.90243902439025,34,7,21,35.93366093366093,0.6185661764705883,45.625,1017.5000000000001,29.926470588235297,8
937,4,0,1,40,0.0,0.024390243902439025,0.975609756097561,41,1100,1000,100,0.9090909090909091,12,10,2,381.9890920903684,0.4491107723577236,0.3314289300067601,0.21362908609972142,129534.44054705215,1696.1486678004505,131230.5892148526,788,12,148.90243902439025,34,7,16,35.78455736171209,0.6197916666666667,45.50595238095238,1017.9761904761904,29.940476190476186,0
938,4,0,0,40,0.0,0.0,1.0,40,1300,1100,200,0.8461538461538461,15,11,4,379.1501410237535,0.44847756410256406,0.3204997077732319,0.2126970135382433,129655.65653344669,1831.7920918367304,131487.4486252834,789,13,150.9,34,6,16,35.73324566530294,0.6210171568627452,45.38690476190476,1018.4523809523807,29.95448179271708,0
939,4,0,0,40,0.0,0.0,1.0,40,1400,900,500,0.6428571428571429,19,9,10,380.9353123273983,0.4484241452991453,0.32046038794110787,0.21419477022982072,129746.60572562342,1885.012755102021,131631.61848072545,790,14,151.9,34,6,16,35.59510594375634,0.6219362745098039,45.29761904761904,1018.8095238095225,29.964985994397722,0
940,4,0,0,40,0.0,0.0,1.0,40,1150,700,450,0.6086956521739131,16,7,9,376.61234087190957,0.44809027777777777,0.309382665576452,0.21225663266651837,129837.58680555536,1779.6874999999775,131617.27430555533,791,15,152.9,34,6,16,35.61256473153446,0.6228553921568627,45.20833333333332,1019.166666666665,29.975490196078383,0
941,4,2,2,40,0.047619047619047616,0.047619047619047616,0.9523809523809523,42,1450,1100,350,0.7586206896551724,18,11,7,357.0376603907311,0.44864256678281067,0.290829006346248,0.2048670639568205,130536.16780045345,922.6544784580404,131458.82227891148,792,0,146.57142857142858,34,8,13,35.40234739049394,0.6299019607843137,44.52380952380952,1021.9047619047614,30.05602240896357,0
942,4,0,1,39,0.0,0.025,0.975,40,1050,700,350,0.6666666666666666,14,7,7,375.5258084303211,0.446741452991453,0.305848168726613,0.213800006749322,130233.05047850207,1781.1743130572481,132014.22479155933,793,17,154.9,35,5,18,35.23795687341724,0.624702380952381,44.82060185185184,1020.7175925925914,29.163359788359752,0
943,4,1,0,40,0.025,0.0,1.0,40,1050,800,250,0.7619047619047619,13,8,5,366.9409795904283,0.4478098290598291,0.29129496402877697,0.21076362050855185,130575.52984429065,1582.7126132599456,132158.2424575506,794,0,146.825,33,7,14,35.109412470023976,0.6325757575757576,44.48529411764706,1022.0588235294117,30.971479500891263,0
944,4,1,1,40,0.024390243902439025,0.024390243902439025,0.975609756097561,41,900,800,100,0.8888888888888888,10,8,2,362.3857042126349,0.44735772357723574,0.3041322846136516,0.21066565362540124,131039.7137001866,1297.3837858128327,132337.09748599943,795,0,144.21951219512195,36,5,16,34.75560016131397,0.630787037037037,44.03153153153153,1023.8738738738733,28.440940940940926,0
945,4,0,0,40,0.0,0.0,1.0,40,1100,700,400,0.6363636363636364,15,7,8,366.2011169439354,0.44603365384615384,0.2956066600725362,0.21400539261868104,131241.56832085442,1612.1617817141196,132853.73010256854,796,1,144.3,36,4,16,34.453648752610164,0.6328125,43.834459459459445,1024.6621621621603,28.462837837837785,0
946,4,0,1,39,0.0,0.025,0.975,40,950,700,250,0.7368421052631579,12,7,5,365.52316742679636,0.4454861111111111,0.29410569105691065,0.2140921409214091,131328.12499999988,1600.751511646769,132928.87651164664,797,2,145.3,34,6,16,34.38346883468835,0.6378676470588236,43.74999999999999,1024.999999999999,30.147058823529385,0
947,4,0,0,39,0.0,0.0,1.0,39,1550,900,650,0.5806451612903226,22,9,13,367.4991256132742,0.44466936572199733,0.29251948683228357,0.21625346953418542,131506.13667052455,1865.678047839487,133371.81471836404,798,3,144.71794871794873,35,4,16,34.15284360189572,0.6375,43.57638888888888,1025.6944444444432,29.30555555555552,0
948,4,0,0,39,0.0,0.0,1.0,39,1400,800,600,0.5714285714285714,20,8,12,367.4540124923419,0.44374156545209176,0.2832918369176409,0.21706960218318427,131654.57182623883,1875.4001361025362,133529.97196234137,799,4,145.71794871794873,35,4,16,34.00400830795836,0.6389880952380953,43.43171296296296,1026.2731481481478,29.32208994708994,0
949,4,0,0,39,0.0,0.0,1.0,39,1100,700,400,0.6363636363636364,15,7,8,368.17058119981857,0.4427856500224921,0.28487844361576053,0.21800220662499267,131743.67310742452,1900.8289394718738,133644.50204689638,800,5,146.71794871794873,35,4,16,33.8956219466366,0.6398809523809523,43.344907407407405,1026.62037037037,29.33201058201057,0
950,4,1,0,40,0.025,0.0,1.0,40,1400,900,500,0.6428571428571429,19,9,10,359.70720952841054,0.4431891025641026,0.2840645196626135,0.2150469623958653,132108.41912436092,1504.0701596867264,133612.48928404765,801,0,144.025,36,4,17,33.74502501186696,0.6414930555555556,42.98986486486487,1028.0405405405413,28.556681681681702,0
951,4,0,1,39,0.0,0.025,0.975,40,1150,1000,150,0.8695652173913043,13,10,3,362.648639057175,0.4424011752136752,0.287125027370265,0.21763683765757158,132253.17166829002,1592.2865433000727,133845.4582115901,802,1,145.025,36,4,17,33.52355667469528,0.6429398148148149,42.84909909909911,1028.6036036036046,28.57232232232235,0
952,4,0,0,39,0.0,0.0,1.0,39,1450,1000,450,0.6896551724137931,19,10,9,372.9537744789777,0.44090193432298697,0.2842144731908516,0.22432740562368814,132338.45191400885,2071.2250300068563,134409.67694401572,803,2,148.12820512820514,35,4,17,33.172572178477694,0.6458333333333333,42.7662037037037,1028.9351851851848,29.398148148148135,0
953,4,0,1,38,0.0,0.02564102564102564,0.9743589743589743,39,1050,900,150,0.8571428571428571,12,9,3,373.8792637151895,0.4410706252811516,0.28526938648396105,0.22523945887232152,132398.0034722223,2100.213798868318,134498.21727109063,804,3,149.12820512820514,32,7,17,33.08873144399459,0.6533203125,42.708333333333336,1029.1666666666672,32.16145833333335,0
954,4,0,1,37,0.0,0.02631578947368421,0.9736842105263158,38,1250,700,550,0.56,18,7,11,372.91790862540694,0.43936699857752487,0.2671468959374155,0.22524241680974574,132495.48037190072,2281.987488521572,134777.4678604223,805,4,146.8684210526316,32,6,17,33.01523792003926,0.654296875,42.61363636363636,1029.5454545454538,32.17329545454543,0
955,4,0,1,36,0.0,0.02702702702702703,0.972972972972973,37,1100,600,500,0.5454545454545454,16,6,10,372.4852618500013,0.43743743743743746,0.2546958092996634,0.22590989257655913,132650.37035034606,2482.0615868896534,135132.4319372357,806,5,146.72972972972974,33,4,14,32.87037037037036,0.6534090909090908,42.463235294117645,1030.1470588235295,31.216577540106954,0
956,4,0,0,36,0.0,0.0,1.0,36,700,400,300,0.5714285714285714,10,4,6,382.9953925091722,0.43771494708994707,0.25337133750153296,0.2319297265551088,132592.99314164364,2956.5010904499486,135549.4942320936,807,6,149.77777777777777,32,4,18,32.65753340688979,0.6552734375,42.51893939393939,1029.9242424242418,32.18513257575756,0
957,4,0,1,35,0.0,0.027777777777777776,0.9722222222222222,36,1100,500,600,0.45454545454545453,17,5,12,359.4724415727256,0.4373842592592592,0.12811884940281892,0.20850319217961125,130953.25213304539,2214.8170552309293,133168.0691882763,808,7,150.77777777777777,36,0,17,34.9176660432024,0.6299189814814814,44.115990990991,1023.5360360360376,28.4315565565566,8
958,4,0,0,35,0.0,0.0,1.0,35,1200,700,500,0.5833333333333334,17,7,10,365.97502174570263,0.4357843137254902,0.14192005687142517,0.212054465417792,130913.23329260989,2582.194680212642,133495.42797282254,809,8,155.68571428571428,35,0,17,34.791808037397274,0.631547619047619,44.1550925925926,1023.3796296296309,29.239417989418026,0
959,4,0,0,35,0.0,0.0,1.0,35,1050,700,350,0.6666666666666666,14,7,7,368.53363745214926,0.43487394957983194,0.14207237320156918,0.2143600979973153,131061.33355034732,2660.1019965277883,133721.43554687512,810,9,156.68571428571428,35,0,17,34.57633943709732,0.6330357142857144,44.01041666666667,1023.9583333333342,29.255952380952404,0
960,4,0,0,35,0.0,0.0,1.0,35,1100,900,200,0.8181818181818182,13,9,4,366.54987606610797,0.4337885154061625,0.14175973145697474,0.21403031022013122,131209.517532579,2618.9664780521402,133828.48401063113,811,10,157.68571428571428,35,0,19,34.47714264196415,0.6345238095238095,43.86574074074075,1024.537037037038,29.272486772486804,0
961,4,0,1,34,0.0,0.02857142857142857,0.9714285714285714,35,950,700,250,0.7368421052631579,12,7,5,367.50611408553107,0.4329481792717087,0.1456445993031359,0.21525358110723966,131328.125,2652.777777777778,133980.90277777778,812,11,158.68571428571428,35,0,19,34.332655826558266,0.6357142857142857,43.75,1025.0,29.285714285714285,0
962,4,0,0,34,0.0,0.0,1.0,34,1300,1200,100,0.9230769230769231,14,12,2,374.37272549894544,0.4327280154486037,0.14193422751839746,0.2191009377172278,131297.62081916098,3030.8496315192747,134328.47045068024,813,12,160.11764705882354,34,0,19,34.18757501839161,0.6375612745098039,43.779761904761905,1024.8809523809523,30.143557422969185,0
963,4,0,0,34,0.0,0.0,1.0,34,1150,800,350,0.6956521739130435,15,8,7,374.8949121857421,0.4323009506833036,0.14080899428977345,0.21993153840215351,131389.14399092985,3051.4243197279043,134440.56831065775,814,13,161.11764705882354,34,0,19,34.081562548382095,0.6384803921568627,43.6904761904762,1025.2380952380963,30.15406162464989,0
964,4,0,1,33,0.0,0.029411764705882353,0.9705882352941176,34,1150,800,350,0.6956521739130435,15,8,7,375.6794585580594,0.4310568924539513,0.14108567878816825,0.22127340358132622,131541.75347222242,3083.506944444468,134625.2604166669,815,14,162.11764705882354,34,0,20,33.90705388572975,0.6400122549019608,43.54166666666668,1025.833333333335,30.17156862745103,0
965,4,0,0,33,0.0,0.0,1.0,33,1300,1000,300,0.7692307692307693,16,10,6,385.144646708604,0.42885890151515155,0.14697512762028886,0.22669906420189992,131516.61169982702,3530.583789888512,135047.19548971552,816,21,167.6060606060606,33,0,20,33.68976503385106,0.6420454545454546,43.56617647058824,1025.7352941176473,31.082887700534766,0
966,4,0,0,33,0.0,0.0,1.0,33,500,200,300,0.4,8,2,6,383.4253453449069,0.4286221590909091,0.14326516871015782,0.22587287585378002,131548.03929077755,3487.770478902351,135035.8097696799,817,22,168.6060606060606,33,0,20,33.702041771194224,0.6423611111111112,43.53553921568628,1025.8578431372548,31.08660130718954,0
967,4,0,0,33,0.0,0.0,1.0,33,1050,800,250,0.7619047619047619,13,8,5,386.75464001840305,0.42846433080808083,0.14636034452197721,0.2289642133875736,131736.68368235786,3589.9547349577224,135326.63841731558,818,23,169.6060606060606,33,0,17,33.42572420516492,0.6442550505050505,43.35171568627452,1026.593137254903,31.108882947118275,0
968,4,0,0,33,0.0,0.0,1.0,33,900,500,400,0.5555555555555556,13,5,8,386.30561457271295,0.42743844696969696,0.14729153106241455,0.22926636332289885,131831.0565647827,3585.4154652056864,135416.47202998836,819,24,170.6060606060606,33,0,17,33.34178599840893,0.6452020202020202,43.259803921568626,1026.9607843137248,31.12002376708257,0
969,4,0,0,33,0.0,0.0,1.0,33,1200,800,400,0.6666666666666666,16,8,8,386.6746742646398,0.42621527777777773,0.14990694060461518,0.23043831867157102,131988.41979346875,3607.31584606881,135595.73563953757,820,25,171.6060606060606,33,0,18,33.17320115285232,0.646780303030303,43.10661764705882,1027.573529411764,31.138591800356483,0
970,4,1,0,34,0.029411764705882353,0.0,1.0,34,1000,700,300,0.7,13,7,6,373.0866050536718,0.42771464646464646,0.147807474256624,0.22439718354063196,132336.75063775497,3074.6138038548524,135411.36444160983,821,0,167.52941176470588,34,0,19,33.170870453931876,0.6479779411764706,42.76785714285713,1028.9285714285702,30.26260504201677,0
971,4,0,0,34,0.0,0.0,1.0,34,750,400,350,0.5333333333333333,11,4,7,372.5514241974926,0.42706476530005943,0.14567210382188378,0.22462738060550905,132429.5361910082,3067.3766350902993,135496.9128260985,822,1,168.52941176470588,33,1,19,33.091116998055305,0.651199494949495,42.67769607843137,1029.289215686274,31.190582293523455,0
972,4,0,0,34,0.0,0.0,1.0,34,1250,900,350,0.72,16,9,7,373.3019860219327,0.4256350267379679,0.14612089481199475,0.22602520825131975,132587.25610342162,3099.017204921168,135686.2733083428,823,2,169.52941176470588,33,1,20,32.91289861970491,0.6527777777777778,42.52450980392156,1029.9019607843125,31.209150326797346,0
973,4,0,0,34,0.0,0.0,1.0,34,800,400,400,0.5,12,4,8,373.69791403219995,0.425393642305407,0.14053764719876294,0.22683598290748755,132681.93310565632,3116.5923262687234,135798.52543192505,824,3,170.52941176470588,33,1,18,32.807357955671854,0.6537247474747474,42.43259803921568,1030.269607843136,31.2202911467617,0
974,4,0,2,32,0.0,0.058823529411764705,0.9411764705882353,34,750,500,250,0.6666666666666666,10,5,5,389.18641833226525,0.42474376114081996,0.12118320610687072,0.23174282182512143,131956.93963860045,3471.1697424067584,135428.1093810072,825,4,171.52941176470588,33,1,18,33.14050572519084,0.6464646464646464,43.13725490196078,1027.4509803921562,31.134878193701702,8
975,4,0,0,32,0.0,0.0,1.0,32,800,500,300,0.625,11,5,6,395.87263295502214,0.42101394489247307,0.13738356988974765,0.23576082616211902,131962.84188164593,4048.095533582881,136010.9374152288,826,31,180.5,31,1,19,32.962789887213276,0.6515456989247312,43.13151041666666,1027.4739583333323,33.14432123655911,0
976,4,1,1,32,0.030303030303030304,0.030303030303030304,0.9696969696969697,33,1250,1000,250,0.8,15,10,5,388.20029021280106,0.42159880050505055,0.1324809211407152,0.23326371420751502,132300.56244260792,3671.8233471074414,135972.38578971536,827,0,176.0,32,1,20,32.81863647520864,0.65234375,42.803030303030305,1028.787878787879,32.14962121212122,0
977,4,0,0,32,0.0,0.0,1.0,32,650,500,150,0.7692307692307693,8,5,3,394.0588156118906,0.4207409274193548,0.13292130919220124,0.236136306957717,132197.0706515841,4018.684217664922,136215.754869249,828,1,180.1875,31,1,20,32.77253735122816,0.6538978494623655,42.90364583333333,1028.3854166666658,33.17372311827954,0
978,4,0,0,32,0.0,0.0,1.0,32,1050,500,550,0.47619047619047616,16,5,11,391.0913115207838,0.41996387768817206,0.1341855940781982,0.23539943906692715,132364.5040724012,3953.321499294701,136317.8255716959,829,2,181.1875,31,1,21,32.679704964359516,0.6555779569892473,42.740885416666664,1029.036458333333,33.194724462365585,0
979,4,1,0,33,0.030303030303030304,0.0,1.0,33,850,500,350,0.5882352941176471,12,5,7,385.47854286595054,0.42017834595959597,0.13969229399060445,0.23526291338141625,132885.7466712579,3644.9207988980556,136530.66747015595,830,0,176.66666666666666,32,1,17,32.298554984080326,0.658203125,42.23484848484848,1031.060606060605,32.22064393939391,0
980,4,0,0,33,0.0,0.0,1.0,33,800,500,300,0.625,11,5,6,384.3795235132667,0.4198232323232323,0.139952592394752,0.23520571742171353,132983.40292125804,3623.219410009184,136606.62233126722,831,1,177.66666666666666,32,1,17,32.228546945770596,0.6591796875,42.140151515151516,1031.439393939394,32.23248106060606,0
981,4,0,0,33,0.0,0.0,1.0,33,650,400,250,0.6153846153846154,9,4,5,385.08080282970974,0.41950757575757575,0.13620414673046244,0.23584034176302304,133015.96297571668,3644.3787623711787,136660.34173808785,832,2,178.66666666666666,32,1,17,32.177682578539375,0.6595052083333333,42.108585858585855,1031.565656565656,32.23642676767675,0
982,4,0,1,32,0.0,0.030303030303030304,0.9696969696969697,33,800,600,200,0.75,10,6,4,385.7715424108182,0.41919191919191917,0.13857582062208174,0.2364695628686268,133048.5270157382,3665.267096469745,136713.79411220792,833,3,179.66666666666666,32,1,17,32.1270856280341,0.6598307291666667,42.0770202020202,1031.6919191919192,32.240372474747474,0
983,4,0,0,32,0.0,0.0,1.0,32,1050,900,150,0.8571428571428571,12,9,3,394.60824572570556,0.4176117271505377,0.14326565063738483,0.2418005514992086,133035.29739379894,4099.365064832913,137134.66245863185,834,4,186.09375,31,1,19,31.912496318734497,0.6622983870967742,42.08984375000001,1031.640625000001,33.27872983870971,0
984,4,0,0,32,0.0,0.0,1.0,32,750,400,350,0.5333333333333333,11,4,7,393.7755298840797,0.4173387096774193,0.1451788417865254,0.24194301161714865,133136.06262207043,4085.1447211371687,137221.20734320758,835,5,187.09375,31,1,20,31.832471191858016,0.6633064516129032,41.99218750000001,1032.031250000001,33.29133064516132,0
985,4,0,0,32,0.0,0.0,1.0,32,1250,1000,250,0.8,15,10,5,396.20968127883543,0.41670866935483875,0.14906029263370302,0.2438781330107615,133203.2606336806,4155.28428819445,137358.54492187503,836,6,188.09375,31,1,20,31.701984527413387,0.663978494623656,41.927083333333336,1032.291666666667,33.29973118279571,0
986,4,0,1,31,0.0,0.03125,0.96875,32,800,600,200,0.75,10,6,4,395.99395085306645,0.4163726478494623,0.14991330390920554,0.24418600546382718,133270.47559950093,4154.860432942719,137425.33603244365,837,7,189.09375,31,1,20,31.63986969314838,0.6646505376344086,41.86197916666667,1032.552083333334,33.308131720430126,0
987,4,0,0,31,0.0,0.0,1.0,31,1000,700,300,0.7,13,7,6,402.0897759331595,0.4148297491039426,0.14187668010752708,0.2474398621127138,133194.58896982323,4511.236486877115,137705.82545670035,838,8,191.25806451612902,30,1,20,31.558973524305557,0.6666666666666667,41.93548387096775,1032.2580645161302,34.408602150537675,0
988,4,1,0,32,0.03125,0.0,1.0,32,1500,1300,200,0.8666666666666667,17,13,4,395.2642298345905,0.41412550403225806,0.14913413098236772,0.24595595492842093,133606.8047417536,4161.998155381964,137768.80289713558,839,0,186.25,31,1,21,31.320319059613773,0.668010752688172,41.53645833333334,1033.8541666666679,33.35013440860219,0
989,4,0,1,31,0.0,0.03125,0.96875,32,1200,700,500,0.5833333333333334,17,7,10,396.941528071571,0.41318044354838707,0.15315056639395763,0.2481274933539445,133775.12825859926,4220.18076578777,137995.30902438704,840,1,187.25,31,1,19,31.107745961820832,0.6696908602150538,41.37369791666667,1034.5052083333342,33.3711357526882,0
990,4,0,0,31,0.0,0.0,1.0,31,600,200,400,0.3333333333333333,10,2,8,401.68365946895824,0.4113799283154122,0.1545973085450134,0.2511583368751073,133784.9051371545,4547.842055439925,138332.74719259443,841,2,191.0,30,1,19,30.975271750898624,0.6725694444444444,41.36424731182795,1034.5430107526877,34.48476702508959,0
991,4,0,0,31,0.0,0.0,1.0,31,1200,600,600,0.5,18,6,12,400.05593990263503,0.4105286738351255,0.15342474933197048,0.2513238865522101,133958.77594230548,4518.200803561104,138476.9767458666,842,3,192.0,30,1,20,30.842638275772536,0.6743055555555555,41.196236559139784,1035.215053763441,34.507168458781365,0
992,4,0,0,31,0.0,0.0,1.0,31,1100,800,300,0.7272727272727273,14,8,6,400.17242327487764,0.4099910394265233,0.15794057548655083,0.25187323112007,134028.35587929236,4526.89039195282,138555.24627124518,843,4,193.0,30,1,21,30.76973001038421,0.675,41.12903225806451,1035.4838709677415,34.51612903225805,0
993,4,0,0,31,0.0,0.0,1.0,31,1150,900,250,0.782608695652174,14,9,5,400.90280456437523,0.4084229390681004,0.15617475617962073,0.2536076723945387,134213.26531304247,4561.294894748255,138774.56020779072,844,5,194.0,31,0,21,30.565154561447592,0.6740591397849462,40.95052083333333,1036.197916666666,33.42573924731181,0
994,4,0,0,31,0.0,0.0,1.0,31,650,500,150,0.7692307692307693,8,5,3,398.008467387041,0.40770609318996415,0.15248530132784444,0.25247373775842485,134314.47558932827,4491.659715440528,138806.1353047688,845,6,195.0,31,0,21,30.538589163840392,0.6750672043010753,40.85286458333333,1036.588541666666,33.43834005376342,0
995,4,0,0,31,0.0,0.0,1.0,31,1000,700,300,0.7,13,7,6,400.0181872352235,0.40627240143369175,0.1570348655947722,0.25515971959191563,134517.01058281795,4561.850145128044,139078.86072794598,846,7,196.0,31,0,21,30.283382494456305,0.6770833333333333,40.657552083333336,1037.3697916666667,33.46354166666667,0
996,4,0,0,31,0.0,0.0,1.0,31,750,600,150,0.8,9,6,3,397.17258414159767,0.40519713261648743,0.15283118144655417,0.25405020028960945,134618.33530002172,4493.342420789935,139111.67772081165,847,8,197.0,31,0,21,30.25564617314932,0.6780913978494624,40.559895833333336,1037.7604166666667,33.47614247311828,0
997,4,0,0,31,0.0,0.0,1.0,31,1200,900,300,0.75,15,9,6,396.63242303043404,0.40434587813620076,0.14600465163312792,0.2548866699168182,134787.29459974507,4492.202250162772,139279.49684990785,848,9,198.0,31,0,20,30.10044409613376,0.679771505376344,40.39713541666667,1038.411458333334,33.49714381720432,0
998,4,1,0,32,0.03125,0.0,1.0,32,750,600,150,0.8,9,6,3,388.53443487914893,0.4031207997311828,0.14710680466189152,0.25259338122332686,135206.56573627694,4106.481322058982,139313.0470583359,849,0,192.78125,32,0,21,29.8915462749383,0.6813151041666667,39.99368686868687,1040.0252525252529,32.50078914141415,0
999,4,0,0,32,0.0,0.0,1.0,32,650,400,250,0.6153846153846154,9,4,5,388.82142865188763,0.4019867271505377,0.14653485620677142,0.2537036732795095,135337.91394054174,4124.456209825528,139462.37015036726,850,1,193.78125,32,0,21,29.752912267928654,0.6826171875,39.86742424242424,1040.5303030303028,32.51657196969696,0
1000,4,0,0,32,0.0,0.0,1.0,32,1000,500,500,0.5,15,5,10,390.2291886476948,0.40148269489247307,0.14396224984839323,0.2555551755679304,135469.32591380985,4172.8170275992325,139642.14294140908,851,2,194.78125,32,0,21,29.58510208206995,0.6839192708333333,39.74116161616162,1041.0353535353538,32.53235479797981,0
1001,4,0,1,31,0.0,0.03125,0.96875,32,900,900,0,1.0,9,9,0,389.65740511646203,0.40066364247311825,0.14128425072744877,0.2558833023408107,135567.92674216928,4165.00931027447,139732.93605244375,852,3,195.78125,32,0,21,29.501596346589075,0.6848958333333333,39.64646464646465,1041.4141414141423,32.544191919191945,0
1002,4,0,1,30,0.0,0.03225806451612903,0.967741935483871,31,450,100,350,0.2222222222222222,8,1,7,392.2277093750098,0.3996863799283154,0.12856434066000588,0.25731296077702637,135531.97436862515,4431.879170735668,139963.8535393608,853,4,197.67741935483872,31,0,21,29.470556667083493,0.6871639784946236,39.68098958333333,1041.276041666666,33.58954973118278,0
1003,4,0,1,29,0.0,0.03333333333333333,0.9666666666666667,30,750,300,450,0.4,12,3,9,391.3162957130867,0.3987787356321839,0.11614832021336108,0.25719338214424997,135598.68057362118,4612.394677130304,140211.07525075148,854,5,199.9,30,0,21,29.427721856583652,0.690625,39.61693548387097,1041.5322580645159,34.717741935483865,0
1004,4,0,0,29,0.0,0.0,1.0,29,850,700,150,0.8235294117647058,10,7,3,391.6800000000001,0.3960899014778325,0.09462068965517223,0.25768421052631574,135633.68055555547,4825.004516418074,140458.68507197354,855,6,199.6551724137931,28,1,21,29.38333333333334,0.6971726190476191,39.58333333333333,1041.666666666666,37.20238095238093,0
1005,4,0,0,29,0.0,0.0,1.0,29,850,600,250,0.7058823529411765,11,6,5,394.3201318893644,0.39644909688013136,0.09416573587775345,0.26078327774451565,135820.82600492125,4911.377204716583,140732.20320963784,856,7,200.6551724137931,28,1,22,29.127900298644608,0.6990327380952381,39.403735632183896,1042.3850574712633,37.22803776683083,0
1006,4,0,0,29,0.0,0.0,1.0,29,900,700,200,0.7777777777777778,11,7,4,393.151802895281,0.39629515599343185,0.09071208607383197,0.26028371184380994,135858.27057735494,4882.584803144397,140740.85538049933,857,8,201.6551724137931,28,1,22,29.12101479235575,0.6994047619047619,39.36781609195402,1042.5287356321835,37.23316912972084,0
1007,4,0,0,29,0.0,0.0,1.0,29,750,600,150,0.8,9,6,3,414.66833000528436,0.3960385878489327,0.10469730306203795,0.25353400960629763,132953.09197053785,5226.287323292395,138179.37929383025,858,9,202.6551724137931,28,1,20,31.47812761214823,0.6703869047619048,42.169540229885065,1031.3218390804607,36.832922824302166,8
1008,4,0,0,29,0.0,0.0,1.0,29,550,400,150,0.7272727272727273,7,4,3,412.7409088642584,0.39516625615763545,0.10437972325449651,0.25335941944129103,133101.31168252087,5187.271270973721,138288.5829534946,859,10,203.6551724137931,28,1,21,31.37821405365267,0.671875,42.02586206896552,1031.8965517241384,36.853448275862085,0
1009,4,0,0,29,0.0,0.0,1.0,29,550,300,250,0.5454545454545454,8,3,5,412.3936106119667,0.3947044334975369,0.10729356190622519,0.25339805859929493,133138.37951265034,5181.083407649638,138319.46292029996,860,11,204.6551724137931,28,1,21,31.34977261125808,0.6722470238095238,41.98994252873564,1032.040229885058,36.85857963875207,0
1010,4,0,0,29,0.0,0.0,1.0,29,650,600,50,0.9230769230769231,7,6,1,411.6646787433614,0.3943452380952381,0.10866508290739829,0.25345421737541163,133212.53065546977,5167.778727374839,138380.3093828446,861,12,205.6551724137931,28,1,21,31.29378334493157,0.6729910714285714,41.91810344827587,1032.3275862068974,36.86884236453205,0
1011,4,0,0,29,0.0,0.0,1.0,29,750,600,150,0.8,9,6,3,414.0665717208146,0.39337027914614126,0.10543434459731715,0.2556967798564617,133323.79607609985,5240.985434007133,138564.781510107,862,13,206.6551724137931,28,1,21,31.119574290484135,0.6741071428571428,41.810344827586206,1032.7586206896551,36.88423645320197,0
1012,4,0,0,29,0.0,0.0,1.0,29,450,300,150,0.6666666666666666,6,3,3,412.02246341603046,0.39316502463054187,0.1025033456286184,0.2546886921322309,133360.89487135035,5189.536885652017,138550.43175700237,863,14,207.6551724137931,28,1,21,31.134951546343945,0.6744791666666667,41.77442528735633,1032.9022988505756,36.88936781609198,0
1013,4,0,0,29,0.0,0.0,1.0,29,1000,800,200,0.8,12,8,4,412.02246341603046,0.39316502463054187,0.1025033456286184,0.2546886921322309,133360.89487135035,5189.536885652017,138550.43175700237,864,15,208.6551724137931,28,1,21,31.134951546343945,0.6744791666666667,41.77442528735633,1032.9022988505756,36.88936781609198,0
1014,4,0,0,29,0.0,0.0,1.0,29,750,500,250,0.6666666666666666,10,5,5,412.02246341603046,0.39316502463054187,0.1025033456286184,0.2546886921322309,133360.89487135035,5189.536885652017,138550.43175700237,865,16,209.6551724137931,28,1,21,31.134951546343945,0.6744791666666667,41.77442528735633,1032.9022988505756,36.88936781609198,0
1015,4,0,0,29,0.0,0.0,1.0,29,550,400,150,0.7272727272727273,7,4,3,412.02246341603046,0.39316502463054187,0.1025033456286184,0.2546886921322309,133360.89487135035,5189.536885652017,138550.43175700237,866,17,210.6551724137931,28,1,21,31.134951546343945,0.6744791666666667,41.77442528735633,1032.9022988505756,36.88936781609198,0
1016,4,0,0,29,0.0,0.0,1.0,29,1100,800,300,0.7272727272727273,14,8,6,412.36986711426414,0.3924466338259442,0.10009298936853472,0.25618210915544176,133546.4662604043,5214.107709076498,138760.57396948079,867,18,211.6551724137931,28,1,21,30.93897692521545,0.6763392857142857,41.5948275862069,1033.6206896551726,36.91502463054188,0
1017,4,0,0,29,0.0,0.0,1.0,29,650,500,150,0.7692307692307693,8,5,3,400.02049503938764,0.39147167487684725,0.10562202734839476,0.24422303907667897,132898.76543209885,4832.445987654334,137731.21141975318,868,19,212.6551724137931,29,0,20,31.91058279454024,0.6666666666666667,42.22222222222223,1031.1111111111118,35.55555555555558,8
1018,4,0,0,29,0.0,0.0,1.0,29,700,400,300,0.5714285714285714,10,4,6,399.51025405570863,0.39116379310344823,0.10198537095088822,0.24414515525626637,132934.5703125,4821.744791666667,137756.31510416666,869,20,213.6551724137931,29,0,21,31.887626262626256,0.6670258620689655,42.1875,1031.25,35.560344827586206,0
1019,4,0,0,29,0.0,0.0,1.0,29,900,600,300,0.6666666666666666,12,6,6,400.197306093261,0.3905480295566503,0.0949807810149852,0.24526943809082044,133042.01388888893,4848.611111111116,137890.62500000006,870,21,214.6551724137931,29,0,21,31.761577813677984,0.6681034482758621,42.083333333333336,1031.666666666667,35.57471264367817,0
1020,4,0,0,29,0.0,0.0,1.0,29,750,600,150,0.8,9,6,3,399.40295154959074,0.3902401477832513,0.09579059729892792,0.24525321735648425,133113.66705246916,4833.1983024691435,137946.86535493832,871,22,215.6551724137931,29,0,22,31.70984746523105,0.6688218390804598,42.01388888888889,1031.9444444444448,35.584291187739474,0
1021,4,0,0,29,0.0,0.0,1.0,29,750,700,50,0.9333333333333333,8,7,1,399.40295154959074,0.3902401477832513,0.09579059729892792,0.24525321735648425,133113.66705246916,4833.1983024691435,137946.86535493832,872,23,216.6551724137931,29,0,22,31.70984746523105,0.6688218390804598,42.01388888888889,1031.9444444444448,35.584291187739474,0
1022,4,0,0,29,0.0,0.0,1.0,29,950,600,350,0.631578947368421,13,6,7,400.9688992564569,0.38808497536945813,0.09099552443011882,0.24740280215533228,133292.88435570977,4889.260223765418,138182.1445794752,873,24,217.6551724137931,29,0,22,31.488875812598074,0.670617816091954,41.84027777777777,1032.638888888888,35.60823754789269,0
1023,4,0,0,29,0.0,0.0,1.0,29,650,400,250,0.6153846153846154,9,4,5,403.4533727492606,0.3875205254515599,0.06359525155455037,0.22373323397913567,129201.38888888895,4625.347222222228,133826.73611111118,874,25,218.6551724137931,29,0,21,35.57889344262294,0.6293103448275862,45.833333333333336,1016.6666666666672,35.057471264367834,8
1024,4,0,0,29,0.0,0.0,1.0,29,550,100,450,0.18181818181818182,10,1,9,404.4633255691055,0.3868534482758621,0.06329531219094098,0.22469502805895217,129272.00038580241,4657.156635802463,133929.1570216049,875,26,219.6551724137931,29,0,21,35.48097059091324,0.6300287356321839,45.763888888888886,1016.944444444444,35.067049808429104,0
1025,4,0,0,29,0.0,0.0,1.0,29,1100,800,300,0.7272727272727273,14,8,6,404.4419058253098,0.3874692118226601,0.06662243990571226,0.22609875879433228,129519.29253472228,4676.605902777782,134195.89843750006,876,27,220.6551724137931,29,0,19,35.228629417383004,0.6325431034482758,45.520833333333336,1017.9166666666671,35.10057471264369,0
1026,4,0,0,29,0.0,0.0,1.0,29,550,200,350,0.36363636363636365,9,2,7,414.3013673537628,0.3874692118226601,0.027839986364088354,0.22235496377578906,127898.55565200633,4797.709297839526,132696.26494984585,877,28,221.6551724137931,29,0,18,36.64112201931438,0.6160201149425287,47.118055555555564,1011.5277777777791,34.88026819923376,8
1027,4,1,0,30,0.03333333333333333,0.0,1.0,30,650,400,250,0.6153846153846154,9,4,5,420.6025498538455,0.3933429118773946,-0.017062335138137374,0.21082812572005918,125104.18836805562,4530.43016975309,129634.61853780871,878,0,215.23333333333332,29,1,19,39.376388310426194,0.5872844827586207,49.895833333333336,1000.4166666666672,34.49712643678163,8
1028,4,2,0,32,0.0625,0.0,1.0,32,1250,900,350,0.72,16,9,7,406.81410856972644,0.40303679435483875,0.029929862640922344,0.20943191966861743,126207.32837253124,3868.584357367588,130075.91272989882,879,0,202.71875,31,1,19,38.57622240939916,0.5930779569892473,48.79557291666665,1004.8177083333314,32.41347446236553,0
1029,4,3,0,35,0.08571428571428572,0.0,1.0,35,600,200,400,0.3333333333333333,10,2,8,382.21246101494626,0.41673669467787117,0.060183626360275744,0.20153688447239065,127184.70848051201,2725.405991146133,129910.11447165815,880,0,186.25714285714287,33,2,20,38.186302798363904,0.5981691919191919,47.824754901960766,1008.7009803921545,30.566696375519832,0
1030,4,0,0,35,0.0,0.0,1.0,35,1300,900,400,0.6923076923076923,17,9,8,385.7531471026361,0.417436974789916,0.057128984150106144,0.2044938497961076,127401.12727076109,2829.077157823898,130230.20442858498,881,1,187.25714285714287,33,2,17,37.87428178360445,0.6003787878787878,47.61029411764705,1009.5588235294105,30.59269162210335,0
1031,4,0,0,35,0.0,0.0,1.0,35,800,600,200,0.75,10,6,4,383.4646602962944,0.417296918767507,0.05804427340648699,0.20374805064485874,127493.93449935103,2777.883656526316,130271.81815587735,882,2,188.25714285714287,33,2,17,37.836604578732356,0.6013257575757576,47.51838235294117,1009.9264705882338,30.60383244206769,0
1032,4,1,0,36,0.027777777777777776,0.0,1.0,36,1050,600,450,0.5714285714285714,15,6,9,370.7704458418945,0.4218253968253968,0.06406736225517173,0.19916607135046874,127933.68055555531,2286.805555555531,130220.48611111085,883,0,184.0,34,2,19,37.70593080724876,0.6035539215686274,47.08333333333332,1011.6666666666647,29.754901960784256,0
1033,4,3,3,36,0.07692307692307693,0.07692307692307693,0.9230769230769231,39,1450,1200,250,0.8275862068965517,17,12,5,345.40172092008066,0.4330578047683311,0.07300515923813977,0.1891329896683089,128700.23108071688,1090.656259618312,129790.88734033519,884,0,170.76923076923077,37,2,19,37.564836827317905,0.6052927927927928,46.3267543859649,1014.6929824561382,27.42413466097671,0
1034,4,1,2,35,0.02702702702702703,0.05405405405405406,0.9459459459459459,37,1000,800,200,0.8,12,8,4,361.2310001876527,0.428272022022022,0.068715290633099,0.196790022490288,128496.33487654287,1883.3719135802035,130379.70679012308,885,0,175.9189189189189,35,2,19,37.37157534246575,0.6071428571428572,46.52777777777776,1013.8888888888862,28.96825396825389,0
1035,4,0,1,34,0.0,0.02857142857142857,0.9714285714285714,35,1050,600,450,0.5714285714285714,15,6,9,375.35182745577424,0.42591036414565825,0.0796683365002595,0.20395266840073922,128392.81316080343,2638.49541041906,131031.30857122249,886,2,185.94285714285715,33,2,19,37.11960902861751,0.610479797979798,46.62990196078431,1013.4803921568619,30.71152703505642,0
1036,4,2,0,36,0.05555555555555555,0.0,1.0,36,850,600,250,0.7058823529411765,11,6,5,362.8690709361914,0.4317956349206349,0.08814046195333614,0.19954289529431157,128868.76594387738,2152.497874149643,131021.26381802703,887,0,178.19444444444446,34,2,21,36.949671708289365,0.6130514705882353,46.16071428571428,1015.3571428571415,29.863445378151223,0
1037,4,1,1,36,0.02702702702702703,0.02702702702702703,0.972972972972973,37,1100,900,200,0.8181818181818182,13,9,4,359.4530410799824,0.4336836836836837,0.10931943992184912,0.1999638231209017,129326.01042868131,1898.1829741700594,131224.19340285138,888,0,174.35135135135135,33,4,22,36.570281124497974,0.619949494949495,45.71078431372549,1017.1568627450984,30.82293523469995,0
1038,4,1,0,37,0.02702702702702703,0.0,1.0,37,800,400,400,0.5,12,4,8,358.5393406998523,0.4325888388388388,0.11486079893830503,0.20088357261463763,129606.62853529911,1893.815029075374,131500.4435643745,889,0,175.1081081081081,33,4,21,36.30789405062784,0.622790404040404,45.43504901960785,1018.2598039215701,30.856357694593033,0
1039,4,0,0,37,0.0,0.0,1.0,37,1450,1400,50,0.9655172413793104,15,14,1,358.0006987509823,0.4314627127127127,0.11669613538772383,0.20161091982292187,129807.25623582785,1894.2176870748494,131701.4739229027,890,1,176.1081081081081,34,3,21,36.11760124610592,0.6225490196078431,45.23809523809525,1019.0476190476205,29.97198879551825,0
1040,4,0,2,35,0.0,0.05405405405405406,0.9459459459459459,37,950,700,250,0.7368421052631579,12,7,5,359.31702882820167,0.4314314314314314,0.12120657385167477,0.2028234487709883,129898.25857426308,1934.9312641723384,131833.1898384354,891,2,177.1081081081081,34,3,21,35.991572268286035,0.623468137254902,45.148809523809526,1019.4047619047622,29.982492997198886,0
1041,4,0,0,35,0.0,0.0,1.0,35,950,600,350,0.631578947368421,13,6,7,374.5166595265404,0.42920168067226894,0.11468932554434441,0.21076355944066835,129779.68606519756,2720.930899908187,132500.61696510576,892,3,179.42857142857142,32,3,22,35.724907063197016,0.626953125,45.26515151515152,1018.939393939395,31.841856060606094,0
1042,4,1,0,36,0.027777777777777776,0.0,1.0,36,1000,700,300,0.7,13,7,6,386.85665005253657,0.4299272486772487,0.10622128337529713,0.2150702700042964,129300.69181654192,2832.1092771980316,132132.80109373995,893,0,175.41666666666666,31,5,19,35.89929266419152,0.6246639784946236,45.735677083333336,1017.057291666667,32.80829973118281,8
1043,4,1,1,36,0.02702702702702703,0.02702702702702703,0.972972972972973,37,1050,700,350,0.6666666666666666,14,7,7,379.32116662946595,0.43058683683683685,0.12749063524397108,0.21422761610254773,129918.78311526822,2456.188875672826,132374.97199094103,894,0,171.64864864864865,33,4,18,35.46086769243099,0.6259469696969697,45.12867647058824,1019.4852941176474,30.89349376114083,0
1044,4,0,0,36,0.0,0.0,1.0,36,600,400,200,0.6666666666666666,8,4,4,383.8498595788322,0.4271494708994709,0.15154110767113904,0.21690606130854245,129940.55333958281,2775.532630598931,132716.08597018174,895,1,177.27777777777777,32,4,18,35.323271413828685,0.6285807291666667,45.10732323232324,1019.570707070708,31.861584595959624,0
1045,4,0,0,36,0.0,0.0,1.0,36,1100,800,300,0.7272727272727273,14,8,6,383.8791510369172,0.426901455026455,0.1546557701832587,0.2171014022250803,129972.738751148,2778.7649219467585,132751.50367309476,896,2,178.27777777777777,32,4,18,35.28974739970282,0.62890625,45.075757575757585,1019.696969696971,31.865530303030344,0
1046,4,1,0,37,0.02702702702702703,0.0,1.0,37,1100,500,600,0.45454545454545453,17,5,12,374.75138541581146,0.4286786786786787,0.1675936225435668,0.214586939801793,130455.99819214897,2378.0360422406143,132834.03423438958,897,0,174.43243243243242,32,5,20,35.031207514522315,0.6337890625,44.60227272727274,1021.5909090909108,31.924715909090963,0
1047,4,0,0,37,0.0,0.0,1.0,37,1450,1300,150,0.896551724137931,16,13,3,372.48791661404977,0.42836586586586584,0.170549054304459,0.2140021068126853,130585.01882779837,2328.268320834628,132913.28714863298,898,1,175.43243243243242,32,5,19,34.95805023677167,0.6350911458333333,44.47601010101011,1022.0959595959611,31.940498737373783,0
1048,4,0,0,37,0.0,0.0,1.0,37,1300,1100,200,0.8461538461538461,15,11,4,371.52615012958864,0.42824074074074076,0.17159215290056395,0.2144368775229288,130763.47588667835,2316.410154748193,133079.88604142654,899,2,176.43243243243242,33,4,19,34.80160156562026,0.634469696969697,44.301470588235304,1022.79411764706,30.993761140820002,0
1049,4,0,1,36,0.0,0.02702702702702703,0.972972972972973,37,850,600,250,0.7058823529411765,11,6,5,373.34640197305794,0.4277715215215215,0.17654808959156765,0.21601310534116872,130857.49959450706,2371.0353289600325,133228.5349234671,900,3,177.43243243243242,33,4,19,34.65971473629576,0.6354166666666667,44.20955882352942,1023.1617647058835,31.00490196078435,0
1050,4,0,0,36,0.0,0.0,1.0,36,1200,800,400,0.6666666666666666,16,8,8,383.6498736396063,0.4265046296296296,0.18875311994294952,0.22170693839002079,130810.95838434853,2837.1215309662284,133648.07991531477,901,4,182.80555555555554,32,4,19,34.44339874928,0.6373697916666667,44.255050505050505,1022.979797979798,31.96811868686869,0
1051,4,1,0,37,0.02702702702702703,0.0,1.0,37,1200,800,400,0.6666666666666666,16,8,8,369.3680528215232,0.428272022022022,0.18329491113316898,0.2154604015027992,131171.15600069688,2290.086895665134,133461.242896362,902,0,178.83783783783784,33,4,21,34.44378813255174,0.6385732323232323,43.90318627450981,1024.3872549019611,31.042038027332154,0
1052,4,0,0,37,0.0,0.0,1.0,37,1450,1100,350,0.7586206896551724,18,11,7,374.27139702492195,0.42680180180180183,0.18417654107309334,0.21958697571115354,131392.8425670849,2435.41041347049,133828.2529805554,903,1,179.83783783783784,32,5,21,34.09380131362892,0.6432291666666667,43.686868686868685,1025.2525252525247,32.0391414141414,0
1053,4,0,0,37,0.0,0.0,1.0,37,1200,800,400,0.6666666666666666,16,8,8,389.19276753266683,0.42586336336336333,0.20035699053817146,0.2183307623765222,129655.65653344664,2759.564768094253,132415.2213015409,904,2,180.83783783783784,34,3,19,35.47754724332749,0.6210171568627452,45.38690476190476,1018.4523809523804,29.954481792717072,8
1054,4,0,0,37,0.0,0.0,1.0,37,950,500,450,0.5263157894736842,14,5,9,388.122221369823,0.42586336336336333,0.1986972947702259,0.2178985384540816,129685.96938775507,2666.8013038548693,132352.77069160994,905,3,181.83783783783784,34,3,19,35.47388772011843,0.6213235294117647,45.357142857142854,1018.5714285714283,29.957983193277304,0
1055,4,1,1,37,0.02631578947368421,0.02631578947368421,0.9736842105263158,38,950,800,150,0.8421052631578947,11,8,3,379.3139066463142,0.4284169037458511,0.20060749422074053,0.21465220497499501,129996.88042534716,2261.9249131944334,132258.8053385416,906,0,178.02631578947367,35,3,20,35.381554307116104,0.6223214285714286,45.05208333333333,1019.7916666666661,29.136904761904745,0
1056,4,0,0,37,0.0,0.0,1.0,37,800,600,200,0.75,10,6,4,361.7971580052104,0.42648898898898896,0.10698697810499036,0.1989001936935961,128858.14868922971,1924.1023963152265,130782.25108554494,907,1,183.32432432432432,36,1,17,36.987716282165024,0.6087962962962963,46.17117117117117,1015.3153153153149,28.20320320320319,8
1057,4,1,0,38,0.02631578947368421,0.0,1.0,38,900,700,200,0.7777777777777778,11,7,4,355.1886977312211,0.4284465386439071,0.11281805225113684,0.19655188294153336,129117.79495854472,1572.2362890504464,130690.03124759517,908,0,179.47368421052633,37,1,18,36.89077840112199,0.6095157657657657,45.91557017543858,1016.3377192982438,27.46858700806064,0
1058,4,0,0,38,0.0,0.0,1.0,38,1250,900,350,0.72,16,9,7,360.3379082434085,0.4272018729255571,0.11657466292822516,0.19996871380022985,129230.01284646145,1713.3215538653537,130943.33440032681,909,1,180.47368421052633,36,2,18,36.645577214161776,0.6125578703703703,45.80518018018019,1016.7792792792802,28.243868868868894,0
1059,4,0,1,37,0.0,0.02631578947368421,0.9736842105263158,38,500,300,200,0.6,7,3,4,362.95415728820905,0.4270981507823613,0.11729056920423298,0.20185972590068388,129315.9037415795,1787.1489732976358,131103.05271487715,910,2,181.47368421052633,36,2,19,36.491548568054334,0.6134259259259259,45.72072072072073,1017.1171171171178,28.253253253253273,0
1060,4,0,0,37,0.0,0.0,1.0,37,1550,1300,250,0.8387096774193549,18,13,5,369.84689115297084,0.42573823823823825,0.12364872344945388,0.20584269672118224,129344.54038075249,2167.535229486252,131512.07561023874,911,3,186.9189189189189,36,1,21,36.28708623934462,0.6137152777777778,45.69256756756757,1017.2297297297307,28.25638138138141,0
1061,4,0,0,37,0.0,0.0,1.0,37,1300,1200,100,0.9230769230769231,14,12,2,368.9893419289248,0.4259259259259259,0.11866647524018048,0.20581405516480042,129430.4693206721,2151.6927400373434,131582.16206070944,912,4,187.9189189189189,36,1,16,36.22131842998377,0.6145833333333333,45.60810810810811,1017.5675675675682,28.26576576576578,0
1062,4,1,1,37,0.02631578947368421,0.02631578947368421,0.9736842105263158,38,800,500,300,0.625,11,5,6,363.0748590123175,0.4292170459933618,0.12633447926282937,0.2043643043489681,129787.30384589477,1824.501409087402,131611.80525498217,913,0,183.94736842105263,37,1,17,36.008622081136345,0.6162725225225225,45.257675438596486,1018.9692982456131,27.53971076339495,0
1063,4,0,0,37,0.0,0.0,1.0,37,1450,1100,350,0.7586206896551724,18,11,7,368.4659198437164,0.42752127127127126,0.13406002687770613,0.20763490501778548,129831.84831791252,2167.7222830939018,131999.57060100642,914,1,189.1081081081081,36,1,17,35.82596685082872,0.6186342592592593,45.21396396396396,1019.1441441441443,28.309559559559563,0
1064,4,0,0,37,0.0,0.0,1.0,37,950,700,250,0.7368421052631579,12,7,5,371.8000760134966,0.42792792792792794,0.1405321822816854,0.21012970588178514,129946.64216581451,2262.834286989699,132209.4764528042,915,2,190.1081081081081,36,1,17,35.62421765702084,0.6197916666666667,45.101351351351354,1019.594594594595,28.322072072072086,0
1065,4,1,0,38,0.02631578947368421,0.0,1.0,38,850,700,150,0.8235294117647058,10,7,3,363.62742080311654,0.429068871503082,0.1421148086720998,0.2074981310688938,130321.66950660177,1878.4737483197985,132200.14325492157,916,0,186.07894736842104,35,3,21,35.45161716919823,0.6255952380952381,44.73379629629631,1021.0648148148169,29.173280423280485,0
1066,4,0,0,38,0.0,0.0,1.0,38,1300,900,400,0.6923076923076923,17,9,8,366.56237957694844,0.42903923660502613,0.13978251019483467,0.2101306939548898,130498.99798525385,1967.2046467764171,132466.20263203027,917,1,187.07894736842104,35,3,17,35.196722549463836,0.6273809523809524,44.56018518518519,1021.7592592592599,29.19312169312171,0
1067,4,0,1,37,0.0,0.02631578947368421,0.9736842105263158,38,800,500,300,0.625,11,5,6,376.1548182289915,0.42819464201043145,-0.006455364931666319,0.21196769022243933,129831.84831791262,2167.3750608716946,131999.2233787843,918,2,188.07894736842104,36,2,17,35.63006445672191,0.6186342592592593,45.21396396396397,1019.1441441441451,28.309559559559588,8
1068,4,1,0,38,0.02631578947368421,0.0,1.0,38,700,300,400,0.42857142857142855,11,3,8,373.9788642082388,0.4289651493598862,0.016124158929006427,0.21198376420514609,130061.48674011882,2128.049417660935,132189.53615777974,919,0,189.0,36,2,19,35.45185655405902,0.6209490740740741,44.98873873873875,1020.0450450450477,28.334584584584658,0
1069,4,0,1,37,0.0,0.02631578947368421,0.9736842105263158,38,900,500,400,0.5555555555555556,13,5,8,373.84373979698717,0.42862434803224275,0.012466596955965636,0.2122195665764854,130118.9280496715,2128.829336092871,132247.75738576436,920,1,190.0,36,2,19,35.3968910963944,0.6215277777777778,44.93243243243244,1020.2702702702719,28.340840840840887,0
1070,4,0,1,36,0.0,0.02702702702702703,0.972972972972973,37,650,400,250,0.6153846153846154,9,4,5,374.15867670001217,0.42551926926926925,0.02756358173261164,0.21237660882875772,130114.93866008663,2336.726653592256,132451.66531367888,921,2,195.94594594594594,35,2,19,35.39291453961052,0.6235119047619048,44.936342592592595,1020.25462962963,29.150132275132286,0
1071,4,0,0,36,0.0,0.0,1.0,36,750,600,150,0.8,9,6,3,378.4993125302899,0.42288359788359786,0.05474875902380871,0.2153201464049219,130201.83000283432,2656.2606292516834,132858.090632086,922,3,202.02777777777777,34,2,19,35.19382557642209,0.626531862745098,44.85119047619047,1020.5952380952369,30.017507002801086,0
1072,4,0,0,36,0.0,0.0,1.0,36,800,600,200,0.75,10,6,4,378.082676490449,0.42243716931216935,0.05760261194029859,0.21558756872221332,130292.97052154191,2652.303004535143,132945.27352607704,923,4,203.02777777777777,34,2,19,35.11179454291045,0.6274509803921569,44.76190476190476,1020.9523809523806,30.028011204481782,0
1073,4,0,1,35,0.0,0.027777777777777776,0.9722222222222222,36,1300,900,400,0.6923076923076923,17,9,8,377.91137003709076,0.4214451058201058,0.06090777220862331,0.21599611216177203,130384.14292800435,2654.730017006781,133038.87294501113,924,5,204.02777777777777,34,2,20,35.02350701324941,0.6283700980392157,44.67261904761904,1021.3095238095224,30.03851540616242,0
1074,4,0,0,35,0.0,0.0,1.0,35,900,500,400,0.5555555555555556,13,5,8,376.3081779417106,0.4196778711484594,0.06689408436641964,0.21609402726619303,130566.58340419497,2826.6546201813953,133393.23802437636,925,6,208.17142857142858,34,1,14,34.87914967967383,0.6302083333333333,44.49404761904761,1022.0238095238092,30.0595238095238,0
1075,4,1,0,36,0.027777777777777776,0.0,1.0,36,550,300,250,0.5454545454545454,8,3,5,366.0310779431074,0.4217261904761905,0.0678562002790033,0.21192408383071468,130883.62328800155,2381.4947434413607,133265.1180314429,926,0,203.36111111111111,35,1,16,34.82036817102138,0.63125,44.18402777777778,1023.2638888888889,29.23611111111111,0
1076,4,0,0,36,0.0,0.0,1.0,36,600,200,400,0.3333333333333333,10,2,8,363.7862399418518,0.42162698412698413,0.069212147887324,0.21084753498670586,130924.43795146486,2325.7017997727285,133250.13975123758,927,1,204.36111111111111,36,0,16,34.836460167253506,0.6296296296296297,44.144144144144136,1023.4234234234225,28.428428428428404,0
1077,4,0,0,36,0.0,0.0,1.0,36,700,400,300,0.5714285714285714,10,4,6,363.4354414539365,0.4216931216931217,0.07236279183473937,0.2109596527979746,130982.06948502557,2320.7052491680897,133302.77473419366,928,2,205.36111111111111,36,0,17,34.78708287495416,0.6302083333333333,44.08783783783784,1023.6486486486486,28.434684684684683,0
1078,4,0,1,35,0.0,0.027777777777777776,0.9722222222222222,36,750,300,450,0.4,12,3,9,363.61760599372906,0.4213955026455027,0.060803215795518284,0.21169900825268703,131097.37059694825,2333.862409707001,133431.23300665527,929,3,206.36111111111111,36,0,17,34.66571365735651,0.6313657407407407,43.97522522522522,1024.0990990990988,28.447197197197188,0
1079,4,0,0,35,0.0,0.0,1.0,35,800,500,300,0.625,11,5,6,369.63125511522304,0.4177871148459384,0.06418397338587223,0.214832988354091,131031.70680084027,2686.682848936907,133718.38964977718,930,4,212.97142857142856,35,0,18,34.578246288341234,0.6327380952380952,44.039351851851855,1023.8425925925932,29.25264550264552,0
1080,4,0,0,35,0.0,0.0,1.0,35,1250,800,450,0.64,17,8,9,365.9804971600657,0.4180322128851541,0.06439468543661087,0.21320351674584723,131120.59709630048,2597.5162626457363,133718.11335894623,931,5,213.97142857142856,35,0,18,34.581708855991266,0.6336309523809525,43.95254629629629,1024.189814814814,29.262566137566118,0
1081,4,0,0,35,0.0,0.0,1.0,35,800,400,400,0.5,12,4,8,365.39773489989756,0.41757703081232495,0.060647722321731434,0.21352251795833593,131239.1643759644,2590.8986786265327,133830.06305459095,932,6,214.97142857142856,35,0,18,34.47666045408336,0.6348214285714286,43.83680555555555,1024.652777777777,29.275793650793627,0
1082,4,0,1,34,0.0,0.02857142857142857,0.9714285714285714,35,650,300,350,0.46153846153846156,10,3,7,363.90602484528165,0.4174719887955182,0.058782148504308296,0.21281531994584685,131268.8145683297,2553.9024991426404,133822.71706747232,933,7,215.97142857142856,35,0,18,34.48488442135382,0.6351190476190476,43.80787037037036,1024.7685185185169,29.279100529100482,0
1083,4,0,1,33,0.0,0.029411764705882353,0.9705882352941176,34,650,300,350,0.46153846153846156,10,3,7,370.8790911906523,0.4147355912061794,0.07178603659036842,0.2161953726696728,131145.15306122438,2927.7990362811697,134072.95209750556,934,8,222.41176470588235,34,0,18,34.4314175577251,0.6360294117647058,43.92857142857142,1024.2857142857135,30.126050420168045,0
1084,4,0,0,33,0.0,0.0,1.0,33,1100,700,400,0.6363636363636364,15,7,8,391.70858100899244,0.41181344696969696,-0.002992891881780979,0.21152263374485583,128144.53124999991,3482.8443877550876,131627.375637755,935,9,229.3030303030303,31,2,20,36.95987654320987,0.6129032258064516,46.87499999999999,1012.4999999999993,32.661290322580626,8
1085,4,0,0,33,0.0,0.0,1.0,33,1550,1200,350,0.7741935483870968,19,12,7,390.0420353370017,0.4116556186868687,-0.0023363940094858204,0.21166716310966144,128342.36145019521,3411.7831759982496,131754.14462619345,936,10,230.3030303030303,31,2,20,36.79913047202947,0.6149193548387097,46.67968749999999,1013.2812499999992,32.68649193548384,0
1086,4,2,0,35,0.05714285714285714,0.0,1.0,35,900,600,300,0.6666666666666666,12,6,6,372.16551591200624,0.41834733893557424,0.007155783051548736,0.20524816775745974,128983.44574502592,2600.6381259611685,131584.0838709871,937,0,218.0857142857143,33,2,19,36.596568745727275,0.6164772727272727,46.04779411764706,1015.8088235294116,30.782085561497322,0
1087,4,2,1,36,0.05405405405405406,0.02702702702702703,0.972972972972973,37,600,600,0,1.0,6,6,0,358.33601655719775,0.4236111111111111,0.029718668190701347,0.20050404590566837,129554.63927469116,1884.818672839484,131439.45794753064,938,0,207.24324324324326,35,2,16,36.36596180081856,0.6178571428571429,45.4861111111111,1018.0555555555538,29.08730158730154,0
1088,4,1,0,37,0.02702702702702703,0.0,1.0,37,850,600,250,0.7058823529411765,11,6,5,360.785123966942,0.4236111111111111,0.034152334152333985,0.2024814471243043,129672.49657064478,1956.7815500685942,131629.27812071337,939,0,208.21621621621622,35,2,17,36.18371212121212,0.6190476190476191,45.370370370370374,1018.518518518519,29.100529100529116,0
1089,4,0,1,36,0.0,0.02702702702702703,0.972972972972973,37,1000,600,400,0.6,14,6,8,361.40484654346324,0.42332957957957956,0.03416137627859572,0.20344042640464516,129790.4074502743,1981.3764574759875,131771.7839077503,940,1,209.21621621621622,35,2,18,36.04800848099348,0.6202380952380953,45.254629629629626,1018.9814814814811,29.113756613756603,0
1090,4,1,0,37,0.02702702702702703,0.0,1.0,37,1300,900,400,0.6923076923076923,17,9,8,365.1872400302561,0.4237675175175175,0.04102513771147431,0.2068142647266463,130026.38996056239,2096.795696159116,132123.1856567215,941,0,210.1081081081081,35,2,20,35.711718868210006,0.6226190476190476,45.023148148148145,1019.9074074074073,29.140211640211636,0
1091,4,0,1,36,0.0,0.02702702702702703,0.972972972972973,37,950,600,350,0.631578947368421,13,6,7,364.1921289191905,0.4230480480480481,0.049695152791443764,0.20703301100454558,130173.98787133477,2081.6683545524525,132255.6562258872,942,1,211.1081081081081,35,2,20,35.58714698877168,0.6241071428571429,44.878472222222214,1020.4861111111103,29.156746031746007,0
1092,4,0,0,36,0.0,0.0,1.0,36,850,400,450,0.47058823529411764,13,4,9,368.2784963733856,0.42371031746031745,0.04862974630213035,0.2091792572840482,130141.08737244895,2385.6327947845784,132526.72016723352,943,2,213.88888888888889,34,2,20,35.51632442733249,0.6259191176470589,44.910714285714285,1020.3571428571425,30.010504201680664,0
1093,4,1,0,37,0.02702702702702703,0.0,1.0,37,800,400,400,0.5,12,4,8,361.6849713520808,0.42530030030030025,0.049160089943124374,0.2072083060175939,130475.34722222213,2038.2511337868375,132513.59835600897,944,0,209.0810810810811,34,3,21,35.345296356715615,0.6292892156862745,44.58333333333333,1021.6666666666658,30.049019607843114,0
1094,4,0,1,36,0.0,0.02702702702702703,0.972972972972973,37,750,600,150,0.8,9,6,3,359.69762986948126,0.4247997997997998,0.04474068663257835,0.20639334590906583,130536.16780045332,1990.7100340135787,132526.8778344669,945,1,210.0810810810811,34,3,15,35.33439150357253,0.6299019607843137,44.52380952380951,1021.9047619047603,30.05602240896354,0
1095,4,0,1,35,0.0,0.027777777777777776,0.9722222222222222,36,700,400,300,0.5714285714285714,10,4,6,368.9956790639322,0.4234457671957672,0.0437784178033791,0.2107498967539236,130356.43029423771,2420.1919033544705,132776.6221975922,946,5,216.88888888888889,33,3,20,35.279286171446856,0.6303661616161615,44.69975490196078,1021.2009803921562,30.945484254307765,0
1096,4,0,0,35,0.0,0.0,1.0,35,1350,900,450,0.6666666666666666,18,9,9,373.4884898215855,0.4222689075630252,0.030727051525900384,0.21400505427096614,130481.60750973172,2746.6757076605027,133228.28321739222,947,6,212.0857142857143,33,2,23,35.03745851825197,0.6316287878787878,44.577205882352935,1021.6911764705873,30.96033868092689,0
1097,4,0,0,35,0.0,0.0,1.0,35,1200,800,400,0.6666666666666666,16,8,8,374.8453321476159,0.42142857142857143,0.02496319879497455,0.21635263776652855,130763.47588667822,2803.2157103037334,133566.69159698195,948,7,213.0857142857143,33,2,20,34.71673056953431,0.634469696969697,44.3014705882353,1022.794117647059,30.99376114081997,0
1098,4,0,0,35,0.0,0.0,1.0,35,1050,600,450,0.5714285714285714,15,6,9,371.7592133850061,0.4212535014005602,0.02345374931581823,0.21562034376330347,130951.5570934256,2736.4895713187225,133688.04666474432,949,8,214.0857142857143,33,2,21,34.60498483397191,0.6363636363636364,44.11764705882353,1023.5294117647059,31.016042780748663,0
1099,4,0,0,35,0.0,0.0,1.0,35,1400,1100,300,0.7857142857142857,17,11,6,375.27110707080914,0.42048319327731093,0.03217447783133376,0.2187249590584254,131139.7734645328,2842.5935938100647,133982.36705834288,950,9,215.0857142857143,33,2,21,34.32439977666108,0.6382575757575757,43.93382352941176,1024.2647058823525,31.03832442067735,0
1100,4,0,0,35,0.0,0.0,1.0,35,600,400,200,0.6666666666666666,8,4,4,375.7304006886586,0.4198529411764706,0.038853862319955024,0.21953052971054335,131233.9323367215,2861.7155961649405,134095.64793288644,951,10,216.0857142857143,33,2,21,34.2172736514771,0.6392045454545454,43.841911764705884,1024.6323529411768,31.049465240641723,0
1101,4,0,0,35,0.0,0.0,1.0,35,900,600,300,0.6666666666666666,12,6,6,380.91587780682414,0.41911764705882354,-0.04613174784996099,0.22022487504990543,130828.1135559081,3039.4768955064856,133867.59045141458,952,11,217.0857142857143,31,4,21,34.49591128929617,0.6401209677419355,44.23828124999999,1023.0468749999992,33.00151209677417,7
1102,4,0,0,35,0.0,0.0,1.0,35,1050,900,150,0.8571428571428571,12,9,3,381.8293944941238,0.41939775910364147,-0.051894524506151174,0.22151740738880485,130961.35669284391,3000.9791056315075,133962.33579847543,953,12,218.0857142857143,31,4,21,34.337366959250325,0.6414650537634409,44.108072916666664,1023.5677083333328,33.018313172042994,0
1103,4,0,0,35,0.0,0.0,1.0,35,950,800,150,0.8421052631578947,11,8,3,385.36818897976065,0.4197829131652661,-0.04872731236714445,0.22395787656673005,131028.00369262695,3098.804897732205,134126.80859035917,954,13,219.0857142857143,31,4,21,34.179198991055145,0.6421370967741935,44.04296875,1023.828125,33.026713709677416,0
1104,4,0,0,35,0.0,0.0,1.0,35,800,400,400,0.5,12,4,8,386.6813743400782,0.41946778711484595,-0.04425720459786797,0.22550202905362438,131161.34855482305,3143.530103895393,134304.87865871846,955,14,220.0857142857143,31,4,23,34.01034384136267,0.643481182795699,43.912760416666664,1024.3489583333328,33.04351478494622,0
1105,4,0,0,35,0.0,0.0,1.0,35,900,600,300,0.6666666666666666,12,6,6,386.9131574593713,0.4194327731092437,-0.04052255361104251,0.22585707623203874,131198.73769258242,3152.503571064184,134351.2412636466,956,15,221.0857142857143,32,3,23,33.96649823350588,0.6412760416666667,43.87626262626263,1024.4949494949499,32.015467171717184,0
1106,4,0,1,34,0.0,0.02857142857142857,0.9714285714285714,35,1150,900,250,0.782608695652174,14,9,5,386.4191205468004,0.4189775910364146,-0.03579788451046306,0.22614015872230567,131295.77219480163,3147.039364605662,134442.81155940727,957,16,222.0857142857143,32,3,23,33.88079544987886,0.6422526041666667,43.78156565656566,1024.8737373737379,32.02730429292931,0
1107,4,0,1,33,0.0,0.029411764705882353,0.9705882352941176,34,1400,1200,200,0.8571428571428571,16,12,4,383.36817002633444,0.417929292929293,-0.016704318359545,0.22568717487637277,131522.32552800752,3284.294651056031,134806.62017906355,958,17,227.47058823529412,32,2,23,33.72953594288526,0.64453125,43.56060606060607,1025.7575757575771,32.054924242424285,0
1108,4,0,0,33,0.0,0.0,1.0,33,900,500,400,0.5555555555555556,13,5,8,383.8159427730351,0.4143781565656566,-0.012404209587308035,0.22658078239657609,131628.58963012707,3504.230244954441,135132.8198750815,959,18,229.3939393939394,31,2,19,33.61050310874255,0.6481854838709677,43.45703125000001,1026.171875000001,33.102318548387125,0
1109,4,0,0,33,0.0,0.0,1.0,33,600,400,200,0.6666666666666666,8,4,4,381.57790618937105,0.4144176136363636,-0.01293318877688332,0.22545705071848757,131661.9957817926,3447.8617350260506,135109.85751681865,960,19,230.3939393939394,31,2,19,33.634124164763605,0.648521505376344,43.42447916666667,1026.302083333334,33.10651881720432,0
1110,4,0,0,33,0.0,0.0,1.0,33,1200,1000,200,0.8333333333333334,14,10,4,380.40667827670177,0.41394412878787884,-0.011075882477277421,0.22535737477173523,131762.23966810445,3424.6471828884632,135186.88685099292,961,20,231.3939393939394,31,2,19,33.5628038469668,0.6495295698924731,43.32682291666667,1026.692708333334,33.11911962365593,0
1111,4,0,0,33,0.0,0.0,1.0,33,950,700,250,0.7368421052631579,12,7,5,379.13475733669225,0.41323390151515155,-0.013362994724728905,0.22499893386866007,131829.0901184082,3396.1980183919272,135225.28813680014,962,21,232.3939393939394,31,2,19,33.52787815392418,0.6502016129032258,43.26171875,1026.953125,33.12752016129032,0
1112,4,0,1,32,0.0,0.030303030303030304,0.9696969696969697,33,900,600,300,0.6666666666666666,12,6,6,382.30434429684937,0.4123263888888889,-0.010388952236158433,0.2280822516655351,132029.74319457996,3495.1088799370514,135524.85207451702,963,22,233.3939393939394,31,2,19,33.24372334135733,0.6522177419354839,43.06640624999999,1027.734374999999,33.152721774193516,0
1113,4,0,1,31,0.0,0.03125,0.96875,32,700,400,300,0.5714285714285714,10,4,6,392.3085841349923,0.41118531586021506,-0.005942448632377806,0.23291607547594972,131845.2661615503,3944.8059385477873,135790.0721000981,964,23,240.875,30,2,20,33.17328665532435,0.653125,43.24596774193547,1027.0161290322567,34.233870967741886,0
1114,4,0,0,31,0.0,0.0,1.0,31,600,500,100,0.8333333333333334,7,5,2,393.1528437730034,0.4095430107526881,-0.02463312145840324,0.2204973425068875,129645.87894915609,3994.129198462267,133640.00814761835,965,24,246.90322580645162,30,1,19,35.3866965817606,0.6309027777777778,45.396505376344095,1018.4139784946246,33.94713261648749,8
1115,4,2,0,33,0.06060606060606061,0.0,1.0,33,750,700,50,0.9333333333333333,8,7,1,373.32588783386007,0.4159564393939394,-0.009058317131008575,0.21341576725710926,130391.51178770036,3135.705380828503,133527.21716852888,966,0,232.87878787878788,32,1,21,35.13310256727244,0.6331380208333333,44.66540404040405,1021.3383838383849,31.916824494949527,0
1116,4,0,0,33,0.0,0.0,1.0,33,600,300,300,0.5,9,3,6,373.28599259773125,0.41571969696969696,-0.005527344627690223,0.21392565524793505,130488.24737271717,3141.8869885726117,133630.1343612898,967,1,233.87878787878788,32,1,19,35.03588935574231,0.6341145833333333,44.57070707070708,1021.7171717171725,31.92866161616164,0
1117,4,0,0,33,0.0,0.0,1.0,33,650,300,350,0.46153846153846156,10,3,7,373.3182913955974,0.41548295454545453,-0.0022687961902194687,0.21430058514581352,130552.75769054198,3147.546487603334,133700.3041781453,968,2,234.87878787878788,32,1,19,34.96957622930566,0.634765625,44.50757575757577,1021.9696969696987,31.936553030303084,0
1118,4,0,0,33,0.0,0.0,1.0,33,1100,900,200,0.8181818181818182,13,9,4,369.7308225818471,0.41433869949494945,-0.0038837566927454326,0.213128109045579,130714.10323245097,3065.806582236533,133779.9098146875,969,3,235.87878787878788,32,1,19,34.89756965880563,0.6363932291666667,44.34974747474749,1022.6010101010118,31.956281565656617,0
1119,4,0,1,32,0.0,0.030303030303030304,0.9696969696969697,33,1200,800,400,0.6666666666666666,16,8,8,370.8675788296079,0.4144570707070707,-0.00821143318675377,0.2146793470596533,130875.54841342739,3107.499553617004,133983.0479670444,970,4,236.87878787878788,32,1,19,34.70482683448505,0.6380208333333333,44.191919191919204,1023.2323232323247,31.976010101010147,0
1120,4,0,0,32,0.0,0.0,1.0,32,700,500,200,0.7142857142857143,9,5,4,376.26357946084494,0.41219338037634407,0.004900712830957055,0.21734755001797054,130794.8133680556,3442.664930555561,134237.47829861115,971,5,243.90625,31,1,19,34.64867617107942,0.6397849462365591,44.270833333333336,1022.9166666666671,32.997311827957006,0
1121,4,0,0,32,0.0,0.0,1.0,32,1150,800,350,0.6956521739130435,15,8,7,377.5209776804946,0.41074428763440857,0.01381424119068786,0.21901788970821912,130961.35669284404,3488.131883409297,134449.48857625335,972,6,244.90625,31,1,19,34.44761586736208,0.6414650537634409,44.10807291666667,1023.5677083333339,33.01831317204303,0
1122,4,0,0,32,0.0,0.0,1.0,32,850,500,350,0.5882352941176471,12,5,7,377.41823448674785,0.4102822580645162,0.013612011954724501,0.21933773671613457,131028.00369262708,3490.4715643988848,134518.47525702597,973,7,245.90625,31,1,20,34.38268366611556,0.6421370967741935,44.04296875000001,1023.828125000001,33.02671370967745,0
1123,4,0,0,32,0.0,0.0,1.0,32,750,500,250,0.6666666666666666,10,5,5,371.79036398130836,0.4093161962365592,0.0065979725435361125,0.21681799803120502,131161.34855482323,3352.905103895408,134514.25365871863,974,8,246.90625,31,1,20,34.39168361510105,0.643481182795699,43.91276041666667,1024.3489583333342,33.04351478494626,0
1124,4,0,0,32,0.0,0.0,1.0,32,700,500,200,0.7142857142857143,9,5,4,371.432861509052,0.40925319220430106,0.007314167725539944,0.2171750832151738,131261.40170627178,3350.9596082899398,134612.3613145617,975,9,247.90625,31,1,22,34.29955527318932,0.644489247311828,43.81510416666667,1024.739583333334,33.05611559139787,0
1125,4,0,0,32,0.0,0.0,1.0,32,1200,800,400,0.6666666666666666,16,8,8,376.5694532627867,0.40830813172043007,0.006559523809523737,0.2211397796006297,131428.2417297362,3498.3722262912174,134926.61395602743,976,10,248.90625,31,1,22,33.99907407407407,0.6461693548387097,43.65234374999999,1025.390624999999,33.07711693548384,0
1126,4,0,0,32,0.0,0.0,1.0,32,800,500,300,0.625,11,5,6,375.29354903971296,0.408203125,0.0120985656257937,0.22096880264087118,131528.39660644517,3472.351752387138,135000.7483588323,977,11,249.90625,31,1,22,33.930460353727696,0.6471774193548387,43.55468749999999,1025.7812499999989,33.089717741935445,0
1127,4,0,0,32,0.0,0.0,1.0,32,1000,700,300,0.7,13,7,6,374.984845295822,0.4080771169354838,0.011949695508754132,0.22156151054135453,131661.99578179247,3474.250623914926,135136.2464057074,978,12,250.90625,31,1,19,33.80328596802842,0.648521505376344,43.424479166666664,1026.302083333333,33.10651881720429,0
1128,4,0,0,32,0.0,0.0,1.0,32,800,600,200,0.75,10,6,4,374.1774509432504,0.40811911962365593,0.010025678417448391,0.2218619081307123,131795.66277398012,3462.9930284288243,135258.65580240893,979,13,251.90625,31,1,19,33.68892129512214,0.6498655913978495,43.294270833333336,1026.8229166666672,33.123319892473134,0
1129,4,0,0,32,0.0,0.0,1.0,32,550,400,150,0.7272727272727273,7,4,3,374.1774509432504,0.40811911962365593,0.010025678417448391,0.2218619081307123,131795.66277398012,3462.9930284288243,135258.65580240893,980,14,252.90625,31,1,19,33.68892129512214,0.6498655913978495,43.294270833333336,1026.8229166666672,33.123319892473134,0
1130,4,0,0,32,0.0,0.0,1.0,32,700,500,200,0.7142857142857143,9,5,4,373.87522680611744,0.40782510080645157,0.014388945233265948,0.2220728756812239,131862.52170138882,3460.026041666662,135322.54774305547,981,15,253.90625,31,1,19,33.62914131169709,0.6505376344086021,43.229166666666664,1027.0833333333328,33.13172043010751,0
1131,4,0,0,32,0.0,0.0,1.0,32,500,200,300,0.4,8,2,6,373.87522680611744,0.40782510080645157,0.014388945233265948,0.2220728756812239,131862.52170138882,3460.026041666662,135322.54774305547,982,16,254.90625,31,1,19,33.62914131169709,0.6505376344086021,43.229166666666664,1027.0833333333328,33.13172043010751,0
1132,4,0,0,32,0.0,0.0,1.0,32,700,600,100,0.8571428571428571,8,6,2,373.54377036521805,0.4074260752688172,0.016569749017619095,0.22207134923972913,131895.95752292217,3453.782653808599,135349.74017673076,983,17,255.90625,31,1,20,33.60388410022393,0.6508736559139785,43.196614583333336,1027.2135416666672,33.13592069892475,0
1133,4,1,1,32,0.030303030303030304,0.030303030303030304,0.9696969696969697,33,800,500,300,0.625,11,5,6,364.03854176205436,0.40916982323232326,0.017545621965511238,0.21818203993023794,132203.1572830579,3025.4089187327845,135228.56620179067,984,0,249.12121212121212,32,1,22,33.53821362799261,0.6513671875,42.89772727272727,1028.4090909090912,32.1377840909091,0
1134,4,0,0,32,0.0,0.0,1.0,32,700,400,300,0.5714285714285714,10,4,6,412.3639518546571,0.40503192204301075,0.01951335877862581,0.2390251225352219,130928.03955078148,4398.00075954864,135326.04031033014,985,1,257.34375,31,1,17,33.58990670059374,0.6411290322580645,44.140625000000014,1023.4375000000018,33.014112903225865,7
1135,4,0,0,32,0.0,0.0,1.0,32,550,300,250,0.5454545454545454,8,3,5,412.3639518546571,0.40503192204301075,0.01951335877862581,0.2390251225352219,130928.03955078148,4398.00075954864,135326.04031033014,986,2,258.34375,31,1,17,33.58990670059374,0.6411290322580645,44.140625000000014,1023.4375000000018,33.014112903225865,0
1136,4,0,0,32,0.0,0.0,1.0,32,850,700,150,0.8235294117647058,10,7,3,415.5117664324331,0.4050949260752688,0.026838515833651266,0.24147590683357154,131028.00369262707,4488.735453287773,135516.73914591485,987,3,259.34375,31,1,17,33.4076529314511,0.6421370967741935,44.04296875000001,1023.8281250000009,33.02671370967745,0
1137,4,0,0,32,0.0,0.0,1.0,32,1200,800,400,0.6666666666666666,16,8,8,416.57268528296436,0.40456989247311825,0.02475050851767091,0.2427230179582073,131128.00598144543,4524.869113498278,135652.8750949437,988,4,260.34375,31,1,17,33.27877362488346,0.6431451612903225,43.94531250000001,1024.218750000001,33.03931451612906,0
1138,4,0,0,32,0.0,0.0,1.0,32,750,500,250,0.6666666666666666,10,5,5,419.7237094322161,0.4047589045698925,0.03582317073170738,0.24583817266744096,131328.12500000012,4624.30555555557,135952.43055555568,989,5,261.34375,31,1,17,32.99457994579945,0.6451612903225806,43.75000000000001,1025.000000000001,33.064516129032285,0
1139,4,0,0,32,0.0,0.0,1.0,32,900,600,300,0.6666666666666666,12,6,6,418.80345832724004,0.4050739247311828,0.034593385341549876,0.24551990596939743,131362.56946251012,4603.019677130308,135965.58913964042,990,6,262.34375,30,2,17,32.98315196014161,0.6482638888888889,43.71639784946237,1025.1344086021506,34.17114695340502,0
1140,4,0,0,32,0.0,0.0,1.0,32,550,300,250,0.5454545454545454,8,3,5,416.9313714023973,0.4054099462365592,0.038483910079958106,0.24486292782362504,131431.4719367846,4559.58076800786,135991.05270479247,991,7,263.34375,30,2,18,32.96112421898894,0.6489583333333333,43.649193548387096,1025.4032258064515,34.18010752688171,0
1141,4,0,0,32,0.0,0.0,1.0,32,700,500,200,0.7142857142857143,9,5,4,415.31926296316027,0.4054309475806452,0.04004750982962002,0.2441360536524586,131465.92994854896,4520.066626199564,135985.9965747485,992,8,264.34375,30,2,18,32.967453036260395,0.6493055555555556,43.615591397849464,1025.5376344086021,34.18458781362007,0
1142,4,1,0,33,0.030303030303030304,0.0,1.0,33,900,500,400,0.5555555555555556,13,5,8,404.4240721793631,0.4086568813131313,0.028133316436446565,0.24085361158998914,131962.8418816461,4073.789978027353,136036.63185967345,993,0,257.3030303030303,31,2,18,32.74313035948126,0.6515456989247312,43.13151041666667,1027.473958333334,33.14432123655916,0
1143,4,0,0,33,0.0,0.0,1.0,33,1150,1000,150,0.8695652173913043,13,10,3,404.23669704662495,0.40818339646464646,0.028254180191379152,0.24223531360199135,132197.07065158428,4087.781439887157,136284.85209147143,994,1,258.3030303030303,31,2,18,32.510867730227055,0.6538978494623655,42.903645833333336,1028.3854166666672,33.17372311827959,0
1144,4,0,0,33,0.0,0.0,1.0,33,900,600,300,0.6666666666666666,12,6,6,404.69363983667057,0.40767045454545453,0.03354731828535962,0.2433705587510937,132331.00891113278,4110.703531901042,136441.71244303382,995,2,259.3030303030303,31,2,18,32.36364211592002,0.655241935483871,42.7734375,1028.9062499999998,33.19052419354838,0
1145,4,0,0,33,0.0,0.0,1.0,33,700,400,300,0.5714285714285714,10,4,6,405.35003032339483,0.4077493686868687,0.03386087596613918,0.24419867680458188,132398.00347222228,4133.523898654518,136531.5273708768,996,3,260.3030303030303,30,3,18,32.27901484480432,0.6586805555555555,42.708333333333336,1029.166666666667,34.305555555555564,0
1146,4,0,0,33,0.0,0.0,1.0,33,700,600,100,0.8571428571428571,8,6,2,384.212740776442,0.4075915404040404,0.03239675029979172,0.22251495429344556,130894.72664727096,3497.3468356662224,134392.07348293718,997,4,261.3030303030303,31,2,22,34.34398460363914,0.6407930107526882,44.17317708333333,1023.3072916666658,33.00991263440857,8
1147,4,0,0,33,0.0,0.0,1.0,33,1000,800,200,0.8,12,8,4,385.9611358506621,0.40707859848484845,0.03458799593082462,0.2244969210302962,131061.33355034712,3516.916232638883,134578.249782986,998,5,262.3030303030303,31,2,22,34.13021363173959,0.6424731182795699,44.010416666666664,1023.9583333333325,33.030913978494596,0
1148,4,0,1,32,0.0,0.030303030303030304,0.9696969696969697,33,750,300,450,0.4,12,3,9,386.5430991594083,0.40688131313131315,0.03842878884201184,0.22503045706060304,131094.66764662004,3534.7478230794313,134629.41546969948,999,6,263.3030303030303,31,2,22,34.08150561559653,0.6428091397849462,43.977864583333336,1024.088541666667,33.03511424731184,0
1149,4,0,0,32,0.0,0.0,1.0,32,550,300,250,0.5454545454545454,8,3,5,395.5405691688439,0.40505292338709675,0.04346934086134446,0.22960647673703624,130983.92877789341,3961.891548155855,134945.82032604926,1000,7,268.78125,30,2,22,33.96358543417366,0.6444444444444444,44.086021505376344,1023.6559139784947,34.121863799283155,0
1150,4,0,0,32,0.0,0.0,1.0,32,1000,600,400,0.6,14,6,8,396.8988896907952,0.4041708669354838,0.0422436991336308,0.23080730852400594,131052.73189097011,4002.936755694308,135055.66864666442,1001,8,269.78125,30,2,22,33.858952480966124,0.6451388888888889,44.01881720430108,1023.9247311827962,34.130824372759875,0
1151,4,0,0,32,0.0,0.0,1.0,32,800,500,300,0.625,11,5,6,398.0576050013884,0.40435987903225806,0.038452388764929735,0.2316883798705559,131087.1402221355,4036.046616660884,135123.1868387964,1002,9,270.78125,30,2,22,33.794351839699,0.6454861111111111,43.98521505376344,1024.0591397849462,34.1353046594982,0
1152,4,0,0,32,0.0,0.0,1.0,32,800,500,300,0.625,11,5,6,401.36204882356355,0.403330813172043,0.039841290661069895,0.23466136964960516,131259.2496242342,4136.496271245251,135395.74589547943,1003,10,271.78125,30,2,22,33.534999125568376,0.6472222222222221,43.81720430107528,1024.7311827957003,34.15770609319001,0
1153,4,1,1,32,0.030303030303030304,0.030303030303030304,0.9696969696969697,33,800,500,300,0.625,11,5,6,391.8718042896644,0.4083017676767677,0.03297730964217149,0.23124192412875721,131613.00154320986,3715.1210078878726,135328.12255109774,1004,0,264.5151515151515,29,4,20,33.419621909402636,0.6537356321839081,43.47222222222222,1026.111111111111,35.383141762452105,0
1154,4,0,0,32,0.0,0.0,1.0,32,800,500,300,0.625,11,5,6,401.0243313011479,0.40343581989247307,0.03762254901960804,0.23624700705364668,131549.12306777653,4150.879822301508,135700.00289007803,1005,12,273.78125,28,4,22,33.24959150326798,0.65625,43.5344827586207,1025.862068965518,36.63793103448278,0
1155,4,0,0,32,0.0,0.0,1.0,32,1050,800,250,0.7619047619047619,13,8,5,406.0442100691794,0.40341481854838707,0.03420744085118277,0.2398985767182919,131659.69177318676,4291.931108799057,135951.62288198582,1006,13,274.78125,28,4,21,33.00871482570349,0.6573660714285714,43.42672413793104,1026.2931034482765,36.65332512315273,0
1156,4,0,0,32,0.0,0.0,1.0,32,950,800,150,0.8421052631578947,11,8,3,400.3333270085873,0.40341481854838707,-0.028877566894835116,0.21897061147134134,128656.40503838917,3901.0893339965587,132557.49437238573,1007,14,275.78125,32,0,16,36.216293300145196,0.6155598958333333,46.36994949494951,1014.5202020202039,31.70375631313137,8
1157,4,0,1,31,0.0,0.03125,0.96875,32,1350,1200,150,0.8888888888888888,15,12,3,407.95244266283953,0.40406586021505375,-0.02179961452375001,0.22440174718841008,128880.6706586063,4115.436881440679,132996.10754004697,1008,15,276.78125,32,0,16,35.793075934676295,0.6178385416666667,46.1489898989899,1015.4040404040406,31.73137626262627,0
1158,4,1,1,31,0.03125,0.03125,0.96875,32,1000,700,300,0.7,13,7,6,405.4689599570011,0.409148185483871,0.00640368852459039,0.22485096870342766,129201.38888888879,4078.227668095081,133279.61655698388,1009,0,274.0,30,2,17,35.52766393442624,0.6263888888888889,45.83333333333333,1016.6666666666658,33.888888888888864,0
1159,4,0,0,31,0.0,0.0,1.0,31,750,600,150,0.8,9,6,3,411.5103051027358,0.40618279569892474,0.057192496809938875,0.21950044521665513,127650.6233215332,4305.909389919705,131956.53271145292,1010,1,281.64516129032256,31,0,19,36.96701992870334,0.6078629032258065,47.36328125,1010.546875,32.598286290322584,8
1160,4,2,0,33,0.06060606060606061,0.0,1.0,33,800,500,300,0.625,11,5,6,392.04215061993835,0.4127209595959596,0.06455751417648115,0.21252540715901863,128299.67928501074,3459.7764381488123,131759.45572315957,1011,0,265.5151515151515,33,0,21,36.79224124027257,0.6095328282828283,46.72181372549021,1013.1127450980407,30.70038621509214,0
1161,4,1,0,34,0.029411764705882353,0.0,1.0,34,750,600,150,0.8,9,6,3,383.30579728834647,0.41664809863339275,0.06730629803277122,0.20918527143494098,128566.75347222245,3056.076388888923,131622.8298611114,1012,0,258.6764705882353,34,0,17,36.73993426458506,0.6099877450980392,46.45833333333335,1014.1666666666686,29.828431372549076,0
1162,4,1,0,35,0.02857142857142857,0.0,1.0,35,700,500,200,0.7142857142857143,9,5,4,376.6929098493337,0.4200280112044818,0.0741059214383426,0.20703948654125054,128848.62075617301,2707.272376543226,131555.89313271624,1013,0,252.25714285714287,35,0,18,36.61935704514363,0.6107142857142858,46.180555555555564,1015.2777777777792,29.00793650793655,0
1163,4,2,0,37,0.05405405405405406,0.0,1.0,37,1050,800,250,0.7619047619047619,13,8,5,359.0693558964219,0.42680180180180183,0.0715343152140906,0.19973232921738454,129322.44897959182,1888.5924508692387,131211.04143046105,1014,0,239.56756756756758,34,3,20,36.58366495006244,0.6176470588235294,45.714285714285715,1017.142857142857,29.91596638655462,0
1164,4,0,0,37,0.0,0.0,1.0,37,800,600,200,0.75,10,6,4,356.31044309194056,0.4261136136136136,0.07138750626408452,0.1986255615232245,129407.39300679443,1821.841108324763,131229.2341151192,1015,1,240.56756756756758,35,2,20,36.567346339058886,0.6163690476190475,45.63078703703704,1017.4768518518521,29.070767195767203,0
1165,4,1,3,35,0.02631578947368421,0.07894736842105263,0.9210526315789473,38,800,500,300,0.625,11,5,6,353.6974137735591,0.42819464201043145,0.09270440690585846,0.1990207835710925,129774.47041636253,1580.1789120201497,131354.6493283827,1016,0,235.21052631578948,36,2,16,36.260545608605945,0.6180555555555556,45.27027027027028,1018.9189189189207,28.303303303303352,0
1166,4,1,0,36,0.027777777777777776,0.0,1.0,36,900,600,300,0.6666666666666666,12,6,6,347.8469014205218,0.4217261904761905,0.049912130887849404,0.1861126031557473,127774.23327043239,1689.1742249005542,129463.40749533294,1017,0,249.0,36,0,15,38.44884718200044,0.5978009259259259,47.24099099099098,1011.0360360360344,28.084334334334287,8
1167,4,1,1,36,0.02702702702702703,0.02702702702702703,0.972972972972973,37,750,400,350,0.5333333333333333,11,4,7,350.87752675386446,0.424049049049049,0.04316868592730683,0.18301165963780694,126742.1392746913,1502.655470786095,128244.7947454774,1018,0,243.24324324324326,35,2,17,39.43103448275863,0.5892857142857143,48.263888888888886,1006.944444444444,28.76984126984126,8
1168,4,1,0,37,0.02702702702702703,0.0,1.0,37,1000,700,300,0.7,13,7,6,354.14247660678916,0.4239552052052052,0.06187178914451663,0.186309737693137,127092.01388888895,1601.7361111111213,128693.75000000007,1019,0,244.05405405405406,35,2,19,38.989325068870514,0.5928571428571429,47.91666666666667,1008.3333333333339,28.809523809523828,0
1169,4,1,1,37,0.02631578947368421,0.02631578947368421,0.9736842105263158,38,800,400,400,0.5,12,4,8,346.98949239717336,0.4272018729255571,0.07660765111679257,0.1846661152221054,127559.26354595335,1252.3448216735237,128811.60836762688,1020,0,238.60526315789474,35,3,17,38.690612587839894,0.5976190476190476,47.4537037037037,1010.1851851851851,28.86243386243386,0
1170,4,1,0,38,0.02631578947368421,0.0,1.0,38,1200,1000,200,0.8333333333333334,14,10,4,345.10343872309113,0.42895033191085824,0.09382491477033139,0.18500084954370383,127851.72994898842,1224.4143304183876,129076.1442794068,1021,0,239.47368421052633,35,3,18,38.4389066910811,0.6005952380952381,47.164351851851855,1011.3425925925932,28.895502645502663,0
1171,4,2,1,39,0.05,0.025,0.975,40,1000,600,400,0.6,14,6,8,333.3061210274794,0.4312633547008547,0.11442016443098257,0.18124010486929518,128422.23087873182,560.7831255770931,128983.0140043089,1022,0,228.45,37,3,17,38.154929323525174,0.6024774774774775,46.60087719298245,1013.5964912280695,27.394499762920795,0
1172,4,0,0,39,0.0,0.0,1.0,39,1100,700,400,0.6363636363636364,15,7,8,339.9831856141899,0.4303025191183086,0.10871361727107476,0.18450957202391324,128344.1443977762,926.9702134567093,129271.1146112329,1023,1,235.30769230769232,36,3,20,38.06540342298289,0.603587962962963,46.67792792792793,1013.2882882882886,28.146896896896905,0
1173,4,3,0,42,0.07142857142857142,0.0,1.0,42,1000,800,200,0.8,12,8,4,319.0613426996706,0.4340882694541231,0.12529337998136025,0.17681542551993681,129174.91455078126,-157.05566406249966,129017.85888671876,1024,0,219.42857142857142,39,3,21,37.750730095296646,0.6065705128205128,45.859375,1016.5625000000001,26.06570512820513,0
1174,4,0,0,42,0.0,0.0,1.0,42,1250,900,350,0.72,16,9,7,320.05981695161523,0.4334712543554007,0.13171455260267506,0.17824219577893666,129368.65790435509,-118.85278102398041,129249.80512333111,1025,1,220.42857142857142,37,5,22,37.52874182654309,0.6120495495495495,45.6688596491228,1017.3245614035079,27.495258416311025,0
1175,4,0,0,42,0.0,0.0,1.0,42,1400,1100,300,0.7857142857142857,17,11,6,321.9968067813111,0.43279374758033295,0.13676371022342604,0.18008544302154758,129536.03512619254,-57.9620652508608,129478.07306094168,1026,2,221.42857142857142,37,5,17,37.30970845899754,0.6137387387387387,45.504385964912274,1017.9824561403498,27.51303935514459,0
1176,4,0,0,42,0.0,0.0,1.0,42,1150,900,250,0.782608695652174,14,9,5,322.1715415859054,0.43216463414634143,0.13285596353325468,0.18056771917370557,129619.76431450053,-48.040142159133865,129571.72417234139,1027,3,222.42857142857142,37,5,19,37.22037525573383,0.6145833333333333,45.422149122807014,1018.3114035087713,27.521929824561386,0
1177,4,2,1,43,0.045454545454545456,0.022727272727272728,0.9772727272727273,44,1650,1500,150,0.9090909090909091,18,15,3,313.8969544463399,0.4356501057082452,0.1536909202249066,0.17860408592713328,130209.42382812487,-625.5316840277924,129583.89214409707,1028,0,213.27272727272728,39,5,22,36.834473021705115,0.6169871794871795,44.84374999999999,1020.624999999999,26.169871794871767,0
1178,4,0,0,43,0.0,0.0,1.0,43,1350,1100,250,0.8148148148148148,16,11,5,321.18909073576947,0.43466223698781836,0.14982120045020486,0.1822552696793813,130103.130425347,-242.45876736113132,129860.67165798586,1029,1,219.13953488372093,39,4,22,36.75592199305698,0.6159188034188035,44.94791666666666,1020.2083333333316,26.159188034187988,0
1179,4,0,0,43,0.0,0.0,1.0,43,1150,800,350,0.6956521739130435,15,8,7,323.06083715805715,0.43431616832779624,0.15056928789159318,0.18356751512762895,130156.27170138867,-190.32118055558107,129965.9505208331,1030,2,220.13953488372093,39,4,22,36.65441676874912,0.6164529914529915,44.89583333333332,1020.4166666666649,26.16452991452987,0
1180,4,0,0,43,0.0,0.0,1.0,43,950,500,450,0.5263157894736842,14,5,9,326.9731959804107,0.4343623108157992,0.15000012488354653,0.18643278798368645,130290.57167830465,-79.60826889044682,130210.96340941421,1031,3,221.13953488372093,37,6,23,36.418729638778515,0.6213400900900901,44.764254385964904,1020.9429824561387,27.59305357989564,0
1181,4,0,0,43,0.0,0.0,1.0,43,1300,900,400,0.6923076923076923,17,9,8,329.3173357258868,0.43415466961978594,0.15863386136389246,0.18831129418579717,130402.5412266274,-11.236510272387477,130391.30471635502,1032,4,222.13953488372093,37,6,23,36.24563875469674,0.6224662162162162,44.6546052631579,1021.3815789473683,27.604907539118063,0
1182,4,0,0,43,0.0,0.0,1.0,43,1200,700,500,0.5833333333333334,17,7,10,331.09932599623994,0.43397009966777406,0.16323250073009854,0.1896037136021491,130458.54403518382,38.94720010002413,130497.49123528384,1033,5,223.13953488372093,37,6,23,36.1434966548603,0.6230292792792793,44.59978070175438,1021.6008771929818,27.610834518729238,0
1183,4,0,0,43,0.0,0.0,1.0,43,1800,1400,400,0.7777777777777778,22,14,8,334.7160361317376,0.4334856035437431,0.16073548631688173,0.19264767412915565,130654.64854570643,146.44121268083302,130801.08975838726,1034,6,224.13953488372093,37,6,19,35.85281710281711,0.625,44.40789473684211,1022.368421052632,27.631578947368432,0
1184,4,0,0,43,0.0,0.0,1.0,43,1250,800,450,0.64,17,8,9,335.6666056064668,0.43339331856773716,0.16134936586387627,0.19347507811408599,130710.70545744854,175.04376346569438,130885.74922091424,1035,7,225.13953488372093,37,6,19,35.77185645864609,0.6255630630630631,44.3530701754386,1022.5877192982464,27.63750592697963,0
1185,4,0,0,43,0.0,0.0,1.0,43,1400,1000,400,0.7142857142857143,18,10,8,333.4764712707455,0.43362403100775193,0.15746155188314725,0.19277171480520808,130822.85534972318,125.26883271778081,130948.12418244095,1036,8,226.13953488372093,37,6,19,35.71454090746696,0.6266891891891893,44.24342105263159,1023.0263157894751,27.64935988620203,0
1186,4,0,0,43,0.0,0.0,1.0,43,850,600,250,0.7058823529411765,11,6,5,335.2289838462338,0.433577888519749,0.16013637960985205,0.193925706650292,130850.90033712306,173.00287107572458,131023.90320819878,1037,9,227.13953488372093,37,6,19,35.641388025577825,0.6269707207207207,44.21600877192983,1023.1359649122816,27.652323376007608,0
1187,4,1,2,42,0.022727272727272728,0.045454545454545456,0.9545454545454546,44,750,600,150,0.8,9,6,3,330.03551059600454,0.4342186398872445,0.1706678803049262,0.1924805642089108,131163.91354372134,-142.250164365537,131021.6633793558,1038,0,222.95454545454547,38,6,20,35.45838548185232,0.6282894736842105,43.910256410256416,1024.3589743589753,26.956815114709876,0
1188,4,0,0,42,0.0,0.0,1.0,42,1050,700,350,0.6666666666666666,14,7,7,347.2029893730283,0.42989014711575685,0.17730457430028257,0.2010856318950099,130895.62694028475,689.4705939047025,131585.09753418947,1039,1,234.0,36,6,20,35.28988298301604,0.6293402777777778,44.17229729729729,1023.3108108108098,28.42530030030027,0
1189,4,0,0,42,0.0,0.0,1.0,42,1300,900,400,0.6923076923076923,17,9,8,346.5358637073828,0.43012001548586914,0.17459269736497451,0.20115012778417032,130982.06948502548,677.9969158347408,131660.06640086023,1040,2,235.0,36,6,20,35.219563623028954,0.6302083333333333,44.08783783783783,1023.648648648648,28.434684684684665,0
1190,4,0,0,42,0.0,0.0,1.0,42,1250,900,350,0.72,16,9,7,347.5856187152951,0.42938201703445605,0.17014377485469567,0.20239711214469164,131103.44048168656,713.9340951061708,131817.37457679273,1041,3,236.0,37,5,20,35.070039257673066,0.6295045045045045,43.96929824561403,1024.122807017543,27.678994784257917,0
1191,4,0,0,42,0.0,0.0,1.0,42,1300,1100,200,0.8461538461538461,15,11,4,342.44889245705446,0.4288617886178862,0.16383407968943486,0.20043016892899704,131300.0289151468,592.7098963142345,131892.73881146105,1042,4,237.0,37,5,20,35.00309814200635,0.6314752252252251,43.777412280701746,1024.8903508771916,27.69973921289707,0
1192,4,0,2,40,0.0,0.047619047619047616,0.9523809523809523,42,1400,1000,400,0.7142857142857143,18,10,8,341.33442115052657,0.4290432636469222,0.1608500252663716,0.20023445712260696,131387.44882758913,569.4177698669807,131956.8665974561,1043,5,238.0,35,7,21,34.94345977271016,0.6363095238095238,43.692129629629626,1025.2314814814813,29.292328042328037,0
1193,4,0,0,40,0.0,0.0,1.0,40,1500,900,600,0.6,21,9,12,347.60674017392904,0.4266693376068376,0.1641265094233153,0.20438907263976036,131476.45968632135,1140.4207122342445,132616.8803985556,1044,6,246.5,35,5,21,34.69287232441787,0.637202380952381,43.60532407407408,1025.5787037037053,29.302248677248723,0
1194,4,0,0,40,0.0,0.0,1.0,40,900,500,400,0.5555555555555556,13,5,8,347.8476195441097,0.4265090811965812,0.16292870036101093,0.20500806513557118,131565.5006858712,1152.9492455418545,132718.44993141305,1045,7,247.5,35,5,20,34.596871239470524,0.638095238095238,43.518518518518526,1025.925925925927,29.312169312169342,0
1195,4,0,0,40,0.0,0.0,1.0,40,1500,1200,300,0.8,18,12,6,348.40834968673363,0.42544070512820514,0.1517500845451467,0.20646162124722914,131773.38023244624,1182.1891878858305,132955.5694203321,1046,8,248.5,35,5,20,34.37288637132229,0.6401785714285715,43.315972222222236,1026.7361111111131,29.33531746031752,0
1196,4,0,0,40,0.0,0.0,1.0,40,1450,1100,350,0.7586206896551724,18,11,7,346.59439968176065,0.42504006410256406,0.14591922946941538,0.2063526818226017,131951.69331114978,1146.7435860339574,133098.43689718374,1047,9,249.5,35,5,22,34.239819195674215,0.6419642857142858,43.142361111111114,1027.430555555556,29.355158730158745,0
1197,4,0,0,40,0.0,0.0,1.0,40,900,400,500,0.4444444444444444,14,4,10,347.9386091627436,0.42413194444444446,0.1462926472244117,0.2078038189626313,132070.63567654756,1190.4946577074832,133261.13033425505,1048,10,250.5,35,5,22,34.08552434035205,0.643154761904762,43.026620370370374,1027.8935185185192,29.36838624338626,0
1198,4,0,0,40,0.0,0.0,1.0,40,1700,1300,400,0.7647058823529411,21,13,8,346.83191622840343,0.42422542735042734,0.14119583567810934,0.20779511636475814,132189.63162562152,1169.51664844821,133359.14827406974,1049,11,251.5,35,5,22,33.99420840367661,0.6443452380952381,42.910879629629626,1028.356481481481,29.381613756613746,0
1199,4,0,0,40,0.0,0.0,1.0,40,1200,600,600,0.5,18,6,12,345.73243024037055,0.4239850427350427,0.13665354330708612,0.2079540801648778,132338.4519140089,1150.738918895745,133489.19083290466,1050,12,252.5,35,5,23,33.8727971503562,0.6458333333333333,42.7662037037037,1028.9351851851852,29.39814814814815,0
1200,4,0,1,39,0.0,0.025,0.975,40,800,500,300,0.625,11,5,6,345.4193256122577,0.4242654914529915,0.12996183206106848,0.2082632837687294,132428.63520408171,1148.6953687081866,133577.3305727899,1051,13,253.5,34,6,23,33.79019199629886,0.6488970588235294,42.67857142857143,1029.285714285715,30.273109243697498,0
1201,4,0,0,39,0.0,0.0,1.0,39,700,400,300,0.5714285714285714,10,4,6,338.5929254724821,0.4224583895636527,0.09749441546676607,0.20012554622284048,131674.63705259308,1185.2760380692312,132859.9130906623,1052,14,258.8205128205128,36,3,17,34.724279496744934,0.6371527777777778,43.41216216216216,1026.351351351351,28.50975975975975,8
1202,4,0,0,39,0.0,0.0,1.0,39,1250,900,350,0.72,16,9,7,341.3262169093557,0.4212494376968061,0.09877476145495434,0.2024395200352193,131806.21831957897,1197.7835728300925,133004.00189240905,1053,15,259.8205128205128,37,2,17,34.52160081865102,0.6365427927927928,43.28399122807017,1026.8640350877183,27.753082029397792,0
1203,4,0,0,39,0.0,0.0,1.0,39,1400,1000,400,0.7142857142857143,18,10,8,335.3918825289798,0.4208277103013945,0.0453535232963298,0.18518393905608688,129029.71172185717,884.7100487639702,129914.42177062113,1054,16,260.8205128205128,36,3,17,37.48337397472844,0.6105324074074074,46.00225225225226,1015.9909909909925,28.221971971972014,8
1204,4,1,0,40,0.025,0.0,1.0,40,1300,900,400,0.6923076923076923,17,9,8,325.213659334126,0.42212873931623934,0.04669181034482728,0.1813691561671086,129424.43828870417,418.1190366266457,129842.55732533082,1055,0,255.275,37,3,19,37.34105603448274,0.6126126126126126,45.614035087719294,1017.5438596491224,27.501185395922228,0
1205,4,1,0,41,0.024390243902439025,0.0,1.0,41,1000,700,300,0.7,13,7,6,324.1049026097035,0.42385670731707314,0.06835199051078611,0.18286723097570556,129881.14458917745,219.0231435824359,130100.16773275989,1056,0,250.02439024390245,38,3,16,36.90629039583551,0.6154057017543859,45.16559829059829,1019.3376068376069,26.824673864147552,0
1206,4,1,0,42,0.023809523809523808,0.0,1.0,42,800,600,200,0.75,10,6,4,316.72497053405203,0.42552264808362367,0.07312022399813367,0.1799673904496271,130156.27170138879,-155.2517361111211,130001.01996527766,1057,0,245.04761904761904,39,3,17,36.81604736627194,0.6164529914529915,44.89583333333333,1020.4166666666658,26.164529914529894,0
1207,4,2,1,43,0.045454545454545456,0.022727272727272728,0.9772727272727273,44,1050,900,150,0.8571428571428571,12,9,3,304.7982201721276,0.4282725510923185,0.09617469797869393,0.17553376606478374,130677.89019639413,-833.8789276803021,129844.01126871383,1058,0,234.86363636363637,40,4,17,36.59406785276481,0.6200520833333334,44.38516260162601,1022.4593495934943,25.561483739837357,0
1208,4,1,0,44,0.022727272727272728,0.0,1.0,44,500,300,200,0.6,7,3,4,307.64195669035536,0.428580866807611,0.10315901187734311,0.17764866862239972,130781.8193225759,-753.2050408156416,130028.61428176027,1059,0,235.1590909090909,40,4,18,36.41662526908431,0.62109375,44.28353658536586,1022.865853658537,25.571646341463428,0
1209,4,0,0,44,0.0,0.0,1.0,44,1150,700,450,0.6086956521739131,16,7,9,307.61670323860056,0.4281404157857646,0.09768462947754064,0.1785949885718978,130989.80150910518,-741.0698203780709,130248.7316887271,1060,1,236.1590909090909,40,4,18,36.20776663688409,0.6231770833333333,44.080284552845534,1023.6788617886191,25.591971544715477,0
1210,4,0,1,43,0.0,0.022727272727272728,0.9772727272727273,44,1600,1100,500,0.6875,21,11,10,306.4228944153963,0.42757884073291047,0.09381567435441829,0.17862558431537176,131145.8965913972,-762.7789551523679,130383.11763624483,1061,2,237.1590909090909,40,4,18,36.08120845321956,0.6247395833333333,43.92784552845528,1024.2886178861781,25.607215447154452,0
1211,4,0,1,42,0.0,0.023255813953488372,0.9767441860465116,43,1350,1000,350,0.7407407407407407,17,10,7,340.76351922805395,0.42552602436323367,0.10280198081865444,0.19058783763860512,129537.39636005362,228.45032718620718,129765.84668723983,1062,3,243.13953488372093,40,3,15,36.830721107450664,0.60859375,45.50304878048781,1017.9878048780495,25.449695121951237,8
1212,4,0,0,42,0.0,0.0,1.0,42,1000,800,200,0.8,12,8,4,351.07780006581305,0.42375629113433994,0.10994670018611097,0.196531180861584,129572.31445312501,697.9926215277775,130270.3070746528,1063,4,249.76190476190476,39,3,16,36.53272287019985,0.6105769230769231,45.46875,1018.1250000000001,26.105769230769234,0
1213,4,0,0,42,0.0,0.0,1.0,42,1050,800,250,0.7619047619047619,13,8,5,339.88721231519594,0.42300619434765774,0.12571036645110745,0.18353909465020563,128144.53124999988,341.41710069443,128485.9483506943,1064,5,250.76190476190476,38,4,15,38.271604938271594,0.5978618421052632,46.87499999999999,1012.4999999999991,26.64473684210524,8
1214,4,0,0,42,0.0,0.0,1.0,42,1050,800,250,0.7619047619047619,13,8,5,341.25941355551987,0.4233086527293844,0.12034358047016225,0.18465406623894556,128225.67389875074,351.64365548979595,128577.31755424054,1065,6,251.76190476190476,38,4,16,38.15400843881855,0.5986842105263157,46.79487179487179,1012.8205128205121,26.653171390013476,0
1215,4,1,0,43,0.023255813953488372,0.0,1.0,43,1200,800,400,0.6666666666666666,16,8,8,347.50768134435907,0.42716408268733846,0.15347595880698806,0.19040606477259517,128725.26584201379,346.60373263887857,129071.86957465266,1066,0,246.88372093023256,39,4,14,37.48588585506057,0.6020299145299146,46.30208333333333,1014.7916666666658,26.020299145299123,0
1216,4,1,0,44,0.022727272727272728,0.0,1.0,44,850,400,450,0.47058823529411764,13,4,9,339.94963918804547,0.43002334390415786,0.14767384760882862,0.1876574568173875,129020.64252635658,-27.895825071061495,128992.74670128552,1067,0,242.25,40,4,15,37.376838051415426,0.6033854166666667,46.011178861788615,1015.9552845528448,25.39888211382112,0
1217,4,0,1,43,0.0,0.022727272727272728,0.9772727272727273,44,1050,800,250,0.7619047619047619,13,8,5,343.0733569342923,0.42937367864693443,0.14214884295868147,0.19000109169749654,129149.73416121339,61.56656917177304,129211.30073038516,1068,1,243.25,40,4,17,37.16610844497765,0.6046875,45.884146341463406,1016.4634146341449,25.41158536585362,0
1218,4,0,0,43,0.0,0.0,1.0,43,1050,600,450,0.5714285714285714,15,6,9,348.61014380775987,0.4278100775193798,0.14926155936728946,0.19267376503369368,129069.04432508661,398.95562065970364,129467.99994574631,1069,2,249.69767441860466,39,4,17,37.10757303946694,0.6055021367521367,45.96354166666666,1016.1458333333318,26.055021367521327,0
1219,4,0,0,43,0.0,0.0,1.0,43,1000,700,300,0.7,13,7,6,346.4340125376247,0.42681801402731634,0.14841217802951068,0.1918622919934285,129149.73416121339,348.372124727328,129498.10628594072,1070,3,250.69767441860466,40,3,17,37.08070885822834,0.6046875,45.884146341463406,1016.4634146341449,25.41158536585362,0
1220,4,2,2,43,0.044444444444444446,0.044444444444444446,0.9555555555555556,45,1100,600,500,0.5454545454545454,16,6,10,334.26719431506774,0.431986531986532,0.14824914513266663,0.18776015050476536,129706.17992567373,-328.68550233677075,129377.49442333696,1071,0,240.51111111111112,41,4,14,36.824763017789884,0.608739837398374,45.337301587301575,1018.6507936507917,24.845141308555895,0
1221,4,1,0,44,0.022727272727272728,0.0,1.0,44,950,700,250,0.7368421052631579,12,7,5,345.411647813815,0.42937367864693443,0.16241574511707202,0.19369726484287855,129640.87106095905,155.89337943683805,129796.76444039588,1072,0,246.95454545454547,40,4,15,36.60729135482153,0.6096354166666667,45.40142276422764,1018.3943089430892,25.45985772357723,0
1222,4,0,2,42,0.0,0.045454545454545456,0.9545454545454546,44,1150,600,550,0.5217391304347826,17,6,11,346.0822155270114,0.4290103065539112,0.15998116407867946,0.18457083962768264,127644.04432508719,38.041151758974095,127682.08547684616,1073,1,247.95454545454547,39,5,14,38.626709445761605,0.5910790598290598,47.369791666666686,1010.5208333333364,25.910790598290678,8
1223,4,1,0,43,0.023255813953488372,0.0,1.0,43,800,600,200,0.75,10,6,4,349.6010210879313,0.42485695828719083,0.19131939534404374,0.18669117818471137,127696.6810438371,328.5780164930895,128025.2590603302,1074,0,254.53488372093022,39,4,15,38.483909615582824,0.5916132478632479,47.31770833333335,1010.729166666669,25.916132478632537,0
1224,4,0,0,43,0.0,0.0,1.0,43,1150,700,450,0.6086956521739131,16,7,9,348.3747862011828,0.42400332225913623,0.18997558702542583,0.18652366517677277,127801.98703342052,304.59798177087214,128106.58501519139,1075,1,255.53488372093022,39,4,15,38.40709882902372,0.5926816239316239,47.213541666666686,1011.1458333333364,25.92681623931632,0
1225,4,1,0,44,0.022727272727272728,0.0,1.0,44,900,600,300,0.6666666666666666,12,6,6,341.24201933987,0.4269622093023256,0.18714927048260366,0.1842706904435301,128144.53125000026,-54.340277777748526,128090.19097222251,1076,0,250.70454545454547,40,4,18,38.23731138545956,0.59453125,46.875000000000014,1012.500000000002,25.31250000000005,0
1226,4,0,0,44,0.0,0.0,1.0,44,1200,900,300,0.75,15,9,6,343.87031542218153,0.4268300739957717,0.19164524421593754,0.1863029981883411,128276.40109592049,22.08930121531597,128298.4903971358,1077,1,251.70454545454547,39,5,19,38.036096829477295,0.5974893162393162,46.744791666666686,1013.0208333333362,25.974893162393236,0
1227,4,0,0,44,0.0,0.0,1.0,44,1950,1700,250,0.8717948717948718,22,17,5,381.33239642640467,0.42605928470754056,0.24322177713755777,0.20309807518340398,127590.03371229596,1024.4977195507174,128614.53143184668,1078,2,252.70454545454547,37,7,17,37.791675710874756,0.5940315315315315,47.42324561403508,1010.3070175438586,27.305595068752936,8
1228,4,0,0,44,0.0,0.0,1.0,44,1200,900,300,0.75,15,9,6,381.7914230258793,0.42632355532064836,0.24964511740699158,0.20446460529295313,127811.68845221584,959.4812827023452,128771.16973491818,1079,3,253.70454545454547,37,7,18,37.5524109014675,0.5962837837837838,47.20394736842104,1011.1842105263139,27.32930298719767,0
1229,4,0,0,44,0.0,0.0,1.0,44,1400,1200,200,0.8571428571428571,16,12,4,376.5640179667422,0.4264667019027484,0.24202439480969917,0.20236203807682723,127950.32035097312,836.2973462988317,128786.61769727195,1080,4,254.70454545454547,37,7,19,37.542334995123,0.5976914414414414,47.06688596491227,1011.7324561403489,27.344120436225644,0
1230,4,3,1,46,0.06382978723404255,0.02127659574468085,0.9787234042553191,47,1450,800,650,0.5517241379310345,21,8,13,360.6914883009674,0.43485969781066913,0.25856592293385683,0.19781580964644468,128762.65290377739,-111.28141731113976,128651.37148646625,1081,0,239.38297872340425,40,7,18,37.1132472213878,0.60078125,46.26524390243902,1014.9390243902428,25.37347560975607,0
1231,4,0,0,46,0.0,0.0,1.0,46,850,400,450,0.47058823529411764,13,4,9,361.44846736301247,0.4308876811594203,0.2539624090018435,0.19791284545155152,128698.8403320311,103.59971788192996,128802.44004991303,1082,1,245.58695652173913,39,7,18,37.15919395681484,0.6017628205128205,46.32812499999999,1014.6874999999989,26.017628205128176,0
1232,4,0,0,46,0.0,0.0,1.0,46,1200,800,400,0.6666666666666666,16,8,8,360.76265614727185,0.42967995169082124,0.2591527313266446,0.19872519194553095,128936.76757812484,103.1141493055415,129039.88172743039,1083,2,246.58695652173913,39,7,19,36.93376068376069,0.6041666666666667,46.09374999999999,1015.6249999999987,26.041666666666636,0
1233,4,1,1,46,0.02127659574468085,0.02127659574468085,0.9787234042553191,47,1300,1000,300,0.7692307692307693,16,10,6,356.63995832156894,0.4316990440949738,0.22018087630024952,0.19805263314216942,129257.13320444745,-16.231526767857332,129240.90167767959,1084,0,242.31914893617022,37,10,17,36.71195456832723,0.6109234234234234,45.77850877192982,1016.8859649122801,27.48340445708865,8
1234,4,0,0,46,0.0,0.0,1.0,46,1650,1200,450,0.7272727272727273,21,12,9,357.6152402219068,0.4282306763285024,0.23413659510079077,0.1995807002104339,129452.33298947745,58.82543186364401,129511.1584213411,1085,1,248.41304347826087,37,9,16,36.48841270696406,0.6128941441441442,45.58662280701754,1017.6535087719292,27.504148885727815,0
1235,4,0,0,46,0.0,0.0,1.0,46,1300,1000,300,0.7692307692307693,16,10,6,352.6599929417545,0.42837157809983895,0.22869752522769304,0.19737480617626213,129563.94184989601,-61.59623634196356,129502.34561355405,1086,2,249.41304347826087,37,9,16,36.500964817806505,0.6140202702702703,45.47697368421052,1018.092105263157,27.51600284495019,0
1236,4,1,1,46,0.02127659574468085,0.02127659574468085,0.9787234042553191,47,1450,1100,350,0.7586206896551724,18,11,7,346.4904507222557,0.4306005242059821,0.23729735513902006,0.19590668611926607,129962.83512309169,-393.8237362115411,129569.01138688014,1087,0,245.08510638297872,38,9,17,36.25292504889634,0.6162280701754386,45.08547008547009,1019.6581196581209,26.83310841205581,0
1237,4,0,1,45,0.0,0.021739130434782608,0.9782608695652174,46,1000,600,400,0.6,14,6,8,353.0516989043149,0.4280998389694042,0.2370248837845219,0.19906106427583747,129853.9201183434,-30.97057856671455,129822.94953977669,1088,1,251.34782608695653,38,8,19,36.19627882599578,0.6151315789473684,45.1923076923077,1019.230769230771,26.821862348178183,0
1238,4,0,0,45,0.0,0.0,1.0,45,1400,800,600,0.5714285714285714,20,8,12,349.25396806667777,0.4279882154882155,0.22971421919562318,0.19760694280951024,129990.07100819997,79.90962177660464,130069.98062997658,1089,2,250.44444444444446,38,7,19,36.15483673825737,0.6165021929824561,45.05876068376068,1019.7649572649569,26.83591992802518,0
1239,4,1,1,45,0.021739130434782608,0.021739130434782608,0.9782608695652174,46,1400,900,500,0.6428571428571429,19,9,10,338.84703218579864,0.42908615136876005,0.22628740709204753,0.19359302468237602,130368.94531250013,-364.9739583333192,130003.97135416682,1090,0,245.97826086956522,39,7,20,36.03631170950632,0.6185897435897436,44.68750000000001,1021.250000000001,26.185897435897463,0
1240,4,0,0,45,0.0,0.0,1.0,45,1400,800,600,0.5714285714285714,20,8,12,336.5202059302083,0.42887205387205385,0.21968486990405656,0.19292382816887313,130501.95448133702,-216.69108072914327,130285.26340060787,1091,1,246.86666666666667,39,6,16,35.96112838549632,0.6199252136752137,44.55729166666668,1021.7708333333351,26.199252136752182,0
1241,4,0,0,45,0.0,0.0,1.0,45,1100,700,400,0.6363636363636364,15,7,8,333.58601265541904,0.42832491582491583,0.218780777721175,0.1920320653497327,130661.65500217036,-282.6199001735881,130379.03510199676,1092,2,247.86666666666667,39,6,17,35.87461793173713,0.6215277777777778,44.40104166666668,1022.3958333333351,26.21527777777782,0
1242,4,0,0,45,0.0,0.0,1.0,45,1150,1000,150,0.8695652173913043,13,10,3,338.3141726997039,0.4281355218855219,0.22711120164776677,0.19515678892865437,130741.54188368078,-153.65668402775418,130587.88519965303,1093,3,248.86666666666667,39,6,17,35.67299857404766,0.6223290598290598,44.32291666666668,1022.7083333333352,26.223290598290646,0
1243,4,0,1,44,0.0,0.022222222222222223,0.9777777777777777,45,1400,1100,300,0.7857142857142857,17,11,6,340.7053290767711,0.4273569023569024,0.2348909023041159,0.1972155832363657,130874.74093967032,-82.0556640624792,130792.68527560783,1094,4,249.86666666666667,39,6,17,35.47721758458041,0.6236645299145299,44.19270833333334,1023.2291666666681,26.236645299145337,0
1244,4,0,0,44,0.0,0.0,1.0,44,1000,600,400,0.6,14,6,8,345.57239542123267,0.42676400634249473,0.2375696507731586,0.19997261818423878,130863.1260158707,244.53678592303416,131107.66280179375,1095,5,254.95454545454547,38,6,18,35.36445825067002,0.6252741228070176,44.204059829059844,1023.183760683763,26.925888439046396,0
1245,4,1,1,44,0.022222222222222223,0.022222222222222223,0.9777777777777777,45,1050,700,350,0.6666666666666666,14,7,7,337.6575869624911,0.428956228956229,0.2365037398594445,0.1969468985877309,131168.01757812526,-142.0247395833032,131025.99283854196,1096,0,250.26666666666668,39,6,19,35.259050233882455,0.6266025641025641,43.906250000000014,1024.375000000002,26.266025641025692,0
1246,4,1,0,45,0.022222222222222223,0.0,1.0,45,1800,1400,400,0.7777777777777778,22,14,8,337.195581493298,0.4310185185185185,0.24012982892842372,0.1980969654889015,131443.578291129,-135.2682681625788,131308.3100229664,1097,0,249.48888888888888,36,9,20,34.99295336408231,0.634837962962963,43.63738738738739,1025.4504504504507,28.484734734734744,0
1247,4,0,0,45,0.0,0.0,1.0,45,1050,800,250,0.7619047619047619,13,8,5,334.5041275012922,0.4304503367003367,0.2356384924990853,0.19711077629603974,131559.08230866017,-198.58879149417925,131360.493517166,1098,1,250.48888888888888,36,9,15,34.94557263080865,0.6359953703703703,43.524774774774784,1025.9009009009021,28.49724724724728,0
1248,4,0,1,44,0.0,0.022222222222222223,0.9777777777777777,45,1350,1100,250,0.8148148148148148,16,11,5,335.3427412794434,0.4293350168350168,0.2358375465831135,0.19844998380898543,131721.78578985843,-165.6110534010466,131556.17473645738,1099,2,251.48888888888888,37,8,15,34.76020081179234,0.6356981981981982,43.36622807017544,1026.5350877192984,27.74419155998104,0
1249,4,0,0,44,0.0,0.0,1.0,44,1450,1100,350,0.7586206896551724,18,11,7,341.1411057733282,0.42659883720930236,0.23466230852169523,0.20143467564243392,131637.38031173046,181.3842961295711,131818.76460786004,1100,4,258.15909090909093,37,7,15,34.696437475513754,0.6348536036036037,43.4484649122807,1026.2061403508767,27.735301090564235,0
1250,4,0,0,44,0.0,0.0,1.0,44,850,700,150,0.8235294117647058,10,7,3,344.37489506308896,0.4261363636363636,0.23246482770673738,0.20394573956203055,131749.92696069946,274.2734543321027,132024.20041503158,1101,5,259.15909090909093,37,7,16,34.50004895154687,0.6359797297297297,43.338815789473685,1026.6447368421054,27.747155049786635,0
1251,4,0,1,43,0.0,0.022727272727272728,0.9772727272727273,44,1350,1100,250,0.8148148148148148,16,11,5,345.40217251406347,0.4257069238900634,0.22654991753177423,0.20561743052457296,131946.9993170977,314.9560441674515,132261.95536126517,1102,6,260.15909090909093,37,7,16,34.27516897901102,0.6379504504504505,43.14692982456141,1027.4122807017557,27.76789947842583,0
1252,4,1,0,44,0.022727272727272728,0.0,1.0,44,800,500,300,0.625,11,5,6,345.68095761631275,0.42513433756166313,0.23219515882163977,0.2065926816263455,132095.8034279349,332.60076521295355,132428.40419314787,1103,0,261.0,38,6,17,34.11821000485,0.637609649122807,43.00213675213676,1027.9914529914536,27.05240665766983,0
1253,4,1,0,45,0.022222222222222223,0.0,1.0,45,1100,700,400,0.6363636363636364,15,7,8,342.7807126894467,0.426557239057239,0.24766072275097506,0.20682234288410808,132455.9583865963,81.70540853105672,132537.66379512736,1104,0,256.1777777777778,36,9,18,33.83063486854101,0.6449652777777778,42.65202702702704,1029.3918918918937,28.59421921921927,0
1254,4,0,0,45,0.0,0.0,1.0,45,1200,900,300,0.75,15,9,6,344.90750308661075,0.4260942760942761,0.2514484300573536,0.20858691853333158,132542.914536158,143.00914089767844,132685.9236770557,1105,1,257.1777777777778,36,9,18,33.68852981918928,0.6458333333333333,42.56756756756758,1029.7297297297316,28.603603603603656,0
1255,4,0,1,44,0.0,0.022222222222222223,0.9777777777777777,45,1550,1100,450,0.7096774193548387,20,11,9,345.53833206053747,0.4263888888888889,0.24918813227918002,0.20977639018061467,132687.90486009684,169.75146599304855,132857.6563260899,1106,2,258.1777777777778,36,9,17,33.526660472911416,0.6472800925925926,42.426801801801815,1030.292792792795,28.619244244244303,0
1256,4,0,0,44,0.0,0.0,1.0,44,900,600,300,0.6666666666666666,12,6,6,351.21805274340915,0.4240992776603241,0.25119536565929024,0.21259443764019445,132576.73852237666,512.6687885802587,133089.4073109569,1107,3,264.6136363636364,35,9,18,33.49207687120701,0.6482142857142856,42.53472222222223,1029.861111111112,29.4246031746032,0
1257,4,0,1,43,0.0,0.022727272727272728,0.9772727272727273,44,1550,1200,350,0.7741935483870968,19,12,7,352.47491663094564,0.4242534355179704,0.2477946581720163,0.2143740886394767,132755.59413580244,558.6033950617202,133314.19753086416,1108,4,265.6136363636364,35,9,17,33.27998652291106,0.65,42.36111111111111,1030.5555555555552,29.444444444444436,0
1258,4,0,0,43,0.0,0.0,1.0,43,950,600,350,0.631578947368421,13,6,7,348.4874170488823,0.4229881875230712,0.24137180615868536,0.2128036149303694,132906.3029008926,663.2348414896878,133569.5377423823,1109,5,268.86046511627904,37,6,17,33.23142634339997,0.6475225225225225,42.21491228070175,1031.140350877193,27.868658131816026,0
1259,4,1,1,43,0.022727272727272728,0.022727272727272728,0.9772727272727273,44,1300,1000,300,0.7692307692307693,16,10,6,341.4954695009778,0.42422040169133196,0.24446436924996062,0.21035187061679278,133230.14458550373,299.4981553819687,133529.6427408857,1110,0,263.72727272727275,39,5,18,33.08707917129115,0.6471688034188035,41.90104166666668,1032.3958333333353,26.471688034188084,0
1260,4,0,0,43,0.0,0.0,1.0,43,1100,600,500,0.5454545454545454,16,6,10,337.88659922597685,0.4229881875230712,0.24600541003190113,0.20860289315518737,133314.74837233164,409.0533908388194,133723.80176317046,1111,1,268.72093023255815,40,3,19,33.09551925473988,0.6463541666666667,41.819105691056926,1032.723577235775,25.81808943089438,0
1261,4,0,1,42,0.0,0.023255813953488372,0.9767441860465116,43,1350,1200,150,0.8888888888888888,15,12,3,336.2382934443285,0.4228497600590624,0.24737434358589594,0.2084677419354838,133472.22222222234,375.6944444444544,133847.9166666668,1112,2,269.72093023255815,40,3,19,32.98051075268816,0.6479166666666667,41.66666666666667,1033.3333333333344,25.83333333333336,0
1262,4,0,0,42,0.0,0.0,1.0,42,950,600,350,0.631578947368421,13,6,7,340.64616321422403,0.42111885404568333,0.26140662214542587,0.21136645299641196,133501.3153990138,695.3421749452066,134196.657573959,1113,3,275.85714285714283,36,6,19,32.83752860411899,0.6553819444444444,41.63851351351351,1033.4459459459454,28.706831831831817,0
1263,4,0,0,42,0.0,0.0,1.0,42,950,400,550,0.42105263157894735,15,4,11,342.57645390103943,0.4209010840108401,0.25807179423343296,0.21323352022138564,133617.71981018168,754.8569261829252,134372.5767363646,1114,4,276.85714285714283,36,6,19,32.6711868714374,0.6565393518518519,41.52590090090089,1033.8963963963952,28.71934434434431,0
1264,4,0,0,42,0.0,0.0,1.0,42,1100,700,400,0.6363636363636364,15,7,8,340.23911755452514,0.4203082655826558,0.2550102122277176,0.21261473019427662,133763.29665814454,702.3012032302468,134465.5978613748,1115,5,277.85714285714283,36,6,17,32.5860457943247,0.6579861111111112,41.38513513513513,1034.4594594594587,28.734984984984962,0
1265,4,0,0,42,0.0,0.0,1.0,42,1000,600,400,0.6,14,6,8,341.39670907861415,0.41964285714285715,0.25792893974712205,0.21395100533094,133869.08111149567,740.4927477685237,134609.5738592642,1116,6,278.85714285714283,37,5,18,32.45037790492337,0.6570945945945945,41.282894736842096,1034.86842105263,27.969416785206217,0
1266,4,0,0,42,0.0,0.0,1.0,42,950,600,350,0.631578947368421,13,6,7,343.4579474130687,0.41976384049554777,0.26079487839208215,0.2154086090120898,133897.4507180092,797.6287174899787,134695.07943549918,1117,7,279.85714285714283,37,5,18,32.36869636614048,0.6573761261261262,41.25548245614034,1034.978070175437,27.972380275011812,0
1267,4,0,0,42,0.0,0.0,1.0,42,1100,600,500,0.5454545454545454,16,6,10,345.7768745268392,0.4187838753387534,0.27033630353549887,0.217533046379543,134010.95920138882,867.5781249999891,134878.53732638882,1118,8,280.85714285714283,37,5,18,32.19525486250837,0.6585022522522522,41.14583333333333,1035.416666666666,27.98423423423422,0
1268,4,0,1,41,0.0,0.023809523809523808,0.9761904761904762,42,1150,900,250,0.782608695652174,14,9,5,343.57754272507714,0.4184693186217576,0.26799162871586324,0.21639357515491678,134052.44545118333,811.4819608809898,134863.9274120643,1119,9,281.85714285714283,38,4,18,32.21074486743011,0.6570723684210527,41.105769230769226,1035.5769230769222,27.252024291497953,0
1269,4,0,0,41,0.0,0.0,1.0,41,1000,500,500,0.5,15,5,10,348.1795509304798,0.4184197154471545,0.26810392342908074,0.21896223413804536,133997.13187824163,1131.0122406676899,135128.14411890932,1120,10,287.3658536585366,38,3,19,32.146880266914316,0.6565241228070176,41.159188034188034,1035.3632478632478,27.246401259559153,0
1270,4,0,0,41,0.0,0.0,1.0,41,1150,700,450,0.6086956521739131,16,7,9,344.63497346945655,0.4178353658536585,0.26350115826619747,0.2177150057155256,134163.1068398896,1047.4597532690364,135210.56659315864,1121,11,288.3658536585366,38,3,19,32.07284899109691,0.6581688596491229,40.99893162393162,1036.0042735042728,27.2632703553756,0
1271,4,0,0,41,0.0,0.0,1.0,41,1600,1300,300,0.8125,19,13,6,342.6453644094494,0.41740345528455286,0.257951782692758,0.21711317309837144,134273.81388569277,1001.6599779019502,135275.47386359473,1122,12,289.3658536585366,38,3,19,32.01388173040579,0.659265350877193,40.89209401709401,1036.4316239316229,27.274516419253235,0
1272,4,0,0,41,0.0,0.0,1.0,41,1550,1200,350,0.7741935483870968,19,12,7,342.04641546279527,0.4174288617886179,0.25725145934205207,0.21689766815817224,134301.4977810649,987.4691814595458,135288.96696252446,1123,13,290.3658536585366,38,3,19,32.001777983920846,0.6595394736842105,40.865384615384606,1036.53846153846,27.277327935222633,0
1273,4,0,0,41,0.0,0.0,1.0,41,1050,600,450,0.5714285714285714,15,6,9,339.8098057756822,0.4168445121951219,0.2515922396237933,0.21583452437047612,134361.7201063366,931.4860026041476,135293.20610894077,1124,14,291.3658536585366,39,2,19,31.999669278944374,0.6583867521367521,40.80729166666666,1036.7708333333317,26.583867521367477,0
1274,4,0,0,41,0.0,0.0,1.0,41,950,600,350,0.631578947368421,13,6,7,341.2992256325588,0.41638719512195127,0.257562543484013,0.21726183442440852,134442.73003472202,977.0399305555363,135419.76996527755,1125,15,292.3658536585366,39,2,19,31.880273202089196,0.6591880341880342,40.72916666666666,1037.0833333333317,26.591880341880298,0
1275,4,0,1,40,0.0,0.024390243902439025,0.975609756097561,41,750,400,350,0.5333333333333333,11,4,7,338.2203512846569,0.4165142276422764,0.25389362327358245,0.21594068582020393,134550.78124999997,901.6493055555552,135452.43055555553,1126,16,293.3658536585366,37,4,19,31.85240963855424,0.6638513513513513,40.625,1037.4999999999998,28.040540540540533,0
1276,4,0,0,40,0.0,0.0,1.0,40,1150,700,450,0.6086956521739131,16,7,9,335.6004589938866,0.41510416666666666,0.24573299535276738,0.2152754163790055,134721.4768005541,1042.5178901200488,135763.99469067415,1127,17,297.0,37,3,19,31.750369666244204,0.6655405405405406,40.46052631578948,1038.1578947368428,28.05832147937413,0
1277,4,0,0,40,0.0,0.0,1.0,40,1400,1100,300,0.7857142857142857,17,11,6,336.2586813481555,0.4152510683760684,0.2467694256756756,0.21637515147620473,134835.33394890753,1067.910318559577,135903.24426746712,1128,18,298.0,37,3,16,31.619950028153152,0.6666666666666667,40.350877192982466,1038.5964912280715,28.07017543859653,0
1278,4,0,0,40,0.0,0.0,1.0,40,1400,1000,400,0.7142857142857143,18,10,8,340.7429853914325,0.41467681623931624,0.25011870845204176,0.22012414945839165,134977.72301333104,1198.5424601800569,136176.2654735111,1129,19,299.0,37,3,18,31.361783792339338,0.6680743243243243,40.213815789473685,1039.1447368421054,28.08499288762447,0
1279,4,0,0,40,0.0,0.0,1.0,40,900,500,400,0.5555555555555556,13,5,8,338.48273988024175,0.4141426282051282,0.1633333333333331,0.2034699616134038,132315.551035503,1013.720642565718,133329.27167806873,1130,20,300.0,38,2,17,34.08229491173416,0.6398026315789473,42.78846153846154,1028.8461538461543,27.074898785425113,8
1280,4,0,1,39,0.0,0.025,0.975,40,1050,700,350,0.6666666666666666,14,7,7,340.36461737058676,0.4143563034188034,0.15613880899115795,0.20520248318931902,132426.21678064397,1014.6654029926754,133440.88218363666,1131,21,301.0,37,3,18,33.9226900678243,0.6427364864864865,42.680921052631575,1029.276315789473,27.818278805120894,0
1281,4,0,1,38,0.0,0.02564102564102564,0.9743589743589743,39,1350,1000,350,0.7407407407407407,17,10,7,342.78071268944694,0.41303981106612686,0.16437072754762272,0.20682234288410792,132455.95838659615,1280.6695631442353,133736.6279497404,1132,22,307.79487179487177,36,3,18,33.83063486854101,0.6449652777777778,42.65202702702703,1029.3918918918926,28.594219219219237,0
1282,4,0,1,37,0.0,0.02631578947368421,0.9736842105263158,38,1050,700,350,0.6666666666666666,14,7,7,347.85466175870596,0.4120288051209104,0.1535317953676838,0.21036924782550329,132542.9145361579,1621.134140897664,134164.04867705557,1133,23,304.86842105263156,36,2,18,33.61266039661708,0.6458333333333333,42.56756756756757,1029.7297297297307,28.60360360360363,0
1283,4,0,0,37,0.0,0.0,1.0,37,950,500,450,0.5263157894736842,14,5,9,353.905935762538,0.41019144144144143,0.16720372468209277,0.21439134937718346,132606.53941883144,1986.048284250688,134592.58770308213,1134,24,311.02702702702703,35,2,19,33.39291399782748,0.6485119047619048,42.50578703703704,1029.976851851852,29.427910052910057,0
1284,4,0,0,37,0.0,0.0,1.0,37,1000,600,400,0.6,14,6,8,354.7104013492029,0.41066066066066065,0.17423354606010188,0.21539099541682147,132695.96220207465,2013.7276020233035,134709.68980409796,1135,25,312.02702702702703,35,2,18,33.282314835617456,0.6494047619047619,42.418981481481474,1030.3240740740732,29.437830687830665,0
1285,4,0,1,36,0.0,0.02702702702702703,0.972972972972973,37,1250,800,450,0.64,17,8,9,357.71343741622894,0.40953453453453453,0.17283096501688622,0.2180803276568346,132845.06715374233,2104.0931230709903,134949.16027681332,1136,26,313.02702702702703,35,2,19,33.055111148534856,0.6508928571428572,42.27430555555556,1030.902777777778,29.454365079365086,0
1286,4,0,0,36,0.0,0.0,1.0,36,850,500,350,0.5882352941176471,12,5,7,357.3452133803079,0.40701058201058204,0.16642658485177297,0.21820346168644014,132904.73257726766,2298.5740044152903,135203.30658168293,1137,27,312.5,35,1,19,33.00466288771653,0.6514880952380953,42.21643518518518,1031.1342592592591,29.460978835978832,0
1287,4,0,0,36,0.0,0.0,1.0,36,850,600,250,0.7058823529411765,11,6,5,357.15042335077754,0.40697751322751324,0.1738939376940054,0.21878224902580612,133024.1036120756,2301.9229841820957,135326.0265962577,1138,28,313.5,35,1,19,32.88980982834062,0.6526785714285714,42.10069444444444,1031.597222222222,29.47420634920634,0
1288,4,0,0,36,0.0,0.0,1.0,36,1700,1300,400,0.7647058823529411,21,13,8,355.0123698484477,0.40641534391534395,0.1684072537956629,0.21887113693282648,133263.00643272026,2262.0031453617808,135525.00957808204,1139,29,314.5,35,1,19,32.7052507192766,0.6550595238095238,41.869212962962955,1032.5231481481474,29.500661375661352,0
1289,4,0,0,36,0.0,0.0,1.0,36,1100,700,400,0.6363636363636364,15,7,8,353.6739862877678,0.4058531746031746,0.16256238875819906,0.21910115722351875,133442.32420535415,2239.015748242461,135681.33995359662,1140,30,315.5,35,1,19,32.56004723498002,0.6568452380952381,41.695601851851855,1033.217592592593,29.52050264550266,0
1290,4,0,0,36,0.0,0.0,1.0,36,750,500,250,0.6666666666666666,10,5,5,355.86357707669134,0.40591931216931215,0.1638263585570121,0.22081347322569655,133502.12358806998,2301.708649477008,135803.832237547,1141,31,316.5,35,1,19,32.44355937581663,0.6574404761904762,41.637731481481474,1033.4490740740728,29.527116402116366,0
1291,4,0,0,36,0.0,0.0,1.0,36,1050,500,550,0.47619047619047616,16,5,11,353.8763998637062,0.40520833333333334,0.15777230432402867,0.22011309217149183,133591.84777949244,2255.000428669406,135846.84820816186,1142,32,317.5,35,1,19,32.40502313778176,0.6583333333333333,41.550925925925924,1033.796296296296,29.53703703703703,0
1292,4,0,0,36,0.0,0.0,1.0,36,850,500,350,0.5882352941176471,12,5,7,353.0479391968234,0.4046792328042328,0.16239459741810336,0.2199532976837112,133651.68065200606,2237.0900848765323,135888.7707368826,1143,33,318.5,35,1,19,32.36652115513768,0.6589285714285714,41.49305555555555,1034.027777777777,29.54365079365077,0
1293,4,0,0,36,0.0,0.0,1.0,36,1000,700,300,0.7,13,7,6,352.60191194570416,0.40343915343915343,0.16409677940609813,0.22056742413454505,133801.32144043632,2235.7203521519136,136037.04179258825,1144,34,319.5,35,1,15,32.22827404258493,0.6604166666666667,41.348379629629626,1034.606481481481,29.560185185185173,0
1294,4,0,0,36,0.0,0.0,1.0,36,1300,1000,300,0.7692307692307693,16,10,6,353.58510355335,0.40375330687830685,0.15648375953676785,0.22172215960547373,133891.14610125174,2268.3829518175635,136159.5290530693,1145,35,320.5,35,1,15,32.11296876164914,0.6613095238095238,41.261574074074076,1034.953703703704,29.570105820105827,0
1295,4,0,0,36,0.0,0.0,1.0,36,1300,1000,300,0.7692307692307693,16,10,6,356.38377548996215,0.4029265873015873,0.1659400849541699,0.22420599546646974,134010.9592013888,2351.866319444435,136362.82552083323,1146,36,321.5,35,1,15,31.92069081153588,0.6625,41.14583333333333,1035.4166666666658,29.58333333333331,0
1296,4,0,0,36,0.0,0.0,1.0,36,900,600,300,0.6666666666666666,12,6,6,356.4408102119158,0.4028935185185185,0.16689633767846046,0.22497498246802874,134130.82588520242,2361.9400505829963,136492.7659357854,1147,37,322.5,35,1,15,31.799348230912464,0.6636904761904762,41.030092592592595,1035.8796296296302,29.596560846560863,0
1297,4,0,0,36,0.0,0.0,1.0,36,1050,800,250,0.7619047619047619,13,8,5,355.82059525794193,0.4021494708994709,0.1644296759621231,0.22513510878758689,134220.76106234998,2351.7022194358738,136572.46328178587,1148,38,323.5,35,1,15,31.725515655832314,0.6645833333333333,40.94328703703704,1036.226851851852,29.606481481481485,0
1298,4,0,0,36,0.0,0.0,1.0,36,700,400,300,0.5714285714285714,10,4,6,352.7118120791197,0.40165343915343915,0.15444469254338622,0.22390075838360568,134340.7215175969,2276.7118644976026,136617.4333820945,1149,39,324.5,35,1,15,31.68622771761378,0.6657738095238095,40.8275462962963,1036.689814814815,29.619708994709,0
1299,4,0,1,35,0.0,0.027777777777777776,0.9722222222222222,36,1100,800,300,0.7272727272727273,14,8,6,353.14420613285455,0.4017030423280423,0.15815542165687213,0.2250980352320514,134490.74743870032,2298.9256472908164,136789.67308599112,1150,40,325.5,35,1,16,31.525236182399766,0.6672619047619048,40.682870370370374,1037.268518518519,29.636243386243397,0
1300,4,0,0,35,0.0,0.0,1.0,35,1300,1100,200,0.8461538461538461,15,11,4,352.73624618957734,0.4011554621848739,0.1452667814113593,0.22520852641334568,134550.78125000015,2492.1875000000155,137042.96875000017,1151,41,318.0,34,1,16,31.47590361445782,0.6700367647058824,40.62500000000001,1037.5000000000011,30.514705882352974,0
1301,4,0,0,35,0.0,0.0,1.0,35,1000,700,300,0.7,13,7,6,352.834134785536,0.40014005602240893,0.14165451477069757,0.22603679803049914,134674.32149943334,2503.539540816354,137177.8610402497,1152,42,319.0,34,1,17,31.350116603586038,0.6712622549019608,40.505952380952394,1037.9761904761924,30.528711484593895,0
1302,4,0,0,35,0.0,0.0,1.0,35,1000,700,300,0.7,13,7,6,354.0682334637639,0.39859943977591034,0.1446946496126822,0.22760038323540277,134797.9184382088,2545.532171201838,137343.45060941065,1153,43,320.0,34,1,13,31.194829760403525,0.6724877450980392,40.38690476190477,1038.4523809523826,30.54271708683478,0
1303,4,0,0,35,0.0,0.0,1.0,35,1000,700,300,0.7,13,7,6,358.52525612391935,0.39751400560224087,0.1476457784396834,0.2316481836199626,134983.42013888905,2678.9930555555743,137662.4131944446,1154,44,321.0,34,1,13,30.89414595028066,0.6743259803921569,40.20833333333334,1039.166666666668,30.56372549019612,0
1304,4,0,0,35,0.0,0.0,1.0,35,900,400,500,0.4444444444444444,14,4,10,358.0883303280996,0.39733893557422967,0.14655739313932337,0.23215927162251634,135107.1588010206,2676.059382086183,137783.21818310677,1155,45,322.0,34,1,14,30.782186342990187,0.6755514705882353,40.08928571428572,1039.6428571428585,30.577731092437013,0
1305,4,0,0,35,0.0,0.0,1.0,35,550,500,50,0.9090909090909091,6,5,1,358.0883303280996,0.39733893557422967,0.14655739313932337,0.23215927162251634,135107.1588010206,2676.059382086183,137783.21818310677,1156,46,323.0,34,1,14,30.782186342990187,0.6755514705882353,40.08928571428572,1039.6428571428585,30.577731092437013,0
1306,4,0,0,35,0.0,0.0,1.0,35,850,600,250,0.7058823529411765,11,6,5,357.8134926862929,0.3967436974789916,0.14967699730149664,0.2323792459936631,135169.04939058956,2673.061933106576,137842.11132369612,1157,47,324.0,34,1,14,30.727676016027477,0.6761642156862745,40.029761904761905,1039.8809523809523,30.58473389355742,0
1307,4,0,0,35,0.0,0.0,1.0,35,550,400,150,0.7272727272727273,7,4,3,328.8276929853949,0.3967436974789916,0.08745922843324672,0.19794224904083585,132368.2260186257,1705.2676772548023,134073.4936958805,1158,48,325.0,35,0,19,34.277757470100845,0.6461309523809524,42.73726851851852,1029.050925925926,29.401455026455032,8
1308,4,0,0,35,0.0,0.0,1.0,35,800,500,300,0.625,11,5,6,330.7373269133238,0.3963585434173669,0.09183466932258133,0.19940657954170796,132427.7842747987,1759.7622760202557,134187.54655081895,1159,49,326.0,35,0,19,34.16884534652724,0.6467261904761905,42.67939814814816,1029.2824074074088,29.40806878306882,0
1309,4,0,0,35,0.0,0.0,1.0,35,900,500,400,0.5555555555555556,13,5,8,332.55747652991477,0.3969187675070028,0.09062710721510459,0.20129907660974034,132576.73852237655,1817.8771219135785,134394.6156442901,1160,50,327.0,35,0,21,33.972521915037085,0.6482142857142856,42.53472222222222,1029.861111111111,29.424603174603174,0
1310,4,1,0,36,0.027777777777777776,0.0,1.0,36,550,200,350,0.36363636363636365,9,2,7,324.8484099389618,0.39981812169312164,0.08653671144115616,0.19844142026758335,132920.05423920543,1435.7736537212913,134355.82789292673,1161,0,318.8888888888889,36,0,16,33.827035783189544,0.6495949074074074,42.20157657657658,1031.1936936936938,28.644269269269273,0
1311,4,0,0,36,0.0,0.0,1.0,36,900,800,100,0.8888888888888888,10,8,2,325.89171640510284,0.3988756613756614,0.0929039301310044,0.19954332368119937,133007.1625679734,1469.186500689882,134476.3490686633,1162,1,319.8888888888889,36,0,17,33.71292758369723,0.650462962962963,42.11711711711712,1031.5315315315318,28.65365365365366,0
1312,4,0,0,36,0.0,0.0,1.0,36,1150,800,350,0.6956521739130435,15,8,7,326.1757572997863,0.3989087301587302,0.0899473786313596,0.20034012331737563,133123.35139193258,1484.32199090984,134607.67338284242,1163,2,320.8888888888889,36,0,18,33.58931689218682,0.6516203703703703,42.00450450450451,1031.9819819819827,28.666166166166185,0
1313,4,0,0,36,0.0,0.0,1.0,36,950,800,150,0.8421052631578947,11,8,3,351.04378116248864,0.39902447089947085,0.13828282828282812,0.20150046262173243,130550.14209733409,1965.7631026296888,132515.90519996377,1164,3,321.8888888888889,36,0,15,35.54132231404961,0.6258680555555556,44.51013513513515,1021.9594594594616,28.387762762762822,7
1314,4,0,1,35,0.0,0.027777777777777776,0.9722222222222222,36,1050,1000,50,0.9523809523809523,11,10,1,350.54338333753805,0.3994708994708995,0.14171561429270674,0.2019628122274649,130694.0386332279,1962.7860969077267,132656.82473013562,1165,4,322.8888888888889,36,0,15,35.4084067547724,0.6273148148148149,44.36936936936937,1022.5225225225231,28.40340340340342,0
1315,4,0,0,35,0.0,0.0,1.0,35,1000,800,200,0.8,12,8,4,358.5192104373324,0.39544817927170867,0.15602056987612833,0.20646406160387212,130676.4470271778,2370.0033221879485,133046.45034936574,1166,56,333.0,35,0,16,35.22234171005963,0.6291666666666667,44.38657407407408,1022.453703703705,29.212962962962997,0
1316,4,0,0,35,0.0,0.0,1.0,35,1000,800,200,0.8,12,8,4,358.1783715846539,0.3952380952380952,0.15571719522839644,0.20690068288007663,130794.81336805563,2369.5746527777824,133164.38802083343,1167,57,334.0,35,0,16,35.111167684996595,0.6303571428571428,44.270833333333336,1022.9166666666673,29.226190476190496,0
1317,4,0,0,35,0.0,0.0,1.0,35,850,600,250,0.7058823529411765,11,6,5,358.5440258924936,0.3944327731092437,0.15165729792595473,0.20806846226989606,130972.46334876557,2391.8788580247056,133364.3422067903,1168,58,335.0,35,0,17,34.92198100407055,0.6321428571428571,44.09722222222223,1023.6111111111122,29.24603174603178,0
1318,4,0,0,35,0.0,0.0,1.0,35,1100,800,300,0.7272727272727273,14,8,6,357.57540936512527,0.39310224089635853,0.1494624697336564,0.20846787700140673,131150.2338927467,2379.21971450615,133529.45360725286,1169,59,336.0,35,0,17,34.76694915254238,0.6339285714285714,43.9236111111111,1024.3055555555538,29.265873015872966,0
1319,4,0,0,35,0.0,0.0,1.0,35,800,600,200,0.75,10,6,4,358.6504858217109,0.3921218487394958,0.14615856794465576,0.2102341275296634,131358.63272392302,2422.4880519337494,133781.12077585678,1170,60,337.0,34,1,17,34.52875198389657,0.6381740196078431,43.7202380952381,1025.1190476190484,30.15056022408966,0
1320,4,0,0,35,0.0,0.0,1.0,35,1050,800,250,0.7619047619047619,13,8,5,357.143993053678,0.3918767507002801,0.14653885701018265,0.209852548169467,131450.1771541952,2389.328231292543,133839.50538548775,1171,61,338.0,34,1,17,34.47488584474887,0.639093137254902,43.630952380952394,1025.4761904761922,30.16106442577036,0
1321,4,0,0,35,0.0,0.0,1.0,35,850,600,250,0.7058823529411765,11,6,5,357.192390654945,0.39173669467787114,0.14361984348056756,0.2102165053198778,131511.22448979615,2394.961734693902,133906.18622449005,1172,62,339.0,34,1,17,34.411995125348184,0.6397058823529411,43.571428571428584,1025.7142857142874,30.168067226890805,0
1322,4,0,0,35,0.0,0.0,1.0,35,1350,1100,250,0.8148148148148148,16,11,5,356.1159190928933,0.39173669467787114,0.1397421877588889,0.21059200647592108,131694.45153061242,2379.6981292517207,134074.14965986414,1173,63,340.0,34,1,15,34.25466829041986,0.6415441176470589,43.39285714285715,1026.428571428573,30.189075630252145,0
1323,4,0,0,35,0.0,0.0,1.0,35,1250,1000,250,0.8,15,10,5,359.8941398865782,0.3918067226890756,0.14337060041407867,0.2133393097265801,131786.11288265322,2485.8099489796105,134271.92283163284,1174,64,341.0,34,1,15,34.065217391304344,0.6424632352941176,43.30357142857144,1026.7857142857156,30.199579831932812,0
1324,4,0,0,35,0.0,0.0,1.0,35,1400,1200,200,0.8571428571428571,16,12,4,358.20734080627625,0.39149159663865546,0.13846994354585007,0.2130235109453729,131908.37762188227,2450.1098356009234,134358.4874574832,1175,65,342.0,34,1,17,33.98520492911499,0.6436887254901961,43.18452380952382,1027.2619047619062,30.213585434173712,0
1325,4,0,0,35,0.0,0.0,1.0,35,1000,800,200,0.8,12,8,4,357.2003288816901,0.39184173669467787,0.136635891326649,0.2132826860003122,132061.2882653062,2434.467120181419,134495.75538548763,1176,66,343.0,34,1,18,33.85694154891515,0.6452205882352942,43.03571428571429,1027.8571428571436,30.231092436974812,0
1326,4,0,0,35,0.0,0.0,1.0,35,550,300,250,0.5454545454545454,8,3,5,358.02166550601856,0.3916316526610644,0.140160476466209,0.2139458187989254,132091.88102324272,2458.3510487528474,134550.23207199556,1177,67,344.0,34,1,18,33.80500868558194,0.6455269607843137,43.00595238095239,1027.9761904761913,30.234593837535037,0
1327,4,0,0,35,0.0,0.0,1.0,35,1250,1100,150,0.88,14,11,3,356.72662680041196,0.39201680672268907,0.14017857142857215,0.2140359760802468,132244.89795918346,2435.0552721088243,134679.95323129228,1178,68,345.0,34,1,18,33.684172453703724,0.6470588235294117,42.85714285714285,1028.5714285714268,30.252100840336084,0
1328,4,1,0,36,0.027777777777777776,0.0,1.0,36,1400,1000,400,0.7142857142857143,18,10,8,347.28951038267394,0.39854497354497354,0.13915112010189623,0.21021646689694076,132576.7385223764,2008.5021219135663,134585.24064428997,1179,0,336.3888888888889,35,1,20,33.593223196223875,0.6482142857142856,42.534722222222214,1029.86111111111,29.424603174603142,0
1329,4,0,0,36,0.0,0.0,1.0,36,900,500,400,0.5555555555555556,13,5,8,348.7809790404252,0.39833002645502646,0.13692281766093672,0.2116223240926259,132666.15125868036,2054.286024305524,134720.4372829859,1180,1,337.3888888888889,35,1,13,33.46498988877653,0.6491071428571429,42.44791666666665,1030.2083333333317,29.43452380952376,0
1330,4,0,1,35,0.0,0.027777777777777776,0.9722222222222222,36,1050,900,150,0.8571428571428571,12,9,3,350.8174875496462,0.39864417989417994,0.13386561333882496,0.21319645676822485,132725.7764944484,2112.5046885716347,134838.28118302004,1181,2,338.3888888888889,35,1,13,33.352638623684896,0.649702380952381,42.390046296296276,1030.4398148148123,29.441137566137495,0
1331,4,0,0,35,0.0,0.0,1.0,35,1200,700,500,0.5833333333333334,17,7,10,358.01625454278906,0.39156162464985994,0.13661581137309375,0.21691573069357176,132612.49999999974,2495.486111111083,135107.98611111083,1182,72,349.0,34,1,19,33.28108144552319,0.6507352941176471,42.499999999999986,1029.999999999998,30.294117647058762,0
1332,4,0,0,35,0.0,0.0,1.0,35,900,700,200,0.7777777777777778,11,7,4,356.35102819649654,0.3914565826330532,0.13070751758064003,0.21625959312850457,132673.81660997702,2455.6901927437207,135129.50680272075,1183,73,350.0,34,1,14,33.26231607734379,0.6513480392156863,42.44047619047617,1030.2380952380927,30.301120448179198,0
1333,4,0,0,35,0.0,0.0,1.0,35,1000,800,200,0.8,12,8,4,355.9088776155006,0.3919467787114846,0.13132229904783954,0.21652165520150266,132765.81809807225,2450.506660997701,135216.32475906995,1184,74,351.0,34,1,15,33.18124061453159,0.6522671568627452,42.35119047619046,1030.5952380952358,30.311624649859876,0
1334,4,0,0,35,0.0,0.0,1.0,35,1150,1000,150,0.8695652173913043,13,10,3,354.5458282129541,0.3919467787114846,0.125342217237854,0.2165779946389707,132919.2247732424,2425.191326530591,135344.416099773,1185,75,352.0,34,1,15,33.06227391672439,0.6537990196078431,42.20238095238094,1031.1904761904746,30.329131652661015,0
1335,4,0,0,35,0.0,0.0,1.0,35,1250,1000,250,0.8,15,10,5,354.39410587194453,0.3912464985994398,0.11954765751211727,0.21719797181656764,133042.01388888867,2429.8611111110877,135471.87499999977,1186,76,353.0,34,1,15,32.94291868605277,0.6550245098039216,42.08333333333332,1031.666666666665,30.343137254901908,0
1336,4,0,0,35,0.0,0.0,1.0,35,1000,800,200,0.8,12,8,4,351.3272332427005,0.3910014005602241,0.11209070085526496,0.21585087065775801,133134.14292800426,2354.730017006777,135488.87294501104,1187,77,354.0,34,1,16,32.92959587803285,0.6559436274509804,41.994047619047606,1032.0238095238074,30.35364145658257,0
1337,4,0,0,35,0.0,0.0,1.0,35,850,700,150,0.8235294117647058,10,7,3,350.7010181891998,0.3911064425770308,0.11650581376198232,0.21635708618585453,133287.76218820843,2348.83078231291,135636.59297052133,1188,78,355.0,34,1,16,32.79172431019908,0.6574754901960784,41.84523809523809,1032.6190476190461,30.371148459383708,0
1338,4,0,0,35,0.0,0.0,1.0,35,950,700,250,0.7368421052631579,12,7,5,327.6212595623565,0.3906512605042017,0.010390813726463888,0.19562115871793817,132061.2882653061,1653.2171201814047,133714.5053854875,1189,79,356.0,34,1,22,34.61701799088873,0.6452205882352942,43.035714285714285,1027.8571428571427,30.231092436974784,8
1339,4,0,0,35,0.0,0.0,1.0,35,550,100,450,0.18181818181818182,10,1,9,324.96342158559906,0.39054621848739496,0.005325306783978467,0.1946625544838004,132183.68055555545,1590.9722222222183,133774.65277777766,1190,80,357.0,34,1,24,34.562398703403574,0.6464460784313726,42.916666666666664,1028.3333333333326,30.245098039215662,0
1340,4,0,0,35,0.0,0.0,1.0,35,600,600,0,1.0,6,6,0,325.54762517146764,0.3907563025210084,0.0022156084656081987,0.19532857510288054,132244.89795918367,1610.4024943310599,133855.30045351473,1191,81,358.0,34,1,24,34.48591820987652,0.6470588235294117,42.857142857142854,1028.5714285714284,30.25210084033613,0
1341,4,0,0,35,0.0,0.0,1.0,35,1050,800,250,0.7619047619047619,13,8,5,324.9591909584765,0.391281512605042,-0.0014543531433857115,0.19560913973851488,132367.3752834469,1602.7990362812002,133970.1743197281,1192,82,359.0,34,1,24,34.37813319450872,0.6482843137254901,42.73809523809525,1029.0476190476204,30.26610644257707,0
1342,4,0,0,35,0.0,0.0,1.0,35,750,500,250,0.6666666666666666,10,5,5,323.4604335144142,0.391421568627451,-0.006410891907075333,0.19502363376329332,132428.6352040817,1567.0847505668985,133995.71995464858,1193,83,360.0,34,1,24,34.35524134474516,0.6488970588235294,42.67857142857143,1029.2857142857147,30.27310924369749,0
1343,4,0,0,35,0.0,0.0,1.0,35,700,300,400,0.42857142857142855,11,3,8,323.27150621518933,0.39096638655462185,-0.0052854995622944045,0.1953861116181116,132520.55165816343,1568.023667800472,134088.5753259639,1194,84,361.0,34,1,24,34.26793078197864,0.6498161764705883,42.58928571428572,1029.6428571428585,30.28361344537819,0
1344,4,0,0,35,0.0,0.0,1.0,35,1100,800,300,0.7272727272727273,14,8,6,323.9780689351807,0.3904761904761905,-0.0016181229773462036,0.19629259470778626,132612.50000000015,1592.7083333333494,134205.2083333335,1195,85,362.0,34,1,24,34.15756472491909,0.6507352941176471,42.50000000000001,1030.0000000000011,30.294117647058858,0
1345,4,0,1,34,0.0,0.02857142857142857,0.9714285714285714,35,700,400,300,0.5714285714285714,10,4,6,323.63712963927816,0.3902310924369748,-0.005645613919244452,0.1964064319704288,132673.81660997742,1587.6346371882228,134261.45124716565,1196,86,363.0,34,1,19,34.10489369077884,0.6513480392156863,42.4404761904762,1030.238095238096,30.301120448179297,0
1346,4,0,0,34,0.0,0.0,1.0,34,950,800,150,0.8421052631578947,11,8,3,328.38913128180343,0.390170083184789,-0.0016271826993734528,0.1989986047890092,132618.81134960108,1910.115250144174,134528.92659974526,1197,87,371.0882352941176,33,1,25,34.03765119968272,0.6530934343434344,42.493872549019606,1030.0245098039213,31.212863933452162,0
1347,4,0,0,34,0.0,0.0,1.0,34,1000,800,200,0.8,12,8,4,328.38913128180343,0.390170083184789,-0.0016271826993734528,0.1989986047890092,132618.81134960108,1910.115250144174,134528.92659974526,1198,88,372.0882352941176,33,1,25,34.03765119968272,0.6530934343434344,42.493872549019606,1030.0245098039213,31.212863933452162,0
1348,4,0,0,34,0.0,0.0,1.0,34,1200,1000,200,0.8333333333333334,14,10,4,329.33599378577236,0.390170083184789,-0.004662371548690425,0.20024485695911495,132745.06987997398,1943.5459018166023,134688.61578179058,1199,89,373.0882352941176,33,1,20,33.88668391009634,0.6543560606060606,42.37132352941176,1030.5147058823525,31.227718360071286,0
1349,4,0,0,34,0.0,0.0,1.0,34,750,300,450,0.4,12,3,9,330.0761336633622,0.38957590612002374,-0.007605586521851615,0.2010333352818639,132808.2216725539,1967.3648656766684,134775.58653823056,1200,90,374.0882352941176,33,1,20,33.80431874925691,0.6549873737373737,42.310049019607845,1030.759803921569,31.23514557338088,0
1350,4,0,0,34,0.0,0.0,1.0,34,1000,800,200,0.8,12,8,4,330.6209347285802,0.3887032085561497,-0.00845229938897396,0.20187551123412717,132902.9775206651,1988.1013312187492,134891.07885188385,1201,91,375.0882352941176,33,1,21,33.695329213216056,0.6559343434343434,42.218137254901954,1031.1274509803918,31.246286393345205,0
1351,4,0,0,34,0.0,0.0,1.0,34,800,500,300,0.625,11,5,6,331.43556779920414,0.3886660724896019,-0.004456327985739472,0.20254395809951362,132934.57031249988,2011.8489583333196,134946.4192708332,1202,92,376.0882352941176,33,1,21,33.64267676767677,0.65625,42.18749999999999,1031.249999999999,31.24999999999997,0
1352,4,0,0,34,0.0,0.0,1.0,34,450,200,250,0.4444444444444444,7,2,5,332.56634113547966,0.3884618241235888,-0.0004613061954823472,0.2034068551596072,132966.16685890037,2044.0143214148252,135010.18118031518,1203,93,377.0882352941176,33,1,21,33.58186787072241,0.6565656565656566,42.15686274509803,1031.3725490196073,31.253713606654767,0
1353,4,0,0,34,0.0,0.0,1.0,34,450,400,50,0.8888888888888888,5,4,1,333.4915547418133,0.3884061200237671,0.0032493396503292526,0.20431818834181828,133029.37121539787,2072.83436658977,135102.20558198763,1204,94,378.0882352941176,33,1,21,33.49469390987567,0.6571969696969697,42.095588235294116,1031.6176470588232,31.26114081996434,0
1354,4,0,0,34,0.0,0.0,1.0,34,1050,500,550,0.47619047619047616,16,5,11,339.4799457590134,0.38771910279263216,0.06215994251103596,0.19648687769688333,130870.93431122435,2085.6115362811606,132956.5458475055,1205,95,379.0882352941176,34,0,18,35.51241031607523,0.6332720588235294,44.19642857142856,1023.2142857142845,30.094537815126017,8
1355,4,0,1,33,0.0,0.029411764705882353,0.9705882352941176,34,250,200,50,0.8,3,2,1,339.4799457590134,0.38771910279263216,0.06215994251103596,0.19648687769688333,130870.93431122435,2085.6115362811606,132956.5458475055,1206,96,380.0882352941176,34,0,18,35.51241031607523,0.6332720588235294,44.19642857142856,1023.2142857142845,30.094537815126017,0
1356,4,0,0,33,0.0,0.0,1.0,33,1100,800,300,0.7272727272727273,14,8,6,353.618551330492,0.3865214646464647,0.06269692613727118,0.20443266388552284,130826.1546039986,2652.511053441002,133478.6656574396,1207,97,382.72727272727275,33,0,18,35.196054943299785,0.6351010101010102,44.24019607843138,1023.0392156862756,31.001188354129564,0
1357,4,0,0,33,0.0,0.0,1.0,33,800,500,300,0.625,11,5,6,357.95608560373586,0.3858506944444444,0.06635975461547083,0.2077836819352332,130982.91710219628,2777.2264573721623,133760.14355956845,1208,98,383.72727272727275,33,0,18,34.926448581348005,0.6366792929292929,44.08700980392157,1023.6519607843138,31.019756387403447,0
1358,4,0,0,33,0.0,0.0,1.0,33,700,500,200,0.7142857142857143,9,5,4,357.33171377110943,0.3854166666666667,0.07101286890684988,0.2080990335878162,131108.39468293454,2769.837472366405,133878.23215530094,1209,99,384.72727272727275,33,0,21,34.815498982888606,0.6379419191919191,43.96446078431373,1024.1421568627457,31.034610814022596,0
1359,4,0,0,33,0.0,0.0,1.0,33,500,400,100,0.8,6,4,2,389.4517704904165,0.38573232323232326,0.07448387953803115,0.20688958437833374,127486.19927300356,3372.1840664498122,130858.38333945337,1210,100,385.72727272727275,31,2,17,37.69339865910263,0.6061827956989247,47.52604166666667,1009.895833333334,32.57728494623658,8
1360,4,2,0,35,0.05714285714285714,0.0,1.0,35,1100,800,300,0.7272727272727273,14,8,6,367.3475389701644,0.3969187675070028,0.07826282394841089,0.1985214332577155,128175.55334787109,2416.994815695898,130592.54816356699,1211,0,364.62857142857143,33,2,19,37.544752712896866,0.608270202020202,46.844362745098046,1012.6225490196084,30.685531788472982,0
1361,4,0,0,35,0.0,0.0,1.0,35,1100,700,400,0.6363636363636364,15,7,8,364.97877648235516,0.39698879551820726,0.07597159100727557,0.19785439640522168,128299.67928501061,2365.3319937043525,130665.01127871497,1212,1,365.62857142857143,33,2,19,37.477697471876134,0.6095328282828283,46.7218137254902,1013.1127450980396,30.70038621509211,0
1362,4,1,1,35,0.027777777777777776,0.027777777777777776,0.9722222222222222,36,800,500,300,0.625,11,5,6,353.9794118728667,0.40028108465608464,0.08822149225715625,0.19391519966608722,128717.71541950117,1912.684240362812,130630.39965986398,1213,0,356.44444444444446,34,2,15,37.329403253558574,0.6115196078431373,46.30952380952381,1014.7619047619049,29.845938375350144,0
1363,4,1,0,36,0.027777777777777776,0.0,1.0,36,650,400,250,0.6153846153846154,9,4,5,353.68458050503796,0.401521164021164,0.09115163597982856,0.19419629220646867,128808.3351048753,1911.5043934240343,130719.83949829933,1214,0,357.3611111111111,34,2,16,37.24443923224267,0.6124387254901961,46.220238095238095,1015.1190476190477,29.856442577030815,0
1364,4,2,0,38,0.05263157894736842,0.0,1.0,38,600,400,200,0.6666666666666666,8,4,4,343.79123898745013,0.410458155523945,0.11803962218003483,0.19203864140720503,129487.77113261924,1303.352254281321,130791.12338690055,1215,0,339.5,36,2,16,36.80409567013351,0.615162037037037,45.55180180180181,1017.7927927927939,28.272022022022053,0
1365,4,0,0,38,0.0,0.0,1.0,38,1050,800,250,0.7619047619047619,13,8,5,343.79123898745013,0.410458155523945,0.11803962218003483,0.19203864140720503,129487.77113261924,1303.352254281321,130791.12338690055,1216,1,340.5,36,2,16,36.80409567013351,0.615162037037037,45.55180180180181,1017.7927927927939,28.272022022022053,0
1366,4,0,0,38,0.0,0.0,1.0,38,1100,700,400,0.6363636363636364,15,7,8,342.3371367260275,0.4107545045045045,0.11741853250842449,0.19192527758298009,129631.08114448925,1275.5066299407686,130906.58777443001,1217,2,341.5,36,2,16,36.695510339489104,0.6166087962962963,45.411036036036045,1018.3558558558572,28.287662662662697,0
1367,4,1,0,39,0.02564102564102564,0.0,1.0,39,1050,700,350,0.6666666666666666,14,7,7,334.48477568143755,0.4131803868645974,0.11924276132425793,0.18935136327529234,130010.85820877597,897.3305488227347,130908.1887575987,1218,0,333.71794871794873,37,2,18,36.510299071784395,0.6185247747747749,45.038377192982466,1019.8464912280717,27.563418681839778,0
1368,4,1,0,40,0.025,0.0,1.0,40,1250,1000,250,0.8,15,10,5,327.6694294601026,0.41610576923076925,0.12123352165725065,0.18708867424012315,130344.39718934921,541.9748520710162,130886.37204142023,1219,0,326.35,38,2,19,36.34651600753297,0.6200657894736843,44.71153846153847,1021.1538461538469,26.87246963562755,0
1369,4,0,2,38,0.0,0.05,0.95,40,900,500,400,0.5555555555555556,13,5,8,359.26427584051737,0.4160657051282051,0.11391179342519298,0.19173936481887938,127673.13169677202,1315.957969002975,128989.089665775,1220,1,327.35,37,3,18,38.263873820114995,0.5948761261261262,47.34100877192982,1010.6359649122801,27.31448553816973,8
1370,4,2,0,40,0.05,0.0,1.0,40,900,500,400,0.5555555555555556,13,5,8,361.3573993032466,0.4155582264957265,0.17206890641069617,0.1955620656340573,128232.4369454088,1269.285297586206,129501.722242995,1221,0,328.225,35,5,20,37.63819849160097,0.6044642857142857,46.788194444444436,1012.8472222222209,28.938492063492028,0
1371,4,0,0,40,0.0,0.0,1.0,40,1250,900,350,0.72,16,9,7,362.2839506172842,0.4149706196581197,0.18040000000000012,0.19689345142243697,128401.20525931334,1303.5391810729643,129704.7444403863,1222,1,329.225,36,4,18,37.44212962962964,0.6041666666666667,46.62162162162162,1013.5135135135133,28.15315315315315,0
1372,4,0,0,40,0.0,0.0,1.0,40,950,600,350,0.631578947368421,13,6,7,363.78125399563993,0.4145833333333333,0.18305466059326747,0.19784864454469808,128429.74044568211,1344.0664059329542,129773.80685161507,1223,2,330.225,36,4,18,37.37501388734585,0.6044560185185186,46.593468468468465,1013.6261261261257,28.156281281281267,0
1373,4,2,0,42,0.047619047619047616,0.0,1.0,42,950,700,250,0.7368421052631579,12,7,5,348.84121377668475,0.4200662988772745,0.18943424203260117,0.19212541009044942,128929.9859832709,595.2185605230097,129525.20454379391,1224,0,315.45238095238096,38,4,21,37.24336384038151,0.6058114035087719,46.10042735042733,1015.5982905982879,26.726270805218103,0
1374,4,1,0,43,0.023255813953488372,0.0,1.0,43,1100,1000,100,0.9090909090909091,12,10,2,342.87335496563475,0.4238418235511259,0.18882309457639113,0.19027679913858123,129230.01284646132,262.7616839512633,129492.77453041259,1225,0,309.09302325581393,36,7,22,37.08951711152951,0.6125578703703703,45.80518018018018,1016.7792792792792,28.243868868868866,0
1375,4,0,0,43,0.0,0.0,1.0,43,1200,700,500,0.5833333333333334,17,7,10,341.2076460879177,0.4236341823551126,0.18276402749080511,0.18999878397948244,129364.36760355021,228.0222715318812,129592.3898750821,1226,1,310.09302325581393,38,5,22,36.99524784709097,0.6101973684210527,45.67307692307692,1017.3076923076916,26.771255060728727,0
1376,4,0,0,43,0.0,0.0,1.0,43,900,800,100,0.8888888888888888,10,8,2,344.5699107404457,0.42400332225913623,0.18155499303082312,0.19253475305713938,129500.26167223684,324.3787210534024,129824.64039329025,1227,2,311.09302325581393,38,5,16,36.77158776809769,0.6115679824561404,45.539529914529915,1017.8418803418804,26.7853126405758,0
1377,4,0,1,42,0.0,0.023255813953488372,0.9767441860465116,43,1150,800,350,0.6956521739130435,15,8,7,342.01313894809186,0.42374953857512,0.17140305848598092,0.19176877885018878,129636.2270801373,267.4585890130703,129903.68566915036,1228,3,312.09302325581393,38,5,16,36.69853301161001,0.6129385964912281,45.4059829059829,1018.376068376068,26.799370220422844,0
1378,4,1,0,43,0.023255813953488372,0.0,1.0,43,1350,1000,350,0.7407407407407407,17,10,7,347.72537863084256,0.4223191214470284,0.1891755554418315,0.19646792707366048,129935.60209155137,436.38128698222437,130371.9833785336,1229,0,313.0,38,5,18,36.24908309755841,0.615953947368421,45.112179487179475,1019.55128205128,26.830296896086317,0
1379,4,0,1,42,0.0,0.023255813953488372,0.9767441860465116,43,1350,900,450,0.6666666666666666,18,9,9,349.914311559442,0.4215577703949797,0.19732131985876045,0.19867310793059856,130126.2932372707,506.6104627803226,130632.90370005103,1230,1,314.0,38,5,19,35.99978184991273,0.6178728070175439,44.92521367521367,1020.2991452991446,26.849977507872225,0
1380,4,0,1,41,0.0,0.023809523809523808,0.9761904761904762,42,750,500,250,0.6666666666666666,10,5,5,357.12396980823735,0.41885646535036775,0.20061809001479913,0.20187816384479024,129954.9515836604,882.0056411588204,130836.95722481921,1231,2,322.3333333333333,37,5,19,35.98986898232785,0.6179617117117118,45.093201754385966,1019.6271929824564,27.557491702228553,0
1381,4,0,0,41,0.0,0.0,1.0,41,1200,900,300,0.75,15,9,6,377.56589518362324,0.41526930894308944,0.1686736075118127,0.20044489528532577,127459.90125868075,1424.90234375002,128884.80360243077,1232,3,330.780487804878,39,2,13,38.020510968984254,0.5892094017094017,47.55208333333334,1009.7916666666682,25.892094017094056,8
1382,4,1,0,42,0.023809523809523808,0.0,1.0,42,1050,600,450,0.5714285714285714,15,6,9,372.48015859813694,0.4185419086333721,0.17757450106930417,0.20013449195910432,127943.71712805488,1131.2992094986098,129075.01633755349,1233,0,323.8809523809524,41,1,15,37.652399163234605,0.5909552845528455,47.073412698412696,1011.7063492063489,24.675764614789,0
1383,4,0,0,42,0.0,0.0,1.0,42,1050,500,550,0.47619047619047616,16,5,11,374.5694250294442,0.41935249709639955,0.17124515198611068,0.2018875775792615,128069.20750070868,1194.1618835034105,129263.3693842121,1234,1,324.8809523809524,41,1,16,37.47090316573557,0.5922256097560976,46.949404761904766,1012.2023809523814,24.687862950058083,0
1384,4,0,0,42,0.0,0.0,1.0,42,1100,700,400,0.6363636363636364,15,7,8,373.41868617588773,0.41911053039101814,0.17156574563982008,0.2016460905349796,128144.53125000012,1170.3567885487676,129314.88803854889,1235,2,325.8809523809524,39,3,16,37.422839506172856,0.5961538461538461,46.87500000000001,1012.5000000000009,25.961538461538485,0
1385,4,0,0,42,0.0,0.0,1.0,42,1200,1000,200,0.8333333333333334,14,10,4,369.18013652465885,0.41885646535036775,0.16640890414843001,0.1997725202740638,128227.80957842778,1067.832049284373,129295.64162771216,1236,3,326.8809523809524,37,5,16,37.44485493125473,0.6005067567567568,46.792763157894726,1012.8289473684196,27.37375533428161,0
1386,4,1,0,43,0.023255813953488372,0.0,1.0,43,1550,1200,350,0.7741935483870968,19,12,7,357.0282651308641,0.41971207087486156,0.16622751747050057,0.19588307519342005,128778.125,595.4861111111111,129373.61111111111,1237,0,320.25581395348837,39,4,17,37.19040777230431,0.6025641025641026,46.25,1015.0,26.025641025641026,0
1387,4,0,1,42,0.0,0.023255813953488372,0.9767441860465116,43,850,600,250,0.7058823529411765,11,6,5,346.29329866493856,0.41957364341085274,0.13731953833689703,0.18796018783704485,128349.69142500414,357.90399412721183,128707.59541913135,1238,1,321.25581395348837,35,8,16,37.899890538739776,0.6056547619047619,46.672453703703695,1013.3101851851841,28.951719576719544,8
1388,4,0,0,42,0.0,0.0,1.0,42,1150,800,350,0.6956521739130435,15,8,7,352.04202477429084,0.4187596786682153,0.1515623725218247,0.19108046663973427,128349.69142500413,636.8970496827675,128986.5884746869,1239,6,329.8809523809524,35,7,18,37.75425947077861,0.6056547619047619,46.672453703703695,1013.310185185184,28.95171957671954,0
1389,4,1,0,43,0.023255813953488372,0.0,1.0,43,950,700,250,0.7368421052631579,12,7,5,345.49407861297664,0.4208887043189369,0.16440887494096312,0.1892551454335278,128715.26668137724,294.0724931011971,129009.33917447843,1240,0,323.1860465116279,36,7,18,37.547164576628546,0.607349537037037,46.31193693693693,1014.7522522522517,28.187562562562547,0
1390,4,1,1,43,0.022727272727272728,0.022727272727272728,0.9772727272727273,44,1500,1100,400,0.7333333333333333,19,11,8,340.74060267199934,0.42375792811839325,0.1752661531668549,0.1880263063583125,129006.37846500815,-8.457770660240726,128997.92069434791,1241,0,316.8181818181818,37,7,19,37.37126731426515,0.6083896396396397,46.025219298245595,1015.8991228070149,27.45673304883824,0
1391,4,1,1,43,0.022727272727272728,0.022727272727272728,0.9772727272727273,44,950,500,450,0.5263157894736842,14,5,9,341.2544712795358,0.42534355179704014,0.17016901463682466,0.18937478828097717,129229.25954380161,20.012527893161064,129249.27207169478,1242,0,306.3863636363636,37,7,21,37.13143445127431,0.6106418918918919,45.80592105263156,1016.776315789471,27.480440967283002,0
1392,4,1,1,43,0.022727272727272728,0.022727272727272728,0.9772727272727273,44,1150,800,350,0.6956521739130435,15,8,7,340.3687767375539,0.42396714235377025,0.17649964209019364,0.189924581044241,129445.89548405622,11.868219921070562,129457.7637039773,1243,0,307.15909090909093,38,6,17,36.93372703412072,0.6110197368421053,45.5929487179487,1017.6282051282026,26.77968960863691,0
1393,4,0,0,43,0.0,0.0,1.0,43,1500,1000,500,0.6666666666666666,20,10,10,348.35296521997657,0.4208656330749354,0.1892943063352046,0.1942737690649866,129424.43828870401,417.077369959965,129841.51565866398,1244,2,315.30232558139534,37,6,21,36.752424568965516,0.6126126126126126,45.61403508771929,1017.5438596491211,27.501185395922192,0
1394,4,0,0,43,0.0,0.0,1.0,43,1050,800,250,0.7619047619047619,13,8,5,346.1213679272166,0.4200350682908822,0.19110647976513717,0.19357775782146228,129536.03512619245,367.03793474912544,129903.07306094158,1245,3,316.30232558139534,37,6,19,36.695748958782104,0.6137387387387387,45.50438596491227,1017.9824561403491,27.51303935514457,0
1395,4,0,0,43,0.0,0.0,1.0,43,1250,900,350,0.72,16,9,7,346.56440215502687,0.4196889996308601,0.18361803283203226,0.19451581459927755,129675.59880203518,388.18927458448366,130063.78807661966,1246,4,317.30232558139534,37,6,19,36.54266246815231,0.6151463963963963,45.36732456140351,1018.5307017543855,27.527856804172583,0
1396,4,0,0,43,0.0,0.0,1.0,43,850,300,550,0.35294117647058826,14,3,11,350.60130692550445,0.4190891472868217,0.18882960085695144,0.19720262372589512,129759.37307633119,498.7611572791652,130258.13423361036,1247,5,318.30232558139534,37,6,19,36.354749605395334,0.615990990990991,45.28508771929825,1018.8596491228071,27.53674727358938,0
1397,4,1,0,44,0.022727272727272728,0.0,1.0,44,650,300,350,0.46153846153846156,10,3,7,346.13964693900374,0.42170983086680763,0.1887401454850135,0.1962554245233733,130071.79578493677,204.60109394403946,130276.39687888081,1248,0,312.04545454545456,38,6,20,36.15133186705768,0.6173245614035088,44.97863247863248,1020.0854700854698,26.844354475933415,0
1398,4,2,1,45,0.043478260869565216,0.021739130434782608,0.9782608695652174,46,900,500,400,0.5555555555555556,13,5,8,334.79973621515944,0.42410426731078904,0.20054020996840238,0.1922012997078369,130555.17713758699,-457.892401703105,130097.28473588388,1249,0,299.4347826086956,39,7,16,35.951249447898626,0.6204594017094017,44.50520833333334,1021.9791666666681,26.204594017094053,0
1399,4,0,0,45,0.0,0.0,1.0,45,1400,1200,200,0.8571428571428571,16,12,4,341.074253659466,0.4222011784511785,0.207574648966935,0.19597942250811498,130589.98243343207,-91.82384122286516,130498.1585922092,1250,1,307.0888888888889,38,7,17,35.755722797115084,0.622532894736842,44.471153846153854,1022.1153846153857,26.897773279352254,0
1400,4,0,1,44,0.0,0.022222222222222223,0.9777777777777777,45,750,200,550,0.26666666666666666,13,2,11,339.1882474498301,0.42196969696969694,0.20353688415136828,0.1951709164069408,130644.58832137121,-137.3782096939094,130507.2101116773,1251,2,308.0888888888889,38,7,17,35.74868498972376,0.6230811403508771,44.417735042735046,1022.3290598290602,26.903396311291058,0
1401,4,0,1,43,0.0,0.022727272727272728,0.9772727272727273,44,1450,1000,450,0.6896551724137931,19,10,9,340.26574819686317,0.4217318534178999,0.18309254179046364,0.19690181694751432,130863.12601587058,105.64789703413066,130968.77391290471,1252,3,305.0,38,6,17,35.50020013226131,0.6252741228070176,44.20405982905984,1023.1837606837621,26.92588843904637,0
1402,4,0,0,43,0.0,0.0,1.0,43,900,500,400,0.5555555555555556,13,5,8,347.4154778717702,0.4186046511627907,0.18967189529772255,0.20039234150340152,130738.73842191831,484.13225704062955,131222.87067895895,1253,4,313.0,37,6,17,35.44313552053178,0.6258445945945945,44.32565789473684,1022.6973684210529,27.640469416785216,0
1403,4,0,0,43,0.0,0.0,1.0,43,1050,700,350,0.6666666666666666,14,7,7,348.49684143558306,0.41823551125876707,0.19132523994786,0.20160099364137812,130850.90033712311,520.2250932979489,131371.12543042106,1254,5,314.0,37,6,17,35.30201746865286,0.6269707207207207,44.21600877192983,1023.1359649122819,27.65232337600762,0
1404,4,0,0,43,0.0,0.0,1.0,43,800,600,200,0.75,10,6,4,349.2419191352242,0.41782022886674053,0.19495808371295564,0.20217900678473394,130878.94833025541,541.6830178516445,131420.63134810707,1255,6,315.0,37,6,17,35.2545899414202,0.6272522522522522,44.18859649122807,1023.2456140350873,27.65528686581317,0
1405,4,0,0,43,0.0,0.0,1.0,43,1000,700,300,0.7,13,7,6,351.13544495917074,0.41687430786268,0.19338992845897884,0.20386819117778726,130991.17036011083,599.1285780240137,131590.29893813483,1256,7,316.0,37,6,18,35.09265209940018,0.6283783783783784,44.078947368421055,1023.684210526316,27.667140825035567,0
1406,4,0,0,43,0.0,0.0,1.0,43,850,700,150,0.8235294117647058,10,7,3,349.23392770297124,0.41643595422665186,0.18943207221201575,0.20365439154813714,131159.5935768698,561.0760041551285,131720.66958102494,1257,8,317.0,37,6,18,34.971098265895954,0.6300675675675675,43.91447368421053,1024.342105263158,27.684921763869134,0
1407,4,0,1,42,0.0,0.023255813953488372,0.9767441860465116,43,1200,900,300,0.75,15,9,6,353.554074839377,0.41668973791066816,0.18475797685114914,0.2072336705751306,131356.22409058546,688.3056565481559,132044.5297471336,1258,9,318.0,37,6,18,34.661795379184944,0.6320382882882882,43.72258771929824,1025.109649122806,27.70566619250827,0
1408,4,0,1,41,0.0,0.023809523809523808,0.9761904761904762,42,1500,1200,300,0.8,18,12,6,363.6605678390034,0.4146341463414634,0.1918671598748638,0.21268909055214796,131271.93583602645,1147.6853454909167,132419.62118151737,1259,10,326.1904761904762,37,5,18,34.48801626364219,0.6311936936936937,43.80482456140351,1024.7807017543857,27.696775723091505,0
1409,4,0,0,41,0.0,0.0,1.0,41,1050,700,350,0.6666666666666666,14,7,7,362.87923854848304,0.4130589430894309,0.19313900456077726,0.21254355400696862,131328.125,1331.2620229301328,132659.38702293014,1260,11,333.9756097560976,35,6,18,34.45121951219511,0.6357142857142857,43.75,1025.0,29.285714285714285,0
1410,4,0,0,41,0.0,0.0,1.0,41,1450,800,650,0.5517241379310345,21,8,13,366.8390381241782,0.41224593495934964,0.19819343758772745,0.21586504354956598,131506.13667052455,1448.3169367283758,132954.45360725292,1261,12,334.9756097560976,35,6,18,34.169769803656045,0.6375,43.57638888888888,1025.6944444444432,29.30555555555552,0
1411,4,0,0,41,0.0,0.0,1.0,41,1500,1100,400,0.7333333333333333,19,11,8,369.7241466028352,0.4115345528455285,0.19938047790132774,0.21824063141016878,131624.8780971363,1532.9791452331779,133157.85724236947,1262,13,335.9756097560976,35,6,17,33.97576885480112,0.6386904761904761,43.46064814814814,1026.157407407406,29.31878306878303,0
1412,4,0,0,41,0.0,0.0,1.0,41,1000,800,200,0.8,12,8,4,369.48837587652815,0.4107977642276423,0.19561690543624732,0.21878250293890528,131743.6731074244,1535.5511616940832,133279.22426911848,1263,14,336.9756097560976,35,6,17,33.86180007515972,0.6398809523809523,43.3449074074074,1026.620370370369,29.332010582010543,0
1413,4,1,0,42,0.023809523809523808,0.0,1.0,42,1050,700,350,0.6666666666666666,14,7,7,365.18106393821506,0.4128072977158343,0.1960276608726943,0.2186536586767112,132166.31063073225,1252.9267865838979,133419.23741731615,1264,0,329.92857142857144,36,6,18,33.545978899718904,0.6420717592592593,42.933558558558566,1028.2657657657671,28.562937937937974,0
1414,4,0,0,42,0.0,0.0,1.0,42,800,300,500,0.375,13,3,10,366.34637622551924,0.41233546264034066,0.1922515420270814,0.21968755443648513,132224.21481870388,1287.9723896193568,133512.18720832324,1265,1,330.92857142857144,36,6,19,33.457653563998704,0.642650462962963,42.877252252252255,1028.4909909909913,28.569194194194203,0
1415,4,0,0,42,0.0,0.0,1.0,42,1150,800,350,0.6956521739130435,15,8,7,369.0081826365395,0.41171844754161824,0.18726544908681508,0.221793339247857,132311.0948786625,1364.775332765204,133675.8702114277,1266,2,331.92857142857144,36,6,19,33.30163638353765,0.6435185185185186,42.792792792792795,1028.8288288288293,28.57857857857859,0
1416,4,0,0,42,0.0,0.0,1.0,42,1350,900,450,0.6666666666666666,18,9,9,370.3015017181341,0.4110288424312814,0.19112461784451296,0.22377175348373451,132513.92598257054,1414.0211579823213,133927.94714055286,1267,3,332.92857142857144,36,6,19,33.0640016041416,0.6455439814814814,42.59572072072073,1029.6171171171181,28.600475475475506,0
1417,4,0,0,42,0.0,0.0,1.0,42,1550,1000,550,0.6451612903225806,21,10,11,368.8564006091553,0.410762679055362,0.18900858704137424,0.22410598044978558,132716.9124360848,1390.6965242269384,134107.60896031174,1268,4,333.92857142857144,36,6,17,32.89685792349727,0.6475694444444444,42.39864864864865,1030.4054054054059,28.622372372372386,0
1418,4,0,0,42,0.0,0.0,1.0,42,1200,800,400,0.6666666666666666,16,8,8,369.0163638808743,0.41025454897406116,0.1894771894771894,0.22455038312751086,132774.93709926153,1399.2249005762649,134174.1619998378,1269,5,334.92857142857144,36,6,17,32.834353146853154,0.6481481481481481,42.34234234234235,1030.6306306306315,28.62862862862865,0
1419,4,0,0,42,0.0,0.0,1.0,42,1500,1100,400,0.7333333333333333,19,11,8,369.27772232884627,0.40972222222222227,0.18511007809981384,0.22575736856392345,132949.0871783946,1419.0272197873526,134368.11439818196,1270,6,335.92857142857144,36,6,17,32.652462328019205,0.6498842592592593,42.17342342342342,1031.3063063063062,28.647397397397395,0
1420,4,0,0,42,0.0,0.0,1.0,42,1250,900,350,0.72,16,9,7,365.9519410686229,0.4089237320944638,0.18728565192991198,0.22477101795930676,133123.35139193234,1343.3497686875903,134466.70116061994,1271,7,336.92857142857144,36,6,17,32.563109268150725,0.6516203703703703,42.004504504504496,1031.9819819819809,28.666166166166136,0
1421,4,0,0,42,0.0,0.0,1.0,42,1350,1200,150,0.8888888888888888,15,12,3,380.5363443430126,0.40857288037166084,0.2534958647490617,0.22147318227595378,131084.19075963725,1607.5201606391336,132691.71092027638,1272,8,337.92857142857144,34,8,17,34.24591180345656,0.6354166666666667,43.98809523809524,1024.0476190476195,30.11904761904763,7
1422,4,1,0,43,0.023255813953488372,0.0,1.0,43,900,700,200,0.7777777777777778,11,7,4,367.10108833887534,0.4104143595422665,0.2432487778752095,0.21534976427190455,131387.44882758922,1046.4950917352628,132433.9439193245,1273,0,331.04651162790697,35,8,18,34.2830398133514,0.6363095238095238,43.69212962962963,1025.231481481482,29.292328042328055,0
1423,4,0,0,43,0.0,0.0,1.0,43,900,500,400,0.5555555555555556,13,5,8,346.89868973807353,0.410437430786268,0.19084746010797282,0.19464303762643023,129663.42872242286,396.0147061508983,130059.44342857377,1274,1,332.04651162790697,38,5,18,36.54651386412113,0.6132127192982456,45.37927350427349,1018.482905982904,26.80218173639221,8
1424,4,1,1,43,0.022727272727272728,0.022727272727272728,0.9772727272727273,44,1100,700,400,0.6363636363636364,15,7,8,341.24950753178194,0.4143322762508809,0.19617163770121748,0.19271834565571536,129917.22140842005,66.83756510415651,129984.05897352421,1275,0,325.47727272727275,39,5,19,36.43278924423556,0.6140491452991452,45.13020833333333,1019.479166666666,26.140491452991434,0
1425,4,0,2,41,0.0,0.046511627906976744,0.9534883720930233,43,1050,700,350,0.6666666666666666,14,7,7,318.1439709552113,0.4151208933185677,0.12173962376546554,0.18608206814847614,131274.74500868062,-246.6878255208292,131028.05718315979,1276,1,327.48837209302326,39,4,22,35.65130107745477,0.6276709401709402,43.802083333333336,1024.7916666666672,26.276709401709414,8
1426,4,2,1,42,0.046511627906976744,0.023255813953488372,0.9767441860465116,43,1100,600,500,0.5454545454545454,16,6,10,312.16788789859675,0.41269841269841273,0.1576603828376446,0.18495273752808344,131766.52444480962,-373.3336229705536,131393.19082183906,1277,0,328.3488372093023,38,5,17,35.310006937218155,0.6343201754385965,43.32264957264957,1026.709401709401,27.018668466036868,0
1427,4,0,0,42,0.0,0.0,1.0,42,1200,900,300,0.75,15,9,6,319.99869384099395,0.4129887727448703,0.09996914532551715,0.17596127701707864,128867.17547706992,-151.0248959043383,128716.15058116558,1278,1,325.23809523809524,37,5,19,38.039506839452855,0.6069819819819819,46.16228070175439,1015.3508771929828,27.441915599810347,8
1428,4,0,1,41,0.0,0.023809523809523808,0.9761904761904762,42,1150,700,450,0.6086956521739131,16,7,9,323.0842502929566,0.4132791327913279,0.0989698307579101,0.17879583903646856,129119.93805473366,-56.676323142680104,129063.26173159099,1279,2,326.23809523809524,38,4,20,37.70432565962365,0.6077302631578947,45.91346153846153,1016.3461538461534,26.745951417004036,0
1429,4,1,0,42,0.023809523809523808,0.0,1.0,42,650,400,250,0.6153846153846154,9,4,5,320.1833754458978,0.4160496515679442,0.10426929392446649,0.17856380553713516,129424.43828870403,-112.06361458967302,129312.37467411436,1280,0,321.07142857142856,37,5,21,37.469019396551715,0.6126126126126126,45.61403508771929,1017.5438596491213,27.501185395922196,0
1430,4,0,1,41,0.0,0.023809523809523808,0.9761904761904762,42,1000,600,400,0.6,14,6,8,319.7978687073791,0.41527535811072397,0.10253510000359078,0.1787286944738469,129508.13140822164,-116.71511907511643,129391.41628914652,1281,1,322.07142857142856,37,5,14,37.393959388128835,0.6134572072072072,45.53179824561403,1017.8728070175429,27.510075865338997,0
1431,4,1,0,42,0.023809523809523808,0.0,1.0,42,1500,1300,200,0.8666666666666667,17,13,4,319.4940486393621,0.4136178861788618,0.10921837525367417,0.17970573244291452,129759.37307633096,-108.53050938753123,129650.84256694342,1282,0,323.0238095238095,37,5,17,37.1470978619601,0.615990990990991,45.28508771929823,1018.8596491228053,27.536747273589334,0
1432,4,1,1,42,0.023255813953488372,0.023255813953488372,0.9767441860465116,43,1100,600,500,0.5454545454545454,16,6,10,333.34447244123436,0.41858157991878925,0.12945052719582728,0.17573669450595256,127177.1914439777,1.6130577824526426,127178.80450176015,1283,0,316.48837209302326,36,7,20,39.426333221688814,0.591724537037037,47.832207207207205,1008.6711711711707,28.01864364364363,8
1433,4,1,1,42,0.023255813953488372,0.023255813953488372,0.9767441860465116,43,1550,1300,250,0.8387096774193549,18,13,5,332.7911202050234,0.42061184939091917,0.14456737441471312,0.1764324300791269,127404.47108848716,-120.1846694667654,127284.2864190204,1284,0,317.3255813953488,36,7,14,39.207566462167684,0.5940393518518519,47.60698198198198,1009.5720720720723,28.043668668668673,0
1434,4,4,3,43,0.08695652173913043,0.06521739130434782,0.9347826086956522,46,900,500,400,0.5555555555555556,13,5,8,308.55730180083845,0.43014291465378424,0.15598022288494717,0.16758896588006322,128376.15258774532,-1277.7201483905187,127098.4324393548,1285,0,286.1521739130435,40,6,11,38.828929335472644,0.596875,46.64634146341463,1013.4146341463409,25.335365853658523,0
1435,4,0,0,43,0.0,0.0,1.0,43,1400,1300,100,0.9285714285714286,15,13,2,330.43066119525275,0.42294204503506827,0.15137576525918628,0.17757039667143837,127950.32035097339,-144.2582092566954,127806.06214171668,1286,1,307.1162790697674,37,6,18,38.70920035403347,0.5976914414414414,47.06688596491228,1011.7324561403509,27.3441204362257,0
1436,4,1,0,44,0.022727272727272728,0.0,1.0,44,1200,800,400,0.6666666666666666,16,8,8,327.7107509975511,0.42509029245947855,0.15270493139388797,0.1774429257685771,128252.72715547167,-394.04049327926305,127858.68666219241,1287,0,301.1136363636364,38,6,19,38.469482825299714,0.5989583333333333,46.7681623931624,1012.9273504273515,26.655982905982935,0
1437,4,0,0,44,0.0,0.0,1.0,44,1400,800,600,0.5714285714285714,20,8,12,322.79868344881373,0.42424242424242425,0.1458513023977921,0.17537619193559265,128388.03624260356,-511.302186061797,127876.73405654175,1288,1,302.1136363636364,38,6,12,38.456014126080554,0.600328947368421,46.63461538461539,1013.4615384615386,26.67004048582996,0
1438,4,0,1,43,0.0,0.022727272727272728,0.9772727272727273,44,850,600,250,0.7058823529411765,11,6,5,323.41316781856864,0.42407725510923183,0.1427623446438664,0.1758292677991267,128415.10662073563,-493.7727144057276,127921.3339063299,1289,2,303.1136363636364,38,6,12,38.412872000281084,0.6006030701754386,46.60790598290598,1013.5683760683761,26.67285200179937,0
1439,4,0,0,43,0.0,0.0,1.0,43,1200,800,400,0.6666666666666666,16,8,8,330.10988948679545,0.4235188261351052,0.14144790662434525,0.1788789014057774,128283.34349270936,-130.47993132501347,128152.86356138435,1290,3,309.7674418604651,37,6,20,38.37750748638021,0.6010698198198199,46.73793859649123,1013.0482456140356,27.379682313892854,0
1440,4,1,1,43,0.022727272727272728,0.022727272727272728,0.9772727272727273,44,1250,1100,150,0.88,14,11,3,323.9509944121249,0.4246828752642706,0.15047393364928863,0.17708202026155043,128631.77237426057,-465.9218852728237,128165.85048898775,1291,0,303.70454545454544,38,6,14,38.1786466561348,0.602796052631579,46.39423076923078,1014.4230769230787,26.6953441295547,0
1441,4,0,0,43,0.0,0.0,1.0,43,1800,1200,600,0.6666666666666666,24,12,12,329.6757341124908,0.421234772978959,0.1548208673790068,0.1800177414722869,128588.9949311327,-121.46573945829238,128467.5291916744,1292,1,311.6744186046512,37,6,14,38.077027027027015,0.6041666666666667,46.43640350877193,1014.2543859649127,27.412280701754398,0
1442,4,0,0,43,0.0,0.0,1.0,43,1200,900,300,0.75,15,9,6,327.8652765369387,0.42100406053894424,0.15653318992164245,0.1795304892942505,128700.23108071726,-160.73262927053372,128539.49845144672,1293,2,312.6744186046512,37,6,14,38.00968950363807,0.6052927927927928,46.32675438596492,1014.6929824561414,27.424134660976794,0
1443,4,0,1,42,0.0,0.023255813953488372,0.9767441860465116,43,1400,1000,400,0.7142857142857143,18,10,8,327.3387475132273,0.42100406053894424,0.15652401057927312,0.17987118476112593,128839.34389667978,-165.17810768697504,128674.1657889928,1294,3,313.6744186046512,37,6,14,37.881498181949105,0.6067004504504505,46.189692982456144,1015.2412280701757,27.43895211000475,0
1444,4,1,1,42,0.023255813953488372,0.023255813953488372,0.9767441860465116,43,1050,600,450,0.5714285714285714,15,6,9,327.22579279093986,0.4219499815430048,0.16147764675164233,0.1803148434635618,128950.68825263534,-160.80176111881923,128789.88649151652,1295,0,314.3720930232558,37,6,17,37.77112796430241,0.6078265765765766,46.080043859649116,1015.6798245614028,27.450806069227102,0
1445,4,0,0,42,0.0,0.0,1.0,42,1100,900,200,0.8181818181818182,13,9,4,334.3359168655104,0.4205623306233062,0.16354967132672926,0.18358730239269822,128811.51532202197,213.2632156047785,129024.77853762674,1296,1,322.5952380952381,37,5,17,37.73223158349534,0.6064189189189189,46.21710526315788,1015.1315789473668,27.435988620199105,0
1446,4,0,0,42,0.0,0.0,1.0,42,750,500,250,0.6666666666666666,10,5,5,334.3359168655104,0.4205623306233062,0.16354967132672926,0.18358730239269822,128811.51532202197,213.2632156047785,129024.77853762674,1297,2,323.5952380952381,37,5,17,37.73223158349534,0.6064189189189189,46.21710526315788,1015.1315789473668,27.435988620199105,0
1447,4,0,1,41,0.0,0.023809523809523808,0.9761904761904762,42,1400,1100,300,0.7857142857142857,17,11,6,336.50201288432567,0.4201872822299652,0.16890877301244478,0.1850361424767728,128867.17547706972,272.8127885503042,129139.98826562002,1298,3,324.5952380952381,37,5,18,37.62059035277178,0.6069819819819819,46.162280701754376,1015.3508771929812,27.441915599810304,0
1448,4,0,0,41,0.0,0.0,1.0,41,1100,800,300,0.7272727272727273,14,8,6,343.2170273078069,0.42096036585365854,0.16746001033737157,0.18827845813300442,128772.40997331786,639.376750060865,129411.78672337873,1299,4,325.8536585365854,36,5,18,37.54669181552571,0.6079282407407407,46.25563063063063,1014.9774774774771,28.19381881881881,0
1449,4,0,0,41,0.0,0.0,1.0,41,1350,1000,350,0.7407407407407407,17,10,7,341.2225765121328,0.4200457317073171,0.1664886323993524,0.18799550504355053,128943.9159387427,599.7150444363205,129543.63098317903,1300,5,326.8536585365854,36,5,20,37.422617067671965,0.6096643518518519,46.08671171171171,1015.6531531531524,28.212587587587567,0
1450,4,1,0,42,0.023809523809523808,0.0,1.0,42,1350,1200,150,0.8888888888888888,15,12,3,337.4996462647812,0.4223528842431281,0.17065909318650507,0.18729467155038146,129230.01284646122,323.2735269052704,129553.28637336649,1301,0,320.04761904761904,36,6,21,37.22611400302727,0.6125578703703703,45.80518018018017,1016.7792792792784,28.243868868868844,0
1451,4,0,1,41,0.0,0.023809523809523808,0.9761904761904762,42,1000,600,400,0.6,14,6,8,335.61983123763747,0.42172377080913664,0.16379887502438173,0.18679321845776806,129344.54038075222,282.1185628195578,129626.65894357178,1302,1,321.04761904761904,36,6,21,37.15750581202257,0.6137152777777778,45.69256756756756,1017.2297297297284,28.256381381381345,0
1452,4,1,1,41,0.023809523809523808,0.023809523809523808,0.9761904761904762,42,750,300,450,0.4,12,3,9,333.0538973065179,0.42437330623306235,0.16433803163660987,0.18626942063817506,129536.03512619242,228.4962680824584,129764.53139427488,1303,0,316.2142857142857,37,5,15,37.02831035473214,0.6137387387387387,45.50438596491227,1017.9824561403489,27.513039355144564,0
1453,4,2,1,42,0.046511627906976744,0.023255813953488372,0.9767441860465116,43,1700,1200,500,0.7058823529411765,22,12,10,324.94266352549556,0.42889442598744926,0.18047544029238383,0.18462387741415856,130153.5462437905,-141.51200325080168,130012.0342405397,1304,0,305.1860465116279,38,5,18,36.60916832443374,0.6181469298245614,44.898504273504265,1020.4059829059818,26.852789023841627,0
1454,4,0,0,42,0.0,0.0,1.0,42,650,300,350,0.46153846153846156,10,3,7,332.5227770265327,0.42629694154084397,0.17904229619620904,0.18864584862529604,130094.74068944262,251.89289012000546,130346.63357956264,1305,1,313.3809523809524,37,5,19,36.47535110346803,0.6193693693693694,44.95614035087718,1020.1754385964889,27.572309151256455,0
1455,4,0,2,40,0.0,0.047619047619047616,0.9523809523809523,42,900,600,300,0.6666666666666666,12,6,6,334.83940187919796,0.42641792489353464,0.18366542834627975,0.19023293491378568,130150.67737188331,315.91499307474976,130466.59236495807,1306,2,314.3809523809524,37,5,19,36.359606705351375,0.6199324324324325,44.901315789473664,1020.3947368421025,27.578236130867634,0
1456,4,0,0,40,0.0,0.0,1.0,40,950,500,450,0.5263157894736842,14,5,9,366.942438728764,0.4234107905982906,0.20906381697772414,0.20493994308287705,129481.87183114652,1768.750597818337,131250.62242896485,1307,3,329.1,33,7,16,36.22102649006621,0.6215277777777778,45.55759803921568,1017.7696078431361,30.84150326797382,8
1457,4,0,2,38,0.0,0.05,0.95,40,1200,900,300,0.75,15,9,6,365.2369576764344,0.4236912393162393,0.20706161993019645,0.20463613495168528,129606.62853529886,1467.4261401864558,131074.05467548533,1308,4,330.1,33,7,17,36.13739619689493,0.622790404040404,45.43504901960784,1018.2598039215682,30.856357694592976,0
1458,4,0,0,38,0.0,0.0,1.0,38,1250,900,350,0.72,16,9,7,373.38236211119874,0.41890410146989093,0.21692471428933446,0.20903373749459805,129575.43372741232,2076.2363033448437,131651.67003075717,1309,5,341.9736842105263,33,5,19,35.96182394479218,0.6224747474747474,45.46568627450979,1018.1372549019591,30.852644087938152,0
1459,4,2,0,40,0.05,0.0,1.0,40,1600,1100,500,0.6875,21,11,10,359.0238251946412,0.4210737179487179,0.22449585884047507,0.2047246740380942,130293.86421388415,1359.3547253460295,131653.2189392302,1310,0,325.825,33,7,21,35.597342255831634,0.6297348484848485,44.76102941176471,1020.9558823529417,30.93805704099823,0
1460,4,0,0,40,0.0,0.0,1.0,40,850,400,450,0.47058823529411764,13,4,9,375.60948955035343,0.42081997863247866,0.21552883012998603,0.20428163235303498,128429.7404456821,1716.3128075573286,130146.05325323943,1311,1,326.825,36,4,16,37.075278672740076,0.6044560185185186,46.593468468468465,1013.6261261261255,28.156281281281267,8
1461,4,0,0,40,0.0,0.0,1.0,40,1100,700,400,0.6363636363636364,15,7,8,380.31668471861593,0.42069978632478633,0.21581270123237495,0.20773270947608097,128601.01814229778,1781.8225742634604,130382.84071656124,1312,2,327.825,36,4,17,36.780652085415056,0.6061921296296297,46.42454954954955,1014.3018018018024,28.175050050050068,0
1462,4,3,1,42,0.06976744186046512,0.023255813953488372,0.9767441860465116,43,1100,800,300,0.7272727272727273,14,8,6,363.030353590393,0.42536452565522337,0.23224749416913637,0.20289047395422144,129508.13140822176,805.872840506101,130314.00424872786,1313,0,305.8837209302326,37,6,17,36.29383011957342,0.6134572072072072,45.531798245614034,1017.8728070175438,27.510075865339022,0
1463,4,0,1,41,0.0,0.023809523809523808,0.9761904761904762,42,950,600,350,0.631578947368421,13,6,7,370.18245056390543,0.42369579945799457,0.23509301871972066,0.20602945631200026,129344.54038075257,1176.2157850418207,130520.75616579439,1314,1,314.1666666666667,36,6,19,36.27855271412229,0.6137152777777778,45.69256756756758,1017.2297297297314,28.256381381381427,0
1464,4,0,0,41,0.0,0.0,1.0,41,1500,1200,300,0.8,18,12,6,375.53017861694457,0.42304369918699186,0.24796655432978132,0.20855930147461937,129260.23046339175,1508.2234867969942,130768.45395018875,1315,2,322.5853658536585,35,6,19,36.2285643827301,0.6148809523809524,45.77546296296297,1016.8981481481491,29.05423280423283,0
1465,4,0,0,41,0.0,0.0,1.0,41,1200,800,400,0.6666666666666666,16,8,8,372.86692585138263,0.42281504065040654,0.24924328951027785,0.20752353303854257,129344.54038075257,1445.660229486266,130790.20061023884,1316,3,323.5853658536585,36,5,19,36.210284512343634,0.6137152777777778,45.69256756756758,1017.2297297297314,28.256381381381427,0
1466,4,0,1,40,0.0,0.024390243902439025,0.975609756097561,41,1300,700,600,0.5384615384615384,19,7,12,368.47410077288896,0.42266260162601627,0.24716148023549156,0.20549517158488073,129424.43828870442,1337.9107032933416,130762.34899199776,1317,4,324.5853658536585,37,4,19,36.240571120689644,0.6126126126126126,45.61403508771931,1017.5438596491244,27.50118539592228,0
1467,4,1,0,41,0.024390243902439025,0.0,1.0,41,1100,800,300,0.7272727272727273,14,8,6,368.1278812768229,0.42339939024390244,0.2617780416159172,0.20641146849003977,129636.22708013741,1344.5419223464169,130980.76900248382,1318,0,325.2439024390244,38,3,18,36.03366729612534,0.6129385964912281,45.40598290598291,1018.3760683760689,26.799370220422865,0
1468,4,1,0,42,0.023809523809523808,0.0,1.0,42,1100,800,300,0.7272727272727273,14,8,6,353.0141477058467,0.42629694154084397,0.20641755600698142,0.193479653073029,128736.86814230957,690.6966948830366,129427.5648371926,1319,0,318.4761904761905,40,2,17,37.334351425328805,0.6005208333333334,46.29065040650407,1014.8373983739846,25.370934959349615,8
1469,4,0,0,42,0.0,0.0,1.0,42,850,500,350,0.5882352941176471,12,5,7,353.43663293412914,0.42587349980642664,0.2087081503940047,0.19408897891033633,128814.23017259905,705.5335572410688,129519.76372984012,1320,1,319.4761904761905,40,2,17,37.24471919111022,0.6013020833333333,46.21443089430895,1015.1422764227648,25.37855691056912,0
1470,4,2,0,44,0.045454545454545456,0.0,1.0,44,1150,900,250,0.782608695652174,14,9,5,341.1590974276836,0.43032064834390416,0.20542065472421922,0.189696892214345,129307.31336805536,24.616088100647943,129331.92945615601,1321,0,305.90909090909093,39,5,19,37.05448586644817,0.607905982905983,45.72916666666666,1017.0833333333318,26.07905982905979,0
1471,4,0,0,44,0.0,0.0,1.0,44,1400,1200,200,0.8571428571428571,16,12,4,341.8719581719438,0.43035368217054265,0.19813835974650829,0.19073370413373594,129439.78000217005,50.36621093749085,129490.14621310754,1322,1,306.90909090909093,39,5,16,36.90170010577678,0.6092414529914529,45.59895833333333,1017.604166666666,26.09241452991451,0
1472,4,1,1,44,0.022222222222222223,0.022222222222222223,0.9777777777777777,45,1600,1200,400,0.75,20,12,8,325.7196367014485,0.430050505050505,0.22107789563913016,0.1677116500791471,126214.17451625512,-713.4544356512041,125500.72008060392,1323,0,301.06666666666666,42,3,18,40.60631629701062,0.5719246031746033,48.788759689922486,1004.8449612403108,23.92488002953121,8
1473,4,2,0,46,0.043478260869565216,0.0,1.0,46,1050,700,350,0.6666666666666666,14,7,7,334.197406958153,0.4335346215780998,0.256572086165354,0.17491111039498136,126882.03125,-719.2708333333339,126162.76041666667,1324,0,295.3695652173913,44,2,18,39.707402812241526,0.5759943181818181,48.125,1007.5,22.897727272727273,0
1474,4,1,3,44,0.02127659574468085,0.06382978723404255,0.9361702127659575,47,1300,900,400,0.6923076923076923,17,9,8,364.04378368980935,0.4363822078322541,0.2003336926188961,0.18278295898850738,125173.67139274713,-199.45505401232322,124974.21633873481,1325,0,290.06382978723406,41,6,15,40.71897409206569,0.5627540650406504,49.8263888888889,1000.6944444444463,24.407181571815762,8
1475,4,1,0,45,0.022222222222222223,0.0,1.0,45,1150,900,250,0.782608695652174,14,9,5,342.34151273069574,0.4386153198653198,0.13809095002251204,0.17163442432841455,125112.63797581391,-242.17501214612884,124870.46296366779,1326,0,289.93333333333334,36,9,21,41.32499437190453,0.5706018518518519,49.8873873873874,1000.4504504504525,27.790290290290347,8
1476,4,4,1,48,0.08163265306122448,0.02040816326530612,0.9795918367346939,49,1500,1100,400,0.7333333333333333,19,11,8,324.2438019336906,0.4471371882086168,0.14023699401611833,0.16341555910243766,125330.50272861739,-1653.4847330247237,123677.01799559266,1327,0,267.18367346938777,40,9,17,41.55291112689877,0.5658854166666667,49.66971544715448,1001.3211382113834,25.033028455284587,8
1477,4,1,1,48,0.02040816326530612,0.02040816326530612,0.9795918367346939,49,1300,800,500,0.6153846153846154,18,8,10,323.6114473837512,0.44467474489795916,0.16331910983821563,0.1640008270348696,125559.56792418573,-1673.4972982351414,123886.07062595058,1328,0,268.14285714285717,40,9,18,41.33268268775772,0.5682291666666667,49.441056910569124,1002.2357723577268,25.05589430894317,0
1478,4,4,4,48,0.07692307692307693,0.07692307692307693,0.9230769230769231,52,1150,800,350,0.6956521739130435,15,8,7,311.2967538136487,0.4506190296631473,0.1965561079275926,0.16088692503321425,126367.80876992013,-2530.5580922598256,123837.2506776603,1329,0,253.46153846153845,41,11,11,40.811030258181226,0.5749491869918699,48.6359126984127,1005.4563492063502,24.523325590398784,0
1479,4,4,3,49,0.07692307692307693,0.057692307692307696,0.9423076923076923,52,1100,800,300,0.7272727272727273,14,8,6,312.7231351035892,0.4515538587229764,0.20166233037251757,0.1622161285465726,126517.47453900528,-2487.0117433547566,124030.46279565053,1330,0,254.30769230769232,41,11,13,40.62171301318082,0.5764735772357723,48.48710317460317,1006.0515873015862,24.537843592721615,0
1480,4,1,0,50,0.02,0.0,1.0,50,2000,1600,400,0.8,24,16,8,320.33229170685274,0.44787414965986394,0.2197515527950309,0.16636612569291387,126567.38281250003,-1891.2760416666658,124676.10677083336,1331,0,265.06,41,9,14,40.379140786749474,0.5769817073170731,48.4375,1006.2500000000002,24.542682926829272,0
1481,4,1,0,51,0.0196078431372549,0.0,1.0,51,1100,700,400,0.6363636363636364,15,7,8,320.4164665040707,0.44929738562091504,0.23603688182320393,0.16806110277906383,126969.90983301777,-2063.3500277928033,124906.55980522497,1332,0,260.84313725490193,42,9,16,39.96450661795342,0.5796130952380952,48.03779069767442,1007.8488372093017,23.996400885935753,0
1482,4,1,3,49,0.019230769230769232,0.057692307692307696,0.9423076923076923,52,1250,700,550,0.56,18,7,11,316.3251714831667,0.4506425967823027,0.2459404076636429,0.16715234846494725,127271.40472147852,-2347.994162944317,124923.4105585342,1333,0,256.8076923076923,40,12,17,39.7591650720113,0.5856770833333333,47.73882113821138,1009.0447154471537,25.226117886178844,0
1483,4,0,1,48,0.0,0.02040816326530612,0.9795918367346939,49,1250,600,650,0.48,19,6,13,332.61485911752925,0.44708404195011336,0.22954613482365094,0.1744467916249342,126967.00330884651,-1353.7776163706417,125613.22569247587,1334,1,273.16326530612247,41,8,19,39.66013305115333,0.5810467479674797,48.040674603174594,1007.8373015873001,24.581397599690245,0
1484,4,1,0,49,0.02040816326530612,0.0,1.0,49,1150,800,350,0.6956521739130435,15,8,7,332.286046035107,0.4481823979591837,0.22567043346264137,0.17481135465325187,127092.01388888882,-1353.7579325711827,125738.25595631763,1335,0,273.9183673469388,40,9,20,39.54028925619835,0.5838541666666667,47.916666666666664,1008.3333333333327,25.208333333333318,0
1485,4,1,1,49,0.02,0.02,0.98,50,1650,1100,550,0.6666666666666666,22,11,11,325.00878103759055,0.4495238095238095,0.23710805500982368,0.17268211852623544,127492.4611048122,-1712.766124968514,125779.69497984368,1336,0,269.42,41,9,17,39.31401440733464,0.5863821138211383,47.519841269841265,1009.9206349206341,24.632210607820344,0
1486,4,1,1,49,0.02,0.02,0.98,50,1650,1400,250,0.8484848484848485,19,14,5,324.06881462699545,0.45226190476190475,0.2521624988023381,0.1737188607222369,127850.36886492708,-1713.5365024637847,126136.83236246329,1337,0,268.96,42,8,18,38.97212640924917,0.5885416666666667,47.16569767441861,1011.3372093023263,24.079457364341103,0
1487,4,1,0,50,0.02,0.0,1.0,50,1750,1400,350,0.8,21,14,7,328.37135260546296,0.45259353741496594,0.26576131687242754,0.17732053040695034,128144.53125000029,-1584.2013888888598,126560.32986111143,1338,0,269.9,43,7,19,38.563100137174246,0.5901162790697674,46.875000000000014,1012.5000000000023,23.54651162790703,0
1488,4,2,2,50,0.038461538461538464,0.038461538461538464,0.9615384615384616,52,1550,1100,450,0.7096774193548387,20,11,9,323.1654354537715,0.4555445575666164,0.28155876381682887,0.17716947506388442,128747.91843820861,-2078.6245748299298,126669.29386337868,1339,0,260.4807692307692,41,11,19,38.080400782013676,0.5990853658536586,46.279761904761905,1014.8809523809523,24.75319396051103,0
1489,4,1,0,51,0.0196078431372549,0.0,1.0,51,1050,800,250,0.7619047619047619,13,8,5,331.89120220557993,0.45132352941176473,0.2882258672699849,0.18166676331252815,128685.30636525885,-1658.0957928481691,127027.21057241068,1340,0,266.3921568627451,40,11,20,37.92275974893161,0.6,46.34146341463415,1014.634146341464,25.3658536585366,0
1490,4,0,0,51,0.0,0.0,1.0,51,1800,1300,500,0.7222222222222222,23,13,10,331.4925816857717,0.45145424836601306,0.287409246900167,0.18208070791145997,128823.44148596932,-1659.1969600340233,127164.2445259353,1341,1,267.3921568627451,41,10,21,37.79225300498387,0.5998475609756098,46.20535714285714,1015.1785714285709,24.76045296167246,0
1491,4,1,4,48,0.019230769230769232,0.07692307692307693,0.9230769230769231,52,1500,1300,200,0.8666666666666667,17,13,4,343.46963511388225,0.4524336978381096,0.30266394255563944,0.18246236232488144,127486.1992730034,-1534.2975504003757,125951.90172260303,1342,0,263.2307692307692,39,13,16,38.85432783221592,0.5894764957264957,47.526041666666664,1009.8958333333327,25.89476495726494,8
1492,4,2,2,48,0.04,0.04,0.96,50,800,600,200,0.75,10,6,4,349.0158920026613,0.45232993197278915,0.3077100065118292,0.1858862675671979,127590.03371229615,-1093.8101146506597,126496.2235976455,1343,0,273.34,37,13,18,38.60791549091961,0.5940315315315315,47.42324561403509,1010.3070175438602,27.30559506875298,0
1493,4,1,1,48,0.02040816326530612,0.02040816326530612,0.9795918367346939,49,1450,900,550,0.6206896551724138,20,9,11,347.7086100712474,0.45059169501133783,0.303375196232339,0.18612637362637344,127793.20987654309,-913.0401234568069,126880.16975308627,1344,0,277.3469387755102,38,11,20,38.432921245421234,0.5942982456140351,47.222222222222214,1011.1111111111102,26.6081871345029,0
1494,4,3,0,51,0.058823529411764705,0.0,1.0,51,950,600,350,0.631578947368421,13,6,7,328.6296463251966,0.4543300653594771,0.30665030833046214,0.1789900586280438,128487.53390842032,-1754.072928722976,126733.46097969734,1345,0,262.4313725490196,39,12,16,38.20689492790849,0.5996260683760684,46.53645833333334,1013.8541666666681,25.99626068376072,0
1495,4,0,0,51,0.0,0.0,1.0,51,1750,1400,350,0.8,21,14,7,334.6950796785769,0.4545751633986928,0.303323793077074,0.18338579675077074,128725.26584201411,-1583.2573784722017,127142.0084635419,1346,1,263.4313725490196,39,12,19,37.810938890029426,0.6020299145299146,46.30208333333334,1014.7916666666684,26.02029914529919,0
1496,4,0,1,50,0.0,0.0196078431372549,0.9803921568627451,51,1900,1200,700,0.631578947368421,26,12,14,333.5571220644241,0.4544934640522876,0.30228545517716565,0.18317218759216797,128814.23017259917,-1606.6192205366956,127207.61095206247,1347,2,264.4313725490196,40,11,19,37.749232489071325,0.6013020833333333,46.214430894308954,1015.1422764227657,25.37855691056914,0
1497,4,2,1,51,0.038461538461538464,0.019230769230769232,0.9807692307692307,52,1600,1100,500,0.6875,21,11,10,328.73982479762856,0.4553088863750629,0.30434405823590605,0.18279132399339687,129307.31336805565,-1897.1454088588052,127410.16795919684,1348,0,260.25,39,13,21,37.37027174655195,0.607905982905983,45.72916666666667,1017.0833333333342,26.07905982905985,0
1498,4,2,1,52,0.03773584905660377,0.018867924528301886,0.9811320754716981,53,1000,300,700,0.3,17,3,14,326.9338746962004,0.4545990566037736,0.3250335548992038,0.18357749165714385,129692.62390318264,-2119.817589563085,127572.80631361956,1349,0,256.20754716981133,40,13,17,37.02525857195119,0.61015625,45.35060975609756,1018.5975609756098,25.464939024390244,0
1499,4,0,1,51,0.0,0.019230769230769232,0.9807692307692307,52,2200,1700,500,0.7727272727272727,27,17,10,333.70776001209214,0.45410696329813977,0.32277719212675215,0.18731311580931342,129678.39084201398,-1745.0629340277733,127933.32790798621,1350,1,262.11538461538464,39,13,17,36.86720188177541,0.6116452991452992,45.364583333333336,1018.5416666666674,26.11645299145301,0
1500,4,0,1,50,0.0,0.0196078431372549,0.9803921568627451,51,1600,1200,400,0.75,20,12,8,336.56602026451304,0.4537418300653595,0.3255555761153155,0.1893705094550242,129772.26382725182,-1464.613124589086,128307.65070266274,1351,2,267.52941176470586,38,13,17,36.699171647268535,0.6143092105263157,45.2724358974359,1018.9102564102566,26.81342780026991,0
1501,4,0,0,50,0.0,0.0,1.0,50,650,400,250,0.6153846153846154,9,4,5,347.69657524961167,0.4516156462585034,0.3305791173304633,0.19529027715047698,129703.52055440123,-980.5060210834265,128723.01453331781,1352,3,273.76,37,13,17,36.48546824542518,0.615427927927928,45.339912280701746,1018.640350877192,27.53082029397816,0
1502,4,0,1,49,0.0,0.02,0.98,50,1450,1200,250,0.8275862068965517,17,12,5,354.6629232989918,0.4516581632653061,0.2539821826280626,0.19002822501342137,127831.16731596446,-867.3203915808654,126963.84692438359,1353,4,274.76,36,14,15,38.21826280623607,0.5983796296296297,47.184684684684676,1011.26126126126,28.090590590590555,8
1503,4,1,2,48,0.02,0.04,0.96,50,1600,1200,400,0.75,20,12,8,354.7900895866145,0.4527551020408163,0.25325102880658434,0.1915866483767719,128144.53124999999,-907.118055555557,127237.41319444442,1354,0,275.58,36,14,16,37.89437585733882,0.6015625,46.875,1012.4999999999999,28.124999999999996,0
1504,4,1,0,49,0.02040816326530612,0.0,1.0,49,1700,1300,400,0.7647058823529411,21,13,8,360.08757151846976,0.45259353741496594,0.27100586752170575,0.19587869263097854,128437.6674489882,-550.2384473594191,127887.42900162879,1355,0,279.1224489795918,35,14,14,37.4605122935221,0.6065476190476191,46.58564814814814,1013.6574074074063,28.96164021164018,0
1505,4,1,1,49,0.02,0.02,0.98,50,1700,1200,500,0.7058823529411765,22,12,10,352.7028553792566,0.45255102040816325,0.2772227151730251,0.1939005453719132,128858.14868922973,-910.2726036847762,127947.87608554495,1356,0,274.52,36,14,15,37.2185559006211,0.6087962962962963,46.17117117117117,1015.315315315315,28.203203203203195,0
1506,4,0,1,48,0.0,0.02040816326530612,0.9795918367346939,49,1150,600,550,0.5217391304347826,17,6,11,360.71324667220466,0.45059169501133783,0.2791769685286849,0.19737904621276783,128672.41753472202,-517.230902777799,128155.18663194422,1357,1,281.0816326530612,35,14,15,37.20482546201233,0.6089285714285715,46.35416666666666,1014.5833333333317,28.98809523809519,0
1507,4,0,0,48,0.0,0.0,1.0,48,1200,800,400,0.6666666666666666,16,8,8,364.3326412084318,0.4495142582742317,0.27711421512732803,0.1999497661700844,128789.87295310364,-215.52908521947018,128574.34386788416,1358,2,263.7916666666667,35,13,15,36.99306347396428,0.6101190476190477,46.23842592592593,1015.0462962962969,29.001322751322768,0
1508,4,0,0,48,0.0,0.0,1.0,48,1150,800,350,0.6956521739130435,15,8,7,362.6561472715318,0.449431146572104,0.27566239316239294,0.19976821671736938,128936.76757812512,-248.05772569442962,128688.7098524307,1359,3,264.7916666666667,35,13,15,36.885683760683754,0.6116071428571428,46.09375000000001,1015.6250000000009,29.017857142857167,0
1509,4,0,1,47,0.0,0.020833333333333332,0.9791666666666666,48,1450,1000,450,0.6896551724137931,19,10,9,361.2930013045767,0.4494219119385343,0.2758996527008044,0.19948503413524454,129029.7117218572,-276.4936389091603,128753.21808294803,1360,4,265.7916666666667,36,12,15,36.825491391413564,0.6105324074074074,46.00225225225226,1015.9909909909927,28.22197197197202,0
1510,4,0,0,47,0.0,0.0,1.0,47,1300,1000,300,0.7692307692307693,16,10,6,363.5852164344451,0.44917900092506935,0.26773108570270243,0.20147843761533088,129172.76810171679,-6.938230460165755,129165.82987125663,1361,5,250.82978723404256,36,11,17,36.62138584247259,0.6119791666666667,45.8614864864865,1016.5540540540558,28.23761261261266,0
1511,4,1,1,47,0.020833333333333332,0.020833333333333332,0.9791666666666666,48,1050,400,650,0.38095238095238093,17,4,13,353.63922688227836,0.4500313977541371,0.2667630084448871,0.19768367172473197,129516.4267941929,-439.57902158914885,129076.84777260375,1362,0,246.58333333333334,36,12,15,36.52436663347716,0.6154513888888888,45.52364864864865,1017.9054054054059,28.275150150150164,0
1512,4,1,1,47,0.020833333333333332,0.020833333333333332,0.9791666666666666,48,1400,1100,300,0.7857142857142857,17,11,6,355.2119630335517,0.4488493646572104,0.2740763773723973,0.19943464963615612,129688.42734203805,-386.62382822010346,129301.80351381794,1363,0,247.5625,36,12,16,36.309425096738536,0.6171875,45.35472972972973,1018.5810810810816,28.293918918918934,0
1513,4,0,0,47,0.0,0.0,1.0,47,900,500,400,0.5555555555555556,13,5,8,364.1009154935657,0.44819611470860315,0.26515697474764655,0.20403565952308217,129613.56122470846,38.48326045953303,129652.044485168,1364,1,253.31914893617022,35,12,16,36.15925968023036,0.618452380952381,45.42824074074074,1018.2870370370367,29.093915343915334,0
1514,4,0,1,46,0.0,0.02127659574468085,0.9787234042553191,47,1400,1000,400,0.7142857142857143,18,10,8,365.13636363636346,0.4482924761023743,0.2659381044487428,0.20492346938775516,129672.49657064478,69.62877229081596,129742.1253429356,1365,2,254.31914893617022,35,12,17,36.072916666666664,0.6190476190476191,45.370370370370374,1018.518518518519,29.100529100529116,0
1515,4,0,0,46,0.0,0.0,1.0,46,1700,1100,600,0.6470588235294118,23,11,12,375.15139241228525,0.4482085346215781,0.2726163060774687,0.21022814970976317,129613.56122470835,524.9415937928507,130138.5028185012,1366,3,260.5,35,11,18,35.877945745245135,0.618452380952381,45.42824074074073,1018.2870370370358,29.09391534391531,0
1516,4,0,0,46,0.0,0.0,1.0,46,1500,1100,400,0.7333333333333333,19,11,8,361.8266574969896,0.44811795491143314,0.09428715874620797,0.20293756007439864,129647.68005540175,194.88421947969556,129842.56427488144,1367,4,261.5,37,9,17,36.182439707149015,0.6148648648648649,45.39473684210527,1018.4210526315796,27.524893314367016,8
1517,4,1,1,46,0.02127659574468085,0.02127659574468085,0.9787234042553191,47,1150,800,350,0.6956521739130435,15,8,7,357.15119373916355,0.44931390687634903,0.11283637433259952,0.20249878846921218,130071.79578493678,-108.94057272262819,129962.85521221416,1368,0,256.9148936170213,38,9,18,35.87051389470744,0.6173245614035088,44.97863247863248,1020.0854700854699,26.844354475933418,0
1518,4,0,1,45,0.0,0.021739130434782608,0.9782608695652174,46,1250,700,550,0.56,18,7,11,372.1652892561982,0.44884259259259257,-0.031067193675889393,0.20886827458256035,129672.49657064478,545.7115303447282,130218.20810098952,1369,1,262.30434782608694,35,11,14,35.89393939393939,0.6190476190476191,45.370370370370374,1018.518518518519,29.100529100529116,8
1519,4,1,2,44,0.021739130434782608,0.043478260869565216,0.9565217391304348,46,1350,900,450,0.6666666666666666,18,9,9,356.88812997474787,0.4490237520128824,-0.00705560038280395,0.19735317354450793,129089.93632656158,14.133194829131725,129104.06952139072,1370,0,263.1521739130435,37,9,21,36.87598906632139,0.6092342342342343,45.94298245614033,1016.228070175435,27.465623518255,8
1520,4,0,0,44,0.0,0.0,1.0,44,1000,700,300,0.7,13,7,6,356.92711995724466,0.44747621564482026,0.002820289053021341,0.19823611564855534,129261.91184807238,427.5125666609871,129689.42441473337,1371,1,271.84090909090907,34,10,21,36.69978732537266,0.6170343137254901,45.77380952380951,1016.9047619047604,29.90896358543413,0
1521,4,0,0,44,0.0,0.0,1.0,44,1150,600,550,0.5217391304347826,17,6,11,356.8824331092966,0.44739913671599724,0.002094322060192333,0.19879572794871456,129377.9538001543,434.5437885802457,129812.49758873454,1372,2,272.84090909090907,35,9,21,36.582764505119464,0.6160714285714286,45.65972222222222,1017.361111111111,29.067460317460313,0
1522,4,0,0,44,0.0,0.0,1.0,44,1000,700,300,0.7,13,7,6,373.54191914819893,0.44749823819591267,-0.04952900717703301,0.2027798989661656,128355.55555555588,861.9357638889269,129217.49131944482,1373,3,273.84090909090907,34,10,20,37.20360471491229,0.607843137254902,46.666666666666686,1013.333333333336,29.80392156862753,7
1523,4,1,2,43,0.022222222222222223,0.044444444444444446,0.9555555555555556,45,1300,900,400,0.6923076923076923,17,9,8,370.3914513098716,0.4487373737373737,-0.1352794914183565,0.20078859855598116,128299.67928501074,560.470882593257,128860.150167604,1374,0,268.73333333333335,33,12,20,37.34060622555542,0.6095328282828283,46.72181372549021,1013.1127450980407,30.70038621509214,8
1524,4,0,1,42,0.0,0.023255813953488372,0.9767441860465116,43,1450,1100,350,0.7586206896551724,18,11,7,379.32242056110834,0.44652085640457734,-0.1281939781878899,0.2053255369595961,128240.42986685043,1128.8940541781612,129369.3239210286,1375,1,281.25581395348837,32,11,20,37.17511219147346,0.611328125,46.78030303030304,1012.8787878787888,31.65246212121215,0
1525,4,0,1,41,0.0,0.023809523809523808,0.9761904761904762,42,1500,1200,300,0.8,18,12,6,386.35483508567887,0.4443113627564847,-0.11603623454523204,0.209320377226085,128276.4010959201,1512.0415581597174,129788.44265407982,1376,2,288.7857142857143,31,11,21,36.960154241645256,0.614247311827957,46.744791666666664,1013.0208333333329,32.67809139784945,0
1526,4,1,0,42,0.023809523809523808,0.0,1.0,42,1600,1400,200,0.875,18,14,4,377.3711471654207,0.44581155632984903,-0.10005450301543839,0.20691059214977164,128752.49496224873,1317.495344862772,130069.99030711151,1377,0,281.2857142857143,32,10,18,36.700412623372316,0.6165364583333333,46.275252525252526,1014.8989898989898,31.715593434343432,0
1527,4,1,0,43,0.023255813953488372,0.0,1.0,43,1200,800,400,0.6666666666666666,16,8,8,366.4755161264422,0.44712070874861576,-0.08242006252015077,0.2030670946071368,129170.24289035458,867.5462862841146,130037.78917663869,1378,0,275.72093023255815,33,10,20,36.55050733373519,0.6183712121212122,45.86397058823529,1016.5441176470581,30.804367201426004,0
1528,4,0,2,41,0.0,0.046511627906976744,0.9534883720930233,43,950,800,150,0.8421052631578947,11,8,3,382.3148606345685,0.44721299372462164,-0.22129791851047187,0.20972634442479415,128772.40997331798,1250.9205373061682,130023.33051062415,1379,1,276.72093023255815,36,7,16,36.554606309404925,0.6079282407407407,46.255630630630634,1014.977477477478,28.193818818818833,8
1529,4,1,2,40,0.023809523809523808,0.047619047619047616,0.9523809523809523,42,1300,800,500,0.6153846153846154,18,8,10,401.09177531798673,0.4449283778552071,-0.20144663197611012,0.2115064153805541,127187.51793503213,1937.0177260687042,129124.53566110083,1380,0,284.2142857142857,32,10,18,37.707316309926135,0.6005859375,47.821969696969695,1008.712121212121,31.522253787878782,8
1530,4,2,1,41,0.047619047619047616,0.023809523809523808,0.9761904761904762,42,1050,600,450,0.5714285714285714,15,6,9,382.6083178736063,0.44547280294231517,-0.14425648135167268,0.197907551224977,126401.93527094864,1380.6704798631492,127782.6057508118,1381,0,282.57142857142856,37,5,18,38.98327608766764,0.5819256756756757,48.60197368421052,1005.592105263157,27.17816500711235,8
1531,4,1,0,42,0.023809523809523808,0.0,1.0,42,600,400,200,0.6666666666666666,8,4,4,377.8361056400601,0.444904181184669,-0.11833530356763966,0.19720283121612447,126769.03558514139,1179.5837442472105,127948.6193293886,1382,0,281.07142857142856,38,4,19,38.72467112242734,0.5838815789473684,48.23717948717949,1007.0512820512824,26.501349527665326,0
1532,4,0,0,42,0.0,0.0,1.0,42,1000,700,300,0.7,13,7,6,379.58953639707045,0.44460172280294236,-0.12077116265327204,0.1984124765924145,126829.56271701379,1228.6349826388794,128058.19769965266,1383,1,282.07142857142856,39,3,19,38.61814891416752,0.5827991452991452,48.17708333333333,1007.2916666666658,25.82799145299143,0
1533,4,3,2,43,0.06666666666666667,0.044444444444444446,0.9555555555555556,45,1050,500,550,0.47619047619047616,16,5,11,361.7968696256447,0.4501262626262626,-0.08618739221148841,0.1925612108527479,127562.34039560263,231.68742425555564,127794.02781985818,1384,0,264.2,37,8,18,38.31350175476681,0.59375,47.45065789473685,1010.1973684210537,27.3026315789474,0
1534,4,1,2,42,0.022727272727272728,0.045454545454545456,0.9545454545454546,44,1150,800,350,0.6956521739130435,15,8,7,356.1994324356958,0.4476083509513742,-0.07611138861138833,0.19067146089204923,127793.20987654345,303.97376543212624,128097.18364197557,1385,0,268.8863636363636,38,6,20,38.21829212454213,0.5942982456140351,47.222222222222236,1011.111111111113,26.608187134502973,0
1535,4,1,1,42,0.023255813953488372,0.023255813953488372,0.9767441860465116,43,1300,900,400,0.6923076923076923,17,9,8,358.2660253582256,0.4459902177925434,-0.05610402291835692,0.19308213912400937,128065.44189453169,576.2993706597649,128641.74126519145,1386,0,274.5348837209302,39,4,22,37.887315186443004,0.5953525641025641,46.95312500000002,1012.1875000000035,25.95352564102573,0
1536,4,1,0,43,0.023255813953488372,0.0,1.0,43,1200,900,300,0.75,15,9,6,362.41184408105795,0.44306016980435586,-0.02656402383222367,0.19688653660893718,128385.7160572562,705.8228923079589,129091.53894956416,1387,0,275.3720930232558,34,9,17,37.454726105172476,0.6081495098039216,46.63690476190476,1013.4523809523806,29.807422969187666,0
1537,4,3,0,46,0.06521739130434782,0.0,1.0,46,800,600,200,0.75,10,6,4,339.72585793893103,0.44619565217391305,0.001048375369980592,0.1879951628200565,129117.79495854476,-427.06926650509456,128690.72569203968,1388,0,258.3478260869565,37,9,20,37.2836650843313,0.6095157657657657,45.91557017543859,1016.3377192982441,27.468587008060652,0
1538,4,1,3,44,0.02127659574468085,0.06382978723404255,0.9361702127659575,47,1450,1000,450,0.6896551724137931,19,10,9,332.1339604725549,0.4472325007708911,0.013530273471081378,0.1853599090286098,129452.33298947738,-800.869738765794,128651.46325071159,1389,0,253.82978723404256,37,10,14,37.13669055058721,0.6128941441441442,45.586622807017534,1017.6535087719286,27.5041488857278,0
1539,4,2,1,45,0.043478260869565216,0.021739130434782608,0.9782608695652174,46,1300,800,500,0.6153846153846154,18,8,10,331.0535490539723,0.44994967793880836,4.6821301815658245e-06,0.18541394792009527,129591.85157933176,-619.6315212373431,128972.22005809442,1390,0,236.6304347826087,37,9,16,37.02257879244741,0.6143018018018018,45.44956140350875,1018.2017543859622,27.518966334755735,0
1540,4,1,2,44,0.021739130434782608,0.043478260869565216,0.9565217391304348,46,800,600,200,0.75,10,6,4,333.64208652891364,0.45136876006441223,0.006332194505545674,0.18739631099477636,129703.52055440111,-545.0893544167736,129158.43119998433,1391,0,237.47826086956522,37,9,17,36.84337997847146,0.615427927927928,45.33991228070174,1018.640350877191,27.530820293978138,0
1541,4,0,0,44,0.0,0.0,1.0,44,650,500,150,0.7692307692307693,8,5,3,348.53380732149856,0.4492710535588442,0.0035061773109577032,0.19440441252821336,129430.46932067175,222.17885114841096,129652.64817182015,1392,1,249.13636363636363,36,8,17,36.74169064482808,0.6145833333333333,45.60810810810809,1017.5675675675653,28.265765765765703,0
1542,4,0,2,42,0.0,0.045454545454545456,0.9545454545454546,44,1500,1100,400,0.7333333333333333,19,11,8,349.84660632575765,0.4484452078928823,0.010414676574393544,0.19584911255672893,129573.74762854056,266.18717535100967,129839.93480389156,1393,2,250.13636363636363,36,8,18,36.562603694281606,0.6160300925925926,45.467342342342334,1018.1306306306294,28.281406406406372,0
1543,4,0,0,42,0.0,0.0,1.0,42,850,600,250,0.7058823529411765,11,6,5,354.1307056205369,0.4460293263646922,0.019878850639987178,0.19835493943500027,129595.04145408173,778.7166950113475,130373.75814909308,1394,3,260.6904761904762,34,8,18,36.43190498460579,0.6204044117647058,45.44642857142858,1018.2142857142866,29.947478991596665,0
1544,4,0,0,42,0.0,0.0,1.0,42,1200,500,700,0.4166666666666667,19,5,14,354.98930020429157,0.44558168795973674,0.02477236804025007,0.19929714255563766,129685.96938775507,807.4263038548678,130493.39569160994,1395,4,261.6904761904762,34,8,18,36.31759389122644,0.6213235294117647,45.357142857142854,1018.5714285714283,29.957983193277304,0
1545,4,0,0,42,0.0,0.0,1.0,42,1550,900,650,0.5806451612903226,22,9,13,351.17938361707365,0.4446380178087495,0.024782665109641,0.19828128274994758,129908.37191358015,724.2283950617203,130632.60030864188,1396,5,262.6904761904762,35,7,19,36.18869209809264,0.6214285714285714,45.138888888888886,1019.4444444444437,29.126984126984105,0
1546,4,1,0,43,0.023255813953488372,0.0,1.0,43,1300,1000,300,0.7692307692307693,16,10,6,344.5710959812018,0.4448366555924696,0.026768691510845155,0.19603564613167834,130205.11379200163,372.98375233343313,130578.09754433506,1397,0,257.5581395348837,36,7,20,36.05617161352017,0.6223958333333333,44.84797297297298,1020.6081081081095,28.350225225225262,0
1547,4,0,0,43,0.0,0.0,1.0,43,1200,900,300,0.75,15,9,6,352.9450799635282,0.4446059431524548,0.0255030536979155,0.2017265716860168,130384.14292800473,603.7137135411972,130987.85664154592,1398,1,258.5581395348837,34,9,20,35.660964758907404,0.6283700980392157,44.67261904761906,1021.3095238095254,30.038515406162514,0
1548,4,1,0,44,0.022727272727272728,0.0,1.0,44,1300,1100,200,0.8461538461538461,15,11,4,343.9261705836915,0.44538407329105006,0.03153421951520641,0.19836368428704335,130735.6234996574,192.6804698217154,130928.30396947912,1399,0,253.6590909090909,35,9,19,35.53549871736835,0.6297619047619047,44.328703703703724,1022.685185185188,29.2195767195768,0
1549,4,0,0,44,0.0,0.0,1.0,44,950,500,450,0.5263157894736842,14,5,9,348.7066482640886,0.44356721282593375,-0.013297203184284179,0.1940768424996616,129344.54038075224,221.9998213929444,129566.54020214519,1400,1,254.6590909090909,36,8,19,36.82469832835158,0.6137152777777778,45.69256756756756,1017.2297297297285,28.25638138138135,8
1550,4,0,2,42,0.0,0.045454545454545456,0.9545454545454546,44,1650,1100,550,0.6666666666666666,22,11,11,354.1820743485218,0.4431818181818182,-0.020625037719527617,0.19784286699393933,129487.77113261909,372.4494765035295,129860.22060912263,1401,2,255.6590909090909,36,8,14,36.53970273659364,0.615162037037037,45.5518018018018,1017.7927927927926,28.272022022022018,0
1551,4,0,0,42,0.0,0.0,1.0,42,1150,600,550,0.5217391304347826,17,6,11,366.6111428205337,0.4410448122338366,-0.009052494718023718,0.20421495217949875,129377.95380015431,1086.2798996913566,130464.23369984567,1402,3,268.26190476190476,35,7,20,36.33532423208191,0.6160714285714286,45.65972222222222,1017.3611111111111,29.067460317460316,0
1552,4,0,1,41,0.0,0.023809523809523808,0.9761904761904762,42,1100,700,400,0.6363636363636364,15,7,8,366.70867587212047,0.44001645373596593,0.0006190107418122537,0.2049894694624676,129516.42679419302,1098.9594746774035,130615.38626887042,1403,4,269.26190476190476,36,6,16,36.191780064166416,0.6154513888888888,45.52364864864866,1017.9054054054068,28.27515015015019,0
1553,4,1,1,41,0.023809523809523808,0.023809523809523808,0.9761904761904762,42,1050,800,250,0.7619047619047619,13,8,5,396.56393758635033,0.443996806039489,0.05849410233101038,0.21111929575644697,127572.62613378659,1751.9877813555113,129324.6139151421,1404,0,268.95238095238096,34,8,16,37.42487626679235,0.5998774509803921,47.440476190476176,1010.2380952380931,29.712885154061563,7
1554,4,0,2,39,0.0,0.04878048780487805,0.9512195121951219,41,1600,1200,400,0.75,20,12,8,403.1985622407877,0.44059959349593497,0.06433059963787424,0.21472667617009378,127586.77551903104,2088.5608900422817,129675.33640907332,1405,1,276.1951219512195,33,8,17,37.24274219634482,0.6022727272727273,47.42647058823529,1010.2941176470581,30.614973262032063,0
1555,4,0,0,39,0.0,0.0,1.0,39,1000,800,200,0.8,12,8,4,412.2115624999998,0.43851214574898784,0.07639102564102562,0.2192614694148937,127538.00632588522,2714.5281731456093,130252.53449903082,1406,2,289.56410256410254,32,7,18,37.065364583333334,0.6041666666666667,47.47474747474748,1010.101010101011,31.565656565656592,0
1556,4,1,0,40,0.025,0.0,1.0,40,1150,900,250,0.782608695652174,14,9,5,412.0057462532193,0.43864850427350427,0.10823447524512786,0.22231087327223034,128113.51290669465,2556.700698048843,130670.21360474349,1407,0,283.3,33,7,19,36.478004075374265,0.6076388888888888,46.90563725490197,1012.3774509803931,30.678104575163427,0
1557,4,1,0,41,0.024390243902439025,0.0,1.0,41,1900,1400,500,0.7368421052631579,24,14,10,401.56258976273887,0.4399390243902439,0.11952858886318474,0.21946624803767673,128624.38303489459,2130.155580756472,130754.53861565106,1408,0,277.3658536585366,32,9,17,36.217948717948715,0.615234375,46.40151515151516,1014.393939393941,31.699810606060655,0
1558,4,0,0,41,0.0,0.0,1.0,41,1300,1000,300,0.7692307692307693,16,10,6,397.50783087347537,0.43927845528455284,0.11826400458853392,0.21777576255829073,128720.46100206631,2033.478248393047,130753.93925045936,1409,1,278.3658536585366,32,9,17,36.22231554062461,0.6162109375,46.306818181818194,1014.7727272727288,31.711647727272776,0
1559,4,0,1,40,0.0,0.024390243902439025,0.975609756097561,41,1050,700,350,0.6666666666666666,14,7,7,395.08346583103196,0.43844004065040654,0.11436275115828565,0.2173746080926916,128890.09785899671,1984.4693146866762,130874.56717368339,1410,2,279.3658536585366,33,8,17,36.1101053986644,0.615530303030303,46.13970588235295,1015.4411764705897,30.770944741533018,0
1560,4,2,0,42,0.047619047619047616,0.0,1.0,42,650,300,350,0.46153846153846156,10,3,7,371.95034369549614,0.44008904374758034,0.12461709830130907,0.2078546038298361,129504.14540816336,1234.1977354667488,130738.3431436301,1411,0,271.8333333333333,34,8,17,36.07090643274854,0.6194852941176471,45.53571428571429,1017.8571428571436,29.936974789915986,0
1561,4,1,0,43,0.023255813953488372,0.0,1.0,43,700,400,300,0.5714285714285714,10,4,6,366.0865399045207,0.4418143226282761,0.12829263653941636,0.20607582463679042,129790.40745027442,902.9042352537807,130693.3116855282,1412,0,266.48837209302326,35,8,18,35.92874451007118,0.6202380952380953,45.25462962962963,1018.981481481482,29.113756613756628,0
1562,4,0,1,42,0.0,0.023255813953488372,0.9767441860465116,43,1050,700,350,0.6666666666666666,14,7,7,368.2851139977387,0.4414913252122554,0.13292280717505367,0.20778263926829504,129878.87577428418,966.4913140860821,130845.36708837027,1413,1,267.48837209302326,35,8,18,35.78273437795693,0.6211309523809524,45.167824074074076,1019.3287037037042,29.12367724867726,0
1563,4,0,0,42,0.0,0.0,1.0,42,1300,700,600,0.5384615384615384,19,7,12,369.6790880662843,0.4385041618273326,0.12161080648475675,0.2084119109802623,129849.38298396765,1200.520297496559,131049.90328146421,1414,2,274.5238095238095,35,7,18,35.77721629192217,0.6208333333333333,45.19675925925925,1019.2129629629619,29.120370370370342,0
1564,4,0,1,41,0.0,0.023809523809523808,0.9761904761904762,42,1050,900,150,0.8571428571428571,12,9,3,389.3777802689438,0.43829849012775846,0.17825790963488464,0.20293453724604957,126710.35640495871,1517.8339715547752,128228.19037651349,1415,3,275.5238095238095,32,10,20,38.494638826185096,0.595703125,48.29545454545455,1006.8181818181822,31.463068181818194,8
1565,4,1,0,42,0.023809523809523808,0.0,1.0,42,1100,600,500,0.5454545454545454,16,6,10,378.6872578703748,0.4398954703832753,0.18374747492287336,0.1990709310223371,127061.12320081229,1223.2856653690997,128284.40886618139,1416,0,275.6904761904762,33,9,22,38.402389489891014,0.5969065656565656,47.94730392156863,1008.2107843137262,30.551841948900794,0
1566,4,1,1,42,0.023255813953488372,0.023255813953488372,0.9767441860465116,43,1000,600,400,0.6,14,6,8,374.95390683413626,0.4412606127722407,0.20601473630147593,0.1992259926640953,127493.9344993513,960.8735222030081,128454.8080215543,1417,0,270.25581395348837,33,10,19,38.051485458884436,0.6013257575757576,47.51838235294118,1009.926470588236,30.60383244206776,0
1567,4,0,0,42,0.0,0.0,1.0,42,1650,1400,250,0.8484848484848485,19,14,5,380.4007890499171,0.43953252032520324,0.20509820236795084,0.2021201097717839,127493.9344993513,1299.7586565263446,128793.69315587764,1418,1,277.54761904761904,33,9,19,37.913961695587105,0.6013257575757576,47.51838235294118,1009.926470588236,30.60383244206776,0
1568,4,1,0,43,0.023255813953488372,0.0,1.0,43,1100,700,400,0.6363636363636364,15,7,8,373.308586548605,0.4412606127722407,0.20731804111437424,0.2003792204613706,127903.5732001134,949.500425170073,128853.07362528348,1419,0,272.06976744186045,34,9,20,37.67260994076342,0.6032475490196079,47.11309523809524,1011.5476190476193,29.751400560224095,0
1569,4,1,0,44,0.022727272727272728,0.0,1.0,44,1150,700,450,0.6086956521739131,16,7,9,327.70135432959677,0.44535103946441157,0.08425448840236083,0.1760747318995378,127943.71712805485,-392.9780013857438,127550.73912666911,1420,0,266.8636363636364,41,3,17,38.7849741779434,0.5909552845528455,47.073412698412696,1011.7063492063487,24.675764614788992,8
1570,4,0,2,42,0.0,0.045454545454545456,0.9545454545454546,44,1550,1200,350,0.7741935483870968,19,12,7,328.81779499794277,0.44535103946441157,0.07689583277645617,0.17722810155118912,128069.20750070858,-377.7131164966035,127691.49438421198,1421,1,267.8636363636364,41,3,17,38.628650886994016,0.5922256097560976,46.94940476190476,1012.2023809523806,24.687862950058065,0
1571,4,3,3,42,0.06666666666666667,0.06666666666666667,0.9333333333333333,45,1150,900,250,0.782608695652174,14,9,5,328.2469052494022,0.4470117845117845,0.12892712814496154,0.17972748109694264,128697.58204207616,-551.0612520471099,128146.52079002906,1422,0,262.5777777777778,41,4,16,38.002704992830154,0.5985772357723578,46.32936507936508,1014.6825396825403,24.748354626403422,0
1572,4,0,0,42,0.0,0.0,1.0,42,1300,900,400,0.6923076923076923,17,9,8,343.78659733332347,0.44208526906697637,0.126180202921522,0.18736947023754627,128513.9377170141,436.27387152780284,128950.21158854189,1423,1,280.3333333333333,39,3,17,37.7957845353058,0.5998931623931624,46.51041666666668,1013.9583333333351,25.998931623931668,0
1573,4,0,0,42,0.0,0.0,1.0,42,800,400,400,0.5,12,4,8,343.9404684582769,0.4418795973674023,0.1319537160658648,0.18782660355458503,128593.1654188372,445.678710937539,129038.84412977475,1424,2,281.3333333333333,39,3,17,37.71107202766082,0.6006944444444444,46.432291666666686,1014.2708333333366,26.006944444444528,0
1574,4,0,1,41,0.0,0.023809523809523808,0.9761904761904762,42,1100,700,400,0.6363636363636364,15,7,8,349.95052321364506,0.4413472706155633,0.13472515442958777,0.1919998816550543,128778.12500000026,613.1944444444747,129391.31944444474,1425,3,282.3333333333333,39,3,17,37.370005473453766,0.6025641025641026,46.250000000000014,1015.000000000002,26.02564102564108,0
1575,4,0,0,41,0.0,0.0,1.0,41,1350,1200,150,0.8888888888888888,15,12,3,355.3631301956011,0.4364075203252033,0.13108632507826612,0.19451778947940185,128685.9673483271,946.049633830084,129632.01698215719,1426,4,290.0975609756098,38,3,17,37.3266996595416,0.6033442982456141,46.340811965811966,1014.636752136752,26.700967161493473,0
1576,4,0,1,40,0.0,0.024390243902439025,0.975609756097561,41,1400,1000,400,0.7142857142857143,18,10,8,354.5730320887936,0.43597560975609756,0.12992559474158316,0.1948818695164725,128848.62075617303,937.2492283950806,129785.86998456811,1427,5,291.0975609756098,38,3,17,37.18080255357957,0.6049890350877193,46.180555555555564,1015.2777777777793,26.717836257309983,0
1577,4,1,0,41,0.024390243902439025,0.0,1.0,41,1400,900,500,0.6428571428571429,19,9,10,358.36213788300256,0.43551829268292686,0.13111475040942078,0.19806360651833965,129069.04432508702,1050.6917317708592,130119.73605685787,1428,0,291.8048780487805,39,2,18,36.85983683581072,0.6055021367521367,45.96354166666668,1016.1458333333351,26.055021367521412,0
1578,4,1,0,42,0.023809523809523808,0.0,1.0,42,600,400,200,0.6666666666666666,8,4,4,351.273753924619,0.4368466898954704,0.13605825252185455,0.1957153881678127,129386.78521050357,690.104166666677,130076.88937717024,1429,0,285.8333333333333,39,3,19,36.71643032661,0.6087072649572649,45.65104166666667,1017.3958333333342,26.087072649572672,0
1579,4,1,0,43,0.023255813953488372,0.0,1.0,43,1050,700,350,0.6666666666666666,14,7,7,343.2842582431056,0.43980712440014763,0.13814287570296413,0.19288572895901857,129718.50419723714,306.0640987507493,130024.56829598789,1430,0,280.16279069767444,40,3,18,36.58261838254857,0.6104166666666666,45.32520325203252,1018.6991869918702,25.467479674796756,0
1580,4,2,0,45,0.044444444444444446,0.0,1.0,45,950,600,350,0.631578947368421,13,6,7,341.06278647353633,0.44290824915824917,0.16121966931500986,0.1948870425284978,130374.54433094787,-101.12569929539586,130273.41863165247,1431,0,268.6666666666667,37,8,21,35.97407129053039,0.6221846846846847,44.682017543859644,1021.2719298245605,27.601944049312447,0
1581,4,0,0,45,0.0,0.0,1.0,45,1000,800,200,0.8,12,8,4,340.6811773762654,0.4423400673400673,0.15361773316603955,0.19534021465387272,130508.09500328716,-107.66970742933711,130400.42529585783,1432,1,269.6666666666667,38,7,14,35.84862505227938,0.6217105263157895,44.551282051282044,1021.7948717948706,26.889338731443964,0
1582,4,0,1,44,0.0,0.022222222222222223,0.9777777777777777,45,1400,1000,400,0.7142857142857143,18,10,8,341.1491907495638,0.44183501683501686,0.15535633432943996,0.19652115354446703,130688.28124999999,-83.159722222222,130605.12152777777,1433,2,270.6666666666667,39,6,16,35.65437381146428,0.6217948717948718,44.375,1022.4999999999999,26.217948717948715,0
1583,4,0,2,42,0.0,0.045454545454545456,0.9545454545454546,44,1150,700,450,0.6086956521739131,16,7,9,344.99944262782424,0.4404950669485553,0.1374902037617558,0.192403535311671,129424.43828870401,134.959314404409,129559.39760310842,1434,3,277.77272727272725,37,7,18,36.83773347701149,0.6126126126126126,45.61403508771929,1017.5438596491211,27.501185395922192,8
1584,4,0,0,42,0.0,0.0,1.0,42,1650,1200,450,0.7272727272727273,21,12,9,361.9533088072137,0.4360965931087882,0.14178659511613434,0.20086922412327043,129230.80800165032,955.1037112054121,130185.91171285574,1435,4,291.2857142857143,35,7,18,36.60370423069626,0.6145833333333333,45.804398148148145,1016.782407407407,29.050925925925917,0
1585,4,1,0,43,0.023255813953488372,0.0,1.0,43,1300,900,400,0.6923076923076923,17,9,8,355.9360787773421,0.43745385751199706,0.15173736377360592,0.1997758450611922,129675.5988020352,631.2448301400395,130306.84363217524,1436,0,285.48837209302326,37,6,17,36.30402895898376,0.6151463963963963,45.36732456140351,1018.5307017543856,27.527856804172586,0
1586,4,1,0,44,0.022727272727272728,0.0,1.0,44,1350,800,550,0.5925925925925926,19,8,11,352.1053894863955,0.4380835976039465,0.1534235957037955,0.1996623091627258,130076.56385633699,360.1318359375184,130436.6956922745,1437,0,279.97727272727275,39,5,18,35.9943539603118,0.6156517094017093,44.97395833333334,1020.1041666666681,26.15651709401713,0
1587,4,0,0,44,0.0,0.0,1.0,44,1100,800,300,0.7272727272727273,14,8,6,353.3527696793,0.4374779774489077,0.15426716141001817,0.20132890365448505,130262.58680555566,406.12792968750904,130668.71473524318,1438,1,280.97727272727275,36,8,19,35.77380952380952,0.622974537037037,44.79166666666667,1020.8333333333343,28.35648148148151,0
1588,4,0,0,44,0.0,0.0,1.0,44,1250,800,450,0.64,17,8,9,351.19792552812805,0.4367952783650458,0.16720337507901717,0.18487729522629293,127117.63340480233,167.7523299623519,127285.38573476468,1439,2,281.97727272727275,40,4,14,39.037253518761126,0.5841145833333333,47.89126016260164,1008.4349593495958,25.210873983739894,8
1589,4,2,1,45,0.043478260869565216,0.021739130434782608,0.9782608695652174,46,1450,1200,250,0.8275862068965517,17,12,5,337.7083858548526,0.44240136876006436,0.17410904177682873,0.17982367880095473,127581.01695360857,-582.9641397752524,126998.05281383332,1440,0,270.67391304347825,42,4,13,38.902743142144644,0.5858134920634921,47.43217054263566,1010.2713178294575,24.054078995939467,0
1590,4,1,0,46,0.021739130434782608,0.0,1.0,46,950,600,350,0.631578947368421,13,6,7,343.1038286846102,0.4403582930756844,0.19559800837482477,0.18369874049891788,127801.3746638574,-430.17180833483434,127371.20285552256,1441,0,271.6521739130435,42,4,15,38.54096789650213,0.5880456349206349,47.21414728682171,1011.1434108527136,24.0748431155408,0
1591,4,0,0,46,0.0,0.0,1.0,46,1350,1100,250,0.8148148148148148,16,11,5,344.97004118195974,0.4401469404186795,0.19265396034862503,0.18537479155845835,127948.38543544571,-372.32804143379644,127576.05739401192,1442,1,272.6521739130435,42,4,15,38.343429748108406,0.5895337301587302,47.06879844961241,1011.7248062015515,24.088685861941702,0
1592,4,1,0,47,0.02127659574468085,0.0,1.0,47,1800,1500,300,0.8333333333333334,21,15,6,342.44159284077693,0.44110391612704286,0.1996744388444649,0.18581930472352431,128338.88942992073,-609.3838679025886,127729.50556201814,1443,0,267.82978723404256,37,10,16,38.00849024275871,0.6016328828828829,46.68311403508772,1013.2675438596491,27.38560929350403,0
1593,4,0,0,47,0.0,0.0,1.0,47,1250,800,450,0.64,17,8,9,340.8276346619658,0.44156645081714463,0.24346098222476842,0.17659859196972696,126472.11192177466,-776.0733396353246,125696.03858213933,1444,1,268.82978723404256,43,4,12,39.96147931965105,0.5731589147286822,48.532196969696976,1005.8712121212129,23.392353770260765,7
1594,4,2,1,48,0.04081632653061224,0.02040816326530612,0.9795918367346939,49,1300,800,500,0.6153846153846154,18,8,10,334.2766891970973,0.443983843537415,0.2647156975997935,0.17566097973388595,127046.35072069982,-1306.273301302214,125740.07741939761,1445,0,258.81632653061223,45,4,14,39.536912249176396,0.5763888888888888,47.96195652173915,1008.1521739130467,22.403381642512148,0
1595,4,1,0,49,0.02040816326530612,0.0,1.0,49,1400,900,500,0.6428571428571429,19,9,10,332.897077598413,0.44355867346938777,0.2651965371030691,0.17558688994896715,127197.07031250025,-1331.2441746744103,125865.82613782583,1446,0,259.6938775510204,39,10,16,39.41725182431504,0.5865384615384616,47.812500000000014,1008.7500000000019,25.865384615384666,0
1596,4,1,2,48,0.02,0.04,0.96,50,1150,700,450,0.6086956521739131,16,7,9,324.6094727542332,0.4456292517006803,0.26692012967875,0.17236305806809304,127467.41470025529,-1724.573944160975,125742.84075609432,1447,0,255.48,41,9,13,39.3497028195304,0.5861280487804879,47.54464285714287,1009.8214285714301,24.62979094076659,0
1597,4,0,0,48,0.0,0.0,1.0,48,1600,1100,500,0.6875,21,11,10,337.68197161438303,0.4434286347517731,0.2655256145779612,0.1793877651945998,127486.19927300369,-990.0417751735879,126496.15749783009,1448,1,262.2708333333333,39,9,13,39.00045126353792,0.5894764957264957,47.52604166666668,1009.8958333333351,25.894764957265004,0
1598,4,0,1,47,0.0,0.020833333333333332,0.9791666666666666,48,1700,1000,700,0.5882352941176471,24,10,14,334.47234814630804,0.44383495862884165,0.25715949460419596,0.1786606860721367,127707.59489226012,-1057.0681720536477,126650.52672020647,1449,2,263.2708333333333,40,8,13,38.855025470876086,0.5901041666666667,47.3069105691057,1010.772357723579,25.269308943089477,0
1599,4,1,1,47,0.020833333333333332,0.020833333333333332,0.9791666666666666,48,1450,1200,250,0.8275862068965517,17,12,5,339.3284683612793,0.44393653959810875,0.27008556438168085,0.18220813016745468,127918.62643494898,-918.7136833900233,126999.91275155895,1450,0,264.1666666666667,41,7,14,38.51653672648819,0.5907012195121951,47.098214285714285,1011.6071428571428,24.67334494773519,0
1600,4,0,0,47,0.0,0.0,1.0,47,1800,1300,500,0.7222222222222222,23,13,10,339.20980880285884,0.4432431390687635,0.2684528500131338,0.18317329675354366,128144.53124999985,-705.6264172335751,127438.90483276627,1451,1,268.27659574468083,37,10,15,38.288751714677645,0.5996621621621622,46.87499999999999,1012.4999999999989,27.364864864864835,0
1601,4,0,0,47,0.0,0.0,1.0,47,1300,900,400,0.6923076923076923,17,9,8,344.8781681363148,0.443127505396238,0.274935613844594,0.18711810907350165,128333.90404704506,-548.0876524947043,127785.81639455035,1452,2,269.27659574468083,38,9,15,37.95185751441023,0.5997807017543859,46.68803418803419,1013.247863247863,26.664417453891133,0
1602,4,0,1,46,0.0,0.02127659574468085,0.9787234042553191,47,1250,700,550,0.56,18,7,11,343.89247090375125,0.44349367869256856,0.27624372208143777,0.18705520594546687,128434.73442925343,-566.4523654513919,127868.28206380203,1453,3,270.27659574468083,39,8,13,37.87391241050938,0.5990918803418803,46.588541666666664,1013.6458333333329,25.990918803418793,0
1603,4,2,0,48,0.041666666666666664,0.0,1.0,48,1100,900,200,0.8181818181818182,13,9,4,338.38916231107635,0.4440658244680851,0.28563403673309873,0.18622319706538587,128898.98667800453,-876.3959750566909,128022.59070294784,1454,0,264.2916666666667,41,7,15,37.54029894490034,0.600609756097561,46.13095238095238,1015.4761904761904,24.76771196283391,0
1604,4,2,3,47,0.04,0.06,0.94,50,1500,900,600,0.6,21,9,12,326.5551594104678,0.44760204081632654,0.2901423388222162,0.1825346546283472,129514.47289837289,-1541.2761313418312,127973.19676703106,1455,0,254.68,43,7,15,37.215574316990725,0.6039244186046512,45.52556818181818,1017.8977272727269,23.672040169133183,0
1605,4,1,0,48,0.020833333333333332,0.0,1.0,48,1550,900,650,0.5806451612903226,22,9,13,340.24857598807233,0.44363179669030733,0.29648748577929496,0.18953010031274736,129377.95380015415,-795.867091049399,128582.08670910475,1456,0,265.625,41,7,17,37.00583048919226,0.6054369918699187,45.659722222222214,1017.3611111111098,24.813685636856338,0
1606,4,0,1,47,0.0,0.020833333333333332,0.9791666666666666,48,1200,600,600,0.5,18,6,12,342.4242892510168,0.4432624113475177,0.2967648539778456,0.1914776911174211,129529.39111118963,-729.1980623268037,128800.19304886283,1457,1,266.625,41,7,15,36.796588214274124,0.6069613821138211,45.51091269841269,1017.9563492063475,24.828203639179208,0
1607,4,0,2,45,0.0,0.0425531914893617,0.9574468085106383,47,1300,800,500,0.6153846153846154,18,8,10,352.7741409679738,0.4407570151094666,0.30108911353891865,0.1969164017643971,129459.81744497304,-265.9848221958018,129193.83262277723,1458,3,273.27659574468083,40,7,15,36.60396278543373,0.6078125,45.57926829268292,1017.6829268292668,25.442073170731668,0
1608,4,0,1,44,0.0,0.022222222222222223,0.9777777777777777,45,1150,700,450,0.6086956521739131,16,7,9,334.2965972452331,0.4391414141414141,0.21598486331310762,0.18188725402831687,128446.04768990923,-407.2221349624594,128038.82555494677,1459,4,277.44444444444446,41,4,18,38.105549031121555,0.5960365853658536,46.57738095238095,1013.6904761904757,24.724157955865262,8
1609,4,1,0,45,0.022222222222222223,0.0,1.0,45,2000,1600,400,0.8,24,16,8,338.89385305287357,0.4403829966329966,0.22038946162657513,0.18607190799695492,128807.63250405609,-269.57702361638457,128538.05548043971,1460,0,275.73333333333335,42,3,19,37.620513554791884,0.5982142857142857,46.22093023255813,1015.1162790697663,24.169435215946816,0
1610,4,1,0,46,0.021739130434782608,0.0,1.0,46,1550,1000,550,0.6451612903225806,21,10,11,334.3251889693899,0.4418478260869565,0.22984751220104882,0.18528553967921516,129177.32119669701,-562.5535360709478,128614.76766062606,1461,0,270.7173913043478,43,3,20,37.36036717900948,0.6005329457364341,45.85700757575757,1016.5719696969691,23.64120859760393,0
1611,4,1,1,46,0.02127659574468085,0.02127659574468085,0.9787234042553191,47,1050,600,450,0.5714285714285714,15,6,9,338.5799908414663,0.4426842429848905,0.258319364650889,0.18948846858597598,129562.67329724783,-626.5320104453815,128936.14128680245,1462,0,265.93617021276594,43,4,18,36.86062149257433,0.6044089147286822,45.47821969696969,1018.0871212121195,23.67644467935162,0
1612,4,0,0,46,0.0,0.0,1.0,46,1350,1000,350,0.7407407407407407,17,10,7,342.14852240763884,0.4415056360708534,0.24811566623919257,0.19188799202264026,129645.08311549763,-328.42527492340764,129316.65784057422,1463,1,260.3695652173913,42,4,18,36.68609261021249,0.6066468253968254,45.397286821705414,1018.4108527131765,24.247877445551822,0
1613,4,0,2,44,0.0,0.043478260869565216,0.9565217391304348,46,1550,1100,450,0.7096774193548387,20,11,9,342.38803385060754,0.44149557165861514,0.24361264446236253,0.19262761776025322,129768.46648526205,-313.7659808605531,129454.7005044015,1464,2,261.3695652173913,42,4,18,36.55472341100014,0.6078869047619048,45.27616279069766,1018.8953488372073,24.259413067552554,0
1614,4,0,0,44,0.0,0.0,1.0,44,1100,800,300,0.7272727272727273,14,8,6,341.86811029402554,0.44125484496124034,0.2289917081847388,0.1926500876056236,129832.53146455316,77.1204372952617,129909.65190184843,1465,3,268.54545454545456,41,3,18,36.502948668029454,0.610010162601626,45.21329365079364,1019.1468253968234,24.85723964382496,0
1615,4,0,1,43,0.0,0.022727272727272728,0.9772727272727273,44,1200,1000,200,0.8333333333333334,14,10,4,338.372101656409,0.44113372093023256,0.22374287837503148,0.19105009431984896,129908.3719135799,-8.526234567935774,129899.84567901197,1466,4,269.54545454545456,41,3,18,36.51509990917348,0.6107723577235773,45.13888888888887,1019.4444444444416,24.86449864498638,0
1616,4,0,0,43,0.0,0.0,1.0,43,1600,1300,300,0.8125,19,13,6,342.2669864726339,0.44040697674418605,0.2166230851971367,0.19333459506156855,129925.63950029724,293.85141945929286,130219.49091975653,1467,5,274.2325581395349,40,3,18,36.398317052099934,0.6125,45.121951219512184,1019.5121951219496,25.487804878048742,0
1617,4,1,0,44,0.022727272727272728,0.0,1.0,44,1200,800,400,0.6666666666666666,16,8,8,333.1996675228669,0.4407703488372093,0.21730400515996795,0.1897228212032525,130237.26974875582,-120.99700412574126,130116.27274463007,1468,0,268.97727272727275,41,3,19,36.31376146045937,0.6140752032520325,44.816468253968246,1020.7341269841256,24.89595431668599,0
1618,4,0,1,43,0.0,0.022727272727272728,0.9772727272727273,44,850,400,450,0.47058823529411764,13,4,9,331.79250735674276,0.44068225863284005,0.21317078147316848,0.1893032687491732,130315.76063368074,-152.43648530011978,130163.32414838062,1469,1,269.97727272727275,39,5,19,36.27023396585731,0.6180555555555556,44.73958333333334,1021.0416666666681,26.180555555555593,0
1619,4,0,0,43,0.0,0.0,1.0,43,1250,1000,250,0.8,15,10,5,332.93294059977904,0.43943798449612403,0.21667315364405892,0.19036117895537644,130398.95171305457,82.8212889911918,130481.77300204577,1470,2,275.4186046511628,38,5,20,36.156947350069736,0.6206140350877193,44.65811965811967,1021.3675213675238,26.878092667566413,0
1620,4,0,0,43,0.0,0.0,1.0,43,1450,1100,350,0.7586206896551724,18,11,7,312.1349212247326,0.4391842008121078,0.16137730553328056,0.17407524452917775,129424.43828870411,-402.20213822177146,129022.23615048235,1471,3,276.4186046511628,37,6,18,37.67376077586208,0.6126126126126126,45.614035087719294,1017.5438596491219,27.501185395922214,8
1621,4,0,1,42,0.0,0.023255813953488372,0.9767441860465116,43,1150,900,250,0.782608695652174,14,9,5,313.28515970084527,0.4387689184200812,0.16400308607957736,0.1752132182326896,129536.03512619264,-483.6565096952901,129052.37861649736,1472,4,277.4186046511628,37,6,14,37.531416056297566,0.6137387387387387,45.50438596491228,1017.9824561403506,27.51303935514461,0
1622,4,1,0,43,0.023255813953488372,0.0,1.0,43,1200,1000,200,0.8333333333333334,14,10,4,311.9483738303096,0.4413528977482466,0.16683009644796276,0.17515405159588784,129690.63321827764,-508.64357330701944,129181.98964497061,1473,0,267.6744186046512,38,5,15,37.408878749737774,0.6134868421052632,45.35256410256411,1018.5897435897451,26.804993252361715,0
1623,4,0,0,43,0.0,0.0,1.0,43,800,500,300,0.625,11,5,6,314.6529222307993,0.4406607604282023,0.17235342595346848,0.17716408336702286,129799.47973738052,-431.64287931915,129367.83685806138,1474,1,268.6744186046512,38,5,16,37.22980883483608,0.6145833333333333,45.2457264957265,1019.0170940170951,26.816239316239347,0
1624,4,1,0,44,0.022727272727272728,0.0,1.0,44,1050,600,450,0.5714285714285714,15,6,9,341.50281645233326,0.4416292283298097,0.17164948453608297,0.18200974283448507,127617.7300347221,-74.68836177771391,127543.04167294438,1475,0,263.54545454545456,41,3,16,38.76932989690722,0.5876524390243902,47.39583333333333,1010.4166666666656,24.644308943089406,8
1625,4,3,1,46,0.06382978723404255,0.02127659574468085,0.9787234042553191,47,1350,1100,250,0.8148148148148148,16,11,5,326.18806988997216,0.4436285846438483,0.1802233666138331,0.1770082328406559,128340.82729591071,-1025.1805123640383,127315.64678354668,1476,0,247.6595744680851,42,5,19,38.41824455707502,0.5935019841269842,46.6812015503876,1013.2751937984497,24.12559985234404,0
1626,4,0,0,46,0.0,0.0,1.0,46,1400,700,700,0.5,21,7,14,329.0483999188563,0.4436090982286634,0.17385005506406492,0.1784332909646144,128312.37736921765,-755.803507374897,127556.57386184276,1477,1,253.8695652173913,43,3,19,38.37478969997194,0.591812015503876,46.7092803030303,1013.1628787878781,23.561927413671583,0
1627,4,0,2,44,0.0,0.043478260869565216,0.9565217391304348,46,1400,800,600,0.5714285714285714,20,8,12,330.69514546620456,0.44261272141706925,0.17716253980633012,0.17986589619259422,128432.33471074386,-705.6100780532544,127726.7246326906,1478,2,254.8695652173913,43,3,15,38.21079347284504,0.5930232558139534,46.59090909090909,1013.6363636363641,23.572938689217768,0
1628,4,0,2,42,0.0,0.045454545454545456,0.9545454545454546,44,1350,900,450,0.6666666666666666,18,9,9,336.2432110737374,0.43916270260747003,0.1765929333463836,0.1828311275966138,128420.9077873047,-163.86831931847195,128257.03946798624,1479,3,264.3863636363636,41,3,16,38.08185295748915,0.5957825203252032,46.60218253968254,1013.5912698412695,24.72173828881145,0
1629,4,2,1,43,0.045454545454545456,0.022727272727272728,0.9772727272727273,44,1550,1100,450,0.7096774193548387,20,11,9,340.70776717021033,0.44016472868217055,0.1819315403422983,0.18619652160958872,128622.09590143946,-35.49057933356869,128586.6053221059,1480,0,264.8636363636364,41,3,18,37.763549307253456,0.5978150406504066,46.40376984126985,1014.3849206349221,24.741095625242004,0
1630,4,2,1,44,0.044444444444444446,0.022222222222222223,0.9777777777777777,45,1050,800,250,0.7619047619047619,13,8,5,341.4233056579094,0.4414772727272727,0.19558438530106903,0.18827672347248117,128979.82698042493,-192.65622183161446,128787.17075859332,1481,0,259.93333333333334,42,3,20,37.38095805907976,0.5999503968253967,46.05135658914729,1015.7945736434115,24.185585086747892,0
1631,4,0,2,42,0.0,0.045454545454545456,0.9545454545454546,44,1500,1100,400,0.7333333333333333,19,11,8,346.39291060344016,0.4414860817477097,0.1895508272132287,0.1907490169901785,128924.17332963271,131.6839293587766,129055.8572589915,1482,1,265.9318181818182,41,3,21,37.31144785256097,0.6008638211382114,46.10615079365079,1015.5753968253963,24.770131629887715,0
1632,4,1,1,42,0.023255813953488372,0.023255813953488372,0.9767441860465116,43,1250,900,350,0.72,16,9,7,348.98689913030495,0.44264488741232927,0.19510607078827014,0.1931498604428432,129123.91067031845,412.51063768257654,129536.42130800102,1483,0,263.72093023255815,40,3,22,37.042129120421265,0.6044270833333334,45.909552845528445,1016.361788617885,25.409044715447127,0
1633,4,0,0,42,0.0,0.0,1.0,42,1400,1000,400,0.7142857142857143,18,10,8,345.85828166608246,0.4423272357723577,0.18664286689686094,0.19230980991956867,129307.31336805539,544.4010416666488,129851.71440972203,1484,1,266.2857142857143,39,3,22,36.93499931721973,0.607905982905983,45.72916666666666,1017.083333333332,26.079059829059794,0
1634,4,1,0,43,0.023255813953488372,0.0,1.0,43,1200,800,400,0.6666666666666666,16,8,8,342.28048215010256,0.44395994832041347,0.19148462295142865,0.19232172382694082,129718.504197237,280.0224320840683,129998.52662932106,1485,0,261.06976744186045,40,3,17,36.60818202979516,0.6104166666666666,45.325203252032516,1018.699186991869,25.467479674796728,0
1635,4,0,2,41,0.0,0.046511627906976744,0.9534883720930233,43,850,500,350,0.5882352941176471,12,5,7,336.5687705872336,0.44326781100036916,0.18295315677558377,0.18973851603256683,129847.94439693628,140.55260179125708,129988.49699872754,1486,1,262.06976744186045,40,3,17,36.62233688968657,0.61171875,45.198170731707314,1019.2073170731701,25.48018292682925,0
1636,4,0,1,40,0.0,0.024390243902439025,0.975609756097561,41,1150,1000,150,0.8695652173913043,13,10,3,350.5807654031986,0.4423272357723577,0.19639608753162952,0.1967090309940371,129663.42872242304,891.5008172620257,130554.92953968506,1487,2,274.9512195121951,38,3,17,36.452760586034465,0.6132127192982456,45.3792735042735,1018.4829059829053,26.802181736392246,0
1637,4,1,0,41,0.024390243902439025,0.0,1.0,41,1500,1200,300,0.8,18,12,6,348.0761122616991,0.4426067073170732,0.20453366783589355,0.1972155871669103,130044.5513391225,853.0803701877286,130897.63170931023,1488,0,274.9024390243902,38,3,20,36.129586955762726,0.6170504385964912,45.005341880341874,1019.9786324786312,26.841542959963977,0
1638,4,0,1,40,0.0,0.024390243902439025,0.975609756097561,41,1300,900,400,0.6923076923076923,17,9,8,351.65028976541043,0.4423272357723577,0.20377803652408444,0.19993830760947587,130180.8021038788,955.6233563444888,131136.42546022328,1489,1,275.9024390243902,38,3,20,35.900204145728644,0.618421052631579,44.87179487179486,1020.5128205128187,26.855600539811018,0
1639,4,0,0,40,0.0,0.0,1.0,40,1000,800,200,0.8,12,8,4,356.5437327042093,0.43872863247863253,0.20538478073946642,0.2022733468951198,130094.7406894429,1276.8928901200334,131371.63357956294,1490,2,283.4,37,3,21,35.862711378618506,0.6193693693693694,44.95614035087719,1020.1754385964913,27.572309151256523,0
1640,4,0,1,39,0.0,0.025,0.975,40,900,500,400,0.5555555555555556,13,5,8,357.8495907398336,0.4387820512820513,0.2102245862884169,0.2033057564972458,130150.67737188349,1314.8733264081106,131465.5506982916,1491,3,284.4,37,3,21,35.772619815173016,0.6199324324324325,44.90131578947368,1020.3947368421038,27.578236130867673,0
1641,4,1,0,40,0.025,0.0,1.0,40,1050,700,350,0.6666666666666666,14,7,7,355.9410347723558,0.4372061965811966,0.20968352954889835,0.20343891654310725,130384.14292800447,1281.9576255017157,131666.10055350617,1492,0,285.0,34,6,22,35.58446982942844,0.6283700980392157,44.672619047619044,1021.3095238095233,30.03851540616245,0
1642,4,0,2,38,0.0,0.05,0.95,40,950,700,250,0.7368421052631579,12,7,5,356.6755382100833,0.43696581196581197,0.21039214543759477,0.20417830509544516,130444.94224773235,1305.3039965986288,131750.24624433098,1493,1,286.0,34,6,23,35.504069067319264,0.6289828431372548,44.613095238095234,1021.5476190476185,30.045518207282896,0
1643,4,1,1,38,0.02564102564102564,0.02564102564102564,0.9743589743589743,39,1350,1000,350,0.7407407407407407,17,10,7,361.19571816252517,0.4382591093117409,0.20249677988558257,0.2076315289588991,130606.84479827486,1634.9266207708822,132241.77141904575,1494,0,291.56410256410254,33,6,18,35.22446848899015,0.6328914141414141,44.45465686274511,1022.1813725490209,30.97519310754609,0
1644,4,1,0,39,0.02564102564102564,0.0,1.0,39,900,500,400,0.5555555555555556,13,5,8,360.90476767190233,0.43685335132703557,0.2076843198338525,0.20830644474340915,130763.47588667824,1638.6323769704018,132402.10826364864,1495,0,292.53846153846155,33,6,19,35.073188753095295,0.634469696969697,44.3014705882353,1022.7941176470591,30.993761140819974,0
1645,4,0,2,37,0.0,0.05128205128205128,0.9487179487179487,39,850,500,350,0.5882352941176471,12,5,7,362.07747603502537,0.43679712100764734,0.20993263355788772,0.2091529890978795,130794.81336805562,1671.571180555561,132466.38454861118,1496,1,293.53846153846155,33,6,19,35.011456211812614,0.6347853535353536,44.270833333333336,1022.9166666666672,30.997474747474765,0
1646,4,0,0,37,0.0,0.0,1.0,37,900,600,300,0.6666666666666666,12,6,6,351.32860456307316,0.4343405905905906,0.11492950809579527,0.19424843501661102,129083.74592764062,1723.3308684842286,130807.07679612485,1497,2,307.1621621621622,35,2,21,37.02353834472286,0.6130952380952381,45.949074074074076,1016.2037037037038,29.03439153439154,8
1647,4,1,0,38,0.02631578947368421,0.0,1.0,38,800,500,300,0.625,11,5,6,355.8445582750451,0.43724810336652437,0.14207559870845543,0.1910955701190667,127922.58795975686,1504.1113611880564,129426.69932094491,1498,0,300.05263157894734,37,1,20,38.09478647301105,0.5974099099099099,47.094298245614034,1011.6228070175439,27.341156946420107,8
1648,4,2,1,39,0.05,0.025,0.975,40,1000,600,400,0.6,14,6,8,349.0032699263505,0.440357905982906,0.16530502208072284,0.1905914099423936,128593.1654188369,975.8870442708429,129569.05246310774,1499,0,286.0,39,1,18,37.58269573106022,0.6006944444444444,46.43229166666667,1014.2708333333342,26.006944444444464,0
1649,4,0,1,38,0.0,0.02564102564102564,0.9743589743589743,39,1150,600,550,0.5217391304347826,17,6,11,359.2309784672339,0.4393556005398111,0.16112047177759048,0.19650100066387394,128658.8684345094,1443.6502392431785,130102.51867375257,1500,1,293.7435897435897,38,1,20,37.25625702049986,0.6030701754385965,46.36752136752136,1014.529914529914,26.698155645524054,0
1650,4,0,0,38,0.0,0.0,1.0,38,1600,1200,400,0.75,20,12,8,362.80701662646464,0.44004860123281175,0.16275076195241778,0.19894204655773415,128755.86718990435,1742.706409664485,130498.57359956884,1501,2,289.55263157894734,37,1,21,37.06649740708729,0.6058558558558558,46.27192982456139,1014.9122807017526,27.43006164058791,0
1651,4,0,0,38,0.0,0.0,1.0,38,1000,700,300,0.7,13,7,6,359.74138051677295,0.4397522522522523,0.16202114357167252,0.19781503465470962,128867.17547706958,1671.771121883623,130538.9465989532,1502,3,290.55263157894734,37,1,21,37.03068754499639,0.6069819819819819,46.16228070175437,1015.3508771929801,27.441915599810272,0
1652,4,0,0,38,0.0,0.0,1.0,38,1400,1100,300,0.7857142857142857,17,11,6,359.58808620518994,0.43923364153627314,0.15982859382188042,0.19870618931803766,129062.08070031149,1681.8373201369454,130743.91802044843,1503,4,291.55263157894734,37,1,21,36.83579277723822,0.6089527027027026,45.970394736842096,1016.1184210526303,27.462660028449466,0
1653,4,0,0,38,0.0,0.0,1.0,38,1000,700,300,0.7,13,7,6,361.0096218310152,0.438715030820294,0.1576644846139046,0.20034147974875474,129230.01284646148,1730.7307566969957,130960.74360315848,1504,5,292.55263157894734,36,2,21,36.628502602724545,0.6125578703703703,45.80518018018019,1016.7792792792804,28.2438688688689,0
1654,4,3,0,41,0.07317073170731707,0.0,1.0,41,1300,1000,300,0.7692307692307693,16,10,6,341.3083643043272,0.4429623983739837,0.1732026143790848,0.1934080731057856,130050.00000000013,677.4305555555702,130727.43055555571,1505,0,272.0731707317073,39,2,22,36.29663671023967,0.6153846153846154,45.00000000000001,1020.000000000001,26.15384615384618,0
1655,4,0,1,40,0.0,0.024390243902439025,0.975609756097561,41,1150,700,450,0.6086956521739131,16,7,9,342.87327732168916,0.44275914634146346,0.1733565099588097,0.19455972642460181,130103.13042534747,721.7773437500249,130824.9077690975,1506,1,273.0731707317073,39,2,22,36.2028622966442,0.6159188034188035,44.94791666666668,1020.2083333333353,26.159188034188084,0
1656,4,0,0,40,0.0,0.0,1.0,40,1400,1200,200,0.8571428571428571,16,12,4,346.0224906289045,0.4401842948717949,0.17581632653061252,0.19715234931181796,130262.58680555574,1014.756944444469,131277.3437500002,1507,2,280.325,38,2,24,35.96088435374151,0.6192434210526316,44.79166666666668,1020.8333333333348,26.864035087719337,0
1657,4,0,0,40,0.0,0.0,1.0,40,1000,700,300,0.7,13,7,6,343.6243316693986,0.44019764957264956,0.17836869098962582,0.1963992765750681,130384.14292800457,960.6327947845876,131344.77572278917,1508,3,281.325,34,6,24,35.898948983953076,0.6283700980392157,44.67261904761905,1021.3095238095241,30.038515406162475,0
1658,4,0,0,40,0.0,0.0,1.0,40,650,200,450,0.3076923076923077,11,2,9,344.7197613427394,0.4400774572649573,0.1803833605220222,0.1974889847692518,130475.34722222232,995.4861111111165,131470.83333333343,1509,4,282.325,34,6,24,35.77861609570417,0.6292892156862745,44.583333333333336,1021.6666666666674,30.04901960784316,0
1659,4,0,1,39,0.0,0.025,0.975,40,1200,900,300,0.75,15,9,6,346.34660042291864,0.43993055555555555,0.177352393152439,0.19920149081256572,130627.42524092991,1048.4729308390183,131675.89817176893,1510,5,283.325,34,6,17,35.5831004231202,0.6308210784313726,44.43452380952382,1022.2619047619064,30.066526610644306,0
1660,4,0,0,39,0.0,0.0,1.0,39,1800,1600,200,0.8888888888888888,20,16,4,348.22321128583314,0.43887764282501124,0.15447281842393834,0.20115011381334602,130794.81336805563,1309.1579861111163,132103.97135416674,1511,6,271.7435897435897,35,4,18,35.365750169721636,0.6303571428571428,44.270833333333336,1022.9166666666673,29.226190476190496,0
1661,4,0,0,39,0.0,0.0,1.0,39,900,500,400,0.5555555555555556,13,5,8,346.282648678404,0.43803418803418803,0.1510628674807779,0.20095300163463287,130972.46334876542,1270.6983024691344,132243.16165123455,1512,7,272.7435897435897,35,4,18,35.23575305291723,0.6321428571428571,44.09722222222222,1023.6111111111111,29.246031746031747,0
1662,4,0,2,37,0.0,0.05128205128205128,0.9487179487179487,39,1000,800,200,0.8,12,8,4,346.654409652399,0.4378936122357175,0.15224684919600207,0.20210089100288056,131150.2338927467,1292.7613811728165,132442.9952739195,1513,8,273.7435897435897,35,4,19,35.04661016949153,0.6339285714285714,43.9236111111111,1024.3055555555538,29.265873015872966,0
1663,4,0,2,35,0.0,0.05405405405405406,0.9459459459459459,37,900,700,200,0.7777777777777778,11,7,4,366.6748901254532,0.4349974974974975,0.16898573966636787,0.21222698186048974,130870.9343112246,2197.417091836745,133068.35140306133,1514,9,289.1081081081081,34,3,19,34.81675392670157,0.6332720588235294,44.19642857142858,1023.2142857142866,30.094537815126074,0
1664,4,0,0,35,0.0,0.0,1.0,35,1150,800,350,0.6956521739130435,15,8,7,378.8881357841497,0.43280812324929974,0.17534855027760599,0.21950595715014562,130907.84940631074,2919.8862042138717,133827.7356105246,1515,10,303.9714285714286,32,3,21,34.46689286448693,0.6383463541666667,44.16035353535354,1023.3585858585872,31.97995580808085,0
1665,4,0,0,35,0.0,0.0,1.0,35,1100,700,400,0.6363636363636364,15,7,8,379.0270167361087,0.4326680672268908,0.1745773457311921,0.22088126147724954,131134.06795224975,2940.670913682274,134074.738865932,1516,11,304.9714285714286,32,3,22,34.234005177514796,0.640625,43.93939393939394,1024.242424242424,32.00757575757575,0
1666,4,0,0,35,0.0,0.0,1.0,35,800,500,300,0.625,11,5,6,383.3696873554102,0.4325280112044818,0.17816492450638832,0.2245451025938829,131328.12499999988,3069.7314049586626,134397.85640495855,1517,12,305.9714285714286,30,5,22,33.926151761517616,0.6479166666666667,43.74999999999999,1024.999999999999,34.166666666666636,0
1667,4,0,0,35,0.0,0.0,1.0,35,1100,800,300,0.7272727272727273,14,8,6,386.6322254466905,0.43186274509803924,0.18111088230338623,0.22747806571963744,131500.39247673153,3168.4578780783977,134668.85035480993,1518,13,306.9714285714286,30,5,22,33.66804263311929,0.6496527777777779,43.58198924731183,1025.6720430107534,34.18906810035845,0
1668,4,0,0,35,0.0,0.0,1.0,35,850,700,150,0.8235294117647058,10,7,3,388.43225668019136,0.4316526610644258,0.17781644823898346,0.22930596366266576,131628.58963012692,3225.7580227322046,134854.34765285914,1519,14,307.9714285714286,31,4,19,33.49207482130018,0.6481854838709677,43.45703125,1026.1718749999998,33.10231854838709,0
1669,4,0,1,34,0.0,0.02857142857142857,0.9714285714285714,35,1100,800,300,0.7272727272727273,14,8,6,408.53770030878934,0.43137254901960786,0.2205859347223209,0.22363821251235932,128688.43102744634,3517.0573279415335,132205.48835538788,1520,15,308.9714285714286,32,3,13,35.975350506056074,0.6158854166666667,46.33838383838385,1014.6464646464659,31.70770202020206,8
1670,4,1,0,35,0.02857142857142857,0.0,1.0,35,850,500,350,0.5882352941176471,12,5,7,405.3343164944743,0.4320028011204482,0.21131351869606907,0.22368449317658046,129008.91012396706,3458.3476813590596,132467.2578053261,1521,0,301.1714285714286,32,3,15,35.7281568481233,0.619140625,46.02272727272728,1015.9090909090918,31.74715909090912,0
1671,4,0,0,35,0.0,0.0,1.0,35,1000,500,500,0.5,15,5,10,404.12523515184057,0.43214285714285716,0.20889929742388702,0.22410581222056625,129201.38888888896,3442.7083333333385,132644.0972222223,1522,1,302.1714285714286,32,3,18,35.5618169398907,0.62109375,45.833333333333336,1016.6666666666673,31.770833333333353,0
1672,4,1,0,36,0.027777777777777776,0.0,1.0,36,900,500,400,0.5555555555555556,13,5,8,396.4947035521444,0.43411044973544977,0.20951693147167383,0.2219729108565512,129575.4337274127,3075.194636678221,132650.62836409092,1523,0,294.75,33,3,16,35.37353554806613,0.6224747474747474,45.465686274509814,1018.1372549019621,30.852644087938245,0
1673,4,0,0,36,0.0,0.0,1.0,36,1250,800,450,0.64,17,8,9,394.99153070003325,0.4337797619047619,0.20874428674524914,0.2221894172016291,129762.65889321425,3051.030252787403,132813.68914600165,1524,1,295.75,33,3,17,35.22071205196055,0.6243686868686869,45.281862745098046,1018.8725490196086,30.874925727866927,0
1674,4,0,0,36,0.0,0.0,1.0,36,850,200,650,0.23529411764705882,15,2,13,395.7759854499377,0.43341600529100527,0.2058601525656949,0.22316399125336517,129856.32216275012,3078.802774173419,132935.12493692353,1525,2,296.75,33,3,17,35.105181155063924,0.6253156565656566,45.18995098039217,1019.2401960784331,30.886066547831305,0
1675,4,0,0,36,0.0,0.0,1.0,36,900,600,300,0.6666666666666666,12,6,6,395.90557614228464,0.43349867724867724,0.20913814752477866,0.22341537193701008,129887.55076172645,3084.6411236063273,132972.19188533278,1526,3,297.75,33,3,17,35.070028853089696,0.6256313131313131,45.15931372549021,1019.3627450980408,30.889780154486086,0
1676,4,2,0,38,0.05263157894736842,0.0,1.0,38,1350,1200,150,0.8888888888888888,15,12,3,375.3109217530406,0.4334844713134187,0.20634215124298794,0.21552135540132814,130566.58340419515,2201.153610954202,132767.73701514935,1527,0,283.0263157894737,34,4,16,34.904630168899246,0.6302083333333333,44.49404761904763,1022.0238095238105,30.05952380952384,0
1677,4,0,0,38,0.0,0.0,1.0,38,650,500,150,0.7692307692307693,8,5,3,373.2599763354866,0.4337808202939782,0.2066863618811785,0.21468073789637157,130627.42524092985,2151.597930839017,132779.02317176887,1528,1,284.0263157894737,34,4,16,34.89528745002135,0.6308210784313726,44.43452380952382,1022.261904761906,30.066526610644292,0
1678,4,0,0,38,0.0,0.0,1.0,38,1150,800,350,0.6956521739130435,15,8,7,373.4341987393631,0.4332325746799431,0.20302064824459265,0.21528857497792822,130718.71456916108,2162.9676870748426,132881.68225623592,1529,2,285.0263157894737,34,4,16,34.79821497865737,0.6317401960784313,44.3452380952381,1022.6190476190483,30.07703081232495,0
1679,4,0,0,38,0.0,0.0,1.0,38,750,400,350,0.5333333333333333,11,4,7,374.60765330184574,0.43256578947368424,0.20293663628344571,0.21630570948719496,130779.5918367348,2198.2071995464967,132977.7990362813,1530,3,286.0263157894737,34,4,16,34.70646143699566,0.6323529411764706,44.28571428571429,1022.8571428571437,30.084033613445403,0
1680,4,1,1,38,0.02564102564102564,0.02564102564102564,0.9743589743589743,39,1800,1300,500,0.7222222222222222,23,13,10,364.071066339603,0.43390125955915426,0.20482379369924697,0.21244095513094113,131183.8797200918,1752.0509952520188,132935.9307153438,1531,0,279.6666666666667,36,3,17,34.566569565058074,0.6322337962962963,43.89076576576577,1024.4369369369376,28.456581581581602,0
1681,4,0,1,37,0.0,0.02631578947368421,0.9736842105263158,38,700,300,400,0.42857142857142855,11,3,8,359.5811870250811,0.43143966334755807,0.1402135938875797,0.19842285275684154,129006.37846500822,1677.653340450884,130684.0318054591,1532,1,287.8157894736842,37,1,18,36.89276398632848,0.6083896396396397,46.0252192982456,1015.8991228070156,27.45673304883826,8
1682,4,0,0,37,0.0,0.0,1.0,37,1050,700,350,0.6666666666666666,14,7,7,336.6506072275941,0.4301488988988989,0.08195671209369881,0.17734892813742326,127147.30133310244,1160.8432402277617,128308.14457333021,1533,6,296.56756756756755,37,0,18,39.37359570921215,0.589527027027027,47.86184210526316,1008.552631578947,27.25817923186343,8
1683,4,3,0,40,0.075,0.0,1.0,40,1150,800,350,0.6956521739130435,15,8,7,321.32111742169315,0.43575053418803417,0.11452916373858013,0.17329072282823427,128093.08824319196,231.8028496596027,128324.89109285157,1534,0,275.25,40,0,18,38.79400495264865,0.5940104166666667,46.925813008130085,1012.2967479674803,25.307418699187007,0
1684,4,1,0,41,0.024390243902439025,0.0,1.0,41,1400,1200,200,0.8571428571428571,16,12,4,315.1799511792707,0.4361534552845528,0.1143057679292101,0.1713240740209111,128408.33875868075,-105.63255611117427,128302.70620256958,1535,0,269.5121951219512,39,2,15,38.62838300787943,0.5988247863247863,46.61458333333334,1013.5416666666682,25.988247863247903,0
1685,4,0,0,41,0.0,0.0,1.0,41,1750,1200,550,0.6857142857142857,23,12,11,318.11925595612115,0.4364329268292683,0.117907059489744,0.1733803380446185,128513.93771701398,-23.44835069443468,128490.48936631954,1536,1,270.5121951219512,39,2,15,38.44642490240393,0.5998931623931624,46.51041666666667,1013.9583333333342,25.998931623931647,0
1686,4,0,0,41,0.0,0.0,1.0,41,1100,800,300,0.7272727272727273,14,8,6,318.7806328757483,0.43628048780487805,0.11696957999330548,0.1743773730410191,128659.52934967628,2.833238317155235,128662.36258799343,1537,2,271.5121951219512,40,1,16,38.28153694614177,0.5997395833333333,46.366869918699194,1014.5325203252045,25.363313008130113,0
1687,4,0,2,39,0.0,0.04878048780487805,0.9512195121951219,41,750,400,350,0.5333333333333333,11,4,7,320.3716942464272,0.43600101626016263,0.11486009502058003,0.1754751161300373,128711.08596280341,47.07773564018339,128758.16369844359,1538,3,272.5121951219512,40,1,16,38.18874144550159,0.6002604166666667,46.31605691056912,1014.735772357725,25.368394308943124,0
1688,4,0,0,39,0.0,0.0,1.0,39,1550,1000,550,0.6451612903225806,21,10,11,322.3136262035532,0.43488529014844807,0.13809944844427635,0.17683693545762513,128778.125,501.38888888888886,129279.51388888889,1539,4,286.05128205128204,39,0,17,38.07129173508483,0.6025641025641026,46.25,1015.0,26.025641025641026,0
1689,4,0,0,39,0.0,0.0,1.0,39,1250,1000,250,0.8,15,10,5,322.558072259877,0.43499775078722447,0.13490015336737438,0.1773250722119019,128857.43408203125,512.8011067708333,129370.23518880208,1540,5,287.05128205128204,39,0,17,37.98444393146608,0.6033653846153846,46.171875,1015.3125,26.033653846153847,0
1690,4,0,1,38,0.0,0.02564102564102564,0.9743589743589743,39,750,300,450,0.4,12,3,9,321.2187081508503,0.4342948717948718,0.13466206921945956,0.17682445995271837,128910.32036675359,481.68131510417606,129392.00168185776,1541,6,288.05128205128204,39,0,17,37.96468441207645,0.6038995726495726,46.11979166666667,1015.5208333333343,26.038995726495752,0
1691,4,0,0,38,0.0,0.0,1.0,38,1150,800,350,0.6956521739130435,15,8,7,330.9235749421299,0.4334400189663348,0.07547514619883033,0.17649257330246917,127645.4293628808,855.2320260200177,128500.66138890081,1542,7,294.1578947368421,37,1,15,39.008246527777786,0.5945945945945945,47.368421052631575,1010.5263157894728,27.311522048364132,8
1692,4,1,1,38,0.02564102564102564,0.02564102564102564,0.9743589743589743,39,1100,700,400,0.6363636363636364,15,7,8,322.14251927860494,0.43612235717498876,0.06923537264650403,0.17302141321889433,127928.27641034762,442.2274499598126,128370.50386030744,1543,0,287.5897435897436,38,1,16,38.941326081599605,0.5956688596491229,47.08867521367521,1011.6452991452983,26.622244714349954,0
1693,4,0,1,37,0.0,0.02631578947368421,0.9736842105263158,38,1550,1200,350,0.7741935483870968,19,12,7,328.3953660435694,0.43475877192982454,0.08209031845898451,0.17647664778590663,127950.3203509735,803.6584574099872,128753.97880838349,1544,1,295.92105263157896,37,1,16,38.760679708103055,0.5976914414414414,47.06688596491229,1011.7324561403518,27.344120436225726,0
1694,4,0,0,37,0.0,0.0,1.0,37,750,200,550,0.26666666666666666,13,2,11,337.66045079100934,0.43440315315315314,0.09296839977013627,0.1813032773135469,127916.59216226373,1238.4748346319398,129155.06699689566,1545,2,304.6756756756757,36,1,18,38.56080002968571,0.5992476851851851,47.10022522522523,1011.5990990991,28.099974974975,0
1695,4,0,1,36,0.0,0.02702702702702703,0.972972972972973,37,800,500,300,0.625,11,5,6,337.2676517126472,0.434496996996997,0.08123757976265344,0.17236241296068444,125906.24188452214,1092.8205072714636,126999.0623917936,1546,3,305.6756756756757,37,0,19,40.633194034742694,0.5768581081081081,49.0953947368421,1003.6184210526314,27.12482219061166,8
1696,4,5,1,40,0.12195121951219512,0.024390243902439025,0.975609756097561,41,1050,800,250,0.7619047619047619,13,8,5,315.2633201447271,0.4454776422764228,0.11584259218272819,0.16543818038070912,126989.56164485418,-192.89469111063107,126796.66695374355,1547,0,276.2682926829268,40,1,17,40.0742337164751,0.5828125,48.01829268292683,1007.9268292682921,25.1981707317073,0
1697,4,4,5,39,0.09090909090909091,0.11363636363636363,0.8863636363636364,44,1150,800,350,0.6956521739130435,15,8,7,297.85206343625157,0.44864341085271314,0.1266979121143743,0.15953789188679482,127818.28826727418,-1185.7291961631254,126632.55907111106,1548,0,258.34090909090907,41,3,13,39.66764364433105,0.5896849593495934,47.19742063492062,1011.2103174603149,24.663666279519873,0
1698,4,0,0,39,0.0,0.0,1.0,39,650,300,350,0.46153846153846156,10,3,7,330.0420506183145,0.44048020692757534,0.12262791974473175,0.17317111821652817,126984.30879720929,582.0323343560361,127566.34113156532,1549,1,292.4102564102564,38,1,17,39.70722033778533,0.5860745614035088,48.023504273504265,1007.9059829059818,26.523841655420572,0
1699,4,2,0,41,0.04878048780487805,0.0,1.0,41,1250,700,550,0.56,18,7,11,317.07998754557644,0.44273373983739833,0.1404890115691506,0.16921397355155,127670.36132812474,-103.61102693086696,127566.75030119387,1550,0,279.0975609756098,39,2,16,39.3325259396688,0.5913461538461539,47.343749999999986,1010.624999999998,25.913461538461487,0
1700,4,1,0,42,0.023809523809523808,0.0,1.0,42,1850,1400,450,0.7567567567567568,23,14,9,314.8232823587191,0.44370644599303133,0.15098961395257682,0.1700045724737083,128144.53124999999,-330.5447048611113,127813.98654513888,1551,0,273.42857142857144,39,3,17,38.90603566529494,0.5961538461538461,46.875,1012.4999999999999,25.96153846153846,0
1701,4,2,2,42,0.045454545454545456,0.045454545454545456,0.9545454545454546,44,1600,1200,400,0.75,20,12,8,305.6470280685926,0.44654025722339674,0.1630110136270304,0.16724730637011745,128672.41753472215,-934.3315972222263,127738.08593749991,1552,0,261.95454545454544,41,3,14,38.60155715263518,0.5983231707317074,46.354166666666664,1014.5833333333327,24.74593495934958,0
1702,4,1,1,42,0.023255813953488372,0.023255813953488372,0.9767441860465116,43,1100,800,300,0.7272727272727273,14,8,6,311.6042115250993,0.44414451827242524,0.17110316637747358,0.17067295952156455,128711.08596280341,-578.616708804261,128132.46925399915,1553,0,267.93023255813955,40,3,15,38.41115840427309,0.6002604166666667,46.31605691056912,1014.735772357725,25.368394308943124,0
1703,4,0,2,40,0.0,0.047619047619047616,0.9523809523809523,42,750,500,250,0.6666666666666666,10,5,5,313.4837167683722,0.4444323461091754,0.16322070816115386,0.1723729121757188,128865.81776926781,-320.5328962588254,128545.28487300899,1554,1,256.1904761904762,40,2,16,38.20626063457111,0.6018229166666667,46.16361788617887,1015.3455284552861,25.383638211382152,0
1704,4,1,0,41,0.024390243902439025,0.0,1.0,41,1400,1100,300,0.7857142857142857,17,11,6,323.93086195640427,0.4453760162601626,0.1761937020825568,0.17927359161138057,129121.97401258688,165.3184678819493,129287.29248046884,1555,0,259.1951219512195,39,2,18,37.680746301800404,0.6060363247863247,45.911458333333336,1016.3541666666673,26.060363247863265,0
1705,4,0,1,40,0.0,0.024390243902439025,0.975609756097561,41,1350,1000,350,0.7407407407407407,17,10,7,322.22205790622104,0.4451219512195122,0.17164374901611956,0.17880668034238895,129227.86593967005,128.01378038193934,129355.87972005199,1556,1,260.1951219512195,39,2,18,37.61664190827443,0.6071047008547008,45.807291666666664,1016.7708333333326,26.07104700854699,0
1706,4,0,1,39,0.0,0.025,0.975,40,1550,1100,450,0.7096774193548387,20,11,9,330.22037086804653,0.44383012820512824,0.17663934426229577,0.1831222056631892,129201.38888888876,532.9861111111012,129734.37499999985,1557,2,267.475,38,2,19,37.44023224043718,0.6085526315789473,45.83333333333333,1016.6666666666656,26.754385964912252,0
1707,4,0,0,39,0.0,0.0,1.0,39,1500,1100,400,0.7333333333333333,19,11,8,337.50013777936164,0.4435166441745389,0.17847525201417813,0.18742372920753264,129257.13320444734,924.8600530932388,130181.99325754058,1558,3,272.02564102564105,37,2,20,37.19852994033498,0.6109234234234234,45.778508771929815,1016.8859649122792,27.483404457088625,0
1708,4,1,0,40,0.025,0.0,1.0,40,1450,1000,450,0.6896551724137931,19,10,9,352.79095369879263,0.4431891025641026,0.18797420333839177,0.1894557240293981,127922.58795975683,1058.9051438904266,128981.49310364726,1559,0,266.2,37,3,14,38.172013873834814,0.5974099099099099,47.094298245614034,1011.6228070175437,27.3411569464201,8
1709,4,1,2,39,0.024390243902439025,0.04878048780487805,0.9512195121951219,41,1050,900,150,0.8571428571428571,12,9,3,346.49985869960517,0.4433943089430894,0.18993298687450744,0.18802144417164093,128338.88942992044,694.0737775084351,129032.96320742888,1560,0,260.6829268292683,37,4,15,37.905687515781125,0.6016328828828829,46.683114035087705,1013.2675438596466,27.38560929350396,0
1710,4,1,0,40,0.025,0.0,1.0,40,950,700,250,0.7368421052631579,12,7,5,376.17993079584767,0.44296207264957266,0.18314705882352955,0.20237527922561427,127993.90589569164,1681.3591657519446,129675.26506144358,1561,0,263.925,34,6,16,37.50735294117648,0.6041666666666667,47.023809523809526,1011.9047619047622,29.76190476190477,8
1711,4,3,0,43,0.06976744186046512,0.0,1.0,43,1100,700,400,0.6363636363636364,15,7,8,349.3936149092168,0.44638242894056845,0.1997072359673313,0.18706915719380948,127801.98703342008,350.56949537626986,128152.55652879635,1562,0,246.4418604651163,39,4,12,38.38134421894854,0.5926816239316239,47.213541666666664,1011.1458333333328,25.926816239316224,8
1712,4,1,1,43,0.022727272727272728,0.022727272727272728,0.9772727272727273,44,1250,900,350,0.72,16,9,7,341.5807210960388,0.4474431818181818,0.19594089038533458,0.18445358939186088,128144.5312499999,-45.20128038196029,128099.32996961793,1563,0,241.8181818181818,39,5,14,38.228737997256495,0.5961538461538461,46.87499999999999,1012.4999999999992,25.961538461538442,0
1713,4,1,0,44,0.022727272727272728,0.0,1.0,44,1450,1000,450,0.6896551724137931,19,10,9,344.25784900941966,0.44714587737843553,0.20612928545398446,0.18700639938652372,128381.94580078112,39.298502604150656,128421.24430338528,1564,0,242.72727272727272,39,5,12,37.91852965361291,0.5985576923076923,46.64062499999999,1013.437499999999,25.9855769230769,0
1714,4,0,1,43,0.0,0.022727272727272728,0.9772727272727273,44,800,500,300,0.625,11,5,6,346.2764951744378,0.4474101479915433,0.20954405306923318,0.1882273909523617,128408.33875868033,92.95789930553087,128501.29665798586,1565,1,243.72727272727272,39,5,12,37.840441932168545,0.5988247863247863,46.61458333333332,1013.5416666666648,25.988247863247814,0
1715,4,1,1,43,0.022727272727272728,0.022727272727272728,0.9772727272727273,44,1550,900,650,0.5806451612903226,22,9,13,370.7820607957569,0.44749823819591267,0.22309627978772983,0.1989430647493355,127887.41949443142,683.6721899993611,128571.09168443078,1566,0,244.4090909090909,40,4,15,37.753064402692665,0.5919270833333333,47.12906504065042,1011.4837398373999,25.287093495934997,8
1716,4,0,0,43,0.0,0.0,1.0,43,1050,600,450,0.5714285714285714,15,6,9,373.0742652858334,0.44603636028054633,0.22688844248537632,0.200535159862828,127960.02739800357,947.718641493065,128907.74603949663,1567,1,251.02325581395348,39,4,15,37.62065015957994,0.594284188034188,47.05729166666667,1011.7708333333342,25.942841880341902,0
1717,4,2,2,43,0.044444444444444446,0.044444444444444446,0.9555555555555556,45,1000,400,600,0.4,16,4,12,361.09704739716557,0.4486111111111111,0.2284331186920585,0.19654342646919548,128461.1328125,277.6529947916673,128738.78580729167,1568,0,240.82222222222222,39,6,15,37.41094670502808,0.5993589743589743,46.5625,1013.75,25.993589743589745,0
1718,4,0,2,41,0.0,0.046511627906976744,0.9534883720930233,43,1150,700,450,0.6086956521739131,16,7,9,378.15349574651844,0.4474667774086379,0.22781082217193593,0.20491261860422738,128283.34349270898,1102.1589575638334,129385.50245027282,1569,1,247.46511627906978,37,6,16,37.16074521052062,0.6010698198198199,46.73793859649121,1013.0482456140326,27.379682313892772,0
1719,4,3,0,44,0.06818181818181818,0.0,1.0,44,1300,1100,200,0.8461538461538461,15,11,4,379.2249805602381,0.44738812544045103,0.2570426575633271,0.20900242841659,128957.11343277422,980.7517669296219,129937.86519970384,1570,0,242.38636363636363,38,6,18,36.44419901125486,0.6060855263157895,46.073717948717935,1015.705128205126,26.729082321187526,0
1720,4,0,0,44,0.0,0.0,1.0,44,1150,900,250,0.782608695652174,14,9,5,376.6795267577045,0.4473661028893587,0.251520091014255,0.20788424956117252,129011.37689248633,919.18887884429,129930.56577133061,1571,1,243.38636363636363,38,6,18,36.45340379289795,0.6066337719298245,46.02029914529913,1015.9188034188006,26.734705353126333,0
1721,4,0,0,44,0.0,0.0,1.0,44,1300,900,400,0.6923076923076923,17,9,8,372.9720913063259,0.4469807082452431,0.24697976442162517,0.20713025734908508,129258.63997443386,842.2527038539629,130100.89267828781,1572,2,244.38636363636363,36,8,19,36.295219638242884,0.6128472222222222,45.777027027027025,1016.8918918918916,28.24699699699699,0
1722,4,0,0,44,0.0,0.0,1.0,44,1600,1200,400,0.75,20,12,8,372.701430636992,0.4466283474277661,0.2513685672308654,0.2075822888023788,129373.18019032537,843.5138685983181,130216.69405892368,1573,3,245.38636363636363,36,8,19,36.185290753449934,0.6140046296296297,45.66441441441441,1017.3423423423416,28.25950950950949,0
1723,4,0,0,44,0.0,0.0,1.0,44,1050,800,250,0.7619047619047619,13,8,5,372.8621002563664,0.4467274489076815,0.25358202948131003,0.20782289178385374,129401.82317029867,849.8071128560987,130251.63028315477,1574,4,246.38636363636363,36,8,19,36.15200147574249,0.6142939814814814,45.63626126126126,1017.4549549549549,28.26263763763764,0
1724,4,0,1,43,0.0,0.022727272727272728,0.9772727272727273,44,1350,1000,350,0.7407407407407407,17,10,7,372.4847558147734,0.4467714940098661,0.2554020340619876,0.20791505486708498,129459.11864144541,844.3096390309106,130303.42828047632,1575,5,247.38636363636363,36,8,17,36.10319611965622,0.6148726851851851,45.57995495495495,1017.6801801801795,28.268893893893875,0
1725,4,0,1,42,0.0,0.023255813953488372,0.9767441860465116,43,1050,800,250,0.7619047619047619,13,8,5,378.43693059042704,0.446889996308601,0.24702560360417491,0.21175135123876562,129554.6392746913,1205.6520061728306,130760.29128086414,1576,6,252.2093023255814,35,8,17,35.8543656207367,0.6178571428571429,45.48611111111111,1018.0555555555552,29.087301587301578,0
1726,4,0,0,42,0.0,0.0,1.0,42,1450,1100,350,0.7586206896551724,18,11,7,386.5118071385675,0.44460172280294236,0.24368426465732385,0.2164318502481208,129584.09857521,1617.1568233453315,131201.25539855534,1577,7,258.5238095238095,35,7,17,35.61879523322345,0.6181547619047619,45.457175925925924,1018.1712962962958,29.090608465608454,0
1727,4,0,0,42,0.0,0.0,1.0,42,800,400,400,0.5,12,4,8,386.20614667887793,0.44359756097560976,0.24729769208296837,0.21707448934019705,129731.44531250013,1620.6163194444596,131352.06163194458,1578,8,259.5238095238095,35,7,17,35.47631220177233,0.6196428571428572,45.31250000000001,1018.750000000001,29.107142857142886,0
1728,4,0,4,38,0.0,0.09523809523809523,0.9047619047619048,42,950,700,250,0.7368421052631579,12,7,5,384.52122684012005,0.44335559427022847,0.24331170983474593,0.2168412226872233,129860.5420242881,1586.8269874604705,131447.36901174855,1579,9,260.5238095238095,36,6,17,35.387664346481074,0.6189236111111112,45.18581081081083,1019.2567567567592,28.312687687687756,0
1729,4,0,1,37,0.0,0.02631578947368421,0.9736842105263158,38,1200,900,300,0.75,15,9,6,413.402139575519,0.4399596965386439,0.24131788155041867,0.23033990354066872,129388.34372597102,3097.8836264898396,132486.22735246085,1580,10,274.13157894736844,33,5,18,35.13460611900747,0.6205808080808081,45.64950980392158,1017.4019607843156,30.830362448009566,0
1730,4,0,0,37,0.0,0.0,1.0,37,700,500,200,0.7142857142857143,9,5,4,413.6804324479633,0.439720970970971,0.24006952876036358,0.230677544030587,129419.51600646395,3307.6642697520306,132727.18027621598,1581,11,280.2432432432432,33,4,18,35.09562306796741,0.6208964646464646,45.61887254901961,1017.5245098039223,30.834076054664312,0
1731,4,0,1,36,0.0,0.02702702702702703,0.972972972972973,37,1050,800,250,0.7619047619047619,13,8,5,409.10634887304525,0.43968968968968974,0.241808784353013,0.2292154182593484,129606.6285352991,3204.578917964264,132811.20745326337,1582,12,281.2432432432432,33,4,17,35.020635254944445,0.622790404040404,45.43504901960785,1018.25980392157,30.85635769459303,0
1732,4,0,0,36,0.0,0.0,1.0,36,1100,700,400,0.6363636363636364,15,7,8,421.20720878335476,0.4376157407407408,0.24469455813248442,0.23568311758641172,129554.63927469151,3713.869598765453,133268.50887345697,1583,13,289.72222222222223,32,4,17,34.76580263756254,0.6246744791666667,45.48611111111112,1018.0555555555568,31.81423611111115,0
1733,4,0,1,35,0.0,0.027777777777777776,0.9722222222222222,36,1000,800,200,0.8,12,8,4,422.73101119514877,0.4375,0.245000206603033,0.2373118348859618,129683.21352731885,3764.223197887998,133447.43672520685,1584,14,290.72222222222223,32,4,18,34.59541961075989,0.6259765625,45.3598484848485,1018.5606060606077,31.83001893939399,0
1734,4,0,0,35,0.0,0.0,1.0,35,700,500,200,0.7142857142857143,9,5,4,410.5427502469187,0.43746498599439776,0.24983772939163273,0.21654117611062962,127197.07031250001,3501.108026285584,130698.1783387856,1585,15,296.54285714285714,29,6,22,37.45912501721051,0.6088362068965517,47.8125,1008.7500000000001,34.78448275862069,7
1735,4,3,0,38,0.07894736842105263,0.0,1.0,38,1150,1000,150,0.8695652173913043,13,10,3,377.240466671447,0.442345305832148,0.23156318941065157,0.2032230901101025,128048.66850321418,2061.0278925620105,130109.69639577619,1586,0,274.05263157894734,32,6,20,37.42437000998003,0.609375,46.96969696969698,1012.1212121212141,31.62878787878794,0
1736,4,2,2,38,0.05,0.05,0.95,40,1250,1100,150,0.88,14,11,3,355.82983885163003,0.44638087606837606,0.21169807901413584,0.19440287631517805,128610.25694744827,1152.7092709197464,129762.96621836802,1587,0,261.3,33,7,16,37.392145906326775,0.6126893939393939,46.4154411764706,1014.3382352941192,30.737522281639976,0
1737,4,1,2,37,0.02564102564102564,0.05128205128205128,0.9487179487179487,39,1150,800,350,0.6956521739130435,15,8,7,365.0139773747835,0.4437696806117859,0.22187121571105162,0.19973236739496586,128672.41753472228,1593.4461805555663,130265.86371527784,1588,0,268.97435897435895,33,6,17,37.09573921971254,0.6133207070707071,46.35416666666667,1014.5833333333338,30.74494949494951,0
1738,4,1,0,38,0.02631578947368421,0.0,1.0,38,1300,900,400,0.6923076923076923,17,9,8,368.60648421614667,0.441693338074917,0.22415892929636883,0.20210497408795258,128752.49496224865,1891.8009004183132,130644.29586266696,1589,0,276.92105263157896,32,6,20,36.922793812722894,0.6165364583333333,46.27525252525252,1014.898989898989,31.715593434343408,0
1739,4,0,0,38,0.0,0.0,1.0,38,1100,500,600,0.45454545454545453,17,5,12,369.0295974557791,0.44161925082977715,0.22634721522053636,0.20250026852880593,128784.53290799406,1905.0608675135127,130689.59377550757,1590,1,277.92105263157896,32,6,20,36.87932786001576,0.6168619791666667,46.243686868686865,1015.0252525252523,31.719539141414135,0
1740,4,1,0,39,0.02564102564102564,0.0,1.0,39,900,400,500,0.4444444444444444,14,4,10,359.1915710114007,0.4426450742240216,0.21897766361738236,0.1984271882577546,129050.14349489806,1470.744756235838,130520.8882511339,1591,0,271.7692307692308,34,5,21,36.8580355399336,0.6148897058823529,45.98214285714286,1016.0714285714294,29.88445378151263,0
1741,4,0,0,39,0.0,0.0,1.0,39,1000,800,200,0.8,12,8,4,359.1104541789839,0.4423076923076923,0.2103825136612021,0.19914307004470946,129201.38888888908,1479.5138888889082,130680.90277777798,1592,1,272.7692307692308,34,5,21,36.705942622950815,0.616421568627451,45.83333333333334,1016.6666666666682,29.901960784313772,0
1742,4,2,2,39,0.04878048780487805,0.04878048780487805,0.9512195121951219,41,1100,900,200,0.8181818181818182,13,9,4,341.15583864352425,0.44392784552845527,0.20075233588156727,0.19154280326074996,129688.42734203824,648.7928384465774,130337.22018048482,1593,0,260.4146341463415,36,5,15,36.667357656163595,0.6171875,45.35472972972974,1018.5810810810831,28.293918918918976,0
1743,4,2,1,40,0.04878048780487805,0.024390243902439025,0.975609756097561,41,750,500,250,0.6666666666666666,10,5,5,341.4152120345958,0.4420731707317073,0.21716262677430143,0.192673971280372,129889.2389010635,669.2324080837909,130558.47130914728,1594,0,261.3658536585366,36,5,18,36.45695242303728,0.619212962962963,45.15765765765767,1019.3693693693715,28.315815815815874,0
1744,4,1,0,41,0.024390243902439025,0.0,1.0,41,850,500,350,0.5882352941176471,12,5,7,344.6975786312728,0.4427083333333333,0.2274681116952515,0.19509882950530044,130004.0581121663,762.4168087006033,130766.4749208669,1595,0,262.2682926829268,36,5,19,36.25680948174323,0.6203703703703703,45.04504504504505,1019.8198198198204,28.328328328328343,0
1745,4,0,2,39,0.0,0.04878048780487805,0.9512195121951219,41,1200,700,500,0.5833333333333334,17,7,10,351.66627934656117,0.4423780487804878,0.2234902110663135,0.19992470661471362,130176.38204082454,955.7287862186479,131132.1108270432,1596,1,263.2682926829268,36,5,20,35.90427977635548,0.6221064814814814,44.876126126126124,1020.4954954954949,28.34709709709708,0
1746,4,0,1,38,0.0,0.02564102564102564,0.9743589743589743,39,1200,1100,100,0.9166666666666666,13,11,2,366.12944175523734,0.4418016194331984,0.22777448355584395,0.20650858236550326,129867.92091836724,1709.6938775510105,131577.61479591826,1597,2,276.64102564102564,34,5,20,35.84880868955854,0.6231617647058824,45.17857142857142,1019.2857142857133,29.978991596638625,0
1747,4,0,0,38,0.0,0.0,1.0,38,1250,900,350,0.72,16,9,7,378.58601591165376,0.43849276908487433,0.24022176653755634,0.213300901647785,129825.09731833881,2229.9932718184978,132055.0905901573,1598,3,284.7105263157895,33,5,20,35.574995991662654,0.625,45.2205882352941,1019.1176470588211,30.8823529411764,0
1748,4,1,0,39,0.02564102564102564,0.0,1.0,39,800,600,200,0.75,10,6,4,370.27952980505967,0.44048020692757534,0.2342544477651236,0.2103158283604481,130141.08737244873,1837.7161281178826,131978.8035005666,1599,0,278.38461538461536,34,5,21,35.465280208454864,0.6259191176470589,44.91071428571427,1020.3571428571408,30.010504201680614,0
1749,4,2,2,39,0.04878048780487805,0.04878048780487805,0.9512195121951219,41,1400,1300,100,0.9285714285714286,15,13,2,352.18415977644094,0.4420985772357724,0.22581561089184832,0.20303771358923672,130718.71456916099,1007.5255102040799,131726.24007936506,1600,0,265.7560975609756,34,7,18,35.34148234381063,0.6317401960784313,44.345238095238095,1022.6190476190476,30.077030812324928,0
1750,4,0,0,39,0.0,0.0,1.0,39,1250,900,350,0.72,16,9,7,370.55128923044094,0.4393556005398111,0.23882819036369995,0.2121507930649006,130450.30757400983,1867.7059304113668,132318.0135044212,1601,2,280.38461538461536,33,6,22,35.144253838771604,0.6313131313131313,44.607843137254896,1021.5686274509791,30.956625074272093,0
1751,4,0,1,38,0.0,0.02564102564102564,0.9743589743589743,39,850,400,450,0.47058823529411764,13,4,9,371.4258705458355,0.43893387314439947,0.23875860287469775,0.212995110633506,130512.91120001924,1895.1743319876966,132408.08553200692,1602,3,281.38461538461536,33,6,18,35.05836731430399,0.6319444444444444,44.54656862745098,1021.8137254901962,30.964052287581705,0
1752,4,0,0,38,0.0,0.0,1.0,38,950,700,250,0.7368421052631579,12,7,5,372.6533835292979,0.4379593409198672,0.21981194647107016,0.21391889973660563,130552.75769054188,2130.1853764922084,132682.9430670341,1060,4,247.6315789473684,32,6,18,34.986564121571554,0.634765625,44.507575757575765,1021.9696969696977,31.936553030303052,0
1753,4,0,1,37,0.0,0.02631578947368421,0.9736842105263158,38,1000,600,400,0.6,14,6,8,370.0628661540745,0.43686284969179706,0.2150850332399714,0.21331951266774765,130714.10323245105,2074.487137792104,132788.59037024315,1061,5,248.6315789473684,32,6,18,34.8890809564967,0.6363932291666667,44.349747474747495,1022.6010101010123,31.956281565656635,0
1754,4,0,0,37,0.0,0.0,1.0,37,1450,1000,450,0.6896551724137931,19,10,9,379.44717985741806,0.43430930930930933,0.22758877063512828,0.21843249679182186,130661.65500217033,2515.8393012153015,133177.49430338564,1062,10,256.2162162162162,31,6,19,34.70241127525896,0.6384408602150538,44.40104166666668,1022.3958333333348,32.98051075268822,0
1755,4,0,0,37,0.0,0.0,1.0,37,1100,900,200,0.8181818181818182,13,9,4,381.9067397696228,0.43337087087087084,0.23689405873167613,0.22098845074445492,130861.41798231343,2595.3715006510506,133456.7894829645,1063,11,257.2162162162162,31,6,19,34.436773564096036,0.6404569892473118,44.20572916666667,1023.1770833333339,33.005712365591414,0
1756,4,0,1,36,0.0,0.02702702702702703,0.972972972972973,37,1200,700,500,0.5833333333333334,17,7,10,382.6542222667887,0.4341529029029029,0.23623648315310875,0.22224644943689995,131004.77629833692,2625.906157534949,133630.68245587187,1064,12,258.2162162162162,32,5,19,34.27222085183359,0.6393229166666667,44.06565656565657,1023.7373737373739,31.991792929292934,0
1757,4,0,0,36,0.0,0.0,1.0,36,1250,900,350,0.72,16,9,7,394.4918875807041,0.43348214285714287,0.25282761448304125,0.228468072549503,130894.7266472711,3127.3815578884587,134022.10820515957,1065,13,266.02777777777777,31,5,19,34.0810164567163,0.6407930107526882,44.173177083333336,1023.3072916666671,33.009912634408614,0
1758,4,0,0,36,0.0,0.0,1.0,36,1250,800,450,0.64,17,8,9,395.0355538405078,0.4328042328042328,0.2524873512535688,0.2293773651620439,130994.67807345932,3149.5110405816154,134144.18911404093,1066,14,267.02777777777777,31,5,19,33.96559399643857,0.6418010752688172,44.07552083333334,1023.6979166666677,33.022513440860244,0
1759,4,0,0,36,0.0,0.0,1.0,36,750,300,450,0.4,12,3,9,393.16469232668715,0.43275462962962963,0.25169527442254713,0.22888529275717237,131094.6676466201,3108.358934190557,134203.02658081066,1067,15,268.02777777777777,31,5,19,33.91197817334183,0.6428091397849462,43.97786458333334,1024.0885416666677,33.03511424731186,0
1760,4,0,0,36,0.0,0.0,1.0,36,1350,900,450,0.6666666666666666,18,9,9,394.954157872727,0.43230820105820106,0.24740124006044883,0.2303264907327462,131161.34855482323,3160.5439927842967,134321.89254760754,1068,16,269.02777777777777,31,5,19,33.79848841150798,0.643481182795699,43.91276041666667,1024.3489583333342,33.04351478494626,0
1761,4,0,0,36,0.0,0.0,1.0,36,1150,1000,150,0.8695652173913043,13,10,3,394.954157872727,0.43174603174603177,0.24740124006044883,0.2303264907327462,131161.34855482323,3160.5439927842967,134321.89254760754,1069,17,270.02777777777777,31,5,19,33.79848841150798,0.643481182795699,43.91276041666667,1024.3489583333342,33.04351478494626,0
1762,4,0,0,36,0.0,0.0,1.0,36,1050,900,150,0.8571428571428571,12,9,3,443.65237775906917,0.4314814814814815,0.28275163831823824,0.24203595012235576,128553.12256113441,4232.562025451505,132785.6845865859,1070,18,271.02777777777777,30,6,15,35.22393417274133,0.6197916666666667,46.4717741935484,1014.1129032258079,33.803763440860266,8
1763,4,0,0,36,0.0,0.0,1.0,36,1150,1000,150,0.8695652173913043,13,10,3,448.2370942905872,0.4318121693121693,0.2845345345345347,0.24516620200763428,128655.3720083247,4333.622022777206,132988.9940311019,1071,19,272.02777777777777,30,6,16,35.00237369722664,0.6208333333333333,46.37096774193549,1014.5161290322584,33.81720430107528,0
1764,4,0,0,36,0.0,0.0,1.0,36,1500,1200,300,0.8,18,12,6,446.20374711637237,0.43116732804232805,0.28486118237272695,0.24497214172670714,128804.55864800359,4294.6153428819625,133099.17399088555,1072,20,273.02777777777777,31,5,16,34.90037626133061,0.6196236559139785,46.22395833333334,1015.1041666666677,32.745295698924764,0
1765,4,0,0,36,0.0,0.0,1.0,36,800,500,300,0.625,11,5,6,448.40213732477304,0.43105158730158727,0.2806163323940547,0.2470511501808547,128944.78242016135,4363.823206815649,133308.605626977,1073,21,274.02777777777777,32,4,16,34.700294215150016,0.6184895833333333,46.085858585858595,1015.6565656565668,31.739267676767714,0
1766,4,1,0,37,0.02702702702702703,0.0,1.0,37,1350,1100,250,0.8148148148148148,16,11,5,439.7887642822866,0.4336836836836837,0.2799730122408768,0.24536777703619686,129440.63484579146,3986.0725973870194,133426.7074431785,1074,0,267.5945945945946,30,7,16,34.40980936027826,0.6288194444444444,45.598118279569896,1017.6075268817207,33.920250896057354,0
1767,4,0,0,37,0.0,0.0,1.0,37,850,700,150,0.8235294117647058,10,7,3,438.4590365645504,0.43374624624624625,0.28021313271544335,0.2450516814688811,129509.03148124053,3956.8810339345446,133465.91251517506,1075,1,268.5945945945946,30,7,16,34.37348694924951,0.6295138888888889,45.53091397849462,1017.8763440860209,33.92921146953403,0
1768,4,0,0,37,0.0,0.0,1.0,37,1050,800,250,0.7619047619047619,13,8,5,437.55652841831915,0.43308933933933935,0.2738577078199722,0.24582957219291612,129714.32978162203,3951.4703650710903,133665.80014669313,1076,2,269.5945945945946,30,7,16,34.186018384131586,0.6315972222222221,45.32930107526881,1018.6827956989237,33.95609318996412,0
1769,4,0,0,37,0.0,0.0,1.0,37,1100,700,400,0.6363636363636364,15,7,8,438.2248481524008,0.4326826826826827,0.27683190473888186,0.2467300476000493,129797.7786593966,3976.122368706588,133773.9010281032,1077,3,270.5945945945946,31,6,16,34.08350370559673,0.6297043010752688,45.24739583333333,1019.0104166666658,32.871303763440835,0
1770,4,0,1,36,0.0,0.02702702702702703,0.972972972972973,37,1150,900,250,0.782608695652174,14,9,5,440.2372940010475,0.4322447447447448,0.27308244699549045,0.24836028472889288,129876.19447314052,4035.2688820018393,133911.46335514236,1078,4,271.5945945945946,32,5,17,33.951907593211935,0.6279296875,45.17045454545455,1019.3181818181821,31.85369318181819,0
1771,4,0,0,36,0.0,0.0,1.0,36,1000,500,500,0.5,15,5,10,446.82365548266586,0.4306051587301587,0.2808965243184176,0.2522121412237772,129897.31046888555,4408.238220214833,134305.5486891004,1079,5,278.1666666666667,31,5,17,33.7624270873249,0.6307123655913979,45.14973958333333,1019.401041666666,32.88390456989245,0
1772,4,1,0,37,0.02702702702702703,0.0,1.0,37,1250,800,450,0.64,17,8,9,434.31903373594315,0.4336836836836837,0.2689464975179259,0.24746084480303754,130262.58680555563,3915.1041666666756,134177.6909722223,1080,0,271.6216216216216,32,5,18,33.70748299319728,0.6318359375,44.79166666666667,1020.833333333334,31.90104166666669,0
1773,4,1,0,38,0.02631578947368421,0.0,1.0,38,700,400,300,0.5714285714285714,10,4,6,424.405563826333,0.43447724039829305,0.2736218169528537,0.24444070098617687,130681.82615294363,3492.418822058981,134174.2449750026,1081,0,265.44736842105266,32,6,17,33.532713838807936,0.6360677083333333,44.381313131313135,1022.4747474747479,31.952335858585872,0
1774,4,0,1,37,0.0,0.02631578947368421,0.9736842105263158,38,1150,800,350,0.6956521739130435,15,8,7,423.2879791365948,0.4333511142721669,0.2785917837238039,0.2447096987418487,130826.1546039985,3475.427720107654,134301.58232410616,1082,1,266.44736842105266,33,5,17,33.41419102379811,0.6351010101010102,44.240196078431374,1023.0392156862748,31.00118835412954,0
1775,4,0,0,37,0.0,0.0,1.0,37,600,300,300,0.5,9,3,6,430.92729766803836,0.4298048048048048,0.2914314314314317,0.2486119025007914,130746.38429752068,3868.4372130394904,134614.82151056017,1083,2,274.5945945945946,32,5,17,33.30015432098766,0.63671875,44.31818181818182,1022.7272727272729,31.960227272727277,0
1776,4,0,1,36,0.0,0.02702702702702703,0.972972972972973,37,800,500,300,0.625,11,5,6,430.9418219612194,0.4290853353353354,0.2912783233572871,0.2496628639739587,130907.84940631058,3882.73342643608,134790.58283274664,1084,3,275.5945945945946,32,5,17,33.13515319761465,0.6383463541666667,44.160353535353536,1023.3585858585858,31.979955808080806,0
1777,4,0,0,36,0.0,0.0,1.0,36,1450,1100,350,0.7586206896551724,18,11,7,435.27688941697204,0.4288690476190476,0.28625001767259106,0.2520885095009566,130894.72664727097,4195.089891221779,135089.81653849274,1085,4,272.97222222222223,31,5,17,33.03762671247402,0.6407930107526882,44.17317708333333,1023.307291666666,33.00991263440858,0
1778,4,2,1,37,0.05263157894736842,0.02631578947368421,0.9736842105263158,38,850,700,150,0.8235294117647058,10,7,3,420.2641936056559,0.4307580606922712,0.2774430364526621,0.24766354386080494,131561.7900424533,3459.574551052513,135021.3645935058,1086,0,259.55263157894734,31,7,18,32.74328912298514,0.647513440860215,43.522135416666664,1025.911458333333,33.09391801075268,0
1779,4,0,0,37,0.0,0.0,1.0,37,1400,1200,200,0.8571428571428571,16,12,4,427.89764280682743,0.42930430430430433,0.285090172698242,0.25243976856161665,131603.8071597872,3862.591773615438,135466.39893340264,1087,1,267.56756756756755,30,7,18,32.50480307396733,0.6506944444444445,43.48118279569892,1026.0752688172038,34.20250896057346,0
1780,4,0,0,37,0.0,0.0,1.0,37,1450,1100,350,0.7586206896551724,18,11,7,424.2171770886906,0.4281156156156156,0.2785926065570965,0.2513112277493858,131762.23966810433,3779.161071777339,135541.40073988168,1088,2,268.56756756756755,31,6,18,32.438305854998944,0.6495295698924731,43.326822916666664,1026.692708333333,33.119119623655905,0
1781,4,0,0,37,0.0,0.0,1.0,37,750,500,250,0.6666666666666666,10,5,5,426.2153919420555,0.4281468968968969,0.273628516306341,0.25293911183197804,131829.0901184081,3837.5174628363575,135666.60758124443,1089,3,269.56756756756755,31,6,18,32.31913803305016,0.6502016129032258,43.26171874999999,1026.953124999999,33.12752016129029,0
1782,4,0,0,37,0.0,0.0,1.0,37,1200,900,300,0.75,15,9,6,397.83366156434437,0.4281156156156156,0.20129737750610732,0.22704875236915006,130327.04132550267,2981.0985165461834,133308.13984204884,1090,4,270.56756756756755,32,5,18,34.57297720621575,0.6324869791666667,44.728535353535364,1021.0858585858599,31.908933080808122,8
1783,4,0,0,37,0.0,0.0,1.0,37,1200,900,300,0.75,15,9,6,405.8825850714798,0.42817817817817816,0.20613619056525612,0.23260636532566717,130488.24737271733,3192.5814330170715,133680.8288057344,1091,5,271.56756756756755,32,5,14,34.2032768989949,0.6341145833333333,44.57070707070709,1021.7171717171739,31.928661616161683,0
1784,4,0,0,37,0.0,0.0,1.0,37,1200,1000,200,0.8333333333333334,14,10,4,403.06756652121254,0.4274587087087087,0.19841421567833262,0.2317013488872113,130606.84479827479,3128.676620770869,133735.52141904566,1092,6,272.56756756756755,33,4,15,34.154452903328945,0.6328914141414141,44.454656862745104,1022.1813725490204,30.975193107546072,0
1785,4,0,1,36,0.0,0.02702702702702703,0.972972972972973,37,1300,900,400,0.6923076923076923,17,9,8,402.3945428972404,0.4274587087087087,0.20280956729554855,0.23225344778840729,130763.47588667825,3123.701821414846,133887.1777080931,1093,7,273.56756756756755,33,4,15,34.01230130202093,0.634469696969697,44.3014705882353,1022.7941176470592,30.993761140819977,0
1786,4,0,1,35,0.0,0.027777777777777776,0.9722222222222222,36,800,300,500,0.375,13,3,10,401.31173049980373,0.425380291005291,0.19022789913200877,0.23210770537044348,130843.25140610668,3301.7863292011225,134145.0377353078,1094,8,276.22222222222223,32,4,15,33.95887325681846,0.6376953125,44.22348484848486,1023.1060606060619,31.972064393939434,0
1787,4,0,0,35,0.0,0.0,1.0,35,950,600,350,0.631578947368421,13,6,7,400.8513004239928,0.4242296918767507,0.17429734444659783,0.2326200066240025,130972.46334876567,3500.096450617312,134472.559799383,1095,9,278.0,32,3,15,33.83932609678879,0.6389973958333333,44.097222222222236,1023.611111111113,31.987847222222282,0
1788,4,0,0,35,0.0,0.0,1.0,35,1550,1100,450,0.7096774193548387,20,11,9,402.8778809913593,0.42454481792717086,0.18066698377464152,0.23418901340207426,131037.09323347126,3558.389290633633,134595.48252410488,1096,10,279.0,32,3,15,33.72179060303367,0.6396484375,44.03409090909092,1023.8636363636379,31.995738636363683,0
1789,4,0,0,35,0.0,0.0,1.0,35,1050,700,350,0.6666666666666666,14,7,7,402.3552281955989,0.42394957983193277,0.18295430542842994,0.23526765360486215,131263.42337516608,3562.9049331701176,134826.3283083362,1097,11,280.0,32,3,17,33.50531871200919,0.6419270833333333,43.81313131313133,1024.747474747477,32.02335858585866,0
1790,4,1,1,35,0.027777777777777776,0.027777777777777776,0.9722222222222222,36,900,700,200,0.7777777777777778,11,7,4,389.97442252696976,0.42544642857142856,0.17080189195100637,0.23035698446941974,131651.87225793308,3068.1885139271753,134720.06077186024,1098,0,273.19444444444446,32,4,14,33.428939058398946,0.6458333333333333,43.43434343434345,1026.262626262628,32.07070707070712,0
1791,4,0,0,35,0.0,0.0,1.0,35,1300,800,500,0.6153846153846154,18,8,10,397.73272540799076,0.42237394957983193,0.1800311899321798,0.23418074818865123,131528.39660644546,3462.629530164945,134991.0261366104,1099,13,282.0,31,4,20,33.355018194127105,0.6471774193548387,43.55468750000001,1025.7812500000011,33.08971774193552,0
1792,4,1,0,36,0.027777777777777776,0.0,1.0,36,1050,900,150,0.8571428571428571,12,9,3,390.585755269403,0.4253968253968254,0.18326233581824636,0.2326930363383897,131976.01807213557,3109.5905392306977,135085.60861136627,1100,0,275.1388888888889,32,4,16,33.085268698287855,0.6490885416666667,43.11868686868687,1027.525252525253,32.11016414141416,0
1793,4,0,0,36,0.0,0.0,1.0,36,1200,700,500,0.5833333333333334,17,7,10,393.0587301010431,0.42566137566137563,0.15755423411518588,0.221562155682655,129844.02101826342,3015.6986531986518,132859.71967146208,1101,1,276.1388888888889,32,4,17,35.186963164849686,0.6276041666666667,45.2020202020202,1019.191919191919,31.84974747474747,8
1794,4,0,1,35,0.0,0.027777777777777776,0.9722222222222222,36,1150,800,350,0.6956521739130435,15,8,7,392.49678889887065,0.425,0.15296699969724514,0.22160972542443927,129908.37191358022,2997.723765432094,132906.09567901233,1102,2,277.1388888888889,32,4,17,35.135672116257936,0.6282552083333333,45.138888888888886,1019.4444444444442,31.857638888888882,0
1795,4,0,0,35,0.0,0.0,1.0,35,1000,700,300,0.7,13,7,6,394.2131023192875,0.4258053221288515,0.14732234058076799,0.22308359952056775,129996.88042534715,3249.294704861102,133246.17513020826,1103,3,280.1142857142857,31,4,18,35.00170241743277,0.6317204301075269,45.05208333333333,1019.791666666666,32.89650537634406,0
1796,4,0,1,34,0.0,0.02857142857142857,0.9714285714285714,35,1400,1100,300,0.7857142857142857,17,11,6,392.9528293698871,0.42489495798319327,0.14860933911712215,0.22350974431068027,130196.13477918829,3232.1879069010342,133428.32268608932,1104,4,281.1142857142857,31,4,19,34.83084545377223,0.633736559139785,44.85677083333333,1020.572916666666,32.92170698924729,0
1797,4,0,0,34,0.0,0.0,1.0,34,1500,1300,200,0.8666666666666667,17,13,4,404.3376312040517,0.42266414141414144,0.15887466683195983,0.22977030659439826,130159.70054341538,3725.6929991906554,133885.39354260603,1105,5,289.5,30,4,20,34.5775158061117,0.6361111111111111,44.89247311827957,1020.4301075268813,34.01433691756271,0
1798,4,0,0,34,0.0,0.0,1.0,34,750,600,150,0.8,9,6,3,403.99833402748845,0.4224970291146762,0.15762304921968773,0.23018509729473194,130262.58680555563,3725.173611111121,133987.76041666674,1106,6,290.5,30,4,21,34.4812925170068,0.6371527777777778,44.79166666666667,1020.833333333334,34.0277777777778,0
1799,4,1,1,34,0.02857142857142857,0.02857142857142857,0.9714285714285714,35,950,900,50,0.9473684210526315,10,9,1,396.9964989730962,0.42496498599439775,0.1573302763979112,0.22833842589287753,130628.3760070801,3371.8015882704008,134000.1775953505,1107,0,283.1714285714286,31,4,14,34.28769689636139,0.6381048387096775,44.43359375,1022.2656250000002,32.976310483870975,0
1800,4,1,0,35,0.02857142857142857,0.0,1.0,35,950,700,250,0.7368421052631579,12,7,5,392.19552102979077,0.42531512605042016,0.17466499390897972,0.2267461522245082,130828.11355590825,3262.0400322808173,134090.15358818907,1108,0,283.54285714285714,31,4,15,34.207421195536895,0.6401209677419355,44.23828125,1023.0468750000003,33.001512096774206,0
1801,4,0,1,34,0.0,0.02857142857142857,0.9714285714285714,35,1300,800,500,0.6153846153846154,18,8,10,397.35488046440355,0.4243347338935574,0.18443871061525607,0.2307240819949145,130994.67807345925,3410.274929470492,134404.95300292975,1109,1,284.54285714285714,31,4,16,33.90623675061477,0.6418010752688172,44.075520833333336,1023.6979166666671,33.02251344086023,0
1802,4,0,1,33,0.0,0.029411764705882353,0.9705882352941176,34,850,600,250,0.7058823529411765,11,6,5,406.07182005911875,0.42492944147355916,0.19035368284429666,0.23529915052740707,130915.143730489,3832.190137588153,134747.33386807714,1110,2,291.05882352941177,30,4,16,33.764009281148766,0.64375,44.15322580645161,1023.387096774193,34.112903225806434,0
1803,4,0,1,32,0.0,0.030303030303030304,0.9696969696969697,33,850,600,250,0.7058823529411765,11,6,5,409.2755272104569,0.42566287878787884,0.1555937128516709,0.2283437742454214,129440.63484579136,3995.376813793493,133436.01165958485,1111,3,298.1818181818182,30,3,17,35.18607185312377,0.6288194444444444,45.59811827956989,1017.6075268817199,33.92025089605733,8
1804,4,2,0,34,0.058823529411764705,0.0,1.0,34,1100,900,200,0.8181818181818182,13,9,4,396.92350903278333,0.427584670231729,0.16155717052852392,0.22484909579009985,130037.12153096622,3522.9581165187237,133560.07964748493,1112,0,290.02941176470586,32,2,20,34.891577948337044,0.6295572916666667,45.01262626262626,1019.9494949494949,31.873421717171716,0
1805,4,0,1,33,0.0,0.029411764705882353,0.9705882352941176,34,1250,1100,150,0.88,14,11,3,393.7928171883783,0.4263406120023767,0.15802592223330025,0.22399910917196791,130198.1482278595,3454.219116671782,133652.3673445313,1113,1,291.02941176470586,32,2,21,34.80736319023467,0.6311848958333333,44.854797979797986,1020.5808080808089,31.893150252525277,0
1806,4,0,0,33,0.0,0.0,1.0,33,1000,900,100,0.9,11,9,2,393.1835809089414,0.4250710227272727,0.17706714581714533,0.2044554620726495,126618.10613943805,3356.848018213321,129974.95415765137,1114,2,300.6969696969697,30,3,20,38.494090544871796,0.6,48.387096774193544,1006.4516129032255,33.548387096774185,8
1807,4,1,0,34,0.029411764705882353,0.0,1.0,34,1150,700,450,0.6086956521739131,16,7,9,381.33913251575393,0.42968285799168154,0.1715091099731032,0.20029359321146317,127026.37566460497,2888.025580512143,129914.40124511711,1115,0,292.8235294117647,31,3,21,38.37132954447603,0.601478494623656,47.98177083333333,1008.0729166666661,32.51848118279568,0
1808,4,4,1,37,0.10526315789473684,0.02631578947368421,0.9736842105263158,38,950,700,250,0.7368421052631579,12,7,5,344.9367517209139,0.4420489568515884,0.16962340679047339,0.1859936393681324,128085.94419795931,1236.3099065500455,129322.25410450935,1116,0,262.89473684210526,35,3,22,38.20365500419239,0.6029761904761906,46.93287037037036,1012.2685185185167,28.921957671957617,0
1809,4,0,0,37,0.0,0.0,1.0,37,750,600,150,0.8,9,6,3,351.4256055363322,0.43846971971971976,0.17119236883942768,0.18905807892777343,127993.90589569141,1596.0671768707211,129589.97307256213,1117,1,270.97297297297297,34,3,23,38.13357843137255,0.6041666666666667,47.02380952380951,1011.9047619047603,29.761904761904717,0
1810,4,1,0,38,0.02631578947368421,0.0,1.0,38,800,500,300,0.625,11,5,6,341.4181527008311,0.4410413703176861,0.17460180055401642,0.18534128289473675,128355.55555555539,1164.671910430819,129520.2274659862,1118,0,264.8157894736842,34,4,24,38.01740679824562,0.607843137254902,46.66666666666666,1013.333333333332,29.803921568627413,0
1811,4,0,1,37,0.0,0.02631578947368421,0.9736842105263158,38,1100,800,300,0.7272727272727273,14,8,6,355.8113219421137,0.4408487434803224,0.18876990067520927,0.1876035675678612,127182.05959467118,1450.563350340129,128632.62294501132,1119,1,265.8157894736842,34,4,19,38.85479365828711,0.5958946078431373,47.82738095238095,1008.690476190476,29.667366946778706,8
1812,4,0,1,36,0.0,0.02702702702702703,0.972972972972973,37,1050,700,350,0.6666666666666666,14,7,7,369.2297244027645,0.43640515515515516,0.199756986634265,0.19454293417636043,127153.80652873889,1989.7929882737328,129143.59951701263,1120,2,273.9189189189189,33,4,19,38.545463750506286,0.5978535353535354,47.85539215686274,1008.5784313725485,30.562982768865105,0
1813,4,2,0,38,0.05263157894736842,0.0,1.0,38,1400,900,500,0.6428571428571429,19,9,10,363.5112047453997,0.43801861071597914,0.19748779867661348,0.19366726896887684,127602.69451530611,1677.0018424036255,129279.69635770973,1121,0,267.44736842105266,34,4,19,38.228810730136274,0.6001838235294117,47.410714285714285,1010.3571428571428,29.716386554621845,0
1814,4,0,1,37,0.0,0.02631578947368421,0.9736842105263158,38,600,200,400,0.3333333333333333,10,2,8,366.94398210102304,0.4376778093883357,0.1965331713455114,0.19608063889363025,127723.00347222218,1773.4374999999948,129496.44097222218,1122,1,268.44736842105266,34,4,20,38.01868645232207,0.6014093137254901,47.291666666666664,1010.8333333333329,29.730392156862735,0
1815,4,1,0,38,0.02631578947368421,0.0,1.0,38,1300,1000,300,0.7692307692307693,16,10,6,361.9496863880753,0.4386557610241821,0.1923176970432665,0.1944278403872228,127933.6805555556,1661.111111111115,129594.79166666672,1123,0,269.1578947368421,34,4,22,37.92902251510159,0.6035539215686274,47.083333333333336,1011.6666666666671,29.754901960784327,0
1816,4,1,0,39,0.02564102564102564,0.0,1.0,39,850,600,250,0.7058823529411765,11,6,5,354.5178726011767,0.44025528565002253,0.19957992424575366,0.19214210147851993,128291.057487247,1296.2945548268076,129587.3520420738,1124,0,263.2307692307692,35,4,23,37.7514614037092,0.6050595238095238,46.73032407407407,1013.078703703703,28.945105820105802,0
1817,4,0,2,37,0.0,0.05128205128205128,0.9487179487179487,39,850,500,350,0.5882352941176471,12,5,7,341.44936044678155,0.4400865946918579,0.16917942225802762,0.17670360291376333,126421.8445242842,833.331591863865,127255.17611614807,1125,1,264.2307692307692,35,4,15,39.99753040242453,0.5860119047619048,48.58217592592593,1005.6712962962969,28.733465608465625,7
1818,4,3,2,38,0.075,0.05,0.95,40,1100,800,300,0.7272727272727273,14,8,6,336.54318414325326,0.442454594017094,0.20139075067024148,0.17680367279638504,127035.24470416353,550.5691502313025,127585.81385439483,1126,0,258.4,36,4,18,39.49117515638963,0.5902777777777778,47.97297297297297,1008.1081081081073,28.00300300300298,0
1819,4,3,2,39,0.07317073170731707,0.04878048780487805,0.9512195121951219,41,1150,900,250,0.782608695652174,14,9,5,330.47278990660993,0.44110772357723577,0.20472549388323635,0.1754077188616698,127451.59718615342,223.85698003231028,127675.45416618574,1127,0,252.65853658536585,37,4,16,39.21786205523581,0.5926238738738738,47.560307017543856,1009.7587719298244,27.290777619724985,0
1820,4,3,3,39,0.07142857142857142,0.07142857142857142,0.9285714285714286,42,1100,600,500,0.5454545454545454,16,6,10,324.9532061345247,0.44386372435152927,0.20996860282574525,0.1739455397543634,127793.20987654333,-94.63734567899905,127698.57253086433,1128,0,247.57142857142858,38,4,18,39.00812728937728,0.5942982456140351,47.22222222222223,1011.1111111111121,26.608187134502952,0
1821,4,1,0,40,0.025,0.0,1.0,40,850,700,150,0.8235294117647058,10,7,3,341.705089202087,0.4412126068376068,0.2226694915254237,0.18154095023485303,127489.7532667804,712.7795024754611,128202.53276925586,1129,0,260.875,36,4,19,38.895238626226586,0.5949074074074074,47.52252252252253,1009.9099099099109,28.05305305305308,0
1822,4,0,0,40,0.0,0.0,1.0,40,1450,1100,350,0.7586206896551724,18,11,7,344.76221205655867,0.44034455128205124,0.23783836470981434,0.1843317675778276,127745.77100326674,808.3829183913612,128554.1539216581,1130,1,261.875,36,4,19,38.55593925216296,0.5975115740740741,47.26914414414414,1010.9234234234231,28.081206206206197,0
1823,4,3,4,39,0.06976744186046512,0.09302325581395349,0.9069767441860466,43,1150,700,450,0.6086956521739131,16,7,9,324.3884625048372,0.44748984865263935,0.22994201768397748,0.17651391029177282,128450.0173731341,-265.21647427097037,128184.80089886313,1131,0,244.53488372093022,37,6,16,38.35260050477735,0.602759009009009,46.573464912280706,1013.7061403508777,27.397463252726425,0
1824,4,3,1,41,0.07142857142857142,0.023809523809523808,0.9761904761904762,42,800,500,300,0.625,11,5,6,321.9727373770179,0.4457026713124274,0.21826190726896222,0.1762406390126535,128685.9673483271,-113.3253661699174,128572.64198215719,1132,0,237.85714285714286,38,4,18,38.17367765259203,0.6033442982456141,46.340811965811966,1014.636752136752,26.700967161493473,0
1825,4,0,0,41,0.0,0.0,1.0,41,1750,1300,450,0.7428571428571429,22,13,9,328.99190677954994,0.4434705284552845,0.22253495144351776,0.180273540393412,128728.04763244436,270.09716932130027,128998.14480176567,1133,1,244.65853658536585,37,4,20,37.95279578606157,0.6055743243243243,46.29934210526314,1014.8026315789455,27.42709815078231,0
1826,4,0,2,39,0.0,0.04878048780487805,0.9512195121951219,41,1200,800,400,0.6666666666666666,16,8,8,359.12606238448694,0.44308943089430897,0.12877335354706343,0.19449698626169737,128261.74554183817,1065.745815604706,129327.49135744288,1134,2,245.65853658536585,35,6,18,37.66472425350396,0.6047619047619048,46.75925925925926,1012.9629629629633,28.94179894179895,8
1827,4,1,1,39,0.025,0.025,0.975,40,1700,1400,300,0.8235294117647058,20,14,6,391.35449462083915,0.441025641025641,0.1492422448496331,0.20228764146680572,126372.79620181404,1956.9523617059965,128329.74856352003,1135,0,252.6,34,6,16,38.79351172152498,0.5876225490196079,48.63095238095238,1005.4761904761903,29.572829131652654,8
1828,4,2,1,40,0.04878048780487805,0.024390243902439025,0.975609756097561,41,1200,900,300,0.75,15,9,6,375.7306652547608,0.444385162601626,0.1691502685261841,0.19712992437338797,126981.47506925193,1342.166820560159,128323.64188981209,1136,0,247.1951219512195,37,4,19,38.558891789962296,0.5878378378378378,48.02631578947368,1007.8947368421041,27.24039829302984,0
1829,4,2,1,41,0.047619047619047616,0.023809523809523808,0.9761904761904762,42,1100,600,500,0.5454545454545454,16,6,10,366.47657824384896,0.44650116144018587,0.18237227253620691,0.19433283842073526,127413.1559311772,938.9317569431462,128352.08768812034,1137,0,242.07142857142858,35,7,15,38.348451411976015,0.5961309523809524,47.59837962962963,1009.606481481482,28.845899470899486,0
1830,4,2,1,42,0.046511627906976744,0.023255813953488372,0.9767441860465116,43,1100,800,300,0.7272727272727273,14,8,6,362.4721603563473,0.4494970468807678,0.19218936137152332,0.19421241050119337,127831.16731596472,667.0478755782921,128498.21519154301,1138,0,237.3953488372093,36,7,17,38.02083333333333,0.5983796296296297,47.18468468468469,1011.2612612612621,28.090590590590615,0
1831,4,2,0,44,0.045454545454545456,0.0,1.0,44,850,600,250,0.7058823529411765,11,6,5,375.83960245006034,0.4509667899929528,0.23822394222987686,0.20505022395189454,128555.01570001699,863.9804355625449,129418.99613557952,1139,0,232.45454545454547,35,9,14,36.941242486494716,0.6077380952380953,46.4699074074074,1014.1203703703691,28.97486772486769,0
1832,4,0,0,44,0.0,0.0,1.0,44,1000,800,200,0.8,12,8,4,375.52971136188023,0.4510108350951374,0.23993184152376235,0.20503220315664528,128584.36113522375,857.4496045524683,129441.81073977622,1140,1,233.45454545454547,35,9,14,36.91907737076344,0.6080357142857142,46.44097222222222,1014.236111111111,28.978174603174597,0
1833,4,1,1,44,0.022222222222222223,0.022222222222222223,0.9777777777777777,45,1300,800,500,0.6153846153846154,18,8,10,366.7705665163886,0.4526725589225589,0.23152500615915228,0.20221702383727555,128972.51136271423,460.66421150882235,129433.17557422305,1141,0,229.24444444444444,36,9,16,36.74473392461198,0.6099537037037037,46.058558558558566,1015.765765765767,28.21571571571575,0
1834,4,0,2,42,0.0,0.045454545454545456,0.9545454545454546,44,950,600,350,0.631578947368421,13,6,7,374.05674042606887,0.45006386539816773,0.2349244929053389,0.20543842644189406,128819.24518014831,837.1413912465697,129656.38657139488,1142,1,235.38636363636363,35,9,16,36.7162856762817,0.6104166666666666,46.20949074074074,1015.162037037037,29.004629629629626,0
1835,4,1,1,42,0.023255813953488372,0.023255813953488372,0.9767441860465116,43,1750,1500,250,0.8571428571428571,20,15,5,381.6308407227264,0.448827980804725,0.2577028928237115,0.2119660452688878,129263.69214965405,1266.768279579824,130530.46042923386,1143,0,240.88372093023256,33,10,18,36.06993653089096,0.6193181818181819,45.77205882352941,1016.9117647058829,30.81550802139039,0
1836,4,1,0,43,0.023255813953488372,0.0,1.0,43,1100,800,300,0.7272727272727273,14,8,6,384.03781768307243,0.44737449243263194,0.25907060750738564,0.21448783294269777,129481.87183114664,1345.1870975105676,130827.0589286572,1144,0,241.72093023255815,33,10,17,35.78604756170981,0.6215277777777778,45.557598039215684,1017.769607843137,30.84150326797385,0
1837,4,1,0,44,0.022727272727272728,0.0,1.0,44,1400,1200,200,0.8571428571428571,16,12,4,370.77287976629714,0.44836812896405914,0.26226344059033213,0.20970321213515444,129975.3485537904,838.266856383428,130813.61541017384,1145,0,237.20454545454547,36,8,18,35.621203754831605,0.6200810185185186,45.073198198198206,1019.7072072072083,28.32520020020023,0
1838,4,1,1,44,0.022222222222222223,0.022222222222222223,0.9777777777777777,45,1500,1100,400,0.7333333333333333,19,11,8,359.42387757138295,0.449179292929293,0.2600022668026756,0.20525546095872543,130351.21588059393,370.90197161545626,130722.11785220938,1146,0,232.9111111111111,35,10,19,35.5289442366542,0.6258928571428571,44.7048611111111,1021.1805555555538,29.17658730158725,0
1839,4,1,0,45,0.022222222222222223,0.0,1.0,45,1100,600,500,0.5454545454545454,16,6,10,358.6491971308067,0.44842171717171714,0.26118473213274473,0.20575138151188363,130528.56445312485,362.79296874998505,130891.35742187484,1147,0,233.77777777777777,35,10,15,35.36888379204893,0.6276785714285714,44.53124999999999,1021.8749999999989,29.196428571428537,0
1840,4,0,1,44,0.0,0.022222222222222223,0.9777777777777777,45,750,600,150,0.8,9,6,3,359.79590028355426,0.44835858585858585,0.26340579710144985,0.20688264266304335,130617.283950617,399.1126543209565,131016.39660493795,1148,1,234.77777777777777,35,10,15,35.24966032608697,0.6285714285714286,44.44444444444443,1022.2222222222199,29.20634920634914,0
1841,4,0,0,44,0.0,0.0,1.0,44,1300,1100,200,0.8461538461538461,15,11,4,360.1915133416545,0.44707980972515854,0.26398363945053305,0.20758591130942666,130706.03358892718,615.840808256137,131321.87439718333,1149,2,240.4318181818182,35,9,16,35.14961799660441,0.6294642857142857,44.35763888888887,1022.5694444444421,29.216269841269774,0
1842,4,0,1,43,0.0,0.022727272727272728,0.9772727272727273,44,1150,900,250,0.782608695652174,14,9,5,362.16043570418265,0.446694415081043,0.26684873171634904,0.20920091050676876,130794.81336805536,673.74131944442,131468.55468749977,1150,3,241.4318181818182,35,9,16,35.009334691106574,0.6303571428571428,44.27083333333332,1022.916666666665,29.22619047619043,0
1843,4,0,1,42,0.0,0.023255813953488372,0.9767441860465116,43,1250,800,450,0.64,17,8,9,374.60765330184586,0.4447443706164636,0.27467952882075264,0.21630570948719488,130779.59183673469,1198.2071995464817,131977.79903628118,1151,4,247.72093023255815,34,9,16,34.706461436995646,0.6323529411764706,44.285714285714285,1022.8571428571428,30.084033613445374,0
1844,4,2,1,43,0.045454545454545456,0.022727272727272728,0.9772727272727273,44,1150,900,250,0.782608695652174,14,9,5,364.32542622769694,0.44537306201550386,0.26685860754682067,0.2122393480374517,131120.5970963006,754.1134848679707,131874.71058116856,1152,0,242.25,35,9,19,34.62408652578447,0.6336309523809525,43.9525462962963,1024.189814814815,29.262566137566143,0
1845,4,0,1,42,0.0,0.023255813953488372,0.9767441860465116,43,800,400,400,0.5,12,4,8,372.1037021575637,0.4436830933923957,0.266996973688125,0.21605129877467188,130992.77388038552,1148.579223356015,132141.35310374154,1153,1,248.27906976744185,34,9,20,34.55440555103307,0.6344975490196079,44.077380952380956,1023.6904761904765,30.108543417366956,0
1846,4,1,0,43,0.023255813953488372,0.0,1.0,43,1250,800,450,0.64,17,8,9,371.7611189624748,0.4418835363602805,0.26092736904542746,0.21676532936427403,131155.04017531066,1151.6688986283857,132306.70907393904,1154,0,249.04651162790697,36,7,21,34.39881999413661,0.6319444444444444,43.91891891891893,1024.3243243243262,28.453453453453506,0
1847,4,0,1,42,0.0,0.023255813953488372,0.9767441860465116,43,850,600,250,0.7058823529411765,11,6,5,368.28334791366564,0.4413528977482466,0.2577719611261353,0.21506045566871201,131212.72243527326,1064.6921414658075,132277.41457673907,1155,1,250.04651162790697,36,7,21,34.429499157323974,0.6325231481481481,43.86261261261262,1024.5495495495506,28.459709709709742,0
1848,4,1,0,43,0.023255813953488372,0.0,1.0,43,1250,800,450,0.64,17,8,9,358.1830364101161,0.44176818014027314,0.2617997156631813,0.21142814918855476,131624.87809713668,829.2104271908513,132454.08852432753,1156,0,249.30232558139534,35,8,13,34.271843747650195,0.6386904761904761,43.46064814814816,1026.157407407409,29.318783068783112,0
1849,4,0,1,42,0.0,0.023255813953488372,0.9767441860465116,43,1100,800,300,0.7272727272727273,14,8,6,356.2981049340201,0.4416297526762643,0.25419084503903044,0.21080773133154285,131713.96933138304,785.8875332218979,132499.85686460492,1157,1,250.30232558139534,35,8,13,34.2303012365167,0.6395833333333334,43.3738425925926,1026.504629629631,29.32870370370374,0
1850,4,0,0,42,0.0,0.0,1.0,42,1150,900,250,0.782608695652174,14,9,5,366.09677411147743,0.4394115369725126,0.2628274189360156,0.21597454456309592,131602.82206632686,1235.8737244898307,132838.69579081668,1158,2,256.8333333333333,34,8,13,34.09110685694395,0.640625,43.482142857142875,1026.0714285714312,30.178571428571505,0
1851,4,0,0,42,0.0,0.0,1.0,42,1750,1300,450,0.7428571428571429,22,13,9,364.4944023633094,0.4382379984514131,0.2599729546991214,0.21650089200615869,131862.52170138905,1212.6302083333562,133075.1519097224,1159,3,257.8333333333333,35,7,14,33.87001352265045,0.6410714285714285,43.22916666666668,1027.0833333333346,29.34523809523813,0
1852,4,0,1,41,0.0,0.023809523809523808,0.9761904761904762,42,1350,1000,350,0.7407407407407407,17,10,7,364.2178260740457,0.4377177700348432,0.2526051303503718,0.2171853645205814,132011.15779588927,1216.1633819873384,133227.3211778766,1160,4,258.8333333333333,35,7,14,33.72716991402937,0.6425595238095239,43.084490740740755,1027.6620370370388,29.361772486772537,0
1853,4,1,1,41,0.023809523809523808,0.023809523809523808,0.9761904761904762,42,1300,900,400,0.6923076923076923,17,9,8,364.2734669617349,0.4380081300813008,0.256921560117239,0.21858867662990816,132249.14969403733,1234.971252357697,133484.12094639504,1161,0,259.6666666666667,35,7,16,33.48582667566858,0.6449404761904762,42.85300925925927,1028.587962962964,29.38822751322754,0
1854,4,1,2,40,0.023809523809523808,0.047619047619047616,0.9523809523809523,42,1200,800,400,0.6666666666666666,16,8,8,365.36773885323134,0.43687088656600853,0.26662651569902796,0.2206344899592324,132487.35592689048,1281.3211323302473,133768.67705922073,1162,0,260.2857142857143,35,7,18,33.21774873524451,0.6473214285714286,42.62152777777778,1029.5138888888891,29.41468253968255,0
1855,4,1,0,41,0.024390243902439025,0.0,1.0,41,1400,1100,300,0.7857142857142857,17,11,6,371.08903697752277,0.43572154471544716,0.275040960607317,0.22428714750654027,132520.55165816314,1635.3847789115532,134155.93643707468,1163,0,267.1219512195122,34,7,21,33.03705630708752,0.6498161764705883,42.58928571428571,1029.6428571428562,30.283613445378123,0
1856,4,0,0,41,0.0,0.0,1.0,41,1150,900,250,0.782608695652174,14,9,5,374.0534766079121,0.4348577235772358,0.2797774094245806,0.22663240053302883,132612.49999999983,1720.8333333333196,134333.33333333314,1164,1,268.1219512195122,34,7,21,32.8681229773463,0.6507352941176471,42.49999999999999,1029.9999999999986,30.294117647058783,0
1857,4,0,0,41,0.0,0.0,1.0,41,900,500,400,0.5555555555555556,13,5,8,372.0536995039613,0.43419715447154467,0.2772776722451764,0.2257891104843814,132673.8166099772,1672.3568594104158,134346.1734693876,1165,2,269.1219512195122,34,7,15,32.857878822894996,0.6513480392156863,42.44047619047618,1030.2380952380943,30.301120448179244,0
1858,4,0,1,40,0.0,0.024390243902439025,0.975609756097561,41,1000,900,100,0.9,11,9,2,384.5442529377881,0.433739837398374,0.30442355397345744,0.21700400922228813,129887.55076172652,1835.339111134686,131722.8898728612,1166,3,270.1219512195122,33,8,20,35.359561593331755,0.6256313131313131,45.159313725490215,1019.3627450980414,30.889780154486104,8
1859,4,0,0,40,0.0,0.0,1.0,40,1200,800,400,0.6666666666666666,16,8,8,391.79225221893455,0.43356036324786323,0.30338942307692296,0.2214477947324417,129950.01922337589,2182.6821414840797,132132.70136485997,1167,4,273.9,33,7,21,35.11117788461539,0.6262626262626263,45.09803921568629,1019.6078431372571,30.89720736779567,0
1860,4,0,0,40,0.0,0.0,1.0,40,650,300,350,0.46153846153846156,10,3,7,390.5566802983299,0.43319978632478634,0.30444958538637157,0.22092604600696197,129981.25908604893,2153.009809928908,132134.26889597785,1168,5,274.9,33,7,21,35.11083904178183,0.6265782828282829,45.06740196078433,1019.7303921568652,30.900920974450457,0
1861,4,0,0,40,0.0,0.0,1.0,40,1450,900,550,0.6206896551724138,20,9,11,394.39831740029985,0.4328792735042735,0.30840742520725706,0.22345658241815505,130043.75007509145,2257.8072436082452,132301.5573186997,1169,6,275.9,33,7,21,34.94921202290841,0.627209595959596,45.0061274509804,1019.9754901960795,30.908348187759984,0
1862,4,0,0,40,0.0,0.0,1.0,40,1050,800,250,0.7619047619047619,13,8,5,394.8598688778866,0.4327590811965812,0.30827927927927856,0.22407691945524263,130106.25608239633,2274.747843377562,132381.0039257739,1170,7,276.9,33,7,21,34.87374874874876,0.6278409090909092,44.94485294117648,1020.2205882352952,30.91577540106955,0
1863,4,0,0,40,0.0,0.0,1.0,40,1350,1000,350,0.7407407407407407,17,10,7,397.6600669423375,0.4320245726495726,0.30986012726617806,0.22639170865090455,130231.3131517928,2357.5585411861066,132588.8716929789,1171,8,277.9,33,7,21,34.674905951094566,0.6291035353535354,44.82230392156864,1020.7107843137272,30.930629827688705,0
1864,4,1,0,41,0.024390243902439025,0.0,1.0,41,1250,1000,250,0.8,15,10,5,390.36510810029495,0.4332317073170732,0.3164320351089476,0.22577647901047027,130843.25140610649,2015.3355049988634,132858.58691110535,1172,0,272.0975609756098,32,9,17,34.23886214982104,0.6376953125,44.223484848484844,1023.1060606060603,31.972064393939384,0
1865,4,0,0,41,0.0,0.0,1.0,41,1150,600,550,0.5217391304347826,17,6,11,392.56658609014875,0.4332063008130081,0.3148558758314859,0.22781226295152723,130972.4633487654,2083.0825617283945,133055.5459104938,1173,1,273.0975609756098,32,9,17,34.0513342379014,0.6389973958333333,44.09722222222222,1023.611111111111,31.987847222222218,0
1866,4,0,1,40,0.0,0.024390243902439025,0.975609756097561,41,1400,900,500,0.6428571428571429,19,9,10,392.93699934926866,0.4329014227642276,0.3126154924026805,0.2284612825026538,131045.64838343408,2098.5367707131677,133144.18515414724,1174,2,274.0975609756098,33,8,17,33.96755934570118,0.6373106060606061,44.02573529411764,1023.8970588235279,31.027183600712966,0
1867,4,1,1,40,0.024390243902439025,0.024390243902439025,0.975609756097561,41,1000,600,400,0.6,14,6,8,390.91481422128646,0.4317835365853659,0.3100011669973164,0.2282156317660581,131202.54229142625,2057.803489042666,133260.34578046892,1175,0,274.8048780487805,33,8,19,33.8601475279107,0.6388888888888888,43.87254901960784,1024.5098039215677,31.0457516339869,0
1868,4,0,0,40,0.0,0.0,1.0,40,850,700,150,0.8235294117647058,10,7,3,427.7325091059281,0.4303151709401709,0.29624235168927937,0.2280633335786075,127634.70668574395,3011.8158936209124,130646.52257936486,1176,1,282.325,30,10,18,36.573612219561944,0.6104166666666666,47.37903225806451,1010.4838709677414,33.682795698924714,8
1869,4,1,1,40,0.024390243902439025,0.024390243902439025,0.975609756097561,41,800,600,200,0.75,10,6,4,422.3266508824352,0.4329014227642276,0.30181789663555847,0.22786882100006464,128111.57438490118,2620.9864298502516,130732.56081475143,1177,0,276.4146341463415,31,10,19,36.21878349410505,0.6125672043010753,46.90755208333333,1012.369791666666,32.65709005376342,0
1870,4,1,1,40,0.024390243902439025,0.024390243902439025,0.975609756097561,41,1250,900,350,0.72,16,9,7,424.5902010986893,0.4376778455284553,0.2892764515485464,0.2172278786508035,125951.55897070836,2495.559550413295,128447.11852112165,1178,0,272.6829268292683,33,8,16,38.39516440809016,0.5855429292929293,49.05024509803921,1003.799019607843,30.418152109328574,8
1871,4,5,4,41,0.1111111111111111,0.08888888888888889,0.9111111111111111,45,1050,800,250,0.7619047619047619,13,8,5,391.36670992418567,0.45035774410774415,0.28613406795224994,0.205892921307941,127092.01388888885,958.2980404171408,128050.31192930599,1179,0,249.26666666666668,32,13,18,38.050964187327835,0.599609375,47.916666666666664,1008.3333333333329,31.510416666666654,0
1872,4,1,0,42,0.023809523809523808,0.0,1.0,42,850,400,450,0.47058823529411764,13,4,9,406.9475499656148,0.4447590011614402,0.2966201843535814,0.21283004745420447,126852.04790249417,1924.4260204081472,128776.47392290233,1180,0,260.9047619047619,34,8,19,37.90598164342553,0.5925245098039216,48.1547619047619,1007.3809523809512,29.62885154061621,0
1873,4,0,0,42,0.0,0.0,1.0,42,950,700,250,0.7368421052631579,12,7,5,405.7463255983694,0.4447469028261711,0.2968103957471946,0.21267137128112654,126942.00857426292,1901.2507086167639,128843.25928287968,1181,1,261.9047619047619,34,8,19,37.84332545776728,0.5934436274509804,48.06547619047618,1007.7380952380942,29.639355742296885,0
1874,4,0,1,41,0.0,0.023809523809523808,0.9761904761904762,42,1900,1500,400,0.7894736842105263,23,15,8,413.43101882511496,0.4441661827332559,0.30582249684896556,0.21767663091777814,127124.83935885964,2111.7361021150045,129236.57546097464,1182,2,262.9047619047619,31,11,20,37.46086184635248,0.602486559139785,47.884114583333336,1008.4635416666671,32.531081989247326,0
1875,4,1,0,42,0.023809523809523808,0.0,1.0,42,1250,1100,150,0.88,14,11,3,414.11625589553546,0.4450130662020906,0.3055376805376808,0.21889002097335422,127283.05785123953,2141.996671258017,129425.05452249755,1183,0,263.4047619047619,32,10,21,37.28024899899899,0.6015625,47.72727272727272,1009.090909090908,31.534090909090875,0
1876,4,0,0,42,0.0,0.0,1.0,42,1200,900,300,0.75,15,9,6,411.01063399146034,0.4447348044909021,0.3030554811042614,0.2177620953453761,127378.63363751148,2070.7945936639103,129449.42823117539,1184,1,264.4047619047619,32,10,18,37.2600062539087,0.6025390625,47.63257575757576,1009.4696969696969,31.545928030303028,0
1877,4,0,1,41,0.0,0.023809523809523808,0.9761904761904762,42,700,400,300,0.5714285714285714,10,4,6,407.4733987322789,0.4449404761904762,0.2995927553316904,0.21639921932674408,127474.24529384755,1988.4727961432502,129462.7180899908,1185,2,265.4047619047619,32,10,18,37.250718929732436,0.603515625,47.53787878787879,1009.8484848484846,31.557765151515145,0
1878,4,1,1,41,0.023809523809523808,0.023809523809523808,0.9761904761904762,42,1200,900,300,0.75,15,9,6,411.45037352903876,0.44625919473480447,0.32314687989733315,0.21198758230287867,126240.03940158426,2057.3162768935854,128297.35567847785,1186,0,264.9761904761905,31,11,19,38.42586594109007,0.5934139784946236,48.763020833333336,1004.9479166666672,32.417674731182814,8
1879,4,2,0,43,0.046511627906976744,0.0,1.0,43,1150,800,350,0.6956521739130435,15,8,7,398.76035789407166,0.447328349944629,0.31737079631485643,0.20756765397603957,126659.88592128025,1501.3882881583968,128161.27420943865,1187,0,259.6279069767442,33,10,19,38.31060790520249,0.5928030303030303,48.345588235294116,1006.6176470588233,30.503565062388585,0
1880,4,1,0,44,0.022727272727272728,0.0,1.0,44,600,200,400,0.3333333333333333,10,2,8,396.7830283369108,0.4478836328400282,0.3354115209943431,0.2089061336405344,127123.84458537394,1289.588595379365,128413.4331807533,1188,0,254.70454545454547,32,12,20,37.88160969909436,0.5999348958333333,47.88510101010101,1008.459595959596,31.514362373737374,0
1881,4,0,0,44,0.0,0.0,1.0,44,1200,1100,100,0.9166666666666666,13,11,2,394.4390198327392,0.4476193622269204,0.3307044288460881,0.2083253276591817,127251.20722694117,1238.5682902254944,128489.77551716666,1189,1,255.70454545454547,32,12,21,37.80946272890335,0.6012369791666667,47.75883838383839,1008.9646464646469,31.530145202020215,0
1882,4,2,2,44,0.043478260869565216,0.043478260869565216,0.9565217391304348,46,1250,900,350,0.72,16,9,7,381.3410688378819,0.4500805152979066,0.23884966639610772,0.2077979451882429,128506.39349489778,633.7383283202852,129140.13182321806,1190,0,245.54347826086956,34,12,16,36.85154201401119,0.609375,46.51785714285713,1013.9285714285701,29.82142857142853,8
1883,4,0,0,44,0.0,0.0,1.0,44,1050,700,350,0.6666666666666666,14,7,7,389.9451472868705,0.4460998062015504,0.26983646103491643,0.21192211897574179,128400.34060618802,1213.8179458728534,129614.15855206088,1191,1,257.5681818181818,32,12,16,36.742141107096884,0.6129557291666667,46.62247474747474,1013.5101010101,31.672190656565625,0
1884,4,0,0,44,0.0,0.0,1.0,44,1150,900,250,0.782608695652174,14,9,5,387.644500979793,0.44567036645525016,0.2694828741909605,0.21112461860472828,128485.98082768628,1161.3767841695221,129647.3576118558,1192,2,258.5681818181818,33,11,17,36.712674765300775,0.6114267676767677,46.53799019607842,1013.8480392156847,30.72266785502075,0
1885,4,1,0,45,0.022222222222222223,0.0,1.0,45,1500,1000,500,0.6666666666666666,20,10,10,381.00212369098426,0.44720117845117846,0.2782375216890216,0.20956311167028202,128877.99968117679,820.5583151148471,129698.55799629164,1193,0,253.8,35,10,19,36.47994319692996,0.6110119047619047,46.15162037037035,1015.3935185185159,29.01124338624331,0
1886,4,1,0,46,0.021739130434782608,0.0,1.0,46,1450,1000,450,0.6896551724137931,19,10,9,376.68943614119075,0.44747383252818035,0.278114930570607,0.208740057706969,129172.76810171641,531.6034362064556,129704.37153792287,1194,0,249.2608695652174,36,10,20,36.288357150769905,0.6119791666666667,45.86148648648648,1016.5540540540527,28.237612612612576,0
1887,4,0,0,46,0.0,0.0,1.0,46,1150,700,450,0.6086956521739131,16,7,9,378.9446864248882,0.4476650563607085,0.28388715981849955,0.21047409691791988,129263.69214965403,596.7673687551778,129860.4595184092,1195,1,250.2608695652174,33,13,20,36.13822607857314,0.6193181818181819,45.77205882352941,1016.9117647058828,30.815508021390386,0
1888,4,0,0,46,0.0,0.0,1.0,46,1350,1000,350,0.7407407407407407,17,10,7,375.9709545194861,0.4476650563607085,0.28274094118125737,0.20977804955826168,129443.5657596372,533.4041950113374,129976.96995464854,1196,2,251.2608695652174,34,12,17,36.0303579784745,0.6188725490196079,45.595238095238095,1017.6190476190478,29.929971988795526,0
1889,4,1,0,47,0.02127659574468085,0.0,1.0,47,1200,900,300,0.75,15,9,6,367.1178057308517,0.44950662966389143,0.2853040912068179,0.20650083347275952,129760.9247068972,127.50918960046894,129888.43389649768,1197,0,246.89361702127658,35,12,18,35.932470937937815,0.6199404761904762,45.28356481481481,1018.8657407407401,29.110449735449716,0
1890,4,0,0,47,0.0,0.0,1.0,47,1350,1000,350,0.7407407407407407,17,10,7,368.6192928818645,0.4491982732038236,0.28811221248088414,0.2079711795266228,129878.8757742842,175.1718696416375,130054.04764392583,1198,1,247.89361702127658,35,12,18,35.77421842473789,0.6211309523809524,45.167824074074076,1019.3287037037043,29.123677248677264,0
1891,4,0,1,46,0.0,0.02127659574468085,0.9787234042553191,47,1550,1100,450,0.7096774193548387,20,11,9,367.1900385909611,0.4491211840888067,0.28305695328420577,0.2079484974333901,130026.3899605625,148.87902949246623,130175.26899005497,1199,2,248.89361702127658,35,12,18,35.66065214101982,0.6226190476190476,45.02314814814815,1019.9074074074082,29.140211640211664,0
1892,4,1,1,46,0.02127659574468085,0.02127659574468085,0.9787234042553191,47,1050,700,350,0.6666666666666666,14,7,7,367.6793759877239,0.4483117483811286,0.3029386829552305,0.20982907950203555,130325.14537677832,184.00229493881682,130509.14767171715,1200,0,249.63829787234042,33,14,21,35.34465514482318,0.630050505050505,44.730392156862756,1021.0784313725503,30.94177064765304,0
1893,4,0,0,46,0.0,0.0,1.0,46,1450,900,550,0.6206896551724138,20,9,11,379.00874635568516,0.44716183574879226,0.3069210292812774,0.2159468438538207,130262.58680555562,674.1319444444532,130936.71875000007,1201,1,255.69565217391303,34,12,22,35.11904761904762,0.6271446078431373,44.79166666666667,1020.8333333333339,30.024509803921585,0
1894,4,1,1,46,0.02127659574468085,0.02127659574468085,0.9787234042553191,47,1950,1600,350,0.8205128205128205,23,16,7,364.95337883160767,0.4478492136910268,0.29638567949076866,0.20990319250013523,130627.42524092985,134.58404195012935,130762.00928287998,1202,0,251.2340425531915,34,13,16,35.10757540468149,0.6308210784313726,44.43452380952382,1022.261904761906,30.066526610644292,0
1895,4,1,0,47,0.02127659574468085,0.0,1.0,47,1100,800,300,0.7272727272727273,14,8,6,367.1255934222456,0.44624961455442497,0.2987887944913681,0.21165160050316034,130718.71456916099,198.03713151927386,130916.75170068027,1203,0,252.2127659574468,34,13,17,34.959497477687236,0.6317401960784313,44.345238095238095,1022.6190476190476,30.077030812324928,0
1896,4,0,1,46,0.0,0.02127659574468085,0.9787234042553191,47,1300,800,500,0.6153846153846154,18,8,10,367.21875033156846,0.4462110699969164,0.29648624298288184,0.21270972896564466,130901.38888888907,213.88888888891375,131115.27777777798,1204,1,253.2127659574468,34,13,18,34.771986970684054,0.633578431372549,44.16666666666668,1023.3333333333347,30.098039215686317,0
1897,4,0,1,45,0.0,0.021739130434782608,0.9782608695652174,46,1150,500,650,0.43478260869565216,18,5,13,376.4044265313501,0.4449979871175523,0.30160071232710317,0.21768638234255902,130840.48327664411,649.7874149659988,131490.27069161012,1205,2,259.1521739130435,34,12,18,34.598751066635636,0.6329656862745099,44.22619047619048,1023.0952380952391,30.091036414565856,0
1898,4,0,1,44,0.0,0.022222222222222223,0.9777777777777777,45,1400,900,500,0.6428571428571429,19,9,10,385.36094343386185,0.44309764309764305,0.3045380498021877,0.22286621452695882,130840.48327664396,1084.1624149659847,131924.64569160994,1206,3,265.3333333333333,34,11,18,34.36966682181366,0.6329656862745099,44.226190476190474,1023.095238095238,30.09103641456582,0
1899,4,1,1,44,0.022222222222222223,0.022222222222222223,0.9777777777777777,45,1500,900,600,0.6,21,9,12,387.1584667402689,0.44244528619528617,0.3120772946859911,0.22532727543300354,131084.1907596371,1150.0708616779978,132234.2616213151,1207,0,266.1111111111111,34,11,20,34.07637758660777,0.6354166666666667,43.988095238095234,1024.0476190476184,30.1190476190476,0
1900,4,0,1,43,0.0,0.022727272727272728,0.9772727272727273,44,1200,800,400,0.6666666666666666,16,8,8,390.61317502318553,0.441926532769556,0.3044900022833279,0.22822618842549633,131233.93233672142,1452.3405961649264,132686.27293288635,1208,1,249.54545454545453,33,11,21,33.836039349360114,0.6392045454545454,43.84191176470588,1024.6323529411761,31.0494652406417,0
1901,4,0,0,43,0.0,0.0,1.0,43,1400,900,500,0.6428571428571429,19,9,10,399.1267593365076,0.44096068660022153,0.3163655527478617,0.23284649248072156,131175.6395266438,1871.1415816326298,133046.78110827642,1209,2,255.93023255813952,34,9,22,33.67712570211117,0.6363357843137255,43.89880952380951,1024.4047619047603,30.129551820728246,0
1902,4,0,0,43,0.0,0.0,1.0,43,2100,1500,600,0.7142857142857143,27,15,12,406.4378110517376,0.44056847545219635,0.3214321410530354,0.2378669690920736,131297.62081916083,2072.8635204081356,133370.48433956897,1210,3,256.93023255813955,34,9,22,33.366002632903545,0.6375612745098039,43.77976190476189,1024.880952380951,30.143557422969145,0
1903,4,0,0,43,0.0,0.0,1.0,43,1200,900,300,0.75,15,9,6,391.3014739903495,0.4402224067921742,0.23577235772357708,0.2291908633372048,131328.12500000003,1682.3767006802725,133010.5017006803,1211,4,257.93023255813955,33,10,18,33.722899728997284,0.6401515151515151,43.75,1025.0000000000002,31.060606060606066,8
1904,4,1,2,42,0.022727272727272728,0.045454545454545456,0.9545454545454546,44,800,500,300,0.625,11,5,6,384.869536662701,0.44108967582804787,0.23370596920480913,0.22723119219400556,131633.3616780045,1332.334183673464,132965.69586167796,1212,0,253.04545454545453,34,10,16,33.57864462490333,0.6409313725490196,43.45238095238095,1026.190476190476,30.182072829131645,0
1905,4,0,0,42,0.0,0.0,1.0,42,1400,1100,300,0.7857142857142857,17,11,6,397.41784716914066,0.43729432830042586,0.2619445914343752,0.23373084771317898,131485.1878634419,2050.9120590638167,133536.09992250573,1213,10,265.9761904761905,33,9,19,33.40689349583781,0.641729797979798,43.59681372549019,1025.6127450980389,31.079174093879967,0
1906,4,0,0,42,0.0,0.0,1.0,42,1300,1000,300,0.7692307692307693,16,10,6,398.8708398306975,0.43622967479674796,0.2674825870646771,0.23574758529160833,131673.78720023535,2104.1668168492756,133777.95401708462,1214,11,266.9761904761905,33,9,17,33.178482587064686,0.6436237373737373,43.412990196078425,1026.3480392156853,31.101455733808645,0
1907,4,0,0,42,0.0,0.0,1.0,42,850,500,350,0.5882352941176471,12,5,7,394.69792184015984,0.4359877080913666,0.2639563762012742,0.23405335365171262,131799.5951827422,2004.2052636005365,133803.80044634274,1215,12,267.9761904761905,33,9,17,33.15816823805546,0.6448863636363636,43.29044117647059,1026.8382352941176,31.116310160427805,0
1908,4,0,0,42,0.0,0.0,1.0,42,1750,1300,450,0.7428571428571429,22,13,9,392.37314709552203,0.4356368563685637,0.25586294618014116,0.23402853567162493,132019.9037029027,1960.2130190311316,133980.11672193382,1216,13,268.9761904761905,33,9,19,32.99497177836074,0.6470959595959596,43.07598039215686,1027.6960784313721,31.14230540701128,0
1909,4,0,0,42,0.0,0.0,1.0,42,900,500,400,0.5555555555555556,13,5,8,391.06376994009275,0.43503193960511033,0.24906634882797007,0.23402460982862885,132145.87688629364,1935.4929594386626,134081.3698457323,1217,14,269.9761904761905,33,9,19,32.90127135478745,0.6483585858585859,42.95343137254901,1028.186274509803,31.157159833630395,0
1910,4,0,1,41,0.0,0.023809523809523808,0.9761904761904762,42,1350,1100,250,0.8148148148148148,16,11,5,392.4977610122034,0.4348262679055362,0.25177225160346595,0.23552515881940908,132249.14969403707,1981.499030135446,134230.64872417253,1218,15,270.9761904761905,35,7,19,32.76004744758261,0.6449404761904762,42.85300925925925,1028.587962962962,29.388227513227484,0
1911,4,0,1,40,0.0,0.024390243902439025,0.975609756097561,41,1200,900,300,0.75,15,9,6,393.35979176998643,0.4337144308943089,0.24784737013489688,0.2367932659548178,132369.03077063544,2213.730876146412,134582.76164678184,1219,16,273.7073170731707,36,5,19,32.61677427591742,0.6440972222222222,42.736486486486484,1029.0540540540535,28.58483483483482,0
1912,4,0,0,40,0.0,0.0,1.0,40,1000,500,500,0.5,15,5,10,396.14887903938484,0.4311565170940171,0.2586885343493277,0.23885530761319393,132429.53619100817,2492.3688035549585,134921.90499456314,1220,17,280.825,33,7,19,32.48390185339524,0.651199494949495,42.67769607843137,1029.2892156862738,31.19058229352345,0
1913,4,0,0,40,0.0,0.0,1.0,40,1350,900,450,0.6666666666666666,18,9,9,377.49960054728393,0.43106303418803416,0.13757242178447293,0.22467734846365925,131938.95266439908,1969.5578292591554,133908.51049365825,1221,18,281.825,34,6,18,33.458864426419474,0.6439950980392157,43.154761904761905,1027.3809523809523,30.21708683473389,8
1914,4,0,0,40,0.0,0.0,1.0,40,950,800,150,0.8421052631578947,11,8,3,380.18814403547026,0.430982905982906,0.13323100092678386,0.22664254553274718,132000.11337868482,2036.9756235827663,134037.08900226757,1222,19,282.825,34,6,18,33.3280236329935,0.6446078431372548,43.095238095238095,1027.6190476190477,30.224089635854344,0
1915,4,0,0,40,0.0,0.0,1.0,40,1200,800,400,0.6666666666666666,16,8,8,380.1446495170836,0.4305956196581197,0.13328172503096525,0.22703864373646418,132070.63567654754,2041.1891021519277,134111.82477869946,1223,20,283.825,35,5,18,33.25791483691776,0.643154761904762,43.026620370370374,1027.893518518519,29.368386243386254,0
1916,4,0,0,40,0.0,0.0,1.0,40,900,800,100,0.8888888888888888,10,8,2,378.48574482737246,0.4297542735042735,0.1289396668167493,0.2265813582915347,132159.87761488333,2004.1259430726923,134164.00355795602,1224,21,284.825,35,5,19,33.210453249287106,0.644047619047619,42.93981481481481,1028.24074074074,29.378306878306855,0
1917,4,0,0,40,0.0,0.0,1.0,40,1600,1200,400,0.75,20,12,8,383.65093877183756,0.4295005341880342,0.1287594396410201,0.2307714698853377,132340.0612394489,2154.4777463274095,134494.5389857763,1225,22,285.825,36,4,19,32.89578089088323,0.6438078703703703,42.76463963963964,1028.9414414414414,28.581706706706704,0
1918,4,0,1,39,0.0,0.025,0.975,40,1250,800,450,0.64,17,8,9,402.64924570791237,0.4291666666666667,0.10670512099043328,0.24123658449863786,132189.63162562152,2726.176771409009,134915.80839703052,1226,23,286.825,35,5,20,32.5592055899456,0.6443452380952381,42.910879629629626,1028.356481481481,29.381613756613746,8
1919,4,0,1,38,0.0,0.02564102564102564,0.9743589743589743,39,1100,1000,100,0.9090909090909091,12,10,2,404.64382930384085,0.4290092217723797,0.10983499525166196,0.2427862975823045,132244.89795918364,2902.4163832199474,135147.31434240358,1227,24,290.53846153846155,34,5,20,32.45201581790123,0.6470588235294117,42.857142857142854,1028.5714285714282,30.252100840336123,0
1920,4,1,1,38,0.02564102564102564,0.02564102564102564,0.9743589743589743,39,700,400,300,0.5714285714285714,10,4,6,400.8248687815718,0.42808142150247414,0.12406667068458654,0.24169423977395885,132432.58794369295,2816.8092453769664,135249.39718906992,1228,0,290.8974358974359,30,9,21,32.360494472011844,0.6590277777777778,42.6747311827957,1029.3010752688176,34.31003584229392,0
1921,4,0,0,38,0.0,0.0,1.0,38,900,700,200,0.7777777777777778,11,7,4,399.1091867617105,0.42603129445234705,0.14742365459736084,0.24151144285373904,132565.56404961486,2981.626892089853,135547.1909417047,1229,1,298.63157894736844,31,7,22,32.27033021452355,0.6575940860215054,42.54557291666667,1029.817708333334,33.21992607526884,0
1922,4,0,0,38,0.0,0.0,1.0,38,950,700,250,0.7368421052631579,12,7,5,393.5414235547495,0.4255423186344239,0.14463668686464004,0.23908210182430176,132713.49961553258,2845.651912725882,135559.15152825846,1230,2,299.63157894736844,33,5,17,32.26441087852838,0.654040404040404,42.40196078431373,1030.3921568627457,31.224004753416533,0
1923,4,0,0,38,0.0,0.0,1.0,38,850,600,250,0.7058823529411765,11,6,5,397.53987453360116,0.42521633475580844,0.14835096063583442,0.24191825939418132,132776.6438989812,2956.802071318729,135733.44597029992,1231,3,300.63157894736844,33,5,17,32.09770114942529,0.6546717171717171,42.34068627450981,1030.6372549019611,31.231431966726095,0
1924,4,0,1,37,0.0,0.02631578947368421,0.9736842105263158,38,950,600,350,0.631578947368421,13,6,7,399.03260334406195,0.4250533428165007,0.14722887947487284,0.24303137050882737,132808.22167255386,2998.9620878988885,135807.18376045275,1232,4,301.63157894736844,33,5,17,32.02737982007688,0.6549873737373737,42.310049019607845,1030.7598039215688,31.235145573380873,0
1925,4,0,0,37,0.0,0.0,1.0,37,700,500,200,0.7142857142857143,9,5,4,406.8857225602303,0.4241741741741742,0.15017738660341928,0.24682383720215,132658.02158261903,3395.3309930109076,136053.35257562992,1233,33,310.6756756756757,32,5,17,31.976702618784984,0.6559244791666667,42.455808080808076,1030.176767676767,32.19302398989897,0
1926,4,0,0,37,0.0,0.0,1.0,37,1000,600,400,0.6,14,6,8,406.5301687767259,0.4229542042042042,0.1450203265489889,0.2476800222308349,132820.6624324048,3399.121263136402,136219.78369554118,1234,34,311.6756756756757,32,5,18,31.821615221296753,0.6575520833333333,42.29797979797979,1030.8080808080801,32.212752525252505,0
1927,4,0,0,37,0.0,0.0,1.0,37,1150,800,350,0.6956521739130435,15,8,7,405.6375460869019,0.4227665165165165,0.14102352046048505,0.24843019126911442,133015.9629757167,3391.2537623711783,136407.21673808788,1235,35,312.6756756756757,32,5,19,31.647541819665427,0.6595052083333333,42.108585858585855,1031.5656565656561,32.236426767676754,0
1928,4,0,1,36,0.0,0.02702702702702703,0.972972972972973,37,950,700,250,0.7368421052631579,12,7,5,405.67081904190223,0.4222347347347348,0.14174056567888416,0.24866738652598536,133048.52701573828,3394.780985358649,136443.3080010969,1236,36,313.6756756756757,32,5,19,31.613837555582762,0.6598307291666667,42.07702020202021,1031.6919191919199,32.240372474747495,0
1929,4,0,0,36,0.0,0.0,1.0,36,1250,800,450,0.64,17,8,9,405.05462377433867,0.4204530423280423,0.1735830716315241,0.24872362435068915,133113.6670524692,3583.661265432107,136697.3283179013,1237,43,322.3888888888889,32,4,19,31.564042171377295,0.6604817708333333,42.01388888888889,1031.944444444445,32.24826388888891,0
1930,4,0,0,36,0.0,0.0,1.0,36,1050,800,250,0.7619047619047619,13,8,5,404.4429653799708,0.4192294973544974,0.17119077767225943,0.2490517207866137,133219.07439446368,3575.903498654368,136794.97789311805,1238,44,323.3888888888889,33,3,19,31.473567584678698,0.6590909090909092,41.911764705882355,1032.3529411764707,31.283422459893053,0
1931,4,0,0,36,0.0,0.0,1.0,36,1000,800,200,0.8,12,8,4,402.53364914721476,0.41898148148148145,0.17087701945268763,0.2480867588928516,133250.70473195394,3527.578485438281,136778.28321739222,1239,45,324.3888888888889,33,3,19,31.49097428288823,0.6594065656565656,41.88112745098039,1032.4754901960775,31.287136066547806,0
1932,4,0,0,36,0.0,0.0,1.0,36,800,600,200,0.75,10,6,4,401.5923044926273,0.41878306878306876,0.17146003112060515,0.247717185772685,133282.33882401,3505.0323193002714,136787.37114331027,1240,46,325.3888888888889,33,3,19,31.483404541498533,0.6597222222222222,41.85049019607843,1032.5980392156864,31.29084967320262,0
1933,4,0,0,36,0.0,0.0,1.0,36,1250,900,350,0.72,16,9,7,400.98614083745997,0.4180390211640212,0.17670357189930153,0.248187457214375,133408.91273788922,3499.025014417529,136907.93775230675,1241,47,326.3888888888889,33,3,20,31.37158956109134,0.6609848484848485,41.72794117647059,1033.0882352941173,31.30570409982174,0
1934,4,0,0,36,0.0,0.0,1.0,36,1200,800,400,0.6666666666666666,16,8,8,383.44789083186873,0.4173776455026455,0.17832899044564754,0.2158679222929577,129793.87622849373,2772.234987745081,132566.11121623882,1242,48,327.3888888888889,33,3,20,35.482937462417304,0.6246843434343434,45.25122549019607,1018.9950980392147,30.878639334521658,8
1935,4,0,0,36,0.0,0.0,1.0,36,700,400,300,0.5714285714285714,10,4,6,382.2051569839214,0.4165674603174603,0.1757433677967466,0.21568402278102172,129887.5507617263,2728.7383458285362,132616.28910755485,1243,49,328.3888888888889,33,3,20,35.419171275146276,0.6256313131313131,45.1593137254902,1019.3627450980396,30.889780154486047,0
1936,4,0,0,36,0.0,0.0,1.0,36,900,500,400,0.5555555555555556,13,5,8,382.99600520251505,0.41651785714285716,0.17609287975317578,0.2163030391907482,129918.7831152681,2751.674986783922,132670.458102052,1244,50,329.3888888888889,33,3,20,35.36720659534399,0.6259469696969697,45.12867647058823,1019.4852941176465,30.893493761140803,0
1937,4,1,0,37,0.02702702702702703,0.0,1.0,37,1100,600,500,0.5454545454545454,16,6,10,376.58805371499193,0.41976351351351354,0.19100179964007213,0.2154331796646848,130419.01139285375,2423.3026360053864,132842.31402885914,1245,0,321.4594594594595,33,4,22,35.02187062587483,0.6309974747474747,44.638480392156865,1021.4460784313728,30.95291146761736,0
1938,4,0,0,37,0.0,0.0,1.0,37,650,200,450,0.3076923076923077,11,2,9,379.1432885039759,0.4193255755755756,0.1923434769782375,0.2172451956190822,130481.60750973185,2494.245152104961,132975.8526618368,1246,1,322.4594594594595,33,4,22,34.893022070289064,0.6316287878787878,44.57720588235294,1021.6911764705883,30.960338680926917,0
1939,4,0,1,36,0.0,0.02702702702702703,0.972972972972973,37,1000,700,300,0.7,13,7,6,377.3199276662016,0.419044044044044,0.19263368680889692,0.21650496384269202,130536.1678004534,2450.779478458038,132986.94727891145,1247,2,323.4594594594595,34,3,18,34.88418375271824,0.6299019607843137,44.52380952380952,1021.904761904761,30.05602240896356,0
1940,4,0,0,36,0.0,0.0,1.0,36,1200,900,300,0.75,15,9,6,382.34170591943706,0.4180390211640212,0.14384131440752923,0.21333269596601465,129443.56575963706,2698.3347505668785,132141.90051020394,1248,3,330.6111111111111,34,2,16,35.868283029168616,0.6188725490196079,45.59523809523809,1017.6190476190465,29.929971988795483,7
1941,4,1,0,37,0.02702702702702703,0.0,1.0,37,800,500,300,0.625,11,5,6,372.4892418482692,0.4200763263263263,0.14447576410766594,0.20936464283195821,129731.44531250001,2264.713541666667,131996.1588541667,1249,0,322.64864864864865,35,2,18,35.82566462167688,0.6196428571428572,45.3125,1018.7500000000001,29.10714285714286,0
1942,4,0,1,36,0.0,0.02702702702702703,0.972972972972973,37,750,500,250,0.6666666666666666,10,5,5,384.65208610857087,0.4194194194194194,0.03906328891263211,0.21347547548112447,129232.53864198856,2684.057213571693,131916.59585556024,1250,1,323.64864864864865,33,4,21,36.0249437547708,0.6190025252525253,45.80269607843137,1016.7892156862738,30.81179441473557,8
1943,4,0,0,36,0.0,0.0,1.0,36,800,500,300,0.625,11,5,6,393.039505509272,0.41650132275132273,0.05623861566484556,0.21795827123695974,129201.3888888888,2956.249999999991,132157.6388888888,1251,6,333.6111111111111,32,4,21,35.8435792349727,0.62109375,45.83333333333333,1016.666666666666,31.77083333333331,0
1944,4,0,0,36,0.0,0.0,1.0,36,1250,900,350,0.72,16,9,7,388.66064720816513,0.4149801587301587,0.05060939460368674,0.2167623637266853,129426.12879106723,2860.5685963167016,132286.69738738393,1252,7,334.6111111111111,32,4,19,35.72532779087563,0.6233723958333333,45.61237373737374,1017.550505050505,31.79845328282828,0
1945,4,0,0,36,0.0,0.0,1.0,36,1250,1000,250,0.8,15,10,5,392.06088343517166,0.4154596560846561,0.06006518114294357,0.2193745248534205,129554.63927469132,2958.66126543209,132513.3005401234,1253,8,335.6111111111111,32,4,19,35.50761709868121,0.6246744791666667,45.48611111111111,1018.0555555555553,31.814236111111104,0
1946,4,1,0,37,0.02702702702702703,0.0,1.0,37,850,600,250,0.7058823529411765,11,6,5,382.2462919799397,0.4170733233233233,0.061601176240447586,0.21626959954426433,129989.29280045343,2537.585034013592,132526.877834467,1254,0,327.5135135135135,34,3,21,35.31451863958285,0.6243872549019608,45.0595238095238,1019.761904761904,29.99299719887953,0
1947,4,1,0,38,0.02631578947368421,0.0,1.0,38,1150,1000,150,0.8695652173913043,13,10,3,369.6793002915452,0.4190670934091987,0.06584317937701378,0.21063122923588057,130262.58680555562,2031.650368480735,132294.23717403636,1255,0,319.86842105263156,33,5,22,35.35714285714286,0.6294191919191919,44.79166666666667,1020.8333333333339,30.934343434343454,0
1948,4,0,1,37,0.0,0.02631578947368421,0.9736842105263158,38,700,300,400,0.42857142857142855,11,3,8,379.8764708595344,0.41964497392128974,0.04746269036987982,0.20529230076601257,128175.55334787098,2146.8559268069957,130322.40927467798,1256,1,320.86842105263156,33,5,20,37.22757573923919,0.608270202020202,46.84436274509804,1012.6225490196076,30.685531788472957,8
1949,4,0,1,36,0.0,0.02702702702702703,0.972972972972973,37,1250,900,350,0.72,16,9,7,375.1363650299892,0.4176363863863864,0.056305478576702095,0.18798269783546953,125091.92866025075,1985.3062824394278,127077.23494269018,1257,2,330.4864864864865,33,4,20,40.526231165012845,0.5767045454545454,49.90808823529411,1000.3676470588226,30.314171122994626,8
1950,4,5,5,36,0.12195121951219512,0.12195121951219512,0.8780487804878049,41,900,700,200,0.7777777777777778,11,7,4,337.28758113668835,0.43165650406504064,0.059305738285598375,0.17294958947647202,126043.83680555549,313.4285791522385,126357.26538470773,1258,0,299.0731707317073,34,7,19,40.49100968188103,0.5842524509803921,48.95833333333333,1004.1666666666661,29.53431372549018,0
1951,4,2,0,38,0.05263157894736842,0.0,1.0,38,750,500,250,0.6666666666666666,10,5,5,358.0271867300593,0.4237790422000948,0.06662636621566587,0.1819114087180351,125666.39506440736,1398.3971782835783,127064.79224269094,1259,0,323.63157894736844,35,3,22,40.3599840317057,0.5782738095238096,49.334490740740726,1002.6620370370352,28.647486772486722,0
1952,4,1,0,39,0.02564102564102564,0.0,1.0,39,1200,900,300,0.75,15,9,6,353.5619870517369,0.4276034637876743,0.08939945689579676,0.18156604297468915,126105.37413494822,1118.9112641527818,127224.28539910099,1260,0,316.3076923076923,33,6,23,40.019013339840576,0.5871212121212122,48.89705882352942,1004.4117647058833,30.436720142602525,0
1953,4,0,0,39,0.0,0.0,1.0,39,1350,1100,250,0.8148148148148148,16,11,5,352.55078709072404,0.4267881241565452,0.08374442756300882,0.18186299092566782,126290.07623269902,1104.7331555171183,127394.80938821613,1261,1,317.3076923076923,33,6,19,39.854100625863616,0.5890151515151515,48.71323529411765,1005.14705882353,30.45900178253121,0
1954,4,3,2,40,0.07142857142857142,0.047619047619047616,0.9523809523809523,42,1150,800,350,0.6956521739130435,15,8,7,329.392624894985,0.43419715447154467,0.10383885727039366,0.17414084434713656,127290.8059030316,-14.269463720459498,127276.53643931115,1262,0,295.57142857142856,36,6,23,39.40966409998883,0.5928819444444444,47.719594594594604,1009.1216216216233,28.0311561561562,0
1955,4,1,0,41,0.024390243902439025,0.0,1.0,41,1000,700,300,0.7,13,7,6,339.44736366008635,0.4303607723577236,0.11121682579836367,0.17909341535480106,127208.74592764067,436.1346879286788,127644.88061556935,1263,0,303.609756097561,35,6,24,39.24009484472999,0.594047619047619,47.80092592592593,1008.7962962962969,28.82275132275134,0
1956,4,1,1,41,0.023809523809523808,0.023809523809523808,0.9761904761904762,42,900,700,200,0.7777777777777778,11,7,4,331.5725817546832,0.4331204026325977,0.11483062999904403,0.1759100454445264,127432.89531085169,50.65081973869388,127483.54613059039,1264,0,297.35714285714283,36,6,20,39.20923488735223,0.5943287037037037,47.57882882882885,1009.6846846846871,28.046796796796865,0
1957,4,1,0,42,0.023809523809523808,0.0,1.0,42,1100,700,400,0.6363636363636364,15,7,8,336.0559035105239,0.43275745257452575,0.12222646776307733,0.17916991219250936,127631.95363860486,178.29429936693572,127810.2479379718,1265,0,298.3095238095238,36,6,21,38.892371559121806,0.5963541666666667,47.38175675675676,1010.4729729729734,28.068693693693703,0
1958,4,1,0,43,0.023255813953488372,0.0,1.0,43,950,600,350,0.631578947368421,13,6,7,327.2487497197424,0.43685400516795864,0.13295138224074732,0.17635692007081008,128063.41428336628,-218.28155818539187,127845.13272518088,1266,0,292.3488372093023,38,5,22,38.674266413341805,0.5970394736842105,46.95512820512821,1012.1794871794878,26.636302294197048,0
1959,4,1,1,43,0.022727272727272728,0.022727272727272728,0.9772727272727273,44,750,500,250,0.6666666666666666,10,5,5,332.93235847872194,0.4390415785764623,0.17091666295487995,0.17967079419753335,128119.42087309448,-268.97980835854014,127850.44106473595,1267,0,286.6818181818182,41,3,15,38.473276988404386,0.5927337398373984,46.89980158730158,1012.4007936507926,24.692702284165673,8
1960,4,1,1,43,0.022727272727272728,0.022727272727272728,0.9772727272727273,44,1450,1000,450,0.6896551724137931,19,10,9,334.0283540932535,0.4383368569415081,0.1865595807701077,0.18177484081179482,128453.40617563935,-218.58157102088637,128234.82460461846,1268,0,287.6136363636364,40,4,12,38.10484544695072,0.59765625,46.570121951219505,1013.7195121951207,25.342987804878017,0
1961,4,0,0,43,0.0,0.0,1.0,43,1200,700,500,0.5833333333333334,17,7,10,341.30967146471255,0.4364156515319306,0.1886453536144923,0.1862663094944196,128566.75347222238,176.2152777777979,128742.96875000017,1269,1,295.16279069767444,39,4,14,37.804711038071765,0.6004273504273504,46.45833333333334,1014.166666666668,26.004273504273538,0
1962,4,1,1,43,0.022727272727272728,0.022727272727272728,0.9772727272727273,44,1450,1100,350,0.7586206896551724,18,11,7,334.0787058593019,0.4366521317829457,0.18609717102633527,0.18373431243793434,128873.80248685136,-189.20136920507446,128684.60111764629,1270,0,289.4318181818182,41,3,15,37.67535824784238,0.6003556910569106,46.155753968253975,1015.3769841269852,24.765292295780128,0
1963,4,1,0,44,0.022727272727272728,0.0,1.0,44,1200,1000,200,0.8333333333333334,14,10,4,337.6859620601401,0.4366851656095842,0.20178525467503317,0.1866658019094452,129075.34490937597,-82.6135952065797,128992.73131416939,1271,0,290.27272727272725,41,3,16,37.37867730808033,0.6023882113821138,45.95734126984128,1016.1706349206363,24.78464963221064,0
1964,4,0,1,43,0.0,0.022727272727272728,0.9772727272727273,44,1350,1100,250,0.8148148148148148,16,11,5,334.3864485550567,0.4366411205073996,0.20095168374816952,0.18507775069943597,129125.75511975639,-164.41946570293396,128961.33565405346,1272,1,291.27272727272725,41,3,16,37.41123718887261,0.6028963414634146,45.9077380952381,1016.3690476190488,24.789488966318263,0
1965,4,1,0,44,0.022727272727272728,0.0,1.0,44,1400,1100,300,0.7857142857142857,17,11,6,387.5387316069948,0.4349784178999296,0.25618031252543294,0.20133988986279688,126581.54776398021,1044.6655015640276,127626.21326554424,1273,0,292.02272727272725,36,8,18,38.67385668457175,0.5856481481481481,48.42342342342342,1006.3063063063064,27.952952952952955,8
1966,4,0,1,43,0.0,0.022727272727272728,0.9772727272727273,44,1450,900,550,0.6206896551724138,20,9,11,370.76946019244724,0.4349784178999296,0.20742159271571015,0.19466944111940673,127011.23078977641,618.3770956607435,127629.60788543716,1274,1,293.02272727272725,38,6,17,38.65328563857976,0.5863486842105263,47.99679487179487,1008.0128205128201,26.526653171390002,7
1967,4,0,0,43,0.0,0.0,1.0,43,1500,1100,400,0.7333333333333333,19,11,8,376.15127339947486,0.43415466961978594,0.19683784973782226,0.1983156895146049,127179.55789448282,967.8018947124305,128147.35978919525,1275,2,292.3953488372093,35,8,17,38.34444922547334,0.59375,47.8298611111111,1008.6805555555538,28.819444444444397,0
1968,4,1,1,43,0.022727272727272728,0.022727272727272728,0.9772727272727273,44,850,400,450,0.47058823529411764,13,4,9,372.45135717965434,0.43589235377026075,0.20784976535338884,0.1980151880583474,127518.187000345,698.8643626734938,128217.0513630185,1276,0,286.72727272727275,36,8,14,38.0897628869811,0.5951967592592593,47.49436936936937,1010.022522522523,28.056181181181195,0
1969,4,0,0,43,0.0,0.0,1.0,43,1200,900,300,0.75,15,9,6,381.6412227789573,0.4346391657438169,0.22034034542753167,0.2029010152403363,127518.18700034513,1133.2393626735075,128651.42636301865,1277,1,294.25581395348837,36,7,14,37.85771360612481,0.5951967592592593,47.49436936936938,1010.0225225225241,28.056181181181227,0
1970,4,1,0,44,0.022727272727272728,0.0,1.0,44,1650,1300,350,0.7878787878787878,20,13,7,371.3250097465155,0.43700449260042284,0.219793894709865,0.19899654647833345,127839.40882050271,693.9939452524079,128533.40276575512,1278,0,288.54545454545456,37,7,15,37.78856753044923,0.5965653153153153,47.17653508771931,1011.2938596491248,27.332266477003373,0
1971,4,2,0,46,0.043478260869565216,0.0,1.0,46,950,400,550,0.42105263157894735,15,4,11,354.68602495250065,0.44016706924315624,0.22416243375570777,0.19243948859551016,128333.90404704517,-95.98784774707383,128237.9161992981,1279,0,276.95652173913044,38,8,18,37.703412765359204,0.5997807017543859,46.688034188034194,1013.247863247864,26.664417453891158,0
1972,4,1,1,46,0.02127659574468085,0.02127659574468085,0.9787234042553191,47,1750,1200,550,0.6857142857142857,23,12,11,351.68300483838846,0.4412002775208141,0.24445599067375157,0.19320758540895935,128830.99500868077,-338.4657118055319,128492.52929687523,1280,0,272.0425531914894,39,8,16,37.27212873657569,0.6030982905982907,46.19791666666668,1015.2083333333351,26.03098290598295,0
1973,4,1,1,46,0.02127659574468085,0.02127659574468085,0.9787234042553191,47,1450,1000,450,0.6896551724137931,19,10,9,356.34448393640065,0.44227952513105145,0.2505207367743765,0.19694846690082668,129069.04432508688,-201.3916015624892,128867.6527235244,1281,0,273.0,39,8,17,36.911092602084416,0.6055021367521367,45.96354166666667,1016.145833333334,26.055021367521388,0
1974,4,1,0,47,0.02127659574468085,0.0,1.0,47,1250,800,450,0.64,17,8,9,354.2894540444552,0.4410268270120259,0.25522738013847857,0.19674732915019644,129257.13320444766,-240.9765354483966,129016.15666899926,1282,0,273.9148936170213,37,10,18,36.77170943857378,0.6109234234234234,45.77850877192983,1016.8859649122818,27.483404457088696,0
1975,4,0,0,47,0.0,0.0,1.0,47,1300,1000,300,0.7692307692307693,16,10,6,353.28593340106977,0.4404101140918902,0.25684752443389725,0.1967244829149117,129364.36760355043,-259.47772846810403,129104.88987508233,1283,1,274.9148936170213,38,9,18,36.68806448225161,0.6101973684210527,45.67307692307693,1017.3076923076934,26.771255060728773,0
1976,4,0,0,47,0.0,0.0,1.0,47,1300,900,400,0.6923076923076923,17,9,8,354.7865335730669,0.44033302497687327,0.2572625230356844,0.1979696386809294,129445.89548405664,-214.86789118999843,129231.02759286665,1284,2,275.9148936170213,38,9,17,36.56692913385827,0.6110197368421053,45.59294871794872,1017.628205128206,26.779689608637,0
1977,4,1,0,48,0.020833333333333332,0.0,1.0,48,1200,1000,200,0.8333333333333334,14,10,4,352.3464563677077,0.441655585106383,0.26970881891910303,0.19831145202467895,129784.51063368063,-454.17751736110324,129330.33311631953,1285,0,271.1458333333333,39,9,18,36.28475771825803,0.6127136752136753,45.26041666666667,1018.958333333334,26.12713675213677,0
1978,4,0,0,48,0.0,0.0,1.0,48,1550,1000,550,0.6451612903225806,21,10,11,352.43940331263985,0.44191415484633567,0.26933459363716894,0.19890265287298126,129890.673828125,-444.2816840277786,129446.39214409722,1286,1,272.1458333333333,39,9,18,36.174552081204446,0.6137820512820513,45.15625,1019.375,26.137820512820515,0
1979,4,0,0,48,0.0,0.0,1.0,48,1500,1000,500,0.6666666666666666,20,10,10,354.7725052686219,0.44193262411347517,0.27468158289061484,0.20049152895896477,129943.77170138882,-379.9045138888948,129563.86718749993,1287,2,273.1458333333333,39,9,18,36.06116332924671,0.6143162393162394,45.104166666666664,1019.5833333333327,26.143162393162378,0
1980,4,0,2,46,0.0,0.041666666666666664,0.9583333333333334,48,1150,1000,150,0.8695652173913043,13,10,3,353.2149663088208,0.44189568557919623,0.27199050439044337,0.20042800579539916,130103.13042534715,-409.12543402778306,129694.00499131937,1288,3,274.1458333333333,39,9,18,35.939095364508894,0.6159188034188035,44.947916666666664,1020.2083333333327,26.159188034188016,0
1981,4,1,0,47,0.02127659574468085,0.0,1.0,47,1400,1100,300,0.7857142857142857,17,11,6,352.0003323105594,0.4416628122109158,0.264745235195768,0.20083983139653835,130317.12420784948,-225.66579461610212,130091.45841323338,1289,0,275.0425531914894,38,9,19,35.75302570541665,0.6197916666666667,44.73824786324787,1021.0470085470095,26.869658119658144,0
1982,4,0,0,47,0.0,0.0,1.0,47,1450,1100,350,0.7586206896551724,18,11,7,352.9861825005627,0.44229879740980577,0.2601377506073308,0.20239567442658182,130508.09500328744,-186.48915187375366,130321.60585141368,1290,1,276.0425531914894,38,9,14,35.53429527394396,0.6217105263157895,44.55128205128206,1021.7948717948727,26.88933873144402,0
1983,4,0,1,46,0.0,0.02127659574468085,0.9787234042553191,47,1350,800,550,0.5925925925925926,19,8,11,356.4637004436626,0.4420482577860006,0.26415975345919773,0.20511131386322354,130644.58832137122,-85.98932080501976,130558.5990005662,1291,2,277.0425531914894,38,9,14,35.30715504929112,0.6230811403508771,44.417735042735046,1022.3290598290603,26.90339631129106,0
1984,4,1,0,47,0.02127659574468085,0.0,1.0,47,1000,800,200,0.8,12,8,4,358.88404800362525,0.4435707678075856,0.2678944104762735,0.20708842625308638,130753.83434007231,-14.90692800788625,130738.92741206443,1292,0,277.97872340425533,38,9,15,35.13462342003553,0.6241776315789473,44.31089743589744,1022.7564102564102,26.91464237516869,0
1985,4,0,1,46,0.0,0.02127659574468085,0.9787234042553191,47,1300,1000,300,0.7692307692307693,16,10,6,357.6453591509497,0.44337804502004313,0.26809665767739,0.20710563784448593,130890.45606874142,-37.52716597266638,130852.92890276875,1293,1,278.97872340425533,38,9,16,35.02797208881465,0.6255482456140351,44.17735042735043,1023.2905982905991,26.928699955015766,0
1986,4,0,2,44,0.0,0.043478260869565216,0.9565217391304348,46,1150,900,250,0.782608695652174,14,9,5,366.8180629808909,0.4419887278582931,0.26696360349615134,0.21235398038074918,130878.94833025557,401.75246229610246,131280.70079255168,1294,2,285.8695652173913,37,9,17,34.80497213887698,0.6272522522522522,44.188596491228076,1023.2456140350887,27.655286865813206,0
1987,4,0,0,44,0.0,0.0,1.0,44,1350,1100,250,0.8148148148148148,16,11,5,377.3550910096026,0.4415301268498943,0.2580213903743316,0.21831276207623612,130854.0166323732,1075.6858710562533,131929.70250342946,1295,3,250.25,35,9,18,34.5607088989442,0.6309523809523809,44.21296296296297,1023.1481481481488,29.232804232804252,0
1988,4,1,0,45,0.022222222222222223,0.0,1.0,45,1050,700,350,0.6666666666666666,14,7,7,369.18435631948006,0.44328703703703703,0.26155518905381436,0.21510132740074786,131126.20380092948,681.9486293726364,131808.1524303021,1296,0,245.66666666666666,36,9,19,34.49399853399305,0.6316550925925926,43.94707207207208,1024.2117117117132,28.450325325325366,0
1989,4,0,1,44,0.0,0.022222222222222223,0.9777777777777777,45,1000,700,300,0.7,13,7,6,368.37217492333326,0.44305555555555554,0.2609504965006779,0.21495071682344868,131183.8797200918,664.8982174742418,131848.77793756605,1297,1,246.66666666666666,36,9,20,34.45641420248434,0.6322337962962963,43.89076576576577,1024.4369369369376,28.456581581581602,0
1990,4,0,0,44,0.0,0.0,1.0,44,1350,1100,250,0.8148148148148148,16,11,5,372.34242900062264,0.4435782241014799,0.2539173753585098,0.21726741992422494,131183.8797200918,969.0648841409089,132152.9446042327,1298,2,249.52272727272728,36,8,21,34.35473232933935,0.6322337962962963,43.89076576576577,1024.4369369369376,28.456581581581602,0
1991,4,0,0,44,0.0,0.0,1.0,44,1350,1000,350,0.7407407407407407,17,10,7,372.28942706690304,0.4427633897110641,0.24551052395880024,0.2184241436259575,131392.84256708494,983.5502560113501,132376.39282309628,1299,3,250.52272727272728,32,12,21,34.14460180623974,0.6432291666666667,43.686868686868685,1025.252525252525,32.039141414141405,0
1992,4,0,0,44,0.0,0.0,1.0,44,1450,1200,250,0.8275862068965517,17,12,5,369.70812602428134,0.44129889006342493,0.24070438605322297,0.21820028614374248,131619.47959710742,932.1582300275401,132551.63782713495,1300,4,251.52272727272728,32,12,17,33.98163528977483,0.6455078125,43.465909090909086,1026.1363636363633,32.06676136363635,0
1993,4,2,0,46,0.043478260869565216,0.0,1.0,46,1000,800,200,0.8,12,8,4,350.7018092067643,0.4415157004830918,0.24847632324594726,0.2102507237846799,132214.28748582763,73.55796485260296,132287.84545068024,1301,0,241.54347826086956,34,12,19,33.86990199482965,0.6467524509803921,42.88690476190476,1028.4523809523807,30.248599439775905,0
1994,4,0,1,45,0.0,0.021739130434782608,0.9782608695652174,46,1200,1000,200,0.8333333333333334,14,10,4,349.3499664998002,0.4417673107890499,0.24664422964035526,0.20979881771960998,132278.91375171483,42.32681755831891,132321.24056927316,1302,1,242.54347826086956,35,11,19,33.839633963396345,0.6452380952380952,42.82407407407408,1028.7037037037048,29.391534391534424,0
1995,4,0,1,44,0.0,0.022222222222222223,0.9777777777777777,45,900,700,200,0.7777777777777778,11,7,4,355.03622098939724,0.4391835016835017,0.24391699792880783,0.2125050478645477,132153.0771683673,383.825821995463,132536.90299036278,1303,2,248.7111111111111,34,11,19,33.82009571224577,0.6461397058823529,42.94642857142857,1028.2142857142853,30.24159663865545,0
1996,4,0,0,44,0.0,0.0,1.0,44,1850,1300,550,0.7027027027027027,24,13,11,364.4175281430148,0.43733483086680763,0.25214745884037226,0.21794389009993598,132122.47732426302,829.5493197278895,132952.02664399092,1304,3,254.75,34,10,19,33.60979234213371,0.6458333333333333,42.976190476190474,1028.0952380952378,30.23809523809523,0
1997,4,0,0,44,0.0,0.0,1.0,44,1000,700,300,0.7,13,7,6,364.6940153248454,0.43715865045806906,0.25173125092087845,0.21846233733536846,132183.68055555547,841.3194444444397,133024.9999999999,1305,4,255.75,34,10,19,33.54099135602377,0.6464460784313726,42.916666666666664,1028.3333333333328,30.24509803921567,0
1998,4,0,0,44,0.0,0.0,1.0,44,1250,800,450,0.64,17,8,9,362.775502160771,0.4360575229034531,0.2475670673459638,0.21804717024610576,132311.0948786626,799.8447772096625,133110.93965587227,1306,5,256.75,36,8,19,33.46194541739637,0.6435185185185186,42.7927927927928,1028.8288288288302,28.578578578578615,0
1999,4,0,0,44,0.0,0.0,1.0,44,1050,600,450,0.5714285714285714,15,6,9,359.23219509954777,0.4359033650458069,0.24001755732413788,0.2167676755775149,132459.27047902485,716.7839662952969,133176.05444532016,1307,6,257.75,34,10,19,33.403926217185145,0.649203431372549,42.64880952380952,1029.4047619047612,30.276610644257683,0
2000,4,1,0,45,0.022222222222222223,0.0,1.0,45,800,300,500,0.375,13,3,10,351.1671667599044,0.43739478114478114,0.23995208146151503,0.2135787194556139,132755.59413580244,323.88117283949873,133079.47530864194,1308,0,253.0,35,10,17,33.31367924528301,0.65,42.36111111111111,1030.5555555555552,29.444444444444436,0
2001,4,0,0,45,0.0,0.0,1.0,45,900,400,500,0.4444444444444444,14,4,10,354.1041901357971,0.4369739057239057,0.23944519283540378,0.21605206340614241,132874.89819101506,410.31164266117275,133285.20983367623,1309,1,254.0,35,10,17,33.118170932495126,0.6511904761904762,42.24537037037037,1031.0185185185182,29.45767195767195,0
2002,4,0,0,45,0.0,0.0,1.0,45,950,600,350,0.631578947368421,13,6,7,357.0784756531503,0.43617424242424246,0.24335252910527805,0.2189131727628732,133053.9547432268,502.1406678669126,133556.0954110937,1310,2,255.0,35,10,17,32.861696956099024,0.6529761904761905,42.071759259259245,1031.712962962961,29.47751322751317,0
2003,4,0,1,44,0.0,0.022222222222222223,0.9777777777777777,45,1200,900,300,0.75,15,9,6,359.18912995042103,0.43604797979797977,0.24363690743233124,0.2205599368207955,133113.667052469,562.596450617264,133676.2635030863,1311,3,256.0,35,10,18,32.74730820995961,0.6535714285714286,42.01388888888888,1031.9444444444434,29.484126984126956,0
2004,4,0,0,44,0.0,0.0,1.0,44,1850,1300,550,0.7027027027027027,24,13,11,367.59371970730666,0.4328312191684285,0.24406590411088191,0.22621754035358793,133195.58000283435,992.3717403627984,134187.95174319716,1312,4,262.47727272727275,34,10,19,32.44819897743436,0.6565563725490196,41.9345238095238,1032.261904761904,30.360644257703058,0
2005,4,0,0,44,0.0,0.0,1.0,44,1000,600,400,0.6,14,6,8,370.33780826405916,0.4320824524312896,0.24630169225596754,0.22868680021731477,133322.7656276791,1074.8921628514995,134397.6577905306,1313,5,263.47727272727275,35,9,19,32.24964044230266,0.6556547619047619,41.81134259259259,1032.754629629629,29.50727513227512,0
2006,4,0,0,44,0.0,0.0,1.0,44,1100,900,200,0.8181818181818182,13,9,4,369.15622960896053,0.4319062720225511,0.24364471513250385,0.22850821813381275,133412.42953746562,1050.0058942043765,134462.43543167,1314,6,264.47727272727275,35,9,19,32.19013742624542,0.656547619047619,41.72453703703703,1033.101851851851,29.517195767195744,0
2007,4,0,0,44,0.0,0.0,1.0,44,1400,800,600,0.5714285714285714,20,8,12,370.7075962539019,0.4316640239605356,0.2492668621700873,0.22983870967741937,133472.2222222223,1095.8333333333435,134568.05555555565,1315,7,265.47727272727275,35,9,19,32.09005376344086,0.6571428571428571,41.66666666666667,1033.3333333333342,29.523809523809547,0
2008,4,0,0,44,0.0,0.0,1.0,44,1400,1000,400,0.7142857142857143,18,10,8,370.70048624755805,0.43146582100070474,0.24808454645391254,0.2304422840477416,133570.0936926079,1102.8997359963246,134672.9934286042,1316,8,266.47727272727275,32,12,20,31.992030047636494,0.6650390625,41.571969696969695,1033.712121212121,32.30350378787878,0
2009,4,0,0,44,0.0,0.0,1.0,44,1400,900,500,0.6428571428571429,19,9,10,370.1208697805143,0.4305298625792812,0.24775985180558124,0.23125020442763294,133757.3007527153,1101.2736988177624,134858.57445153306,1317,9,267.47727272727275,33,11,18,31.819270031196943,0.6644570707070707,41.39093137254902,1034.4362745098038,31.346553773024358,0
2010,4,0,0,44,0.0,0.0,1.0,44,1550,1100,450,0.7096774193548387,20,11,9,373.0173313724795,0.42992424242424243,0.2524540933847108,0.2340642184823153,133915.80912389472,1190.5835495963174,135106.39267349103,1318,10,268.47727272727275,33,11,18,31.585464519693737,0.6660353535353536,41.23774509803922,1035.0490196078438,31.365121806298298,0
2011,4,0,1,43,0.0,0.022727272727272728,0.9772727272727273,44,1200,900,300,0.75,15,9,6,371.5249241930458,0.429549859055673,0.2510974940552406,0.23373150294170084,134010.9592013888,1157.682291666657,135168.64149305545,1319,11,269.47727272727275,33,11,18,31.528755868544604,0.6669823232323233,41.14583333333333,1035.4166666666658,31.3762626262626,0
2012,4,0,0,43,0.0,0.0,1.0,43,1300,800,500,0.6153846153846154,18,8,10,377.0307964487126,0.4282253599114065,0.25108792288615445,0.23719532384178488,134010.9592013888,1505.2517361111009,135516.21093749988,1320,12,273.48837209302326,33,10,18,31.386234071093227,0.6669823232323233,41.14583333333333,1035.4166666666658,31.3762626262626,0
2013,4,0,0,43,0.0,0.0,1.0,43,1000,700,300,0.7,13,7,6,377.48426175554084,0.428110003691399,0.2512618687216184,0.2376856938773711,134042.68340301808,1519.800677623995,135562.48408064208,1321,13,274.48837209302326,33,10,18,31.342702169625255,0.6672979797979798,41.115196078431374,1035.5392156862747,31.379976232917414,0
2014,4,0,0,43,0.0,0.0,1.0,43,650,300,350,0.46153846153846156,10,3,7,387.87407025745415,0.4282945736434109,0.19030244336548408,0.23238443116908147,132189.63162562152,1663.9725067719314,133853.60413239346,1322,14,275.48837209302326,35,8,15,32.93905927593321,0.6443452380952381,42.910879629629626,1028.356481481481,29.381613756613746,8
2015,4,0,0,43,0.0,0.0,1.0,43,1150,800,350,0.6956521739130435,15,8,7,385.6808011932664,0.4282022886674049,0.1890594106016381,0.23234916559691926,132398.00347222236,1612.6736111111302,134010.6770833335,1323,15,276.48837209302326,36,7,15,32.785087719298254,0.6443865740740741,42.70833333333334,1029.1666666666679,28.587962962962997,0
2016,4,0,0,43,0.0,0.0,1.0,43,1500,1300,200,0.8666666666666667,17,13,4,386.7879490244839,0.42808693244739754,0.18532581804100423,0.2335853479862945,132489.9092970522,1649.100056689345,134139.00935374154,1324,16,277.48837209302326,34,9,16,32.66386255010793,0.6495098039215687,42.61904761904762,1029.5238095238096,30.28011204481793,0
2017,4,0,1,42,0.0,0.023255813953488372,0.9767441860465116,43,1350,1000,350,0.7407407407407407,17,10,7,390.7452791654884,0.42751015134736065,0.18743885000376292,0.236745669141443,132612.5,1763.5416666666674,134376.04166666666,1325,17,278.48837209302326,34,9,16,32.43830906148866,0.6507352941176471,42.5,1030.0,30.294117647058822,0
2018,4,0,0,42,0.0,0.0,1.0,42,1100,700,400,0.6363636363636364,15,7,8,394.5225470554525,0.4249540263259775,0.20873544470119132,0.23967814852906405,132713.49961553258,2071.6935793925504,134785.19319492512,1326,25,285.7142857142857,33,9,16,32.239137329527445,0.654040404040404,42.40196078431373,1030.3921568627457,31.224004753416533,0
2019,4,0,0,42,0.0,0.0,1.0,42,1050,500,550,0.47619047619047616,16,5,11,397.7253716913471,0.42433701122725515,0.21275144227230802,0.24223519922490383,132808.2216725539,2164.2398656766677,134972.46153823056,1327,26,286.7142857142857,33,9,17,32.061065866127684,0.6549873737373737,42.310049019607845,1030.759803921569,31.23514557338088,0
2020,4,0,0,42,0.0,0.0,1.0,42,1000,800,200,0.8,12,8,4,394.1230486685033,0.4240587495160666,0.208802308802309,0.24085297418630755,132934.5703125,2078.515625,135013.0859375,1328,27,287.7142857142857,33,9,17,32.02651515151515,0.65625,42.1875,1031.25,31.25,0
2021,4,1,0,43,0.023255813953488372,0.0,1.0,43,850,700,150,0.8235294117647058,10,7,3,382.83898731122684,0.42513381321520854,0.20867660861403659,0.235837276713822,133233.13185871052,1601.3674554183751,134834.4993141289,1329,0,282.0,35,8,18,32.01700298953661,0.6547619047619048,41.898148148148145,1032.4074074074072,29.49735449735449,0
2022,4,0,0,43,0.0,0.0,1.0,43,1050,800,250,0.7619047619047619,13,8,5,374.2890277071124,0.4246031746031746,0.16685609372267862,0.21643669863063458,130835.7988165681,1194.2951203724042,132030.0939369405,1330,1,283.0,38,5,17,34.65760756056809,0.625,44.23076923076923,1023.0769230769234,26.923076923076934,8
2023,4,0,0,43,0.0,0.0,1.0,43,1550,1200,350,0.7741935483870968,19,12,7,372.8006328424304,0.42469545957918053,0.15850366558236662,0.21618826044978692,130945.1247351887,1163.285073781856,132108.40980897055,1331,2,284.0,38,5,17,34.584855601948504,0.6260964912280702,44.12393162393162,1023.5042735042724,26.934322986954538,0
2024,4,0,0,43,0.0,0.0,1.0,43,950,400,550,0.42105263157894735,15,4,11,371.5786431110759,0.4245801033591731,0.15991921996781389,0.21563264564792345,130972.46334876532,1133.31404320986,132105.7773919752,1332,3,285.0,38,5,17,34.58842152872001,0.6263706140350878,44.097222222222214,1023.6111111111103,26.937134502923954,0
2025,4,0,0,43,0.0,0.0,1.0,43,1450,800,650,0.5517241379310345,21,8,13,366.06029498087446,0.42506459948320413,0.1562969234016025,0.2133386047405253,131136.5549551646,1000.7771979326341,132137.33215309723,1333,4,286.0,38,5,17,34.56351482910886,0.628015350877193,43.936965811965806,1024.2521367521358,26.954003598740417,0
2026,4,0,0,43,0.0,0.0,1.0,43,1400,1000,400,0.7142857142857143,18,10,8,366.8451318659529,0.42538759689922484,0.15239175647570402,0.21486643437862937,131328.12499999988,1035.416666666653,132363.54166666654,1334,5,287.0,38,5,17,34.349593495934954,0.6299342105263157,43.74999999999999,1024.999999999999,26.97368421052629,0
2027,4,0,0,43,0.0,0.0,1.0,43,1400,800,600,0.5714285714285714,20,8,12,364.30078125,0.42545681063122925,0.15633720930232564,0.21429457720588224,131492.4391847468,980.5596646942687,132472.99884944106,1335,6,288.0,38,5,18,34.24869791666666,0.631578947368421,43.589743589743584,1025.641025641025,26.99055330634276,0
2028,4,0,0,43,0.0,0.0,1.0,43,1000,600,400,0.6,14,6,8,362.9841255578468,0.42485695828719083,0.15329852871381133,0.21413387849247914,131602.03904594926,953.8902129447008,132555.92925889397,1336,7,289.0,38,5,15,34.171742676662504,0.6326754385964912,43.48290598290598,1026.0683760683758,27.001799370220414,0
2029,4,0,0,43,0.0,0.0,1.0,43,1200,900,300,0.75,15,9,6,364.62615427716565,0.424718530823182,0.15980111401327957,0.2155669824086603,131684.2689043209,1003.1057098765311,132687.37461419744,1337,8,290.0,38,5,17,34.04657194406855,0.6334978070175439,43.40277777777777,1026.3888888888882,27.010233918128637,0
2030,4,0,0,43,0.0,0.0,1.0,43,1050,900,150,0.8571428571428571,12,9,3,363.5529673932702,0.4245108896271687,0.16403455702635328,0.21539728832609872,131766.5244448095,980.8221930016548,132747.34663781116,1338,9,291.0,38,5,17,33.99106833159902,0.6343201754385965,43.32264957264956,1026.7094017094,27.018668466036843,0
2031,4,0,0,43,0.0,0.0,1.0,43,1600,1300,300,0.8125,19,13,6,362.8804969384287,0.424718530823182,0.1653354362097912,0.21562009255661607,131876.23844875421,971.0629885309095,132847.30143728512,1339,10,292.0,38,5,18,33.897614589834255,0.6354166666666667,43.21581196581195,1027.1367521367501,27.02991452991448,0
2032,4,0,0,43,0.0,0.0,1.0,43,1250,1000,250,0.8,15,10,5,362.8330892609856,0.4247877445551864,0.1655928068720589,0.21637268974590285,132013.44515897764,979.7692262034857,132993.21438518114,1340,11,293.0,38,5,19,33.760439408115886,0.6367872807017544,43.08226495726494,1027.6709401709372,27.043972109761505,0
2033,4,0,0,43,0.0,0.0,1.0,43,1550,1200,350,0.7741935483870968,19,12,7,359.9421800859453,0.4243493909191584,0.15303311488720084,0.21542808091711016,132150.7232084152,913.323882314239,133064.04709072944,1341,12,294.0,38,5,19,33.69635806317539,0.638157894736842,42.948717948717935,1028.205128205126,27.058029689608578,0
2034,4,0,0,43,0.0,0.0,1.0,43,1200,700,500,0.5833333333333334,17,7,10,365.3541576301914,0.42448781838316724,0.15301784523821027,0.21930360534061596,132260.59701219946,1064.3918018116578,133324.98881401113,1342,13,295.0,38,5,19,33.44650152333471,0.6392543859649122,42.841880341880334,1028.6324786324776,27.069275753486252,0
2035,4,0,0,43,0.0,0.0,1.0,43,1250,1000,250,0.8,15,10,5,367.2864578701612,0.42370339608711705,0.145815530712317,0.22111047637412085,132371.20361328125,1123.6300998263896,133494.83371310763,1343,14,296.0,39,4,19,33.28535698619969,0.6386217948717949,42.734375,1029.0625,26.38621794871795,0
2036,4,0,0,43,0.0,0.0,1.0,43,650,300,350,0.46153846153846156,10,3,7,364.6748986757981,0.42358803986710963,0.14376891918640822,0.2198546917298272,132425.49332493238,1058.4533847460648,133483.94670967845,1344,15,297.0,38,5,19,33.297868659608305,0.6408991228070176,42.681623931623925,1029.2735042735037,27.08614484930273,0
2037,4,0,1,42,0.0,0.023255813953488372,0.9767441860465116,43,1250,900,350,0.72,16,9,7,376.38350016965205,0.4226190476190476,0.10857195506714801,0.21900595065946277,131075.36844269375,1321.7981690498468,132397.1666117436,1345,16,298.0,37,6,16,34.3611691116108,0.629222972972973,43.99671052631578,1024.0131578947355,27.67603129445231,8
2038,4,0,0,42,0.0,0.0,1.0,42,1200,900,300,0.75,15,9,6,382.59003288281184,0.42313927603561746,0.1103062870550775,0.22241103446103092,131039.71370018659,1626.8976747017202,132666.6113748883,1346,17,301.2857142857143,36,6,17,34.23843305470011,0.630787037037037,44.03153153153153,1023.8738738738732,28.440940940940923,0
2039,4,1,0,43,0.023255813953488372,0.0,1.0,43,1300,900,400,0.6923076923076923,17,9,8,375.17451358221683,0.42492617201919525,0.1164208886821041,0.21958398111790714,131300.02891514683,1252.0848963142334,132552.11381146105,1347,0,295.25581395348837,37,6,19,34.16459380906529,0.6314752252252251,43.777412280701746,1024.8903508771918,27.69973921289708,0
2040,4,0,0,43,0.0,0.0,1.0,43,1000,700,300,0.7,13,7,6,376.15927865037236,0.4242801771871539,0.11385286470969769,0.22098750912195425,131443.57829112894,1288.7473243754944,132732.32561550444,1348,1,296.25581395348837,36,7,19,33.99406984405885,0.634837962962963,43.637387387387385,1025.4504504504503,28.48473473473473,0
2041,4,0,0,43,0.0,0.0,1.0,43,1550,1100,450,0.7096774193548387,20,11,9,378.6273918311619,0.4243724621631599,0.11556150265193388,0.22260552985192958,131472.44953991144,1355.8141333901365,132828.26367330158,1349,2,297.25581395348837,36,7,19,33.90157754108561,0.6351273148148149,43.60923423423423,1025.5630630630624,28.487862862862844,0
2042,4,0,1,42,0.0,0.023255813953488372,0.9767441860465116,43,1700,1300,400,0.7647058823529411,21,13,8,385.45139018548093,0.42342654115909933,0.12689504463676005,0.2286100233747324,131806.2183195789,1560.9780172745225,133367.19633685343,1350,3,298.25581395348837,37,6,18,33.388836981669336,0.6365427927927928,43.283991228070164,1026.8640350877176,27.753082029397774,0
2043,4,0,0,42,0.0,0.0,1.0,42,1200,800,400,0.6666666666666666,16,8,8,389.72737985322505,0.4231029810298103,0.1343863715862399,0.2315767707909621,131876.97991488117,1879.2139690366116,133756.1938839178,1351,4,305.1904761904762,36,6,19,33.207479077586534,0.6391782407407407,43.215090090090094,1027.13963963964,28.53165665665667,0
2044,4,0,1,41,0.0,0.023809523809523808,0.9761904761904762,42,1300,900,400,0.6923076923076923,17,9,8,398.92403662865087,0.4219173441734418,0.13689823946234214,0.23794645478908918,132021.60564280482,2133.318369044703,134154.9240118495,1352,5,306.1904761904762,36,6,19,32.8249415589159,0.640625,43.074324324324316,1027.7027027027016,28.547297297297266,0
2045,4,1,0,42,0.023809523809523808,0.0,1.0,42,1250,1100,150,0.88,14,11,3,343.8643464034167,0.4247725512969415,0.08783386471162657,0.19696888940317686,130469.4348663621,573.828984432829,131043.26385079493,1353,0,304.6190476190476,35,7,17,35.806450851553954,0.6270833333333333,44.58912037037036,1021.6435185185169,29.189814814814767,8
2046,4,0,0,42,0.0,0.0,1.0,42,1200,800,400,0.6666666666666666,16,8,8,330.75925553252756,0.4248209446380178,0.09483989241010371,0.1822914923100143,128957.11343277477,144.90120644442868,129102.0146392192,1354,1,305.6190476190476,38,4,15,37.67487114757549,0.6060855263157895,46.07371794871796,1015.7051282051304,26.729082321187644,8
2047,4,1,0,43,0.023255813953488372,0.0,1.0,43,1400,900,500,0.6428571428571429,19,9,10,320.6455053363456,0.42790236249538577,0.0963179339309217,0.1781897580583948,129285.0098708258,-308.6062574044058,128976.4036134214,1355,0,299.48837209302326,37,6,17,37.59871967654985,0.611204954954955,45.751096491228076,1016.995614035089,27.486367946894298,0
2048,4,0,1,42,0.0,0.023255813953488372,0.9767441860465116,43,1000,700,300,0.7,13,7,6,322.8367299391584,0.4275793650793651,0.09794164613159317,0.17966144832906883,129340.77222077978,-248.8096096875646,129091.96261109221,1356,1,300.48837209302326,37,6,17,37.486413531673314,0.6117680180180181,45.696271929824576,1017.2149122807042,27.49229492650552,0
2049,4,0,0,42,0.0,0.0,1.0,42,1000,400,600,0.4,16,4,12,327.289235648837,0.42728900503290745,0.09506426464391105,0.18308754271444871,129545.08562616697,79.74241133028252,129624.82803749725,1357,2,299.95238095238096,36,6,15,37.16583702064898,0.6157407407407407,45.49549549549551,1018.0180180180201,28.278278278278336,0
2050,4,0,1,41,0.0,0.023809523809523808,0.9761904761904762,42,1300,700,600,0.5384615384615384,19,7,12,323.05820065991696,0.42628484320557486,0.08983347940403164,0.18158098864678085,129731.44531250001,-17.83854166666609,129713.60677083334,1358,3,300.95238095238096,37,5,15,37.084611451942735,0.6157094594594594,45.3125,1018.7500000000001,27.533783783783786,0
2051,4,0,0,41,0.0,0.0,1.0,41,950,800,150,0.8421052631578947,11,8,3,331.3739541767498,0.42281504065040654,0.08866139523845473,0.1859147668470551,129659.75265806368,393.1729871763932,130052.92564524007,1359,6,309.219512195122,36,5,15,36.94553479286453,0.6168981481481481,45.382882882882896,1018.4684684684701,28.290790790790837,0
2052,4,0,1,40,0.0,0.024390243902439025,0.975609756097561,41,1400,900,500,0.6428571428571429,19,9,10,337.70425768954834,0.4219766260162601,0.09841088301182022,0.19076392393665959,129927.00277970129,575.3804055093724,130502.38318521067,1360,7,310.219512195122,37,4,15,36.51322865132288,0.6176801801801801,45.12061403508771,1019.517543859648,27.554528212422916,0
2053,4,0,0,40,0.0,0.0,1.0,40,1500,1100,400,0.7333333333333333,19,11,8,345.39413565971,0.42140758547008544,0.08837934842628359,0.19534940027474545,129975.34855379029,978.5446341611894,130953.89318795147,1361,8,297.825,36,4,16,36.26817596171545,0.6200810185185186,45.0731981981982,1019.7072072072074,28.325200200200204,0
2054,4,0,0,40,0.0,0.0,1.0,40,1050,800,250,0.7619047619047619,13,8,5,345.94725066365345,0.4213942307692307,0.08716052108633288,0.1960945054137278,130061.48674011837,998.8827509942238,131060.3694911126,1362,9,298.825,36,4,16,36.16669426657834,0.6209490740740741,44.98873873873873,1020.045045045044,28.334584584584558,0
2055,4,0,1,39,0.0,0.025,0.975,40,1250,900,350,0.72,16,9,7,349.134165284582,0.42110042735042735,0.08084730803177376,0.19877839661679964,130233.84871357835,1093.8172124827383,131327.66592606108,1363,10,299.825,36,4,17,35.910607899382164,0.6226851851851851,44.81981981981981,1020.72072072072,28.353353353353334,0
2056,4,0,0,39,0.0,0.0,1.0,39,1100,800,300,0.7272727272727273,14,8,6,356.364517802896,0.4206027890238417,0.08066251432094007,0.20273692374102809,130203.51750042861,1479.9827460562287,131683.50024648485,1364,11,300.5128205128205,35,4,17,35.75687986693884,0.6244047619047619,44.84953703703703,1020.6018518518514,29.160052910052897,0
2057,4,0,0,39,0.0,0.0,1.0,39,800,700,100,0.875,9,7,2,358.01749271137066,0.4203497525865947,0.08498168498168535,0.20398671096345508,130262.58680555537,1527.2569444444246,131789.8437499998,1365,12,301.5128205128205,35,4,18,35.6547619047619,0.625,44.79166666666666,1020.8333333333319,29.166666666666625,0
2058,4,0,1,38,0.0,0.02564102564102564,0.9743589743589743,39,1150,800,350,0.6956521739130435,15,8,7,359.54032889778057,0.4195062977957715,0.08022409744984582,0.20547822941671082,130380.76560356648,1575.428669410146,131956.19427297663,1366,13,302.5128205128205,35,4,19,35.49599576911453,0.6261904761904762,44.675925925925924,1021.296296296296,29.17989417989417,0
2059,4,0,0,38,0.0,0.0,1.0,38,850,800,50,0.9411764705882353,9,8,1,367.3469387755105,0.4187855618776672,0.07551020408163334,0.20930232558139544,130262.58680555546,1970.3124999999945,132232.89930555545,1367,14,306.7368421052632,34,4,19,35.41666666666668,0.6271446078431373,44.791666666666664,1020.8333333333326,30.024509803921546,0
2060,4,0,0,38,0.0,0.0,1.0,38,1000,700,300,0.7,13,7,6,367.6286805657435,0.4179557847321005,0.07566556250766787,0.2102836052836052,130414.54081632647,1988.8251133786762,132403.36592970515,1368,15,307.7368421052632,34,4,19,35.25519619269619,0.6286764705882353,44.64285714285714,1021.4285714285709,30.04201680672267,0
2061,4,0,0,38,0.0,0.0,1.0,38,1450,900,550,0.6206896551724138,20,9,11,372.3360391119661,0.4175408961593172,0.08468698835519373,0.2134776368535743,130505.75573979598,2118.3992346938817,132624.15497448985,1369,16,308.7368421052632,34,4,14,35.04238028661307,0.6295955882352942,44.55357142857143,1021.7857142857148,30.052521008403374,0
2062,4,1,0,39,0.02564102564102564,0.0,1.0,39,1450,1300,150,0.896551724137931,16,13,3,368.67127346277954,0.419365721997301,0.07483754599843806,0.20976275612804812,130208.06081753575,1800.7943193439728,132008.85513687972,1370,0,301.79487179487177,38,1,18,35.43825674308245,0.6186951754385965,44.84508547008546,1020.6196581196563,26.858412055780427,8
2063,4,1,3,37,0.025,0.075,0.925,40,1200,800,400,0.6666666666666666,16,8,8,364.80007185917583,0.42342414529914535,0.07983317240639431,0.20950717620452103,130570.58572108716,1526.4546392979184,132097.0403603851,1371,0,295.225,37,3,15,35.169129742874496,0.6241554054054055,44.49013157894736,1022.0394736842098,27.622688477951616,0
2064,4,2,1,38,0.05128205128205128,0.02564102564102564,0.9743589743589743,39,1400,1000,400,0.7142857142857143,18,10,8,367.8800885146285,0.423582995951417,0.09583266273058166,0.21210914817786314,130722.82745160717,1818.065066755962,132540.89251836314,1372,0,298.5897435897436,36,3,16,34.93603861542415,0.6276041666666667,44.341216216216225,1022.6351351351364,28.406531531531567,0
2065,4,0,0,38,0.0,0.0,1.0,38,950,600,350,0.631578947368421,13,6,7,375.7985247361789,0.4193930772878141,0.08954517022607456,0.21658055877652604,130706.03358892765,2223.826919367307,132929.86050829495,1373,1,307.44736842105266,35,3,17,34.75063667232598,0.6294642857142857,44.3576388888889,1022.5694444444459,29.216269841269884,0
2066,4,0,0,38,0.0,0.0,1.0,38,1300,1100,200,0.8461538461538461,15,11,4,375.0332712270426,0.4193338074917022,0.08956894498690149,0.216969510317216,130854.01663237331,2214.9219821673805,133068.9386145407,1374,2,308.44736842105266,35,3,18,34.62009803921569,0.6309523809523809,44.212962962962976,1023.1481481481499,29.23280423280428,0
2067,4,0,0,38,0.0,0.0,1.0,38,800,700,100,0.875,9,7,2,378.42734029372036,0.41920045045045046,0.09708633864171912,0.2196070470838364,130972.46334876555,2312.7121913580377,133285.1755401236,1375,3,309.44736842105266,35,3,18,34.413161465400265,0.6321428571428571,44.09722222222223,1023.6111111111121,29.246031746031775,0
2068,4,0,0,38,0.0,0.0,1.0,38,1150,800,350,0.6956521739130435,15,8,7,374.18117828036003,0.41758534850640117,0.07836652060881844,0.21677423568532608,130906.99932912063,2196.5870508233434,133103.58637994397,1376,4,310.44736842105266,37,1,18,34.58817725633058,0.6275337837837838,44.16118421052632,1023.3552631578958,27.658250355618804,8
2069,4,0,0,38,0.0,0.0,1.0,38,950,600,350,0.631578947368421,13,6,7,375.37682524891227,0.41709637268847793,0.07734666501335807,0.21826082155506485,131047.29940943362,2238.4238419513636,133285.72325138497,1377,5,311.44736842105266,37,1,18,34.41538159491682,0.6289414414414414,44.02412280701754,1023.9035087719294,27.67306780464674,0
2070,4,1,0,39,0.02564102564102564,0.0,1.0,39,800,500,300,0.625,11,5,6,368.1675295957491,0.42130566801619435,0.07842288042475731,0.21517945011290873,131246.0064308022,1864.1035913872574,133110.11002218944,1378,0,304.43589743589746,38,1,19,34.39878531957043,0.6291118421052632,43.83012820512821,1024.679487179488,26.965249662618106,0
2071,4,1,0,40,0.025,0.0,1.0,40,1300,1000,300,0.7692307692307693,16,10,6,352.59921091226505,0.4234909188034188,0.09780887600356825,0.18732877508656387,127489.75326678052,1031.7257138495706,128521.4789806301,1379,0,297.8,36,4,16,38.620186589354745,0.5949074074074074,47.522522522522536,1009.9099099099118,28.053053053053105,8
2072,4,0,3,37,0.0,0.075,0.925,40,1000,700,300,0.7,13,7,6,354.411991373614,0.423303952991453,0.10121808451332348,0.1884244902566656,127518.18700034515,1038.794918229061,128556.98191857421,1380,1,298.8,36,4,16,38.54526703088416,0.5951967592592593,47.49436936936938,1010.0225225225242,28.05618118118123,0
2073,4,0,0,37,0.0,0.0,1.0,37,850,400,450,0.47058823529411764,13,4,9,372.051525546634,0.4147897897897898,0.10086348736655482,0.19660278868661277,127272.13718820855,2070.358560090694,129342.49574829925,1381,2,314.2162162162162,34,3,20,38.35265258769859,0.5968137254901961,47.738095238095234,1009.0476190476186,29.67787114845937,0
2074,4,0,0,37,0.0,0.0,1.0,37,550,200,350,0.36363636363636365,9,2,7,370.2891551587612,0.4140703203203204,0.11649525631826485,0.19552651650906536,127242.10778061209,2086.8941326530385,129329.00191326512,1382,3,315.2162162162162,34,3,19,38.427974434611585,0.5965073529411764,47.76785714285713,1008.9285714285702,29.674369747899124,8
2075,4,1,0,38,0.02631578947368421,0.0,1.0,38,1100,700,400,0.6363636363636364,15,7,8,363.66202602578744,0.4184892128971076,0.12323315162333004,0.1935391562898213,127559.26354595319,1677.6920438957297,129236.95558984892,1383,0,307.89473684210526,35,3,16,38.26955392606174,0.5976190476190476,47.453703703703695,1010.1851851851837,28.86243386243382,0
2076,4,1,0,39,0.02564102564102564,0.0,1.0,39,1000,800,200,0.8,12,8,4,355.08353712063064,0.4216992802519118,0.123801899170503,0.19042386897678446,127867.13219452118,1280.702716220355,129147.83491074154,1384,0,300.97435897435895,37,2,17,38.170804423243716,0.5968468468468469,47.149122807017534,1011.4035087719282,27.335229966808868,0
2077,4,2,0,41,0.04878048780487805,0.0,1.0,41,1300,1100,200,0.8461538461538461,15,11,4,330.2253258107854,0.4271595528455285,0.11179516912010379,0.17438707631114223,127245.76971379458,250.17129578513658,127495.94100957972,1385,0,287.2439024390244,40,1,20,39.43476363147998,0.5854166666666667,47.76422764227642,1008.9430894308933,25.223577235772332,8
2078,4,0,2,39,0.0,0.04878048780487805,0.9512195121951219,41,1450,900,550,0.6206896551724138,20,9,11,334.8548061042877,0.4269054878048781,0.08469196063840312,0.16894127838652268,125374.21127365035,301.8426135552003,125676.05388720555,1386,1,288.2439024390244,38,3,14,41.242176943318405,0.5696271929824561,49.626068376068375,1001.4957264957262,26.355150697255954,8
2079,4,5,0,44,0.11363636363636363,0.0,1.0,44,750,400,350,0.5333333333333333,11,4,7,326.3343416768947,0.4329303206483439,0.16260550855830802,0.16959204276172574,126593.58859592023,-534.0659603085683,126059.52263561166,1387,0,269.40909090909093,39,5,16,40.201260221509145,0.5803952991452992,48.411458333333336,1006.3541666666674,25.80395299145301,0
2080,4,2,1,45,0.043478260869565216,0.021739130434782608,0.9782608695652174,46,1000,800,200,0.8,12,8,4,313.65017072064813,0.4361916264090177,0.15646484049129583,0.16490567434215958,127067.00685193046,-1229.082321586057,125837.9245303444,1388,0,258.6521739130435,41,5,19,40.035648102594365,0.5820630081300813,47.941468253968246,1008.234126984126,24.59107626790551,0
2081,4,3,3,45,0.0625,0.0625,0.9375,48,1400,1100,300,0.7857142857142857,17,11,6,310.8602583113302,0.43821106678487,0.19287760294714507,0.16636867057594354,127785.23090457135,-1655.3300225263908,126129.90088204495,1389,0,248.70833333333334,43,5,11,39.372502419531074,0.5864825581395349,47.23011363636364,1011.079545454546,23.51347780126851,0
2082,4,0,1,44,0.0,0.022222222222222223,0.9777777777777777,45,1700,1600,100,0.9411764705882353,18,16,2,333.38293313087337,0.4311868686868687,0.19137318038505424,0.17717430959650368,127502.23597891461,-498.58611772093866,127003.64986119367,1390,1,266.24444444444447,40,5,14,39.09258234386531,0.5880208333333333,47.510162601626014,1009.9593495934955,25.24898373983739,0
2083,4,3,2,45,0.06382978723404255,0.0425531914893617,0.9574468085106383,47,1100,900,200,0.8181818181818182,13,9,4,341.1575224957108,0.4365556583410422,0.22820093163792032,0.1768577340545252,126492.5240929707,-538.7950108657146,125953.729082105,1391,0,253.31914893617022,41,6,15,39.932199211045386,0.5762195121951219,48.51190476190477,1005.9523809523824,24.535423925667864,8
2084,4,0,0,45,0.0,0.0,1.0,45,900,500,400,0.5555555555555556,13,5,8,352.24597011971036,0.43253367003367,0.2541882759704537,0.18254086975104197,126477.92009551228,-89.73246744658672,126388.18762806569,1392,1,265.4,40,5,15,39.668367346938766,0.5776041666666667,48.52642276422766,1005.8943089430924,25.147357723577308,0
2085,4,5,0,50,0.1,0.0,1.0,50,1000,700,300,0.7,13,7,6,332.8850851791563,0.44292517006802723,0.30090490797546043,0.17790252093181147,127727.90096749,-1491.7957313542927,126236.10523613571,1393,0,239.76,42,8,17,38.874376917177926,0.5873015873015873,47.28682170542636,1010.8527131782951,24.06792174234036,0
2086,4,1,0,51,0.0196078431372549,0.0,1.0,51,1900,1600,300,0.8421052631578947,22,16,6,324.178551579476,0.44383986928104574,0.29975343430785517,0.17463812294765313,128048.66850321394,-1897.8736225895345,126150.7948806244,1394,0,236.0392156862745,43,8,18,38.766997255489024,0.5891472868217054,46.96969696969697,1012.1212121212119,23.537702607470045,0
2087,4,1,0,52,0.019230769230769232,0.0,1.0,52,1600,1100,500,0.6875,21,11,10,313.3632631670889,0.44402809200603316,0.29178289000718927,0.17002976246895785,128336.3643537648,-2356.7837465564876,125979.58060720832,1395,0,232.48076923076923,43,9,19,38.747663551401864,0.5920542635658914,46.685606060606055,1013.2575757575748,23.56412966878081,0
2088,4,0,1,51,0.0,0.019230769230769232,0.9807692307692307,52,1950,1500,450,0.7692307692307693,24,15,9,313.9425783449054,0.4438788335847159,0.28951527924130693,0.1710284195461051,128496.3348765432,-2331.905864197528,126164.42901234567,1396,1,233.48076923076923,44,8,14,38.57020547945206,0.5923295454545454,46.52777777777778,1013.8888888888888,23.04292929292929,0
2089,4,1,2,50,0.019230769230769232,0.038461538461538464,0.9615384615384616,52,1200,900,300,0.75,15,9,6,314.1664345718696,0.44548139768728,0.2970807148123451,0.17165552572243506,128613.70991940983,-2318.777863511687,126294.93205589814,1397,0,234.44230769230768,44,8,15,38.44515441959531,0.5935132575757576,46.412037037037024,1014.3518518518492,23.05345117845112,0
2090,4,0,0,50,0.0,0.0,1.0,50,1450,1100,350,0.7586206896551724,18,11,7,321.1334206885369,0.4445068027210884,0.2975873015873014,0.1752976012015408,128576.35750258272,-1741.9668991046765,126834.39060347804,1398,1,242.46,43,7,15,38.30648926237163,0.5944767441860466,46.44886363636364,1014.204545454546,23.58615221987316,0
2091,4,0,1,49,0.0,0.02,0.98,50,1600,1000,600,0.625,22,10,12,311.2097909458698,0.4448044217687075,0.2697290764427438,0.16444928229385522,127271.40472147854,-2044.6965582901728,125226.70816318836,1399,2,243.46,40,10,16,39.888206264477795,0.5856770833333333,47.73882113821138,1009.0447154471539,25.226117886178848,8
2092,4,2,0,51,0.0392156862745098,0.0,1.0,51,1150,700,450,0.6086956521739131,16,7,9,309.0287346865238,0.4443137254901961,0.2861955520463224,0.1649523901115884,127678.93024006947,-2308.708348356496,125370.22189171298,1400,0,239.52941176470588,42,9,14,39.52720517737296,0.5868055555555556,47.335271317829445,1010.6589147286802,24.063307493540005,0
2093,4,1,0,52,0.019230769230769232,0.0,1.0,52,1550,1200,350,0.7741935483870968,19,12,7,302.5483443546195,0.44705253896430364,0.2840772470393438,0.1626939637357374,127976.79498285378,-2656.166512425421,125320.62847042836,1401,0,235.90384615384616,43,9,15,39.3874785524879,0.5884205426356589,47.04071969696968,1011.8371212121186,23.531095842142292,0
2094,4,1,1,52,0.018867924528301886,0.018867924528301886,0.9811320754716981,53,1500,1000,500,0.6666666666666666,20,10,10,298.49214336200157,0.4483248669569424,0.2831412861500162,0.16194345685723266,128332.09983710562,-2938.7752914951943,125393.32454561042,1402,0,232.43396226415095,44,9,16,39.128704803679696,0.5906723484848485,46.68981481481482,1013.2407407407406,23.02819865319865,0
2095,4,1,0,53,0.018867924528301886,0.0,1.0,53,1900,1400,500,0.7368421052631579,24,14,10,306.0653343587046,0.448566763425254,0.2958713818390404,0.1670320681231138,128566.75347222235,-2730.0347222222163,125836.71875000013,1403,0,233.32075471698113,44,9,13,38.69830183511364,0.5930397727272727,46.458333333333336,1014.1666666666678,23.04924242424245,0
2096,4,2,1,54,0.03636363636363636,0.01818181818181818,0.9818181818181818,55,1300,800,500,0.6153846153846154,18,8,10,306.70518677774845,0.4506734006734007,0.31669150521609635,0.17008196721311464,129201.38888888858,-3071.5277777777987,126129.86111111079,1404,0,225.8,44,11,15,38.03790983606557,0.5994318181818181,45.83333333333332,1016.6666666666642,23.106060606060552,0
2097,4,2,3,53,0.03571428571428571,0.05357142857142857,0.9464285714285714,56,1150,800,350,0.6956521739130435,15,8,7,304.2900679945878,0.4512242965367965,0.3259866246249308,0.16993057673892556,129477.80468914068,-3320.2380014703,126157.56668767039,1405,0,222.67857142857142,45,11,14,37.819286222855126,0.6009259259259259,45.56159420289854,1017.7536231884037,22.616747181964527,0
2098,4,0,2,51,0.0,0.03773584905660377,0.9622641509433962,53,1450,1000,450,0.6896551724137931,19,10,9,321.47398392652735,0.44761429608127723,0.33235656561071547,0.17816802575839064,129178.367571479,-2294.5031079342775,126883.86446354473,1406,1,235.96226415094338,45,8,17,37.685909144910745,0.5979166666666667,45.855978260869556,1016.5760869565202,22.590579710144894,0
2099,4,0,1,50,0.0,0.0196078431372549,0.9803921568627451,51,1200,900,300,0.75,15,9,6,328.27836270389054,0.4481862745098039,0.33227576744983756,0.18161206194747467,129107.27023319599,-1723.375342935546,127383.89489026045,1407,2,232.92156862745097,44,7,17,37.58522382167151,0.5984848484848485,45.92592592592592,1016.2962962962949,23.09764309764307,0
2100,4,0,0,50,0.0,0.0,1.0,50,1000,300,700,0.3,17,3,14,334.3226990222826,0.44564625850340134,0.33779114270092947,0.18473601707303774,129060.22376543209,-1370.4475308642004,127689.7762345679,1408,3,238.3,44,6,17,37.47949699289228,0.5980113636363636,45.97222222222222,1016.1111111111111,23.093434343434343,0
2101,4,1,0,51,0.0196078431372549,0.0,1.0,51,1500,1000,500,0.6666666666666666,20,10,10,331.1908117741623,0.4471078431372549,0.35042494813625225,0.1844846156840861,129377.95380015398,-1629.9334490741064,127748.02035107987,1409,0,234.6078431372549,41,10,18,37.2362059158134,0.6054369918699187,45.65972222222221,1017.3611111111084,24.813685636856302,0
2102,4,1,0,52,0.019230769230769232,0.0,1.0,52,1250,600,650,0.48,19,6,13,325.40944648791753,0.4483330191050779,0.3518956305350216,0.18250017516478162,129645.08311549765,-1962.4530527011882,127682.63006279647,1410,0,231.07692307692307,42,10,18,37.112274024738326,0.6066468253968254,45.397286821705414,1018.4108527131766,24.247877445551826,0
2103,4,1,1,52,0.018867924528301886,0.018867924528301886,0.9811320754716981,53,1350,900,450,0.6666666666666666,18,9,9,319.5101642934804,0.44886913401064343,0.3476900458032539,0.18050930831377676,129931.9712362824,-2297.08290466394,127634.88833161847,1411,0,227.69811320754718,44,9,19,36.971929585565945,0.6067708333333333,45.11574074074073,1019.5370370370357,23.171296296296266,0
2104,4,1,1,52,0.018867924528301886,0.018867924528301886,0.9811320754716981,53,2300,1800,500,0.782608695652174,28,18,10,320.6018744253611,0.4487481857764877,0.34298252225544235,0.1821270860010936,130147.02896089289,-2254.9237128492186,127892.10524804366,1412,0,228.22641509433961,45,8,20,36.72649430389111,0.6076388888888888,44.904891304347814,1020.3804347826062,22.675120772946805,0
2105,4,0,0,52,0.0,0.0,1.0,52,1900,1400,500,0.7368421052631579,24,14,10,328.02998750520635,0.4458191930618401,0.347331240188383,0.18690080683436136,130262.58680555524,-1853.8392177326527,128408.7475878226,1413,1,233.44230769230768,41,11,21,36.42006802721086,0.6143292682926829,44.79166666666665,1020.8333333333309,24.898373983739777,0
2106,4,0,0,52,0.0,0.0,1.0,52,1200,800,400,0.6666666666666666,16,8,8,330.79927463699005,0.4458427601809955,0.35624845862386056,0.18884730636930275,130338.5527388034,-1776.8202593537853,128561.73247944961,1414,2,234.44230769230768,41,11,21,36.27252744583698,0.6150914634146342,44.717261904761884,1021.1309523809487,24.905632984901185,0
2107,4,0,1,51,0.0,0.019230769230769232,0.9807692307692307,52,1300,600,700,0.46153846153846156,20,6,14,325.5600204706176,0.44574063599798897,0.3428234796311438,0.1865600465131621,130485.24728081207,-1903.8440448290746,128581.40323598299,1415,3,235.44230769230768,42,10,21,36.257982422862916,0.6150793650793651,44.573643410852696,1021.705426356586,24.32631967515681,0
2108,4,0,0,51,0.0,0.0,1.0,51,1300,800,500,0.6153846153846154,18,8,10,331.26740827999845,0.445702614379085,0.342277495634556,0.18960869944742312,130439.8750964505,-1557.9041280864299,128881.97096836407,1416,4,240.35294117647058,41,10,21,36.15808406979379,0.6161077235772358,44.61805555555555,1021.5277777777768,24.915311653116508,0
2109,4,0,0,51,0.0,0.0,1.0,51,1500,1300,200,0.8666666666666667,17,13,4,332.11147296752694,0.4454575163398693,0.34662517960070605,0.1909233748411137,130609.02970261683,-1524.648552520902,129084.38115009593,1417,5,241.35294117647058,42,9,18,35.96549435965493,0.6163194444444444,44.45251937984495,1022.1899224806185,24.337855297157585,0
2110,4,0,0,51,0.0,0.0,1.0,51,1450,900,550,0.6206896551724138,20,9,11,331.1275720164611,0.4451797385620915,0.3433841684822081,0.1910351377018042,130746.38429752042,-1541.253443526197,129205.13085399423,1418,6,242.35294117647058,43,8,19,35.85185185185183,0.6162790697674418,44.318181818181806,1022.7272727272708,23.784355179703972,0
2111,4,0,0,51,0.0,0.0,1.0,51,1700,1000,700,0.5882352941176471,24,10,14,328.1231559444095,0.444624183006536,0.3412534210277973,0.18977743987277293,130843.25140610641,-1613.4598829201186,129229.7915231863,1419,7,243.35294117647058,43,8,19,35.830865111687025,0.6172480620155039,44.223484848484844,1023.1060606060597,23.793164200140925,0
2112,4,0,1,50,0.0,0.0196078431372549,0.9803921568627451,51,1100,700,400,0.6363636363636364,15,7,8,328.60980877086087,0.4444444444444444,0.34045471616980283,0.19041749079821407,130915.92527727553,-1595.9485659148368,129319.9767113607,1420,8,244.35294117647058,43,8,19,35.74506107152771,0.6179748062015504,44.15246212121212,1023.390151515151,23.79977096546863,0
2113,4,1,2,49,0.0196078431372549,0.0392156862745098,0.9607843137254902,51,1950,1500,450,0.7692307692307693,24,15,9,331.6407555018092,0.44441176470588234,0.357439071073115,0.1935270737801698,131185.80246913584,-1498.6882716049283,129687.11419753091,1421,0,245.1764705882353,44,7,20,35.395200650759236,0.6193181818181819,43.88888888888889,1024.4444444444448,23.28282828282829,0
2114,4,0,0,49,0.0,0.0,1.0,49,1600,1000,600,0.625,22,10,12,345.5934413862659,0.44315121882086167,0.2819732191233011,0.1885271807838179,128550.50131492416,-781.2703174081596,127769.230997516,1422,1,252.9591836734694,38,11,16,37.712679098187955,0.6019736842105263,46.474358974358964,1014.1025641025622,26.686909581646372,8
2115,4,1,0,50,0.02,0.0,1.0,50,1450,900,550,0.6206896551724138,20,9,11,341.63164824209696,0.443843537414966,0.30005601680504146,0.18858595182088575,129020.64252635662,-1184.4930472932847,127836.14947906333,1423,0,248.88,40,10,17,37.33411690173719,0.6033854166666667,46.011178861788615,1015.9552845528451,25.398882113821127,0
2116,4,0,1,49,0.0,0.02,0.98,50,2050,1800,250,0.8780487804878049,23,18,5,340.9701693093257,0.44386054421768706,0.2967213114754099,0.18908345752608038,129201.38888888879,-1188.8565627272226,128012.53232616157,1424,1,249.88,37,13,18,37.16700819672132,0.6103603603603603,45.83333333333333,1016.6666666666658,27.477477477477454,0
2117,4,2,1,50,0.0392156862745098,0.0196078431372549,0.9803921568627451,51,950,600,350,0.631578947368421,13,6,7,307.6264726984515,0.44790849673202615,0.14449284730614598,0.1677598247414953,128537.27357317769,-2109.414717414827,126427.85885576287,1425,0,245.2549019607843,42,9,11,38.68868450390187,0.5954861111111112,46.48740310077519,1014.0503875968992,24.14405684754522,8
2118,4,1,0,51,0.0196078431372549,0.0,1.0,51,1500,1100,400,0.7333333333333333,19,11,8,304.86839145299524,0.44797385620915037,0.16012292098284409,0.16749376702952445,128832.22467287118,-2344.625379334176,126487.599293537,1426,0,245.45098039215685,42,9,13,38.459045210142854,0.5984623015873016,46.19670542635659,1015.2131782945733,24.17174234034698,0
2119,4,1,0,52,0.019230769230769232,0.0,1.0,52,1550,1200,350,0.7741935483870968,19,12,7,301.7337913042083,0.44739819004524883,0.1701569273763035,0.16722314143782535,129177.32119669713,-2604.5674249598205,126572.7537717373,1427,0,241.71153846153845,43,9,14,38.18865471200125,0.6005329457364341,45.85700757575758,1016.57196969697,23.641208597603953,0
2120,4,1,1,52,0.018867924528301886,0.018867924528301886,0.9811320754716981,53,1650,1100,550,0.6666666666666666,22,11,11,299.9140301017911,0.4478410740203193,0.17634873710598198,0.16754033240821484,129490.37606175401,-2832.8016493055466,126657.57441244846,1428,0,238.1320754716981,43,10,12,37.9179072075425,0.6036821705426356,45.54924242424243,1017.8030303030312,23.66983791402398,0
2121,4,1,3,50,0.018867924528301886,0.05660377358490566,0.9433962264150944,53,1650,1100,550,0.6666666666666666,22,11,11,297.97164608570273,0.4475991775520078,0.18276581080867715,0.1675837396882429,129755.56456790969,-2867.3041673840235,126888.26040052567,1429,0,238.67924528301887,43,10,13,37.69915497103201,0.6063468992248062,45.28882575757578,1018.8446969697009,23.694062720225602,0
2122,4,1,0,51,0.0196078431372549,0.0,1.0,51,1100,900,200,0.8181818181818182,13,9,4,312.5839089373807,0.4467320261437908,0.20095129615532126,0.17660389401591323,129933.65698420575,-2076.9659194696337,127856.69106473612,1430,0,245.54901960784315,41,10,14,37.146763809153136,0.6110264227642277,45.114087301587304,1019.543650793651,24.866918312040266,0
2123,4,0,2,49,0.0,0.0392156862745098,0.9607843137254902,51,1100,700,400,0.6363636363636364,15,7,8,349.4557144334939,0.44593137254901966,0.1231241308084372,0.196976163151741,129842.52467550016,-996.5952795302286,128845.92939596993,1431,1,246.54901960784315,42,9,13,36.299478671483826,0.6086309523809523,45.20348837209302,1019.1860465116271,24.266334440753024,8
2124,4,1,2,48,0.02,0.04,0.96,50,1400,1000,400,0.7142857142857143,18,10,8,346.45096527647354,0.444234693877551,0.07663898479051978,0.18991892556869389,128744.48609855656,-1028.784925618488,127715.70117293808,1432,0,251.46,43,7,14,37.49309897048302,0.596172480620155,46.28314393939394,1014.867424242424,23.60156800563777,8
2125,4,1,0,49,0.02040816326530612,0.0,1.0,49,1250,1000,250,0.8,15,10,5,348.76931705747097,0.44079506802721086,0.10530331934376203,0.19244723789634333,129004.43558079429,-801.4422210203841,128202.99335977391,1433,0,257.3673469387755,42,7,15,37.16933740302683,0.6001984126984127,46.02713178294573,1015.8914728682159,24.187892211148,0
2126,4,0,1,48,0.0,0.02040816326530612,0.9795918367346939,49,1000,700,300,0.7,13,7,6,346.01085387693706,0.4404939058956916,0.09167621667791925,0.19152020297177766,129127.5137931161,-864.095738687608,128263.41805442849,1434,1,258.3673469387755,42,7,15,37.11407982966281,0.6014384920634921,45.90600775193797,1016.3759689922457,24.199427833148707,0
2127,4,0,2,46,0.0,0.041666666666666664,0.9583333333333334,48,1850,1400,450,0.7567567567567568,23,14,9,348.92560496991626,0.43846040189125296,0.11374825091293839,0.1944070954786747,129386.78521050328,-570.6852864935637,128816.09992400972,1435,2,264.5625,39,9,17,36.776155250674044,0.6087072649572649,45.65104166666666,1017.3958333333318,26.087072649572608,0
2128,4,1,1,46,0.02127659574468085,0.02127659574468085,0.9787234042553191,47,1350,1000,350,0.7407407407407407,17,10,7,343.74862591795994,0.43960067838421213,0.12445655248647647,0.19294914260768162,129678.39084201393,-484.6462673611069,129193.74457465282,1436,0,261.51063829787233,39,8,15,36.61152587441194,0.6116452991452992,45.364583333333336,1018.5416666666671,26.116452991453002,0
2129,4,1,0,47,0.02127659574468085,0.0,1.0,47,1150,700,450,0.6086956521739131,16,7,9,343.5695754743193,0.44106537156953435,0.13997039664582256,0.1942924652985622,129970.32470703125,-469.23014322916737,129501.09456380208,1437,0,261.93617021276594,39,8,16,36.31978496271325,0.6145833333333333,45.078125,1019.6875,26.145833333333332,0
2130,4,0,0,47,0.0,0.0,1.0,47,1100,700,400,0.6363636363636364,15,7,8,341.20526296892604,0.4407570151094666,0.13544549637424552,0.19361322975189246,130103.13042534732,-521.6254340277685,129581.50499131955,1438,1,262.93617021276594,39,8,16,36.24540535021442,0.6159188034188035,44.94791666666667,1020.2083333333342,26.159188034188055,0
2131,4,0,2,45,0.0,0.0425531914893617,0.9574468085106383,47,1050,600,450,0.5714285714285714,15,6,9,339.0672370502803,0.4404486586493987,0.13447086522505924,0.1926625669457396,130156.27170138908,-573.65451388887,129582.6171875002,1439,2,263.93617021276594,39,8,16,36.24608683816524,0.6164529914529915,44.89583333333334,1020.4166666666682,26.164529914529954,0
2132,4,0,0,45,0.0,0.0,1.0,45,1450,1100,350,0.7586206896551724,18,11,7,341.2282197305179,0.4385942760942761,0.14108438335242468,0.19470080772858978,130318.55955678681,-106.2825821406451,130212.27697464617,1440,3,270.77777777777777,37,8,16,36.026542812142054,0.6216216216216216,44.736842105263165,1021.0526315789483,27.596017069701304,0
2133,4,0,0,45,0.0,0.0,1.0,45,1150,900,250,0.782608695652174,14,9,5,342.19257588296693,0.4385311447811448,0.13337149945136195,0.1958148671330294,130430.54112803933,-73.52743151739733,130357.01369652193,1441,4,271.77777777777777,37,8,17,35.88852511807644,0.6227477477477478,44.62719298245614,1021.4912280701749,27.607871028923647,0
2134,4,0,0,45,0.0,0.0,1.0,45,1750,1100,650,0.6285714285714286,24,11,13,349.80934240884346,0.438047138047138,0.13523979743818848,0.20148067436457473,130682.67549871116,142.80415608648636,130825.47965479764,1442,5,272.77777777777777,37,8,16,35.438672922252,0.6252815315315315,44.38048245614035,1022.4780701754388,27.634542437174023,0
2135,4,0,0,45,0.0,0.0,1.0,45,950,600,350,0.631578947368421,13,6,7,349.73308106133464,0.43794191919191916,0.1308657853995474,0.20216912306705387,130822.85534972281,150.61605493995947,130973.47140466278,1443,6,273.77777777777777,37,8,16,35.298767416934616,0.6266891891891893,44.24342105263157,1023.0263157894722,27.64935988620195,0
2136,4,1,0,46,0.021739130434782608,0.0,1.0,46,1150,800,350,0.6956521739130435,15,8,7,342.2789907910544,0.439200885668277,0.13614844642759927,0.1996211048482135,131163.91354372125,-221.0696088099944,130942.84393491126,1444,0,268.80434782608694,38,8,17,35.14484251147267,0.6282894736842105,43.91025641025641,1024.3589743589746,26.95681511470986,0
2137,4,2,1,47,0.041666666666666664,0.020833333333333332,0.9791666666666666,48,1300,700,600,0.5384615384615384,19,7,12,331.8802254702666,0.4409629875886525,0.1464394689097812,0.1969259940327095,131823.38271077065,-850.0852047392455,130973.2975060314,1445,0,258.5625,40,8,17,34.74682500412338,0.6315104166666667,43.267276422764226,1026.9308943089425,25.67327235772356,0
2138,4,0,0,47,0.0,0.0,1.0,47,1700,1300,400,0.7647058823529411,21,13,8,337.0102325045569,0.43832870798643236,0.14233308877476158,0.2001759573792125,131862.52170138873,-512.1961805555742,131350.32552083317,1446,1,264.8936170212766,39,8,17,34.575726842461115,0.6335470085470085,43.22916666666666,1027.083333333332,26.33547008547005,0
2139,4,0,1,46,0.0,0.02127659574468085,0.9787234042553191,47,1350,900,450,0.6666666666666666,18,9,9,335.7979963020188,0.43738436632747457,0.13935911373401666,0.2000188064929415,131969.5312499999,-536.9791666666799,131432.55208333323,1447,2,265.8936170212766,39,8,17,34.49918896999187,0.6346153846153846,43.12499999999999,1027.4999999999993,26.34615384615383,0
2140,4,0,0,46,0.0,0.0,1.0,46,1300,900,400,0.6923076923076923,17,9,8,333.9316019693841,0.4363828502415459,0.14011595377708908,0.19961059841525441,132103.35422092007,-377.3030598958374,131726.05116102422,1448,3,269.5,39,7,17,34.41257557334415,0.6359508547008548,42.994791666666664,1028.0208333333328,26.359508547008534,0
2141,4,0,1,45,0.0,0.021739130434782608,0.9782608695652174,46,1600,1000,600,0.625,22,10,12,323.5836785747524,0.4361413043478261,0.02243954867302933,0.18679996324350093,130770.59771184863,-566.0526384225743,130204.54507342605,1449,4,270.5,43,3,13,36.020295188717085,0.6165213178294573,44.29450757575758,1022.8219696969699,23.786557434813254,8
2142,4,0,2,43,0.0,0.044444444444444446,0.9555555555555556,45,1200,700,500,0.5833333333333334,17,7,10,327.31868249140695,0.43310185185185185,0.036185304455810696,0.18925688114700273,130831.98594585637,-435.2493464936217,130396.73659936275,1450,5,277.1333333333333,42,3,13,35.862813348487734,0.6185515873015873,44.234496124031,1023.062015503874,24.358619416758906,0
2143,4,0,0,43,0.0,0.0,1.0,43,1050,800,250,0.7619047619047619,13,8,5,334.20302719832785,0.4303940568475452,0.04423814711315299,0.19305139571103383,130794.81336805531,142.40451388886453,130937.21788194418,1451,6,289.5348837209302,41,2,14,35.72428716904275,0.6196646341463414,44.27083333333332,1022.9166666666647,24.94918699186987,0
2144,4,0,0,43,0.0,0.0,1.0,43,1250,800,450,0.64,17,8,9,332.9812107378258,0.42958656330749356,0.04725144550670879,0.1930267589359447,130931.13864100697,119.52181359291255,131050.66045459989,1452,7,290.5348837209302,42,1,14,35.61785962254621,0.6195436507936508,44.137596899224796,1023.4496124030993,24.36784791435951,0
2145,4,0,1,42,0.0,0.023255813953488372,0.9767441860465116,43,950,700,250,0.7368421052631579,12,7,5,330.18286188177206,0.42960963455149503,0.04465415587359489,0.19202214097439077,131055.13232565632,54.431731115896426,131109.56405677221,1453,8,291.5348837209302,42,1,15,35.5643355099208,0.6207837301587302,44.01647286821704,1023.9341085271303,24.379383536360244,0
2146,4,0,0,42,0.0,0.0,1.0,42,950,800,150,0.8421052631578947,11,8,3,335.49341844562497,0.4272406116918312,0.042374445659647764,0.19482029178055144,130997.8517593378,389.7834191546795,131387.6351784925,1454,10,299.2857142857143,41,1,16,35.48621878735019,0.6216971544715447,44.072420634920626,1023.710317460316,24.96854432830039,0
2147,4,0,0,42,0.0,0.0,1.0,42,1200,900,300,0.75,15,9,6,338.8733857421936,0.42750677506775064,-0.0283543824382001,0.1940064970212313,130448.74267578126,456.0072926016483,130904.74996838291,1455,11,300.2857142857143,39,3,17,35.9548664219435,0.6193910256410257,44.609375,1021.5625000000001,26.19391025641026,8
2148,4,0,2,40,0.0,0.047619047619047616,0.9523809523809523,42,1100,700,400,0.6363636363636364,15,7,8,343.06769134992646,0.4270833333333333,-0.019034030244792444,0.19708314915254574,130581.7925347223,559.6788194444546,131141.47135416677,1456,12,301.2857142857143,39,3,13,35.713072428319066,0.6207264957264957,44.47916666666667,1022.083333333334,26.207264957264975,0
2149,4,0,0,40,0.0,0.0,1.0,40,1600,1300,300,0.8125,19,13,6,350.65851277422684,0.4273904914529914,-0.004527896995708325,0.20123998393200704,130542.57079101264,1155.1727454601428,131697.7435364728,1457,13,315.1,37,3,14,35.55883404864091,0.6238738738738738,44.51754385964912,1021.9298245614036,27.619724988146043,0
2150,4,0,0,40,0.0,0.0,1.0,40,1500,1200,300,0.8,18,12,6,348.84667421528536,0.4273504273504274,-0.0052424112410169865,0.20063525871123408,130626.62459843411,1113.7327110264628,131740.35730946058,1458,14,316.1,37,3,14,35.52001769816581,0.6247184684684685,44.435307017543856,1022.2587719298243,27.62861545756282,0
2151,4,0,1,39,0.0,0.025,0.975,40,950,500,450,0.5263157894736842,14,5,9,345.6514615419712,0.4272168803418803,-0.009725050916497224,0.19966455013777412,130794.81336805563,1041.8836805555609,131836.69704861118,1459,15,317.1,37,3,15,35.43151731160895,0.6264076576576576,44.270833333333336,1022.9166666666673,27.646396396396415,0
2152,4,0,1,38,0.0,0.02564102564102564,0.9743589743589743,39,900,700,200,0.7777777777777778,11,7,4,345.1798770382458,0.4258884390463338,0.0030392213437970828,0.1996821718936066,130850.9003371231,1233.4195377423919,132084.3198748655,1460,16,324.8205128205128,37,2,15,35.38686010788411,0.6269707207207207,44.21600877192983,1023.1359649122818,27.652323376007615,0
2153,4,1,0,39,0.02564102564102564,0.0,1.0,39,1050,700,350,0.6666666666666666,14,7,7,337.30660764582404,0.4273504273504274,0.02854735617231574,0.1968429503582097,131187.67463306035,1050.0938990843526,132237.7685321447,1461,0,325.1794871794872,37,2,17,35.248202754290205,0.6303490990990991,43.88706140350878,1024.4517543859663,27.687885253674764,0
2154,4,0,0,39,0.0,0.0,1.0,39,1150,800,350,0.6956521739130435,15,8,7,333.465529777249,0.42692869995501576,0.030227225349176656,0.19531552458381735,131328.12500000012,958.6805555555705,132286.80555555568,1462,1,326.1794871794872,37,2,18,35.204945799458,0.6317567567567568,43.75000000000001,1025.000000000001,27.702702702702727,0
2155,4,0,1,38,0.0,0.02564102564102564,0.9743589743589743,39,1500,1100,400,0.7333333333333333,19,11,8,371.71559221694537,0.42701304543409807,0.025462409558433707,0.21503274587577892,130850.9003371228,1932.2042599645845,132783.1045970874,1463,2,327.1794871794872,37,2,15,34.70811899403423,0.6269707207207207,44.216008771929815,1023.1359649122794,27.65232337600755,8
2156,4,0,0,38,0.0,0.0,1.0,38,1300,800,500,0.6153846153846154,18,8,10,379.36655008820117,0.4241494784257942,0.026906569825024595,0.21971343790003045,130895.62694028464,2331.484482793578,133227.11142307823,1464,20,336.7368421052632,36,2,15,34.467049998165876,0.6293402777777778,44.172297297297284,1023.3108108108089,28.425300300300247,0
2157,4,1,1,38,0.02564102564102564,0.02564102564102564,0.9743589743589743,39,750,600,150,0.8,9,6,3,372.7289473060641,0.425691632928475,0.03373790271670818,0.21735541983353596,131159.59357686958,1977.3954485995432,133136.9890254691,1465,0,329.0769230769231,37,2,16,34.36942481981017,0.6300675675675675,43.91447368421051,1024.342105263156,27.684921763869085,0
2158,4,0,0,38,0.0,0.0,1.0,38,1200,700,500,0.5833333333333334,17,7,10,377.92761341375376,0.4238086770981508,0.029914674326265267,0.22087139132905076,131243.8457626382,2320.134680863307,133563.9804435015,1466,1,330.1578947368421,37,1,19,34.150949705724976,0.6309121621621622,43.832236842105246,1024.6710526315765,27.69381223328585,0
2159,4,1,0,39,0.02564102564102564,0.0,1.0,39,1000,600,400,0.6,14,6,8,364.2079079560581,0.4256635177687809,0.036746603190145555,0.2151021818019155,131645.74361100953,1789.3382775626642,133435.0818885722,1467,0,322.6666666666667,36,3,16,34.096208712827824,0.6368634259259259,43.44031531531531,1026.2387387387378,28.506631631631606,0
2160,4,0,1,38,0.0,0.02564102564102564,0.9743589743589743,39,1150,600,550,0.5217391304347826,17,6,11,364.6833641120346,0.4251855600539811,0.040244039586144975,0.2165307474415205,131848.0642804967,1816.5591266942583,133664.62340719096,1468,1,323.6666666666667,36,3,16,33.87975146198831,0.6388888888888888,43.24324324324324,1027.0270270270269,28.528528528528525,0
2161,4,0,0,38,0.0,0.0,1.0,38,650,300,350,0.46153846153846156,10,3,7,368.16163515006764,0.42373458985301093,0.05187224146931846,0.21833756865316822,131803.09070644708,2104.968278463637,133908.05898491072,1469,2,332.1578947368421,35,3,16,33.83585061617074,0.6404761904761904,43.28703703703703,1026.8518518518508,29.33862433862431,0
2162,4,0,1,37,0.0,0.02631578947368421,0.9736842105263158,38,1350,900,450,0.6666666666666666,18,9,9,367.6458747183684,0.4235715979137032,0.047446683623557195,0.21888614553151958,131951.69331114975,2102.2991415895117,134053.99245273927,1470,3,333.1578947368421,35,3,16,33.699095978371076,0.6419642857142858,43.142361111111114,1027.4305555555559,29.355158730158738,0
2163,4,0,0,37,0.0,0.0,1.0,37,1100,900,200,0.8181818181818182,13,9,4,375.4062384897402,0.4214527027027027,0.04744961372553824,0.2226339671043432,131803.09070644717,2495.9405006858715,134299.03120713303,1471,4,343.02702702702703,35,2,16,33.64987225728887,0.6404761904761904,43.28703703703704,1026.8518518518517,29.338624338624335,0
2164,4,0,0,37,0.0,0.0,1.0,37,950,600,350,0.631578947368421,13,6,7,375.9755604046814,0.4209834834834835,0.044802436239055776,0.22349518409856328,131892.2422223295,2517.6519365140725,134409.89415884358,1472,5,344.02702702702703,35,2,16,33.545187793427246,0.6413690476190477,43.20023148148149,1027.199074074075,29.348544973545,0
2165,4,0,1,36,0.0,0.02702702702702703,0.972972972972973,37,1000,800,200,0.8,12,8,4,379.2549306062821,0.41985735735735735,0.0525931336742147,0.2263295553618134,132040.8950617284,2615.432098765434,134656.32716049382,1473,6,345.02702702702703,35,2,17,33.310810810810814,0.6428571428571428,43.05555555555556,1027.7777777777778,29.365079365079367,0
2166,4,0,0,36,0.0,0.0,1.0,36,1350,1000,350,0.7407407407407407,17,10,7,384.96524258439734,0.41868386243386246,0.05676188637972124,0.2300467037865933,132091.8810232427,2970.156604308402,135062.0376275511,1474,7,353.8333333333333,34,2,18,33.11257479251111,0.6455269607843137,43.00595238095239,1027.976190476191,30.23459383753503,0
2167,4,0,0,36,0.0,0.0,1.0,36,600,300,300,0.5,9,3,6,387.08431223090827,0.4186342592592593,0.0598721115742884,0.2315000083397592,132122.47732426302,3028.507653061221,135150.98497732423,1475,8,354.8333333333333,34,2,18,33.0272020225413,0.6458333333333333,42.976190476190474,1028.0952380952378,30.23809523809523,0
2168,4,0,0,36,0.0,0.0,1.0,36,800,500,300,0.625,11,5,6,390.20043475228135,0.41747685185185185,0.05994086243326713,0.2341466079435195,132249.14969403722,3120.7351412465705,135369.8848352838,1476,9,355.8333333333333,35,1,18,32.819122501031465,0.6449404761904762,42.85300925925926,1028.587962962963,29.388227513227516,0
2169,4,0,0,36,0.0,0.0,1.0,36,1150,1000,150,0.8695652173913043,13,10,3,387.8851068922774,0.41582341269841266,0.05480498353370633,0.2342647579440706,132492.61289227704,3078.549711819944,135571.162604097,1477,10,356.8333333333333,33,3,18,32.63289588541047,0.6518308080808081,42.61642156862745,1029.5343137254904,31.198009506833042,0
2170,4,0,0,36,0.0,0.0,1.0,36,950,600,350,0.631578947368421,13,6,7,388.2803959712091,0.4148974867724868,0.05680150703946052,0.2352917612211977,132618.8113496011,3098.6569168108394,135717.46826641195,1478,11,357.8333333333333,33,3,18,32.49541443585166,0.6530934343434344,42.493872549019606,1030.0245098039215,31.21286393345217,0
2171,4,0,0,36,0.0,0.0,1.0,36,1250,900,350,0.72,16,9,7,389.2539313104433,0.4143849206349206,0.063888568018174,0.23680753923784334,132765.81809807266,3135.9233276644104,135901.74142573707,1479,12,358.8333333333333,34,2,18,32.32210927573062,0.6522671568627452,42.35119047619048,1030.595238095239,30.31162464985997,0
2172,4,0,0,36,0.0,0.0,1.0,36,850,300,550,0.35294117647058826,14,3,11,389.8116071700367,0.4138888888888889,0.07207727237743411,0.23812046130513798,132919.22477324257,3162.691326530607,136081.9160997732,1480,13,359.8333333333333,34,2,18,32.15313053182483,0.6537990196078431,42.20238095238095,1031.1904761904757,30.32913165266105,0
2173,4,0,0,36,0.0,0.0,1.0,36,800,400,400,0.5,12,4,8,382.6856630907016,0.41317791005291005,0.022408751764469104,0.21738123748760466,130144.46159122078,2760.8839163237258,132905.3455075445,1481,14,360.8333333333333,35,1,20,35.14537961282519,0.6238095238095238,44.907407407407405,1020.3703703703698,29.153439153439137,8
2174,4,1,0,37,0.02702702702702703,0.0,1.0,37,1150,700,450,0.6086956521739131,16,7,9,370.55128923044094,0.4154466966966967,0.026119209420553346,0.21215079306490064,130450.30757400987,2267.866681440175,132718.17425545005,1482,0,352.05405405405406,33,4,21,35.1442538387716,0.6313131313131313,44.607843137254896,1021.5686274509794,30.956625074272104,0
2175,4,0,1,36,0.0,0.02702702702702703,0.972972972972973,37,1350,1100,250,0.8148148148148148,16,11,5,370.3020030169536,0.4148836336336336,0.026145642497843458,0.2128121149868516,130597.00255102033,2272.066326530599,132869.06887755092,1483,1,353.05405405405406,34,3,19,35.00174703004892,0.6305147058823529,44.46428571428571,1022.1428571428565,30.063025210084017,0
2176,4,0,2,34,0.0,0.05555555555555555,0.9444444444444444,36,900,600,300,0.6666666666666666,12,6,6,400.2566489102861,0.41230158730158734,0.005392218452904274,0.20619046399203692,126234.09162649229,2907.2477148573007,129141.33934134958,1484,17,363.8333333333333,32,4,18,38.71324915190349,0.5908203125,48.7689393939394,1004.9242424242432,31.4038825757576,8
2177,4,0,0,34,0.0,0.0,1.0,34,1100,900,200,0.8181818181818182,13,9,4,411.67454845347925,0.4080325311942959,0.04030646759907541,0.21231050160931839,126280.14257428596,3597.264134582023,129877.40670886799,1485,18,381.7647058823529,30,4,17,38.37868859766427,0.5965277777777778,48.72311827956989,1005.1075268817198,33.50358422939066,0
2178,4,0,0,34,0.0,0.0,1.0,34,1050,900,150,0.8571428571428571,12,9,3,409.2081147034489,0.40899806892453955,0.04467161621930327,0.2120142646602377,126469.13528442392,3550.4392835829126,130019.57456800682,1486,19,382.7647058823529,31,3,17,38.245010787486535,0.595766129032258,48.53515625000001,1005.8593750000007,32.447076612903246,0
2179,4,2,0,36,0.05555555555555555,0.0,1.0,36,650,400,250,0.6153846153846154,9,4,5,400.3286335704363,0.4173445767195767,0.08141426783479377,0.21126986672574538,127219.36058820527,2987.4406750549324,130206.8012632602,1487,0,362.44444444444446,32,4,19,37.693731748018365,0.6009114583333333,47.79040404040404,1008.8383838383837,31.52619949494949,0
2180,4,3,1,38,0.07692307692307693,0.02564102564102564,0.9743589743589743,39,850,400,450,0.47058823529411764,13,4,9,379.8822235904189,0.4262539361223572,0.11597709492701047,0.20577368677578015,128268.64216887743,1952.099117264896,130220.74128614232,1488,0,335.4871794871795,33,6,18,37.13202677635294,0.6092171717171717,46.75245098039216,1012.990196078432,30.696672608437332,0
2181,4,0,0,38,0.0,0.0,1.0,38,900,600,300,0.6666666666666666,12,6,6,388.67994845240423,0.4213637980085348,0.12374724617010702,0.2105392171630126,128268.64216887731,2371.0898452518204,130639.73201412913,1489,1,345.2894736842105,33,5,19,36.90922655052827,0.6092171717171717,46.752450980392155,1012.990196078431,30.696672608437304,0
2182,4,3,0,41,0.07317073170731707,0.0,1.0,41,1150,800,350,0.6956521739130435,15,8,7,363.24921080093924,0.4302337398373984,0.14394756111070572,0.20129224222836573,129172.76810171655,1184.3812139842498,130357.1493157008,1490,0,320.9512195121951,36,5,19,36.62992503969573,0.6119791666666667,45.861486486486484,1016.5540540540537,28.237612612612605,0
2183,4,2,3,40,0.046511627906976744,0.06976744186046512,0.9302325581395349,43,1100,700,400,0.6363636363636364,15,7,8,347.57814592368436,0.4349160206718346,0.13913383276175018,0.1952914228587358,129717.1051964125,417.3725245515662,130134.47772096407,1491,0,306.9767441860465,36,7,15,36.474684943621504,0.6174768518518519,45.32657657657657,1018.6936936936927,28.29704704704702,0
2184,4,1,0,41,0.024390243902439025,0.0,1.0,41,1200,900,300,0.75,15,9,6,364.3171591176832,0.42873475609756095,0.1462582675855184,0.2036979920178017,129525.18332315233,1237.6493644975874,130762.83268764992,1492,0,322.9024390243902,35,6,16,36.243722759143445,0.6175595238095238,45.51504629629629,1017.9398148148141,29.083994708994688,0
2185,4,1,0,42,0.023809523809523808,0.0,1.0,42,1400,1200,200,0.8571428571428571,16,12,4,362.1280805789011,0.4299990321331785,0.15503943263306907,0.20421316244982143,129860.54202428782,1005.2297652382172,130865.77178952603,1493,0,316.1904761904762,36,6,17,35.95827348727582,0.6189236111111112,45.185810810810814,1019.2567567567569,28.312687687687692,0
2186,4,1,1,42,0.023255813953488372,0.023255813953488372,0.9767441860465116,43,1000,600,400,0.6,14,6,8,360.01665972511444,0.4303248431155408,0.15738016136687172,0.2051257712387281,130262.58680555565,779.3402777777878,131041.92708333343,1494,0,309.8139534883721,37,6,19,35.60374149659865,0.6210585585585586,44.79166666666667,1020.8333333333342,27.59009009009011,0
2187,4,1,2,41,0.023255813953488372,0.046511627906976744,0.9534883720930233,43,1100,600,500,0.5454545454545454,16,6,10,352.1693335821033,0.4315014765596161,0.1590016189019905,0.20254624904293334,130626.6245984342,600.5382665820324,131227.16286501623,1495,0,308.3953488372093,37,6,16,35.43510225606922,0.6247184684684685,44.43530701754386,1022.258771929825,27.628615457562837,0
2188,4,0,0,41,0.0,0.0,1.0,41,1650,1300,350,0.7878787878787878,20,13,7,364.4029297901279,0.42746443089430897,0.15231052378504728,0.2085745952222871,130439.87509645053,1306.5345293209762,131746.4096257715,1496,2,324.2682926829268,35,6,20,35.31186267845004,0.6267857142857143,44.61805555555555,1021.527777777777,29.186507936507915,0
2189,4,0,0,41,0.0,0.0,1.0,41,750,400,350,0.5333333333333333,11,4,7,364.8831790763173,0.42710873983739833,0.15070665584328302,0.20928887275211805,130521.3723013556,1325.0106525444594,131846.38295390006,1497,3,325.2682926829268,36,5,16,35.21692013812358,0.6255787037037037,44.5382882882883,1021.8468468468484,28.38463463463468,0
2190,4,0,0,41,0.0,0.0,1.0,41,1400,900,500,0.6428571428571429,19,9,10,365.3329117459569,0.4264989837398374,0.1528773935763137,0.21095478940804377,130780.41459956586,1355.677933000576,132136.09253256643,1498,4,326.2682926829268,36,5,17,34.94279606591068,0.6281828703703703,44.28490990990991,1022.860360360361,28.412787787787806,0
2191,4,0,0,41,0.0,0.0,1.0,41,1200,800,400,0.6666666666666666,16,8,8,361.51205729163354,0.4261686991869919,0.1487146247373321,0.2092822902385559,130878.9483302554,1262.8635734071995,132141.8119036626,1499,5,327.2682926829268,37,4,17,34.940705815116445,0.6272522522522522,44.18859649122807,1023.2456140350872,27.655286865813167,0
2192,4,0,2,39,0.0,0.04878048780487805,0.9512195121951219,41,1600,1200,400,0.75,20,12,8,359.1480580732797,0.42550813008130084,0.1584190483155632,0.20882469279503627,131047.29940943352,1213.0766197291273,132260.37602916264,1500,6,328.2682926829268,37,4,17,34.83079888627114,0.6289414414414414,44.024122807017534,1023.9035087719286,27.67306780464672,0
2193,4,0,0,39,0.0,0.0,1.0,39,1750,1400,350,0.8,21,14,7,371.336894110164,0.4219523166891588,0.15471622597513335,0.21499603672743686,130883.62328800157,1920.38363233025,132804.00692033183,1501,7,345.71794871794873,35,4,18,34.68463691890057,0.63125,44.18402777777778,1023.2638888888891,29.236111111111118,0
2194,4,0,0,39,0.0,0.0,1.0,39,1100,700,400,0.6363636363636364,15,7,8,369.24584414116435,0.42102451641925326,0.1511111862992227,0.2149757814737357,131097.37059694837,1881.4318541514608,132978.80245109982,1502,8,346.71794871794873,36,3,18,34.52161681694892,0.6313657407407407,43.97522522522523,1024.0990990990997,28.447197197197212,0
2195,4,0,0,39,0.0,0.0,1.0,39,650,400,250,0.6153846153846154,9,4,5,367.1983561218231,0.42102451641925326,0.15017549794899998,0.21394420556873692,131126.2038009294,1829.8652960392897,132956.06909696868,1503,9,347.71794871794873,36,3,18,34.54485065054059,0.6316550925925926,43.947072072072075,1024.2117117117123,28.45032532532534,0
2196,4,0,0,39,0.0,0.0,1.0,39,1350,1000,350,0.7407407407407407,17,10,7,369.9372568095502,0.4206027890238417,0.15508621224163166,0.2160262620316615,131212.72243527303,1908.0949192435596,133120.8173545166,1504,10,348.71794871794873,36,3,18,34.3871363669671,0.6325231481481481,43.86261261261261,1024.5495495495488,28.45970970970969,0
2197,4,1,0,40,0.025,0.0,1.0,40,1250,700,550,0.56,18,7,11,369.1424145853484,0.42191506410256413,0.1700592885375496,0.21829072286376802,131693.64762474992,1722.742213950445,133416.38983870036,1505,0,340.975,37,3,18,33.92121123099383,0.6354166666666667,43.39364035087719,1026.4254385964912,27.74122807017544,0
2198,4,0,0,40,0.0,0.0,1.0,40,750,400,350,0.5333333333333333,11,4,7,370.9291097141851,0.4219551282051282,0.17106921597949176,0.21950937579925411,131721.7857898584,1771.8889465989528,133493.67473645735,1506,1,341.975,37,3,18,33.84693441572312,0.6356981981981982,43.36622807017544,1026.5350877192982,27.744191559981033,0
2199,4,0,0,40,0.0,0.0,1.0,40,850,500,350,0.5882352941176471,12,5,7,373.46378713757304,0.42183493589743587,0.16861054766734296,0.22182849043231753,131862.52170138896,1849.1753472222335,133711.69704861118,1507,2,342.975,37,3,18,33.63970588235295,0.6371058558558558,43.22916666666667,1027.083333333334,27.759009009009027,0
2200,4,0,0,40,0.0,0.0,1.0,40,1450,900,550,0.6206896551724138,20,9,11,372.52321428414916,0.420980235042735,0.17527205803904855,0.22225716661268818,132031.5039843991,1836.9600502077647,133868.46403460688,1508,3,343.975,37,3,18,33.49325633913012,0.638795045045045,43.064692982456144,1027.741228070176,27.776789947842595,0
2201,4,0,0,40,0.0,0.0,1.0,40,1400,1100,300,0.7857142857142857,17,11,6,372.5909736863563,0.42072649572649573,0.1805247440273039,0.22279419446959678,132116.03570329328,1845.0484764542934,133961.0841797476,1509,4,344.975,37,3,18,33.40621444823664,0.6396396396396397,42.98245614035088,1028.0701754385964,27.78568041725936,0
2202,4,0,0,40,0.0,0.0,1.0,40,1600,900,700,0.5625,23,9,14,371.12624141321726,0.41965811965811967,0.18210327187466713,0.22307991820501094,132313.3815813521,1820.9935989920118,134134.3751803441,1510,5,345.975,37,3,19,33.244853280755976,0.6416103603603603,42.7905701754386,1028.8377192982466,27.806424845898558,0
2203,4,0,0,40,0.0,0.0,1.0,40,1000,700,300,0.7,13,7,6,367.3782177101014,0.4193643162393162,0.17918112421929244,0.22150293377416566,132428.63520408154,1730.3603497897213,134158.99555387127,1511,6,346.975,34,6,19,33.22514264785257,0.6488970588235294,42.67857142857142,1029.2857142857135,30.27310924369746,0
2204,4,0,2,38,0.0,0.05,0.95,40,950,500,450,0.5263157894736842,14,5,9,364.1520237047774,0.4191105769230769,0.1735161870503601,0.22007448389114798,132517.14677640592,1651.2774348422404,134168.42421124817,1512,7,347.975,35,5,19,33.21904976019186,0.6476190476190475,42.59259259259259,1029.6296296296289,29.417989417989396,0
2205,4,1,0,39,0.02564102564102564,0.0,1.0,39,1100,700,400,0.6363636363636364,15,7,8,360.57545148454255,0.4199561403508772,0.19922299922299946,0.22035166479610915,132934.57031249988,1786.5885416666526,134721.15885416654,1513,0,340.79487179487177,35,4,18,32.89141414141414,0.6517857142857143,42.18749999999999,1031.249999999999,29.464285714285687,0
2206,4,0,0,39,0.0,0.0,1.0,39,1250,900,350,0.72,16,9,7,363.8981274139047,0.4185222672064777,0.21277306812044383,0.21028759978935324,130810.03578514738,1819.0467332766411,132629.08251842402,1514,1,341.79487179487177,34,5,17,34.949474378369985,0.6326593137254901,44.25595238095238,1022.9761904761904,30.0875350140056,8
2207,4,0,0,39,0.0,0.0,1.0,39,1500,1200,300,0.8,18,12,6,362.52068877273985,0.4182411156095367,0.20979020979021046,0.21037617923268406,130972.46334876512,1696.0455246913266,132668.50887345645,1515,2,342.79487179487177,35,4,17,34.82021709633651,0.6321428571428571,44.09722222222221,1023.6111111111086,29.246031746031672,0
2208,4,0,0,39,0.0,0.0,1.0,39,1150,900,250,0.782608695652174,14,9,5,365.7716090762536,0.41832546108861896,0.2141466128807903,0.212917578757019,131090.9636488339,1789.8705418381192,132880.834190672,1516,3,343.79487179487177,35,4,18,34.61705093429776,0.6333333333333333,43.981481481481474,1024.074074074073,29.259259259259228,0
2209,4,0,0,39,0.0,0.0,1.0,39,1300,800,500,0.6153846153846154,18,8,10,369.6970316364625,0.41795996401259555,0.2143210906342048,0.21603483967508913,131239.1643759644,1903.745900848754,133142.91027681317,1517,4,344.79487179487177,35,4,18,34.36652829549304,0.6348214285714286,43.83680555555555,1024.652777777777,29.275793650793627,0
2210,4,0,0,39,0.0,0.0,1.0,39,1350,1000,350,0.7407407407407407,17,10,7,372.0834447691131,0.41734143049932526,0.21551700361309511,0.21847173209706489,131422.3514543687,1980.0765313955346,133402.42798576425,1518,5,345.79487179487177,33,6,18,34.12003007848293,0.6410984848484849,43.65808823529413,1025.3676470588252,31.071746880570462,0
2211,4,0,0,39,0.0,0.0,1.0,39,1150,800,350,0.6956521739130435,15,8,7,370.0657888871754,0.4173133153396311,0.21628127038374245,0.21836228684653455,131610.9057363757,1940.938731497534,133551.84446787322,1519,6,346.79487179487177,33,6,17,33.981124845734314,0.6429924242424243,43.47426470588237,1026.1029411764728,31.094028520499176,0
2212,4,0,0,39,0.0,0.0,1.0,39,750,300,450,0.4,12,3,9,371.3958743268846,0.4166666666666667,0.22186711728259012,0.2196901019323438,131705.23356401396,1982.9560745867132,133688.18963860068,1520,7,347.79487179487177,33,6,17,33.85167940146451,0.6439393939393939,43.38235294117648,1026.470588235295,31.105169340463487,0
2213,4,1,0,40,0.025,0.0,1.0,40,950,400,550,0.42105263157894735,15,4,11,363.2823882553112,0.41971153846153847,0.21681490655257818,0.2171382350258195,132100.37964034654,1597.9482810356908,133698.32792138224,1521,0,340.075,35,5,18,33.661243713878264,0.6434523809523809,42.9976851851852,1028.0092592592607,29.371693121693163,0
2214,4,0,0,40,0.0,0.0,1.0,40,1000,700,300,0.7,13,7,6,366.0637715360123,0.41931089743589745,0.21753882511816292,0.2194900589655202,132219.38898533973,1680.1456404321234,133899.53462577186,1522,1,341.075,35,5,18,33.469783929777186,0.6446428571428571,42.88194444444446,1028.472222222224,29.384920634920686,0
2215,4,0,0,40,0.0,0.0,1.0,40,1400,1300,100,0.9285714285714286,15,13,2,367.55536161876597,0.4191639957264957,0.21787161021717116,0.2205580350240362,132249.14969403733,1721.776807913252,133970.9265019506,1523,2,342.075,35,5,18,33.40143374217021,0.6449404761904762,42.85300925925927,1028.587962962964,29.38822751322754,0
2216,4,0,1,39,0.0,0.025,0.975,40,1250,800,450,0.64,17,8,9,367.3783184301064,0.4186965811965812,0.21886951631046148,0.2209738329393535,132338.45191400885,1723.655585562411,134062.10749957126,1524,3,343.075,35,5,19,33.315991751031135,0.6458333333333333,42.7662037037037,1028.9351851851848,29.398148148148135,0
2217,4,0,0,39,0.0,0.0,1.0,39,1000,600,400,0.6,14,6,8,370.3729362429026,0.4175663517768781,0.22999528515892576,0.22349021491223853,132459.27047902485,2011.8791839009155,134471.14966292577,1525,4,350.46153846153845,34,5,19,33.1172179175822,0.649203431372549,42.64880952380952,1029.4047619047612,30.276610644257683,0
2218,4,0,0,39,0.0,0.0,1.0,39,850,600,250,0.7058823529411765,11,6,5,368.81966054399345,0.4177631578947369,0.226373711057563,0.22327913809419758,132581.84700963704,1979.7583616779905,134561.60537131503,1526,5,351.46153846153845,34,5,19,33.03375332331522,0.6504289215686274,42.5297619047619,1029.8809523809514,30.29061624649857,0
2219,4,0,0,39,0.0,0.0,1.0,39,950,700,250,0.7368421052631579,12,7,5,368.05536573949104,0.4170602789023841,0.22739821792502024,0.22372803692703896,132735.1473922902,1970.7766439909265,134705.92403628113,1527,6,352.46153846153845,34,5,16,32.89914510166358,0.6519607843137255,42.38095238095238,1030.4761904761904,30.308123249299715,0
2220,4,0,0,39,0.0,0.0,1.0,39,900,600,300,0.6666666666666666,12,6,6,365.3296134238616,0.41649797570850206,0.22921738306353734,0.22243486589478154,132796.49234693873,1902.8982426303803,134699.3905895691,1528,7,353.46153846153845,34,5,16,32.90766728266728,0.6525735294117647,42.32142857142857,1030.7142857142853,30.315126050420158,0
2221,4,0,0,39,0.0,0.0,1.0,39,900,300,600,0.3333333333333333,15,3,12,366.81485313805075,0.4168915879442195,0.22937762776099957,0.22370539635038875,132857.85147392287,1946.8466553287922,134804.69812925166,1529,8,354.46153846153845,34,5,16,32.80768860662046,0.6531862745098039,42.26190476190476,1030.9523809523807,30.32212885154061,0
2222,4,0,0,39,0.0,0.0,1.0,39,850,400,450,0.47058823529411764,13,4,9,367.17258622994154,0.4168915879442195,0.22547409110955208,0.22447537858221492,132949.9167375284,1963.1129535147463,134913.02969104314,1530,9,355.46153846153845,34,5,16,32.70590442110125,0.6541053921568627,42.17261904761905,1031.3095238095243,30.332633053221304,0
2223,4,0,0,39,0.0,0.0,1.0,39,1350,1100,250,0.8148148148148148,16,11,5,366.8006316442042,0.4159356725146199,0.21713542128767105,0.22554336711739364,133164.85969387752,1968.9909297052182,135133.85062358272,1531,10,356.46153846153845,34,5,17,32.499519415609385,0.65625,41.964285714285715,1032.1428571428569,30.35714285714285,0
2224,4,0,1,38,0.0,0.02564102564102564,0.9743589743589743,39,950,600,350,0.631578947368421,13,6,7,366.8701033990153,0.41545771479982,0.21510316425570664,0.22614530254297532,133257.03125000012,1977.6041666666813,135234.6354166668,1532,11,357.46153846153845,34,5,18,32.4051654560129,0.6571691176470589,41.87500000000001,1032.500000000001,30.367647058823557,0
2225,4,0,0,38,0.0,0.0,1.0,38,1250,900,350,0.72,16,9,7,378.4301702048978,0.409880275011854,0.22189286272060005,0.23323146920089682,133250.70473195383,2485.2173743271546,135735.92210628098,1533,20,367.57894736842104,33,5,18,32.113130563798215,0.6594065656565656,41.88112745098038,1032.4754901960766,31.287136066547777,0
2226,4,0,0,38,0.0,0.0,1.0,38,1250,1100,150,0.88,14,11,3,408.40043961952153,0.4091838549075391,0.2488020521367742,0.23250064463973363,130230.36552392639,3037.411680068561,133267.77720399495,1534,21,368.57894736842104,32,6,18,34.40180191324427,0.6315104166666667,44.82323232323234,1020.7070707070728,31.897095959596026,8
2227,4,0,0,38,0.0,0.0,1.0,38,1250,900,350,0.72,16,9,7,403.949472918577,0.4100729018492177,0.24356989023430087,0.23092206971295948,130391.51178770058,2934.316491939643,133325.82827964023,1535,22,369.57894736842104,32,6,19,34.35117649482838,0.6331380208333333,44.66540404040406,1021.3383838383867,31.916824494949584,0
2228,4,0,0,38,0.0,0.0,1.0,38,1050,700,350,0.6666666666666666,14,7,7,402.24178357963274,0.41016180654338547,0.2424212867231086,0.23090390044635128,130552.75769054201,2902.754820936669,133455.51251147868,1536,23,370.57894736842104,32,6,14,34.23060291574005,0.634765625,44.50757575757577,1021.9696969696989,31.93655303030309,0
2229,4,0,1,37,0.0,0.02631578947368421,0.9736842105263158,38,850,500,350,0.5882352941176471,12,5,7,402.24178357963274,0.41016180654338547,0.2424212867231086,0.23090390044635128,130552.75769054201,2902.754820936669,133455.51251147868,1537,24,371.57894736842104,32,6,14,34.23060291574005,0.634765625,44.50757575757577,1021.9696969696989,31.93655303030309,0
2230,4,0,0,37,0.0,0.0,1.0,37,850,500,350,0.5882352941176471,12,5,7,406.47078231159503,0.40953453453453453,0.23361791032820922,0.23411098116353488,130681.82615294374,3223.668822058996,133905.49497500274,1538,25,372.8918918918919,32,5,15,33.991160368815336,0.6360677083333333,44.38131313131314,1022.4747474747488,31.9523358585859,0
2231,4,0,0,37,0.0,0.0,1.0,37,1250,900,350,0.72,16,9,7,408.3539094650201,0.409034034034034,0.2395595595595592,0.23558879392212742,130746.38429752094,3278.1594352617412,134024.54373278268,1539,26,373.8918918918919,32,5,15,33.87731481481481,0.63671875,44.318181818181834,1022.727272727275,31.960227272727344,0
2232,4,1,0,38,0.02631578947368421,0.0,1.0,38,1300,900,400,0.6923076923076923,17,9,8,399.8922729091075,0.41193990042674256,0.235078270181738,0.23250521504214317,131045.64838343445,2880.8284373798774,133926.47682081434,1540,0,365.0263157894737,33,5,17,33.789522242170364,0.6373106060606061,44.02573529411766,1023.897058823531,31.02718360071306,0
2233,4,0,1,37,0.0,0.02631578947368421,0.9736842105263158,38,1150,900,250,0.782608695652174,14,9,5,383.30729783457366,0.4120139876718824,0.21271572078646828,0.21959567623606896,130475.34722222229,2522.730590397931,132998.07781262023,1541,1,366.0263157894737,34,4,17,34.79302610114192,0.6292892156862745,44.583333333333336,1021.6666666666672,30.049019607843153,8
2234,4,0,0,37,0.0,0.0,1.0,37,700,500,200,0.7142857142857143,9,5,4,392.27099413040474,0.4092217217217217,0.22398640541189185,0.22422403738565125,130387.7189662631,2829.4640282583823,133217.18299452148,1542,29,376.8918918918919,33,4,17,34.65322774178067,0.6306818181818181,44.66911764705883,1021.3235294117658,30.9491978609626,0
2235,4,0,0,37,0.0,0.0,1.0,37,750,600,150,0.8,9,6,3,391.7117519969579,0.40919044044044045,0.22756121436860255,0.2246281009732213,130512.91120001933,2824.6882208766015,133337.59942089592,1543,30,377.8918918918919,33,4,16,34.54015751179341,0.6319444444444444,44.54656862745099,1021.8137254901969,30.964052287581726,0
2236,4,0,0,37,0.0,0.0,1.0,37,650,200,450,0.3076923076923077,11,2,9,392.43344630313305,0.4086586586586587,0.22957905753733576,0.22558837874668747,130606.8447982748,2850.898842993092,133457.7436412679,1544,31,378.8918918918919,33,4,16,34.426202893338136,0.6328914141414141,44.454656862745104,1022.1813725490205,30.975193107546076,0
2237,4,0,0,37,0.0,0.0,1.0,37,600,300,300,0.5,9,3,6,391.8671888254356,0.4091591591591592,0.23070319510448933,0.2256278782864466,130669.48596993952,2841.016826460987,133510.5027964005,1545,32,379.8918918918919,33,4,17,34.37699768268808,0.6335227272727273,44.39338235294118,1022.4264705882359,30.982620320855634,0
2238,4,0,0,37,0.0,0.0,1.0,37,950,700,250,0.7368421052631579,12,7,5,392.7689150449622,0.4089401901901902,0.22787417179940572,0.22669774308196786,130763.4758866782,2871.9657103037366,133635.44159698195,1546,33,380.8918918918919,33,4,17,34.2584271906702,0.634469696969697,44.3014705882353,1022.7941176470589,30.993761140819966,0
2239,4,0,0,37,0.0,0.0,1.0,37,1400,1200,200,0.8571428571428571,16,12,4,390.5937469967527,0.40853353353353355,0.22284591454551905,0.2259921825139216,130857.49959450697,2822.424217848909,133679.92381235588,1547,34,381.8918918918919,33,4,17,34.2185441370224,0.6354166666666667,44.20955882352941,1023.1617647058828,31.004901960784327,0
2240,4,1,0,38,0.02631578947368421,0.0,1.0,38,750,600,150,0.8,9,6,3,382.25211954321657,0.41231033665244193,0.21830942842288747,0.22300199923182226,131175.63952664402,2428.433248299325,133604.07277494334,1548,0,372.8157894736842,34,4,19,34.109287236103036,0.6363357843137255,43.898809523809526,1024.4047619047622,30.1295518207283,0
2241,4,0,0,38,0.0,0.0,1.0,38,1000,700,300,0.7,13,7,6,382.57005312709543,0.41173245614035087,0.21724568337840644,0.22390335891873295,131298.46810967507,2446.1723840449213,133744.64049371998,1549,1,373.8157894736842,35,3,19,33.97668454733672,0.6354166666666667,43.77893518518518,1024.8842592592591,29.282407407407405,0
2242,4,0,0,38,0.0,0.0,1.0,38,1250,800,450,0.64,17,8,9,384.6331027025146,0.41205844001896635,0.22249375680146954,0.22584036282890818,131422.35145436856,2509.884058830364,133932.23551319892,1550,2,374.8157894736842,33,5,19,33.79832974781881,0.6410984848484849,43.65808823529412,1025.367647058824,31.071746880570426,0
2243,4,0,0,38,0.0,0.0,1.0,38,1250,1100,150,0.88,14,11,3,384.58178575758336,0.4112138454243717,0.22496976951545689,0.2266980731640802,131572.2859977324,2520.0609410430793,134092.34693877547,1551,3,375.8157894736842,34,4,16,33.64783979268198,0.6403186274509804,43.51190476190476,1025.9523809523807,30.1750700280112,0
2244,4,0,0,38,0.0,0.0,1.0,38,1100,600,500,0.5454545454545454,16,6,10,382.5264030432268,0.41119902797534374,0.22073700083639092,0.2260287951086812,131663.90483276648,2472.9839852607784,134136.88881802725,1552,4,376.8157894736842,34,4,16,33.607856783822456,0.6412377450980392,43.42261904761905,1026.309523809524,30.185574229691884,0
2245,4,0,0,38,0.0,0.0,1.0,38,1250,800,450,0.64,17,8,9,382.3631725417438,0.41111012328117597,0.21842959671907014,0.22647664835164838,131755.55555555562,2475.69444444445,134231.25000000006,1553,5,377.8157894736842,34,4,17,33.519345238095234,0.642156862745098,43.333333333333336,1026.6666666666672,30.196078431372566,0
2246,4,0,0,38,0.0,0.0,1.0,38,1250,900,350,0.72,16,9,7,382.1130091692552,0.4110212185870081,0.217191436920805,0.22687466827963965,131847.23816609982,2476.108985260774,134323.3471513606,1554,6,378.8157894736842,34,4,17,33.43306866040725,0.6430759803921569,43.24404761904762,1027.0238095238099,30.20658263305323,0
2247,4,0,1,37,0.0,0.02631578947368421,0.9736842105263158,38,1500,1100,400,0.7333333333333333,19,11,8,381.1922406629276,0.4102655286865813,0.21643929141826046,0.22760814701823756,132061.2882653061,2468.147675736959,134529.43594104305,1555,7,379.8157894736842,34,4,17,33.240435101536576,0.6452205882352942,43.035714285714285,1027.8571428571427,30.231092436974784,0
2248,4,1,0,38,0.02631578947368421,0.0,1.0,38,1050,800,250,0.7619047619047619,13,8,5,361.3601107937003,0.40891714082503555,0.14153627311522055,0.20734727212921944,130536.16780045354,1842.0386904761951,132378.20649092973,1556,0,380.60526315789474,34,4,15,35.29191907424668,0.6299019607843137,44.523809523809526,1021.904761904762,30.05602240896359,8
2249,4,0,0,38,0.0,0.0,1.0,38,700,400,300,0.5714285714285714,10,4,6,361.6817538412169,0.4094209340919867,0.1418784293290003,0.20769483991483925,130566.58340419499,1844.7101757369514,132411.29357993192,1557,1,381.60526315789474,34,4,15,35.25286352164626,0.6302083333333333,44.49404761904761,1022.0238095238093,30.059523809523803,0
2250,4,0,0,38,0.0,0.0,1.0,38,1050,900,150,0.8571428571428571,12,9,3,360.51204596807304,0.4087393314366998,0.13765594652240742,0.20761169583324354,130676.44702717755,1822.0866555212529,132498.5336826988,1558,2,382.60526315789474,35,3,16,35.17140215832767,0.6291666666666667,44.38657407407407,1022.453703703703,29.212962962962944,0
2251,4,1,1,38,0.02564102564102564,0.02564102564102564,0.9743589743589743,39,1050,800,250,0.7619047619047619,13,8,5,350.4228559488945,0.41028452541610433,0.13564674996545678,0.20386404537065253,131068.54056336741,1385.8824618537474,132454.42302522116,1559,0,373.7692307692308,36,3,18,35.03267165218666,0.6310763888888888,44.00337837837838,1023.9864864864865,28.44406906906907,0
2252,4,1,0,39,0.02564102564102564,0.0,1.0,39,1050,700,350,0.6666666666666666,14,7,7,348.0593183030359,0.4127024291497976,0.12680715830055478,0.2043378065504703,131417.11576485337,1348.7039501142435,132765.81971496763,1560,0,361.7435897435897,35,4,19,34.74115306467998,0.6366071428571429,43.66319444444444,1025.3472222222222,29.29563492063492,0
2253,4,0,0,39,0.0,0.0,1.0,39,700,400,300,0.5714285714285714,10,4,6,349.3716895837329,0.411240440845704,0.122192303471794,0.2063398708474764,131645.74361100973,1398.6591743770837,133044.4027853868,1561,1,362.7435897435897,36,3,14,34.47684626357948,0.6368634259259259,43.44031531531532,1026.2387387387394,28.50663163163165,0
2254,4,0,1,38,0.0,0.02564102564102564,0.9743589743589743,39,1200,1000,200,0.8333333333333334,14,10,4,349.3108472130741,0.41065002249212773,0.11383760308727409,0.20677387553210289,131732.4334469605,1403.113586559535,133135.54703352004,1562,2,363.7435897435897,36,3,14,34.390997513529314,0.6377314814814814,43.35585585585586,1026.5765765765768,28.516016016016025,0
2255,4,0,0,38,0.0,0.0,1.0,38,1100,700,400,0.6363636363636364,15,7,8,356.8640523880913,0.40647226173541967,0.11342562361238118,0.21064957979179888,131624.87809713653,1794.4374785665389,133419.31557570308,1563,4,374.2631578947368,35,3,14,34.305680878261526,0.6386904761904761,43.46064814814815,1026.1574074074078,29.31878306878308,0
2256,4,0,0,38,0.0,0.0,1.0,38,1100,800,300,0.7272727272727273,14,8,6,356.958385635923,0.40625,0.11798952794952133,0.21146131266034515,131761.33639974444,1806.6627860969202,133567.99918584136,1564,5,375.2631578947368,36,2,14,34.165569814632015,0.6380208333333333,43.32770270270271,1026.68918918919,28.519144144144168,0
2257,4,0,1,37,0.0,0.02631578947368421,0.9736842105263158,38,1200,700,500,0.5833333333333334,17,7,10,355.5383836829529,0.4059091986723566,0.12340988940618547,0.21158360563206682,131934.82069485047,1781.5785802694847,133716.39927511994,1565,6,376.2631578947368,36,2,14,34.02709269611605,0.6397569444444444,43.1587837837838,1027.3648648648666,28.53791291291296,0
2258,4,0,0,37,0.0,0.0,1.0,37,1200,800,400,0.6666666666666666,16,8,8,363.7996905375917,0.40224599599599603,0.12650780357822633,0.21625735120704123,131892.2422223294,2196.4713809585037,134088.7136032879,1566,10,387.27027027027026,35,2,15,33.85786384976526,0.6413690476190477,43.20023148148148,1027.1990740740741,29.348544973544975,0
2259,4,0,0,37,0.0,0.0,1.0,37,900,800,100,0.8888888888888888,10,8,2,367.4214755295837,0.40277777777777773,0.1313367421475531,0.21926765475152574,132040.8950617284,2302.9320987654355,134343.82716049382,1567,11,388.27027027027026,35,2,15,33.61486486486488,0.6428571428571428,43.05555555555556,1027.7777777777778,29.365079365079367,0
2260,4,0,0,37,0.0,0.0,1.0,37,1300,800,500,0.6153846153846154,18,8,10,401.45187868759126,0.40168293293293295,0.2267038433509707,0.22092803388420384,128898.98667800477,2996.60887503152,131895.59555303628,1568,12,389.27027027027026,34,3,14,35.93933177022275,0.6133578431372548,46.130952380952394,1015.4761904761924,29.86694677871154,8
2261,4,0,0,37,0.0,0.0,1.0,37,950,400,550,0.42105263157894735,15,4,11,402.4396493074832,0.40090090090090086,0.23381196992633568,0.22214876889974547,129019.90504535165,2984.5450680272343,132004.4501133789,1569,13,390.27027027027026,34,3,14,35.790416764315296,0.6145833333333333,46.01190476190477,1015.9523809523823,29.880952380952422,0
2262,4,0,0,37,0.0,0.0,1.0,37,1350,1100,250,0.8148148148148148,16,11,5,401.1424530520689,0.40137012012012013,0.23343221398744385,0.22194122629329344,129110.63102324284,2958.3510487528556,132068.9820719957,1570,14,391.27027027027026,34,3,14,35.73049666159071,0.6155024509803921,45.92261904761906,1016.3095238095256,29.891456582633104,0
2263,4,0,0,37,0.0,0.0,1.0,37,1100,800,300,0.7272727272727273,14,8,6,400.4299919376508,0.4002127127127127,0.23238812583074875,0.22205663189269767,129201.38888888915,2947.2222222222563,132148.61111111142,1571,15,392.27027027027026,35,2,14,35.65573770491804,0.6142857142857143,45.83333333333335,1016.6666666666688,29.047619047619108,0
2264,4,0,0,37,0.0,0.0,1.0,37,1450,1100,350,0.7586206896551724,18,11,7,397.0955841098823,0.4003378378378379,0.22172974237543164,0.2217354767181835,129473.85381235849,2882.69912131522,132356.5529336737,1572,16,393.27027027027026,34,3,14,35.46199360548992,0.6191789215686274,45.565476190476204,1017.738095238097,29.933473389355793,0
2265,4,0,0,37,0.0,0.0,1.0,37,1400,1000,400,0.7142857142857143,18,10,8,403.214585380046,0.40027527527527523,0.18935568011543435,0.22063539671919324,128672.41753472193,2978.9142219387413,131651.33175666066,1573,17,394.27027027027026,35,2,14,36.12679671457906,0.6089285714285715,46.35416666666665,1014.583333333331,28.98809523809517,7
2266,4,1,0,38,0.02631578947368421,0.0,1.0,38,800,500,300,0.625,11,5,6,393.30723969017856,0.403256875296349,0.18624087655120602,0.21700456325658074,129001.10995708525,2547.4140948380623,131548.5240519233,1574,0,384.86842105263156,36,2,16,36.04159738388207,0.6102430555555556,46.030405405405396,1015.8783783783766,28.218843843843796,0
2267,4,1,0,39,0.02564102564102564,0.0,1.0,39,800,500,300,0.625,11,5,6,386.9341837250726,0.40651709401709407,0.17865528705967249,0.21504016081360783,129287.27027280646,2205.288227416595,131492.55850022307,1575,0,375.97435897435895,36,3,18,35.91102867899459,0.6131365740740741,45.74887387387387,1017.0045045045034,28.250125125125095,0
2268,4,0,0,39,0.0,0.0,1.0,39,1250,1000,250,0.8,15,10,5,384.4148270427221,0.4071637426900585,0.17908990817357417,0.2144180479727182,129430.46932067195,2150.998295592884,131581.46761626482,1576,1,376.97435897435895,36,3,14,35.82890659583887,0.6145833333333333,45.608108108108105,1017.5675675675669,28.26576576576575,0
2269,4,1,1,39,0.025,0.025,0.975,40,1600,1300,300,0.8125,19,13,6,376.16101536275534,0.41010950854700856,0.17694106893214312,0.21263959160232615,129954.95158366051,1776.7973078255004,131731.748891486,1577,0,368.525,37,3,17,35.50460174929204,0.6179617117117118,45.09320175438597,1019.6271929824574,27.557491702228578,0
2270,4,1,0,40,0.025,0.0,1.0,40,700,600,100,0.8571428571428571,8,6,2,378.8910001284113,0.41048344017094013,0.18539899465912657,0.2149750540835533,130099.04308431958,1858.6713099934323,131957.71439431302,1578,0,369.45,38,2,19,35.28838098230181,0.6175986842105263,44.95192307692308,1020.1923076923082,26.84716599190285,0
2271,4,0,0,40,0.0,0.0,1.0,40,1200,1000,200,0.8333333333333334,14,10,4,377.5308215538313,0.4096688034188034,0.1766323024054981,0.21541464523953915,130318.55955678681,1839.9572991052464,132158.51685589206,1579,1,370.45,37,3,19,35.099871134020624,0.6216216216216216,44.736842105263165,1021.0526315789483,27.596017069701304,0
2272,4,0,1,39,0.0,0.025,0.975,40,1050,500,550,0.47619047619047616,16,5,11,377.3443887729609,0.40997596153846155,0.17991477569800285,0.2162099694329436,130480.80490037634,1847.239914347304,132328.04481472366,1580,2,371.45,38,2,19,34.939785283558166,0.6214364035087719,44.57799145299146,1021.6880341880352,26.88652721547461,0
2273,4,0,0,39,0.0,0.0,1.0,39,1450,900,550,0.6206896551724138,20,9,11,387.89625891064475,0.4089631129104813,0.1746010784637393,0.22261041459650321,130542.57079101274,2327.3949676823786,132869.96575869512,1581,3,371.1025641025641,37,2,15,34.60747496423463,0.6238738738738738,44.51754385964913,1021.9298245614044,27.619724988146064,0
2274,4,0,0,39,0.0,0.0,1.0,39,1150,800,350,0.6956521739130435,15,8,7,384.810331735328,0.4089631129104813,0.1666804137316682,0.22180106018316895,130710.70545744867,2259.765985687931,132970.4714431366,1582,4,372.1025641025641,37,2,16,34.51551218814785,0.6255630630630631,44.35307017543861,1022.5877192982474,27.63750592697966,0
2275,4,0,1,38,0.0,0.02564102564102564,0.9743589743589743,39,1000,800,200,0.8,12,8,4,385.4721027372541,0.40893499775078723,0.166901665883336,0.2226668264046964,130794.81336805572,2283.5503472222413,133078.36371527796,1583,5,373.1025641025641,37,2,16,34.41318737270876,0.6264076576576576,44.27083333333334,1022.916666666668,27.646396396396433,0
2276,4,0,1,37,0.0,0.02631578947368421,0.9736842105263158,38,850,400,450,0.47058823529411764,13,4,9,394.16254002474454,0.40710941204362255,0.1764334310782456,0.22743228643613317,130751.61944038658,2707.478086194329,133459.0975265809,1584,6,381.86842105263156,36,2,16,34.23484181164209,0.6278935185185186,44.313063063063076,1022.7477477477498,28.409659659659717,0
2277,4,0,0,37,0.0,0.0,1.0,37,900,800,100,0.8888888888888888,10,8,2,396.5782828839915,0.4023711211211211,0.21121956956368382,0.21383038296528706,128084.27047902482,2787.101665751508,130871.37214477634,1585,8,393.02702702702703,34,3,18,36.89849660903995,0.6050857843137255,46.9345238095238,1012.2619047619038,29.772408963585406,8
2278,4,0,0,37,0.0,0.0,1.0,37,1050,900,150,0.8571428571428571,12,9,3,394.25155358888327,0.40230855855855857,0.20786697123831277,0.2132166539339242,128204.80619331053,2708.988803854859,130913.79499716539,1586,9,394.02702702702703,34,3,18,36.833637004819565,0.6063112745098039,46.81547619047618,1012.7380952380942,29.7864145658263,0
2279,4,1,0,38,0.02631578947368421,0.0,1.0,38,550,400,150,0.7272727272727273,7,4,3,384.920114971873,0.40527204836415365,0.2048402309277364,0.20984972789474649,128525.67361379007,2294.4234128514845,130820.09702664155,1587,0,384.63157894736844,35,3,14,36.74107312711638,0.6074404761904761,46.49884259259258,1014.0046296296279,28.971560846560795,0
2280,4,1,0,39,0.02564102564102564,0.0,1.0,39,700,500,200,0.7142857142857143,9,5,4,377.6279810948336,0.40811965811965817,0.20317725752508364,0.20760328521652552,128858.14868922971,1932.088507426336,130790.23719665605,1588,0,375.7435897435897,36,3,16,36.58588435374149,0.6087962962962963,46.17117117117117,1015.3153153153149,28.20320320320319,0
2281,4,0,1,38,0.0,0.02564102564102564,0.9743589743589743,39,700,500,200,0.7142857142857143,9,5,4,377.6279810948336,0.40811965811965817,0.20317725752508364,0.20760328521652552,128858.14868922971,1932.088507426336,130790.23719665605,1589,1,376.7435897435897,36,3,16,36.58588435374149,0.6087962962962963,46.17117117117117,1015.3153153153149,28.20320320320319,0
2282,4,0,0,38,0.0,0.0,1.0,38,1000,600,400,0.6,14,6,8,383.5834778121406,0.40742057847321006,0.20507949655184898,0.2103591943048564,128760.50407503826,2278.080391589468,131038.58446662773,1590,2,384.44736842105266,35,3,16,36.53459630516592,0.6098214285714285,46.26736111111109,1014.9305555555529,28.9980158730158,0
2283,4,1,0,39,0.02564102564102564,0.0,1.0,39,750,300,450,0.4,12,3,9,375.4463862896217,0.40997525865946916,0.21052571772713646,0.20790055721779885,129144.15048494424,1897.3409220030696,131041.49140694732,1591,0,375.56410256410254,36,3,18,36.349157988034584,0.6116898148148149,45.88963963963963,1016.4414414414401,28.234484484484447,0
2284,4,0,1,38,0.0,0.02564102564102564,0.9743589743589743,39,1150,700,450,0.6086956521739131,16,7,9,375.32256818357405,0.4103969860548808,0.21107987619615542,0.20843559598386668,129258.63997443387,1902.7369430240997,131161.37691745796,1592,1,376.56410256410254,36,3,18,36.23546511627905,0.6128472222222222,45.777027027027025,1016.8918918918918,28.246996996996995,0
2285,4,1,0,39,0.02564102564102564,0.0,1.0,39,1050,600,450,0.5714285714285714,15,6,9,371.47896854617653,0.4161043634727845,0.21357212371929646,0.20735364044174157,129459.11864144543,1818.267972364245,131277.38661380968,1593,0,360.94871794871796,36,3,17,36.12878536387442,0.6148726851851851,45.57995495495495,1017.6801801801796,28.26889389389388,0
2286,4,0,0,39,0.0,0.0,1.0,39,1000,600,400,0.6,14,6,8,376.40339576801546,0.41548582995951416,0.21475847753220023,0.2108698577778434,129602.41280131468,1956.5576556285805,131558.97045694327,1594,1,361.94871794871796,36,3,17,35.857433827324336,0.6163194444444444,45.43918918918918,1018.243243243242,28.2845345345345,0
2287,4,2,0,41,0.04878048780487805,0.0,1.0,41,1150,800,350,0.6956521739130435,15,8,7,364.6160877546397,0.421900406504065,0.22131703649761247,0.20789592119310774,130290.57167830484,1302.8848450004884,131593.45652330533,1595,0,345.2439024390244,37,4,19,35.457948483872116,0.6213400900900901,44.76425438596491,1020.9429824561402,27.59305357989568,0
2288,4,0,0,41,0.0,0.0,1.0,41,850,700,150,0.8235294117647058,10,7,3,365.20792001747685,0.42174796747967475,0.2240172659458548,0.20838334259820768,130318.55955678686,1318.674015081578,131637.23357186845,1596,1,346.2439024390244,37,4,19,35.41442941008019,0.6216216216216216,44.736842105263165,1021.0526315789486,27.596017069701315,0
2289,4,0,0,41,0.0,0.0,1.0,41,1100,700,400,0.6363636363636364,15,7,8,362.1083384447158,0.42228150406504067,0.217839766121666,0.20766077575177266,130514.5588666705,1252.0820108110183,131766.64087748152,1597,2,347.2439024390244,37,4,16,35.294715992416926,0.6235923423423424,44.54495614035088,1021.8201754385964,27.61676149834044,0
2290,4,1,0,42,0.023809523809523808,0.0,1.0,42,1400,900,500,0.6428571428571429,19,9,10,355.71188309118696,0.4253411730545877,0.2201187492540877,0.20569426283099054,130835.79881656794,907.9696745562038,131743.76849112415,1598,0,339.95238095238096,38,4,18,35.13275375939849,0.625,44.230769230769226,1023.0769230769222,26.9230769230769,0
2291,4,0,2,40,0.0,0.047619047619047616,0.9523809523809523,42,1150,700,450,0.6086956521739131,16,7,9,329.54811367880285,0.4245063879210221,0.14550834886072606,0.18339639175754377,129340.77222077946,125.72605763653246,129466.498278416,1599,1,340.95238095238096,37,5,18,37.315740541123205,0.6117680180180181,45.69627192982456,1017.2149122807016,27.492294926505448,8
2292,4,2,2,40,0.047619047619047616,0.047619047619047616,0.9523809523809523,42,1450,1200,250,0.8275862068965517,17,12,5,327.95336490386916,0.42938201703445605,0.14795735301655677,0.18420113421746914,129703.52055440107,107.34120113878112,129810.86175553985,1600,0,331.1190476190476,37,5,16,36.98824901327592,0.615427927927928,45.33991228070174,1018.6403508771907,27.530820293978127,0
2293,4,0,1,39,0.0,0.025,0.975,40,1200,1000,200,0.8333333333333334,14,10,4,342.2237929840063,0.4239049145299145,0.154069502900694,0.19077294636159767,129407.39300679418,857.2577749913994,130264.65078178559,1601,1,348.45,35,5,22,36.92566734918288,0.6163690476190475,45.630787037037024,1017.4768518518499,29.07076719576714,0
2294,4,0,0,39,0.0,0.0,1.0,39,1400,1100,300,0.7857142857142857,17,11,6,356.1984884237888,0.419112685560054,0.16026390763232934,0.19905209647211705,129504.1454081631,1425.8361678004364,130929.98157596352,1602,2,358.1794871794872,34,5,18,36.471734892787524,0.6194852941176471,45.53571428571428,1017.8571428571415,29.936974789915926,0
2295,4,0,1,38,0.0,0.02564102564102564,0.9743589743589743,39,850,600,250,0.7058823529411765,11,6,5,356.4750811540108,0.4184379217273954,0.16193448392676735,0.19966806608449578,129595.04145408151,1439.4805839002072,131034.52203798172,1603,3,359.1794871794872,34,5,18,36.37222806812423,0.6204044117647058,45.44642857142856,1018.2142857142846,29.947478991596608,0
2296,4,0,0,38,0.0,0.0,1.0,38,1300,900,400,0.6923076923076923,17,9,8,360.7386590907463,0.41811877667140823,0.16304715617213716,0.20236847400139868,129655.65653344653,1754.3615362811581,131410.0180697277,1604,4,366.7631578947368,34,4,18,36.20202610559127,0.6210171568627452,45.38690476190475,1018.4523809523795,29.954481792717043,0
2297,4,0,1,37,0.0,0.02631578947368421,0.9736842105263158,38,950,400,550,0.42105263157894735,15,4,11,359.3400878320888,0.4182224988146041,0.16135183681503906,0.20173975009785752,129685.96938775496,1720.273526077076,131406.24291383204,1605,5,367.7631578947368,34,4,18,36.206804191990024,0.6213235294117647,45.35714285714285,1018.5714285714273,29.957983193277272,0
2298,4,1,0,38,0.02631578947368421,0.0,1.0,38,800,500,300,0.625,11,5,6,355.5346902209207,0.41881519677572304,0.17624758838492416,0.20115654930200827,129989.29280045343,1643.1405895691466,131632.43339002258,1606,0,368.2894736842105,34,4,19,35.995505486808305,0.6243872549019608,45.0595238095238,1019.761904761904,29.99299719887953,0
2299,4,0,0,38,0.0,0.0,1.0,38,1200,700,500,0.5833333333333334,17,7,10,362.6822157434403,0.41800023707918443,0.17003222341568192,0.20664451827242533,130262.58680555562,1848.7847222222322,132111.37152777784,1607,1,369.2894736842105,34,4,20,35.535714285714285,0.6271446078431373,44.79166666666667,1020.8333333333339,30.024509803921585,0
2300,4,0,1,37,0.0,0.02631578947368421,0.9736842105263158,38,1000,300,700,0.3,17,3,14,366.2136016696674,0.4178076102418207,0.16903707157845616,0.2091464896885757,130353.74858276648,1947.4631519274449,132301.21173469393,1608,2,370.2894736842105,34,4,20,35.353034895469044,0.6280637254901961,44.702380952380956,1021.1904761904765,30.03501400560225,0
2301,4,2,0,39,0.05128205128205128,0.0,1.0,39,750,500,250,0.6666666666666666,10,5,5,350.5025885891212,0.42116509221772375,0.17343108868532586,0.20284500126883814,130866.81909950507,1373.8317709601702,132240.65087046524,1609,0,358.64102564102564,36,3,18,35.23461002274562,0.6290509259259259,44.20045045045046,1023.1981981981995,28.42217217217221,0
2302,4,1,0,40,0.025,0.0,1.0,40,1450,1100,350,0.7586206896551724,18,11,7,339.8550226545135,0.42433226495726495,0.16991761181254028,0.19876627294925414,131271.93583602642,922.6853454909162,132194.62118151734,1610,0,350.65,37,3,19,35.09790284613738,0.6311936936936937,43.80482456140351,1024.7807017543855,27.696775723091502,0
2303,4,0,0,40,0.0,0.0,1.0,40,1150,1100,50,0.9565217391304348,12,11,1,340.4631700914506,0.42363782051282056,0.16375719607179118,0.19987827858450405,131417.1157648536,948.5616133757223,132365.67737822933,1611,1,351.65,35,5,20,34.93587030138843,0.6366071428571429,43.66319444444446,1025.347222222224,29.29563492063497,0
2304,4,0,0,40,0.0,0.0,1.0,40,900,400,500,0.4444444444444444,14,4,10,339.85752940166896,0.4237980769230769,0.15636071307683674,0.20014334106890322,131535.81700370807,940.6875589420549,132476.50456265014,1612,2,352.65,35,5,20,34.831720824401074,0.6377976190476191,43.54745370370371,1025.8101851851857,29.308862433862448,0
2305,4,0,0,40,0.0,0.0,1.0,40,1200,800,400,0.6666666666666666,16,8,8,339.9933005230745,0.4237713675213675,0.15510152284263978,0.20053497066780177,131595.18771701414,948.2964409722563,132543.4841579864,1613,3,353.65,35,5,14,34.76840101522842,0.6383928571428572,43.48958333333335,1026.0416666666688,29.31547619047625,0
2306,4,0,0,40,0.0,0.0,1.0,40,950,600,350,0.631578947368421,13,6,7,341.4852389964524,0.42286324786324786,0.15439120631341585,0.20220120626826013,131743.67310742478,997.7039394719022,132741.37704689667,1614,4,354.65,35,5,14,34.58051484404359,0.6398809523809523,43.34490740740742,1026.620370370372,29.33201058201063,0
2307,4,0,0,40,0.0,0.0,1.0,40,1150,900,250,0.782608695652174,14,9,5,341.45378092483384,0.42321047008547014,0.14619675456389447,0.20281531806740158,131862.5217013891,1004.9913194444682,132867.51302083358,1615,5,355.65,35,5,14,34.461629479377955,0.6410714285714285,43.22916666666668,1027.083333333335,29.345238095238145,0
2308,4,0,0,40,0.0,0.0,1.0,40,900,300,600,0.3333333333333333,15,3,12,339.29889187469325,0.4224626068376069,0.1471333633701286,0.20216748738681403,131981.42387902958,956.23017403979,132937.65405306936,1616,6,356.65,35,5,15,34.397292933843964,0.6422619047619047,43.11342592592593,1027.546296296297,29.35846560846563,0
2309,4,0,3,37,0.0,0.075,0.925,40,1050,900,150,0.8571428571428571,12,9,3,338.20620446760245,0.42154113247863245,0.14055217831813538,0.20230880230880238,132130.12695312515,937.4457465277926,133067.57269965293,1617,7,357.65,35,5,17,34.27579365079366,0.64375,42.96875000000001,1028.1250000000011,29.375000000000032,0
2310,4,0,1,36,0.0,0.02702702702702703,0.972972972972973,37,1250,900,350,0.72,16,9,7,363.7055088055886,0.41438313313313313,0.15570717600810746,0.21478631387433006,131642.34459102273,2175.8091839677086,133818.15377499044,1618,8,386.9189189189189,33,4,17,34.11253084945468,0.6433080808080809,43.443627450980394,1026.2254901960787,31.0977421271539,0
2311,4,0,0,36,0.0,0.0,1.0,36,1200,900,300,0.75,15,9,6,362.5855344858528,0.4142195767195767,0.14007746219107342,0.21509176892585266,131813.89534550047,2358.7623393021067,134172.65768480257,1408,9,353.72222222222223,32,4,18,33.968092954629284,0.6474609375,43.27651515151515,1026.8939393939393,32.0904356060606,0
2312,4,0,1,35,0.0,0.027777777777777776,0.9722222222222222,36,850,600,250,0.7058823529411765,11,6,5,363.4997084954015,0.4138227513227513,0.13567273025237725,0.21618666873673853,131911.1570247932,2389.933425160679,134301.0904499539,1409,10,354.72222222222223,32,4,18,33.84648475909538,0.6484375,43.18181818181817,1027.272727272726,32.102272727272684,0
2313,4,0,0,35,0.0,0.0,1.0,35,800,500,300,0.625,11,5,6,372.68947027271867,0.41207983193277314,0.1402923195840069,0.2208972866077074,131781.48275686146,2822.7142000816134,134604.19695694308,1410,11,365.14285714285717,32,3,19,33.74144326938842,0.6471354166666667,43.3080808080808,1026.7676767676762,32.08648989898988,0
2314,4,1,0,36,0.027777777777777776,0.0,1.0,36,1300,1000,300,0.7692307692307693,16,10,6,363.80275627520723,0.41395502645502646,0.13769699377565914,0.217710779254564,132145.8768862936,2415.006848327552,134560.88373462117,1411,0,355.97222222222223,33,3,21,33.60200635677394,0.6483585858585859,42.95343137254901,1028.1862745098028,31.157159833630388,0
2315,4,0,0,36,0.0,0.0,1.0,36,700,600,100,0.8571428571428571,8,6,2,363.2111409354739,0.4139384920634921,0.13778982772547343,0.21753780753672794,132177.37956855522,2401.659367791218,134579.03893634645,1412,1,356.97222222222223,33,3,21,33.58546359194375,0.6486742424242424,42.92279411764705,1028.3088235294106,31.16087344028517,0
2316,4,0,0,36,0.0,0.0,1.0,36,700,400,300,0.5714285714285714,10,4,6,361.70644825044667,0.41321097883597885,0.13109231461626059,0.21717910776925953,132271.9101427335,2368.72056420607,134640.63070693958,1413,2,357.97222222222223,33,3,21,33.52890953855928,0.6496212121212122,42.830882352941174,1028.676470588235,31.172014260249544,0
2317,4,0,0,36,0.0,0.0,1.0,36,1000,800,200,0.8,12,8,4,360.1144632641488,0.4131283068783069,0.1338474058195387,0.21676567369383934,132366.4745080018,2333.4163843233437,134699.89089232514,1414,3,358.97222222222223,33,3,21,33.4746288356953,0.6505681818181819,42.7389705882353,1029.0441176470592,31.183155080213915,0
2318,4,0,0,36,0.0,0.0,1.0,36,950,600,350,0.631578947368421,13,6,7,359.8147363040715,0.41289682539682543,0.14011528084375735,0.2173281007276594,132495.48037190098,2334.76902086493,134830.24939276592,1415,4,359.97222222222223,32,4,22,33.352495707628165,0.654296875,42.613636363636374,1029.5454545454559,32.173295454545496,0
2319,4,0,0,36,0.0,0.0,1.0,36,1050,600,450,0.5714285714285714,15,6,9,359.695672555157,0.4130456349206349,0.13617753252946385,0.21744389990269156,132527.98064291922,2333.948225946344,134861.92886886557,1416,5,360.97222222222223,32,4,22,33.32285918659308,0.6546223958333333,42.58207070707071,1029.6717171717182,32.177241161616195,0
2320,4,0,0,36,0.0,0.0,1.0,36,1050,800,250,0.7619047619047619,13,8,5,362.55004360136377,0.41347552910052915,0.1401010596279042,0.21973872627785496,132625.5053693502,2416.676550862171,135042.18192021237,1417,6,361.97222222222223,32,4,19,33.151252349432035,0.6555989583333333,42.487373737373744,1030.050505050506,32.18907828282831,0
2321,4,1,0,37,0.02702702702702703,0.0,1.0,37,800,600,200,0.75,10,6,4,355.08562671467735,0.41485235235235235,0.11620995995995975,0.21305137602880647,132244.8979591837,1994.3467347146939,134239.2446938984,1418,0,353.1621621621622,34,3,19,33.72636959876541,0.6470588235294117,42.857142857142854,1028.5714285714287,30.252100840336137,8
2322,4,0,0,37,0.0,0.0,1.0,37,1150,900,250,0.782608695652174,14,9,5,358.9045262423902,0.41410160160160164,0.11305280069013146,0.21656995383237596,132459.27047902485,2108.0463435374045,134567.31682256225,1419,1,354.1621621621622,34,3,19,33.41235881423229,0.649203431372549,42.64880952380952,1029.4047619047612,30.276610644257683,0
2323,4,0,0,37,0.0,0.0,1.0,37,850,600,250,0.7058823529411765,11,6,5,355.3976579921694,0.41447697697697694,0.1074082983688811,0.21515361366621794,132581.84700963704,2023.855583900213,134605.70259353725,1420,2,355.1621621621622,34,3,19,33.37932994258853,0.6504289215686274,42.5297619047619,1029.8809523809514,30.29061624649857,0
2324,4,0,0,37,0.0,0.0,1.0,37,950,700,250,0.7368421052631579,12,7,5,357.5434390711348,0.4141328828828829,0.10911338738530629,0.21751606128171544,132765.8180980724,2093.909438775493,134859.7275368479,1421,3,356.1621621621622,34,3,17,33.13912633321781,0.6522671568627452,42.35119047619047,1030.595238095237,30.31162464985991,0
2325,4,0,0,37,0.0,0.0,1.0,37,750,400,350,0.5333333333333333,11,4,7,355.7842303693252,0.4137887887887888,0.11230308724245641,0.2168005384073176,132827.17013888867,2051.562499999967,134878.73263888864,1422,4,357.1621621621622,34,3,17,33.12281056319051,0.6528799019607843,42.29166666666665,1030.8333333333314,30.318627450980337,0
2326,4,0,1,36,0.0,0.02702702702702703,0.972972972972973,37,800,600,200,0.75,10,6,4,354.96804610501755,0.4131944444444444,0.11833100852844569,0.2166580864915821,132888.53635204048,2034.2368197278563,134922.77317176835,1423,5,358.1621621621622,34,3,17,33.08220759727515,0.6534926470588236,42.23214285714284,1031.071428571426,30.325630252100762,0
2327,4,0,0,36,0.0,0.0,1.0,36,1300,1200,100,0.9230769230769231,14,12,2,359.79405946899755,0.4095899470899471,0.13991855108048545,0.22024629807640367,132997.7671598663,2370.3613093521553,135368.12846921844,1424,6,368.02777777777777,33,3,17,32.84808027404854,0.6568813131313131,42.12622549019607,1031.4950980392148,31.25742721330954,0
2328,4,0,0,36,0.0,0.0,1.0,36,1250,1000,250,0.8,15,10,5,358.76521166969763,0.4087962962962963,0.13941654464627296,0.22073625842906228,133187.44781153888,2356.6045811707095,135544.0523927096,1425,7,369.02777777777777,33,3,18,32.684193082433026,0.6587752525252526,41.942401960784316,1032.230392156863,31.279708853238272,0
2329,4,0,0,36,0.0,0.0,1.0,36,550,200,350,0.36363636363636365,9,2,7,359.53825427713554,0.4086640211640212,0.13753049785690763,0.22158813403693245,133250.70473195406,2381.745152104963,135632.44988405902,1426,8,370.02777777777777,33,3,18,32.600766567754704,0.6594065656565656,41.881127450980394,1032.4754901960785,31.28713606654783,0
2330,4,0,0,36,0.0,0.0,1.0,36,1400,800,600,0.5714285714285714,20,8,12,359.9765868886574,0.4077215608465608,0.13149641577060933,0.22318548387096793,133472.22222222245,2409.3750000000246,135881.59722222248,1427,9,371.02777777777777,33,3,18,32.36727150537634,0.6616161616161615,41.66666666666668,1033.333333333335,31.313131313131365,0
2331,4,0,0,36,0.0,0.0,1.0,36,600,400,200,0.6666666666666666,8,4,4,359.9765868886574,0.4077215608465608,0.13149641577060933,0.22318548387096793,133472.22222222245,2409.3750000000246,135881.59722222248,1428,10,372.02777777777777,33,3,18,32.36727150537634,0.6616161616161615,41.66666666666668,1033.333333333335,31.313131313131365,0
2332,4,0,1,35,0.0,0.027777777777777776,0.9722222222222222,36,1300,1100,200,0.8461538461538461,15,11,4,359.68899032981017,0.4068452380952381,0.13614995654578488,0.22415477846402815,133662.24078479444,2415.3672866205493,136077.608071415,1429,11,373.02777777777777,33,3,18,32.18426562376551,0.663510101010101,41.48284313725491,1034.0686274509815,31.335412953060043,0
2333,4,0,1,34,0.0,0.02857142857142857,0.9714285714285714,35,1200,800,400,0.6666666666666666,16,8,8,373.19969407881456,0.40668767507002807,0.14649921507064323,0.23261076822720658,133668.001033058,2976.9714187327963,136644.97245179082,1430,12,382.8857142857143,32,3,19,31.829212454212445,0.666015625,41.477272727272734,1034.0909090909104,32.31534090909095,0
2334,4,0,0,34,0.0,0.0,1.0,34,950,800,150,0.8421052631578947,11,8,3,384.4338588729869,0.40348336304218657,0.15818779961915475,0.23899924867600972,133573.15275404198,3470.008511013467,137043.16126505545,1431,13,394.5882352941176,31,3,19,31.634048158878105,0.6676747311827957,41.56901041666667,1033.7239583333342,33.34593413978497,0
2335,4,0,0,34,0.0,0.0,1.0,34,1000,800,200,0.8,12,8,4,382.919757120469,0.4030191622103387,0.15517854496962524,0.23827451971289376,133606.80474175353,3432.1370442708394,137038.94178602437,1432,14,395.5882352941176,31,3,19,31.639378673383707,0.668010752688172,41.536458333333336,1033.854166666667,33.35013440860216,0
2336,4,0,0,34,0.0,0.0,1.0,34,1300,900,400,0.6923076923076923,17,9,8,384.0110273670206,0.4027963458110517,0.1579855199064275,0.24026390735892467,133808.8056776258,3476.81138780381,137285.6170654296,1433,15,396.5882352941176,31,3,17,31.408360600721537,0.6700268817204301,41.34114583333333,1034.635416666666,33.375336021505355,0
2337,4,0,0,34,0.0,0.0,1.0,34,550,400,150,0.7272727272727273,7,4,3,383.3993069316384,0.4028520499108734,0.15616325805520437,0.2401004170359126,133842.48733520508,3463.0233764648447,137305.51071166992,1434,16,397.5882352941176,31,3,17,31.39038316345792,0.6703629032258065,41.30859375,1034.765625,33.379536290322584,0
2338,4,0,0,34,0.0,0.0,1.0,34,700,500,200,0.7142857142857143,9,5,4,382.7774342992917,0.4023878490790256,0.15884129192693686,0.23993020881788402,133876.17323133675,3448.955620659718,137325.12885199647,1435,17,398.5882352941176,31,3,17,31.372672370407646,0.6706989247311828,41.276041666666664,1034.895833333333,33.38373655913978,0
2339,4,0,0,34,0.0,0.0,1.0,34,900,500,400,0.5555555555555556,13,5,8,383.4418945877467,0.4015708556149733,0.1563089696817208,0.24056666298958143,133909.863366021,3469.3303426106677,137379.19370863165,1436,18,399.5882352941176,31,3,17,31.321680924225273,0.6710349462365591,41.24348958333333,1035.026041666666,33.38793682795697,0
2340,4,0,0,34,0.0,0.0,1.0,34,700,500,200,0.7142857142857143,9,5,4,386.60252195661894,0.4015337195484254,0.1576195476933544,0.24366374482115255,134078.37761772992,3567.0077853732437,137645.38540310317,1437,19,400.5882352941176,31,3,18,31.07084485793311,0.6727150537634409,41.08072916666666,1035.6770833333323,33.40893817204298,0
2341,4,0,0,34,0.0,0.0,1.0,34,900,600,300,0.6666666666666666,12,6,6,384.16476622673815,0.4013294711824124,0.15239633618937076,0.2427957938734038,134179.53703138552,3509.410095214824,137688.94712660034,1438,20,401.5882352941176,31,3,18,31.032555192492968,0.6737231182795699,40.98307291666666,1036.0677083333323,33.42153897849459,0
2342,4,0,0,34,0.0,0.0,1.0,34,1100,900,200,0.8181818181818182,13,9,4,385.4058917829874,0.40092097445038627,0.1550536808116041,0.24447938681150297,134314.47558932824,3553.1180487738616,137867.59363810212,1439,21,402.5882352941176,31,3,18,30.865181300506645,0.6750672043010753,40.85286458333333,1036.5885416666658,33.43834005376341,0
2343,4,0,0,34,0.0,0.0,1.0,34,950,700,250,0.7368421052631579,12,7,5,387.44633320053316,0.4005496137849079,0.16172593331117735,0.2466834567499798,134449.48196411136,3618.391757541233,138067.87372165258,1440,22,403.5882352941176,31,3,18,30.677050638208826,0.6764112903225806,40.72265625,1037.1093750000002,33.45514112903226,0
2344,4,0,0,34,0.0,0.0,1.0,34,800,500,300,0.625,11,5,6,385.446264583959,0.39947266785502084,0.16532076502328863,0.24632087269202624,134584.5561557345,3575.022888183574,138159.57904391806,1441,23,404.5882352941176,31,3,18,30.593680721127694,0.677755376344086,40.59244791666666,1037.6302083333323,33.471942204301044,0
2345,4,0,0,34,0.0,0.0,1.0,34,500,400,100,0.8,6,4,2,386.2105228357913,0.3990827391562686,0.16893497675105262,0.24703835208677802,134618.3353000216,3598.203531901032,138216.53883192263,1442,24,405.5882352941176,31,3,18,30.540046005855313,0.6780913978494624,40.55989583333333,1037.7604166666658,33.47614247311825,0
2346,4,0,1,33,0.0,0.029411764705882353,0.9705882352941176,34,900,600,300,0.6666666666666666,12,6,6,388.43862994334864,0.3984699940582293,0.17198117174877003,0.24915697478184368,134719.69816419802,3666.0669962565007,138385.76516045452,1443,25,406.5882352941176,31,3,19,30.380790375851838,0.6790994623655914,40.46223958333333,1038.1510416666658,33.48874327956987,0
2347,4,0,0,33,0.0,0.0,1.0,33,1200,700,500,0.5833333333333334,17,7,10,390.2600098448907,0.39725378787878785,0.15843091105227036,0.25060337290538476,134760.03593262215,3918.2905899525786,138678.32652257473,1444,26,408.57575757575756,30,3,19,30.29314994606257,0.6822916666666667,40.423387096774185,1038.3064516129023,34.61021505376341,0
2348,4,0,0,33,0.0,0.0,1.0,33,1250,900,350,0.72,16,9,7,392.2297618300088,0.39634627525252525,0.16375630578191647,0.25332734241502075,134969.4532062955,3987.8072970863636,138957.26050338187,1445,27,409.57575757575756,30,3,17,30.032499029879702,0.684375,40.221774193548384,1039.1129032258063,34.637096774193544,0
2349,4,0,0,33,0.0,0.0,1.0,33,1050,700,350,0.6666666666666666,14,7,7,389.47804212187214,0.3963857323232323,0.1597796143250687,0.2520362928643042,135039.2950955312,3918.968052665037,138958.26314819625,1446,28,410.57575757575756,30,3,17,30.03416095521358,0.6850694444444445,40.15456989247311,1039.381720430107,34.64605734767023,0
2350,4,0,0,33,0.0,0.0,1.0,33,1150,600,550,0.5217391304347826,17,6,11,388.20178365373977,0.39551767676767674,0.16004448726082243,0.25242902537080997,135213.97885593708,3898.061553358766,139112.04040929585,1447,29,411.57575757575756,30,3,17,29.892790988196776,0.6868055555555556,39.986559139784944,1040.0537634408602,34.668458781362006,0
2351,4,0,0,33,0.0,0.0,1.0,33,750,600,150,0.8,9,6,3,388.3356731941071,0.395123106060606,0.16282447260357125,0.2532524386011442,135318.84330919755,3909.826822465019,139228.67013166257,1448,30,412.57575757575756,30,3,18,29.78458855445033,0.6878472222222223,39.88575268817204,1040.4569892473114,34.68189964157705,0
2352,4,0,0,33,0.0,0.0,1.0,33,450,300,150,0.6666666666666666,6,3,3,388.1451013741337,0.39496527777777773,0.1652067040855465,0.25337431491050094,135353.80715978716,3907.3834402820976,139261.19060006927,1449,31,413.57575757575756,30,3,18,29.754639197451127,0.6881944444444444,39.8521505376344,1040.5913978494616,34.68637992831539,0
2353,4,0,0,33,0.0,0.0,1.0,33,1000,800,200,0.8,12,8,4,386.3160110156385,0.3946890782828283,0.1594488651033965,0.25316445188892867,135493.70772632677,3868.6777373106743,139362.38546363745,1450,32,414.57575757575756,30,3,20,29.66262156812117,0.6895833333333333,39.71774193548387,1041.1290322580649,34.70430107526883,0
2354,4,0,0,33,0.0,0.0,1.0,33,1000,700,300,0.7,13,7,6,386.1949741669864,0.3943734217171717,0.15834692257456462,0.2538273837845612,135598.6805736212,3873.5057882414158,139472.18636186264,1451,33,415.57575757575756,30,3,20,29.561072396438245,0.690625,39.61693548387097,1041.532258064516,34.71774193548387,0
2355,4,0,0,33,0.0,0.0,1.0,33,650,400,250,0.6153846153846154,9,4,5,385.9781583047646,0.3941366792929293,0.15336804578290675,0.25443050027028363,135703.69406867845,3875.73238235634,139579.4264510348,1452,34,416.57575757575756,30,3,20,29.462020553835572,0.6916666666666667,39.516129032258064,1041.9354838709676,34.73118279569892,0
2356,4,0,0,33,0.0,0.0,1.0,33,950,600,350,0.631578947368421,13,6,7,386.6054821621073,0.3932291666666667,0.15295294356666234,0.2558457439973809,135843.77529194127,3903.589649092383,139747.36494103365,1453,35,417.57575757575756,30,3,21,29.30607486676982,0.6930555555555555,39.38172043010753,1042.47311827957,34.74910394265233,0
2357,4,0,1,32,0.0,0.030303030303030304,0.9696969696969697,33,850,700,150,0.8235294117647058,10,7,3,387.12299662863813,0.39271622474747475,0.15621350767632491,0.25694502402408914,135948.88363177815,3925.7878439703873,139874.67147574853,1454,36,418.57575757575756,30,3,16,29.18787859260214,0.6940972222222221,39.28091397849462,1042.8763440860207,34.76254480286736,0
2358,4,0,0,32,0.0,0.0,1.0,32,950,700,250,0.7368421052631579,12,7,5,390.7751768592829,0.39285114247311825,0.16224280862964457,0.25944569434450543,135959.39670138893,4225.9114583333385,140185.30815972228,1455,37,424.5,29,3,17,29.08218471167932,0.697198275862069,39.270833333333336,1042.916666666667,35.96264367816093,0
2359,4,0,0,32,0.0,0.0,1.0,32,850,600,250,0.7058823529411765,11,6,5,391.0451574695438,0.39220010080645157,0.1558340543058696,0.26068520568488734,136104.2848186727,4244.584297839488,140348.86911651219,1456,38,425.5,29,3,18,28.93082545809487,0.6986350574712643,39.131944444444436,1043.472222222221,35.981800766283484,0
2360,4,0,0,32,0.0,0.0,1.0,32,1050,700,350,0.6666666666666666,14,7,7,393.1891405097775,0.39039398521505375,0.1583280688921398,0.2637278454498678,136321.76167052475,4320.047260802477,140641.80893132722,1457,39,426.5,29,3,19,28.658371015649244,0.7007902298850575,38.923611111111114,1044.3055555555559,36.010536398467444,0
2361,4,0,0,32,0.0,0.0,1.0,32,1200,900,300,0.75,15,9,6,393.8787347215936,0.39005796370967744,0.16040558510638303,0.2644614361702129,136358.02469135806,4341.705246913589,140699.72993827166,1458,40,427.5,29,3,19,28.604277482269502,0.7011494252873562,38.88888888888889,1044.4444444444448,36.01532567049809,0
2362,4,0,0,32,0.0,0.0,1.0,32,1000,500,500,0.5,15,5,10,396.80029534171194,0.3873487903225807,0.15799372259864475,0.2683482320788021,136612.0008680556,4441.5364583333385,141053.53732638893,1459,41,428.5,29,3,19,28.275292281121295,0.7036637931034483,38.645833333333336,1045.416666666667,36.04885057471265,0
2363,4,0,0,32,0.0,0.0,1.0,32,450,400,50,0.8888888888888888,5,4,1,394.49516149897124,0.38678175403225806,0.15591795059104818,0.26734060044336216,136684.60889274694,4384.28337191359,141068.89226466054,1460,42,429.5,29,3,19,28.26335392039669,0.704382183908046,38.57638888888889,1045.6944444444448,36.05842911877396,0
2364,4,0,0,32,0.0,0.0,1.0,32,750,400,350,0.5333333333333333,11,4,7,399.12593228223653,0.3860887096774193,0.13517016642829294,0.2481550157787131,133576.40921277032,4262.7617715921,137839.17098436243,1461,43,430.5,30,2,20,31.251083517531317,0.6704861111111111,41.56586021505377,1033.7365591397854,34.45788530465951,8
2365,4,0,0,32,0.0,0.0,1.0,32,1100,900,200,0.8181818181818182,13,9,4,398.3407665620557,0.3855426747311828,0.13272421743083496,0.24953828818236515,133854.4399099607,4263.9360402936745,138118.37595025438,1462,44,431.5,30,2,17,30.991849590855935,0.6732638888888889,41.29704301075269,1034.8118279569894,34.493727598566316,0
2366,4,0,0,32,0.0,0.0,1.0,32,500,300,200,0.6,7,3,4,402.08799869677995,0.3852486559139785,0.13639056616023892,0.2523618319448982,133923.99274843905,4369.84604434038,138293.83879277942,1463,45,432.5,30,2,17,30.825001082110553,0.6739583333333333,41.229838709677416,1035.0806451612898,34.502688172042994,0
2367,4,0,0,32,0.0,0.0,1.0,32,1200,900,300,0.75,15,9,6,401.540280361688,0.3852486559139785,0.13184531533869714,0.25321353522644596,134097.95388195178,4369.145999537535,138467.09988148932,1464,46,433.5,30,2,17,30.664417337139895,0.6756944444444444,41.061827956989255,1035.752688172044,34.5250896057348,0
2368,4,0,0,32,0.0,0.0,1.0,32,1150,800,350,0.6956521739130435,15,8,7,400.43611265745574,0.3850596438172043,0.13218721624075735,0.25323724302512923,134202.3847590762,4347.8962524569315,138550.28101153314,1465,47,434.5,30,2,19,30.588165347861807,0.6767361111111111,40.961021505376344,1036.1559139784947,34.538530465949826,0
2369,4,0,0,32,0.0,0.0,1.0,32,550,400,150,0.7272727272727273,7,4,3,401.0477985518919,0.3844716061827957,0.13635147840746953,0.25410678509725887,134272.0279259164,4369.900241357393,138641.92816727379,1466,48,435.5,30,2,19,30.50242078416116,0.6774305555555555,40.89381720430108,1036.4247311827964,34.547491039426546,0
2370,4,0,0,32,0.0,0.0,1.0,32,1150,900,250,0.782608695652174,14,9,5,401.292686552339,0.3845766129032258,0.135991994036043,0.25474654250026285,134341.68915842887,4382.067471673045,138723.7566301019,1467,49,436.5,30,2,19,30.426174424132416,0.678125,40.826612903225815,1036.693548387098,34.55645161290327,0
2371,4,0,0,32,0.0,0.0,1.0,32,750,400,350,0.5333333333333333,11,4,7,401.292686552339,0.3845766129032258,0.135991994036043,0.25474654250026285,134341.68915842887,4382.067471673045,138723.7566301019,1468,50,437.5,30,2,19,30.426174424132416,0.678125,40.826612903225815,1036.693548387098,34.55645161290327,0
2372,4,0,0,32,0.0,0.0,1.0,32,500,300,200,0.6,7,3,4,401.2559926106699,0.3839255712365592,0.13055663556246744,0.25545307252342664,134446.2148803331,4389.469880911105,138835.68476124422,1469,51,438.5,30,2,19,30.32227406255399,0.6791666666666667,40.72580645161291,1037.0967741935494,34.569892473118315,0
2373,4,0,0,32,0.0,0.0,1.0,32,600,300,300,0.5,9,3,6,401.2559926106699,0.3839255712365592,0.13055663556246744,0.25545307252342664,134446.2148803331,4389.469880911105,138835.68476124422,1470,52,439.5,30,2,19,30.32227406255399,0.6791666666666667,40.72580645161291,1037.0967741935494,34.569892473118315,0
2374,4,0,0,32,0.0,0.0,1.0,32,900,600,300,0.6666666666666666,12,6,6,393.54195914179235,0.3831065188172043,0.15385439142023083,0.23191601316964722,131561.79004245342,3955.0169203016585,135516.80696275507,1471,53,440.5,31,1,16,33.42865528620384,0.647513440860215,43.52213541666667,1025.911458333334,33.09391801075271,8
2375,4,0,1,31,0.0,0.03125,0.96875,32,800,700,100,0.875,9,7,2,396.74194624453384,0.3824974798387097,0.15913632326820615,0.2344167931258933,131661.9957817926,4047.167290581606,135709.16307237418,1472,54,441.5,31,1,16,33.24505201725451,0.648521505376344,43.42447916666667,1026.302083333334,33.10651881720432,0
2376,4,0,0,31,0.0,0.0,1.0,31,1100,900,200,0.8181818181818182,13,9,4,401.3984185273933,0.3796594982078853,0.14956626037892073,0.2376652031559867,131741.7566337148,4376.186553358764,136117.94318707357,1473,55,443.7741935483871,30,1,17,33.04475429868203,0.6520833333333333,43.346774193548384,1026.612903225806,34.220430107526866,0
2377,4,0,0,31,0.0,0.0,1.0,31,750,500,250,0.6666666666666666,10,5,5,401.3984185273933,0.3796594982078853,0.14956626037892073,0.2376652031559867,131741.7566337148,4376.186553358764,136117.94318707357,1474,56,444.7741935483871,30,1,17,33.04475429868203,0.6520833333333333,43.346774193548384,1026.612903225806,34.220430107526866,0
2378,4,0,0,31,0.0,0.0,1.0,31,750,500,250,0.6666666666666666,10,5,5,397.8166910627169,0.378584229390681,0.1429620687035149,0.23640086727070642,131879.7783703319,4292.795409873986,136172.57378020586,1475,57,445.7741935483871,30,1,18,32.99692488877257,0.6534722222222222,43.212365591397855,1027.1505376344091,34.23835125448031,0
2379,4,0,0,31,0.0,0.0,1.0,31,1050,800,250,0.7619047619047619,13,8,5,398.59432884774884,0.3780465949820788,0.14397967623774055,0.23729400698693082,131948.81633714878,4318.809978032134,136267.6263151809,1476,58,446.7741935483871,30,1,18,32.907073085644505,0.6541666666666667,43.14516129032258,1027.4193548387093,34.24731182795698,0
2380,4,1,1,31,0.03125,0.03125,0.96875,32,950,600,350,0.631578947368421,13,6,7,387.97554459178184,0.3816994287634408,0.1387904858299598,0.23373160857114647,132398.00347222213,3873.43749999999,136271.44097222213,1477,0,433.78125,31,1,19,32.726045883940635,0.6559139784946236,42.70833333333333,1029.1666666666658,33.19892473118277,0
2381,4,0,0,31,0.0,0.0,1.0,31,850,600,250,0.7058823529411765,11,6,5,393.34230260506257,0.37983870967741934,0.12430663482556925,0.23740021242333914,132467.17693158166,4220.988878772111,136688.16581035376,1478,1,421.51612903225805,30,1,20,32.518115942028984,0.659375,42.641129032258064,1029.4354838709676,34.31451612903225,0
2382,4,0,0,31,0.0,0.0,1.0,31,800,500,300,0.625,11,5,6,393.71425260244445,0.3795250896057348,0.12494735955529324,0.23784315259737585,132501.77043588858,4233.567103133313,136735.3375390219,1479,2,422.51612903225805,30,1,20,32.4736183637946,0.6597222222222222,42.60752688172043,1029.5698924731187,34.31899641577062,0
2383,4,0,0,31,0.0,0.0,1.0,31,750,600,150,0.8,9,6,3,393.71425260244445,0.3795250896057348,0.12494735955529324,0.23784315259737585,132501.77043588858,4233.567103133313,136735.3375390219,1480,3,423.51612903225805,30,1,20,32.4736183637946,0.6597222222222222,42.60752688172043,1029.5698924731187,34.31899641577062,0
2384,4,0,0,31,0.0,0.0,1.0,31,900,600,300,0.6666666666666666,12,6,6,394.7522174983636,0.378673835125448,0.1272724210809948,0.23890928044806176,132570.97099375646,4266.5369551393205,136837.50794889577,1481,4,424.51612903225805,30,1,20,32.37704472287481,0.6604166666666667,42.54032258064516,1029.838709677419,34.327956989247305,0
2385,4,1,0,32,0.03125,0.0,1.0,32,650,500,150,0.7692307692307693,8,5,3,385.6939565524583,0.38272849462365593,0.12992507886435312,0.2367641057845263,133102.4699740941,3867.3636542426416,136969.83362833675,1482,0,412.21875,31,1,19,32.074789695057845,0.6629704301075269,42.02473958333334,1031.9010416666679,33.28713037634412,0
2386,4,0,0,32,0.0,0.0,1.0,32,750,500,250,0.6666666666666666,10,5,5,384.05405293203063,0.3821404569892473,0.1228126182368523,0.236609524918265,133236.86599731445,3834.031677246095,137070.89767456055,1483,1,413.21875,31,1,19,31.981886114264093,0.6643145161290323,41.89453125,1032.421875,33.303931451612904,0
2387,4,1,0,33,0.030303030303030304,0.0,1.0,33,1500,1100,400,0.7333333333333333,19,11,8,371.5441162958696,0.38490372474747475,0.12507586860298137,0.23117045776828127,133602.72548719522,3327.8613151719246,136930.58680236715,1484,0,401.6666666666667,32,1,21,31.937489822504478,0.6653645833333333,41.54040404040404,1033.838383838384,32.3074494949495,0
2388,4,0,0,33,0.0,0.0,1.0,33,650,400,250,0.6153846153846154,9,4,5,372.55028244039244,0.38419349747474746,0.1260295260295261,0.23220599795942257,133668.00103305784,3359.6103076216705,137027.61134067952,1485,1,402.6666666666667,32,1,21,31.84600122100123,0.666015625,41.47727272727273,1034.090909090909,32.31534090909091,0
2389,4,0,0,33,0.0,0.0,1.0,33,650,500,150,0.7692307692307693,8,5,3,371.3858849149297,0.38423295454545453,0.12367542136857401,0.2320949317397421,133765.9442435721,3335.7567148760345,137101.70095844814,1486,2,403.6666666666667,32,1,17,31.77788966190651,0.6669921875,41.38257575757576,1034.469696969697,32.32717803030303,0
2390,4,0,0,33,0.0,0.0,1.0,33,900,600,300,0.6666666666666666,12,6,6,375.5118275713416,0.38308869949494945,0.12056894881974167,0.2357156173376617,133929.26263901655,3458.404435771873,137387.66707478842,1487,3,404.6666666666667,32,1,17,31.507430674148164,0.6686197916666667,41.22474747474748,1035.101010101011,32.346906565656596,0
2391,4,0,0,33,0.0,0.0,1.0,33,850,600,250,0.7058823529411765,11,6,5,377.3429684410261,0.38237847222222227,0.12285271936533926,0.23749728965348085,134027.3015030354,3514.8519602591587,137542.15346329458,1488,4,405.6666666666667,32,1,18,31.361774986790227,0.6695963541666667,41.130050505050505,1035.4797979797981,32.35874368686869,0
2392,4,0,0,33,0.0,0.0,1.0,33,900,600,300,0.6666666666666666,12,6,6,376.16801545951216,0.382220643939394,0.1178213140670481,0.23739095375614142,134125.3762371187,3490.735320375474,137616.11155749418,1489,5,406.6666666666667,32,1,18,31.29393182187551,0.6705729166666667,41.035353535353536,1035.8585858585861,32.37058080808082,0
2393,4,0,0,33,0.0,0.0,1.0,33,1050,700,350,0.6666666666666666,14,7,7,376.52062734191543,0.3812342171717172,0.12059180817557813,0.2382501764529762,134223.48684126625,3507.5822938985857,137731.06913516484,1490,6,407.6666666666667,32,1,19,31.186537914788182,0.6715494791666667,40.94065656565657,1036.2373737373741,32.38241792929294,0
2394,4,0,0,33,0.0,0.0,1.0,33,900,500,400,0.5555555555555556,13,5,8,374.55020896178337,0.3806818181818182,0.11837709535358454,0.23742723284689426,134288.91383851145,3459.588147893087,137748.50198640453,1491,7,408.6666666666667,32,1,19,31.172087546189143,0.6722005208333333,40.87752525252526,1036.4898989898998,32.39030934343437,0
2395,4,0,0,33,0.0,0.0,1.0,33,800,600,200,0.75,10,6,4,375.77179209279603,0.3799715909090909,0.11908636972575559,0.23862816588352284,134354.35677800744,3497.31548438936,137851.6722623968,1492,8,409.6666666666667,32,1,19,31.074929971988784,0.6728515625,40.814393939393945,1036.742424242425,32.39820075757578,0
2396,4,0,1,32,0.0,0.030303030303030304,0.9696969696969697,33,650,400,250,0.6153846153846154,9,4,5,376.30603743454236,0.37969539141414144,0.1127333237402639,0.23939593225793163,134419.81565975415,3516.597636720751,137936.4132964749,1493,9,410.6666666666667,32,1,19,30.99557611916068,0.6735026041666667,40.75126262626263,1036.9949494949499,32.406092171717184,0
2397,4,0,0,32,0.0,0.0,1.0,32,950,700,250,0.7368421052631579,12,7,5,386.1619656069292,0.374978998655914,0.12019472361809047,0.24473322024133412,134280.73459201393,3970.822482638899,138251.55707465284,1494,10,424.0,31,1,20,30.879396984924632,0.674731182795699,40.88541666666667,1036.4583333333337,33.43413978494625,0
2398,4,0,0,32,0.0,0.0,1.0,32,950,600,350,0.631578947368421,13,6,7,384.3167126241006,0.37472698252688175,0.11941880180859088,0.24401352997712025,134348.22082519528,3926.4533148871533,138274.67414008244,1495,11,425.0,31,1,20,30.859603952105847,0.6754032258064516,40.8203125,1036.7187499999998,33.44254032258064,0
2399,4,1,0,33,0.030303030303030304,0.0,1.0,33,900,600,300,0.6666666666666666,12,6,6,375.9499597670365,0.3768939393939394,0.11617021590264143,0.2411123688927124,134714.57791296803,3529.1880292827236,138243.76594225076,1496,0,413.09090909090907,32,1,23,30.71003608205627,0.6764322916666667,40.467171717171716,1038.131313131313,32.44160353535353,0
2400,4,0,0,33,0.0,0.0,1.0,33,650,500,150,0.7692307692307693,8,5,3,375.1139032344489,0.37681502525252525,0.11261306069816701,0.24122844832707924,134812.90373750127,3514.038905468829,138326.9426429701,1497,1,414.09090909090907,32,1,17,30.63348530901722,0.6774088541666667,40.37247474747475,1038.5101010101012,32.45344065656566,0
2401,4,0,1,32,0.0,0.030303030303030304,0.9696969696969697,33,1000,800,200,0.8,12,8,4,374.3796589249834,0.37547348484848486,0.11632976177326149,0.24184808421920045,134976.85982297733,3506.5181486583137,138483.37797163564,1498,2,415.09090909090907,32,1,19,30.488811259619283,0.6790364583333333,40.21464646464647,1039.1414141414148,32.47316919191921,0
2402,4,0,0,32,0.0,0.0,1.0,32,1000,700,300,0.7,13,7,6,382.5216874293893,0.37250084005376344,0.12076855566700084,0.24604782088200097,134821.09917534736,3914.3988715277983,138735.49804687517,1499,15,429.0,31,1,19,30.43296556335673,0.6801075268817205,40.36458333333334,1038.5416666666679,33.50134408602155,0
2403,4,0,0,32,0.0,0.0,1.0,32,800,600,200,0.75,10,6,4,385.5477709315293,0.3717657930107527,0.12722794762561063,0.24915439350644022,134990.1856316461,4009.033033582911,138999.218665229,1500,16,430.0,31,1,19,30.18536211001128,0.6817876344086021,40.20182291666667,1039.192708333334,33.52234543010755,0
2404,4,0,0,32,0.0,0.0,1.0,32,850,600,250,0.7058823529411765,11,6,5,383.8940405861823,0.3714507728494623,0.12719188376753499,0.24878328084740925,135091.68836805562,3972.178819444454,139063.8671875001,1501,17,431.0,31,1,19,30.12692050768203,0.6827956989247312,40.10416666666667,1039.583333333334,33.53494623655916,0
2405,4,0,0,32,0.0,0.0,1.0,32,650,500,150,0.7692307692307693,8,5,3,386.05940059516877,0.37103074596774194,0.13167574505384438,0.2506561278986193,135159.3780517578,4035.9096950954868,139195.2877468533,1502,18,432.0,31,1,19,30.003026129059183,0.6834677419354839,40.0390625,1039.84375,33.54334677419355,0
2406,4,0,0,32,0.0,0.0,1.0,32,1200,900,300,0.75,15,9,6,381.27428183008055,0.36924563172043007,0.12433144626548209,0.24918441003007646,135396.42545912007,3924.634975857216,139321.0604349773,1503,19,433.0,31,1,22,29.89086805121148,0.6858198924731183,39.81119791666667,1040.755208333334,33.572748655914,0
2407,4,0,1,31,0.0,0.03125,0.96875,32,1250,1100,150,0.88,14,11,3,382.6205053229837,0.3689516129032258,0.12353460672752248,0.2510103511950699,135531.97436862535,3971.462504069032,139503.43687269438,1504,20,434.0,31,1,22,29.720650452252933,0.6871639784946236,39.68098958333334,1041.2760416666679,33.589549731182835,0
2408,4,0,0,31,0.0,0.0,1.0,31,650,600,50,0.9230769230769231,7,6,1,390.71401570642,0.3689516129032258,0.11114767071367582,0.25579713031667156,135458.72581006485,4385.12454474507,139843.85035480993,1505,21,423.93548387096774,30,1,23,29.58306434258662,0.6892361111111112,39.75134408602151,1040.9946236559147,34.69982078853049,0
2409,4,0,0,31,0.0,0.0,1.0,31,1000,800,200,0.8,12,8,4,392.081961428465,0.36854838709677423,0.11462315617634089,0.2569430518802784,135493.70772632677,4424.927737310674,139918.63546363745,1506,22,424.93548387096774,30,1,23,29.512544108787317,0.6895833333333333,39.71774193548387,1041.1290322580649,34.70430107526883,0
2410,4,0,0,31,0.0,0.0,1.0,31,900,500,400,0.5555555555555556,13,5,8,394.8225291953697,0.3682347670250896,0.11993239611062645,0.26001438028924206,135669.8519483024,4513.175079047345,140183.02702734974,1507,23,425.93548387096774,29,2,23,29.26540350175532,0.6943247126436782,39.54861111111111,1041.805555555555,35.924329501915686,0
2411,4,0,0,31,0.0,0.0,1.0,31,850,400,450,0.47058823529411764,13,4,9,394.2644946149542,0.36769713261648745,0.11405529953917037,0.2604366872879064,135778.3950617284,4506.520061728393,140284.9151234568,1508,24,426.93548387096774,29,2,24,29.171664001421465,0.6954022988505747,39.44444444444444,1042.2222222222224,35.93869731800767,0
2412,4,0,0,31,0.0,0.0,1.0,31,550,300,250,0.5454545454545454,8,3,5,394.1127333117807,0.3671146953405018,0.11249935552614865,0.2613956185251632,135923.18672839497,4513.811728395051,140436.99845679002,1509,25,427.93548387096774,29,2,22,29.031255549635954,0.6968390804597702,39.30555555555555,1042.777777777777,35.95785440613024,0
2413,4,0,0,31,0.0,0.0,1.0,31,750,300,450,0.4,12,3,9,401.45193560311424,0.3673387096774194,0.0754517551883247,0.24867455964174176,133438.5871887207,4513.835822211369,137952.42301093208,1510,26,428.93548387096774,31,0,21,31.329683889939083,0.6663306451612903,41.69921875,1033.203125,33.32913306451613,8
2414,4,0,0,31,0.0,0.0,1.0,31,650,600,50,0.9230769230769231,7,6,1,401.45193560311424,0.3673387096774194,0.0754517551883247,0.24867455964174176,133438.5871887207,4513.835822211369,137952.42301093208,1511,27,429.93548387096774,31,0,21,31.329683889939083,0.6663306451612903,41.69921875,1033.203125,33.32913306451613,0
2415,4,0,2,29,0.0,0.06451612903225806,0.935483870967742,31,600,600,0,1.0,6,6,0,418.13775441884377,0.3668906810035842,0.06386461756689354,0.2348235213796563,129698.28499688033,4646.34992811414,134344.63492499446,1512,28,430.93548387096774,31,0,18,34.696967275981095,0.6286962365591398,45.34505208333333,1018.6197916666658,32.85870295698922,7
2416,4,0,0,29,0.0,0.0,1.0,29,1050,700,350,0.6666666666666666,14,7,7,417.9029574652541,0.364378078817734,0.02933102696198242,0.23510246134701712,129766.82098765425,5045.987654320977,134812.80864197522,1513,29,425.6551724137931,29,0,18,34.63286077789894,0.6350574712643677,45.27777777777777,1018.8888888888883,35.13409961685822,0
2417,4,1,0,30,0.03333333333333333,0.0,1.0,30,800,600,200,0.75,10,6,4,408.23296658874847,0.3737068965517241,0.032657361074532654,0.2323928896757836,130228.28686842401,4632.695976413449,134860.98284483745,1514,0,412.43333333333334,30,0,19,34.408195066280406,0.6368055555555556,44.8252688172043,1020.698924731182,34.0232974910394,0
2418,4,0,0,30,0.0,0.0,1.0,30,850,600,250,0.7058823529411765,11,6,5,407.8241535835532,0.3728208812260536,0.024891404501776737,0.23277536399506027,130331.20022907265,4630.442283790023,134961.6425128627,1515,1,413.43333333333334,30,0,20,34.313709358957475,0.6378472222222222,44.72446236559139,1021.1021505376339,34.03673835125446,0
2419,4,0,0,30,0.0,0.0,1.0,30,650,400,250,0.6153846153846154,9,4,5,407.27458736934597,0.3732998084291188,0.02896433741281723,0.23287280582540715,130399.83171826223,4621.707531217482,135021.5392494797,1516,2,414.43333333333334,30,0,20,34.25779707856296,0.6385416666666667,44.65725806451613,1021.3709677419355,34.045698924731184,0
2420,4,0,0,30,0.0,0.0,1.0,30,550,500,50,0.9090909090909091,6,5,1,408.34457676746104,0.3732040229885058,0.028141034074463667,0.23389805033982444,130468.48127312402,4655.219353393448,135123.70062651747,1517,3,415.43333333333334,30,0,20,34.16052712362407,0.6392361111111111,44.59005376344086,1021.6397849462363,34.054659498207876,0
2421,4,0,0,30,0.0,0.0,1.0,30,600,300,300,0.5,9,3,6,410.0159027180724,0.3732998084291188,0.032746000438308,0.23568941346719116,130605.83457986459,4710.093833102074,135315.92841296666,1518,4,416.43333333333334,30,0,18,33.977920227920215,0.640625,44.45564516129031,1022.1774193548376,34.07258064516125,0
2422,4,0,0,30,0.0,0.0,1.0,30,750,500,250,0.6666666666666666,10,5,5,410.3224345975944,0.37308429118773945,0.0334209834341308,0.23607507091900926,130640.18419759511,4720.919687247081,135361.1038848422,1519,5,417.43333333333334,30,0,18,33.935106056621954,0.6409722222222223,44.42204301075269,1022.3118279569894,34.077060931899645,0
2423,4,0,0,30,0.0,0.0,1.0,30,900,400,500,0.4444444444444444,14,4,10,411.61416350258526,0.3732040229885058,0.03572586652644505,0.23702868597760515,130674.53833174346,4757.498157301412,135432.03648904487,1520,6,418.43333333333334,30,0,18,33.86710705052364,0.6413194444444444,44.38844086021505,1022.446236559139,34.081541218637966,0
2424,4,2,0,32,0.0625,0.0,1.0,32,650,500,150,0.7692307692307693,8,5,3,388.3270540022473,0.3826444892473118,0.027947154471544833,0.22744870305845916,131328.125,3801.2832047057454,135129.40820470575,1521,0,393.21875,31,1,20,33.799119241192415,0.6451612903225806,43.75,1025.0,33.064516129032256,0
2425,4,0,0,32,0.0,0.0,1.0,32,800,400,400,0.5,12,4,8,387.5999784367192,0.3826444892473118,0.028901091924835587,0.22781622613191035,131461.6224500867,3790.904405381939,135252.52685546863,1522,1,394.21875,31,1,21,33.68249534450653,0.646505376344086,43.619791666666664,1025.5208333333326,33.08131720430105,0
2426,4,0,0,32,0.0,0.0,1.0,32,750,400,350,0.5333333333333333,11,4,7,387.6935762323174,0.38289650537634407,0.026300761421319763,0.2286695644244505,131595.18771701382,3803.7217881944357,135398.90950520826,1523,2,395.21875,31,1,19,33.54483925549916,0.6478494623655914,43.48958333333333,1026.041666666666,33.098118279569874,0
2427,4,0,0,32,0.0,0.0,1.0,32,700,200,500,0.2857142857142857,12,2,10,387.6168934584455,0.38188844086021506,0.022434677828513827,0.22942729639837703,131728.82080078113,3812.063259548597,135540.88406032973,1524,3,396.21875,31,1,19,33.41155082022662,0.6491935483870968,43.35937499999999,1026.562499999999,33.11491935483868,0
2428,4,0,1,31,0.0,0.03125,0.96875,32,850,600,250,0.7058823529411765,11,6,5,386.6653209641291,0.3819934475806452,0.024639346861128786,0.2290650680542566,131762.23966810424,3789.5777384439907,135551.81740654825,1525,4,397.21875,31,1,19,33.40216127668568,0.6495295698924731,43.32682291666666,1026.6927083333321,33.11911962365588,0
2429,4,0,0,31,0.0,0.0,1.0,31,600,400,200,0.6666666666666666,8,4,4,396.89655553465195,0.37862903225806455,0.027981779306498256,0.2341505645248479,131603.8071597872,4246.619551393216,135850.4267111804,1526,5,410.9032258064516,30,1,19,33.30003929787791,0.6506944444444445,43.48118279569892,1026.0752688172038,34.20250896057346,0
2430,4,0,0,31,0.0,0.0,1.0,31,800,500,300,0.625,11,5,6,395.84153074881,0.3785394265232975,0.02945760664337871,0.23416280172956336,131707.2624906059,4227.040879003359,135934.30336960926,1527,6,411.9032258064516,30,1,20,33.222305879271964,0.6517361111111111,43.380376344086024,1026.4784946236564,34.215949820788545,0
2431,4,0,0,31,0.0,0.0,1.0,31,800,600,200,0.75,10,6,4,397.932330656318,0.37943548387096776,-0.01230462254738951,0.22105403918837774,129269.72229448504,4088.120375187895,133357.84266967294,1528,7,412.9032258064516,30,1,20,35.64934135166093,0.6270833333333333,45.76612903225807,1016.9354838709688,33.89784946236563,8
2432,4,0,0,31,0.0,0.0,1.0,31,1100,800,300,0.7272727272727273,14,8,6,399.1833159119029,0.3780913978494624,-0.003869263220692698,0.22251971291996356,129406.44330269397,4131.378627587006,133537.82193028097,1529,8,413.9032258064516,30,1,20,35.477763099955965,0.6284722222222222,45.63172043010753,1017.4731182795699,33.915770609319,0
2433,4,1,1,31,0.03125,0.03125,0.96875,32,1050,700,350,0.6666666666666666,14,7,7,404.41994302639307,0.3853956653225807,-0.01255451513596717,0.22203224477702543,128804.55864800353,4021.0492152949464,132825.60786329847,1530,0,401.9375,31,1,21,35.960749102103655,0.6196236559139785,46.223958333333336,1015.1041666666671,32.74529569892474,8
2434,4,1,0,32,0.03125,0.0,1.0,32,900,600,300,0.6666666666666666,12,6,6,405.8048911582906,0.38610971102150543,0.014600409836065475,0.2250372578241431,129201.38888888893,4086.1111111111163,133287.50000000006,1531,0,402.625,31,1,22,35.51912568306011,0.6236559139784946,45.833333333333336,1016.6666666666671,32.7956989247312,0
2435,4,1,0,33,0.030303030303030304,0.0,1.0,33,950,600,350,0.631578947368421,13,6,7,396.75109670959205,0.3923611111111111,0.019182272933978117,0.22199889609780984,129554.6392746913,3680.1890432098694,133234.82831790118,1532,0,391.3939393939394,32,1,16,35.38824465666212,0.6246744791666667,45.48611111111111,1018.0555555555552,31.8142361111111,0
2436,4,0,1,32,0.0,0.030303030303030304,0.9696969696969697,33,800,500,300,0.625,11,5,6,399.1834904807466,0.39200599747474746,0.020347286402331966,0.22390918179538977,129651.06398581788,3750.912853280287,133401.97683909818,1533,1,392.3939393939394,32,1,16,35.2278597404744,0.6256510416666667,45.391414141414145,1018.4343434343442,31.826073232323257,0
2437,4,0,0,32,0.0,0.0,1.0,32,1150,900,250,0.782608695652174,14,9,5,411.18026559851864,0.3868867607526882,0.027572588897416317,0.22994329874457947,129532.54699707043,4252.245415581612,133784.79241265205,1534,2,405.59375,31,1,16,35.04359597510019,0.627016129032258,45.50781250000001,1017.9687500000009,32.83770161290325,0
2438,4,0,0,32,0.0,0.0,1.0,32,700,400,300,0.5714285714285714,10,4,6,410.03225851225136,0.38627772177419356,0.023786120700677538,0.2298826017078365,129631.97708129896,4230.658467610692,133862.63554890966,1535,3,406.59375,31,1,17,34.97115138729062,0.6280241935483871,45.41015625000001,1018.359375000001,32.85030241935487,0
2439,4,2,0,34,0.058823529411764705,0.0,1.0,34,1100,800,300,0.7272727272727273,14,8,6,393.3087781367394,0.3950906120023767,0.017856133807990116,0.22373466559581745,130200.04325259525,3441.763985005781,133641.80723760102,1536,0,383.61764705882354,33,1,19,34.81778338136407,0.6287878787878788,44.852941176470594,1020.5882352941185,30.926916221033892,0
2440,4,0,0,34,0.0,0.0,1.0,34,1350,1000,350,0.7407407407407407,17,10,7,395.4038954292106,0.39321524064171126,0.018524175248734842,0.22584934366041343,130359.27456381998,3508.92801183429,133868.2025756543,1537,1,384.61764705882354,32,2,20,34.602188427299716,0.6328125,44.696969696969695,1021.2121212121209,31.91287878787878,0
2441,4,0,1,33,0.0,0.029411764705882353,0.9705882352941176,34,1400,1100,300,0.7857142857142857,17,11,6,400.2470599807339,0.3931409685086156,0.016439192430122596,0.2297588442187279,130552.75769054191,3650.67148760332,134203.42917814522,1538,2,385.61764705882354,32,2,15,34.28156659253768,0.634765625,44.507575757575765,1021.9696969696979,31.93655303030306,0
2442,4,0,0,33,0.0,0.0,1.0,33,1050,800,250,0.7619047619047619,13,8,5,410.20662284861004,0.38735006313131315,0.027936308213125205,0.23508441870332547,130488.24737271722,4105.4286552392805,134593.6760279565,1539,3,397.57575757575756,32,1,15,34.09282830779371,0.6341145833333333,44.57070707070708,1021.7171717171728,31.92866161616165,0
2443,4,0,0,33,0.0,0.0,1.0,33,950,600,350,0.631578947368421,13,6,7,406.67567104910756,0.38660037878787884,0.02393703616378695,0.23403361112186394,130649.55305899908,4026.3989325068887,134675.95199150598,1540,4,398.57575757575756,32,1,16,34.018772384833895,0.6357421875,44.41287878787879,1022.3484848484849,31.948390151515152,0
2444,4,0,2,31,0.0,0.06060606060606061,0.9393939393939394,33,900,700,200,0.7777777777777778,11,7,4,405.5915283823844,0.38648200757575757,0.022733820486629197,0.23379970023978183,130714.1032324509,4003.3065822365193,134717.40981468742,1541,5,399.57575757575756,32,1,16,33.98078980944149,0.6363932291666667,44.34974747474748,1022.6010101010112,31.9562815656566,0
2445,4,0,0,31,0.0,0.0,1.0,31,950,700,250,0.7368421052631579,12,7,5,420.26815092155243,0.37620967741935485,0.031583622575710235,0.24027575625573314,130395.54172092018,4760.218641493061,135155.76036241325,1542,10,426.03225806451616,31,0,19,33.930392656807754,0.635752688172043,44.661458333333336,1021.3541666666671,32.94690860215055,0
2446,4,1,0,32,0.03125,0.0,1.0,32,750,600,150,0.8,9,6,3,410.24013839356564,0.3822874663978495,0.027121403877022,0.2364793509501415,130714.10323245075,4324.834360014284,135038.93759246505,1543,0,413.6875,32,0,17,33.861947977116515,0.6363932291666667,44.349747474747474,1022.6010101010099,31.95628156565656,0
2447,4,0,0,32,0.0,0.0,1.0,32,600,500,100,0.8333333333333334,7,5,2,409.44515438277494,0.38241347446236557,0.02787850265399361,0.23641590845722432,130778.66934815308,4309.338492245672,135088.00784039876,1544,1,414.6875,32,0,17,33.81655556927127,0.6370442708333333,44.28661616161615,1022.8535353535341,31.96417297979794,0
2448,4,1,0,33,0.030303030303030304,0.0,1.0,33,400,200,200,0.5,6,2,4,399.8050360602475,0.387823547979798,0.0263927278531062,0.2322650397251256,131014.28086553245,3876.0338571703173,134890.31472270275,1545,0,403.09090909090907,33,0,18,33.823617428776636,0.6369949494949495,44.056372549019606,1023.7745098039213,31.02346999405822,0
2449,4,0,1,32,0.0,0.030303030303030304,0.9696969696969697,33,1350,1200,150,0.8888888888888888,15,12,3,400.42450656179733,0.38790246212121215,0.032050584814403926,0.23338549692074628,131139.77346453283,3902.3158160322887,135042.08928056512,1546,1,404.09090909090907,33,0,18,33.680306293371615,0.6382575757575757,43.93382352941176,1024.2647058823527,31.038324420677355,0
2450,4,0,0,32,0.0,0.0,1.0,32,750,400,350,0.5333333333333333,11,4,7,409.8081737334129,0.38062836021505375,0.028730584319526686,0.23881924607223007,131134.06795224964,4347.962580348926,135482.03053259855,1547,2,417.28125,32,0,18,33.44582100591715,0.640625,43.93939393939393,1024.242424242423,32.00757575757572,0
2451,4,0,0,32,0.0,0.0,1.0,32,700,500,200,0.7142857142857143,9,5,4,413.3278210748221,0.3803553427419355,0.029101201478743066,0.24147986090872434,131231.07854109272,4448.291150137739,135679.36969123047,1548,3,418.28125,32,0,18,33.257085643869374,0.6416015625,43.84469696969697,1024.621212121212,32.019412878787875,0
2452,4,0,0,32,0.0,0.0,1.0,32,1000,900,100,0.9,11,9,2,410.8814889983164,0.3806913642473118,0.03290547616114292,0.24045602351833698,131295.77219480154,4389.4004757167595,135685.1726705183,1549,4,419.28125,32,0,18,33.25402447538089,0.6422526041666667,43.781565656565654,1024.8737373737372,32.02730429292929,0
2453,4,0,0,32,0.0,0.0,1.0,32,550,300,250,0.5454545454545454,8,3,5,412.7833961266442,0.38096438172043007,0.029979674796748013,0.24177313201703443,131328.125,4442.013888888889,135770.13888888888,1550,5,420.28125,32,0,18,33.172425474254744,0.642578125,43.75,1025.0,32.03125,0
2454,4,0,0,32,0.0,0.0,1.0,32,750,500,250,0.6666666666666666,10,5,5,411.816619037865,0.3809853830645162,0.025016161802733583,0.24181943334826486,131425.20732897162,4424.6169077135155,135849.82423668515,1551,6,421.28125,32,0,18,33.09860238886838,0.6435546875,43.65530303030304,1025.3787878787887,32.043087121212146,0
2455,4,0,1,31,0.0,0.03125,0.96875,32,1150,800,350,0.6956521739130435,15,8,7,445.46139666464376,0.380838373655914,-0.07737167663147171,0.25843336082514884,130961.35669284404,5304.376718120043,136265.73341096408,1552,7,422.28125,31,1,15,32.70907539329178,0.6414650537634409,44.10807291666667,1023.5677083333339,33.01831317204303,8
2456,4,0,1,30,0.0,0.03225806451612903,0.967741935483871,31,900,500,400,0.5555555555555556,13,5,8,450.699392814009,0.37410394265232977,-0.04989291077539182,0.26169856915094103,130994.67807345923,5607.844373914937,136602.52244737418,1553,8,436.61290322580646,31,0,16,32.54102009666752,0.6418010752688172,44.075520833333336,1023.697916666667,33.02251344086022,0
2457,4,0,1,29,0.0,0.03333333333333333,0.9666666666666667,30,900,700,200,0.7777777777777778,11,7,4,463.67242694763286,0.3667624521072797,-0.04398318444561222,0.2681971515140867,130846.37674875707,6133.971412880101,136980.34816163717,1554,24,451.9,30,0,16,32.36063671396041,0.6430555555555555,44.22043010752688,1023.1182795698924,34.10394265232974,0
2458,4,0,0,29,0.0,0.0,1.0,29,900,500,400,0.5555555555555556,13,5,8,468.2518988516865,0.3662253694581281,-0.031165039003093087,0.27148294591959715,130936.9237075618,6462.292631172853,137399.21633873467,1555,25,461.2758620689655,29,0,17,32.15087415750668,0.6469109195402298,44.13194444444445,1023.4722222222229,35.292145593869755,0
2459,4,0,0,29,0.0,0.0,1.0,29,600,300,300,0.5,9,3,6,466.50684247916087,0.36560960591133007,-0.03985256422250094,0.27122148602179624,131043.55709876555,6426.543209876561,137470.1003086421,1556,26,462.2758620689655,29,0,17,32.08649846265148,0.6479885057471264,44.027777777777786,1023.8888888888898,35.30651340996172,0
2460,4,0,0,29,0.0,0.0,1.0,29,800,500,300,0.625,11,5,6,467.97127262280947,0.36540435139573074,-0.032542372881356085,0.2728291016279227,131150.23389274697,6474.908371913586,137625.14226466056,1557,27,463.2758620689655,29,0,18,31.939971751412436,0.649066091954023,43.923611111111114,1024.3055555555559,35.32088122605365,0
2461,4,0,0,29,0.0,0.0,1.0,29,800,600,200,0.75,10,6,4,467.9949275600998,0.3656609195402299,-0.029732964320442923,0.27309577418380515,131185.80246913587,6478.858024691366,137664.66049382725,1558,28,464.2758620689655,29,0,18,31.90301879971077,0.6494252873563218,43.88888888888889,1024.444444444445,35.325670498084314,0
2462,4,0,0,29,0.0,0.0,1.0,29,700,400,300,0.5714285714285714,10,4,6,466.13929409925794,0.3647885878489327,-0.06875269056452293,0.2717176637476376,131144.10186699027,6426.360974405825,137570.4628413961,1559,29,465.2758620689655,28,1,16,31.993150044419497,0.6521577380952381,43.92959770114942,1024.2816091954016,36.581486042692916,7
2463,4,1,0,30,0.03333333333333333,0.0,1.0,30,650,400,250,0.6153846153846154,9,4,5,458.8162838287643,0.3732040229885058,-0.056289478433495965,0.2707455834606156,131613.00154320974,6077.237654320972,137690.23919753073,1560,0,450.73333333333335,29,1,16,31.702310052337126,0.6537356321839081,43.472222222222214,1026.1111111111102,35.38314176245208,0
2464,4,0,0,30,0.0,0.0,1.0,30,1050,700,350,0.6666666666666666,14,7,7,454.89339683707846,0.37248563218390807,-0.05648098071029395,0.2704494825568352,131898.18672839494,5999.922839506156,137898.1095679011,1561,1,451.73333333333335,29,1,16,31.512529295114472,0.6566091954022988,43.194444444444436,1027.2222222222213,35.421455938697285,0
2465,4,0,0,30,0.0,0.0,1.0,30,650,200,450,0.3076923076923077,11,2,9,455.66905780030726,0.37198275862068964,-0.05596412960209085,0.2711652470272623,131933.85657793196,6023.635223765415,137957.49180169738,1562,2,452.73333333333335,29,1,16,31.456305484205313,0.6569683908045977,43.159722222222214,1027.3611111111102,35.426245210727934,0
2466,4,0,0,30,0.0,0.0,1.0,30,800,600,200,0.75,10,6,4,458.05697007775416,0.3728208812260536,-0.05959650544897788,0.2738721884099788,132112.2781635803,6102.989969135809,138215.26813271613,1563,3,453.73333333333335,29,1,17,31.213410789876608,0.6587643678160919,42.986111111111114,1028.0555555555559,35.45019157088124,0
2467,4,0,1,29,0.0,0.03333333333333333,0.9666666666666667,30,800,400,400,0.5,12,4,8,455.2146226726928,0.373132183908046,-0.05102408282691884,0.2729444761855297,132219.38898533955,6037.639853395072,138257.02883873464,1564,4,454.73333333333335,29,1,17,31.17755458023858,0.6598419540229885,42.88194444444445,1028.4722222222226,35.46455938697319,0
2468,4,0,0,29,0.0,0.0,1.0,29,900,700,200,0.7777777777777778,11,7,4,457.16503854436496,0.37089490968801314,-0.032720092467732664,0.27460584530013876,132287.12511560318,6295.4097304796005,138582.53484608277,1565,5,464.48275862068965,28,1,17,31.058542830540055,0.6636904761904762,42.816091954022994,1028.7356321839086,36.74055829228245,0
2469,4,0,0,29,0.0,0.0,1.0,29,700,700,0,1.0,7,7,0,455.8343850907245,0.3713054187192118,-0.03657685327376792,0.27461242223758286,132398.00347222225,6270.312500000005,138668.31597222225,1566,6,465.48275862068965,28,1,17,30.98009446693658,0.6648065476190477,42.708333333333336,1029.1666666666667,36.75595238095239,0
2470,4,0,0,29,0.0,0.0,1.0,29,500,300,200,0.6,7,3,4,455.8343850907245,0.3713054187192118,-0.03657685327376792,0.27461242223758286,132398.00347222225,6270.312500000005,138668.31597222225,1567,7,466.48275862068965,28,1,17,30.98009446693658,0.6648065476190477,42.708333333333336,1029.1666666666667,36.75595238095239,0
2471,4,0,0,29,0.0,0.0,1.0,29,700,500,200,0.7142857142857143,9,5,4,455.54526953881907,0.37038177339901474,-0.03747142479004739,0.27497740996172204,132471.9481809024,6269.393868080339,138741.34204898274,1568,8,467.48275862068965,28,1,17,30.91242149337055,0.6655505952380952,42.63649425287357,1029.454022988506,36.76621510673236,0
2472,4,0,0,29,0.0,0.0,1.0,29,900,600,300,0.6666666666666666,12,6,6,445.18930075784704,0.3690989326765189,-0.01102170397140756,0.26603526726948135,132091.88102324252,5981.125128410443,138073.00615165295,1569,9,468.48275862068965,27,2,16,31.564852345107127,0.6651234567901234,43.00595238095237,1027.9761904761895,38.07319223985887,8
2473,4,1,0,30,0.03333333333333333,0.0,1.0,30,450,100,350,0.2222222222222222,8,1,7,435.92764945070735,0.3760775862068966,-0.016591971471254352,0.26288679609856497,132436.2936906532,5546.882750496009,137983.1764411492,1570,0,453.8333333333333,27,3,17,31.45345405040721,0.6685956790123457,42.67113095238094,1029.315476190475,38.12279541446204,0
2474,4,0,0,30,0.0,0.0,1.0,30,1000,800,200,0.8,12,8,4,436.21392445310966,0.3756944444444445,-0.021671722278395755,0.26467212962216274,132666.1512586805,5574.164496527772,138240.31575520828,1571,1,454.8333333333333,27,3,14,31.213136164475902,0.6709104938271605,42.447916666666664,1030.208333333333,38.15586419753085,0
2475,4,1,1,30,0.03225806451612903,0.03225806451612903,0.967741935483871,31,650,400,250,0.6153846153846154,9,4,5,423.84176100433746,0.37983870967741934,-0.016515410189594792,0.2596573245743295,133027.19150482223,5076.4958217730145,138103.68732659525,1572,0,441.1290322580645,28,3,15,31.16672469823585,0.6711309523809523,42.09770114942528,1031.6091954022984,36.84318555008208,0
2476,4,0,0,30,0.0,0.0,1.0,30,1150,900,250,0.782608695652174,14,9,5,435.18176906816973,0.37286877394636014,-0.009513497906741497,0.2651278904428505,132819.5003587372,5560.12502657312,138379.6253853103,1573,1,456.76666666666665,27,3,15,31.084434098455322,0.6724537037037037,42.29910714285714,1030.8035714285709,38.17791005291003,0
2477,4,0,0,30,0.0,0.0,1.0,30,500,300,200,0.6,7,3,4,435.73706306430637,0.37262931034482755,-0.002227353634483009,0.26601075858789236,132896.20812517713,5581.560684169499,138477.76880934663,1574,2,457.76666666666665,27,3,15,30.992477269447253,0.6732253086419753,42.22470238095238,1031.1011904761904,38.188932980599645,0
2478,4,0,0,30,0.0,0.0,1.0,30,1000,600,400,0.6,14,6,8,436.911074452111,0.37203065134099617,0.006682049802903656,0.26810100798680864,133088.07442247728,5629.53071853741,138717.60514101468,1575,3,458.76666666666665,27,3,16,30.76807518507836,0.6751543209876543,42.038690476190474,1031.8452380952378,38.216490299823626,0
2479,4,0,0,30,0.0,0.0,1.0,30,1000,800,200,0.8,12,8,4,434.69893246288586,0.37183908045977015,0.006159315845104096,0.2678455766809502,133241.66710955199,5584.002090419481,138825.66919997145,1576,4,459.76666666666665,27,3,17,30.66986163159412,0.6766975308641976,41.88988095238094,1032.440476190475,38.23853615520278,0
2480,4,0,1,29,0.0,0.03333333333333333,0.9666666666666667,30,550,300,250,0.5454545454545454,8,3,5,434.98741788404544,0.3712164750957854,0.004553314121037433,0.26857764057965067,133318.496669501,5598.37372448978,138916.8703939908,1577,5,460.76666666666665,27,3,17,30.58477425552354,0.6774691358024691,41.81547619047618,1032.7380952380943,38.24955908289238,0
2481,4,0,0,29,0.0,0.0,1.0,29,750,500,250,0.6666666666666666,10,5,5,447.3000990133009,0.36376231527093594,0.017612605180663543,0.27495800204052917,133153.48270080783,6111.91319920744,139265.39590001525,1578,6,476.0344827586207,26,3,18,30.433861642743224,0.6794871794871795,41.97530864197531,1032.0987654320988,39.69610636277303,0
2482,4,0,0,29,0.0,0.0,1.0,29,550,400,150,0.7272727272727273,7,4,3,445.28913602849445,0.3641215106732348,0.018302654928842088,0.274087909195179,133203.2606336806,6062.7929687500055,139266.0536024306,1579,7,477.0344827586207,27,2,18,30.435376723847963,0.6763117283950617,41.927083333333336,1032.291666666667,38.23302469135803,0
2483,4,0,0,29,0.0,0.0,1.0,29,800,500,300,0.625,11,5,6,447.3585861521979,0.36381362889983576,0.022816257577263244,0.2762160665388125,133318.49666950104,6128.2348356008915,139446.73150510192,1580,8,478.0344827586207,27,2,18,30.265369836695477,0.6774691358024691,41.81547619047618,1032.7380952380945,38.24955908289239,0
2484,4,0,0,29,0.0,0.0,1.0,29,950,700,250,0.7368421052631579,12,7,5,450.2879464427018,0.3630439244663382,0.024515810174936314,0.27978002460790485,133551.96663999383,6227.456737438903,139779.42337743274,1581,9,479.0344827586207,26,3,20,29.953593112371863,0.6834935897435898,41.5895061728395,1033.6419753086413,39.755460588793895,0
2485,4,0,0,29,0.0,0.0,1.0,29,850,600,250,0.7058823529411765,11,6,5,449.17442637558497,0.36181239737274223,0.024282038085434943,0.27969039560561504,133631.73487273275,6204.79157140679,139836.52644413954,1582,10,480.0344827586207,26,3,20,29.90174129353234,0.6842948717948718,41.51234567901234,1033.9506172839501,39.76733143399808,0
2486,4,0,0,29,0.0,0.0,1.0,29,500,300,200,0.6,7,3,4,449.73586744576426,0.3611453201970443,0.02833339336897711,0.280342330023634,133671.62791971496,6223.3851070720775,139895.01302678703,1583,11,481.0344827586207,26,3,20,29.846913396010535,0.6846955128205128,41.47376543209876,1034.1049382716046,39.77326685660018,0
2487,4,0,0,29,0.0,0.0,1.0,29,600,400,200,0.6666666666666666,8,4,4,454.2629591708866,0.36032430213464695,0.02881450086412629,0.2840838505859722,133791.34278311225,6355.290256820594,140146.63303993284,1584,12,482.0344827586207,26,3,15,29.608877784407312,0.6858974358974359,41.35802469135802,1034.5679012345672,39.79107312440643,0
2488,4,0,0,29,0.0,0.0,1.0,29,1250,1000,250,0.8,15,10,5,457.19579750448844,0.3599651067323481,0.03139843316266755,0.2871600570842797,133951.04595336074,6448.371056241424,140399.41700960216,1585,13,483.0344827586207,26,3,16,29.3716457960644,0.6875,41.2037037037037,1035.185185185185,39.81481481481481,0
2489,4,0,0,29,0.0,0.0,1.0,29,650,400,250,0.6153846153846154,9,4,5,456.2655657712598,0.36047824302134646,0.03021287746828394,0.2875115691916361,134070.8858453361,6434.385716735251,140505.27156207134,1586,14,484.0344827586207,26,3,16,29.274698256593645,0.6887019230769231,41.08796296296296,1035.6481481481483,39.83262108262109,0
2490,4,0,0,29,0.0,0.0,1.0,29,450,100,350,0.2222222222222222,8,1,7,457.0097354674742,0.36022167487684725,0.028430808433685284,0.2882941113212113,134110.8443834782,6457.992303002599,140568.8366864808,1587,15,485.0344827586207,26,3,16,29.215087405641643,0.6891025641025641,41.04938271604939,1035.802469135803,39.838556505223195,0
2491,4,0,0,29,0.0,0.0,1.0,29,600,500,100,0.8333333333333334,7,5,2,457.0097354674742,0.36022167487684725,0.028430808433685284,0.2882941113212113,134110.8443834782,6457.992303002599,140568.8366864808,1588,16,486.0344827586207,26,3,16,29.215087405641643,0.6891025641025641,41.04938271604939,1035.802469135803,39.838556505223195,0
2492,4,0,0,29,0.0,0.0,1.0,29,1150,800,350,0.6956521739130435,15,8,7,459.5343771161894,0.3596572249589491,0.025466718695446477,0.29115404497286107,134270.73807346437,6540.40399710409,140811.14207056846,1589,17,487.0344827586207,26,3,16,28.98829908675798,0.6907051282051282,40.895061728395056,1036.4197530864194,39.86229819563152,0
2493,4,0,0,29,0.0,0.0,1.0,29,1000,800,200,0.8,12,8,4,458.86356671666596,0.35837438423645324,0.02742002492729534,0.29296673874987134,134550.78125,6548.090277777777,141098.87152777778,1590,18,488.0344827586207,26,3,18,28.72322623828648,0.6935096153846154,40.625,1037.5,39.90384615384615,0
2494,4,0,0,29,0.0,0.0,1.0,29,1150,1000,150,0.8695652173913043,13,10,3,460.5101739175727,0.357502052545156,0.027229435676096925,0.29531477025200303,134710.93690462588,6607.15139650969,141318.08830113558,1591,19,489.0344827586207,26,3,18,28.519089737872267,0.6951121794871795,40.470679012345684,1038.1172839506178,39.92758784425453,0
2495,4,0,0,29,0.0,0.0,1.0,29,1000,700,300,0.7,13,7,6,462.7391931185679,0.3579125615763547,0.032966132089972566,0.29772798945391626,134831.11615988426,6678.328379820161,141509.44453970442,1592,20,490.0344827586207,26,3,16,28.3401436354631,0.6963141025641026,40.354938271604944,1038.580246913581,39.94539411206081,0
2496,4,0,0,29,0.0,0.0,1.0,29,900,700,200,0.7777777777777778,11,7,4,461.63670145353893,0.35729679802955666,0.029018165801994344,0.29800574409268255,134951.34899881884,6659.699121704021,141611.04812052287,1593,21,491.0344827586207,26,3,17,28.247685528986583,0.6975160256410257,40.2391975308642,1039.0432098765436,39.96320037986706,0
2497,4,0,0,29,0.0,0.0,1.0,29,800,500,300,0.625,11,5,6,459.1395860720713,0.35719417077175697,0.026179457777049775,0.2973811780559109,135071.63542142973,6603.346955494602,141674.98237692434,1594,22,492.0344827586207,26,3,17,28.19149594220111,0.6987179487179487,40.12345679012346,1039.5061728395067,39.98100664767333,0
2498,4,0,0,29,0.0,0.0,1.0,29,950,700,250,0.7368421052631579,12,7,5,459.1041187387508,0.35719417077175697,0.025830088368784976,0.29835126867699546,135191.97542771688,6613.438547858572,141805.41397557544,1595,23,493.0344827586207,26,3,17,28.071363209180397,0.6999198717948718,40.00771604938272,1039.9691358024697,39.998812915479604,0
2499,4,0,0,29,0.0,0.0,1.0,29,950,800,150,0.8421052631578947,11,8,3,460.8369682050477,0.3576559934318555,0.02697850006905722,0.3001451210309397,135272.2318672839,6667.689043209866,141939.92091049376,1596,24,494.0344827586207,26,3,17,27.945594125500655,0.7007211538461539,39.93055555555555,1040.2777777777774,40.01068376068375,0
2500,4,0,0,29,0.0,0.0,1.0,29,600,300,300,0.5,9,3,6,460.8369682050477,0.3576559934318555,0.02697850006905722,0.3001451210309397,135272.2318672839,6667.689043209866,141939.92091049376,1597,25,495.0344827586207,26,3,17,27.945594125500655,0.7007211538461539,39.93055555555555,1040.2777777777774,40.01068376068375,0
2501,4,0,0,29,0.0,0.0,1.0,29,750,600,150,0.8,9,6,3,459.9530980535364,0.3572454844006568,0.03337305098007137,0.30023850340513036,135352.51212181838,6651.161455951846,142003.6735777702,1598,26,496.0344827586207,26,3,17,27.88787137278164,0.7015224358974359,39.8533950617284,1040.5864197530868,40.022554605887954,0
2502,4,0,0,29,0.0,0.0,1.0,29,950,600,350,0.631578947368421,13,6,7,455.99999999999943,0.3561165845648604,0.03475862068965463,0.30000000000000004,135633.68055555582,6569.791666666702,142203.47222222254,1599,27,497.0344827586207,26,3,18,27.708333333333332,0.7043269230769231,39.58333333333335,1041.6666666666688,40.06410256410265,0
2503,4,0,0,29,0.0,0.0,1.0,29,650,600,50,0.9230769230769231,7,6,1,456.89550515851505,0.3554495073891626,0.033813636804764347,0.30092698100733034,135673.87128962815,6597.756391937203,142271.62768156535,1600,28,498.0344827586207,26,3,18,27.644669925443136,0.7047275641025641,39.54475308641975,1041.8209876543212,40.07003798670466,0
2504,4,0,0,29,0.0,0.0,1.0,29,600,400,200,0.6666666666666666,8,4,4,456.89550515851505,0.3554495073891626,0.033813636804764347,0.30092698100733034,135673.87128962815,6597.756391937203,142271.62768156535,1601,29,499.0344827586207,26,3,18,27.644669925443136,0.7047275641025641,39.54475308641975,1041.8209876543212,40.07003798670466,0
2505,4,0,0,29,0.0,0.0,1.0,29,700,600,100,0.8571428571428571,8,6,2,453.11264016743434,0.3555008210180624,0.03511584450593763,0.2994444982084981,135794.4792142966,6506.038999390337,142300.51821368694,1602,30,500.0344827586207,26,3,18,27.62221152897049,0.7059294871794872,39.42901234567901,1042.2839506172838,40.08784425451092,0
2506,4,0,0,29,0.0,0.0,1.0,29,700,600,100,0.8571428571428571,8,6,2,451.0830314031166,0.3555521346469623,0.03169044641261887,0.2984393611290946,135834.69376333652,6454.545086495985,142289.2388498325,1603,31,501.0344827586207,26,3,18,27.6347767086109,0.7063301282051282,39.390432098765444,1042.4382716049395,40.093779677113055,0
2507,4,0,0,29,0.0,0.0,1.0,29,650,400,250,0.6153846153846154,9,4,5,451.7806220897019,0.3554495073891626,0.03448786188524822,0.29957621820020763,135915.14072264137,6480.76536541686,142395.90608805823,1604,32,502.0344827586207,26,3,16,27.535950372453264,0.7071314102564102,39.31327160493827,1042.7469135802469,40.10565052231719,0
2508,4,0,0,29,0.0,0.0,1.0,29,500,300,200,0.6,7,3,4,450.8325339848691,0.3550389983579639,0.03315120069792021,0.29962410002003226,135995.6114969135,6462.249228395054,142457.86072530856,1605,33,503.0344827586207,26,3,16,27.480026631158456,0.7079326923076923,39.23611111111111,1043.055555555555,40.11752136752135,0
2509,4,0,0,29,0.0,0.0,1.0,29,1150,700,450,0.6086956521739131,16,7,9,427.26618023771067,0.3539614121510673,0.03655412711762551,0.26046175388322634,132841.98137551194,5551.777191504816,138393.75856701675,1606,34,504.0344827586207,28,1,17,31.265679442508706,0.6692708333333333,42.27729885057471,1030.890804597701,36.81752873563217,8
2510,4,0,0,29,0.0,0.0,1.0,29,500,300,200,0.6,7,3,4,428.67322150517657,0.35329433497536944,0.03617878952400644,0.2618372519780978,132916.0499446755,5595.510263905388,138511.5602085809,1607,35,505.0344827586207,28,1,17,31.154498165435882,0.6700148809523809,42.205459770114935,1031.178160919539,36.82779146141211,0
2511,4,0,0,29,0.0,0.0,1.0,29,900,700,200,0.7777777777777778,11,7,4,428.70575791901865,0.35319170771756975,0.03431942429454016,0.2621166891262958,132953.0919705376,5599.551212181252,138552.64318271886,1608,36,506.0344827586207,28,1,17,31.116199962849446,0.6703869047619048,42.16954022988505,1031.3218390804589,36.8329228243021,0
2512,4,1,0,30,0.03333333333333333,0.0,1.0,30,650,400,250,0.6153846153846154,9,4,5,415.63982145463604,0.3573994252873563,0.04102460669624852,0.2569504033381653,133364.60503472228,5086.3281250000055,138450.93315972228,1609,0,490.1333333333333,29,1,18,31.03780086056206,0.6713362068965517,41.770833333333336,1032.916666666667,35.61781609195403,0
2513,4,0,0,30,0.0,0.0,1.0,30,550,500,50,0.9090909090909091,6,5,1,413.8636287965464,0.35718390804597705,0.03698826480336814,0.25709291531752054,133543.9911265431,5053.800154320972,138597.79128086407,1610,1,491.1333333333333,29,1,20,30.902871092000357,0.673132183908046,41.597222222222214,1033.6111111111102,35.641762452107244,0
2514,4,0,0,30,0.0,0.0,1.0,30,800,600,200,0.75,10,6,4,416.4651080040594,0.356992337164751,0.03757722266988983,0.2597151753934864,133687.5868055556,5135.24305555556,138822.82986111115,1611,2,492.1333333333333,29,1,20,30.690975020145036,0.6745689655172413,41.458333333333336,1034.166666666667,35.6609195402299,0
2515,4,0,0,30,0.0,0.0,1.0,30,550,400,150,0.7272727272727273,7,4,3,417.20987677110537,0.35732758620689653,0.035320443967060244,0.26068617132476435,133759.41358024685,5161.149691358019,138920.56327160486,1612,3,493.1333333333333,29,1,17,30.599377909058354,0.6752873563218391,41.388888888888886,1034.4444444444441,35.670498084291175,0
2516,4,0,0,30,0.0,0.0,1.0,30,750,600,150,0.8,9,6,3,407.1999990486259,0.35737547892720306,0.02809887313704107,0.22908122645864418,129766.82098765443,4581.2500000000155,134348.07098765444,1613,4,494.1333333333333,29,1,18,34.90548891312251,0.6350574712643677,45.277777777777786,1018.8888888888897,35.134099616858265,8
2517,4,0,1,29,0.0,0.03333333333333333,0.9666666666666667,30,850,700,150,0.8235294117647058,10,7,3,407.6330220940708,0.3574473180076629,0.023713494118181355,0.2299476363680543,129872.9769483026,4588.102816358045,134461.07976466065,1614,5,495.1333333333333,29,1,18,34.78604600990144,0.6361350574712643,45.17361111111112,1019.3055555555566,35.14846743295023,0
2518,4,0,0,29,0.0,0.0,1.0,29,1050,700,350,0.6666666666666666,14,7,7,420.3836849065934,0.35360221674876846,0.03041910113451851,0.23705897144096794,129859.55253335992,5118.167442859053,134977.71997621897,1615,43,513.0344827586207,28,1,19,34.47484963819189,0.6391369047619048,45.186781609195414,1019.2528735632197,36.40188834154356,0
2519,4,0,0,29,0.0,0.0,1.0,29,900,500,400,0.5555555555555556,13,5,8,421.05154752873153,0.35355090311986864,0.02790096711047174,0.23855107229899983,130042.67251701021,5150.933701611845,135193.60621862207,1616,44,514.0344827586207,28,1,20,34.27067192562333,0.6409970238095238,45.00718390804598,1019.9712643678165,36.42754515599345,0
2520,4,0,0,29,0.0,0.0,1.0,29,500,300,200,0.6,7,3,4,422.50362117051253,0.3532430213464696,0.032759348890949,0.24027567823652132,130189.26139929322,5201.086875743167,135390.34827503638,1617,45,515.0344827586207,28,1,20,34.08389647566755,0.6424851190476191,44.86350574712644,1020.5459770114946,36.44807060755338,0
2521,4,0,0,29,0.0,0.0,1.0,29,700,600,100,0.8571428571428571,8,6,2,420.5509604906096,0.3538074712643678,0.03034832147675104,0.23984230539697188,130299.25724996685,5159.495557537306,135458.75280750415,1618,46,516.0344827586207,28,1,20,34.02142555586828,0.6436011904761905,44.75574712643677,1020.9770114942519,36.463464696223284,0
2522,4,0,1,28,0.0,0.034482758620689655,0.9655172413793104,29,700,500,200,0.7142857142857143,9,5,4,422.1556103628486,0.3532430213464696,0.0276579954501579,0.24144040499352296,130409.2995483221,5210.603489562694,135619.9030378848,1619,47,517.0344827586207,28,1,20,33.8681600787734,0.6447172619047619,44.64798850574713,1021.4080459770115,36.47885878489327,0
2523,4,0,0,28,0.0,0.0,1.0,28,750,600,150,0.8,9,6,3,431.30399845488716,0.3494543650793651,0.038618055411002716,0.24646455798467032,130376.54400953093,5646.384947208053,136022.928956739,1620,48,531.6071428571429,27,1,21,33.66800840254504,0.6477623456790124,44.680059523809526,1021.2797619047622,37.825176366843046,0
2524,4,0,0,28,0.0,0.0,1.0,28,850,500,350,0.5882352941176471,12,5,7,431.50946048992967,0.3489307760141094,0.04268444925304782,0.2473075088250298,130490.55103812355,5661.581455498863,136152.13249362243,1621,49,532.6071428571429,27,1,18,33.54633945043208,0.6489197530864197,44.56845238095238,1021.7261904761903,37.84171075837742,0
2525,4,0,0,28,0.0,0.0,1.0,28,550,400,150,0.7272727272727273,7,4,3,433.26537617943814,0.3481316137566137,0.037721232036270536,0.24904601414029817,130604.60789133374,5717.290913761357,136321.8988050951,1622,50,533.6071428571429,27,1,18,33.385045130295524,0.6500771604938271,44.45684523809525,1022.1726190476201,37.85824514991185,0
2526,4,1,0,29,0.034482758620689655,0.0,1.0,29,900,600,300,0.6666666666666666,12,6,6,416.90782806808204,0.3555521346469623,0.038222785618555744,0.24255527270540608,131070.52873976105,5128.8658921258,136199.39463188685,1623,0,516.1724137931035,28,1,20,33.3286562836163,0.6514136904761905,44.00143678160921,1023.9942528735647,36.57122331691303,0
2527,4,0,0,29,0.0,0.0,1.0,29,1100,1000,100,0.9090909090909091,12,10,2,411.9879154059542,0.3552955665024631,0.03627168468485875,0.24084408300616938,131254.5002642358,5015.053590302559,136269.55385453836,1624,1,517.1724137931035,28,1,20,33.26760843148252,0.6532738095238095,43.821839080459775,1024.7126436781616,36.596880131362916,0
2528,4,1,0,30,0.03333333333333333,0.0,1.0,30,1250,900,350,0.72,16,9,7,397.82697920971793,0.3621408045977012,0.03276522836917839,0.23585684501182394,131791.20611496916,4486.019483024697,136277.22559799385,1625,0,500.9,29,1,20,33.08633730105055,0.6555316091954023,43.298611111111114,1026.8055555555557,35.407088122605366,0
2529,4,0,0,30,0.0,0.0,1.0,30,750,500,250,0.6666666666666666,10,5,5,395.5169533715421,0.36271551724137935,0.03509127789046618,0.23492753977369923,131862.521701389,4430.772569444455,136293.29427083346,1626,1,501.9,29,1,20,33.07344489519946,0.65625,43.22916666666667,1027.0833333333342,35.41666666666669,0
2530,4,0,0,30,0.0,0.0,1.0,30,850,600,250,0.7058823529411765,11,6,5,397.772096420745,0.36125478927203064,0.023603603603603585,0.23738012205754153,132040.89506172852,4504.43672839508,136545.3317901236,1627,2,502.9,29,1,20,32.83502252252253,0.6580459770114943,43.055555555555564,1027.7777777777787,35.44061302681995,0
2531,4,1,0,31,0.03225806451612903,0.0,1.0,31,750,700,50,0.9333333333333333,8,7,1,384.1103901095412,0.36778673835125447,0.023193118728885853,0.23161554074479282,132432.58794369304,3973.746603653625,136406.33454734666,1628,0,487.64516129032256,30,1,21,32.79060024375382,0.6590277777777778,42.67473118279571,1029.3010752688183,34.31003584229394,0
2532,4,0,0,31,0.0,0.0,1.0,31,800,600,200,0.75,10,6,4,382.94082997947834,0.367921146953405,0.02068288903579507,0.23154772679343227,132536.36845661365,3950.7173878483277,136487.08584446198,1629,1,488.64516129032256,30,1,21,32.716029239002744,0.6600694444444444,42.57392473118281,1029.70430107527,34.323476702509,0
2533,4,0,1,30,0.0,0.03225806451612903,0.967741935483871,31,600,300,300,0.5,9,3,6,382.6491677549232,0.3686827956989247,0.019687309302863776,0.2322253262740687,132674.80570369415,3953.580796912948,136628.3865006071,1630,2,489.64516129032256,30,1,20,32.583985649054135,0.6614583333333333,42.43951612903226,1030.2419354838717,34.34139784946239,0
2534,4,0,0,30,0.0,0.0,1.0,30,700,500,200,0.7142857142857143,9,5,4,389.0649567893339,0.3658285440613027,0.03395319588554968,0.23685406434238304,132791.3797260804,4332.894483024715,137124.27420910512,1631,3,499.9,29,1,20,32.30121165161928,0.6655890804597702,42.3263888888889,1030.6944444444457,35.541187739463645,0
2535,4,1,1,30,0.03225806451612903,0.03225806451612903,0.967741935483871,31,800,600,200,0.75,10,6,4,376.3027356423294,0.37150537634408604,0.038313275272736425,0.2320030188767556,133263.97018441436,3829.5193085905876,137093.48949300495,1632,0,484.741935483871,30,1,21,32.15471231450144,0.6673611111111111,41.86827956989247,1032.5268817204299,34.41756272401433,0
2536,4,0,0,30,0.0,0.0,1.0,30,1250,1000,250,0.8,15,10,5,401.06896506566005,0.36637931034482757,0.08983154403421456,0.2374701360598069,131741.75663371477,4567.505997803195,136309.26263151798,1633,1,501.76666666666665,30,0,18,33.053209828052715,0.6520833333333333,43.34677419354838,1026.6129032258054,34.220430107526845,8
2537,4,0,0,30,0.0,0.0,1.0,30,450,300,150,0.6666666666666666,6,3,3,399.95785477371794,0.366139846743295,0.08845549738219871,0.23724208155832321,131810.75846918713,4543.749638686542,136354.50810787367,1634,2,502.76666666666665,30,0,18,33.01183464223384,0.6527777777777778,43.27956989247311,1026.881720430107,34.229390681003565,0
2538,4,0,0,30,0.0,0.0,1.0,30,700,400,300,0.5714285714285714,10,4,6,400.6787656463962,0.36678639846743294,0.09261197610013538,0.2383181171856346,131914.29509553118,4571.05138599837,136485.34648152956,1635,3,503.76666666666665,30,0,19,32.88848183523049,0.6538194444444445,43.17876344086021,1027.2849462365584,34.242831541218614,0
2539,4,1,0,31,0.03225806451612903,0.0,1.0,31,750,600,150,0.8,9,6,3,390.53997756769763,0.37240143369175627,0.08231931400571657,0.23444269170097337,132264.0313042534,4130.878363715274,136394.9096679687,1636,0,488.48387096774195,31,0,20,32.79535864978902,0.6545698924731183,42.838541666666664,1028.645833333333,33.18212365591397,0
2540,4,0,0,31,0.0,0.0,1.0,31,750,500,250,0.6666666666666666,10,5,5,390.4355046172345,0.3723566308243728,0.07810835411624018,0.23500470624447856,132364.5040724012,4135.960388183589,136500.4644605848,1637,1,489.48387096774195,31,0,21,32.69657619469399,0.6555779569892473,42.740885416666664,1029.036458333333,33.194724462365585,0
2541,4,1,1,31,0.03125,0.03125,0.96875,32,800,400,400,0.5,12,4,8,381.5310164097273,0.37621807795698925,0.07508733758274078,0.2312429444183178,132625.5053693502,3720.148773084395,136345.6541424346,1638,0,475.15625,32,0,15,32.66246833374193,0.6555989583333333,42.487373737373744,1030.050505050506,32.18907828282831,0
2542,4,2,0,33,0.06060606060606061,0.0,1.0,33,900,700,200,0.7777777777777778,11,7,4,370.68572187543896,0.3819049873737374,0.0802897110808729,0.22710570645905723,133029.37121539802,3262.4176999231177,136291.78891532114,1639,0,461.6969696969697,33,0,17,32.53543993030807,0.6571969696969697,42.09558823529412,1031.6176470588243,31.261140819964375,0
2543,4,0,1,32,0.0,0.030303030303030304,0.9696969696969697,33,650,400,250,0.6153846153846154,9,4,5,369.4934002201282,0.3817471590909091,0.08003541772397904,0.22656700192667595,133060.9790254951,3233.0307153498757,136294.00974084498,1640,1,462.6969696969697,33,0,17,32.534421150572115,0.6575126262626263,42.06495098039216,1031.740196078432,31.264854426619152,0
2544,4,1,1,32,0.030303030303030304,0.030303030303030304,0.9696969696969697,33,1000,700,300,0.7,13,7,6,371.9157164367037,0.3826546717171717,0.08487006564157906,0.22921652604090914,133250.7047319541,3311.606263216075,136562.31099517015,1641,0,463.54545454545456,33,0,19,32.28128090999011,0.6594065656565656,41.881127450980394,1032.4754901960787,31.287136066547838,0
2545,4,0,2,30,0.0,0.0625,0.9375,32,1050,800,250,0.7619047619047619,13,8,5,418.0683095309888,0.37754116263440857,-0.00248691099476428,0.24798461838639402,131810.75846918722,4745.118403104088,136555.8768722913,1642,1,478.75,30,2,16,32.5469022687609,0.6527777777777778,43.27956989247312,1026.8817204301076,34.229390681003586,8
2546,4,0,1,29,0.0,0.03333333333333333,0.9666666666666667,30,900,700,200,0.7777777777777778,11,7,4,429.2721679092823,0.3648227969348659,0.04563159318366217,0.2547382351140636,131826.86149691354,5317.9205246913525,137144.7820216049,1643,4,511.53333333333336,29,1,16,32.24292218916238,0.6558908045977012,43.263888888888886,1026.9444444444441,35.411877394636,0
2547,4,1,0,30,0.03333333333333333,0.0,1.0,30,800,700,100,0.875,9,7,2,429.1463760168808,0.36475095785440614,0.06001080788975921,0.2565865488915147,132112.2781635803,5339.101080246919,137451.37924382722,1644,0,512.3666666666667,29,1,18,31.956453210843915,0.6587643678160919,42.986111111111114,1028.0555555555559,35.45019157088124,0
2548,4,0,0,30,0.0,0.0,1.0,30,850,500,350,0.5882352941176471,12,5,7,431.8304025502763,0.36496647509578545,0.05974604889909463,0.2584349612028858,132147.97694830253,5413.102816358032,137561.07976466056,1645,1,513.3666666666667,29,1,18,31.851248367778833,0.6591235632183908,42.95138888888889,1028.194444444445,35.454980842911894,0
2549,4,0,0,30,0.0,0.0,1.0,30,900,600,300,0.6666666666666666,12,6,6,430.95521040822126,0.36436781609195407,0.06517278617710587,0.2591328083363722,132326.54320987663,5405.362654321004,137731.90586419764,1646,2,514.3666666666667,29,1,19,31.69265208783298,0.6609195402298851,42.777777777777786,1028.8888888888896,35.47892720306516,0
2550,4,0,0,30,0.0,0.0,1.0,30,200,0,200,0.0,4,0,4,430.95521040822126,0.36436781609195407,0.06517278617710587,0.2591328083363722,132326.54320987663,5405.362654321004,137731.90586419764,1647,3,515.3666666666667,29,1,19,31.69265208783298,0.6609195402298851,42.777777777777786,1028.8888888888896,35.47892720306516,0
2551,4,0,0,30,0.0,0.0,1.0,30,550,200,350,0.36363636363636365,9,2,7,429.00663212707724,0.3637931034482758,0.06323796231681778,0.25895808923256197,132471.94818090243,5366.288158203794,137838.23633910622,1648,4,516.3666666666667,28,2,20,31.595429169574324,0.6655505952380952,42.63649425287357,1029.4540229885063,36.76621510673237,0
2552,4,0,0,30,0.0,0.0,1.0,30,800,600,200,0.75,10,6,4,429.00663212707724,0.3637931034482758,0.06323796231681778,0.25895808923256197,132471.94818090243,5366.268868080338,137838.21704898277,1649,5,517.3666666666667,28,2,20,31.595429169574324,0.6655505952380952,42.63649425287357,1029.4540229885063,36.76621510673237,0
2553,4,0,0,30,0.0,0.0,1.0,30,650,400,250,0.6153846153846154,9,4,5,433.2277495278149,0.3625478927203065,0.0639373227321336,0.2625367486360865,132619.89952850438,5490.924123067769,138110.82365157214,1650,6,518.3666666666667,28,2,20,31.336890314781236,0.6670386904761905,42.49281609195402,1030.0287356321835,36.786740558292266,0
2554,4,1,0,31,0.03225806451612903,0.0,1.0,31,1150,500,650,0.43478260869565216,18,5,13,419.8636127123008,0.371415770609319,0.06177187048141741,0.257569511051997,133077.83805941363,4974.908371913589,138052.74643132722,1651,0,502.61290322580646,29,2,18,31.218170906806662,0.6684626436781609,42.048611111111114,1031.8055555555559,35.579501915708825,0
2555,4,0,0,31,0.0,0.0,1.0,31,1000,500,500,0.5,15,5,10,417.0793321397569,0.3719086021505376,0.05745127688172058,0.25666420439369664,133194.58896982312,4910.542042432656,138105.13101225576,1652,1,503.61290322580646,30,1,18,31.172146267361114,0.6666666666666667,41.935483870967744,1032.2580645161293,34.40860215053764,0
2556,4,0,0,31,0.0,0.0,1.0,31,1000,800,200,0.8,12,8,4,421.24799222627166,0.3719086021505376,0.055118374751199184,0.2597132484977702,133263.97018441427,5027.435975257238,138291.40615967152,1653,2,504.61290322580646,30,1,18,30.99453267378287,0.6673611111111111,41.868279569892465,1032.5268817204292,34.4175627240143,0
2557,4,0,0,31,0.0,0.0,1.0,31,1200,1000,200,0.8333333333333334,14,10,4,425.2125566800319,0.37150537634408604,0.05149706630404638,0.26313878507590394,133402.786810614,5144.908009596486,138547.69482021048,1654,3,505.61290322580646,30,1,18,30.75207086477579,0.66875,41.733870967741936,1033.0645161290327,34.43548387096776,0
2558,4,0,0,31,0.0,0.0,1.0,31,450,300,150,0.6666666666666666,6,3,3,426.3137356919874,0.371236559139785,0.05385015608740895,0.2643145161290324,133472.22222222228,5180.208333333344,138652.43055555562,1655,4,506.61290322580646,30,1,18,30.653561827956988,0.6694444444444445,41.66666666666667,1033.333333333334,34.444444444444464,0
2559,4,0,0,31,0.0,0.0,1.0,31,850,700,150,0.8235294117647058,10,7,3,424.14542418642054,0.3707885304659498,0.05685740769479186,0.26371078879690873,133576.40921277023,5131.164549369863,138707.5737621401,1656,5,507.61290322580646,30,1,19,30.60449443071989,0.6704861111111111,41.56586021505376,1033.7365591397847,34.45788530465949,0
2560,4,0,0,31,0.0,0.0,1.0,31,900,500,400,0.5555555555555556,13,5,8,424.7867762202658,0.3703853046594982,0.05012052233331277,0.26510415596228265,133715.38843002077,5160.105756445829,138875.4941864666,1657,6,508.61290322580646,30,1,18,30.44780160277236,0.671875,41.431451612903224,1034.2741935483868,34.4758064516129,0
2561,4,0,0,31,0.0,0.0,1.0,31,1250,1000,250,0.8,15,10,5,425.3155341067358,0.36998207885304657,0.05052841542419917,0.2661852830531423,133819.67026534854,5183.116906578792,139002.78717192734,1658,7,509.61290322580646,30,1,18,30.32903568026328,0.6729166666666666,41.33064516129032,1034.6774193548383,34.489247311827945,0
2562,4,0,0,31,0.0,0.0,1.0,31,1100,800,300,0.7272727272727273,14,8,6,422.1930536819755,0.37105734767025095,0.050564432385354685,0.26573327496453747,134028.3558792924,5117.168169730598,139145.524049023,1659,8,510.61290322580646,30,1,18,30.199679820006914,0.675,41.12903225806451,1035.4838709677417,34.51612903225806,0
2563,4,0,0,31,0.0,0.0,1.0,31,550,400,150,0.7272727272727273,7,4,3,417.4209314606917,0.37069892473118277,0.04591794030500318,0.2637279130900831,134167.5699502834,5000.8704040929715,139168.44035437636,1660,9,511.61290322580646,30,1,18,30.183197111226423,0.6763888888888889,40.99462365591398,1036.021505376345,34.5340501792115,0
2564,4,0,0,31,0.0,0.0,1.0,31,1300,1100,200,0.8461538461538461,15,11,4,420.24217794976005,0.37069892473118277,0.04049825993842893,0.26652201285761085,134306.85628396343,5088.2811596716365,139395.13744363506,1661,10,512.6129032258065,30,1,18,29.97006829183956,0.6777777777777778,40.86021505376344,1036.559139784946,34.55197132616487,0
2565,4,0,0,31,0.0,0.0,1.0,31,700,300,400,0.42857142857142855,11,3,8,409.43206805955106,0.3700716845878136,0.05121437498361314,0.24025656012842647,131399.31520061722,4566.34038055137,135965.6555811686,1662,11,513.6129032258065,29,2,18,33.18601553327914,0.6515804597701149,43.68055555555555,1025.2777777777771,35.354406130268174,8
2566,4,0,1,30,0.0,0.03225806451612903,0.967741935483871,31,750,400,350,0.5333333333333333,11,4,7,404.4990367848832,0.3693100358422939,0.051922077581802784,0.23847042176615563,131577.3750964506,4444.584297839503,136021.95939429008,1663,12,514.6129032258065,29,2,17,33.13182505302108,0.6533764367816092,43.50694444444444,1025.972222222222,35.37835249042145,0
2567,4,0,0,30,0.0,0.0,1.0,30,1250,1100,150,0.88,14,11,3,402.10826722387367,0.36779214559386975,0.014207132873439221,0.23839506171500352,131791.20611496893,4598.866705246891,136390.0728202158,1664,13,481.46666666666664,29,1,17,32.97643604310385,0.6555316091954023,43.2986111111111,1026.8055555555538,35.4070881226053,0
2568,4,0,0,30,0.0,0.0,1.0,30,800,500,300,0.625,11,5,6,403.2625617723097,0.3657806513409962,0.020061269540928794,0.24043027353370794,132005.21074459856,4646.551890432072,136651.76263503064,1665,14,482.46666666666664,29,1,18,32.730070505023214,0.6576867816091954,43.090277777777764,1027.6388888888873,35.43582375478922,0
2569,4,0,0,30,0.0,0.0,1.0,30,800,600,200,0.75,10,6,4,401.4745758729454,0.3657327586206896,0.017146331576813667,0.2398154427793116,132076.58420138896,4605.0781250000055,136681.66232638896,1666,15,483.46666666666664,29,1,18,32.703773138765015,0.6584051724137931,43.020833333333336,1027.9166666666672,35.445402298850595,0
2570,4,0,0,30,0.0,0.0,1.0,30,600,400,200,0.6666666666666666,8,4,4,401.0097481146029,0.3656609195402299,0.020475418692598613,0.24021651901622312,132183.68055555547,4601.388888888882,136785.06944444435,1667,16,484.46666666666664,29,1,18,32.60737439222042,0.6594827586206897,42.916666666666664,1028.3333333333328,35.45977011494251,0
2571,4,0,0,30,0.0,0.0,1.0,30,800,600,200,0.75,10,6,4,398.48345609673044,0.3648946360153256,0.015460763138948952,0.2396075846399822,132326.54320987663,4545.987654321004,136872.53086419764,1668,17,485.46666666666664,29,1,18,32.52789776817855,0.6609195402298851,42.777777777777786,1028.8888888888896,35.47892720306516,0
2572,4,0,0,30,0.0,0.0,1.0,30,850,700,150,0.8235294117647058,10,7,3,400.04118115953213,0.364272030651341,0.015848174132037984,0.24145808100606284,132469.4830246913,4598.649691358019,137068.1327160493,1669,18,486.46666666666664,29,1,19,32.343384601547044,0.6623563218390804,42.638888888888886,1029.4444444444441,35.49808429118773,0
2573,4,0,0,30,0.0,0.0,1.0,30,1050,900,150,0.8571428571428571,12,9,3,399.00973510446806,0.36396072796934864,0.017766086604613207,0.24106431673426415,132505.23003472216,4574.175347222218,137079.40538194438,1670,19,487.46666666666664,29,1,19,32.33382233913396,0.6627155172413793,42.604166666666664,1029.583333333333,35.50287356321838,0
2574,4,0,1,29,0.0,0.03333333333333333,0.9666666666666667,30,950,600,350,0.631578947368421,13,6,7,398.1420387302186,0.3642480842911877,0.013268608414239269,0.24122723523066186,132612.5,4559.722222222223,137172.22222222222,1671,20,488.46666666666664,29,1,19,32.24784250269686,0.6637931034482758,42.5,1030.0,35.51724137931034,0
2575,4,0,0,29,0.0,0.0,1.0,29,450,400,50,0.8888888888888888,5,4,1,408.21664683344767,0.3634031198686371,-0.003416516692811733,0.2466509689045939,132508.92827652252,5018.470075307158,137527.39835182967,1345,21,448.6896551724138,28,1,19,32.09310168387758,0.6659226190476191,42.60057471264367,1029.5977011494242,36.771346469622294,0
2576,4,1,0,30,0.03333333333333333,0.0,1.0,30,1100,800,300,0.7272727272727273,14,8,6,395.3985273424786,0.37037835249042145,-0.0016608313134034436,0.24186404151937774,132970.38001543202,4515.25848765431,137485.63850308632,1346,0,434.7,29,1,19,31.95753658317622,0.6673850574712643,42.15277777777777,1031.3888888888882,35.565134099616834,0
2577,4,0,0,30,0.0,0.0,1.0,30,200,0,200,0.0,4,0,4,395.3985273424786,0.37037835249042145,-0.0016608313134034436,0.24186404151937774,132970.38001543202,4515.25848765431,137485.63850308632,1347,1,435.7,29,1,19,31.95753658317622,0.6673850574712643,42.15277777777777,1031.3888888888882,35.565134099616834,0
2578,4,0,0,30,0.0,0.0,1.0,30,900,800,100,0.8888888888888888,10,8,2,396.79448744586057,0.3687021072796935,-0.0031852848811131373,0.24365149105146652,133113.6670524691,4563.753858024685,137677.4209104938,1348,2,436.7,29,1,20,31.777142216240463,0.6688218390804598,42.013888888888886,1031.9444444444443,35.58429118773946,0
2579,4,0,0,30,0.0,0.0,1.0,30,650,500,150,0.7692307692307693,8,5,3,395.89251391363325,0.3680555555555556,-0.001547570986408342,0.24333145334096012,133149.5008680555,4542.578124999995,137692.0789930555,1349,3,437.7,29,1,20,31.764315031624278,0.6691810344827587,41.979166666666664,1032.083333333333,35.5890804597701,0
2580,4,0,0,30,0.0,0.0,1.0,30,950,800,150,0.8421052631578947,11,8,3,395.0763490304672,0.3681752873563218,0.003631961259079386,0.24353213753669095,133257.03125000003,4529.340277777778,137786.3715277778,1350,4,438.7,29,1,20,31.677091740651065,0.6702586206896552,41.875,1032.5000000000002,35.60344827586208,0
2581,4,0,0,30,0.0,0.0,1.0,30,950,700,250,0.7368421052631579,12,7,5,393.8330821697782,0.3677442528735632,-0.004347046697140922,0.24370469760223054,133400.47260802478,4507.503858024699,137907.97646604947,1351,5,439.7,29,1,20,31.564824773684684,0.6716954022988506,41.736111111111114,1033.055555555556,35.6226053639847,0
2582,4,0,0,30,0.0,0.0,1.0,30,700,400,300,0.5714285714285714,10,4,6,394.1207075962541,0.36779214559386975,-0.003225806451612634,0.24435483870967745,133472.22222222216,4520.833333333329,137993.0555555555,1352,6,440.7,29,1,21,31.48521505376344,0.6724137931034483,41.666666666666664,1033.333333333333,35.63218390804597,0
2583,4,0,0,30,0.0,0.0,1.0,30,500,300,200,0.6,7,3,4,393.65522184645204,0.3682231800766283,0.004903936584710111,0.2447765928323428,133579.88281250003,4516.883680555557,138096.7664930556,1353,7,441.7,29,1,22,31.388972860405744,0.6734913793103448,41.5625,1033.7500000000002,35.646551724137936,0
2584,4,0,0,30,0.0,0.0,1.0,30,750,500,250,0.6666666666666666,10,5,5,394.1553032062752,0.3680795019157088,0.0022610252966195343,0.24556370145361656,133651.6806520061,4535.903742283941,138187.58439429002,1354,8,442.7,29,1,23,31.30386724871278,0.6742097701149425,41.49305555555555,1034.0277777777771,35.65613026819921,0
2585,4,0,0,30,0.0,0.0,1.0,30,850,600,250,0.7058823529411765,11,6,5,393.72201368013725,0.3673132183908046,0.00046986172640584023,0.2462498135938995,133795.33420138888,4535.633680555552,138330.96788194444,1355,9,443.7,29,1,16,31.17071083366894,0.6756465517241379,41.354166666666664,1034.5833333333333,35.67528735632184,0
2586,4,0,1,29,0.0,0.03333333333333333,0.9666666666666667,30,850,600,250,0.7058823529411765,11,6,5,395.2152660746672,0.36709770114942525,0.015284381053002338,0.22069100256027874,129474.83090530695,4234.0859492426835,133708.91685454964,1356,10,444.7,30,0,20,35.50883738334213,0.6291666666666667,45.564516129032256,1017.7419354838709,33.924731182795696,8
2587,4,0,0,29,0.0,0.0,1.0,29,1000,700,300,0.7,13,7,6,397.0845465430557,0.3668924466338259,-0.003668378576669129,0.22258592471358413,129625.34722222209,4494.444444444423,134119.7916666665,1357,11,434.9655172413793,29,0,21,35.30755591925805,0.6336206896551724,45.41666666666666,1018.3333333333322,35.1149425287356,0
2588,4,0,0,29,0.0,0.0,1.0,29,300,200,100,0.6666666666666666,4,2,2,397.0845465430557,0.3668924466338259,-0.003668378576669129,0.22258592471358413,129625.34722222209,4494.444444444423,134119.7916666665,1358,12,435.9655172413793,29,0,21,35.30755591925805,0.6336206896551724,45.41666666666666,1018.3333333333322,35.1149425287356,0
2589,4,0,0,29,0.0,0.0,1.0,29,700,300,400,0.42857142857142855,11,3,8,394.3191940482015,0.3663279967159277,-0.008744094210563658,0.221634581482265,129731.4453125,4431.119791666667,134162.56510416666,1359,13,436.9655172413793,29,0,21,35.26968302658487,0.634698275862069,45.3125,1018.75,35.12931034482759,0
2590,4,0,0,29,0.0,0.0,1.0,29,750,600,150,0.8,9,6,3,390.4517462722191,0.3666871921182266,-0.0039473313220741435,0.220056445018859,129837.58680555549,4339.06249999999,134176.64930555547,1360,14,437.9655172413793,29,0,22,35.25994821477241,0.6357758620689655,45.20833333333333,1019.1666666666661,35.14367816091952,0
2591,4,0,0,29,0.0,0.0,1.0,29,900,600,300,0.6666666666666666,12,6,6,395.9780988355072,0.3658661740558293,0.06158144573847801,0.20778113255598535,126987.00086805562,4256.814236111117,131243.81510416674,1361,15,438.9655172413793,29,0,20,38.043010197051125,0.6066810344827587,48.020833333333336,1007.9166666666672,34.7557471264368,8
2592,4,2,1,30,0.06451612903225806,0.03225806451612903,0.967741935483871,31,600,100,500,0.16666666666666666,11,1,10,375.3123371521923,0.37979390681003583,0.049231178637660244,0.1997032312501171,127551.95617675783,3374.3645562065976,130926.32073296442,1362,0,411.5806451612903,31,0,20,37.982834923090124,0.6068548387096775,47.4609375,1010.1562500000001,32.58568548387097,0
2593,4,1,0,31,0.03225806451612903,0.0,1.0,31,800,500,300,0.625,11,5,6,375.4858847690763,0.3761648745519713,0.06565411148074762,0.20126976307808264,127848.07205200197,3401.0292900933164,131249.1013420953,1363,0,412.5483870967742,31,0,21,37.674482854813085,0.6098790322580645,47.16796875,1011.3281250000001,32.62348790322581,0
2594,4,1,0,32,0.03125,0.0,1.0,32,500,400,100,0.8,6,4,2,363.93503700316677,0.38455561155913975,0.06057098765432101,0.19652491998171012,128144.53125000001,2927.6002671983515,131072.13151719837,1364,0,400.625,31,1,22,37.66289437585735,0.6129032258064516,46.875,1012.5000000000001,32.66129032258065,0
2595,4,0,0,32,0.0,0.0,1.0,32,950,500,450,0.5263157894736842,14,5,9,362.67008544749217,0.38434559811827956,0.06791452442159351,0.1964883889123601,128276.40109592023,2904.402669270843,131180.80376519106,1365,1,401.625,31,1,22,37.55998286203939,0.614247311827957,46.74479166666667,1013.0208333333342,32.67809139784949,0
2596,4,3,1,34,0.08571428571428572,0.02857142857142857,0.9714285714285714,35,600,300,300,0.5,9,3,6,336.26713249126567,0.4033963585434173,0.08032786885245913,0.18647540983606545,129201.38888888883,1692.5591362847126,130893.94802517355,1366,0,368.1142857142857,33,2,23,37.286543715846996,0.6186868686868687,45.83333333333333,1016.6666666666662,30.808080808080792,0
2597,4,0,0,34,0.0,0.0,1.0,34,950,800,150,0.8421052631578947,11,8,3,345.402249739091,0.3961489898989899,0.08382439091629657,0.1908095923315947,129050.1434948978,2114.841978458029,131164.98547335583,1367,1,379.88235294117646,34,0,23,37.20830892403826,0.6148897058823529,45.98214285714285,1016.0714285714272,29.884453781512565,0
2598,4,1,1,34,0.02857142857142857,0.02857142857142857,0.9714285714285714,35,950,600,350,0.631578947368421,13,6,7,341.39678603319487,0.40059523809523806,0.08929861373877768,0.19082380247588945,129513.05537533648,1843.2453250908293,131356.30070042732,1368,0,370.0,33,2,19,36.83933301228027,0.6218434343434344,45.52696078431373,1017.8921568627457,30.845216874628655,0
2599,4,0,1,33,0.0,0.029411764705882353,0.9705882352941176,34,1200,1000,200,0.8333333333333334,14,10,4,388.17579975183037,0.3968731431966726,-0.010288844114373585,0.2215368872683874,130327.04132550243,3320.12332892113,133647.16465442357,1369,1,381.70588235294116,32,2,17,34.819514859239106,0.6324869791666667,44.72853535353535,1021.085858585858,31.908933080808062,8
2600,4,0,1,32,0.0,0.030303030303030304,0.9696969696969697,33,950,800,150,0.8421052631578947,11,8,3,398.402131405497,0.3936631944444444,-0.007099695620230273,0.22680865001986178,130230.36552392608,3776.8110396898182,134007.1765636159,1370,2,394.1818181818182,32,1,19,34.65693551047335,0.6315104166666667,44.82323232323232,1020.7070707070703,31.897095959595948,0
2601,4,1,1,32,0.030303030303030304,0.030303030303030304,0.9696969696969697,33,1300,1000,300,0.7692307692307693,16,10,6,401.21237726307874,0.39453125,-0.004186653689585151,0.22977462131431514,130462.04460991762,3868.601397672083,134330.6460075897,1371,0,395.09090909090907,31,2,21,34.34924377602176,0.6364247311827957,44.59635416666667,1021.614583333334,32.95530913978497,0
2602,4,1,1,32,0.030303030303030304,0.030303030303030304,0.9696969696969697,33,800,600,200,0.75,10,6,4,397.83534264127445,0.3896780303030303,0.024768494413397457,0.2300067908118096,130828.1135559082,3809.6094767252607,134637.72303263345,1372,0,395.90909090909093,31,2,16,34.063176148657256,0.6401209677419355,44.23828125,1023.046875,33.00151209677419,0
2603,4,0,0,32,0.0,0.0,1.0,32,850,700,150,0.8235294117647058,10,7,3,408.3543085818915,0.3849546370967742,0.02935157790927012,0.23473427942292419,130605.8345798648,4266.691055324325,134872.52563518911,1373,1,409.25,30,2,16,34.02038132807363,0.640625,44.45564516129033,1022.1774193548393,34.07258064516131,0
2604,4,1,0,33,0.030303030303030304,0.0,1.0,33,750,600,150,0.8,9,6,3,399.7258951045823,0.3904671717171717,0.02904249208790599,0.2319000192927767,130961.35669284404,3869.7291056315203,134831.08579847557,1374,0,397.8181818181818,31,2,17,33.87940995632447,0.6414650537634409,44.10807291666667,1023.5677083333339,33.01831317204303,0
2605,4,1,1,33,0.029411764705882353,0.029411764705882353,0.9705882352941176,34,800,600,200,0.75,10,6,4,390.6404917707713,0.3956662210338681,0.032520325203251765,0.22880371660859447,131328.1249999999,3460.416666666652,134788.54166666657,1375,0,387.0882352941176,32,2,18,33.73983739837397,0.642578125,43.74999999999999,1024.9999999999993,32.03124999999998,0
2606,4,0,2,31,0.0,0.06060606060606061,0.9393939393939394,33,750,500,250,0.6666666666666666,10,5,5,397.2503139665543,0.39255839646464646,0.04779502340477948,0.23267518389469605,131328.125,3834.0277777777783,135162.15277777778,1376,1,398.93939393939394,31,2,18,33.57046070460704,0.6451612903225806,43.75,1025.0,33.064516129032256,0
2607,4,1,0,32,0.03125,0.0,1.0,32,350,200,150,0.5714285714285714,5,2,3,405.6606876831212,0.394552251344086,0.049637657397691104,0.23717462292148128,131259.24962423398,4249.343493467446,135508.59311770144,1377,0,395.71875,30,2,19,33.42487539349421,0.6472222222222221,43.817204301075265,1024.7311827956987,34.15770609318996,0
2608,4,0,0,32,0.0,0.0,1.0,32,750,500,250,0.6666666666666666,10,5,5,403.60485353481783,0.3937542002688172,0.047844008129015014,0.2366098553351311,131362.5694625101,4203.71412157474,135566.28358408483,1378,1,396.71875,30,2,19,33.37266727852803,0.6482638888888889,43.71639784946236,1025.1344086021502,34.17114695340501,0
2609,4,0,0,32,0.0,0.0,1.0,32,950,800,150,0.8421052631578947,11,8,3,401.6871026046231,0.393544186827957,0.046145778710015906,0.23569763220523574,131397.0184414383,4156.097525725512,135553.11596716382,1379,2,397.71875,30,2,19,33.38686418458312,0.6486111111111111,43.68279569892473,1025.2688172043008,34.17562724014336,0
2610,4,0,0,32,0.0,0.0,1.0,32,750,400,350,0.5333333333333333,11,4,7,405.053739490417,0.3924101142473118,0.07334281513679386,0.22728338237403473,129665.12891981343,4104.269070095495,133769.39798990893,1380,3,398.71875,31,1,20,35.06402880763658,0.6283602150537635,45.37760416666667,1018.4895833333339,32.85450268817206,8
2611,4,2,0,34,0.058823529411764705,0.0,1.0,34,600,300,300,0.5,9,3,6,380.60060385973225,0.3986928104575163,0.06452692380439706,0.21703360245485157,130294.81207274768,3119.430121951245,133414.24219469892,1381,0,376.20588235294116,32,2,23,35.04565504163574,0.6321614583333333,44.76010101010101,1020.959595959596,31.904987373737374,0
2612,4,0,1,33,0.0,0.029411764705882353,0.9705882352941176,34,550,400,150,0.7272727272727273,7,4,3,382.08600058114433,0.39828431372549017,0.06680921626810976,0.21824234270482326,130359.27456382012,3161.690771349873,133520.96533516998,1382,1,377.20588235294116,32,2,23,34.94219831849653,0.6328125,44.6969696969697,1021.2121212121219,31.91287878787881,0
2613,4,2,2,33,0.05714285714285714,0.05714285714285714,0.9428571428571428,35,850,700,150,0.8235294117647058,10,7,3,367.5451548867758,0.40066526610644254,0.06028288543140037,0.2085509024919346,130101.52025303539,2684.0524882665018,132785.57274130188,1383,0,367.14285714285717,32,3,20,35.57523721122112,0.6302083333333333,44.94949494949495,1020.2020202020201,31.881313131313128,8
2614,4,1,0,34,0.029411764705882353,0.0,1.0,34,700,500,200,0.7142857142857143,9,5,4,365.66999156268076,0.3977272727272727,0.09720171911019349,0.2090391916431466,130391.51178770028,2736.052603050713,133127.56439075098,1384,0,378.52941176470586,32,2,21,35.32858408538344,0.6331380208333333,44.66540404040404,1021.3383838383842,31.916824494949505,0
2615,4,0,0,34,0.0,0.0,1.0,34,1350,900,450,0.6666666666666666,18,9,9,369.99375206409917,0.3969474153297683,0.10545938167705948,0.21239215809977446,130552.75769054181,2860.740932047751,133413.49862258957,1385,1,379.52941176470586,32,2,18,35.05451569063503,0.634765625,44.50757575757576,1021.9696969696971,31.936553030303035,0
2616,4,0,0,34,0.0,0.0,1.0,34,750,300,450,0.4,12,3,9,373.1227008864315,0.3955919489007724,0.10743630538543703,0.21472455643762892,130649.5530589992,2949.6628213957933,133599.215880395,1386,2,380.52941176470586,32,2,19,34.87634309003334,0.6357421875,44.412878787878796,1022.3484848484859,31.948390151515184,0
2617,4,1,0,35,0.02857142857142857,0.0,1.0,35,700,500,200,0.7142857142857143,9,5,4,364.7847016070603,0.40042016806722686,0.1163717192442506,0.21209298412853095,131045.64838343435,2560.6895484909755,133606.3379319253,1387,0,370.62857142857143,33,2,20,34.688185717135454,0.6373106060606061,44.02573529411765,1023.8970588235302,31.027183600713037,0
2618,4,0,1,34,0.0,0.02857142857142857,0.9714285714285714,35,950,600,350,0.631578947368421,13,6,7,364.01827045641926,0.4003501400560224,0.1179229480737014,0.21216629738317677,131139.77346453306,2547.4547049212056,133687.22816945426,1388,1,371.62857142857143,33,2,21,34.612546861290575,0.6382575757575757,43.933823529411775,1024.2647058823545,31.03832442067741,0
2619,4,0,0,34,0.0,0.0,1.0,34,950,700,250,0.7368421052631579,12,7,5,370.76170404166396,0.39551767676767674,0.12326397702466485,0.21588285581349173,131101.7390604277,2921.500835373962,134023.23989580167,1389,2,383.2352941176471,32,2,21,34.478383265524194,0.6402994791666667,43.970959595959606,1024.116161616163,32.003630050505095,0
2620,4,0,0,34,0.0,0.0,1.0,34,1250,900,350,0.72,16,9,7,372.9780887724176,0.39529486036838973,0.132902033271719,0.21790620521153126,131231.07854109278,2989.2633723599633,134220.34191345275,1390,3,384.2352941176471,32,2,21,34.29066543438076,0.6416015625,43.84469696969697,1024.6212121212125,32.01941287878789,0
2621,4,0,0,34,0.0,0.0,1.0,34,800,600,200,0.75,10,6,4,375.10740961068166,0.39449643493761144,0.14299378287900533,0.21970576848625617,131328.12499999988,3052.430555555542,134380.55555555542,1391,4,385.2352941176471,32,2,21,34.137872628726285,0.642578125,43.74999999999999,1024.999999999999,32.03124999999997,0
2622,4,1,0,35,0.02857142857142857,0.0,1.0,35,700,500,200,0.7142857142857143,9,5,4,363.79994964563457,0.3983893557422969,0.13888860452816054,0.21466504428350233,131610.90573637543,2576.0081759419513,134186.91391231737,1392,0,375.2,33,2,20,34.14185974760144,0.6429924242424243,43.474264705882355,1026.1029411764707,31.094028520499112,0
2623,4,0,0,35,0.0,0.0,1.0,35,850,600,250,0.7058823529411765,11,6,5,364.1458882384652,0.39747899159663863,0.14066039023059074,0.21540155083936327,131705.2335640138,2591.9838523644626,134297.21741637826,1393,1,376.2,33,2,20,34.03772683858644,0.6439393939393939,43.382352941176464,1026.4705882352937,31.105169340463444,0
2624,4,0,0,35,0.0,0.0,1.0,35,900,500,400,0.5555555555555556,13,5,8,361.5814270126589,0.39705882352941174,0.1351157794222968,0.21423827408147472,131768.137555267,2528.982242406738,134297.11979767372,1394,2,377.2,33,2,20,34.040045356887084,0.6445707070707071,43.321078431372534,1026.715686274508,31.11259655377297,0
2625,4,0,0,35,0.0,0.0,1.0,35,650,400,250,0.6153846153846154,9,4,5,364.08296269476534,0.3967787114845938,0.14430599826137347,0.21625650675725197,131862.5217013888,2601.779513888871,134464.30121527766,1395,3,378.2,33,2,20,33.880578093306276,0.6455176767676767,43.22916666666666,1027.0833333333323,31.123737373737345,0
2626,4,0,0,35,0.0,0.0,1.0,35,900,600,300,0.6666666666666666,12,6,6,366.07239906561824,0.39688375350140054,0.1479472590371711,0.218341617252082,132019.90370290267,2665.7685745866884,134685.67227748936,1396,4,379.2,33,2,20,33.67070116861435,0.6470959595959596,43.07598039215686,1027.696078431372,31.14230540701127,0
2627,4,0,0,35,0.0,0.0,1.0,35,850,500,350,0.5882352941176471,12,5,7,365.5644624096127,0.3959733893557423,0.15309818875119197,0.21912978346724762,132208.88600538237,2666.174067666266,134875.06007304863,1397,5,380.2,33,2,20,33.49320781696855,0.648989898989899,42.89215686274509,1028.4313725490183,31.16458704693995,0
2628,4,0,0,35,0.0,0.0,1.0,35,800,600,200,0.75,10,6,4,366.6284431469003,0.3959033613445378,0.1540420027911098,0.22013441715129303,132271.91014273337,2698.9288975393893,134970.83904027275,1398,6,381.2,33,2,20,33.402331030100875,0.6496212121212122,42.83088235294117,1028.6764705882338,31.172014260249508,0
2629,4,0,0,35,0.0,0.0,1.0,35,1350,900,450,0.6666666666666666,18,9,9,365.68375157763626,0.3964285714285714,0.15199537304800503,0.2203021625357954,132398.00347222213,2683.1597222222126,135081.16319444435,1399,7,382.2,33,2,20,33.299595141700415,0.6508838383838385,42.70833333333333,1029.1666666666658,31.18686868686866,0
2630,4,0,0,35,0.0,0.0,1.0,35,750,400,350,0.5333333333333333,11,4,7,364.5277001582017,0.3948879551820728,0.15215654273133739,0.22052744884300712,132555.70461180797,2664.045228998461,135219.74984080644,1400,8,383.2,33,2,20,33.170569042802164,0.6524621212121212,42.55514705882353,1029.779411764706,31.205436720142607,0
2631,4,0,1,34,0.0,0.02857142857142857,0.9714285714285714,35,900,800,100,0.8888888888888888,10,8,2,366.3529930521372,0.3948529411764706,0.15957168352171336,0.22200410285531444,132618.81134960108,2717.059694588617,135335.8710441897,1401,9,384.2,33,2,20,33.06005849692642,0.6530934343434344,42.493872549019606,1030.0245098039213,31.212863933452162,0
2632,4,0,0,34,0.0,0.0,1.0,34,1000,700,300,0.7,13,7,6,371.70296381979614,0.39369800950683304,0.1142652182824353,0.21059794199265902,130043.75007509121,2867.5294658304383,132911.27954092165,1402,10,376.7647058823529,33,1,17,35.5279296327446,0.627209595959596,45.00612745098039,1019.9754901960777,30.90834818775993,8
2633,4,0,0,34,0.0,0.0,1.0,34,600,400,200,0.6666666666666666,8,4,4,371.77746716880335,0.3936423054070113,0.11123046046866647,0.21080896707855035,130075.00120146097,2871.790897731644,132946.79209919262,1403,11,377.7647058823529,33,1,17,35.49425356399169,0.6275252525252526,44.97549019607843,1020.0980392156862,30.912061794414733,0
2634,4,0,0,34,0.0,0.0,1.0,34,800,500,300,0.625,11,5,6,374.30756837113535,0.3931224004753417,0.10870486523139533,0.212925780696367,130200.043252595,2946.9723183390834,133147.01557093408,1404,12,378.7647058823529,33,1,17,35.30259365994237,0.6287878787878788,44.85294117647058,1020.5882352941164,30.92691622103383,0
2635,4,0,0,34,0.0,0.0,1.0,34,750,500,250,0.6666666666666666,10,5,5,375.01041232819625,0.3929738562091503,0.1062424969987994,0.2136687233032748,130262.58680555566,2969.9802960399948,133232.56710159566,1405,13,379.7647058823529,32,2,17,35.22108843537415,0.6318359375,44.79166666666667,1020.8333333333343,31.901041666666696,0
2636,4,0,0,34,0.0,0.0,1.0,34,800,500,300,0.625,11,5,6,374.095263672305,0.3933637849079026,0.10366119741665236,0.2136781421314692,130359.2745638201,2953.35743801654,133312.63200183664,1406,14,380.7647058823529,32,2,17,35.14620425321465,0.6328125,44.6969696969697,1021.2121212121218,31.912878787878807,0
2637,4,1,0,35,0.02857142857142857,0.0,1.0,35,1000,600,400,0.6,14,6,8,363.78272706056987,0.3956582633053221,0.14045575912273955,0.1967386941579317,128204.80619331055,2327.7388038548606,130532.54499716542,1407,0,370.85714285714283,34,1,17,37.60506053838016,0.6063112745098039,46.81547619047618,1012.7380952380943,29.786414565826302,8
2638,4,0,1,34,0.0,0.02857142857142857,0.9714285714285714,35,1000,600,400,0.6,14,6,8,361.2809151050609,0.3954131652661064,0.14231995971126454,0.19582806290089586,128295.24518140573,2270.124716553271,130565.369897959,1408,1,371.85714285714283,34,1,18,37.5758911084998,0.6072303921568627,46.72619047619047,1013.0952380952368,29.796918767506966,0
2639,4,2,1,35,0.05555555555555555,0.027777777777777776,0.9722222222222222,36,1100,800,300,0.7272727272727273,14,8,6,355.2335173943511,0.39928902116402115,0.14847966552641578,0.19495606680528543,128789.87295310367,1950.0959147805315,130739.96886788419,1409,0,361.77777777777777,35,1,17,37.22396427213987,0.6101190476190477,46.23842592592593,1015.0462962962971,29.001322751322775,0
2640,4,2,0,37,0.05405405405405406,0.0,1.0,37,400,300,100,0.75,5,3,2,347.04096797822035,0.40224599599599603,0.1498646252635618,0.19189324111736908,129086.92476260052,1559.6902645889238,130646.61502718944,1410,0,352.94594594594594,36,1,19,37.129229462174955,0.6111111111111112,45.94594594594595,1016.2162162162168,28.228228228228247,0
2641,4,1,1,37,0.02631578947368421,0.02631578947368421,0.9736842105263158,38,1500,1300,200,0.8666666666666667,17,13,4,340.79273224192076,0.4057906590801328,0.08852398419062268,0.1867398896920648,128728.04763244453,1173.9166137657728,129901.96424621031,1411,0,344.63157894736844,37,1,17,37.65340806771116,0.6055743243243243,46.29934210526316,1014.8026315789468,27.427098150782346,8
2642,4,1,0,38,0.02631578947368421,0.0,1.0,38,1100,1000,100,0.9090909090909091,12,10,2,338.0273445073841,0.4063685395922238,0.10760385419507279,0.1863979356855003,128978.5318559556,1119.6541243459405,130098.18598030154,1412,0,345.57894736842104,37,1,18,37.46851611974667,0.6081081081081081,46.05263157894736,1015.78947368421,27.4537695590327,0
2643,4,0,0,38,0.0,0.0,1.0,38,1150,1000,150,0.8695652173913043,13,10,3,339.29051330287535,0.4060425557136083,0.10396893874029312,0.18815201192250386,129201.38888888905,1167.5534779932468,130368.9423668823,1413,1,346.57894736842104,36,2,19,37.20969945355192,0.6122685185185186,45.83333333333334,1016.666666666668,28.240740740740776,0
2644,4,0,0,38,0.0,0.0,1.0,38,1150,800,350,0.6956521739130435,15,8,7,340.3320908135139,0.40602773826458033,0.10484696780065983,0.18943500608992853,129348.51794249384,1204.2903109996364,130552.80825349348,1414,2,347.57894736842104,35,3,21,37.03362631319452,0.6157738095238094,45.6886574074074,1017.2453703703691,29.0641534391534,0
2645,4,1,0,39,0.02564102564102564,0.0,1.0,39,750,500,250,0.6666666666666666,10,5,5,334.3015124184158,0.4090193432298695,0.11143907881716109,0.18742024654679068,129631.08114448913,867.1732966074208,130498.25444109655,1415,0,339.64102564102564,36,3,18,36.90008846621696,0.6166087962962963,45.41103603603604,1018.3558558558561,28.28766266266267,0
2646,4,0,0,39,0.0,0.0,1.0,39,1150,700,450,0.6086956521739131,16,7,9,337.1695958280972,0.4084289248762933,0.10649784140908403,0.19005405659321778,129843.17440221987,955.8341268467166,130799.00852906659,1416,1,340.64102564102564,37,2,18,36.611865698404145,0.6168355855855856,45.20285087719298,1019.1885964912277,27.545637743006154,0
2647,4,0,1,38,0.0,0.02564102564102564,0.9743589743589743,39,1000,800,200,0.8,12,8,4,334.07912518961024,0.40854138551506974,0.10634173511902278,0.18885117234882595,129954.9515836604,883.0473078254879,130837.99889148588,1417,2,341.64102564102564,37,2,19,36.57729773810803,0.6179617117117118,45.093201754385966,1019.6271929824564,27.557491702228553,0
2648,4,2,1,39,0.05,0.025,0.975,40,1200,900,300,0.75,15,9,6,327.36359850062513,0.41010950854700856,0.10724489795918402,0.18652112007593746,130262.58680555545,529.0095269698328,130791.59633252528,1418,0,333.925,37,3,21,36.43707482993199,0.6210585585585586,44.791666666666664,1020.8333333333325,27.590090090090065,0
2649,4,1,0,40,0.025,0.0,1.0,40,1000,800,200,0.8,12,8,4,329.88025421436845,0.4083733974358974,0.10678402747960525,0.1887693150037503,130430.54112803932,605.2920129270469,131035.83314096637,1419,0,334.725,37,3,22,36.202948332617716,0.6227477477477478,44.62719298245614,1021.4912280701748,27.607871028923643,0
2650,4,0,0,40,0.0,0.0,1.0,40,700,400,300,0.5714285714285714,10,4,6,330.70972020114573,0.4086672008547008,0.106952789699571,0.18979153893316977,130542.57079101252,634.3394121267942,131176.91020313933,1420,1,335.725,37,3,14,36.06849070100142,0.6238738738738738,44.517543859649116,1021.9298245614027,27.619724988146018,0
2651,4,1,3,38,0.024390243902439025,0.07317073170731707,0.926829268292683,41,1300,800,500,0.6153846153846154,18,8,10,324.7868002730067,0.4117123983739837,0.10725946819683974,0.18800122210263684,130874.74093967021,301.2776692708378,131176.01860894106,1421,0,328.5121951219512,39,2,15,35.88442515864128,0.6236645299145299,44.192708333333336,1023.2291666666673,26.236645299145316,0
2652,4,0,0,38,0.0,0.0,1.0,38,1050,800,250,0.7619047619047619,13,8,5,345.4587196647338,0.4058943812233286,0.10745299819591958,0.19800043989375432,130492.60567577723,1415.961696493804,131908.56737227103,1422,1,355.2368421052632,36,2,15,35.74226643153681,0.6252893518518519,44.56644144144145,1021.734234234235,28.38150650650653,0
2653,4,0,0,38,0.0,0.0,1.0,38,1000,600,400,0.6,14,6,8,343.29442632663637,0.4054498577524894,0.09658593437432872,0.19734537731265894,130607.69120049127,1367.3784849038452,131975.0696853951,1423,2,356.2368421052632,36,2,15,35.68107120561124,0.6264467592592593,44.45382882882884,1022.1846846846867,28.394019019019073,0
2654,4,0,1,37,0.0,0.02631578947368421,0.9736842105263158,38,900,500,400,0.5555555555555556,13,5,8,344.56568146092457,0.40540540540540543,0.09594829584975617,0.19851880632393407,130694.03863322815,1406.5360969077556,132100.5747301359,1424,3,357.2368421052632,36,2,15,35.56121512481645,0.6273148148148149,44.36936936936939,1022.5225225225252,28.403403403403477,0
2655,4,0,0,37,0.0,0.0,1.0,37,1100,800,300,0.7272727272727273,14,8,6,352.1856539515466,0.40183933933933935,0.10352455931534355,0.20266162093511492,130646.86381440761,1802.3902338391642,132449.25404824677,1425,4,367.64864864864865,35,2,15,35.41419015811917,0.6288690476190476,44.41550925925926,1022.3379629629633,29.209656084656093,0
2656,4,0,0,37,0.0,0.0,1.0,37,1200,800,400,0.6666666666666666,16,8,8,355.54578260341196,0.4014952452452452,0.10409504117064117,0.20506543962687665,130735.62349965714,1896.4999142661306,132632.12341392328,1426,5,368.64864864864865,35,2,15,35.238418590614174,0.6297619047619047,44.32870370370371,1022.6851851851858,29.219576719576736,0
2657,4,0,0,37,0.0,0.0,1.0,37,600,400,200,0.6666666666666666,8,4,4,355.4983883418579,0.4014952452452452,0.10598606299477464,0.20551015399304684,130824.41332572463,1901.5736186128497,132725.9869443375,1427,6,369.64864864864865,35,2,16,35.14973884677755,0.6306547619047619,44.24189814814816,1023.0324074074088,29.229497354497394,0
2658,4,0,0,37,0.0,0.0,1.0,37,850,500,350,0.5882352941176471,12,5,7,351.8350231884401,0.4014326826826827,0.09260385314653252,0.2043322902233589,131002.08340031306,1818.2242101766294,132820.3076104897,1428,7,370.64864864864865,35,2,18,35.06371302053892,0.6324404761904762,44.068287037037045,1023.7268518518529,29.24933862433865,0
2659,4,0,0,37,0.0,0.0,1.0,37,750,600,150,0.8,9,6,3,352.7380792518338,0.40118243243243246,0.09587475786887945,0.20501452359144046,131031.70680084026,1843.9745156035726,132875.68131644384,1429,8,371.64864864864865,35,2,18,35.01064511266862,0.6327380952380952,44.039351851851855,1023.8425925925931,29.252645502645517,0
2660,4,1,0,38,0.02631578947368421,0.0,1.0,38,850,600,250,0.7058823529411765,11,6,5,346.88572536437107,0.4061314604077762,0.09613661199026313,0.2033290893748792,131356.98356718224,1513.17250527557,132870.15607245782,1430,0,362.8421052631579,36,2,21,34.83192354168956,0.6339699074074074,43.72184684684686,1025.1126126126142,28.475350350350393,0
2661,4,0,0,38,0.0,0.0,1.0,38,1400,1100,300,0.7857142857142857,17,11,6,342.7987750179419,0.4063833570412518,0.09564755102512512,0.2016932327431148,131501.32395909436,1415.698553283026,132917.02251237739,1431,1,363.8421052631579,36,2,22,34.791071951398024,0.6354166666666667,43.58108108108109,1025.6756756756768,28.490990990991023,0
2662,4,0,0,38,0.0,0.0,1.0,38,850,400,450,0.47058823529411764,13,4,9,342.54981377556646,0.4059832859174965,0.09608108186171682,0.2020046183371643,131587.96623904322,1415.0866660579627,133003.05290510118,1432,2,364.8421052631579,36,2,14,34.7101031719899,0.6362847222222222,43.49662162162163,1026.0135135135145,28.500375375375402,0
2663,4,0,0,38,0.0,0.0,1.0,38,1050,600,450,0.5714285714285714,15,6,9,342.5483822331126,0.4061166429587482,0.09330931014171306,0.20246342124984393,131674.6370525934,1420.986780699646,133095.62383329304,1433,3,365.8421052631579,36,2,15,34.62278728695779,0.6371527777777778,43.412162162162176,1026.3513513513535,28.50975975975982,0
2664,4,1,1,38,0.02564102564102564,0.02564102564102564,0.9743589743589743,39,750,400,350,0.5333333333333333,11,4,7,335.8628835414463,0.41014394961763384,0.09340229318884608,0.1999387051323603,131946.99931709754,1063.2199330563265,133010.21925015387,1434,0,357.43589743589746,37,2,17,34.520188545001794,0.6379504504504505,43.146929824561404,1027.4122807017543,27.767899478425793,0
2665,4,0,0,38,0.0,0.0,1.0,38,850,700,150,0.8235294117647058,10,7,3,343.322073403103,0.405034969179706,0.09126134599738034,0.2040026470038895,131876.97991488117,1455.2556357032781,133332.23555058445,1435,1,367.7368421052632,36,2,18,34.399097321200166,0.6391782407407407,43.215090090090094,1027.13963963964,28.53165665665667,0
2666,4,1,1,38,0.02564102564102564,0.02564102564102564,0.9743589743589743,39,1600,1300,300,0.8125,19,13,6,333.1681525361313,0.40781039136302294,0.09032857689574114,0.19981568227550597,132228.78674207453,1010.8841181902196,133239.67086026474,1436,0,359.28205128205127,37,2,19,34.30614783226723,0.6407657657657657,42.87280701754386,1028.5087719298251,27.79753437648176,0
2667,4,0,0,38,0.0,0.0,1.0,38,1450,1100,350,0.7586206896551724,18,11,7,341.9201049943074,0.4041311047889995,0.09490978267135497,0.20456949925281975,132137.36329234648,1436.0842261180162,133573.4475184645,1437,1,369.3421052631579,36,2,19,34.17305585980286,0.6417824074074074,42.961711711711715,1028.1531531531537,28.559809809809824,0
2668,4,0,0,38,0.0,0.0,1.0,38,1100,400,700,0.36363636363636365,18,4,14,347.22420325859895,0.40371621621621623,0.10266442326530112,0.20838014931432663,132253.17166829028,1584.3004321889898,133837.47210047927,1438,2,370.3421052631579,36,2,19,33.92019743084448,0.6429398148148149,42.84909909909912,1028.6036036036066,28.572322322322407,0
2669,4,0,0,38,0.0,0.0,1.0,38,1100,800,300,0.7272727272727273,14,8,6,346.80342212191994,0.40381993835941205,0.1035894333534979,0.2082872623986684,132282.1316882765,1575.179191015379,133857.31087929188,1439,3,371.3421052631579,36,2,19,33.90188834154352,0.6432291666666667,42.820945945945965,1028.7162162162192,28.575450450450532,0
2670,4,0,0,38,0.0,0.0,1.0,38,950,800,150,0.8421052631578947,11,8,3,346.799093934827,0.4037754860123281,0.10252732948589482,0.20876483006432506,132369.03077063579,1581.0919872575664,133950.12275789335,1440,4,372.3421052631579,36,2,20,33.81461114758885,0.6440972222222222,42.736486486486505,1029.0540540540565,28.5848348348349,0
2671,4,0,0,38,0.0,0.0,1.0,38,950,600,350,0.631578947368421,13,6,7,346.46917159185614,0.40315315315315314,0.10538448336065609,0.2088915486756868,132427.78427479873,1576.4321130870524,134004.2163878858,1441,5,373.3421052631579,35,3,20,33.76403257243525,0.6467261904761905,42.67939814814816,1029.282407407409,29.408068783068828,0
2672,4,0,0,38,0.0,0.0,1.0,38,1200,800,400,0.6666666666666666,16,8,8,344.753872353414,0.40327169274537694,0.10778737832221341,0.20833342068256908,132513.92598257065,1536.9378246490014,134050.86380721966,1442,6,374.3421052631579,36,2,20,33.72160851653361,0.6455439814814814,42.595720720720735,1029.617117117119,28.60047547547553,0
2673,4,0,0,38,0.0,0.0,1.0,38,1150,900,250,0.782608695652174,14,9,5,345.5146005019332,0.40257527264106213,0.11311243339049515,0.2092765918007078,132600.90115453317,1563.1094777209923,134164.01063225415,1443,7,375.3421052631579,36,2,21,33.614649391355066,0.646412037037037,42.511261261261275,1029.954954954957,28.609859859859917,0
2674,4,0,0,38,0.0,0.0,1.0,38,1200,900,300,0.75,15,9,6,346.7391593212636,0.4019529397818871,0.10984857202034348,0.2103428268879924,132658.9004545088,1599.6071240159406,134258.50757852476,1444,8,376.3421052631579,36,2,18,33.524859714327356,0.6469907407407407,42.45495495495497,1030.1801801801823,28.616116116116174,0
2675,4,0,0,38,0.0,0.0,1.0,38,850,400,450,0.47058823529411764,13,4,9,346.7878548462025,0.4019529397818871,0.10800630290761859,0.21102409890641297,132774.93709926168,1608.9471227985014,134383.88422206018,1445,9,377.3421052631579,36,2,19,33.40708770396271,0.6481481481481481,42.342342342342356,1030.6306306306326,28.628628628628682,0
2676,4,1,1,38,0.02564102564102564,0.02564102564102564,0.9743589743589743,39,950,600,350,0.631578947368421,13,6,7,364.1587148136855,0.4047177237966712,0.10786749296717835,0.20781033246553393,130323.35778061197,1707.126655751139,132030.4844363631,1446,0,368.64102564102564,34,5,17,35.43634137810423,0.6277573529411764,44.73214285714284,1021.0714285714263,30.03151260504195,8
2677,4,0,0,38,0.0,0.0,1.0,38,1350,1000,350,0.7407407407407407,17,10,7,383.86188778382456,0.3993598862019914,0.17563085796683509,0.2091187896135759,128496.33487654309,2302.557712899961,130798.89258944304,1447,1,379.0263157894737,35,3,19,36.79794520547945,0.6071428571428572,46.52777777777777,1013.8888888888879,28.96825396825394,8
2678,4,0,0,38,0.0,0.0,1.0,38,750,400,350,0.5333333333333333,11,4,7,389.72136333838256,0.399033902323376,0.18250498450599362,0.21293753293625808,128613.7099194099,2424.702074759917,131038.41199416982,1448,2,380.0263157894737,35,3,19,36.529172371824124,0.6083333333333334,46.412037037037024,1014.3518518518498,28.981481481481424,0
2679,4,1,0,39,0.02564102564102564,0.0,1.0,39,1100,700,400,0.6363636363636364,15,7,8,383.49396025508935,0.40255285650022493,0.181999556639326,0.21174311563166548,129029.71172185689,2096.4230277574775,131126.13474961437,1449,0,371.2564102564103,36,3,21,36.26159203428656,0.6105324074074074,46.00225225225225,1015.9909909909902,28.22197197197195,0
2680,4,1,0,40,0.025,0.0,1.0,40,650,500,150,0.7692307692307693,8,5,3,374.05158945502205,0.40738514957264954,0.17633458206509056,0.20774698810954445,129261.91184807234,1670.4671197672872,130932.37896783963,1450,0,362.95,34,6,22,36.264438460938116,0.6170343137254901,45.77380952380951,1016.9047619047601,29.908963585434122,0
2681,4,0,0,40,0.0,0.0,1.0,40,1250,1000,250,0.8,15,10,5,371.67203499219374,0.40669070512820515,0.17647189021691,0.2073104017400904,129430.46932067211,1621.1371844817884,131051.6065051539,1451,1,363.95,36,4,18,36.15307289361074,0.6145833333333333,45.60810810810811,1017.5675675675683,28.265765765765785,0
2682,4,2,1,41,0.047619047619047616,0.023809523809523808,0.9761904761904762,42,1550,1300,250,0.8387096774193549,18,13,5,368.54898623489623,0.41073848238482386,0.18328770402286,0.2091072055589436,130099.04308431943,1189.574087771196,131288.61717209063,1452,0,347.57142857142856,38,4,21,35.5521520578071,0.6175986842105263,44.95192307692307,1020.1923076923069,26.847165991902813,0
2683,4,0,2,39,0.0,0.04878048780487805,0.9512195121951219,41,1000,700,300,0.7,13,7,6,325.63825850468254,0.4065294715447154,0.08343825335012056,0.17964017836715263,128994.83194527068,201.2332146205387,129196.06515989122,1453,1,357.0,40,1,15,37.766564959317066,0.603125,46.03658536585366,1015.8536585365854,25.396341463414636,8
2684,4,2,0,41,0.04878048780487805,0.0,1.0,41,850,400,450,0.47058823529411764,13,4,9,324.6282850070066,0.4097560975609756,0.11779420961630382,0.18129962343171083,129480.23069598337,207.08478329441147,129687.31547927778,1454,0,356.2439024390244,37,4,15,37.29934281404869,0.6131756756756757,45.55921052631579,1017.7631578947367,27.507112375533424,0
2685,4,1,0,42,0.023809523809523808,0.0,1.0,42,1250,900,350,0.72,16,9,7,317.5665826612882,0.4122991676345335,0.12362356514881578,0.17873626648979998,129784.51063368062,-156.95529513887988,129627.55533854174,1455,0,348.73809523809524,39,3,17,37.17073877189396,0.6127136752136753,45.26041666666667,1018.9583333333339,26.127136752136767,0
2686,4,1,0,43,0.023255813953488372,0.0,1.0,43,1000,700,300,0.7,13,7,6,312.0186221591109,0.4159745293466224,0.12920463077108435,0.17671664176009255,130029.26911891077,-485.6893218322374,129543.57979707854,1456,0,341.6046511627907,40,3,18,37.06448452238607,0.6135416666666667,45.020325203252035,1019.9186991869925,25.497967479674813,0
2687,4,1,0,44,0.022727272727272728,0.0,1.0,44,1100,800,300,0.7272727272727273,14,8,6,315.4049050461152,0.4177457716701903,0.13754577098684528,0.18091251113740375,130522.07396597594,-566.3303919624536,129955.74357401348,1457,0,334.8181818181818,40,4,15,36.480192275816336,0.6184895833333333,44.53760162601626,1021.849593495935,25.546239837398375,0
2688,4,1,0,45,0.022222222222222223,0.0,1.0,45,1400,1200,200,0.8571428571428571,16,12,4,310.96131195452836,0.4199494949494949,0.14635807257995026,0.17974400498178797,130820.18455530363,-863.996756109849,129956.18779919378,1458,0,328.35555555555555,41,4,17,36.29307279544866,0.6199186991869918,44.24603174603175,1023.0158730158732,24.951606658923737,0
2689,4,0,1,44,0.0,0.022222222222222223,0.9777777777777777,45,1200,800,400,0.6666666666666666,16,8,8,312.7499367723457,0.41927609427609425,0.1491621698381138,0.1814155728789837,130955.93268320734,-808.7080666726545,130147.22461653469,1459,1,329.35555555555555,42,3,17,36.11051942314367,0.6197916666666667,44.113372093023266,1023.5465116279086,24.370155038759727,0
2690,4,1,1,44,0.022222222222222223,0.022222222222222223,0.9777777777777777,45,700,300,400,0.42857142857142855,11,3,8,316.4959682960003,0.4173611111111111,0.16155843609718135,0.18430004897633223,131104.746231071,-701.1752786791513,130403.57095239186,1460,0,330.26666666666665,42,3,18,35.864714416374945,0.6212797619047619,43.96802325581396,1024.1279069767454,24.383997785160606,0
2691,4,0,0,44,0.0,0.0,1.0,44,1650,1300,350,0.7878787878787878,20,13,7,321.76092060104213,0.4155214940098661,0.15644922686766893,0.1874638681876502,131124.83071932488,-361.830750818836,130762.99996850605,1461,1,338.65909090909093,41,3,18,35.709673253261016,0.6229674796747968,43.9484126984127,1024.20634920635,24.980642663569515,0
2692,4,1,0,45,0.022222222222222223,0.0,1.0,45,850,400,450,0.47058823529411764,13,4,9,317.81072376807964,0.4185395622895623,0.1671396628826971,0.18664157050379968,131429.8311917361,-645.8805744519856,130783.9506172841,1462,0,332.1111111111111,41,4,19,35.50374097007226,0.6260162601626016,43.65079365079366,1025.3968253968267,25.009678668215283,0
2693,4,0,0,45,0.0,0.0,1.0,45,1800,1100,700,0.6111111111111112,25,11,14,319.2098788042594,0.41811868686868686,0.1650222866655926,0.18859087357110585,131658.81406092533,-594.6411840199006,131064.17287690543,1463,1,333.1111111111111,41,4,16,35.23753423554052,0.6283028455284553,43.42757936507937,1026.2896825396829,25.031455671699582,0
2694,4,0,1,44,0.0,0.022222222222222223,0.9777777777777777,45,1050,500,550,0.47619047619047616,16,5,11,320.31664901694813,0.4175715488215488,0.1672088553912887,0.18975140244283878,131760.64819735757,-558.9741394242959,131201.67405793327,1464,2,334.1111111111111,41,4,16,35.10675347054465,0.629319105691057,43.32837301587301,1026.6865079365073,25.041134339914812,0
2695,4,1,0,45,0.022222222222222223,0.0,1.0,45,1250,1000,250,0.8,15,10,5,322.25752685622416,0.41877104377104374,0.17805249715622562,0.1915415862841185,131887.99622858394,-499.62010267070593,131388.37612591323,1465,0,335.0444444444444,41,4,17,34.92893245766531,0.630589430894309,43.204365079365076,1027.182539682539,25.053232675183878,0
2696,4,0,2,43,0.0,0.044444444444444446,0.9555555555555556,45,1550,1300,250,0.8387096774193549,18,13,5,318.16958024548967,0.4183291245791246,0.17214180016727787,0.1901310951847614,132091.88102324257,-594.4763321995496,131497.40469104302,1466,1,336.0444444444444,41,4,17,34.82918355529822,0.6326219512195121,43.00595238095238,1027.9761904761901,25.072590011614395,0
2697,4,0,0,43,0.0,0.0,1.0,43,1650,1200,450,0.7272727272727273,21,12,9,337.98135382039635,0.4171050203026947,0.17498413749344777,0.20206970302879054,132110.53688280808,330.179621918193,132440.71650472627,1467,2,348.06976744186045,40,3,17,34.30127191248187,0.634375,42.98780487804879,1028.0487804878067,25.701219512195166,0
2698,4,0,0,43,0.0,0.0,1.0,43,1550,1200,350,0.7741935483870968,19,12,7,340.2477427221461,0.4168050941306755,0.17616078093597465,0.2046944976269596,132345.71358194537,406.0660610417202,132751.7796429871,1468,3,349.06976744186045,40,3,18,34.00658436213994,0.63671875,42.75914634146342,1028.963414634147,25.724085365853675,0
2699,4,1,0,44,0.022727272727272728,0.0,1.0,44,1550,1100,450,0.7096774193548387,20,11,9,344.6483476719667,0.4192212825933756,0.25230632332110603,0.19212802098506288,129408.11107806192,262.35541013945874,129670.46648820137,1469,0,342.1136363636364,40,4,21,36.86326408310028,0.6072916666666667,45.630081300813,1017.4796747967473,25.436991869918682,8
2700,4,0,1,43,0.0,0.022727272727272728,0.9772727272727273,44,1450,1100,350,0.7586206896551724,18,11,7,342.43881836935964,0.4190781360112756,0.2514203127410679,0.19152482655532477,129537.3963600532,71.72658883597637,129609.12294888918,1470,1,343.1136363636364,40,4,16,36.7880852550664,0.60859375,45.50304878048779,1017.9878048780461,25.44969512195115,0
2701,4,1,0,44,0.022727272727272728,0.0,1.0,44,1000,500,500,0.5,15,5,10,335.1821468782036,0.42083994009866105,0.26126961231117796,0.18888240235215464,129832.53146455316,-96.49067381585053,129736.04079073732,1471,0,342.72727272727275,41,3,18,36.67329812777831,0.610010162601626,45.21329365079364,1019.1468253968234,24.85723964382496,0
2702,4,1,0,45,0.022222222222222223,0.0,1.0,45,1400,800,600,0.5714285714285714,20,8,12,331.63691317668776,0.42165404040404036,0.270246638620804,0.18848730888143347,130165.934917355,-366.4342286501758,129799.50068870482,1472,0,336.0888888888889,43,2,21,36.425853749072,0.6104651162790697,44.88636363636362,1020.4545454545425,23.731501057082383,0
2703,4,0,1,44,0.0,0.022222222222222223,0.9777777777777777,45,900,600,300,0.6666666666666666,12,6,6,322.9460375734451,0.42066498316498313,0.15524841398447342,0.17897659166312793,129176.76150959975,-637.5642107130167,128539.19729888673,1473,1,337.0888888888889,42,3,15,37.65012868172718,0.6019345238095238,45.85755813953488,1016.5697674418602,24.20404208194905,8
2704,4,0,0,44,0.0,0.0,1.0,44,1400,1200,200,0.8571428571428571,16,12,4,329.54850846546606,0.4185936398872445,0.1641207153502231,0.18274962742175868,129201.3888888891,-284.37499999998045,128917.01388888911,1474,3,345.72727272727275,41,3,16,37.4573087431694,0.6036585365853658,45.83333333333334,1016.6666666666683,24.796747967479714,0
2705,4,1,0,45,0.022222222222222223,0.0,1.0,45,1300,1000,300,0.7692307692307693,16,10,6,325.6858269563086,0.42110690235690235,0.17078078377868766,0.18215493738812655,129537.39636005374,-562.3011889417419,128975.095171112,1475,0,339.02222222222224,40,5,12,37.21444377890919,0.60859375,45.503048780487816,1017.9878048780504,25.449695121951258,0
2706,4,1,1,45,0.021739130434782608,0.021739130434782608,0.9782608695652174,46,1400,1100,300,0.7857142857142857,17,11,6,312.6954239563164,0.4227254428341385,0.09532458469828842,0.1724977461716717,128994.27087435659,-1132.8163562014383,127861.45451815515,1476,0,332.6304347826087,45,1,15,38.09583519096449,0.5960648148148149,46.037137681159415,1015.851449275361,22.57447665056358,8
2707,4,0,2,43,0.0,0.044444444444444446,0.9555555555555556,45,1050,700,350,0.6666666666666666,14,7,7,316.7169266641682,0.42045454545454547,0.10015192950470997,0.17459219525155403,128966.15655006863,-830.8470507544538,128135.30949931417,1477,1,340.9111111111111,44,1,16,38.02225767243999,0.5970643939393939,46.06481481481482,1015.740740740741,23.08501683501684,0
2708,4,0,1,42,0.0,0.023255813953488372,0.9767441860465116,43,1100,700,400,0.6363636363636364,15,7,8,326.0879346872117,0.41359819121447033,0.10947855307022003,0.17926282159772333,128856.81918905122,-196.26919205575888,128660.54999699547,1478,2,357.1860465116279,42,1,16,37.89547146401985,0.5987103174603174,46.17248062015504,1015.3100775193806,24.174049464747156,0
2709,4,2,0,44,0.045454545454545456,0.0,1.0,44,700,400,300,0.5714285714285714,10,4,6,316.92062163317905,0.41499295278365045,0.13526618245670052,0.1760841892878982,129277.04480229603,-604.9675526139229,128672.07724968212,1479,0,349.8181818181818,41,3,18,37.70150473124573,0.6044207317073171,45.75892857142858,1016.9642857142867,24.80400696864114,0
2710,4,0,1,43,0.0,0.022727272727272728,0.9772727272727273,44,900,500,400,0.5555555555555556,13,5,8,319.8798287839271,0.4147947498238196,0.13844506707571202,0.17795593513410768,129327.49438027528,-526.1486481166512,128801.34573215863,1480,1,350.8181818181818,41,3,18,37.57507965148412,0.6049288617886179,45.7093253968254,1017.1626984126985,24.808846302748744,0
2711,4,1,0,44,0.022727272727272728,0.0,1.0,44,1500,1000,500,0.6666666666666666,20,10,10,321.1251811972473,0.41569767441860467,0.17113889345361133,0.1802107196777504,129669.75509472088,-471.9552798810161,129197.79981483986,1481,0,351.34090909090907,42,2,14,37.19634985570672,0.6068948412698413,45.373062015503876,1018.5077519379846,24.250184569952015,0
2712,4,0,1,43,0.0,0.022727272727272728,0.9772727272727273,44,1300,700,600,0.5384615384615384,19,7,12,317.9722195654195,0.4154334038054968,0.1662149310508798,0.1788912728052641,129768.46648526232,-547.4465364160778,129221.01994884625,1482,1,352.34090909090907,42,2,14,37.176652401331424,0.6078869047619048,45.276162790697676,1018.8953488372094,24.259413067552607,0
2713,4,2,0,45,0.044444444444444446,0.0,1.0,45,1050,800,250,0.7619047619047619,13,8,5,310.9797680472694,0.4185395622895623,0.19760067467847375,0.17775090863439336,130386.26359593752,-889.5630521002568,129496.70054383726,1483,0,341.9555555555556,42,3,17,36.73031309297913,0.6140873015873016,44.670542635658904,1021.3178294573626,24.31709117755625,0
2714,4,0,0,45,0.0,0.0,1.0,45,1600,1300,300,0.8125,19,13,6,312.7368769368094,0.4181607744107744,0.20478237053891224,0.17967040184801003,130584.26852352619,-832.2967369749456,129751.97178655125,1484,1,342.9555555555556,42,3,11,36.48558968524838,0.6160714285714286,44.47674418604651,1022.0930232558137,24.33554817275747,0
2715,4,0,1,44,0.0,0.022222222222222223,0.9777777777777777,45,1150,700,450,0.6086956521739131,16,7,9,326.63989544287745,0.41788720538720536,0.14030354131534528,0.17450221441227637,127713.43136621926,-656.739626377388,127056.69173984187,1485,2,343.9555555555556,43,2,14,39.04698332396478,0.5857558139534884,47.301136363636374,1010.7954545454566,23.50687103594085,8
2716,4,2,1,45,0.043478260869565216,0.021739130434782608,0.9782608695652174,46,1450,1100,350,0.7586206896551724,18,11,7,324.142508331674,0.4217894524959742,0.16321918887719877,0.17514677514777097,128169.64408738028,-888.7749083027777,127280.8691790775,1486,0,337.30434782608694,41,5,16,38.644537245681086,0.5932418699186992,46.85019841269841,1012.5992063492059,24.697541618273316,0
2717,4,2,1,46,0.0425531914893617,0.02127659574468085,0.9787234042553191,47,900,600,300,0.6666666666666666,12,6,6,319.09345296208653,0.42293015726179467,0.1818743483801213,0.1744433085671062,128635.55304856984,-1190.6474408088375,127444.905607761,1487,0,330.93617021276594,42,5,15,38.29799089374982,0.5964781746031746,46.390503875968996,1014.4379844961244,24.153285345145818,0
2718,4,0,1,45,0.0,0.021739130434782608,0.9782608695652174,46,1300,800,500,0.6153846153846154,18,8,10,301.6895975729608,0.42047101449275365,0.06145473203269125,0.1614606432725065,127785.23090457136,-1489.705022526393,126295.52588204497,1488,1,339.10869565217394,43,3,14,39.60430910680277,0.5864825581395349,47.23011363636364,1011.0795454545461,23.513477801268515,8
2719,4,1,0,46,0.021739130434782608,0.0,1.0,46,900,500,400,0.5555555555555556,13,5,8,302.1752474996733,0.42049114331723025,0.08401308375474437,0.16268749974957203,128024.70842121485,-1462.8204093491916,126561.88801186565,1489,0,340.0652173913044,43,3,16,39.34813714481766,0.5889050387596899,46.993371212121204,1012.0265151515139,23.53550035236079,0
2720,4,1,0,47,0.02127659574468085,0.0,1.0,47,1150,800,350,0.6956521739130435,15,8,7,298.28042785207094,0.42090656799259946,0.094078441425276,0.16196348465612434,128365.37486479159,-1742.112118836835,126623.26274595475,1490,0,333.8085106382979,42,5,19,39.10025020717793,0.59375,46.65697674418604,1013.3720930232544,24.12790697674415,0
2721,4,1,0,48,0.020833333333333332,0.0,1.0,48,1300,700,600,0.5384615384615384,19,7,12,295.3174116894879,0.421875,0.10734108880778548,0.1618339416058393,128731.13854595326,-1996.6906721536484,126734.44787379961,1491,0,327.8333333333333,44,4,10,38.803984184914825,0.5946969696969697,46.29629629629629,1014.8148148148141,23.063973063973048,0
2722,4,0,0,48,0.0,0.0,1.0,48,2000,1700,300,0.85,23,17,6,294.84157090399043,0.42254912825059104,0.11352932239440916,0.1625332679807422,128966.15655006835,-1995.0831618655955,126971.07338820276,1492,1,328.8333333333333,44,4,12,38.57774992403523,0.5970643939393939,46.0648148148148,1015.7407407407388,23.08501683501679,0
2723,4,0,2,46,0.0,0.041666666666666664,0.9583333333333334,48,1400,1000,400,0.7142857142857143,18,10,8,294.3238194656957,0.42270611702127664,0.11337911086817942,0.1629244864485597,129130.7966820986,-1998.7461419753229,127132.05054012328,1493,2,329.8333333333333,44,4,13,38.42409128177098,0.5987215909090908,45.90277777777777,1016.3888888888875,23.099747474747446,0
2724,4,1,0,47,0.02127659574468085,0.0,1.0,47,950,700,250,0.7368421052631579,12,7,5,303.0032599643072,0.42187018193031145,0.12276907109496693,0.16824395528895705,129251.82370401859,-1567.2166320231818,127684.60707199542,1494,0,336.93617021276594,41,6,14,38.080894308943094,0.6041666666666667,45.78373015873016,1016.8650793650789,24.80158730158729,0
2725,4,0,1,46,0.0,0.02127659574468085,0.9787234042553191,47,1600,1300,300,0.8125,19,13,6,300.99826439446014,0.4217738205365402,0.11760946917435189,0.16766633358854902,129377.95380015428,-1611.492091049385,127766.4617091049,1495,1,337.93617021276594,41,6,14,38.00412400455061,0.6054369918699187,45.65972222222222,1017.3611111111109,24.813685636856363,0
2726,4,1,0,47,0.02127659574468085,0.0,1.0,47,1400,1100,300,0.7857142857142857,17,11,6,294.770059998003,0.4238937711995066,0.13001001111906918,0.16527409933360399,129634.9907096533,-1757.4972021349895,127877.49350751832,1496,0,336.531914893617,43,4,12,37.90256338726676,0.6051356589147288,45.40719696969697,1018.3712121212117,23.68305144467934,0
2727,4,1,1,47,0.020833333333333332,0.020833333333333332,0.9791666666666666,48,1450,700,750,0.4827586206896552,22,7,15,290.11535620379817,0.4249131944444444,0.13464571301643757,0.16383584215121647,129916.06710939128,-2061.870782792491,127854.19632659879,1497,0,330.5,45,3,14,37.73720938841998,0.6053240740740741,45.13134057971014,1019.4746376811584,22.654991948470187,0
2728,4,2,0,49,0.04081632653061224,0.0,1.0,49,1200,800,400,0.6666666666666666,16,8,8,287.63097124053775,0.4267467403628118,0.15503319310856645,0.1640820858701197,130309.85189471902,-2302.8471205246406,128007.00477419437,1498,0,324.42857142857144,44,5,17,37.403456666968964,0.6105587121212122,44.74537037037038,1021.0185185185203,23.20496632996637,0
2729,4,0,1,48,0.0,0.02040816326530612,0.9795918367346939,49,650,400,250,0.6153846153846154,9,4,5,286.5793589805826,0.42671130952380953,0.1519175678976703,0.16358163410133902,130333.48765432127,-2329.8225308641686,128003.6651234571,1499,1,325.42857142857144,44,5,17,37.406488030467905,0.6107954545454546,44.722222222222236,1021.1111111111134,23.20707070707076,0
2730,4,0,0,48,0.0,0.0,1.0,48,850,600,250,0.7058823529411765,11,6,5,291.29795543852913,0.4251348256501182,0.1471666975852579,0.1660752648113583,130286.75538230326,-2009.5469072830479,128277.20847502022,1500,2,333.0416666666667,43,5,17,37.333136227313474,0.6116763565891472,44.76799242424243,1020.9280303030313,23.742512332628635,0
2731,4,0,0,48,0.0,0.0,1.0,48,1550,1000,550,0.6451612903225806,21,10,11,291.231167448909,0.42495013297872336,0.14314827692783139,0.16645088187262777,130383.45210808383,-2005.6550053087592,128377.79710277508,1501,3,334.0416666666667,43,5,17,37.237386029979895,0.6126453488372092,44.67329545454546,1021.3068181818194,23.751321353065567,0
2732,4,1,1,48,0.02040816326530612,0.02040816326530612,0.9795918367346939,49,1450,1300,150,0.896551724137931,16,13,3,292.6988255879007,0.4253826530612245,0.16657893132816493,0.16923230371118342,130830.33371913576,-2141.2229938271666,128689.1107253086,1502,0,328.2040816326531,44,5,14,36.7499321205539,0.6157670454545454,44.23611111111111,1023.0555555555552,23.25126262626262,0
2733,4,0,0,48,0.0,0.0,1.0,48,900,500,400,0.5555555555555556,13,5,8,297.451893761848,0.42325096040189125,0.17154616429056402,0.17182221157302027,130794.81336805543,-1818.9670138888973,128975.84635416654,1503,1,335.2708333333333,43,5,14,36.664120841819404,0.6167635658914729,44.27083333333333,1022.9166666666656,23.788759689922458,0
2734,4,0,1,47,0.0,0.020833333333333332,0.9791666666666666,48,1150,700,450,0.6086956521739131,16,7,9,299.733706988991,0.4229000443262411,0.17567440212310403,0.173726096662261,130925.07823216735,-1751.4681927297659,129173.61003943758,1504,2,336.2708333333333,44,4,14,36.474637353358055,0.6167140151515151,44.14351851851852,1023.425925925926,23.259680134680135,0
2735,4,0,1,46,0.0,0.02127659574468085,0.9787234042553191,47,1950,1600,350,0.8205128205128205,23,16,7,337.00348966557226,0.4212149244526673,0.1852090555143282,0.1837801729729138,128537.27357317775,-686.9781604875159,127850.29541269023,1505,3,344.29787234042556,42,5,14,37.94394011785315,0.5954861111111112,46.4874031007752,1014.0503875968997,24.14405684754523,8
2736,4,2,1,47,0.041666666666666664,0.020833333333333332,0.9791666666666666,48,1550,1100,450,0.7096774193548387,20,11,9,335.6124262226898,0.4217272458628842,0.20471968496598025,0.18532093262703245,129032.96212300575,-938.9869038395157,128093.97521916624,1506,0,337.8958333333333,43,5,17,37.474465622766964,0.5990794573643411,45.99905303030304,1016.0037878787889,23.62799506694858,0
2737,4,1,0,48,0.020833333333333332,0.0,1.0,48,1450,1100,350,0.7586206896551724,18,11,7,334.2515452835261,0.4217272458628842,0.21431010928961758,0.18535767511177342,129201.38888888879,-962.5176660066677,128238.87122288212,1507,0,338.6875,40,8,19,37.337773224043715,0.6052083333333333,45.83333333333333,1016.6666666666658,25.416666666666647,0
2738,4,0,0,48,0.0,0.0,1.0,48,1600,1400,200,0.875,18,14,4,330.84204717733314,0.42175494976359335,0.2158521459727636,0.18431050274303148,129382.26176754881,-1038.9815296781305,128343.28023787068,1508,1,339.6875,40,8,20,37.24070189458262,0.60703125,45.655487804878035,1017.3780487804856,25.43445121951214,0
2739,4,0,0,48,0.0,0.0,1.0,48,1300,800,500,0.6153846153846154,18,8,10,328.37159832206237,0.4206929669030733,0.22574782058960574,0.18377802636817958,129563.26116233693,-1091.0209696609477,128472.24019267598,1509,2,340.6875,40,8,15,37.11985093498369,0.6088541666666667,45.47764227642275,1018.0894308943066,25.452235772357664,0
2740,4,0,1,47,0.0,0.020833333333333332,0.9791666666666666,48,1050,500,550,0.47619047619047616,16,5,11,333.5874902463099,0.419778738179669,0.22996997728010427,0.18762012731815997,129756.71315980091,-942.9567428823403,128813.75641691858,1510,3,341.6875,41,7,15,36.79081467056152,0.6092479674796748,45.28769841269841,1018.8492063492059,24.84998064266356,0
2741,4,1,2,46,0.020833333333333332,0.041666666666666664,0.9583333333333334,48,1050,700,350,0.6666666666666666,14,7,7,334.2242003633916,0.42205045803782504,0.2280621718529905,0.176467666033653,127238.61621897737,-1084.3127921676069,126154.30342680977,1511,0,342.4166666666667,42,6,17,39.34122486874121,0.5823412698412698,47.771317829457374,1008.9147286821717,24.02177925433742,8
2742,4,0,1,45,0.0,0.021739130434782608,0.9782608695652174,46,1300,800,500,0.6153846153846154,18,8,10,335.7268328066751,0.4187902576489533,0.23568548057927474,0.17703773381468835,127187.51793503223,-659.9474862258838,126527.57044880635,1512,1,357.5869565217391,43,3,17,39.355676555263486,0.5804263565891472,47.8219696969697,1008.7121212121219,23.458421423537718,0
2743,4,1,1,45,0.021739130434782608,0.021739130434782608,0.9782608695652174,46,1350,1000,350,0.7407407407407407,17,10,7,331.2578824385598,0.4217693236714976,0.23728029602220224,0.17568268239834886,127418.99862825773,-758.2904663923276,126660.7081618654,1513,0,355.5869565217391,44,2,14,39.23139826363415,0.5814393939393939,47.59259259259259,1009.6296296296283,22.946127946127916,0
2744,4,0,0,45,0.0,0.0,1.0,45,1900,1300,600,0.6842105263157895,25,13,12,334.7029555588449,0.41807659932659935,0.23359173126614996,0.17775260548204783,127474.24529384756,-466.798668503213,127007.44662534435,1514,3,364.4888888888889,43,2,14,39.087896974243556,0.5833333333333333,47.53787878787879,1009.8484848484848,23.484848484848484,0
2745,4,0,0,45,0.0,0.0,1.0,45,1200,900,300,0.75,15,9,6,333.54239044079,0.4181607744107744,0.231571053618298,0.17755639826458824,127569.89282024794,-490.00660009182513,127079.88622015611,1515,4,365.4888888888889,43,2,15,39.01934133233347,0.5843023255813953,47.44318181818182,1010.2272727272727,23.493657505285412,0
2746,4,3,1,47,0.0625,0.020833333333333332,0.9791666666666666,48,1400,800,600,0.5714285714285714,20,8,12,324.4971513143226,0.4249686022458629,0.26157318861368806,0.17609064407337163,128340.82729591071,-1265.5881397745065,127075.2391561362,1516,0,343.5833333333333,42,6,18,38.461078703261,0.5935019841269842,46.6812015503876,1013.2751937984497,24.12559985234404,0
2747,4,0,1,46,0.0,0.02127659574468085,0.9787234042553191,47,1250,900,350,0.72,16,9,7,325.925588959145,0.424645390070922,0.2664144525071732,0.177699144937603,128528.34093778688,-1021.8649563820109,127506.47598140487,1517,1,346.1276595744681,43,4,14,38.233874984435296,0.5939922480620154,46.49621212121212,1014.0151515151509,23.581747709654675,0
2748,4,1,0,47,0.02127659574468085,0.0,1.0,47,1000,700,300,0.7,13,7,6,326.20721481194875,0.42505010792476106,0.2732611601335424,0.17838988730374725,128648.39916386887,-1006.7928037476946,127641.60636012118,1518,0,347.0851063829787,43,4,15,38.104503095927065,0.595203488372093,46.377840909090914,1014.4886363636369,23.59275898520086,0
2749,4,0,0,47,0.0,0.0,1.0,47,850,600,250,0.7058823529411765,11,6,5,330.60616588060714,0.425127197039778,0.2747156535947066,0.1812330577873384,128744.48609855653,-887.2558145374222,127857.23028401911,1519,1,348.0851063829787,43,4,15,37.89510823924605,0.596172480620155,46.28314393939394,1014.8674242424238,23.601568005637763,0
2750,4,2,0,49,0.04081632653061224,0.0,1.0,49,1200,700,500,0.5833333333333334,17,7,10,341.34832360022773,0.4321322278911565,0.3165609054509184,0.1752491159553792,126094.86669847641,-1128.8852090385326,124965.98148943788,1520,0,334.83673469387753,40,9,18,40.33652062464163,0.5736979166666667,48.90752032520325,1004.3699186991868,25.109247967479668,8
2751,4,0,1,48,0.0,0.02040816326530612,0.9795918367346939,49,1200,900,300,0.75,15,9,6,344.1007784105996,0.4316184807256236,0.3253126457947131,0.1769916907058889,126171.43090257117,-1116.8624826492219,125054.56841992195,1521,1,335.83673469387753,40,9,18,40.18856632274598,0.5744791666666667,48.83130081300813,1004.674796747967,25.116869918699173,0
2752,4,6,3,51,0.1111111111111111,0.05555555555555555,0.9444444444444444,54,1200,800,400,0.6666666666666666,16,8,8,346.2730684421044,0.4443862101094806,0.3820373537202828,0.18437603499640906,127579.2262067056,-1947.8188619538728,125631.40734475173,1522,0,302.7037037037037,40,14,16,38.6882607383563,0.5888020833333334,47.43394308943089,1010.264227642276,25.256605691056897,0
2753,4,2,2,51,0.03773584905660377,0.03773584905660377,0.9622641509433962,53,1650,1400,250,0.8484848484848485,19,14,5,351.75724955734336,0.44250423318819543,0.38517219187990115,0.1870580686650849,127527.89680621655,-1628.2275555225085,125899.66925069405,1523,0,309.37735849056605,40,13,18,38.60234933091858,0.58828125,47.484756097560975,1010.0609756097563,25.251524390243908,0
2754,4,2,0,53,0.03773584905660377,0.0,1.0,53,1450,1000,450,0.6896551724137931,19,10,9,357.852786932893,0.4421716255442671,0.3492955708265979,0.1867279234185377,126759.19514054112,-1521.8249099411973,125237.37023059993,1524,0,310.33962264150944,40,13,19,39.237898207017174,0.58046875,48.246951219512184,1007.0121951219495,25.17530487804874,6
2755,4,1,0,54,0.018518518518518517,0.0,1.0,54,1400,1100,300,0.7857142857142857,17,11,6,356.98523872812734,0.4439348940135104,0.3656330749354004,0.18794418628129067,127122.02558106581,-1720.808209264263,125401.21737180155,1525,0,305.5740740740741,34,20,20,38.88683941289891,0.595281862745098,47.886904761904766,1008.4523809523814,29.660364145658278,0
2756,4,0,1,53,0.0,0.018518518518518517,0.9814814814814815,54,2050,1400,650,0.6829268292682927,27,14,13,358.301075023213,0.4439203354297694,0.3681051795805885,0.1899975852539508,127413.15593117736,-1669.5458515517607,125743.61007962559,1526,1,306.5740740740741,35,19,16,38.55480243799914,0.5961309523809524,47.59837962962964,1009.6064814814835,28.84589947089953,0
2757,4,0,0,53,0.0,0.0,1.0,53,2050,1500,550,0.7317073170731707,26,15,11,365.0778851103534,0.4420960328979197,0.37117649410521913,0.19382198909322354,127461.32270361608,-1293.3379747990916,126167.98472881698,1527,2,313.2830188679245,36,17,17,38.334309133489455,0.5946180555555556,47.55067567567569,1009.7972972972997,28.04992492492499,0
2758,4,0,0,53,0.0,0.0,1.0,53,2150,1800,350,0.8372093023255814,25,18,7,358.1353912897476,0.4411435655539429,0.38834293978448087,0.1816087076756187,125585.03252239092,-1591.0878381335535,123993.94468425737,1528,3,314.2830188679245,40,13,16,40.441337997228686,0.5684895833333333,49.41565040650407,1002.3373983739849,25.058434959349622,8
2759,4,3,2,54,0.05357142857142857,0.03571428571428571,0.9642857142857143,56,1250,800,450,0.64,17,8,9,341.67744075346303,0.44772050865800866,0.39376471500472277,0.1763737904816525,126317.93986402421,-2566.3288059587708,123751.61105806545,1529,0,298.39285714285717,41,15,15,40.09866689693738,0.5744410569105691,48.685515873015866,1005.2579365079357,24.518486256291116,0
2760,4,1,0,55,0.01818181818181818,0.0,1.0,55,1400,1100,300,0.7857142857142857,17,11,6,344.5497678954704,0.4475448933782267,0.3961558133900458,0.1776403917836646,126268.08080002824,-2298.8724135487605,123969.20838647948,1530,0,304.6,41,14,16,40.07779340637648,0.5739329268292683,48.735119047619044,1005.059523809523,24.513646922183487,0
2761,4,1,1,55,0.017857142857142856,0.017857142857142856,0.9821428571428571,56,1950,1500,450,0.7692307692307693,24,15,9,337.3193801165706,0.4501082251082251,0.3988141082947092,0.17544999505612516,126628.33067611622,-2657.1619982272696,123971.16867788896,1531,0,300.14285714285717,42,14,18,39.889204454285796,0.576140873015873,48.376937984496124,1006.4922480620155,23.964101144333704,0
2762,4,1,1,55,0.017857142857142856,0.017857142857142856,0.9821428571428571,56,1800,1000,800,0.5555555555555556,26,10,16,338.62444788262326,0.44973620129870134,0.4038105087841837,0.17689634713553923,126805.71697084467,-2612.0968204775127,124193.62015036716,1532,0,300.92857142857144,43,13,19,39.6742196314404,0.5765503875968992,48.20075757575757,1007.1969696969686,23.423185341789967,0
2763,4,1,1,55,0.017857142857142856,0.017857142857142856,0.9821428571428571,56,1650,1200,450,0.7272727272727273,21,12,9,307.8554254443032,0.45164366883116885,0.30619836013875745,0.1576871412553926,125999.32980138055,-3419.665753485323,122579.66404789522,1533,0,299.4107142857143,46,10,17,41.27557027225899,0.5645380434782609,49.002659574468076,1003.9893617021263,21.82585568917666,8
2764,4,2,2,55,0.03508771929824561,0.03508771929824561,0.9649122807017544,57,1050,600,450,0.5714285714285714,15,6,9,300.2994486604847,0.45264202172096907,0.32015388698164116,0.15545176945871184,126433.34915457317,-3806.387695003554,122626.96145956962,1534,0,295.10526315789474,42,15,17,41.02032951151363,0.574156746031746,48.57073643410853,1005.717054263567,23.945644149132548,0
2765,4,1,0,56,0.017857142857142856,0.0,1.0,56,1350,1100,250,0.8148148148148148,16,11,5,313.83643358974643,0.45037202380952385,0.3405250112663374,0.16309204827532714,126592.34063995961,-3254.1422587553543,123338.19838120426,1535,0,301.14285714285717,41,15,18,40.51697226603577,0.5772357723577235,48.41269841269841,1006.3492063492057,24.545102593883065,0
2766,4,2,1,57,0.034482758620689655,0.017241379310344827,0.9827586206896551,58,2200,1600,600,0.7272727272727273,28,16,12,305.4948006200686,0.45278155878201254,0.3559526434520073,0.1608158802849819,127117.02338632224,-3831.3136770912,123285.70970923104,1536,0,291.7241379310345,41,17,20,40.1900926381374,0.5825711382113821,47.89186507936508,1008.4325396825407,24.595915602013186,0
2767,4,0,2,55,0.0,0.03508771929824561,0.9649122807017544,57,1600,1100,500,0.6875,21,11,10,311.9821518481699,0.4529161445279866,0.3545430225835129,0.1642308945384073,127117.02338632202,-3468.351501480231,123648.6718848418,1537,1,296.4561403508772,41,16,20,40.02654123626826,0.5825711382113821,47.891865079365076,1008.4325396825388,24.595915602013143,0
2768,4,3,3,55,0.05172413793103448,0.05172413793103448,0.9482758620689655,58,1700,1000,700,0.5882352941176471,24,10,14,302.96189780755924,0.4544452006452914,0.35271112038151986,0.16132831952065785,127582.64853395063,-3869.4637345678975,123713.18479938274,1538,0,291.7931034482759,44,14,14,39.77866373384659,0.5830965909090908,47.43055555555556,1010.2777777777778,22.96085858585859,0
2769,4,1,1,55,0.017857142857142856,0.017857142857142856,0.9821428571428571,56,2000,1500,500,0.75,25,15,10,321.07188873176335,0.4512445887445888,0.3643884819838521,0.17101927013875104,127593.81030654558,-3006.6428668790136,124587.16743966656,1539,0,302.64285714285717,43,13,16,39.309857999812564,0.5845445736434108,47.41950757575758,1010.3219696969697,23.495859760394644,0
2770,4,2,3,54,0.03508771929824561,0.05263157894736842,0.9473684210526316,57,1250,800,450,0.64,17,8,9,320.53122786361973,0.4533860693400167,0.2750388928476486,0.1706388918550336,127571.97251266816,-3182.967861622581,124389.00465104557,1540,0,298.2456140350877,45,12,18,39.34582249917811,0.5817129629629629,47.441123188405804,1010.2355072463779,22.4496779388084,7
2771,4,0,0,54,0.0,0.0,1.0,54,2100,1600,500,0.7619047619047619,26,16,10,331.86223013577944,0.44908135336594457,0.2681814940456171,0.1763088818358964,127489.12144204415,-2338.2351680383813,125150.88627400577,1541,1,315.3703703703704,44,10,18,39.144395036826516,0.5821496212121212,47.52314814814816,1009.9074074074094,22.952441077441122,0
2772,4,0,3,51,0.0,0.05555555555555555,0.9444444444444444,54,1350,1100,250,0.8148148148148148,16,11,5,304.816401197511,0.4491832634521314,0.13226286564771872,0.16298860460726414,127749.32861328125,-3010.301495252486,124739.02711802877,1542,2,316.3703703703704,47,7,15,39.56186673535979,0.5811170212765957,47.265625,1010.9375,21.5093085106383,8
2773,4,0,0,51,0.0,0.0,1.0,51,1100,800,300,0.7272727272727273,14,8,6,322.2523438832822,0.44735294117647056,0.14513217105440424,0.1719992339112974,127676.20991941041,-1971.2084190671894,125705.00150034322,1543,3,331.921568627451,44,7,15,39.19586959841198,0.5840435606060606,47.337962962962976,1010.6481481481503,22.969276094276143,0
2774,4,2,0,53,0.03773584905660377,0.0,1.0,53,1900,1200,700,0.631578947368421,26,12,14,310.6441702341978,0.45092525399129174,0.1678830008124943,0.16785065041092914,128169.06003996167,-2633.5763835565895,125535.48365640508,1544,0,320.35849056603774,42,11,18,38.986842105263165,0.591765873015873,46.850775193798455,1012.5968992248072,24.10944998154303,0
2775,4,1,7,47,0.018518518518518517,0.12962962962962962,0.8703703703703703,54,1600,1000,600,0.625,22,10,12,341.36682995876083,0.4526846028418356,0.023518642459267936,0.18547302205395716,128389.92478103758,-1803.6299651463432,126586.29481589123,1545,0,315.4074074074074,42,12,10,37.98363450935398,0.5939980158730158,46.63275193798449,1013.4689922480603,24.130214101144293,8
2776,4,1,0,48,0.020833333333333332,0.0,1.0,48,1700,1300,400,0.7647058823529411,21,13,8,357.1723564941163,0.44273603723404253,0.05392312020820156,0.1930033976540042,128171.57594601501,-444.131236759446,127727.44470925556,1546,0,353.0416666666667,38,10,17,37.80641133853835,0.5981359649122807,46.848290598290596,1012.6068376068373,26.647548358074665,0
2777,4,3,2,49,0.058823529411764705,0.0392156862745098,0.9607843137254902,51,1300,1100,200,0.8461538461538461,15,11,4,349.2534789805656,0.44655228758169935,0.10244120546797109,0.19235552880689988,128930.61682178038,-1194.1067055766046,127736.51011620378,1547,0,333.2156862745098,42,9,13,37.232253601755545,0.5994543650793651,46.09980620155038,1015.6007751937972,24.18097083794755,0
2778,4,1,1,49,0.02,0.02,0.98,50,650,300,350,0.46153846153846156,10,3,7,354.8884084721329,0.4441156462585034,0.10513481828839377,0.19530310479143803,128898.98667800438,-851.0487528344845,128047.9379251699,1548,0,340.84,41,9,14,37.12143415396639,0.600609756097561,46.13095238095237,1015.4761904761892,24.767711962833882,0
2779,4,0,0,49,0.0,0.0,1.0,49,1950,1600,350,0.8205128205128205,23,16,7,354.7854986890487,0.4421768707482993,0.10877632812841798,0.19590806049587248,129032.9621230055,-644.1952371728772,128388.76688583262,1549,1,348.14285714285717,43,6,14,36.98746776648957,0.5990794573643411,45.999053030303024,1016.003787878787,23.627995066948532,0
2780,4,0,1,48,0.0,0.02040816326530612,0.9795918367346939,49,1200,900,300,0.75,15,9,6,350.772430433666,0.44219458616780044,0.10624960496131419,0.19428757524221915,129154.32527434835,-739.2446844993202,128415.08058984902,1550,2,349.14285714285717,44,5,15,36.965787635877824,0.5989583333333333,45.879629629629626,1016.4814814814808,23.101851851851837,0
2781,4,0,0,48,0.0,0.0,1.0,48,1800,1200,600,0.6666666666666666,24,12,12,356.0833697124275,0.4394023345153664,0.11685315542480956,0.1977363776501099,129255.70371283506,-394.79582653550165,128860.90788629957,1551,3,357.1666666666667,38,10,16,36.72756006163761,0.6091008771929824,45.77991452991453,1016.8803418803413,26.760008996851088,0
2782,4,1,1,48,0.02040816326530612,0.02040816326530612,0.9795918367346939,49,1050,800,250,0.7619047619047619,13,8,5,346.79459613675215,0.44113166099773243,0.12331689189602169,0.1939609977387966,129537.39636005361,-815.4261889417573,128721.97017111185,1552,0,350.85714285714283,40,9,14,36.67723203886727,0.60859375,45.50304878048781,1017.9878048780494,25.449695121951233,0
2783,4,0,1,47,0.0,0.020833333333333332,0.9791666666666666,48,1450,900,550,0.6206896551724138,20,9,11,353.8946909297102,0.44163711583924353,0.1213987821103264,0.19770754860344192,129492.78564453126,-434.6381293402778,129058.14751519098,1553,1,357.8125,39,9,14,36.5419139972026,0.609775641025641,45.546875,1017.8125000000001,26.097756410256412,0
2784,4,0,0,47,0.0,0.0,1.0,47,1350,1000,350,0.7407407407407407,17,10,7,359.99609301948846,0.4405064754856614,0.11515102763142004,0.20046098232348353,129364.36760355026,-85.86661735700864,129278.50098619325,1554,2,366.29787234042556,38,9,17,36.517407057340904,0.6101973684210527,45.67307692307692,1017.3076923076919,26.771255060728734,0
2785,4,1,0,48,0.020833333333333332,0.0,1.0,48,1450,800,650,0.5517241379310345,21,8,13,355.67766946441355,0.4415170656028369,0.1195892978868438,0.19991537973344603,129731.44531249987,-371.48437500001467,129359.96093749985,1555,0,359.6458333333333,41,7,16,36.2538343558282,0.6089939024390244,45.31249999999999,1018.749999999999,24.84756097560973,0
2786,4,0,0,48,0.0,0.0,1.0,48,950,500,450,0.5263157894736842,14,5,9,357.28420604419625,0.4414247192671395,0.1165060358255452,0.20120742129857339,129807.25623582744,-324.383503401384,129482.87273242605,1556,1,360.6458333333333,41,7,17,36.1358547507788,0.6097560975609756,45.23809523809523,1019.0476190476173,24.854819976771154,0
2787,4,1,0,49,0.02040816326530612,0.0,1.0,49,1450,800,650,0.5517241379310345,21,8,13,355.34265289087017,0.4427614795918367,0.13073707021036207,0.20169287289962068,130114.25212013972,-552.9712945436269,129561.28082559608,1557,0,354.265306122449,42,7,18,35.873539747364426,0.611359126984127,44.937015503875955,1020.2519379844937,24.29171280915461,0
2788,4,0,0,49,0.0,0.0,1.0,49,1350,900,450,0.6666666666666666,18,9,9,351.6867971678471,0.44285005668934235,0.13144523115368623,0.20037968675842427,130262.58680555534,-637.5891059732186,129624.99769958212,1558,1,355.265306122449,41,8,18,35.81632653061224,0.6143292682926829,44.79166666666666,1020.8333333333317,24.8983739837398,0
2789,4,0,0,49,0.0,0.0,1.0,49,1400,1100,300,0.7857142857142857,17,11,6,350.79819170728297,0.4424426020408163,0.13565006422149284,0.20065656565656553,130414.5408163263,-650.1629818594333,129764.37783446687,1559,2,356.265306122449,41,8,18,35.68497474747473,0.6158536585365854,44.64285714285713,1021.4285714285696,24.912891986062675,0
2790,4,0,4,45,0.0,0.08163265306122448,0.9183673469387755,49,1500,1200,300,0.8,18,12,6,339.22658518724285,0.4418225623582766,0.19750179468772444,0.1816633219920918,127810.33631601556,-1110.5089069883404,126699.82740902722,1560,3,357.265306122449,40,9,16,38.62981574539362,0.5911458333333333,47.20528455284553,1011.1788617886175,25.279471544715438,8
2791,4,0,0,45,0.0,0.0,1.0,45,1050,800,250,0.7619047619047619,13,8,5,351.49978145737185,0.4364478114478114,0.21496512365250497,0.18790344249433055,127739.20323800125,-19.939595660756027,127719.26364234049,1561,6,385.46666666666664,38,7,16,38.39238533079688,0.59375,47.27564102564102,1010.8974358974353,26.602564102564088,0
2792,4,1,0,46,0.021739130434782608,0.0,1.0,46,1950,1400,550,0.717948717948718,25,14,11,347.60058391918966,0.43842592592592594,0.21878033614121972,0.18758079262135538,128118.16541883704,-293.210177951366,127824.95524088568,1562,0,378.0652173913044,39,7,19,38.10330709606612,0.5958867521367521,46.90104166666668,1012.3958333333353,25.958867521367573,0
2793,4,0,0,46,0.0,0.0,1.0,46,1600,1300,300,0.8125,19,13,6,344.9176589766871,0.4379830917874396,0.22307882755869746,0.18701281647089338,128306.84222961872,-348.93815682013854,127957.90407279858,1563,1,379.0652173913044,38,8,19,37.97848782031002,0.5995065789473684,46.71474358974359,1013.141025641026,26.661605937921735,0
2794,4,0,0,46,0.0,0.0,1.0,46,1650,1100,550,0.6666666666666666,22,11,11,341.9280927146101,0.4375,0.21451352738470497,0.18602143025666407,128442.17985243628,-416.40208378990695,128025.77776864638,1564,2,380.0652173913044,38,8,16,37.916095770095545,0.6008771929824561,46.58119658119658,1013.6752136752139,26.675663517768786,0
2795,4,1,1,46,0.02127659574468085,0.02127659574468085,0.9787234042553191,47,1150,800,350,0.6956521739130435,15,8,7,338.89888968943916,0.44048720320690715,0.22851605130130315,0.18643263976820848,128883.87586805565,-664.279513888883,128219.59635416677,1565,0,372.9574468085106,39,8,18,37.542743810696194,0.6036324786324787,46.145833333333336,1015.4166666666674,26.036324786324805,0
2796,4,1,0,47,0.02127659574468085,0.0,1.0,47,1300,900,400,0.6923076923076923,17,9,8,336.14870054581263,0.44187480727721246,0.24241199960874504,0.18665393438742522,129253.05394441141,-710.350775001654,128542.70316940975,1566,0,372.3404255319149,40,7,19,37.23703278033179,0.6057291666666667,45.78252032520325,1016.8699186991871,25.42174796747968,0
2797,4,0,0,47,0.0,0.0,1.0,47,1500,800,700,0.5333333333333333,22,8,14,338.69319521473636,0.4409497378970089,0.24327643426862,0.1890565026131755,129459.81744497319,-630.5681555291175,128829.24928944407,1567,1,373.3404255319149,40,7,15,36.962211237600705,0.6078125,45.579268292682926,1017.6829268292679,25.442073170731696,0
2798,4,2,0,49,0.04081632653061224,0.0,1.0,49,1800,1000,800,0.5555555555555556,26,10,16,332.37950671088856,0.44221230158730157,0.2640310966771826,0.18901841061982028,130188.40889970529,-1145.6081740881214,129042.80072561717,1568,0,359.0612244897959,42,7,18,36.38415463982783,0.6121031746031746,44.864341085271306,1020.5426356589126,24.298634182355062,0
2799,4,0,3,46,0.0,0.061224489795918366,0.9387755102040817,49,1600,800,800,0.5,24,8,16,338.9056175693799,0.44246031746031744,0.2642382062255868,0.19400223620771076,130444.20070725068,-958.3032676240744,129485.89743962661,1569,1,360.0612244897959,40,9,20,35.958640071627535,0.6177083333333333,44.61382113821137,1021.5447154471522,25.538617886178805,0
2800,4,0,0,46,0.0,0.0,1.0,46,1150,600,550,0.5217391304347826,17,6,11,349.9794494825724,0.4385768921095008,0.267856655476405,0.19982697599488805,130344.39718934905,-76.42792570677608,130267.96926364227,1570,2,380.89130434782606,38,8,20,35.77696693869011,0.6200657894736843,44.71153846153846,1021.1538461538456,26.872469635627517,0
2801,4,0,1,45,0.0,0.021739130434782608,0.9782608695652174,46,900,700,200,0.7777777777777778,11,7,4,350.06813323104336,0.43837560386473434,0.2712469708887062,0.20058127969373685,130480.80490037621,-64.5656412082667,130416.23925916795,1571,3,381.89130434782606,38,8,21,35.63648088117398,0.6214364035087719,44.577991452991455,1021.6880341880342,26.886527215474583,0
2802,4,0,0,45,0.0,0.0,1.0,45,1200,900,300,0.75,15,9,6,351.98843227909884,0.4358164983164983,0.27189318073438273,0.20200321359859633,130542.57079101272,189.89496768237805,130732.4657586951,1572,4,390.24444444444447,37,8,16,35.52485693848355,0.6238738738738738,44.51754385964913,1021.9298245614043,27.61972498814606,0
2803,4,0,0,45,0.0,0.0,1.0,45,1550,1100,450,0.7096774193548387,20,11,9,353.3911359623265,0.4367845117845118,0.26759586862513873,0.20383915430554206,130738.73842191815,240.3822570406135,130979.12067895877,1573,5,391.24444444444447,37,8,16,35.290353275436914,0.6258445945945945,44.325657894736835,1022.6973684210516,27.640469416785177,0
2804,4,2,1,46,0.0425531914893617,0.02127659574468085,0.9787234042553191,47,1300,800,500,0.6153846153846154,18,8,10,341.0549343242382,0.4401017576318224,0.26826915614293845,0.1999036099475297,131355.50356353621,-438.7859437551053,130916.7176197811,1574,0,375.5531914893617,38,9,19,34.98284696890742,0.6302083333333333,43.72329059829059,1025.106837606836,26.976495726495685,0
2805,4,0,1,45,0.0,0.021739130434782608,0.9782608695652174,46,1450,1300,150,0.896551724137931,16,13,3,345.9593548742031,0.4395531400966184,0.27316280902999557,0.2030686194940505,131410.26925131484,-107.47760519396513,131302.79164612087,1575,1,384.5869565217391,38,8,19,34.80189121600498,0.6307565789473684,43.66987179487179,1025.320512820512,26.982118758434527,0
2806,4,0,1,44,0.0,0.022222222222222223,0.9777777777777777,45,1650,1200,450,0.7272727272727273,21,12,9,347.52649508190666,0.438047138047138,0.2676357417699873,0.20475175617042296,131553.00188519535,143.6307325330745,131696.63261772844,1576,2,392.22222222222223,37,8,21,34.61771412284451,0.634009009009009,43.53070175438596,1025.8771929824554,27.726410621147444,0
2807,4,0,0,44,0.0,0.0,1.0,44,1250,800,450,0.64,17,8,9,346.74625546921936,0.4381716878083157,0.2630015833082402,0.20474436624204564,131637.3803117305,328.9537405740166,131966.3340523045,1577,3,398.29545454545456,37,7,17,34.55263649962601,0.6348536036036037,43.4484649122807,1026.206140350877,27.735301090564242,0
2808,4,0,0,44,0.0,0.0,1.0,44,2000,1500,500,0.75,25,15,10,349.1818845596211,0.438193710359408,0.2649152279039062,0.2066397473607566,131721.78578985823,398.9722799322708,132120.7580697905,1578,4,399.29545454545456,37,7,17,34.40504165776545,0.6356981981981982,43.36622807017543,1026.5350877192968,27.744191559980994,0
2809,4,0,1,43,0.0,0.022727272727272728,0.9772727272727273,44,1400,1100,300,0.7857142857142857,17,11,6,364.6601077513937,0.4383919133192389,0.25181589407761207,0.20517778452065127,129772.26382725168,707.8962052046833,130480.16003245636,1579,5,400.29545454545456,38,6,18,35.9835378001468,0.6143092105263157,45.27243589743589,1018.9102564102553,26.813427800269878,8
2810,4,1,0,44,0.022727272727272728,0.0,1.0,44,1550,1100,450,0.7096774193548387,20,11,9,362.54394590962926,0.43953708597603947,0.25629766086882055,0.2057000677059444,130099.04308431932,633.324087771181,130732.3671720905,1580,0,400.27272727272725,38,6,20,35.70530945648759,0.6175986842105263,44.951923076923066,1020.192307692306,26.84716599190279,0
2811,4,0,0,44,0.0,0.0,1.0,44,1200,1000,200,0.8333333333333334,14,10,4,365.00459912205207,0.43919573643410853,0.25673753128479415,0.20767652980422616,130208.06081753575,705.3082082328625,130913.36902576861,1581,1,401.27272727272725,38,6,20,35.53181374088419,0.6186951754385965,44.84508547008546,1020.6196581196563,26.858412055780427,0
2812,4,0,0,44,0.0,0.0,1.0,44,1800,1600,200,0.8888888888888888,20,16,4,366.68545910896114,0.4387332628611698,0.26074846411540675,0.2090935359231178,130293.86421388383,755.4301550408809,131049.29436892472,1582,2,402.27272727272725,33,11,20,35.40178750050012,0.6297348484848485,44.76102941176469,1020.9558823529392,30.938057040998157,0
2813,4,0,1,43,0.0,0.022727272727272728,0.9772727272727273,44,650,400,250,0.6153846153846154,9,4,5,370.5512892304409,0.4383919133192389,0.26309762694119754,0.21215079306490062,130450.30757400984,867.7059304113673,131318.01350442122,1583,3,403.27272727272725,33,11,20,35.1442538387716,0.6313131313131313,44.607843137254896,1021.5686274509792,30.956625074272097,0
2814,4,0,0,43,0.0,0.0,1.0,43,1400,1000,400,0.7142857142857143,18,10,8,380.9647318580435,0.43683093392395717,0.2636405951005909,0.2186899673517028,130552.757690542,1347.1992653811108,131899.95695592312,1584,4,411.5813953488372,32,11,18,34.77421546824808,0.634765625,44.50757575757577,1021.9696969696988,31.936553030303088,0
2815,4,0,0,43,0.0,0.0,1.0,43,1200,900,300,0.75,15,9,6,384.00869618761675,0.43648486526393504,0.2609165070623134,0.2213584647988266,130714.10323245105,1439.0704711254346,132153.17370357647,1585,5,412.5813953488372,32,11,18,34.53255545952178,0.6363932291666667,44.349747474747495,1022.6010101010123,31.956281565656635,0
2816,4,1,0,44,0.022727272727272728,0.0,1.0,44,1200,900,300,0.75,15,9,6,377.6784044219135,0.4367952783650458,0.27418716142725885,0.2210355801270059,131297.6208191612,1117.6551870748604,132415.27600623606,1586,0,404.1818181818182,34,10,19,34.10287683432069,0.6375612745098039,43.77976190476192,1024.880952380954,30.143557422969238,0
2817,4,0,0,44,0.0,0.0,1.0,44,1600,1000,600,0.625,22,10,12,376.016102755051,0.4363548273431994,0.2739673493152983,0.22042416882803328,131360.4817907613,1078.738369965391,132439.2201607267,1587,1,405.1818181818182,32,12,20,34.081834790819904,0.6429036458333333,43.71843434343435,1025.1262626262637,32.03519570707074,0
2818,4,0,1,43,0.0,0.022727272727272728,0.9772727272727273,44,1350,1100,250,0.8148148148148148,16,11,5,375.303725443787,0.43587033121916846,0.28047832167832154,0.2211271043677135,131554.70623214464,1074.594269717371,132629.30050186202,1588,2,406.1818181818182,32,12,19,33.903589743589755,0.6448567708333333,43.5290404040404,1025.883838383838,32.05886994949494,0
2819,4,0,0,43,0.0,0.0,1.0,43,1700,1500,200,0.8823529411764706,19,15,4,379.2765532027016,0.43452380952380953,0.28424026813392955,0.22480152555716953,131781.48275686146,1396.3253111927258,133177.80806805418,1589,3,414.0232558139535,32,11,19,33.572358173471045,0.6471354166666667,43.3080808080808,1026.7676767676762,32.08648989898988,0
2820,4,0,0,43,0.0,0.0,1.0,43,1250,800,450,0.64,17,8,9,378.73331776419604,0.4343392395717977,0.2833324082810682,0.2247723231490058,131831.05656478272,1385.76268742791,133216.81925221064,1590,4,415.0232558139535,33,10,19,33.5361972951472,0.6452020202020202,43.259803921568626,1026.960784313725,31.12002376708258,0
2821,4,0,2,41,0.0,0.046511627906976744,0.9534883720930233,43,1300,900,400,0.6923076923076923,17,9,8,379.4402433001261,0.4329318936877076,0.2833409604637298,0.22612696802214338,131988.41979346887,1416.3436238466036,133404.76341731547,1591,5,416.0232558139535,33,10,19,33.3590488968396,0.646780303030303,43.106617647058826,1027.5735294117649,31.13859180035651,0
2822,4,0,0,41,0.0,0.0,1.0,41,1150,700,450,0.6086956521739131,16,7,9,387.5775857549698,0.42980182926829263,0.2831750180596313,0.23070364413227437,131943.5855556831,2027.675269105197,133971.2608247883,1592,6,429.8536585365854,32,9,19,33.195332022448895,0.6487630208333333,43.150252525252526,1027.39898989899,32.10621843434344,0
2823,4,0,0,41,0.0,0.0,1.0,41,1200,800,400,0.6666666666666666,16,8,8,387.1224185668564,0.42906504065040646,0.2823221605279227,0.23166598372153518,132145.8768862936,2031.3262927719961,134177.2031790656,1593,7,430.8536585365854,33,8,19,33.00258243941201,0.6483585858585859,42.95343137254901,1028.1862745098028,31.157159833630388,0
2824,4,0,1,40,0.0,0.024390243902439025,0.975609756097561,41,1050,700,350,0.6666666666666666,14,7,7,382.6762184261936,0.42792174796747967,0.277292633524453,0.2295783775018615,132240.39619677523,1921.0509479527082,134161.44714472792,1594,8,431.8536585365854,33,8,19,33.02144147901029,0.6493055555555556,42.861519607843135,1028.5539215686272,31.168300653594763,0
2825,4,0,0,40,0.0,0.0,1.0,40,1450,1100,350,0.7586206896551724,18,11,7,400.27833804844204,0.42723023504273505,0.18993351517217927,0.22447731653844716,129643.02722318651,2453.3974771655407,132096.42470035204,1595,9,442.15,35,5,14,35.20819127173542,0.61875,45.39930555555554,1018.402777777776,29.09722222222217,8
2826,4,0,0,40,0.0,0.0,1.0,40,1150,800,350,0.6956521739130435,15,8,7,401.5958447815128,0.426829594017094,0.19647239263803762,0.22572456103236715,129731.44531249974,2419.9218749999704,132151.3671874997,1596,10,443.15,35,5,14,35.08435582822086,0.6196428571428572,45.312499999999986,1018.749999999998,29.107142857142797,0
2827,4,0,0,40,0.0,0.0,1.0,40,1150,700,450,0.6086956521739131,16,7,9,393.9445685987725,0.4266159188034188,0.1915531335149867,0.22242716411653723,129908.37191357996,2235.3395061728042,132143.71141975277,1597,11,444.15,35,5,15,35.09877384196184,0.6214285714285714,45.13888888888887,1019.4444444444421,29.12698412698406,0
2828,4,0,0,40,0.0,0.0,1.0,40,1200,800,400,0.6666666666666666,16,8,8,394.7732493645008,0.4266826923076923,0.19590805902383668,0.22323185666888604,129967.37423911146,2261.5285279492027,132228.90276706067,1598,12,445.15,35,5,15,35.01749905410516,0.6220238095238095,45.0810185185185,1019.6759259259233,29.133597883597808,0
2829,4,0,0,40,0.0,0.0,1.0,40,1000,800,200,0.8,12,8,4,394.6721811775584,0.42664262820512816,0.19359039836567948,0.22334339038891857,129996.88042534704,2261.2304687499754,132258.11089409702,1599,13,446.15,35,5,16,34.98999829758256,0.6223214285714286,45.05208333333332,1019.7916666666652,29.13690476190472,0
2830,4,1,1,40,0.024390243902439025,0.024390243902439025,0.975609756097561,41,1400,1000,400,0.7142857142857143,18,10,8,386.1392974361465,0.43071646341463415,0.19024219623098615,0.2203537427884116,130323.3577806122,1865.1364973072505,132188.49427791947,1600,0,436.2439024390244,34,7,18,34.8752477556255,0.6277573529411764,44.732142857142854,1021.0714285714283,30.03151260504201,0
2831,4,0,0,40,0.0,0.0,1.0,40,950,700,250,0.7368421052631579,12,7,5,394.33569346105793,0.43032852564102564,0.19602040816326527,0.22467963929757964,130262.58680555562,2273.4375000000095,132536.02430555562,1601,1,447.5,34,6,18,34.72789115646259,0.6271446078431373,44.79166666666667,1020.8333333333339,30.024509803921585,0
2832,4,0,0,40,0.0,0.0,1.0,40,1100,700,400,0.6363636363636364,15,7,8,390.49933051621366,0.42974091880341886,0.19573889392565746,0.22317137904631268,130380.76560356647,2182.720336076813,132563.4859396433,1602,2,448.5,35,5,18,34.70553792686612,0.6261904761904762,44.675925925925924,1021.2962962962958,29.179894179894166,0
2833,4,0,0,40,0.0,0.0,1.0,40,1000,1000,0,1.0,10,10,0,397.27173270368036,0.42863247863247866,0.1934824462061151,0.22808253574600137,130558.13426997613,2373.411243998646,132931.54551397476,1603,3,449.5,35,5,15,34.35211400528501,0.6279761904761905,44.502314814814824,1021.9907407407419,29.19973544973548,0
2834,4,1,0,41,0.024390243902439025,0.0,1.0,41,900,600,300,0.6666666666666666,12,6,6,391.9596000726588,0.43074186991869917,0.19060683012729296,0.22683725644969305,130866.81909950508,2058.901215404615,132925.7203149097,1604,0,439.5121951219512,36,5,16,34.17414153642968,0.6290509259259259,44.20045045045046,1023.1981981981996,28.42217217217221,0
2835,4,0,2,39,0.0,0.04878048780487805,0.9512195121951219,41,1150,900,250,0.782608695652174,14,9,5,391.63309107505904,0.43081808943089434,0.19164376502919933,0.2269873425822795,130924.43795146521,2054.8684664394373,132979.30641790465,1605,1,440.5121951219512,36,5,17,34.12398217429578,0.6296296296296297,44.14414414414416,1023.4234234234252,28.42842842842848,0
2836,4,0,0,39,0.0,0.0,1.0,39,1350,1000,350,0.7407407407407407,17,10,7,402.8401776020636,0.4256635177687809,0.17636362054414323,0.2332357570517253,130883.62328800155,2745.0364101080263,133628.65969810958,1606,2,434.87179487179486,35,4,17,33.87873260943332,0.63125,44.18402777777778,1023.2638888888889,29.23611111111111,0
2837,4,0,1,38,0.0,0.02564102564102564,0.9743589743589743,39,1250,1000,250,0.8,15,10,5,420.41374147889417,0.42535425101214575,0.22804796414331063,0.22722975843123056,128180.90236490952,3132.1235375288115,131313.02590243833,1607,3,435.87179487179486,28,11,21,36.19584752175558,0.6220238095238095,46.839080459770116,1012.6436781609196,36.165845648604275,8
2838,4,1,0,39,0.02564102564102564,0.0,1.0,39,1150,1000,150,0.8695652173913043,13,10,3,414.6113015647557,0.423301844354476,0.24162478620771966,0.2260699860137629,128531.54176311744,2858.1259645061905,131389.66772762363,1608,0,436.7692307692308,29,10,20,35.982371136374,0.6224856321839081,46.493055555555564,1014.0277777777791,34.96647509578548,0
2839,4,1,0,40,0.025,0.0,1.0,40,1100,800,300,0.7272727272727273,14,8,6,404.61974180833226,0.42370459401709404,0.2429597165236852,0.22274856833432008,128912.72454660237,2432.1266643709823,131344.85121097334,1609,0,426.825,32,8,21,35.84483401715777,0.6181640625,46.11742424242424,1015.530303030303,31.73532196969697,0
2840,4,0,0,40,0.0,0.0,1.0,40,1400,1300,100,0.9285714285714286,15,13,2,403.40082209242587,0.422275641025641,0.24604533865425093,0.22257362789576612,129001.10995708557,2407.830761504759,131408.94071859034,1610,1,427.825,36,4,21,35.785251080811435,0.6102430555555556,46.03040540540541,1015.8783783783792,28.218843843843867,0
2841,4,0,0,40,0.0,0.0,1.0,40,1300,1000,300,0.7692307692307693,16,10,6,403.40082209242587,0.42223557692307695,0.24604533865425093,0.22257362789576612,129001.10995708557,2407.830761504759,131408.94071859034,1611,2,428.825,36,4,21,35.785251080811435,0.6102430555555556,46.03040540540541,1015.8783783783792,28.218843843843867,0
2842,4,0,0,40,0.0,0.0,1.0,40,1000,700,300,0.7,13,7,6,408.6363396219637,0.4216746794871795,0.2509143381163015,0.22612837205707353,129117.79495854494,2552.44462238381,131670.23958092876,1612,3,429.825,37,3,21,35.532757039594344,0.6095157657657657,45.915570175438596,1016.3377192982457,27.468587008060695,0
2843,4,0,0,40,0.0,0.0,1.0,40,1150,700,450,0.6086956521739131,16,7,9,415.8593440173761,0.4213541666666667,0.2584084391642767,0.23123295187845458,129307.31336805562,2754.947315520169,132062.2606835758,1613,4,430.825,29,11,21,35.1550764713915,0.6303879310344828,45.72916666666667,1017.0833333333339,35.07183908045979,0
2844,4,1,0,41,0.024390243902439025,0.0,1.0,41,900,600,300,0.6666666666666666,12,6,6,403.04536091680893,0.42573678861788616,0.25553941041839434,0.2261564428329471,129665.12891981355,2252.185736762176,131917.31465657573,1614,0,421.2926829268293,31,10,20,35.115166624051824,0.6283602150537635,45.37760416666668,1018.4895833333348,32.85450268817209,0
2845,4,0,1,40,0.0,0.024390243902439025,0.975609756097561,41,1350,1100,250,0.8148148148148148,16,11,5,383.851281338241,0.42578760162601625,0.20967755041237268,0.2093628581738863,128543.91289515879,1668.3491346075984,130212.2620297664,1615,1,422.2926829268293,36,5,17,36.74949102350548,0.6056134259259259,46.480855855855864,1014.0765765765775,28.16879379379382,8
2846,4,0,1,39,0.0,0.025,0.975,40,1400,1100,300,0.7857142857142857,17,11,6,390.35727361428343,0.42413194444444446,0.2305466788404471,0.21297076160699585,128555.01570001725,2036.4770876200366,130591.49278763728,1616,2,433.7,35,5,18,36.573175835045255,0.6077380952380953,46.46990740740741,1014.1203703703712,28.97486772486775,0
2847,4,2,0,41,0.04878048780487805,0.0,1.0,41,850,600,250,0.7058823529411765,11,6,5,381.95141643356044,0.4291158536585366,0.24480027259525272,0.21043493126538076,128943.91593874284,1650.0622666585575,130593.97820540139,1617,0,423.0487804878049,36,5,21,36.38845770041025,0.6096643518518519,46.086711711711715,1015.6531531531534,28.212587587587596,0
2848,4,0,0,41,0.0,0.0,1.0,41,1200,1100,100,0.9166666666666666,13,11,2,382.755883780891,0.42896341463414633,0.24715699445590245,0.21148844699050715,129058.3166570288,1679.5660102670408,130737.88266729584,1618,1,424.0487804878049,36,5,21,36.251108278842956,0.6108217592592593,45.97409909909911,1016.1036036036048,28.225100100100136,0
2849,4,2,2,41,0.046511627906976744,0.046511627906976744,0.9534883720930233,43,1400,800,600,0.5714285714285714,20,8,12,369.7921864437012,0.4346391657438169,0.2462961200877456,0.20731746695662706,129631.08114448926,987.4707055028175,130618.55184999207,1619,0,405.27906976744185,36,7,16,35.996535073168936,0.6166087962962963,45.411036036036045,1018.3558558558573,28.2876626626627,0
2850,4,0,0,41,0.0,0.0,1.0,41,950,600,350,0.631578947368421,13,6,7,377.6478232618584,0.43041158536585367,0.24809584937954665,0.21103848946986198,129504.14540816324,1581.3917233560064,131085.53713151926,1620,1,420.390243902439,34,7,18,35.925925925925924,0.6194852941176471,45.535714285714285,1017.8571428571427,29.93697478991596,0
2851,4,0,1,40,0.0,0.024390243902439025,0.975609756097561,41,1150,700,450,0.6086956521739131,16,7,9,375.8561666769351,0.4302337398373984,0.24450121751626708,0.21068634664184144,129625.34722222216,1544.0972222222185,131169.44444444438,1621,2,421.390243902439,34,7,18,35.84799509001637,0.6207107843137255,45.416666666666664,1018.3333333333328,29.950980392156847,0
2852,4,0,0,40,0.0,0.0,1.0,40,1050,700,350,0.6666666666666666,14,7,7,379.7658925815799,0.4308760683760684,0.2366564417177912,0.21345462238206048,129731.44531250003,1853.5156250000014,131584.96093750003,1622,3,421.325,33,7,19,35.64033742331288,0.6240530303030303,45.3125,1018.7500000000002,30.871212121212128,0
2853,4,0,2,38,0.0,0.05,0.95,40,1100,1000,100,0.9090909090909091,12,10,2,380.60896902656833,0.43064903846153846,0.2369677652152995,0.2140989829828749,129762.65889321425,1877.766363898515,131640.42525711277,1623,4,422.325,33,7,19,35.587061983802414,0.6243686868686869,45.281862745098046,1018.8725490196086,30.874925727866927,0
2854,4,0,0,38,0.0,0.0,1.0,38,1050,800,250,0.7619047619047619,13,8,5,400.8314473085822,0.42382349454717877,0.25481025019362247,0.22359013281345963,129433.15505981448,2776.1757744683173,132209.3308342828,1624,5,445.2368421052632,31,7,19,35.40853593516741,0.626008064516129,45.60546875,1017.5781250000002,32.82510080645162,0
2855,4,0,0,38,0.0,0.0,1.0,38,1000,700,300,0.7,13,7,6,401.04007677608143,0.42309743954480794,0.2529204230994526,0.22408365119075258,129499.41211276589,2786.8908352322105,132286.3029479981,1625,6,446.2368421052632,31,7,19,35.33551341094194,0.6266801075268817,45.540364583333336,1017.8385416666671,32.83350134408604,0
2856,4,0,0,38,0.0,0.0,1.0,38,850,500,350,0.5882352941176471,12,5,7,400.4579496934643,0.4236012328117591,0.25046788113799434,0.2239470851719244,129532.54699707034,2774.4676378038207,132307.01463487415,1626,7,447.2368421052632,31,7,19,35.31647053807451,0.627016129032258,45.5078125,1017.9687500000002,32.83770161290323,0
2857,4,0,0,38,0.0,0.0,1.0,38,850,600,250,0.7058823529411765,11,6,5,424.5085566544919,0.42351232811759126,0.1751369950299475,0.22887993981501958,128082.49831795457,3305.7716331496486,131388.26995110422,1627,8,448.2368421052632,33,5,18,36.19350282485875,0.6073232323232323,46.936274509803916,1012.2549019607837,30.674390968508597,8
2858,4,1,0,39,0.02564102564102564,0.0,1.0,39,1300,800,500,0.6153846153846154,18,8,10,445.4371789868619,0.42732231219073324,0.1968169996958482,0.23453439676760876,127125.89831555671,3562.1450833016274,130688.04339885834,1628,0,437.71794871794873,30,9,16,36.65283886445423,0.6052083333333333,47.88306451612903,1008.4677419354838,33.61559139784946,8
2859,4,2,1,40,0.04878048780487805,0.024390243902439025,0.975609756097561,41,1450,1200,250,0.8275862068965517,17,12,5,426.32819074919774,0.43150406504065036,0.19657763065331957,0.22839213911105857,127825.12825540765,2699.091132282425,130524.21938769007,1629,0,417.3170731707317,32,9,17,36.41268156657094,0.6070963541666667,47.19065656565657,1011.2373737373741,31.60116792929294,0
2860,4,0,1,39,0.0,0.025,0.975,40,1000,500,500,0.5,15,5,10,434.44427598483026,0.42831196581196584,0.20685738190243286,0.2332548431324217,127913.9222039115,3114.294264051626,131028.21646796312,1630,1,428.375,31,9,17,36.11589329386022,0.6105510752688172,47.10286458333332,1011.5885416666652,32.631888440860166,0
2861,4,0,0,39,0.0,0.0,1.0,39,950,700,250,0.7368421052631579,12,7,5,435.2157357954698,0.42628205128205127,0.23065684481543203,0.2342201054184482,128008.47867166712,3342.2608466296515,131350.7395182968,1631,2,439.2307692307692,30,9,19,35.99885996369593,0.6142361111111111,47.00940860215053,1011.9623655913969,33.73207885304656,0
2862,4,0,0,39,0.0,0.0,1.0,39,900,600,300,0.6666666666666666,12,6,6,436.12240009351956,0.42622582096266304,0.22821931274266305,0.23492580844954436,128045.67337036123,3368.7172783745527,131414.39064873577,1632,3,440.2307692307692,31,8,19,35.9375670054462,0.6118951612903225,46.97265624999999,1012.1093749999992,32.648689516129004,0
2863,4,0,0,39,0.0,0.0,1.0,39,850,500,350,0.5882352941176471,12,5,7,435.73980931091126,0.4255229419703104,0.2338292708663079,0.23529949702789196,128144.53124999991,3367.61101616752,131512.14226616744,1633,4,441.2307692307692,29,10,19,35.845336076817546,0.6185344827586207,46.87499999999999,1012.4999999999993,34.91379310344825,0
2864,4,0,0,39,0.0,0.0,1.0,39,1650,1200,450,0.7272727272727273,21,12,9,433.34181164185776,0.4251855600539811,0.2394381050810992,0.23482876479314344,128285.19483024688,3318.2677469135724,131603.46257716045,1634,5,442.2307692307692,29,10,20,35.76112786765376,0.6199712643678161,46.73611111111111,1013.0555555555553,34.932950191570875,0
2865,4,0,0,39,0.0,0.0,1.0,39,1200,700,500,0.5833333333333334,17,7,10,434.142150764378,0.4245389113810167,0.24461917912178266,0.23609310106396655,128425.93557098768,3351.0223765432092,131776.9579475309,1635,6,443.2307692307692,29,10,18,35.59593952681098,0.6214080459770115,46.59722222222222,1013.6111111111113,34.95210727969349,0
2866,4,1,0,40,0.025,0.0,1.0,40,1000,900,100,0.9,11,9,2,420.1831546484138,0.4255742521367521,0.24280915650659418,0.23038418806711772,128752.49496224862,2819.9259004183127,131572.42086266694,1636,0,433.125,32,8,19,35.61416604462139,0.6165364583333333,46.27525252525252,1014.8989898989888,31.7155934343434,0
2867,4,0,1,39,0.0,0.025,0.975,40,1100,900,200,0.8181818181818182,13,9,4,405.55529131985736,0.42562767094017095,0.2026551724137935,0.21153063755891832,126742.1392746913,2280.9702134986155,129023.10948818992,1637,1,434.125,32,8,19,38.05459770114942,0.5960286458333333,48.263888888888886,1006.944444444444,31.467013888888875,8
2868,4,0,0,39,0.0,0.0,1.0,39,1150,900,250,0.782608695652174,14,9,5,410.5425066174279,0.42467948717948717,0.22094453673401016,0.21407452485991718,126731.21346367736,2605.7100084092926,129336.92347208665,1638,9,446.2307692307692,31,8,19,37.940347644295,0.5984543010752688,48.274739583333336,1006.9010416666672,32.48067876344088,0
2869,4,5,2,42,0.11363636363636363,0.045454545454545456,0.9545454545454546,44,950,500,450,0.5263157894736842,14,5,9,361.90282646615503,0.43726876321353064,0.21969696969696972,0.1954275262917239,128144.53125000013,475.6864759657261,128620.21772596586,1639,0,396.40909090909093,35,9,21,37.71433470507545,0.6035714285714286,46.87500000000001,1012.500000000001,28.92857142857146,0
2870,4,0,0,42,0.0,0.0,1.0,42,1050,800,250,0.7619047619047619,13,8,5,379.75604346591524,0.4344149245063879,0.22850922174212762,0.2038399937668908,127903.5732001133,1314.4309807256147,129218.00418083892,1640,1,416.2857142857143,34,8,21,37.50956219842297,0.6032475490196079,47.113095238095234,1011.5476190476185,29.751400560224074,0
2871,4,0,0,42,0.0,0.0,1.0,42,1350,1000,350,0.7407407407407407,17,10,7,382.90020569419465,0.43425764614789003,0.2276047092560851,0.20630022489303187,128054.1454081633,1406.391723356011,129460.5371315193,1641,2,417.2857142857143,34,8,21,37.27554300948796,0.6047794117647058,46.964285714285715,1012.1428571428575,29.76890756302522,0
2872,4,1,1,42,0.023255813953488372,0.023255813953488372,0.9767441860465116,43,1400,900,500,0.6428571428571429,19,9,10,373.2115756029759,0.43579272794389073,0.22317718429372535,0.203522163955579,128536.57171201795,994.2991780045122,129530.87089002246,1642,0,408.5581395348837,34,9,16,37.026737497065035,0.6096813725490196,46.48809523809523,1014.0476190476176,29.82492997198875,0
2873,4,0,0,42,0.0,0.0,1.0,42,1550,1100,450,0.7096774193548387,20,11,9,376.62700399171285,0.43446331784746417,0.22339461853318165,0.2050738852936971,128476.21882086147,1277.5226757369387,129753.7414965984,1643,4,419.2857142857143,34,8,16,37.0019179583529,0.6090686274509804,46.54761904761904,1013.8095238095221,29.8179271708683,0
2874,4,0,1,41,0.0,0.023809523809523808,0.9761904761904762,42,1000,600,400,0.6,14,6,8,391.86191847715594,0.43475367789392183,0.23541239323668117,0.20459474244252,126783.27596357155,1548.6410250374447,128331.916988609,1644,5,420.2857142857143,33,9,14,38.35685892755739,0.5940656565656566,48.22303921568626,1007.1078431372537,30.518419489007687,8
2875,4,2,3,40,0.046511627906976744,0.06976744186046512,0.9302325581395349,43,1550,1000,550,0.6451612903225806,21,10,11,381.0221018632285,0.43452380952380953,0.2485703393061378,0.2017917802434921,127362.24666950085,1105.566184807216,128467.81285430807,1645,0,411.3488372093023,34,9,13,38.03367142351691,0.5977328431372548,47.648809523809504,1009.4047619047597,29.68837535013999,0
2876,4,1,0,41,0.024390243902439025,0.0,1.0,41,750,400,350,0.5333333333333333,11,4,7,395.71681802831284,0.4317073170731707,0.25691294112065854,0.20786504119418245,127030.23626730079,1853.6001778161917,128883.83644511698,1646,0,432.0,33,8,16,38.005004457411445,0.5965909090909092,47.97794117647057,1008.0882352941156,30.548128342245928,0
2877,4,0,0,41,0.0,0.0,1.0,41,1100,800,300,0.7272727272727273,14,8,6,397.46587077169323,0.4320884146341464,0.25775421645539875,0.2092656499573838,127123.84458537391,1905.4929350564112,129029.33752043032,1647,1,433.0,32,9,17,37.86439422394725,0.5999348958333333,47.88510101010101,1008.4595959595957,31.514362373737367,0
2878,4,1,0,42,0.023809523809523808,0.0,1.0,42,950,600,350,0.631578947368421,13,6,7,388.014054885592,0.43539488966318235,0.2509459685851778,0.20648159163472765,127555.82475790546,1498.6905577181626,129054.51531562362,1648,0,423.6666666666667,33,9,14,37.658088681305344,0.6019570707070707,47.457107843137244,1010.1715686274497,30.611259655377264,0
2879,4,0,1,41,0.0,0.023809523809523808,0.9761904761904762,42,1500,1300,200,0.8666666666666667,17,13,4,391.19707231303335,0.4352255129694154,0.2532262814183506,0.20881567995893768,127679.6503298011,1589.5810805940046,129269.23141039509,1649,1,424.6666666666667,33,9,14,37.45036073723778,0.603219696969697,47.33455882352941,1010.6617647058828,30.626114081996448,0
2880,4,2,0,43,0.046511627906976744,0.0,1.0,43,1600,1300,300,0.8125,19,13,6,382.22493183627114,0.4353313030638612,0.2639487032251884,0.20640146319158664,128144.53125000016,1196.8517216935934,129341.38297169375,1650,0,415.6744186046512,33,10,19,37.19993141289437,0.6079545454545454,46.87500000000001,1012.5000000000013,30.68181818181822,0
2881,4,1,1,43,0.022727272727272728,0.022727272727272728,0.9772727272727273,44,900,500,400,0.5555555555555556,13,5,8,375.57525654138715,0.4389644996476392,0.25390616662041854,0.2048111418194325,128536.57171201817,855.0311791383276,129391.6028911565,1651,0,407.20454545454544,34,10,15,36.96681537137044,0.6096813725490196,46.48809523809524,1014.0476190476193,29.8249299719888,0
2882,4,1,0,44,0.022727272727272728,0.0,1.0,44,1450,1000,450,0.6896551724137931,19,10,9,377.58295730981524,0.43813865398167723,0.26251013182031446,0.20684557378591706,128717.7154195013,920.3231292517175,129638.03854875301,1652,0,408.1818181818182,34,10,16,36.73060378539025,0.6115196078431373,46.30952380952382,1014.7619047619062,29.845938375350183,0
2883,4,0,0,44,0.0,0.0,1.0,44,1550,1100,450,0.7096774193548387,20,11,9,380.51675707260716,0.4378083157152925,0.2658142162715329,0.2090880737316494,128838.54875283471,1005.0453514739509,129843.59410430866,1653,1,409.1818181818182,34,10,16,36.53259849906192,0.6127450980392157,46.190476190476204,1015.2380952380972,29.859943977591094,0
2884,4,0,1,43,0.0,0.022727272727272728,0.9772727272727273,44,1650,1200,450,0.7272727272727273,21,12,9,393.6461219195697,0.43851303735024666,0.2602241797396945,0.2055508601382175,126788.14785559008,1181.9325417436007,127970.08039733369,1654,2,410.1818181818182,37,7,16,38.30690890945381,0.5858671171171171,48.21820175438596,1007.1271929824554,27.219653864390686,8
2885,4,2,1,44,0.044444444444444446,0.022222222222222223,0.9777777777777777,45,1250,900,350,0.72,16,9,7,379.1783839143587,0.4409511784511784,0.2967128674652293,0.20153560843826615,127506.96277941273,669.9405105416868,128176.90328995441,1655,0,401.68888888888887,37,8,17,37.93143614518874,0.5931869369369369,47.50548245614034,1009.9780701754372,27.29670459933614,0
2886,4,4,2,46,0.08333333333333333,0.041666666666666664,0.9583333333333334,48,1550,1300,250,0.8387096774193549,18,13,5,348.5243831960692,0.445100103427896,0.19621454083384826,0.18648167934404908,127775.65646701395,-690.2335634522128,127085.42290356173,1656,0,377.3958333333333,39,9,20,38.43026650182017,0.5924145299145299,47.239583333333336,1011.0416666666672,25.924145299145312,8
2887,4,0,0,46,0.0,0.0,1.0,46,1250,1000,250,0.8,15,10,5,349.65621844350073,0.44496779388083735,0.19184908918876653,0.18742048492560495,127847.22792935953,-259.48434874715093,127587.74358061238,1657,1,367.2826086956522,38,8,21,38.32840340869075,0.5948464912280702,47.16880341880343,1011.324786324788,26.613810166441787,0
2888,4,1,0,47,0.02127659574468085,0.0,1.0,47,950,500,450,0.5263157894736842,14,5,9,342.5190120395244,0.4476757631822386,0.19528320267604782,0.18483854958423904,128118.16541883716,-623.4185112846844,127494.74690755247,1658,0,360.4468085106383,39,8,23,38.23192115101005,0.5958867521367521,46.901041666666686,1012.3958333333362,25.958867521367594,0
2889,4,2,2,47,0.04081632653061224,0.04081632653061224,0.9591836734693877,49,1300,1000,300,0.7692307692307693,16,10,6,333.31593358607466,0.4489087301587302,0.2067010190460825,0.18226636031413737,128645.9974500871,-1224.042426215244,127421.95502387187,1659,0,346.6938775510204,39,10,16,37.92665656980527,0.6012286324786325,46.38020833333335,1014.479166666669,26.012286324786384,0
2890,4,0,1,46,0.0,0.02127659574468085,0.9787234042553191,47,1500,1400,100,0.9333333333333333,16,14,2,349.6554360362349,0.4457678075855689,0.21377419599881264,0.18999795386730847,128394.44739006221,-421.23670263928364,127973.21068742292,1660,1,362.4255319148936,37,10,17,37.76900988135165,0.6021959459459459,46.628289473684205,1013.4868421052623,27.391536273115197,0
2891,4,1,0,47,0.02127659574468085,0.0,1.0,47,1400,1200,200,0.8571428571428571,16,12,4,351.7676164948148,0.44518963922294175,0.22112111040987403,0.1928684236077086,128751.69406467023,-341.86469184026816,128409.82937282996,1661,0,363.1914893617021,39,8,20,37.35085445961203,0.6022970085470085,46.27604166666667,1014.895833333334,26.022970085470103,0
2892,4,1,2,46,0.020833333333333332,0.041666666666666664,0.9583333333333334,48,1500,1100,400,0.7333333333333333,19,11,8,346.8485717122963,0.4467531028368794,0.23682744543118273,0.1922205145665713,129176.1751720365,-639.0856284643407,128537.08954357216,1662,0,356.6041666666667,41,7,21,37.04326062912722,0.6034044715447154,45.858134920634924,1016.5674603174612,24.79432830042588,0
2893,4,0,0,46,0.0,0.0,1.0,46,1700,1300,400,0.7647058823529411,21,13,8,360.2545757993116,0.444212962962963,0.24388111127546064,0.19847763123144005,128943.2185289842,90.47689867143873,129033.69542765564,1663,1,372.8478260869565,40,6,21,36.94008071509574,0.6026041666666666,46.087398373983746,1015.6504065040662,25.391260162601654,0
2894,4,0,0,46,0.0,0.0,1.0,46,1400,900,500,0.6428571428571429,19,9,10,359.79734602585455,0.4438707729468599,0.24559324319034848,0.19861369785866737,129020.6425263566,84.2569527067169,129104.89947906332,1664,2,373.8478260869565,40,6,22,36.87272848521223,0.6033854166666667,46.011178861788615,1015.955284552845,25.398882113821124,0
2895,4,0,0,46,0.0,0.0,1.0,46,1050,800,250,0.7619047619047619,13,8,5,359.7870538128916,0.4438506441223833,0.2472095035590509,0.1988673715353846,129072.27143441422,87.70645366516419,129159.97788807937,1665,3,374.8478260869565,40,6,22,36.820348701536815,0.60390625,45.960365853658544,1016.1585365853673,25.403963414634184,0
2896,4,0,1,45,0.0,0.021739130434782608,0.9782608695652174,46,1300,900,400,0.6923076923076923,17,9,8,355.5597532711904,0.4435185185185185,0.24956521739130366,0.197592373372696,129285.00987082582,-6.097110598495533,129278.91276022732,1666,4,375.8478260869565,37,9,22,36.71102875112308,0.611204954954955,45.751096491228076,1016.9956140350891,27.4863679468943,0
2897,4,0,0,45,0.0,0.0,1.0,45,1500,1100,400,0.7333333333333333,19,11,8,365.9917280983475,0.44055134680134683,0.24324404103018238,0.20384520786932625,129373.18019032548,469.9027574872219,129843.0829478127,1667,5,384.35555555555555,36,9,23,36.355942365877056,0.6140046296296297,45.664414414414416,1017.3423423423425,28.259509509509513,0
2898,4,1,0,46,0.021739130434782608,0.0,1.0,46,1300,900,400,0.6923076923076923,17,9,8,354.84127282840063,0.4425523349436393,0.23984173557393085,0.1994452671414804,129731.44531250001,6.814236111111825,129738.25954861112,1668,0,376.9782608695652,37,9,20,36.27513633265166,0.6157094594594594,45.3125,1018.7500000000001,27.533783783783786,0
2899,4,1,0,47,0.02127659574468085,0.0,1.0,47,1000,900,100,0.9,11,9,2,345.72209171283043,0.4425686093123651,0.2495337797745194,0.19632634619891473,130132.94004891257,-402.03355310992913,129730.90649580264,1669,0,369.93617021276594,40,7,21,36.09997509960159,0.6145833333333333,44.918699186991866,1020.3252032520315,25.508130081300788,0
2900,4,1,0,48,0.020833333333333332,0.0,1.0,48,1450,1000,450,0.6896551724137931,19,10,9,339.62658089610096,0.44477689125295505,0.2489133934320673,0.19462733584193534,130486.5499480609,-736.4016414628327,129750.14830659807,1670,0,363.2083333333333,37,11,22,35.89736710309796,0.6233108108108107,44.57236842105263,1021.7105263157891,27.613798008534843,0
2901,4,0,0,48,0.0,0.0,1.0,48,1050,500,550,0.47619047619047616,16,5,11,337.64325378071817,0.44464760638297873,0.2473392210144929,0.1941448709239131,130617.28395061739,-779.5910493827057,129837.69290123468,1671,1,364.2083333333333,38,10,20,35.81578351449274,0.6228070175438596,44.44444444444445,1022.2222222222231,26.90058479532166,0
2902,4,0,0,48,0.0,0.0,1.0,48,2150,2000,150,0.9302325581395349,23,20,3,337.2166678226337,0.4447584219858156,0.2398135417727536,0.1946578754468222,130768.17626953138,-780.5582682291522,129987.61800130222,1672,2,365.2083333333333,39,9,20,35.67413942356655,0.6225961538461539,44.29687500000001,1022.812500000001,26.225961538461565,0
2903,4,1,0,49,0.02040816326530612,0.0,1.0,49,1200,900,300,0.75,15,9,6,333.0684680133969,0.4461982709750567,0.2462668734888276,0.19402682200225538,131119.87428944427,-1065.6208688611125,130054.25342058316,1673,0,358.734693877551,40,9,21,35.42514222398623,0.6244791666666667,43.95325203252033,1024.18699186992,25.604674796747997,0
2904,4,0,1,48,0.0,0.02040816326530612,0.9795918367346939,49,1600,1200,400,0.75,20,12,8,337.9638678763522,0.4460388321995465,0.2502297487136098,0.1974131932751669,131223.97898902764,-930.2073005486145,130293.77168847903,1674,1,359.734693877551,40,9,21,35.19473649408187,0.6255208333333333,43.85162601626016,1024.593495934959,25.614837398373975,0
2905,4,0,0,48,0.0,0.0,1.0,48,1100,800,300,0.7272727272727273,14,8,6,344.5055047173488,0.4434101654846336,0.2516377673819452,0.20080157841646074,131141.3425021702,-564.2171223958237,130577.12537977438,1675,2,368.1041666666667,39,9,21,35.11061815654768,0.6263354700854701,43.93229166666667,1024.270833333334,26.263354700854716,0
2906,4,0,0,48,0.0,0.0,1.0,48,1700,1100,600,0.6470588235294118,23,11,12,346.68367670012293,0.4433732269503546,0.2544378071513309,0.2023521638187362,131194.69536675335,-503.3881293402868,130691.30723741307,1676,3,369.1041666666667,39,9,21,35.00095322826641,0.6268696581196581,43.88020833333333,1024.4791666666656,26.268696581196554,0
2907,4,0,0,48,0.0,0.0,1.0,48,1000,700,300,0.7,13,7,6,346.02760393307625,0.44323470744680854,0.25569233693675875,0.2022606568380989,131250.01161882808,-516.7745926697025,130733.23702615837,1677,4,370.1041666666667,40,8,21,34.96189956692783,0.62578125,43.826219512195124,1024.6951219512196,25.617378048780488,0
2908,4,0,0,48,0.0,0.0,1.0,48,1550,900,650,0.5806451612903226,22,9,13,346.44869527809914,0.4432993498817967,0.2541729048586605,0.2033673414655054,131412.43128895407,-494.39721435534443,130918.03407459873,1678,5,371.1041666666667,37,11,21,34.78716625672834,0.6326013513513513,43.667763157894726,1025.3289473684194,27.711593172119443,0
2909,4,0,0,48,0.0,0.0,1.0,48,1800,1300,500,0.7222222222222222,23,13,10,340.4043772667525,0.4428468528368794,0.2539230365783509,0.2009181258510949,131621.90890841998,-639.0652126736306,130982.84369574636,1679,6,372.1041666666667,39,9,20,34.73092833214901,0.6311431623931624,43.46354166666666,1026.145833333332,26.311431623931586,0
2910,4,0,0,48,0.0,0.0,1.0,48,1500,1000,500,0.6666666666666666,20,10,10,340.0657783774668,0.44232971335697396,0.25000000000000044,0.20142357642357647,131755.55555555545,-638.8888888888976,131116.66666666654,1680,7,373.1041666666667,39,9,20,34.60497835497836,0.6324786324786325,43.33333333333333,1026.6666666666658,26.324786324786302,0
2911,4,0,0,48,0.0,0.0,1.0,48,1850,1400,450,0.7567567567567568,23,14,9,332.6060863793977,0.44189568557919623,0.24320766994557652,0.1976991330793998,131889.27001953128,-826.5652126736102,131062.70480685767,1681,8,374.1041666666667,39,9,20,34.66190464117905,0.6338141025641026,43.203125,1027.1875000000002,26.338141025641033,0
2912,4,0,0,48,0.0,0.0,1.0,48,1350,800,550,0.5925925925925926,19,8,11,331.52249342065863,0.441655585106383,0.23741213841578812,0.1974720939070881,131969.53125000003,-849.8263888888891,131119.70486111115,1682,9,375.1041666666667,39,9,20,34.609015950256826,0.6346153846153846,43.125,1027.5000000000002,26.34615384615385,0
2913,4,0,0,48,0.0,0.0,1.0,48,950,400,550,0.42105263157894735,15,4,11,333.5212468993053,0.4410922724586288,0.2407874075574914,0.19964755780127624,132156.90239800359,-784.5730251736061,131372.32937283,1683,10,376.1041666666667,39,9,20,34.36930148921081,0.6364850427350428,42.942708333333336,1028.2291666666674,26.364850427350447,0
2914,4,1,1,48,0.02040816326530612,0.02040816326530612,0.9795918367346939,49,2050,1800,250,0.8780487804878049,23,18,5,326.1947406162486,0.4395549886621315,0.231566316967746,0.1978836676018499,132659.6078413147,-1145.4267259898234,131514.18111532487,1684,0,369.40816326530614,40,9,19,34.053261977573904,0.63984375,42.454268292682926,1030.1829268292681,25.754573170731703,0
2915,4,0,0,48,0.0,0.0,1.0,48,1650,1100,550,0.6666666666666666,22,11,11,335.1135607829109,0.4397070774231679,0.23579306103191477,0.20347502944774526,132692.98095703125,-706.5565321180554,131986.4244249132,1685,12,378.1041666666667,39,9,20,33.79008273514644,0.6418269230769231,42.421875,1030.3125,26.41826923076923,0
2916,4,1,0,49,0.02040816326530612,0.0,1.0,49,1400,900,500,0.6428571428571429,19,9,10,332.7059209114474,0.4386160714285714,0.24647817948970596,0.20382002433144863,133026.28772762575,-948.2732872298186,132078.01444039593,1686,0,371.3673469387755,40,9,21,33.51804419925788,0.6434895833333334,42.09857723577236,1031.6056910569107,25.790142276422767,0
2917,4,0,0,49,0.0,0.0,1.0,49,800,400,400,0.5,12,4,8,337.43320239876186,0.43767715419501135,0.24830635356062647,0.20729789294370427,133131.1463600537,-815.4261889417475,132315.72017111196,1687,1,372.3673469387755,40,9,21,33.2910717216478,0.64453125,41.996951219512205,1032.0121951219526,25.800304878048813,0
2918,4,0,2,47,0.0,0.04081632653061224,0.9591836734693877,49,1900,1600,300,0.8421052631578947,22,16,6,333.97980466879375,0.43659651360544216,0.24816744253300627,0.20619093408531491,133314.74837233144,-895.1132758278629,132419.63509650357,1688,2,373.3673469387755,40,9,21,33.196385226005376,0.6463541666666667,41.81910569105692,1032.7235772357735,25.81808943089434,0
2919,4,0,0,47,0.0,0.0,1.0,47,850,400,450,0.47058823529411764,13,4,9,341.51864219542364,0.43437789084181316,0.25806590058046597,0.2109755350384813,133337.70751953125,-292.5374348958343,133045.1700846354,1689,3,386.59574468085106,39,8,21,32.978756933938485,0.6482371794871795,41.796875,1032.8125,26.482371794871796,0
2920,4,0,0,47,0.0,0.0,1.0,47,1350,900,450,0.6666666666666666,18,9,9,339.1315811922728,0.43393462843046565,0.2606388341309289,0.21010906644885421,133445.31385633696,-348.8959418402567,133096.4179144967,1690,4,387.59574468085106,39,8,21,32.93269230769233,0.6493055555555556,41.69270833333334,1033.229166666668,26.493055555555593,0
2921,4,0,0,47,0.0,0.0,1.0,47,1350,1100,250,0.8148148148148148,16,11,5,337.70403377898083,0.43270120259019423,0.2633097493204051,0.21020072773727608,133617.7198101818,-375.34326912955976,133242.37654105225,1691,5,388.59574468085106,36,11,21,32.797126311585515,0.6565393518518519,41.5259009009009,1033.8963963963963,28.719344344344343,0
2922,4,0,0,47,0.0,0.0,1.0,47,1150,700,450,0.6086956521739131,16,7,9,336.8945782409548,0.4318532223250077,0.2680503596289048,0.21035871523746877,133734.17494775163,-389.1363069150414,133345.03864083657,1692,6,389.59574468085106,36,11,20,32.70164217020504,0.6576967592592593,41.41328828828828,1034.3468468468454,28.73185685685682,0
2923,4,0,0,47,0.0,0.0,1.0,47,1050,600,450,0.5714285714285714,15,6,9,338.2122310004083,0.4316797718162195,0.2616495671281345,0.21184950174933528,133850.68081172364,-346.0125243486989,133504.66828737492,1693,7,390.59574468085106,36,11,21,32.55114811187289,0.6588541666666667,41.30067567567566,1034.7972972972955,28.74436936936932,0
2924,4,0,0,47,0.0,0.0,1.0,47,1600,1300,300,0.8125,19,13,6,337.5979755060172,0.43119796484736356,0.26625264211062416,0.21222370737202464,133982.57757194497,-353.5506117267098,133629.02696021827,1694,8,391.59574468085106,37,10,21,32.43530678528561,0.6582207207207207,41.173245614035075,1035.3070175438577,27.981270744428585,0
2925,4,0,0,47,0.0,0.0,1.0,47,1250,1100,150,0.88,14,11,3,336.45801883314607,0.4309281529448042,0.2647633981273714,0.2118339686573484,134039.3438365649,-380.2775854109175,133659.06625115397,1695,9,392.59574468085106,37,10,21,32.408142736128745,0.6587837837837838,41.11842105263157,1035.526315789472,27.98719772403978,0
2926,4,0,1,46,0.0,0.02127659574468085,0.9787234042553191,47,1100,700,400,0.6363636363636364,15,7,8,336.62589130656016,0.4309474252235584,0.2629586337213885,0.2124318500449612,134124.51577648876,-370.04306613574875,133754.472710353,1696,10,393.59574468085106,37,10,21,32.318791679898375,0.6596283783783784,41.03618421052631,1035.8552631578934,27.99608819345658,0
2927,4,0,0,46,0.0,0.0,1.0,46,1150,500,650,0.43478260869565216,18,5,13,335.43372209309626,0.42946859903381646,0.25441752195534906,0.21233651088425004,134238.1204433094,-194.40152258387855,134043.7189207255,1697,11,397.7826086956522,37,9,21,32.236337424611165,0.6607545045045045,40.926535087719294,1036.2938596491222,28.00794215267898,0
2928,4,0,1,45,0.0,0.021739130434782608,0.9782608695652174,46,1400,1200,200,0.8571428571428571,16,12,4,336.6242169707259,0.4289251207729468,0.2622316212050608,0.21378281423324105,134356.87413251505,-154.4444901015537,134202.42964241348,1698,12,398.7826086956522,38,8,21,32.08706890629293,0.6600877192982456,40.811965811965806,1036.752136752136,27.282950967161476,0
2929,4,1,0,46,0.021739130434782608,0.0,1.0,46,1000,900,100,0.9,11,9,2,333.36927866154485,0.43056561996779386,0.26262199810369324,0.21352777216285312,134667.64219878658,-220.90940250915608,134446.7327962774,1699,0,396.5,36,10,23,31.861867563560093,0.6669560185185186,40.512387387387385,1037.95045045045,28.831956956956944,0
2930,4,0,0,46,0.0,0.0,1.0,46,1350,700,650,0.5185185185185185,20,7,13,334.82379993395284,0.4300422705314009,0.2663792005959935,0.21515054071017267,134784.5538739752,-174.1846999026151,134610.3691740726,1700,1,397.5,36,10,20,31.707741387412803,0.6681134259259259,40.39977477477477,1038.4009009008998,28.84446946946944,0
2931,4,0,1,45,0.0,0.021739130434782608,0.9782608695652174,46,1500,1100,400,0.7333333333333333,19,11,8,337.48275180994693,0.4294987922705314,0.2719865408722044,0.21773537539850132,134930.76480196405,-92.63883816249188,134838.12596380155,1701,2,398.5,36,10,20,31.493198569260784,0.6695601851851851,40.259009009009006,1038.9639639639634,28.860110110110092,0
2932,4,0,0,45,0.0,0.0,1.0,45,800,400,400,0.5,12,4,8,346.7500973112714,0.42670454545454545,0.2806672688949112,0.22353386776355538,134901.51627556607,355.42277919811625,135256.9390547642,1702,16,408.31111111111113,36,9,20,31.28161698283649,0.6692708333333333,40.28716216216216,1038.8513513513512,28.856981981981978,0
2933,4,0,0,45,0.0,0.0,1.0,45,1850,1300,550,0.7027027027027027,24,13,11,342.6178140967442,0.42619949494949494,0.2710736052508209,0.2218590763413339,135063.1925207753,255.01115727912824,135318.20367805444,1703,17,409.31111111111113,37,8,22,31.228023909985936,0.6689189189189189,40.1315789473684,1039.4736842105237,28.093883357041182,0
2934,4,0,0,45,0.0,0.0,1.0,45,1500,1000,500,0.6666666666666666,20,10,10,341.56752450040847,0.42554713804713806,0.2696564974928539,0.22187852070971717,135177.1939442904,234.42790089257016,135411.62184518296,1704,18,410.31111111111113,37,8,22,31.141923239139594,0.670045045045045,40.0219298245614,1039.9122807017534,28.105737316263607,0
2935,4,0,0,45,0.0,0.0,1.0,45,1050,600,450,0.5714285714285714,15,6,9,341.01077040965083,0.4249579124579124,0.2713092770223584,0.22204318317613975,135262.7265721183,225.20931921359636,135487.9358913319,1705,19,411.31111111111113,37,8,22,31.071356417553844,0.6708896396396397,39.93969298245614,1040.2412280701749,28.1146277856804,0
2936,4,0,0,45,0.0,0.0,1.0,45,1400,900,500,0.6428571428571429,19,9,10,337.1699565068218,0.42468434343434347,0.2658424072122707,0.22006484781635044,135348.28625153878,127.07515774082884,135475.3614092796,1706,20,412.31111111111113,37,8,22,31.086231120477702,0.6717342342342343,39.85745614035087,1040.5701754385952,28.123518255097167,0
2937,4,0,0,45,0.0,0.0,1.0,45,1600,1200,400,0.75,20,12,8,335.99479477547067,0.4243686868686869,0.26630160067396824,0.22034575767872022,135519.48676515848,106.76842874730443,135626.2551939058,1707,21,413.31111111111113,37,8,22,30.946802162313954,0.6734234234234234,39.69298245614035,1041.2280701754382,28.141299193930763,0
2938,4,0,0,45,0.0,0.0,1.0,45,1050,700,350,0.6666666666666666,14,7,7,340.79999999999967,0.42409511784511783,0.274488888888889,0.22421052631578958,135633.68055555574,244.83975838721506,135878.52031394295,1708,22,414.31111111111113,36,9,23,30.70833333333332,0.6765046296296297,39.58333333333334,1041.666666666668,28.935185185185226,0
2939,4,0,0,45,0.0,0.0,1.0,45,1000,700,300,0.7,13,7,6,340.47066440945724,0.4235479797979798,0.27433347744631775,0.22436143782879633,135692.3392987583,239.8521832643541,135932.19148202267,1709,23,415.31111111111113,36,9,23,30.658686410145545,0.6770833333333333,39.52702702702703,1041.8918918918926,28.94144144144146,0
2940,4,0,0,45,0.0,0.0,1.0,45,1300,1000,300,0.7692307692307693,16,10,6,342.26298305231603,0.42304292929292925,0.2791750696245079,0.22628472650944564,135809.69482996516,296.52625598572075,136106.22108595088,1710,24,416.31111111111113,36,9,25,30.495534428118688,0.6782407407407407,39.414414414414416,1042.3423423423428,28.953953953953967,0
2941,4,0,0,45,0.0,0.0,1.0,45,1250,700,550,0.56,18,7,11,341.2519160428402,0.42135942760942763,0.2817867489019721,0.22667515540499267,135976.55047706986,280.4516774392132,136257.00215450907,1711,25,417.31111111111113,37,8,19,30.35639192598822,0.677927927927928,39.25438596491228,1042.982456140351,28.188715030820294,0
2942,4,0,0,45,0.0,0.0,1.0,45,2100,1700,400,0.8095238095238095,25,17,8,341.0561009163241,0.42030723905723905,0.27861375553053325,0.22773595692765358,136162.81920017907,287.83204123750136,136450.65124141658,1712,26,418.31111111111113,38,7,19,30.176877537789615,0.6779057017543859,39.075854700854705,1043.696581196582,27.46569950517321,0
2943,4,0,0,45,0.0,0.0,1.0,45,1050,800,250,0.7619047619047619,13,8,5,341.27576145245916,0.41980218855218854,0.2796165523829015,0.22824130493853403,136218.57792981606,297.6197813938353,136516.1977112099,1713,27,419.31111111111113,38,7,21,30.115904206324846,0.678453947368421,39.022435897435905,1043.9102564102577,27.471322537112044,0
2944,4,0,0,45,0.0,0.0,1.0,45,1250,800,450,0.64,17,8,9,339.06706523374373,0.41927609427609425,0.2750599602159707,0.22747979153464984,136330.12963191263,245.01139144569964,136575.14102335833,1714,28,420.31111111111113,38,7,21,30.06308610400684,0.6795504385964912,38.9155982905983,1044.3376068376078,27.48256860098968,0
2945,4,0,0,45,0.0,0.0,1.0,45,1250,1000,250,0.8,15,10,5,337.7131243178137,0.4179713804713805,0.27127471029311456,0.22746793084216413,136469.63346482598,217.51725838266327,136687.15072320864,1715,29,421.31111111111113,38,7,21,29.960378323108394,0.680921052631579,38.78205128205129,1044.8717948717965,27.49662618083675,0
2946,4,0,0,45,0.0,0.0,1.0,45,1400,1100,300,0.7857142857142857,17,11,6,339.6770921728997,0.41769781144781143,0.16930687566005198,0.22262770729627118,135498.08078342024,248.31613594572858,135746.39691936597,1716,30,422.31111111111113,39,6,16,30.872206936801728,0.6696047008547008,39.71354166666667,1041.1458333333342,26.69604700854703,8
2947,4,0,0,45,0.0,0.0,1.0,45,1800,1300,500,0.7222222222222222,23,13,10,338.16596914655065,0.4178030303030303,0.16195525324263937,0.2219727638580479,135552.31255425353,167.83582899306015,135720.1483832466,1717,31,423.31111111111113,39,6,16,30.857694808442538,0.6701388888888888,39.661458333333336,1041.354166666667,26.701388888888896,0
2948,4,0,0,45,0.0,0.0,1.0,45,1850,1400,450,0.7567567567567568,23,14,9,337.37067391982566,0.4176136363636364,0.16068165766750897,0.22264638385750907,135744.9925578934,159.30033816215976,135904.29289605556,1718,32,424.31111111111113,38,7,16,30.687196705625038,0.6737938596491229,39.476495726495735,1042.0940170940187,27.423526765632072,0
2949,4,0,1,44,0.0,0.022222222222222223,0.9777777777777777,45,1050,500,550,0.47619047619047616,16,5,11,333.2624378527274,0.41677188552188554,0.16791894353369718,0.22096748596756952,135912.04616845667,58.87596793047493,135970.92213638715,1719,33,425.31111111111113,38,7,12,30.628628756830594,0.6754385964912281,39.316239316239326,1042.7350427350445,27.44039586144854,0
2950,4,0,0,44,0.0,0.0,1.0,44,1400,1100,300,0.7857142857142857,17,11,6,341.49525374508625,0.4163032945736434,0.16858430768936605,0.22629117546076843,135890.79241930216,481.21212777009225,136372.00454707225,1720,34,424.9318181818182,37,7,14,30.43509219336068,0.6770833333333333,39.33662280701755,1042.6535087719303,28.17982456140352,0
2951,4,0,1,43,0.0,0.022727272727272728,0.9772727272727273,44,1650,1000,650,0.6060606060606061,23,10,13,337.8559830971064,0.4154884601832276,0.16547451812352443,0.2245998579456866,136005.14250779094,390.03022564635546,136395.1727334373,1721,35,425.9318181818182,37,7,14,30.416600967097658,0.6782094594594594,39.22697368421053,1043.0921052631584,28.191678520625903,0
2952,4,0,0,43,0.0,0.0,1.0,43,1050,800,250,0.7619047619047619,13,8,5,327.4737281871641,0.413390550018457,0.11735552713900677,0.20078817733990145,133058.54752218956,172.7094831238636,133231.2570053134,1722,36,435.3953488372093,38,5,20,33.62068965517239,0.647203947368421,42.0673076923077,1031.7307692307709,27.150809716599234,7
2953,4,0,0,43,0.0,0.0,1.0,43,1200,800,400,0.6666666666666666,16,8,8,328.55196170835,0.4124907715023994,0.11499376603620948,0.2021954811481583,133196.36774965338,152.38558331510833,133348.75333296848,1723,37,436.3953488372093,38,5,21,33.454943765955996,0.6485745614035088,41.9337606837607,1032.2649572649602,27.16486729644632,0
2954,4,1,0,44,0.022727272727272728,0.0,1.0,44,900,600,300,0.6666666666666666,12,6,6,323.8813735691984,0.41426620859760394,0.12371700879765402,0.20080645161290342,133472.2222222226,-154.16666666662763,133318.05555555597,1724,0,427.45454545454544,39,5,22,33.29973118279571,0.6495726495726496,41.666666666666686,1033.3333333333362,26.49572649572657,0
2955,4,0,0,44,0.0,0.0,1.0,44,1100,800,300,0.7272727272727273,14,8,6,323.3441931117897,0.4132091261451727,0.12486260768269619,0.2012219779255817,133610.2564673281,-159.57988622248365,133450.6765811056,1725,1,428.45454545454544,38,6,23,33.175743171092975,0.6526864035087719,41.53311965811967,1033.8675213675238,27.20704003598747,0
2956,4,1,0,45,0.022222222222222223,0.0,1.0,45,1350,900,450,0.6666666666666666,18,9,9,317.7177332217622,0.4151094276094276,0.12920063063969622,0.1994416370830487,133930.07948133728,-489.607747395785,133440.4717339415,1726,0,419.9111111111111,39,6,17,33.002184596289965,0.6541132478632479,41.22395833333336,1035.1041666666704,26.541132478632573,0
2957,4,0,1,44,0.0,0.022222222222222223,0.9777777777777777,45,1200,800,400,0.6666666666666666,16,8,8,316.9217107157785,0.4155513468013468,0.12548414853554157,0.19981944005370908,134091.86333550376,-500.67545572913167,133591.18787977463,1727,1,420.9111111111111,39,6,18,32.86158184987765,0.655715811965812,41.06770833333335,1035.729166666669,26.55715811965818,0
2958,4,0,0,44,0.0,0.0,1.0,44,1250,1000,250,0.8,15,10,5,339.49112459134034,0.41344036293164205,0.1272048846675713,0.2000986287313053,131568.46923828125,184.17968750000176,131752.64892578125,1728,2,431.40909090909093,39,5,17,34.80820810911429,0.6306089743589743,43.515625,1025.9375,26.306089743589745,8
2959,4,0,1,43,0.0,0.022727272727272728,0.9772727272727273,44,1350,900,450,0.6666666666666666,18,9,9,339.7448703786101,0.4129668780831572,0.12830953940993584,0.2005288626782316,131621.90890842007,143.57367621527396,131765.48258463535,1729,3,432.40909090909093,39,5,18,34.74784708828207,0.6311431623931624,43.463541666666664,1026.1458333333328,26.31143162393161,0
2960,4,0,0,43,0.0,0.0,1.0,43,1250,1000,250,0.8,15,10,5,344.4157712192782,0.41140642303433,0.1461980799728828,0.2033259669674964,131629.44614517124,467.05144185111743,132096.49758702237,1730,4,442.09302325581393,38,5,18,34.62042339059519,0.6329495614035088,43.45619658119658,1026.1752136752132,27.00461088618982,0
2961,4,0,0,43,0.0,0.0,1.0,43,1100,600,500,0.5454545454545454,16,6,10,349.53279536463333,0.41170634920634924,0.15055652767391048,0.20694150527780378,131739.1030777447,609.4273915187159,132348.5304692634,1731,5,443.09302325581393,38,5,18,34.378577375377255,0.634046052631579,43.349358974358964,1026.6025641025624,27.01585695006743,0
2962,4,0,1,42,0.0,0.023255813953488372,0.9767441860465116,43,1150,700,450,0.6086956521739131,16,7,9,351.38076468085325,0.41184477667035807,0.14717068780303721,0.20848592037730615,131821.37573964492,663.8991617356952,132485.27490138062,1732,6,444.09302325581393,38,5,18,34.24820536828964,0.6348684210526316,43.26923076923077,1026.9230769230765,27.024291497975696,0
2963,4,1,0,43,0.023255813953488372,0.0,1.0,43,1350,900,450,0.6666666666666666,18,9,9,346.7451171395024,0.4117986341823551,0.17258646407472766,0.20726999158387366,132103.35422092036,561.2386067708574,132664.5928276912,1733,0,443.69767441860466,39,4,19,34.08326155976628,0.6359508547008548,42.99479166666668,1028.020833333335,26.35950854700859,0
2964,4,0,0,43,0.0,0.0,1.0,43,1050,700,350,0.6666666666666666,14,7,7,346.1092913112801,0.41138335179032853,0.16980136444159633,0.2073295463486019,132183.68055555565,550.0000000000105,132733.68055555565,1734,1,444.69767441860466,39,4,20,34.018773635872506,0.6367521367521367,42.91666666666667,1028.3333333333342,26.367521367521388,0
2965,4,0,0,43,0.0,0.0,1.0,43,1150,700,450,0.6086956521739131,16,7,9,343.10142605351655,0.410921926910299,0.16890197232852455,0.20596514177984696,132264.0313042537,475.9955512153029,132740.026855469,1735,2,445.69767441860466,39,4,20,34.015295358649794,0.6375534188034189,42.83854166666668,1028.6458333333353,26.375534188034237,0
2966,4,1,0,44,0.022727272727272728,0.0,1.0,44,1250,900,350,0.72,16,9,7,339.4636369897214,0.41373766737138834,0.18040362127499066,0.20555461435809758,132590.4923661334,202.0657874536612,132792.55815358707,1736,0,436.54545454545456,38,6,21,33.78090421853389,0.6425438596491229,42.52136752136752,1029.91452991453,27.103013945119212,0
2967,4,0,0,44,0.0,0.0,1.0,44,1350,800,550,0.5925925925925926,19,8,11,341.05293190807095,0.4126695736434109,0.18434919497756397,0.20712307779102296,132700.54879830556,251.5822466944557,132952.13104500002,1737,1,437.54545454545456,38,6,20,33.629501935573046,0.643640350877193,42.41452991452993,1030.341880341883,27.114260008996922,0
2968,4,0,0,44,0.0,0.0,1.0,44,1350,1000,350,0.7407407407407407,17,10,7,334.08728055528474,0.41219608879492603,0.18143235099581068,0.20357929361915658,132827.17013888914,75.17361111113615,132902.34375000026,1738,2,438.54545454545456,39,5,20,33.681959040689826,0.6431623931623931,42.29166666666668,1030.8333333333353,26.43162393162398,0
2969,4,0,0,44,0.0,0.0,1.0,44,1550,1200,350,0.7741935483870968,19,12,7,331.3539434751555,0.41197586328400276,0.18122130394857683,0.20249407656815072,132934.57031250012,9.678819444459577,132944.24913194458,1739,3,439.54545454545456,39,5,20,33.64478114478115,0.6442307692307692,42.18750000000001,1031.250000000001,26.442307692307715,0
2970,4,0,1,43,0.0,0.022727272727272728,0.9772727272727273,44,1650,1300,350,0.7878787878787878,20,13,7,330.2794452447447,0.41192080690627203,0.1802369346295427,0.20227318158680976,133015.1489257815,-13.566080729137752,133001.58284505238,1740,4,440.54545454545456,39,5,20,33.59177774411795,0.6450320512820513,42.109375000000014,1031.562500000002,26.450320512820564,0
2971,4,0,0,43,0.0,0.0,1.0,43,650,500,150,0.7692307692307693,8,5,3,335.19281167780593,0.4111295681063123,0.1896350744687001,0.20536940289091984,133030.99203740247,318.20645226096065,133349.19848966342,1741,5,449.8139534883721,38,5,20,33.449193938138635,0.6469298245614035,42.094017094017104,1031.623931623933,27.147998200629814,0
2972,4,1,0,44,0.022727272727272728,0.0,1.0,44,1450,1000,450,0.6896551724137931,19,10,9,330.25457470240843,0.4124603594080338,0.19783521409517113,0.20431282703205186,133391.50526258716,10.630967881983167,133402.13623046916,1742,0,440.5681818181818,39,5,21,33.21579526738597,0.6487713675213675,41.744791666666686,1033.0208333333362,26.487713675213747,0
2973,4,0,0,44,0.0,0.0,1.0,44,1350,1100,250,0.8148148148148148,16,11,5,325.7503816955021,0.4123722692036646,0.18942609115022901,0.20211964104543162,133500.54974848026,-102.38016444964177,133398.1695840306,1743,1,441.5681818181818,37,7,21,33.22314323607428,0.6534346846846847,41.63925438596491,1033.44298245614,27.930891417733516,0
2974,4,1,0,45,0.022222222222222223,0.0,1.0,45,1300,1100,200,0.8461538461538461,15,11,4,317.74313018219743,0.4147727272727273,0.19613915556931993,0.19922185773947879,133886.5389751808,-491.69440335305495,133394.84457182774,1744,0,432.73333333333335,38,7,17,33.04493135129556,0.6554276315789473,41.26602564102564,1034.9358974358975,27.23515519568151,0
2975,4,0,0,45,0.0,0.0,1.0,45,1450,1200,250,0.8275862068965517,17,12,5,321.61907364346047,0.4143728956228956,0.1973652529838683,0.20225895150413853,133997.13187824163,-380.79331488786494,133616.33856335378,1745,1,433.73333333333335,38,7,17,32.83437381763149,0.6565241228070176,41.159188034188034,1035.3632478632478,27.246401259559153,0
2976,4,0,0,45,0.0,0.0,1.0,45,1050,800,250,0.7619047619047619,13,8,5,323.37535507583226,0.4143728956228956,0.19950474618241887,0.20351648970097183,134024.7872379282,-331.9373675944234,133692.84987033377,1746,2,434.73333333333335,38,7,17,32.761340968496356,0.6567982456140351,41.13247863247863,1035.470085470085,27.24921277552855,0
2977,4,0,0,45,0.0,0.0,1.0,45,1000,700,300,0.7,13,7,6,320.9547346514045,0.4147727272727273,0.1840501792114695,0.1989919354838711,133472.22222222248,-344.90112955655457,133127.32109266592,1747,3,435.73333333333335,41,4,17,33.375336021505376,0.6463414634146342,41.66666666666668,1033.3333333333353,25.203252032520375,8
2978,4,0,1,44,0.0,0.022222222222222223,0.9777777777777777,45,1150,700,450,0.6086956521739131,16,7,9,319.2597545545407,0.41508838383838387,0.16441758979523358,0.18870531920991596,131675.98101075648,-592.231724355509,131083.74928640097,1748,4,436.73333333333335,42,3,14,35.21899389476336,0.626984126984127,43.41085271317829,1026.3565891472863,24.437061646363958,8
2979,4,0,1,43,0.0,0.022727272727272728,0.9772727272727273,44,1450,1100,350,0.7586206896551724,18,11,7,327.8929922009433,0.41156844608879495,0.18866776763674986,0.19423952926660362,131760.64819735775,-159.32136164650203,131601.32683571125,1749,7,447.5681818181818,41,3,14,34.912290237382024,0.629319105691057,43.32837301587302,1026.6865079365086,25.041134339914844,0
2980,4,0,1,42,0.0,0.023255813953488372,0.9767441860465116,43,900,800,100,0.8888888888888888,10,8,2,326.9128574943359,0.41207548911037284,0.18113517849078686,0.19391833741684092,131811.58002842354,18.18005558706716,131829.7600840106,1750,8,450.4186046511628,41,2,14,34.88622274820469,0.6298272357723578,43.27876984126985,1026.8849206349219,25.045973674022484,0
2981,4,0,0,42,0.0,0.0,1.0,42,900,700,200,0.7777777777777778,11,7,4,332.63728249137796,0.41089576074332174,0.18623652569015325,0.197104660704422,131771.20642681292,366.4032032851006,132137.609630098,1751,9,459.8809523809524,40,2,14,34.77989211125409,0.6309895833333333,43.31808943089432,1026.7276422764241,25.668191056910604,0
2982,4,0,0,42,0.0,0.0,1.0,42,1000,800,200,0.8,12,8,4,331.81875915023653,0.4108110723964382,0.18919453789827756,0.19702469917581045,131849.47472569253,350.02581961796807,132199.5005453105,1752,10,460.8809523809524,40,2,14,34.72215350616795,0.6317708333333334,43.241869918699194,1027.0325203252046,25.675813008130113,0
2983,4,1,0,43,0.023255813953488372,0.0,1.0,43,800,600,200,0.75,10,6,4,331.8619558315748,0.4131829088224437,0.21109261494420473,0.19884861469075768,132193.88247197043,174.0240772234979,132367.90654919393,1753,0,451.13953488372096,41,2,15,34.37479902244518,0.6336382113821138,42.90674603174604,1028.373015873017,25.082268679829685,0
2984,4,0,2,41,0.0,0.046511627906976744,0.9534883720930233,43,800,500,300,0.625,11,5,6,333.061725916775,0.4128137689184201,0.10224194790013375,0.18822218090493048,129943.771701389,68.16174965357499,130011.93345104258,1754,1,452.13953488372096,39,4,16,36.61456204876719,0.6143162393162394,45.10416666666667,1019.5833333333343,26.143162393162417,8
2985,4,0,0,41,0.0,0.0,1.0,41,850,700,150,0.8235294117647058,10,7,3,335.39782826010236,0.4112042682926829,0.1078195331309535,0.18928507193502653,129890.67382812501,513.009982638889,130403.6838107639,1755,2,470.0487804878049,39,2,16,36.608845970433954,0.6137820512820513,45.15625,1019.3750000000001,26.137820512820515,0
2986,4,0,0,41,0.0,0.0,1.0,41,1650,1300,350,0.7878787878787878,20,13,7,337.50832079982433,0.41209349593495936,0.10873599697083702,0.19112457888670198,130023.43885633672,576.7985026041615,130600.23735894088,1756,3,471.0487804878049,39,2,16,36.4204584141899,0.6151175213675213,45.026041666666664,1019.8958333333327,26.1511752136752,0
2987,4,2,1,42,0.046511627906976744,0.023255813953488372,0.9767441860465116,43,1400,1000,400,0.7142857142857143,18,10,8,324.16140750740436,0.4169435215946844,0.10632583739656232,0.1860940648949761,130555.17713758671,-135.3705512152882,130419.80658637143,1757,0,450.09302325581393,39,4,15,36.22305320558556,0.6204594017094017,44.50520833333333,1021.9791666666658,26.204594017093996,0
2988,4,0,0,42,0.0,0.0,1.0,42,1750,1500,250,0.8571428571428571,20,15,5,337.07019388567335,0.4127347077042199,0.10862815345574006,0.19408915496305018,130671.89554569362,409.12023339908217,131081.0157790927,1758,1,461.8095238095238,38,4,15,35.7752089864159,0.6233552631578947,44.39102564102564,1022.4358974358975,26.90620782726046,0
2989,4,1,0,43,0.023255813953488372,0.0,1.0,43,600,400,200,0.6666666666666666,8,4,4,334.37366606045845,0.4157438169066076,0.13088176964845033,0.18010982793816224,128044.10450522782,-35.441016341904,128008.66348888591,1759,0,452.04651162790697,41,2,15,38.51369012611905,0.5919715447154472,46.97420634920634,1012.103174603173,24.68544328300422,8
2990,4,0,1,42,0.0,0.023255813953488372,0.9767441860465116,43,1400,900,500,0.6428571428571429,19,9,10,336.9091786975322,0.415328534514581,0.13928608167883905,0.18205081301382503,128170.89979383687,36.46925169084324,128207.36904552771,1760,1,453.04651162790697,39,4,15,38.32006737989919,0.5964209401709402,46.848958333333336,1012.6041666666672,25.964209401709414,0
2991,4,1,2,41,0.023255813953488372,0.046511627906976744,0.9534883720930233,43,1150,1000,150,0.8695652173913043,13,10,3,334.1082823067637,0.41659745293466227,0.15425798895767118,0.18161304954440274,128408.33875868047,-19.542100694454803,128388.79665798602,1761,0,453.4651162790698,39,4,14,38.14876670092498,0.5988247863247863,46.61458333333333,1013.541666666666,25.988247863247846,0
2992,4,0,0,41,0.0,0.0,1.0,41,1650,1100,550,0.6666666666666666,22,11,11,347.7033227650039,0.4106961382113821,0.16112502936913797,0.18841237530943503,128283.34349270911,720.9089575638487,129004.25245027296,1762,3,476.4878048780488,37,4,16,37.93193256845978,0.6010698198198199,46.73793859649122,1013.0482456140337,27.379682313892804,0
2993,4,1,1,41,0.023809523809523808,0.023809523809523808,0.9761904761904762,42,1300,800,500,0.6153846153846154,18,8,10,348.79038935882625,0.41372677119628337,0.18197816081581042,0.19105023749308717,128713.06911571336,578.7762984878336,129291.84541420119,1763,0,466.1190476190476,38,4,17,37.465782269951546,0.6036184210526316,46.31410256410256,1014.7435897435898,26.70377867746289,0
2994,4,2,0,43,0.046511627906976744,0.0,1.0,43,1500,1300,200,0.8666666666666667,17,13,4,340.06547691458525,0.4169435215946844,0.19729186678139166,0.18820299819941083,129121.97401258703,181.9851345486326,129303.95914713567,1764,0,455.3720930232558,39,4,19,37.270784223292665,0.6060363247863247,45.91145833333334,1016.3541666666684,26.060363247863293,0
2995,4,0,0,43,0.0,0.0,1.0,43,800,600,200,0.75,10,6,4,340.48780655839323,0.4171050203026947,0.19741941019175657,0.18856299752535774,129148.44292534732,194.69401041667712,129343.13693576399,1765,1,456.3720930232558,39,4,19,37.23312495730001,0.6063034188034189,45.88541666666667,1016.4583333333342,26.06303418803421,0
2996,4,2,1,44,0.044444444444444446,0.022222222222222223,0.9777777777777777,45,1050,700,350,0.6666666666666666,14,7,7,329.02677678574986,0.4246212121212121,0.20866267465069877,0.18438748900409477,129614.99851279006,-470.62811255493784,129144.37040023512,1766,0,437.0444444444444,40,5,17,37.05069028609448,0.609375,45.426829268292686,1018.2926829268297,25.457317073170742,0
2997,4,0,0,44,0.0,0.0,1.0,44,1450,1000,450,0.6896551724137931,19,10,9,337.13988246582426,0.4206087033121917,0.2152663486661648,0.18911168278074394,129651.86767578138,-57.83691406248448,129594.0307617189,1767,1,447.97727272727275,39,5,17,36.80672752378032,0.6113782051282051,45.39062500000001,1018.437500000001,26.113782051282076,0
2998,4,0,1,43,0.0,0.022727272727272728,0.9772727272727273,44,900,400,500,0.4444444444444444,14,4,10,338.2995094544749,0.42021229739252997,0.21264258290027804,0.19001900648795608,129704.91672092034,-24.178059895806342,129680.73866102454,1768,2,448.97727272727275,39,5,18,36.723357023553895,0.6119123931623931,45.33854166666668,1018.6458333333351,26.119123931623978,0
2999,4,0,0,43,0.0,0.0,1.0,43,600,400,200,0.6666666666666666,8,4,4,342.5927292066032,0.418812292358804,0.20793577198077062,0.1918277737566941,129581.83235627173,278.7587205055467,129860.59107677727,1769,3,460.3255813953488,38,5,18,36.739025883175934,0.612390350877193,45.459401709401725,1018.1623931623953,26.793747188484087,0
3000,4,1,0,44,0.022727272727272728,0.0,1.0,44,1500,1000,500,0.6666666666666666,20,10,10,335.39980984697377,0.42177589852008457,0.2130159378831218,0.1895434953107497,129943.7717013891,-83.37673611108579,129860.39496527801,1770,0,450.84090909090907,39,5,19,36.55496526358809,0.6143162393162394,45.10416666666668,1019.5833333333351,26.143162393162438,0
3001,4,0,0,44,0.0,0.0,1.0,44,1200,900,300,0.75,15,9,6,335.42183924066717,0.42209522551092316,0.21398633532300426,0.19020185707491932,130076.563856337,-73.89594184025853,130002.66791449675,1771,1,451.84090909090907,39,5,19,36.4198279383233,0.6156517094017093,44.97395833333334,1020.1041666666682,26.156517094017133,0
3002,4,1,0,45,0.022222222222222223,0.0,1.0,45,1100,800,300,0.7272727272727273,14,8,6,324.5682841012902,0.4249368686868687,0.20410696231217074,0.18570899846154643,130426.23325525994,-533.2904120952221,129892.94284316472,1772,0,442.77777777777777,38,7,21,36.342955757765914,0.6208881578947368,44.63141025641027,1021.4743589743609,26.880904183535815,0
3003,4,1,3,43,0.021739130434782608,0.06521739130434782,0.9347826086956522,46,1300,1000,300,0.7692307692307693,16,10,6,317.1962950211753,0.42704307568438,0.19804303550872193,0.18322750688870268,130794.81336805575,-902.4739583333139,129892.33940972244,1773,0,434.1304347826087,39,7,17,36.159198913781395,0.6228632478632479,44.27083333333334,1022.9166666666682,26.22863247863252,0
3004,4,1,1,43,0.022727272727272728,0.022727272727272728,0.9772727272727273,44,1250,700,550,0.56,18,7,11,360.85143673094467,0.4252995066948555,0.20571439521692447,0.1963164238361928,128442.17985243624,489.24027732120214,128931.42012975745,1774,0,448.5681818181818,38,6,14,37.43654265036537,0.6008771929824561,46.58119658119658,1013.6752136752135,26.675663517768776,8
3005,4,0,0,43,0.0,0.0,1.0,43,1450,1000,450,0.6896551724137931,19,10,9,365.94969990941274,0.42118863049095606,0.21193102494119986,0.19912919221086045,128450.01737313397,801.2490622114426,129251.26643534542,1775,1,459.90697674418607,37,6,15,37.299328465837384,0.602759009009009,46.5734649122807,1013.7061403508767,27.397463252726396,0
3006,4,1,0,44,0.022727272727272728,0.0,1.0,44,850,500,350,0.5882352941176471,12,5,7,358.39400695554764,0.42537658562367864,0.2109863239192642,0.1964445858090446,128740.17373666792,427.9413443275396,129168.11508099546,1776,0,450.4318181818182,38,6,18,37.194485384426436,0.6038925438596492,46.28739316239315,1014.8504273504257,26.706590193432255,0
3007,4,1,0,45,0.022222222222222223,0.0,1.0,45,1450,900,550,0.6206896551724138,20,9,11,351.15802469833477,0.4273779461279461,0.21767619828499174,0.1943419652286814,129121.97401258687,68.44346788194895,129190.41748046882,1777,0,441.4,39,6,19,36.98893529431861,0.6060363247863247,45.911458333333336,1016.3541666666672,26.06036324786326,0
3008,4,0,1,44,0.0,0.022222222222222223,0.9777777777777777,45,800,600,200,0.75,10,6,4,356.3076267177684,0.4271254208754209,0.2206421284503024,0.19773211810908006,129230.01284646132,209.20107779337465,129439.2139242547,1778,1,442.4,36,9,19,36.74802488278508,0.6125578703703703,45.80518018018018,1016.7792792792792,28.243868868868866,0
3009,4,0,0,44,0.0,0.0,1.0,44,800,500,300,0.625,11,5,6,365.77442549611766,0.42502422480620156,0.22194747856999597,0.20242071609915993,129119.93805473343,645.754232412861,129765.69228714629,1779,2,453.1363636363636,38,6,19,36.61962577525492,0.6077302631578947,45.913461538461526,1016.3461538461514,26.745951417003983,0
3010,4,0,1,43,0.0,0.022727272727272728,0.9772727272727273,44,1350,1000,350,0.7407407407407407,17,10,7,366.3194202618746,0.4254536645525018,0.22911212293682404,0.20329223670249957,129230.80800165034,668.0279797787184,129898.83598142906,1780,3,454.1363636363636,35,9,19,36.49271959779927,0.6145833333333333,45.804398148148145,1016.7824074074072,29.05092592592592,0
3011,4,1,0,44,0.022727272727272728,0.0,1.0,44,1100,700,400,0.6363636363636364,15,7,8,369.0883084008482,0.4244626497533474,0.28170809732598245,0.1919338662954248,126619.7970920138,550.879843964329,127170.67693597813,1781,0,452.59090909090907,39,5,15,39.09861657351827,0.5806623931623931,48.385416666666664,1006.4583333333326,25.80662393162391,8
3012,4,2,0,46,0.043478260869565216,0.0,1.0,46,1500,1200,300,0.8,18,12,6,359.52160866153497,0.43014291465378424,0.28466963517588884,0.18939746600623106,127147.30133310225,-54.04391255004515,127093.25742055221,1782,0,433.8695652173913,37,9,17,38.796930492135964,0.589527027027027,47.86184210526314,1008.5526315789455,27.25817923186339,0
3013,4,0,1,45,0.0,0.021739130434782608,0.9782608695652174,46,1450,1000,450,0.6896551724137931,19,10,9,361.28760835139735,0.4305052334943639,0.2877115560889414,0.1908477940326953,127257.91229031979,-4.658644967718828,127253.25364535207,1783,1,434.8695652173913,37,9,19,38.63879229153082,0.5906531531531531,47.75219298245612,1008.9912280701728,27.27003319108575,0
3014,4,3,1,47,0.0625,0.020833333333333332,0.9791666666666666,48,1100,1000,100,0.9090909090909091,12,10,2,359.9264431049046,0.43137743794326244,0.32630175146227547,0.193752487921537,128019.00397022215,-384.5150502330712,127634.48891998909,1784,0,417.3333333333333,41,7,16,37.89283321896548,0.5917174796747968,46.99900793650793,1012.0039682539667,24.683023615950408,0
3015,4,3,1,49,0.06,0.02,0.98,50,1400,1200,200,0.8571428571428571,16,12,4,349.20327774579886,0.43615646258503404,0.3381045388969033,0.1912869748186867,128715.26668137747,-1010.0108126747901,127705.25586870268,1785,0,401.54,36,14,15,37.45306662227648,0.607349537037037,46.311936936936945,1014.7522522522535,28.187562562562597,0
3016,4,0,2,47,0.0,0.04081632653061224,0.9591836734693877,49,1450,1200,250,0.8275862068965517,17,12,5,356.3023885638936,0.43331916099773243,0.3457369982028471,0.1952385201988651,128728.04763244445,-626.7778306786848,128101.26980176577,1786,1,410.734693877551,37,12,16,37.259927066450565,0.6055743243243243,46.29934210526315,1014.8026315789461,27.427098150782328,0
3017,4,1,0,48,0.020833333333333332,0.0,1.0,48,1400,1000,400,0.7142857142857143,18,10,8,355.46268630548843,0.4326979905437352,0.33610901173252694,0.19573694414752857,128922.84765504759,-434.5476492767157,128488.30000577087,1787,0,405.1875,37,11,18,37.08252357302238,0.607545045045045,46.10745614035087,1015.5701754385956,27.4478425794215,0
3018,4,0,1,47,0.0,0.020833333333333332,0.9791666666666666,48,1150,800,350,0.6956521739130435,15,8,7,358.0296271357632,0.4327811022458629,0.2903860856269116,0.18944286096018512,127325.53155006845,-304.6538417328962,127020.87770833555,1788,1,406.1875,35,13,14,38.651567278287466,0.5952380952380952,47.685185185185176,1009.2592592592581,28.835978835978803,8
3019,4,0,1,46,0.0,0.02127659574468085,0.9787234042553191,47,1650,1300,350,0.7878787878787878,20,13,7,360.5155059688318,0.4314292321924144,0.29879454581384657,0.19089591545562712,127354.73632812487,-217.32855902779266,127137.40776909707,1789,2,415.74468085106383,35,12,14,38.558866529067764,0.5955357142857143,47.65624999999999,1009.374999999999,28.839285714285683,0
3020,4,1,0,47,0.02127659574468085,0.0,1.0,47,600,400,200,0.6666666666666666,8,4,4,360.7559850074456,0.433645544249152,0.302086686762856,0.19143766503679752,127442.37075617266,-204.88040123458404,127237.49035493808,1790,0,411.97872340425533,35,12,15,38.46286107290234,0.5964285714285714,47.569444444444436,1009.7222222222208,28.84920634920631,0
3021,4,1,0,48,0.020833333333333332,0.0,1.0,48,1450,900,550,0.6206896551724138,20,9,11,353.5959465384096,0.43556996158392436,0.30043212283242404,0.1890548428871533,127745.77100326677,-565.9226371641955,127179.84836610257,1791,0,404.375,36,12,17,38.33268352456277,0.5975115740740741,47.26914414414414,1010.9234234234233,28.081206206206204,0
3022,4,2,0,50,0.04,0.0,1.0,50,1300,700,600,0.5384615384615384,19,7,12,342.7991324204989,0.43860544217687075,0.3140370116518165,0.18592711308606233,128320.37278163573,-1200.5133124396973,127119.85946919603,1792,0,389.16,35,15,19,38.018334475668276,0.6053571428571429,46.701388888888886,1013.1944444444439,28.94841269841268,0
3023,4,0,0,50,0.0,0.0,1.0,50,1500,1100,400,0.7333333333333333,19,11,8,340.8999268392327,0.43817176870748303,0.31256764470830034,0.1855775300922833,128466.99948827586,-1241.1218546382047,127225.87763363766,1793,1,390.16,35,15,16,37.91683316208091,0.606845238095238,46.55671296296296,1013.7731481481479,28.964947089947085,0
3024,4,0,0,50,0.0,0.0,1.0,50,1750,1200,550,0.6857142857142857,23,12,11,341.47989804130066,0.43835034013605445,0.31014945807187644,0.18671686252850916,128643.0620525764,-1214.1960573130955,127428.8659952633,1794,2,391.16,35,15,16,37.72259459973377,0.6086309523809523,46.383101851851855,1014.4675925925933,28.98478835978838,0
3025,4,0,0,50,0.0,0.0,1.0,50,1500,1200,300,0.8,18,12,6,342.15783393684575,0.4388095238095238,0.31334093760693404,0.18736400562925234,128701.77636584807,-1192.7357949674072,127509.04057088066,1795,3,392.16,35,15,16,37.64555054940876,0.6092261904761904,46.32523148148149,1014.6990740740754,28.991402116402153,0
3026,4,0,2,48,0.0,0.04,0.96,50,1950,1400,550,0.717948717948718,25,14,11,340.2312941451563,0.43858843537414965,0.30693723663783534,0.1873141520513445,128915.32368517187,-1227.794517490439,127687.52916768142,1796,4,393.16,36,14,17,37.47689805574037,0.609375,46.11486486486488,1015.5405405405422,28.209459459459506,0
3027,4,0,0,48,0.0,0.0,1.0,48,1300,1000,300,0.7692307692307693,16,10,6,356.826043933229,0.4348496601654846,0.30507662835249016,0.19577212680660955,128778.12500000003,-409.7222222222208,128368.40277777781,1797,5,410.1458333333333,34,14,19,37.195539135194295,0.6121323529411764,46.25,1015.0000000000002,29.852941176470594,0
3028,4,0,0,48,0.0,0.0,1.0,48,1350,700,650,0.5185185185185185,20,7,13,358.82749166352096,0.43476654846335694,0.3133744675030292,0.19732041756274482,128868.76594387753,-351.66879251700783,128517.09715136052,1798,6,411.1458333333333,34,14,19,37.05226286786259,0.6130514705882353,46.160714285714285,1015.3571428571427,29.863445378151255,0
3029,4,2,1,49,0.04,0.02,0.98,50,1600,1000,600,0.625,22,10,12,347.3400740998525,0.4362074829931973,0.3225605842646897,0.19387969423350027,129459.11864144563,-1006.7320276357248,128452.38661380991,1799,0,395.66,36,14,16,36.742927225111586,0.6148726851851851,45.579954954954964,1017.6801801801812,28.26889389389392,0
3030,4,1,0,50,0.02,0.0,1.0,50,1350,1100,250,0.8148148148148148,16,11,5,348.2599003878376,0.43621598639455783,0.33012483857081354,0.19588565341427303,129759.37307633132,-962.0027316097088,128797.37034472161,1800,0,396.64,37,13,19,36.414388721480854,0.615990990990991,45.285087719298254,1018.8596491228082,27.53674727358941,0
3031,4,1,0,51,0.0196078431372549,0.0,1.0,51,1500,1100,400,0.7333333333333333,19,11,8,340.3997899659211,0.4366013071895425,0.3287183942394385,0.19286627862342146,130044.5513391228,-1346.5724075900193,128697.97893153278,1801,0,389.84313725490193,38,13,20,36.32532907370553,0.6170504385964912,45.00534188034189,1019.9786324786337,26.841542959964045,0
3032,4,1,0,52,0.019230769230769232,0.0,1.0,52,1950,1000,950,0.5128205128205128,29,10,19,333.97705234776515,0.43745286576168924,0.33386390850159,0.1909758282762083,130402.54122662744,-1689.3434757190944,128713.19775090834,1802,0,383.3269230769231,37,15,22,36.12665503667919,0.6224662162162162,44.6546052631579,1021.3815789473686,27.60490753911807,0
3033,4,0,1,51,0.0,0.019230769230769232,0.9807692307692307,52,1850,1600,250,0.8648648648648649,21,16,5,300.43462721786557,0.4367222850678733,0.22485781210529954,0.17163545019399248,130366.35068618198,-2548.261665540867,127818.08902064111,1803,1,384.3269230769231,40,12,22,37.01964540418616,0.6169270833333333,44.690040650406495,1021.2398373983725,25.530995934959314,8
3034,4,0,1,50,0.0,0.0196078431372549,0.9803921568627451,51,1450,800,650,0.5517241379310345,21,8,13,306.88645555707046,0.43619281045751634,0.24027007783937715,0.1753330309021863,130368.94531249999,-2198.307291666668,128170.63802083331,1804,2,392.8235294117647,39,12,22,36.852305181558535,0.6185897435897436,44.6875,1021.2499999999999,26.185897435897434,0
3035,4,0,1,49,0.0,0.02,0.98,50,900,200,700,0.2222222222222222,16,2,14,314.69816545674,0.43443027210884355,0.2397049283247883,0.17955643983701874,130317.12420784935,-1797.8880168383384,128519.23619101102,1805,3,401.4,38,12,22,36.70520735237697,0.6197916666666667,44.738247863247864,1021.0470085470084,26.869658119658116,0
3036,4,0,0,49,0.0,0.0,1.0,49,1400,800,600,0.5714285714285714,20,8,12,351.60220240079366,0.4345769557823129,0.176242280479326,0.1919578763654223,128582.21379469894,-690.3668561047753,127891.84693859416,1806,4,408.16326530612247,40,9,17,37.527972611890455,0.5989583333333333,46.44308943089431,1014.2276422764229,25.355691056910572,8
3037,4,2,1,50,0.0392156862745098,0.0196078431372549,0.9803921568627451,51,900,500,400,0.5555555555555556,13,5,8,335.43607582770176,0.4383986928104575,0.18803111976172127,0.18543585277834004,129078.27546609289,-1540.4979606093304,127537.77750548357,1807,0,393.11764705882354,42,9,19,37.43285337401862,0.6009424603174602,45.95445736434109,1016.1821705426365,24.194813584348488,0
3038,4,0,0,50,0.0,0.0,1.0,50,1150,1000,150,0.8695652173913043,13,10,3,339.76449605456975,0.437389455782313,0.2117657393850665,0.18805441718417415,129125.75511975605,-1225.5305768140731,127900.22454294199,1808,1,401.82,41,9,19,37.2745851634944,0.6028963414634146,45.90773809523809,1016.3690476190461,24.7894889663182,0
3039,4,0,1,49,0.0,0.02,0.98,50,1400,1000,400,0.7142857142857143,18,10,8,338.2827196990059,0.43742346938775506,0.2193442622950823,0.18759314456035758,129201.38888888879,-1258.6805555555643,127942.70833333323,1809,2,402.82,41,9,19,37.235314207650276,0.6036585365853658,45.83333333333333,1016.6666666666658,24.796747967479654,0
3040,4,0,0,49,0.0,0.0,1.0,49,1800,1400,400,0.7777777777777778,22,14,8,347.99533601186886,0.43748228458049887,0.22998186983397373,0.19335865227489,129278.8903451152,-802.3098230220232,128476.58052209318,1810,3,411.53061224489795,40,9,19,36.909579960694174,0.6059895833333333,45.757113821138205,1016.971544715446,25.424288617886152,0
3041,4,1,0,50,0.02,0.0,1.0,50,1400,1100,300,0.7857142857142857,17,11,6,342.85972578023507,0.4378996598639456,0.23130663548670016,0.19196777772408874,129579.88989866755,-1114.4548965419774,128465.43500212557,1811,0,404.28,41,9,18,36.734202962096845,0.6074695121951219,45.46130952380951,1018.1547619047599,24.833042973286826,0
3042,4,1,0,51,0.0196078431372549,0.0,1.0,51,950,500,450,0.5263157894736842,14,5,9,333.74490966707646,0.43931372549019604,0.22885510926180785,0.18812052303742252,129842.5246755,-1533.1436662460414,128309.38100925395,1812,0,397.3333333333333,42,9,19,36.69978449641886,0.6086309523809523,45.20348837209301,1019.1860465116257,24.266334440752992,0
3043,4,0,1,50,0.0,0.0196078431372549,0.9803921568627451,51,1200,800,400,0.6666666666666666,16,8,8,336.3070073059559,0.43893790849673203,0.22551255393833713,0.19028467445633732,129990.70443482934,-1456.643042785915,128534.06139204343,1813,1,398.3333333333333,42,9,19,36.48426612188016,0.6101190476190477,45.05813953488371,1019.7674418604628,24.280177187153875,0
3044,4,0,0,50,0.0,0.0,1.0,50,1400,1000,400,0.7142857142857143,18,10,8,368.2235911920898,0.43650510204081633,0.2007233626588465,0.19517758227435644,127396.24361582415,-496.70752448469324,126899.53609133945,1814,2,407.18,37,13,14,38.32172531769306,0.5920608108108107,47.61513157894737,1009.5394736842109,27.284850640113806,8
3045,4,1,1,50,0.0196078431372549,0.0196078431372549,0.9803921568627451,51,1300,700,600,0.5384615384615384,19,7,12,366.13581609894146,0.43856209150326797,0.20870953032375783,0.19546528331241436,127685.20801373351,-849.974432025727,126835.23358170778,1815,0,400.1764705882353,38,13,15,38.07787174066246,0.5932017543859649,47.32905982905982,1010.6837606837595,26.59694107062525,0
3046,4,0,1,49,0.0,0.02,0.98,50,1250,900,350,0.72,16,9,7,348.14768329304707,0.43691326530612246,0.19404793204570758,0.1794076310622692,126248.01834432234,-1183.6555223749663,125064.36282194738,1816,1,408.58,40,10,17,40.00804766238583,0.5752604166666666,48.75508130081302,1004.9796747967494,25.124491869918735,8
3047,4,0,1,48,0.0,0.02040816326530612,0.9795918367346939,49,2200,1800,400,0.8181818181818182,26,18,8,350.7411711289618,0.43652565192743764,0.19285767129223474,0.18157672961126708,126436.39458550367,-930.7101779513703,125505.6844075523,1817,2,414.6530612244898,39,10,13,39.74894268945278,0.5787927350427351,48.56770833333334,1005.7291666666683,25.787927350427392,0
3048,4,2,2,48,0.04,0.04,0.96,50,1800,1400,400,0.7777777777777778,22,14,8,362.7112096206547,0.4389795918367347,0.23666348903717838,0.19119801954375193,127172.8226701182,-771.2074896758076,126401.61518044239,1818,0,407.2,38,12,15,38.69028704586378,0.5879934210526316,47.83653846153845,1008.6538461538449,26.543522267206445,0
3049,4,4,3,49,0.07692307692307693,0.057692307692307696,0.9423076923076923,52,1150,700,450,0.6086956521739131,16,7,9,354.2519553876135,0.4442244846656611,0.252328189658507,0.18910551241705928,127681.91599122537,-1353.6863184942906,126328.22967273107,1819,0,392.09615384615387,40,12,15,38.381514999162064,0.58984375,47.33231707317073,1010.6707317073162,25.266768292682904,0
3050,4,1,0,50,0.02,0.0,1.0,50,1200,900,300,0.75,15,9,6,366.4541166652452,0.43941326530612246,0.2475975880672805,0.1947212346732186,127496.31461620632,-655.6901298487962,126840.62448635753,1820,0,408.76,38,12,16,38.263646461440814,0.591282894736842,47.516025641025635,1009.9358974358964,26.57726045883938,0
3051,4,0,0,50,0.0,0.0,1.0,50,1200,600,600,0.5,18,6,12,364.51201815720367,0.43916666666666665,0.2460349021681647,0.1939482910341227,127550.26989051426,-701.2787411425284,126848.99114937174,1821,1,409.76,38,12,16,38.257315353428496,0.5918311403508771,47.462606837606835,1010.1495726495725,26.582883490778226,0
3052,4,1,0,51,0.0196078431372549,0.0,1.0,51,1550,1300,250,0.8387096774193549,18,13,5,358.16530766481094,0.44104575163398696,0.245190871737744,0.19290100494852025,128039.08420138898,-1028.1684027777678,127010.91579861121,1822,0,402.70588235294116,39,12,18,37.91683820502263,0.5950854700854701,46.97916666666667,1012.0833333333342,25.950854700854723,0
3053,4,2,1,52,0.03773584905660377,0.018867924528301886,0.9811320754716981,53,1850,1500,350,0.8108108108108109,22,15,7,342.9648227975413,0.44495343492985,0.24936272333027865,0.18784990431340942,128711.08596280344,-1771.2816393598168,126939.80432344362,1823,0,388.47169811320754,40,13,17,37.6155900517443,0.6002604166666667,46.31605691056912,1014.7357723577252,25.36839430894313,0
3054,4,1,0,53,0.018867924528301886,0.0,1.0,53,1150,900,250,0.782608695652174,14,9,5,346.4538198604571,0.44508950169327527,0.2613530382380367,0.19087428201132367,128943.21852898422,-1665.4258791063407,127277.79264987787,1824,0,388.8679245283019,40,13,19,37.29049929957973,0.6026041666666666,46.087398373983746,1015.6504065040663,25.391260162601657,0
3055,4,0,1,52,0.0,0.018867924528301886,0.9811320754716981,53,1450,1000,450,0.6896551724137931,19,10,9,346.5495445637785,0.44521044992743103,0.22840658215171739,0.18534811125378836,127758.96044021394,-1638.2972065239196,126120.66323369002,1825,1,389.8679245283019,40,13,15,38.49726913282401,0.590625,47.2560975609756,1010.9756097560958,25.274390243902396,8
3056,4,2,0,54,0.037037037037037035,0.0,1.0,54,1650,1200,450,0.7272727272727273,21,12,9,357.88398921491324,0.4458857442348008,0.26614575967567067,0.1870360449178604,126822.83676674697,-1447.6189291597036,125375.21783758728,1826,0,383.51851851851853,38,16,17,39.1716606562014,0.5844298245614035,48.18376068376068,1007.2649572649568,26.506972559604126,8
3057,4,3,1,56,0.05263157894736842,0.017543859649122806,0.9824561403508771,57,1950,1600,350,0.8205128205128205,23,16,7,338.78373967229146,0.4507884294068505,0.2804449002700582,0.18044280566071136,127591.41845703124,-2754.249707295205,124837.16874973603,1827,0,364.280701754386,39,18,16,38.86493882530844,0.5905448717948718,47.421875,1010.3124999999999,25.905448717948715,0
3058,4,2,1,57,0.034482758620689655,0.017241379310344827,0.9827586206896551,58,1500,1100,400,0.7333333333333333,19,11,8,338.63913512446175,0.45285087719298245,0.3029076754180915,0.18216260769499035,127990.23321311736,-2931.4996240663413,125058.73358905101,1828,0,358.9655172413793,40,18,18,38.4607980984902,0.59296875,47.027439024390254,1011.8902439024404,25.29725609756101,0
3059,4,1,1,57,0.017241379310344827,0.017241379310344827,0.9827586206896551,58,1450,1000,450,0.6896551724137931,19,10,9,337.8139198658596,0.45256730187537814,0.31072118164264917,0.18316120080548587,128306.8422296187,-2931.0466349111584,125375.79559470755,1829,0,359.8448275862069,38,20,20,38.158415058525776,0.5995065789473684,46.71474358974359,1013.1410256410259,26.661605937921735,0
3060,4,0,2,55,0.0,0.03508771929824561,0.9649122807017544,57,1450,700,750,0.4827586206896552,22,7,15,344.4916633065721,0.45192408103592313,0.3165959178388773,0.18703511313467866,128360.96871803999,-2556.1432765359104,125804.82544150409,1830,1,366.7719298245614,38,19,20,37.93401862590054,0.6000548245614035,46.66132478632478,1013.3547008547005,26.66722896986054,0
3061,4,0,0,55,0.0,0.0,1.0,55,1800,1300,500,0.7222222222222222,23,13,10,351.463715251184,0.4505050505050505,0.3301292518345107,0.19084768838727606,128366.66690712512,-1976.75486688213,126389.912040243,1831,2,380.58181818181816,37,18,20,37.75156892447523,0.6019144144144144,46.65570175438596,1013.377192982455,27.388572783309595,0
3062,4,0,1,54,0.0,0.01818181818181818,0.9818181818181818,55,1450,1100,350,0.7586206896551724,18,11,7,352.80908960340355,0.45072951739618405,0.33084735098361207,0.19224665006262043,128505.59937913572,-1932.4112948215,126573.18808431421,1832,3,381.58181818181816,37,18,17,37.575587577953215,0.603322072072072,46.518640350877185,1013.9254385964898,27.403390232337564,0
3063,4,0,0,54,0.0,0.0,1.0,54,1100,700,400,0.6363636363636364,15,7,8,360.43765913153317,0.4491541462846494,0.3328290500125557,0.19547062201364684,128315.6187226076,-1550.0437515218057,126765.57497108579,1833,5,389.5925925925926,36,18,19,37.57641436034233,0.6032986111111112,46.706081081081074,1013.1756756756745,28.143768768768737,0
3064,4,0,0,54,0.0,0.0,1.0,54,1200,800,400,0.6666666666666666,16,8,8,363.9740740740741,0.44931429070580015,0.3352798353909465,0.19781199677938813,128401.20525931336,-1453.0580411492579,126948.1472181641,1834,6,390.5925925925926,36,18,17,37.39930555555554,0.6041666666666667,46.62162162162162,1013.5135135135134,28.153153153153152,0
3065,4,0,0,54,0.0,0.0,1.0,54,1450,800,650,0.5517241379310345,21,8,13,367.066217704988,0.4491541462846494,0.3311989537838971,0.20035141555461342,128572.46393352808,-1361.078392581771,127211.38554094631,1835,7,391.5925925925926,36,18,17,37.14583795987859,0.6059027777777778,46.4527027027027,1014.1891891891889,28.171921921921914,0
3066,4,1,0,55,0.01818181818181818,0.0,1.0,55,1550,1400,150,0.9032258064516129,17,14,3,357.101028271991,0.45113636363636367,0.3279598708170137,0.1965010471079564,128895.0100631924,-1794.2918734610812,127100.71818973131,1836,0,385.45454545454544,37,18,18,37.06931846812798,0.6072635135135135,46.13486842105262,1015.4605263157885,27.444879089615903,0
3067,4,0,1,54,0.0,0.01818181818181818,0.9818181818181818,55,2100,1600,500,0.7619047619047619,26,16,10,352.4995082021268,0.4507996632996633,0.32544061828774296,0.19506375770301576,129117.79495854497,-1897.2081553939681,127220.586803151,1837,1,386.45454545454544,37,18,18,36.959106519941,0.6095157657657657,45.915570175438596,1016.3377192982459,27.4685870080607,0
3068,4,0,3,51,0.0,0.05555555555555555,0.9444444444444444,54,1150,700,450,0.6086956521739131,16,7,9,359.8947794071352,0.4490595154903331,0.31292480310713144,0.1991561021089398,129117.79495854517,-1506.2359331717155,127611.55902537346,1838,2,394.4259259259259,37,17,18,36.77120419318877,0.6095157657657657,45.91557017543861,1016.3377192982475,27.468587008060744,0
3069,4,2,2,51,0.03773584905660377,0.03773584905660377,0.9622641509433962,53,1450,1100,350,0.7586206896551724,18,11,7,356.5233976143743,0.4497157716497339,0.3223263082614485,0.19892702368196302,129443.56575963725,-1369.9868724324895,128073.57888720476,1839,0,399.62264150943395,34,19,14,36.5251130868819,0.6188725490196079,45.595238095238095,1017.6190476190482,29.929971988795533,0
3070,4,0,0,51,0.0,0.0,1.0,51,1650,1500,150,0.9090909090909091,18,15,3,373.57237782921186,0.44736928104575163,0.3220714653660932,0.20749020021598408,129263.69214965405,-542.131031334098,128721.56111831995,1840,1,415.88235294117646,33,18,19,36.27480517393747,0.6193181818181819,45.77205882352941,1016.9117647058829,30.81550802139039,0
3071,4,0,1,50,0.0,0.0196078431372549,0.9803921568627451,51,1600,1100,500,0.6875,21,11,10,370.2244772028929,0.4468954248366013,0.3119593794529074,0.20669103670127217,129466.28146701385,-613.6827256944473,128852.5987413194,1841,2,416.88235294117646,35,16,16,36.15340327533264,0.6169642857142856,45.572916666666664,1017.7083333333329,29.077380952380942,0
3072,4,0,0,50,0.0,0.0,1.0,50,1800,1300,500,0.7222222222222222,23,13,10,370.817097237788,0.4456377551020408,0.31759290828503306,0.20795536256184155,129643.02722318663,-385.2297935956909,129257.79742959094,1842,3,424.86,35,15,17,35.958276508694176,0.61875,45.39930555555555,1018.4027777777769,29.097222222222197,0
3073,4,0,0,50,0.0,0.0,1.0,50,1250,900,350,0.72,16,9,7,375.1453892967023,0.44576530612244897,0.324836987390662,0.21101628511047082,129760.92470689713,-264.1574770662111,129496.76722983092,1843,4,425.86,35,15,17,35.72799519103334,0.6199404761904762,45.2835648148148,1018.8657407407395,29.110449735449702,0
3074,4,0,0,50,0.0,0.0,1.0,50,950,800,150,0.8421052631578947,11,8,3,377.6421227532644,0.44505102040816324,0.3324014988077666,0.21306176650147318,129878.87577428394,-190.45313035839172,129688.42264392554,1844,5,426.86,35,15,17,35.544287687824074,0.6211309523809524,45.16782407407406,1019.3287037037022,29.123677248677208,0
3075,4,1,2,49,0.0196078431372549,0.0392156862745098,0.9607843137254902,51,1600,1000,600,0.625,22,10,12,373.6052498710836,0.44617647058823534,0.337892168987308,0.2130445733750057,130294.81207274769,-461.9709254086875,129832.841147339,1845,0,419.47058823529414,32,19,19,35.22420438618187,0.6321614583333333,44.76010101010101,1020.9595959595961,31.904987373737377,0
3076,4,0,0,49,0.0,0.0,1.0,49,1400,1200,200,0.8571428571428571,16,12,4,392.33505244454307,0.4421060090702948,0.34379104042025443,0.22202081869549561,129996.88042534713,400.4665798611017,130397.34700520823,1846,1,437.0612244897959,35,14,19,35.049582907728976,0.6223214285714286,45.05208333333333,1019.7916666666658,29.136904761904738,0
3077,4,1,0,50,0.02,0.0,1.0,50,1600,1100,500,0.6875,21,11,10,381.9166417206996,0.4423044217687075,0.348901351006883,0.21872393948471583,130462.04460991747,-33.51847330729515,130428.52613661018,1847,0,429.3,31,19,20,34.842063896677715,0.6364247311827957,44.596354166666664,1021.6145833333328,32.95530913978493,0
3078,4,0,2,48,0.0,0.04,0.96,50,1850,1400,450,0.7567567567567568,23,14,9,381.5613635411258,0.4418112244897959,0.3496665843418125,0.21976414807653194,130681.82615294366,-27.37284460768427,130654.45330833597,1848,1,430.3,32,18,19,34.6278916604923,0.6360677083333333,44.381313131313135,1022.4747474747481,31.95233585858588,0
3079,4,0,0,48,0.0,0.0,1.0,48,1550,1100,450,0.7096774193548387,20,11,9,369.26190004058026,0.4405012559101655,0.25527651556132547,0.2006518366887174,128394.44739006224,18.641402911170175,128413.08879297342,1849,2,446.3541666666667,37,11,15,37.27223754913627,0.6021959459459459,46.628289473684205,1013.4868421052626,27.391536273115204,8
3080,4,0,0,48,0.0,0.0,1.0,48,1450,1100,350,0.7586206896551724,18,11,7,362.5168343486107,0.44133237293144206,0.23468608318549178,0.18862029750261566,126642.26367630392,-415.4816744045201,126226.7820018994,1850,3,447.3541666666667,41,7,17,39.24083382613839,0.5777439024390244,48.36309523809524,1006.5476190476196,24.549941927990723,8
3081,4,1,2,47,0.02040816326530612,0.04081632653061224,0.9591836734693877,49,1250,800,450,0.64,17,8,9,361.3600774347115,0.4433638038548753,0.24363838979160235,0.18965022832875236,126994.32594946223,-621.8641082266597,126372.46184123558,1851,0,439.2040816326531,42,7,19,38.90778215727746,0.5798611111111112,48.01356589147287,1007.945736434109,23.99870801033593,0
3082,4,1,1,47,0.020833333333333332,0.020833333333333332,0.9791666666666666,48,1450,1100,350,0.7586206896551724,18,11,7,368.33756274458017,0.4441858747044917,0.2555186925539612,0.19415419815219212,127170.80213758672,-231.56822199547085,126939.23391559125,1852,0,447.3333333333333,39,9,21,38.550487968604784,0.5862713675213675,47.838541666666664,1008.6458333333327,25.86271367521366,0
3083,4,0,0,47,0.0,0.0,1.0,47,1200,800,400,0.6666666666666666,16,8,8,378.7469069014768,0.4427613320999075,0.26767170160921383,0.19938605991316416,127118.94729572991,229.1816193658898,127348.1289150958,1853,1,457.70212765957444,38,9,21,38.34136737648762,0.5874451754385965,47.88995726495725,1008.440170940169,26.537899235267606,0
3084,4,2,1,48,0.04081632653061224,0.02040816326530612,0.9795918367346939,49,1450,1100,350,0.7586206896551724,18,11,7,370.9744865677832,0.4464462868480725,0.2911425849272622,0.19907662447605867,127893.53820231787,-310.9520660116042,127582.58613630626,1854,0,439.9795918367347,41,8,16,37.74192493788413,0.5904471544715447,47.123015873015866,1011.5079365079357,24.67092528068136,0
3085,4,2,1,49,0.04,0.02,0.98,50,1400,1000,400,0.7142857142857143,18,10,8,361.5039603531852,0.4477636054421769,0.295427631578947,0.19624500704887227,128355.55555555578,-719.053524187429,127636.50203136835,1855,0,432.1,39,11,20,37.5085663377193,0.5982905982905983,46.66666666666668,1013.3333333333352,25.98290598290603,0
3086,4,0,1,48,0.0,0.02040816326530612,0.9795918367346939,49,1450,1000,450,0.6896551724137931,19,10,9,368.8905072380111,0.44649943310657597,0.294459411769769,0.2001463141101428,128333.90404704509,-331.7682080502607,128002.13583899483,1856,1,441.83673469387753,38,11,21,37.343596232250796,0.5997807017543859,46.68803418803419,1013.2478632478633,26.66441745389114,0
3087,4,1,1,48,0.02040816326530612,0.02040816326530612,0.9795918367346939,49,1250,700,550,0.56,18,7,11,364.3993224033935,0.4473852040816326,0.28073638587306315,0.1998493153675286,128762.65290377768,-415.79530619999855,128346.85759757768,1857,0,419.7959183673469,40,9,18,37.01916658322485,0.60078125,46.26524390243903,1014.9390243902452,25.37347560975613,0
3088,4,1,0,49,0.02040816326530612,0.0,1.0,49,1350,1000,350,0.7407407407407407,17,10,7,360.6310471367423,0.44690688775510207,0.28352157189406446,0.1989441471953021,128994.83194527063,-496.09173606979726,128498.74020920084,1858,0,420.734693877551,40,9,19,36.87787615046021,0.603125,46.03658536585366,1015.853658536585,25.396341463414625,0
3089,4,0,0,49,0.0,0.0,1.0,49,1300,900,400,0.6923076923076923,17,9,8,369.28486528972195,0.44623370181405897,0.2870241985493416,0.20524390330808256,129289.65627411264,-250.23111211750114,129039.42516199514,1859,1,421.734693877551,35,14,21,36.357331853875046,0.6151785714285714,45.74652777777778,1017.0138888888888,29.05753968253968,0
3090,4,0,2,47,0.0,0.04081632653061224,0.9591836734693877,49,1700,1400,300,0.8235294117647058,20,14,6,373.1657781372925,0.44596797052154197,0.2918794451356521,0.20817725389486524,129436.83556241432,-139.7205075445744,129297.11505486975,1860,2,422.734693877551,35,14,18,36.10858356081286,0.6166666666666667,45.601851851851855,1017.592592592593,29.074074074074083,0
3091,4,0,0,47,0.0,0.0,1.0,47,1300,1000,300,0.7692307692307693,16,10,6,385.2956691732435,0.44212534690101757,0.2870270623579281,0.21446254821808966,129348.51794249397,567.4847554440955,129916.00269793806,1861,3,439.468085106383,35,12,22,35.89015151515152,0.6157738095238094,45.688657407407405,1017.2453703703701,29.064153439153433,0
3092,4,0,0,47,0.0,0.0,1.0,47,1400,900,500,0.6428571428571429,19,9,10,382.2536045489944,0.44202898550724634,0.28508047898833144,0.21305745324492084,129401.82317029878,492.8626684116688,129894.68583871046,1862,4,440.468085106383,36,11,22,35.91311566131711,0.6142939814814814,45.63626126126127,1017.4549549549558,28.262637637637663,0
3093,4,1,1,47,0.020833333333333332,0.020833333333333332,0.9791666666666666,48,1800,1400,400,0.7777777777777778,22,14,8,345.073936659521,0.44308695330969267,0.23327801127137238,0.18864642521611125,128635.55304857,-719.391302914171,127916.16174565583,1863,0,432.2708333333333,42,6,18,37.63910115579331,0.5964781746031746,46.390503875969,1014.4379844961256,24.15328534514585,7
3094,4,2,0,49,0.04081632653061224,0.0,1.0,49,1500,1100,400,0.7333333333333333,19,11,8,331.2281644719154,0.44616284013605445,0.22231515557042458,0.1836810730253355,129201.3888888894,-1240.9722222221735,127960.41666666722,1375,0,386.38775510204084,44,5,21,37.4146174863388,0.5994318181818181,45.83333333333336,1016.6666666666708,23.1060606060607,0
3095,4,1,0,50,0.02,0.0,1.0,50,750,500,250,0.6666666666666666,10,5,5,326.2008758228647,0.44668367346938775,0.23031679500925972,0.182171735714032,129478.90216561154,-1552.7737425989044,127926.12842301263,1376,0,379.64,41,9,17,37.260677616401836,0.6064532520325203,45.560515873015866,1017.7579365079359,24.823364305071607,0
3096,4,0,2,48,0.0,0.04,0.96,50,1350,1100,250,0.8148148148148148,16,11,5,351.18233235308674,0.4461054421768707,0.21620913684644738,0.18680280180076178,127538.80343967032,-836.0234259357505,126702.78001373456,1377,1,380.64,39,11,17,38.605689904094056,0.5900106837606838,47.47395833333334,1010.1041666666681,25.900106837606874,8
3097,4,1,0,49,0.02040816326530612,0.0,1.0,49,1550,900,650,0.5806451612903226,22,9,13,355.72295012988957,0.4456845238095238,0.23103947274778025,0.19028865331142766,127766.2051304884,-710.1257168163754,127056.07941367202,1378,0,388.48979591836735,38,11,20,38.257996054809965,0.5940241228070176,47.24893162393165,1011.0042735042769,26.6053756185336,0
3098,4,1,0,50,0.02,0.0,1.0,50,1000,900,100,0.9,11,9,2,347.99588680824365,0.44724489795918365,0.23312474269246541,0.18742394879317656,128039.08420138927,-1088.5850694444064,126950.49913194486,1379,0,381.7,39,11,21,38.174145738987235,0.5950854700854701,46.979166666666686,1012.0833333333364,25.95085470085478,0
3099,4,2,0,52,0.038461538461538464,0.0,1.0,52,1650,1200,450,0.7272727272727273,21,12,9,335.0623089867102,0.4502105329311212,0.2417026360413126,0.1829278907925262,128582.2137946994,-1783.3459074872285,126798.86788721218,1380,0,367.9807692307692,40,12,17,37.947353039412164,0.5989583333333333,46.44308943089433,1014.2276422764266,25.355691056910665,0
3100,4,0,1,51,0.0,0.019230769230769232,0.9807692307692307,52,1850,1400,450,0.7567567567567568,23,14,9,323.2818641659949,0.45009269733534435,0.19538552285308097,0.17091596269732318,127292.15876165268,-2137.7653816445522,125154.39338000813,1381,1,368.9807692307692,41,11,19,39.56244265303446,0.584349593495935,47.71825396825396,1009.1269841269832,24.612853271389834,8
3101,4,1,0,52,0.019230769230769232,0.0,1.0,52,1400,1100,300,0.7857142857142857,17,11,6,322.08228205703557,0.45145173453996984,0.19355673804430817,0.1708093478110707,127417.32927256536,-2192.2271628559,125225.10210970946,1382,0,369.9423076923077,41,11,17,39.464703907503846,0.5856199186991871,47.594246031746025,1009.6230158730147,24.624951606658893,0
3102,4,1,0,53,0.018867924528301886,0.0,1.0,53,1150,700,450,0.6086956521739131,16,7,9,319.313659132734,0.45227080309627476,0.20741515040265956,0.17075342930455228,127752.38985224749,-2441.383386665455,125311.00646558203,1383,0,363.9433962264151,42,11,18,39.19234640084348,0.5875496031746033,47.26259689922481,1010.949612403101,24.0702288667405,0
3103,4,0,1,52,0.0,0.018867924528301886,0.9811320754716981,53,1150,700,450,0.6086956521739131,16,7,9,319.26880122595077,0.45211961780358007,0.2072995497653034,0.17135460236492045,127899.37245545641,-2433.144135719005,125466.2283197374,1384,1,364.9433962264151,42,11,18,39.04349075581952,0.5890376984126984,47.117248062015506,1011.5310077519381,24.084071613141383,0
3104,4,2,1,53,0.037037037037037035,0.018518518518518517,0.9814814814814815,54,1600,1200,400,0.75,20,12,8,313.8274215912296,0.45382745166550204,0.21221364850597713,0.16998714328055498,128267.19867345707,-2749.012416621603,125518.18625683547,1385,0,358.8703703703704,42,12,20,38.80631815572986,0.5927579365079365,46.75387596899225,1012.9844961240306,24.118678479143586,0
3105,4,0,0,53,0.0,0.0,1.0,53,1000,600,400,0.6,14,6,8,315.7043747209447,0.4529208998548621,0.22231564664637382,0.17131918248349337,128340.8272959106,-2496.447873475167,125844.37942243544,1386,1,365.9811320754717,42,11,20,38.683816263428,0.5935019841269842,46.68120155038759,1013.2751937984488,24.125599852344017,0
3106,4,1,3,51,0.018518518518518517,0.05555555555555555,0.9444444444444444,54,1550,1100,450,0.7096774193548387,20,11,9,312.14028814895744,0.45376193803866754,0.2316906228610549,0.17080035991971027,128672.41753472209,-2767.2309027777837,125905.1866319443,1387,0,360.18518518518516,43,11,18,38.43685831622178,0.5954457364341086,46.354166666666664,1014.5833333333322,23.594961240310052,0
3107,4,0,0,51,0.0,0.0,1.0,51,1600,1200,400,0.75,20,12,8,320.6954695947577,0.4511601307189543,0.22902543917195106,0.1749279130308224,128546.6319050768,-1955.1355032753895,126591.49640180141,1388,1,377.5882352941176,41,10,18,38.34784451835909,0.5970528455284553,46.4781746031746,1014.0873015873013,24.73383662408052,0
3108,4,0,2,49,0.0,0.0392156862745098,0.9607843137254902,51,1700,1200,500,0.7058823529411765,22,12,10,320.29992342802313,0.4508986928104575,0.23436923704839607,0.17553642585356793,128733.87008180085,-1953.3102540412283,126780.55982775963,1389,2,378.5882352941176,42,9,18,38.16739075081958,0.5974702380952381,46.29360465116279,1014.8255813953479,24.162513842746378,0
3109,4,0,0,49,0.0,0.0,1.0,49,1450,900,550,0.6206896551724138,20,9,11,327.1851374286411,0.4497590702947846,0.22894509916642813,0.1786934212110269,128596.93877551003,-1384.9985827664516,127211.94019274358,1390,3,387.3061224489796,41,8,18,38.132091158059474,0.5975609756097561,46.42857142857142,1014.2857142857129,24.738675958188118,0
3110,4,1,1,49,0.02,0.02,0.98,50,1700,1500,200,0.8823529411764706,19,15,4,324.0341471942196,0.4513350340136055,0.23345801526717547,0.17835492975816283,128906.01526350579,-1646.0098551769727,127260.00540832881,1391,0,380.54,42,8,19,37.89758269720103,0.5992063492063492,46.12403100775194,1015.5038759689921,24.178663713547433,0
3111,4,2,0,51,0.0392156862745098,0.0,1.0,51,1050,700,350,0.6666666666666666,14,7,7,314.61260477808366,0.45040849673202615,0.24409576714420322,0.1759258821595589,129529.39111118938,-2048.670111782994,127480.72099940639,1392,0,371.54901960784315,41,10,19,37.50436523405776,0.6069613821138211,45.510912698412675,1017.9563492063455,24.828203639179158,0
3112,4,0,0,51,0.0,0.0,1.0,51,1450,700,750,0.4827586206896552,22,7,15,317.76222592463495,0.45013071895424833,0.2499216123786825,0.17838468173514455,129683.21352731844,-1958.3146808999254,127724.89884641851,1393,1,372.54901960784315,43,8,19,37.26834634932444,0.6056201550387597,45.35984848484848,1018.5606060606044,23.68745595489778,0
3113,4,0,0,51,0.0,0.0,1.0,51,2050,1300,750,0.6341463414634146,28,13,15,315.017281502997,0.45022875816993463,0.24232935975734682,0.1777562917512295,129884.7747342247,-2016.8102709190957,127867.9644633056,1394,2,373.54901960784315,44,7,19,37.134200805401626,0.6062973484848485,45.162037037037024,1019.3518518518497,23.167087542087494,0
3114,4,0,0,51,0.0,0.0,1.0,51,1500,1200,300,0.8,18,12,6,318.00687234686177,0.4497712418300654,0.2409197563172727,0.17998600678460053,130002.78206447154,-1931.644375857365,128071.13768861418,1395,3,374.54901960784315,44,7,20,36.93859330549,0.6074810606060606,45.04629629629628,1019.814814814812,23.177609427609365,0
3115,4,1,0,52,0.019230769230769232,0.0,1.0,52,1500,800,700,0.5333333333333333,22,8,14,310.34116615539546,0.45007698592257417,0.24920039176977427,0.17776978594644968,130470.15587819759,-2300.6512102910738,128169.50466790651,1396,0,368.3269230769231,40,12,21,36.661941708942614,0.61796875,44.588414634146346,1021.6463414634154,25.541158536585385,0
3116,4,0,1,51,0.0,0.019230769230769232,0.9807692307692307,52,1100,600,500,0.5454545454545454,16,6,10,312.453775337986,0.44998271744595275,0.24260752174145828,0.17946017239144094,130574.0023816018,-2240.331998975451,128333.67038262634,1397,1,369.3269230769231,40,12,20,36.50318186337874,0.6190104166666667,44.48678861788619,1022.0528455284572,25.551321138211428,0
3117,4,0,1,50,0.0,0.0196078431372549,0.9803921568627451,51,1450,1000,450,0.6896551724137931,19,10,9,316.2448206211792,0.4483006535947713,0.23874868054889187,0.18117577106615254,130475.34722222241,-1947.5694444444255,128527.77777777798,1398,2,377.3333333333333,39,12,21,36.50591353996738,0.6196581196581197,44.58333333333334,1021.6666666666681,26.196581196581235,0
3118,4,0,0,50,0.0,0.0,1.0,50,1850,1600,250,0.8648648648648649,21,16,5,322.3119443847072,0.44687925170068027,0.24653005750130608,0.18493783731492067,130535.38795976712,-1585.3770591350622,128950.01090063206,1399,3,385.22,38,12,21,36.290294476389604,0.621984649122807,44.524572649572654,1021.9017094017106,26.892150247413436,0
3119,4,0,0,50,0.0,0.0,1.0,50,1950,1400,550,0.717948717948718,25,14,11,322.2919995463708,0.44594387755102044,0.24198675496688726,0.1855305557505944,130661.65500217036,-1577.7587890624773,129083.89621310789,1400,4,386.22,39,11,21,36.16329173034471,0.6215277777777778,44.40104166666668,1022.3958333333351,26.21527777777782,0
3120,4,0,1,49,0.0,0.02,0.98,50,1550,1100,450,0.7096774193548387,20,11,9,343.3291507078159,0.446062925170068,0.2407722439843314,0.18877821301995898,128864.64520919418,-1151.402160812672,127713.2430483815,1401,5,387.22,43,7,17,37.44986942734565,0.5973837209302326,46.16477272727273,1015.3409090909088,23.612579281183926,7
3121,4,0,0,49,0.0,0.0,1.0,49,1450,1300,150,0.896551724137931,16,13,3,342.55269943476486,0.44667658730158727,0.23136781430129316,0.1885479143947655,128906.0152635058,-968.5792996214161,127937.43596388439,1402,6,378.9591836734694,42,7,17,37.427441157760825,0.5992063492063492,46.12403100775194,1015.5038759689922,24.178663713547433,0
3122,4,2,1,50,0.0392156862745098,0.0196078431372549,0.9803921568627451,51,1500,1200,300,0.8,18,12,6,328.69298638319145,0.4483986928104575,0.23504728097653294,0.18287315734904735,129330.57089240856,-1696.637602339641,127633.93329006892,1403,0,365.05882352941177,40,11,19,37.34784527258801,0.6065104166666666,45.70630081300813,1017.174796747967,25.429369918699173,0
3123,4,2,2,50,0.038461538461538464,0.038461538461538464,0.9615384615384616,52,1600,1100,500,0.6875,21,11,10,317.66641959557825,0.44774384112619403,0.24376773853761335,0.17883190944684674,129793.15020130985,-2153.8149375037706,127639.33526380608,1404,0,358.86538461538464,42,10,19,37.159447508558394,0.6081349206349207,45.25193798449612,1018.9922480620141,24.26172019195272,0
3124,4,0,0,50,0.0,0.0,1.0,50,1350,900,450,0.6666666666666666,18,9,9,330.0416047237018,0.4450170068027211,0.2443386243386243,0.1845911085715979,129537.39636005349,-1449.4539667195518,128087.94239333394,1405,1,374.2,40,10,19,37.10359056271005,0.60859375,45.5030487804878,1017.9878048780483,25.44969512195121,0
3125,4,0,1,49,0.0,0.02,0.98,50,1950,1400,550,0.717948717948718,25,14,11,333.99938614393795,0.4445578231292517,0.247527439632808,0.1874211560993584,129666.74619108965,-1338.2772737788664,128328.46891731079,1406,2,375.2,40,10,19,36.87159083349964,0.6098958333333333,45.37601626016259,1018.4959349593472,25.46239837398368,0
3126,4,1,0,50,0.02,0.0,1.0,50,1550,800,750,0.5161290322580645,23,8,15,333.2474041599579,0.4461904761904762,0.2367583732057419,0.1882397499173814,129925.63950029736,-1340.5235805406912,128585.11591975667,1407,0,350.96,40,10,20,36.62820640616693,0.6125,45.12195121951219,1019.5121951219505,25.487804878048763,0
3127,4,0,0,50,0.0,0.0,1.0,50,1600,1300,300,0.8125,19,13,6,328.7269285263519,0.4457738095238095,0.23031281131699544,0.18642716997443617,130081.09941998808,-1447.7679456672636,128633.33147432082,1408,1,351.96,40,10,20,36.58597330145446,0.6140625,44.96951219512195,1020.121951219512,25.5030487804878,0
3128,4,1,2,49,0.0196078431372549,0.0392156862745098,0.9607843137254902,51,1800,1300,500,0.7222222222222222,23,13,10,318.75395952910316,0.44714052287581696,0.22528741011122033,0.18295603978451266,130548.03688280792,-1877.3327508427478,128670.70413196518,1409,0,346.03921568627453,40,11,17,36.36842018032351,0.61875,44.51219512195122,1021.9512195121956,25.54878048780489,0
3129,4,0,0,49,0.0,0.0,1.0,49,1800,1300,500,0.7222222222222222,23,13,10,336.9644310209541,0.44401927437641725,0.22631946386672652,0.19253096211173365,130371.67302441761,-1013.8766756154369,129357.79634880218,1410,3,360.7959183673469,38,11,21,36.081615929141826,0.6203399122807017,44.68482905982907,1021.2606837606853,26.875281151596983,0
3130,4,0,0,49,0.0,0.0,1.0,49,1250,800,450,0.64,17,8,9,338.42582903632206,0.4435232426303855,0.22873020378286246,0.19391049748797798,130480.80490037637,-968.3850856526943,129512.41981472367,1411,4,361.7959183673469,38,11,21,35.93385095332708,0.6214364035087719,44.57799145299146,1021.6880341880354,26.886527215474615,0
3131,4,0,1,48,0.0,0.02040816326530612,0.9795918367346939,49,1450,900,550,0.6206896551724138,20,9,11,340.07717615851993,0.44322208049886624,0.22880949181177646,0.19540650716567948,130589.98243343209,-917.8655078895282,129672.11692554256,1412,5,362.7959183673469,38,11,18,35.781201003449354,0.622532894736842,44.471153846153854,1022.1153846153858,26.897773279352258,0
3132,4,0,0,48,0.0,0.0,1.0,48,1300,900,400,0.6923076923076923,17,9,8,338.90084235379425,0.4432624113475177,0.2221196298183048,0.19509159927873895,130661.65500217055,-743.7310112846814,129917.92399088587,1413,6,364.4166666666667,39,9,18,35.73877143827475,0.6215277777777778,44.401041666666686,1022.3958333333366,26.21527777777786,0
3133,4,0,0,48,0.0,0.0,1.0,48,1150,700,450,0.6086956521739131,16,7,9,337.5485740938373,0.44291149527186763,0.2240235767389751,0.19484946790284535,130768.1762695317,-771.8777126735672,129996.29855685814,1414,7,365.4166666666667,39,9,18,35.66565247649116,0.6225961538461539,44.29687500000002,1022.8125000000036,26.225961538461632,0
3134,4,0,0,48,0.0,0.0,1.0,48,1600,1000,600,0.625,22,10,12,339.99167917516485,0.4426990986997636,0.22042870618607813,0.19712470932487583,130937.79047070233,-696.4481500759798,130241.34232062634,1415,8,366.4166666666667,40,8,18,35.431767782080556,0.62265625,44.131097560975626,1023.4756097561005,25.586890243902513,0
3135,4,0,3,45,0.0,0.0625,0.9375,48,1300,800,500,0.6153846153846154,18,8,10,344.8176637391339,0.44228354018912525,0.22141799808143925,0.20073527426338858,131093.854569453,-559.304667360673,130534.54990209232,1416,9,367.4166666666667,40,8,18,35.15059045350798,0.62421875,43.97865853658538,1024.0853658536607,25.60213414634152,0
3136,4,0,0,45,0.0,0.0,1.0,45,1100,800,300,0.7272727272727273,14,8,6,367.99830018368493,0.4391414141414141,0.22772119176107575,0.21226469671077494,130738.73842191831,622.3267014850759,131361.0651234034,1417,13,391.4888888888889,37,8,18,34.91688556520496,0.6258445945945945,44.32565789473684,1022.6973684210529,27.640469416785216,0
3137,4,1,0,46,0.021739130434782608,0.0,1.0,46,1300,1000,300,0.7692307692307693,16,10,6,362.75055592355255,0.44152576489533013,0.23520301495231366,0.21140970088991454,131136.55495516458,313.9716423770805,131450.52659754167,1418,0,383.95652173913044,38,8,19,34.64826501164772,0.628015350877193,43.936965811965806,1024.2521367521356,26.95400359874041,0
3138,4,1,0,47,0.02127659574468085,0.0,1.0,47,1550,1000,550,0.6451612903225806,21,10,11,361.4293448011648,0.44187480727721246,0.25093222197850396,0.21306359718389103,131574.63480029584,111.12663452406161,131685.7614348199,1419,0,376.7659574468085,38,9,20,34.23930021868165,0.6324013157894737,43.50961538461538,1025.961538461538,26.998987854251002,0
3139,4,0,1,46,0.0,0.02127659574468085,0.9787234042553191,47,1200,1000,200,0.8333333333333334,14,10,4,361.20134934737314,0.4411424606845513,0.2497652665332084,0.21369597072226348,131711.6845642485,114.88763788441679,131826.57220213293,1420,1,377.7659574468085,38,9,20,34.106777338329174,0.6337719298245614,43.37606837606837,1026.4957264957252,27.013045434098032,0
3140,4,0,0,46,0.0,0.0,1.0,46,1550,1100,450,0.7096774193548387,20,11,9,335.76649897377126,0.43939210950080515,0.14414205111184852,0.1946257140069206,130928.03955078137,-392.4949309921369,130535.54461978923,1421,2,386.0869565217391,39,7,18,35.54972434266328,0.624198717948718,44.14062500000001,1023.4375000000009,26.241987179487204,8
3141,4,0,0,46,0.0,0.0,1.0,46,1050,700,350,0.6666666666666666,14,7,7,338.90362339690773,0.43898953301127214,0.14943108421369278,0.1968525301858637,131008.00781250025,-320.1822916666377,130687.8255208336,1422,3,387.0869565217391,39,7,19,35.3886853886854,0.625,44.062500000000014,1023.7500000000019,26.25000000000005,0
3142,4,1,1,46,0.02127659574468085,0.02127659574468085,0.9787234042553191,47,1500,1100,400,0.7333333333333333,19,11,8,334.8308731738823,0.4385599753314832,0.163229389851836,0.19625197277571044,131354.81906467027,-603.2796223958144,130751.53944227446,1423,0,379.82978723404256,39,8,21,35.14304525285372,0.6284722222222222,43.72395833333334,1025.1041666666679,26.284722222222253,0
3143,4,1,0,47,0.02127659574468085,0.0,1.0,47,1550,1100,450,0.7096774193548387,20,11,9,332.9329108055594,0.4380781683626272,0.16682043780479616,0.19595877900193356,131515.040418837,-642.8629557291465,130872.17746310784,1424,0,379.9574468085106,39,8,22,35.03023340442097,0.6300747863247863,43.56770833333334,1025.7291666666683,26.300747863247906,0
3144,4,0,1,46,0.0,0.02127659574468085,0.9787234042553191,47,1200,700,500,0.5833333333333334,17,7,10,334.03144358680714,0.43744218316373723,0.16453353660511638,0.1974332221752139,131675.35942925367,-603.2579210069252,131072.10150824673,1425,1,380.9574468085106,39,8,17,34.8405942352583,0.6316773504273504,43.41145833333334,1026.3541666666683,26.31677350427355,0
3145,4,0,0,46,0.0,0.0,1.0,46,1250,1000,250,0.8,15,10,5,340.30369571610646,0.43469202898550724,0.1625570383125272,0.20123345004289656,131692.96136558917,-236.87970949831947,131456.08165609086,1426,3,390.2173913043478,40,6,18,34.661922442244226,0.6302083333333333,43.39430894308943,1026.4227642276414,25.660569105691035,0
3146,4,0,1,45,0.0,0.021739130434782608,0.9782608695652174,46,1200,800,400,0.6666666666666666,16,8,8,336.12287958452873,0.43400764895330113,0.14903232309656578,0.199515140450633,131837.04963466869,-337.3102481733446,131499.73938649535,1427,4,391.2173913043478,41,5,18,34.624146702730556,0.6300813008130082,43.25396825396825,1026.984126984127,25.048393341076267,0
3147,4,0,0,45,0.0,0.0,1.0,45,1250,1100,150,0.88,14,11,3,339.78221254756807,0.4311868686868687,0.14432459178624457,0.20161475383400887,131823.38271077053,-41.751871405925954,131781.6308393646,1428,5,400.7111111111111,40,5,18,34.5439551377206,0.6315104166666667,43.26727642276422,1026.9308943089416,25.67327235772354,0
3148,4,0,0,45,0.0,0.0,1.0,45,1800,1400,400,0.7777777777777778,22,14,8,340.0346968213993,0.4300715488215488,0.14538382939450845,0.20287733858140472,132032.19112507423,-20.894784024076756,132011.29634105015,1429,6,401.7111111111111,40,5,19,34.32730973334651,0.63359375,43.064024390243894,1027.7439024390233,25.693597560975583,0
3149,4,0,1,44,0.0,0.022222222222222223,0.9777777777777777,45,1000,600,400,0.6,14,6,8,337.8265875922361,0.4291245791245791,0.15513610260126742,0.20239592894291492,132188.9058781973,-68.61460192348213,132120.29127627384,1430,7,402.7111111111111,40,5,20,34.2264551833185,0.63515625,42.91158536585365,1028.3536585365837,25.708841463414593,0
3150,4,0,0,44,0.0,0.0,1.0,44,1000,800,200,0.8,12,8,4,343.654192372146,0.42750176180408733,0.15783800714891116,0.20527721370026222,132076.58420138867,277.7343749999771,132354.31857638864,1431,8,412.6136363636364,39,5,20,34.18963653560329,0.6356837606837606,43.02083333333332,1027.916666666665,26.356837606837562,0
3151,4,0,0,44,0.0,0.0,1.0,44,850,500,350,0.5882352941176471,12,5,7,343.5851479568743,0.4270502995066949,0.1629593810444876,0.20552638850511176,132130.12695312474,279.58984374997175,132409.7167968747,1432,9,413.6136363636364,39,5,20,34.137537993920965,0.6362179487179487,42.968749999999986,1028.124999999998,26.362179487179436,0
3152,4,1,0,45,0.022222222222222223,0.0,1.0,45,1500,1300,200,0.8666666666666667,17,13,4,331.79221556552875,0.428766835016835,0.1579883089481513,0.2004690646648902,132507.98000447432,-206.43421211831995,132301.545792356,1433,0,405.4,38,7,21,34.061213724879806,0.6417214912280702,42.60149572649572,1029.5940170940164,27.094579397210957,0
3153,4,0,0,45,0.0,0.0,1.0,45,1500,1200,300,0.8,18,12,6,338.6397950162814,0.42832491582491583,0.16154324828873712,0.2053562832419485,132645.51487508198,-16.190006574640506,132629.32486850733,1434,1,406.4,38,7,16,33.746888612321094,0.643092105263158,42.46794871794871,1030.1282051282035,27.108636977057987,0
3154,4,0,0,45,0.0,0.0,1.0,45,1050,700,350,0.6666666666666666,14,7,7,331.9370173926082,0.4280723905723906,0.1886937350338096,0.18888668850331353,130213.13252095698,-355.48823312904454,129857.64428782793,1435,2,407.4,42,3,15,36.370415203012755,0.6123511904761905,44.840116279069754,1020.6395348837185,24.300941306755202,8
3155,4,0,0,45,0.0,0.0,1.0,45,1500,1100,400,0.7333333333333333,19,11,8,335.7251329367776,0.4273569023569024,0.1929213520416626,0.19179658106206257,130366.35068618228,-246.5291381602341,130119.82154802205,1436,3,408.4,40,5,18,36.11864364613394,0.6169270833333333,44.69004065040651,1021.2398373983749,25.53099593495937,0
3156,4,1,0,46,0.021739130434782608,0.0,1.0,46,650,200,450,0.3076923076923077,11,2,9,317.43877714419074,0.42834138486312395,0.15965905021130267,0.17051799798807424,127933.68055555563,-1077.7777777777728,126855.90277777787,1437,0,400.5,44,2,15,39.05477759472816,0.5866477272727273,47.083333333333336,1011.6666666666673,22.992424242424256,8
3157,4,1,1,46,0.02127659574468085,0.02127659574468085,0.9787234042553191,47,1600,1300,300,0.8125,19,13,6,311.12039886201114,0.43058125192722785,0.16153035181484054,0.1685208626789357,128267.19867345682,-1418.170764226939,126849.02790922989,1438,0,392.9574468085106,42,5,16,38.874872457113696,0.5927579365079365,46.75387596899223,1012.9844961240286,24.11867847914354,0
3158,4,0,0,46,0.0,0.0,1.0,46,1200,1000,200,0.8333333333333334,14,10,4,317.2340054709939,0.4292975040257649,0.16579253210954503,0.17206112043947172,128320.37278163547,-1058.4828317901602,127261.88994984531,1439,1,378.69565217391306,41,5,17,38.66589559058716,0.5947662601626016,46.70138888888887,1013.1944444444416,24.712059620596136,0
3159,4,0,0,46,0.0,0.0,1.0,46,1450,1000,450,0.6896551724137931,19,10,9,317.4775192632559,0.42869363929146537,0.1688989393159377,0.17284511291162527,128471.19005298856,-1042.6570570358012,127428.53299595276,1440,2,379.69565217391306,41,5,16,38.50619352839482,0.5962906504065041,46.55257936507935,1013.7896825396806,24.726577622919038,0
3160,4,0,0,46,0.0,0.0,1.0,46,1600,1300,300,0.8125,19,13,6,315.0917700036685,0.4286231884057971,0.17065440585662017,0.1724153842604339,128672.41753472193,-1091.276041666699,127581.14149305523,1441,3,380.69565217391306,41,5,16,38.3619952087611,0.5983231707317074,46.35416666666665,1014.583333333331,24.745934959349537,0
3161,4,0,1,45,0.0,0.021739130434782608,0.9782608695652174,46,1500,1200,300,0.8,18,12,6,343.7918914179786,0.4288345410628019,0.20257097277430614,0.17465761074818656,125661.44180877802,-505.4695762277548,125155.97223255027,1442,4,381.69565217391306,40,6,17,40.721923778633695,0.5692708333333334,49.339430894308954,1002.6422764227657,25.06605691056914,8
3162,4,3,2,46,0.0625,0.041666666666666664,0.9583333333333334,48,1000,800,200,0.8,12,8,4,336.42268580070555,0.43517287234042556,0.2202353882432211,0.17401476612639724,126401.26294079245,-1093.9876437636349,125307.27529702881,1443,0,344.1875,40,8,14,40.145064847566125,0.5768229166666667,48.60264227642276,1005.5894308943084,25.13973577235771,0
3163,4,0,1,45,0.0,0.021739130434782608,0.9782608695652174,46,1350,1000,350,0.7407407407407407,17,10,7,369.3471384624601,0.430787037037037,0.2211876723306574,0.1850203740560774,125078.13720703124,112.74197984572146,125190.87918687696,1444,1,360.1521739130435,39,7,16,40.68531101391926,0.5649038461538461,49.921875,1000.3124999999999,25.64903846153846,7
3164,4,3,2,46,0.0625,0.041666666666666664,0.9583333333333334,48,1650,1200,450,0.7272727272727273,21,12,9,358.27841956638423,0.4412954343971631,0.2387600644122383,0.1823098152660805,125727.80050027044,-590.8884682410848,125136.91203202936,1445,0,344.6666666666667,42,6,13,40.29025764895329,0.5669642857142857,49.27325581395349,1002.9069767441863,23.878737541528245,0
3165,4,3,0,49,0.061224489795918366,0.0,1.0,49,1100,700,400,0.6363636363636364,15,7,8,356.5143926779661,0.44201743197278914,0.2595417262715942,0.18327424322954772,126148.45920138928,-803.6649174102715,125344.794283979,1446,0,338.57142857142856,39,10,17,39.90045624222316,0.5758547008547008,48.854166666666686,1004.5833333333366,25.75854700854709,0
3166,4,0,0,49,0.0,0.0,1.0,49,1150,700,450,0.6086956521739131,16,7,9,354.33589923691443,0.4418934240362811,0.26033461215409415,0.18259654546919496,126248.01834432234,-853.158978617203,125394.85936570514,1447,1,339.57142857142856,40,9,17,39.85257188121484,0.5752604166666666,48.75508130081302,1004.9796747967494,25.124491869918735,0
3167,4,3,1,51,0.057692307692307696,0.019230769230769232,0.9807692307692307,52,1200,800,400,0.6666666666666666,16,8,8,342.7251906920017,0.4470603946706888,0.291395658081115,0.17988002612059512,126996.54571280998,-1695.0169306703303,125301.52878213965,1448,0,320.9230769230769,43,9,15,39.375078291369164,0.5784883720930232,48.01136363636364,1007.954545454546,23.44080338266386,0
3168,4,2,2,51,0.03773584905660377,0.03773584905660377,0.9622641509433962,53,1550,1100,450,0.7096774193548387,20,11,9,337.88158600637473,0.44871794871794873,0.2937999961998137,0.17865623796822708,127297.04231112443,-1997.5912097422126,125299.45110138222,1449,0,315.79245283018867,40,13,18,39.18911547499161,0.5859375,47.713414634146346,1009.1463414634154,25.228658536585385,0
3169,4,3,5,49,0.05555555555555555,0.09259259259259259,0.9074074074074074,54,1800,1600,200,0.8888888888888888,20,16,4,329.9216117759274,0.4514471232238528,0.29525486817664626,0.17627536981567507,127717.98946719886,-2372.61501244017,125345.37445475868,1450,0,292.55555555555554,41,13,15,38.959396571465966,0.5886686991869918,47.29662698412698,1010.8134920634916,24.65398761130467,0
3170,4,1,0,50,0.02,0.0,1.0,50,1200,900,300,0.75,15,9,6,357.1321010490333,0.44568027210884353,0.2958686671015436,0.18813866354232595,127147.30133310262,-918.3234264388916,126228.97790666373,1451,0,316.86,37,13,17,38.85717909690513,0.589527027027027,47.861842105263165,1008.5526315789484,27.258179231863473,0
3171,4,1,0,51,0.0196078431372549,0.0,1.0,51,1550,900,650,0.5806451612903226,22,9,13,344.32830508150386,0.4472058823529412,0.29661347748429745,0.1839253126928378,127707.59489226001,-1405.3320609425468,126302.26283131746,1452,0,311.62745098039215,40,11,17,38.605972250150806,0.5901041666666667,47.306910569105696,1010.7723577235781,25.269308943089452,0
3172,4,1,1,51,0.019230769230769232,0.019230769230769232,0.9807692307692307,52,1500,1300,200,0.8666666666666667,17,13,4,339.9022117656235,0.44748460281548513,0.3109305760709007,0.18367121796548347,128171.57594601504,-1684.6010092163178,126486.97493679872,1453,0,306.61538461538464,38,14,18,38.24360800450164,0.5981359649122807,46.848290598290596,1012.6068376068375,26.647548358074673,0
3173,4,3,0,54,0.05555555555555555,0.0,1.0,54,1450,900,550,0.6206896551724138,20,9,11,321.90582629663567,0.4505008152806895,0.3301800799177501,0.17751387570055938,128979.82698042493,-2496.1284440538357,126483.6985363711,1454,0,294.0,42,12,19,37.87660179973925,0.5999503968253967,46.05135658914729,1015.7945736434115,24.185585086747892,0
3174,4,2,2,54,0.03571428571428571,0.03571428571428571,0.9642857142857143,56,1400,1000,400,0.7142857142857143,18,10,8,311.2927307228424,0.4524012445887446,0.33543710616574973,0.17368388807620283,129442.18911415296,-3140.9273594222414,126301.26175473072,1455,0,284.4642857142857,43,13,17,37.67719771697997,0.6031976744186047,45.596590909090914,1017.6136363636369,23.665433403805512,0
3175,4,0,1,53,0.0,0.018518518518518517,0.9814814814814815,54,1600,900,700,0.5625,23,9,14,317.76855167180537,0.45140344747262984,0.31820490840397486,0.17698949729455096,129373.84627013098,-2577.8120493059346,126796.03422082504,1456,1,290.51851851851853,42,12,21,37.58175381782392,0.6039186507936508,45.66375968992248,1017.3449612403099,24.222499077150236,0
3176,4,1,0,54,0.018518518518518517,0.0,1.0,54,1450,1200,250,0.8275862068965517,17,12,5,317.9882601391331,0.4489212089447938,0.33065585343595627,0.1784018642564619,129659.10099754644,-2553.985612517221,127105.11538502922,1457,0,291.3888888888889,43,11,20,37.28701766620176,0.6053779069767442,45.38352272727273,1018.4659090909087,23.685253699788575,0
3177,4,1,3,52,0.01818181818181818,0.05454545454545454,0.9454545454545454,55,2100,1400,700,0.6666666666666666,28,14,14,318.1354804496694,0.44966329966329965,0.34713743606665637,0.1807140718842966,130144.46159122077,-2719.285836762693,127425.17575445808,1458,0,287.07272727272726,44,11,21,36.79200695704779,0.6089015151515151,44.907407407407405,1020.3703703703696,23.190235690235674,0
3178,4,0,0,52,0.0,0.0,1.0,52,1300,600,700,0.46153846153846156,20,6,14,332.80029091163783,0.4465262066365008,0.3480967640496557,0.18766137150527779,129857.80915375391,-1756.6566672965628,128101.15248645736,1459,1,298.84615384615387,41,11,21,36.70835766660179,0.6102642276422765,45.188492063492056,1019.2460317460303,24.85965931087879,0
3179,4,1,0,53,0.018867924528301886,0.0,1.0,53,1250,700,550,0.56,18,7,11,330.9065853541956,0.44764453313981617,0.3628482861187263,0.18794208974000415,130138.96869929686,-1987.2316492398295,128151.73705005704,1460,0,294.188679245283,42,11,22,36.471786957898075,0.6116071428571428,44.91279069767442,1020.3488372093019,24.294019933554807,0
3180,4,1,0,54,0.018518518518518517,0.0,1.0,54,1550,1100,450,0.7096774193548387,20,11,9,327.20470145091554,0.4493579664570231,0.3661271957461385,0.18717896723296285,130418.24811826645,-2265.1311597715744,128153.11695849488,1461,0,289.72222222222223,40,14,23,36.283703114118,0.6174479166666667,44.63922764227643,1021.443089430896,25.5360772357724,0
3181,4,1,2,53,0.01818181818181818,0.03636363636363636,0.9636363636363636,55,1950,1400,550,0.717948717948718,25,14,11,328.3455561788692,0.4500841750841751,0.38503240912103776,0.19021708276495006,130906.3469461722,-2403.4965409230103,128502.85040524919,1462,0,285.43636363636364,42,13,22,35.76148881103431,0.6192956349206349,44.16182170542636,1023.3527131782953,24.36554078995941,0
3182,4,0,0,53,0.0,0.0,1.0,53,1850,1400,450,0.7567567567567568,23,14,9,341.0972579978692,0.44776548137397193,0.3911692265013169,0.19710017215881503,130807.808059026,-1676.3630692709053,129131.4449897551,1463,1,296.0943396226415,40,13,22,35.53484502284919,0.6213541666666667,44.25813008130083,1022.9674796747992,25.57418699186998,0
3183,4,1,1,53,0.018518518518518517,0.018518518518518517,0.9814814814814815,54,1700,1300,400,0.7647058823529411,21,13,8,336.28940370499265,0.4481568832983927,0.3948316339044804,0.19595253567595258,131129.55670482575,-1980.5039135268055,129149.05279129895,1464,0,291.5925925925926,42,12,23,35.332899716177856,0.6215277777777778,43.943798449612416,1024.2248062015528,24.38630490956078,0
3184,4,0,0,53,0.0,0.0,1.0,53,1300,1000,300,0.7692307692307693,16,10,6,342.6517681564281,0.44833998548621196,0.2949129157465302,0.190277685490833,129255.70371283495,-1700.1275883746757,127555.57612446028,1465,1,289.75471698113205,38,15,18,37.06901835119422,0.6091008771929824,45.77991452991452,1016.8803418803404,26.760008996851063,8
3185,4,0,0,53,0.0,0.0,1.0,53,1450,1000,450,0.6896551724137931,19,10,9,337.8466310309617,0.44803761490082245,0.29131488143308126,0.188107765031264,129360.29188368049,-1859.212239583346,127501.07964409715,1466,2,290.75471698113205,39,14,18,37.0848692743532,0.608440170940171,45.67708333333333,1017.2916666666661,26.084401709401693,0
3186,4,1,0,54,0.018518518518518517,0.0,1.0,54,2200,1800,400,0.8181818181818182,26,18,8,329.64795350846794,0.4489357675285348,0.29530218704036315,0.1849793835420977,129666.74619108993,-2251.1244960010627,127415.62169508886,1467,0,286.35185185185185,40,14,19,36.98238874476153,0.6098958333333333,45.3760162601626,1018.4959349593494,25.462398373983735,0
3187,4,0,2,52,0.0,0.037037037037037035,0.962962962962963,54,1750,1200,550,0.6857142857142857,23,12,11,327.70848518514356,0.44838254134637784,0.28706751031474265,0.18449932515168055,129796.16057117112,-2292.939367274782,127503.22120389633,1468,1,287.35185185185185,40,14,19,36.90057677603803,0.6111979166666667,45.24898373983739,1019.0040650406493,25.475101626016233,0
3188,4,0,1,51,0.0,0.019230769230769232,0.9807692307692307,52,2300,1800,500,0.782608695652174,28,18,10,335.49771846054153,0.4465340623428859,0.2920706248673135,0.18895648702933102,129811.04736328138,-1689.7379557291522,128121.30940755222,1469,2,298.9807692307692,39,13,19,36.68704640703262,0.6129807692307692,45.23437500000001,1019.062500000001,26.12980769230772,0
3189,4,0,2,49,0.0,0.0392156862745098,0.9607843137254902,51,1700,1500,200,0.8823529411764706,19,15,4,336.80034993462067,0.44568627450980397,0.286009111109808,0.19037284005036895,129951.54303200803,-1446.4549664551555,128505.08806555287,1470,3,297.88235294117646,40,11,20,36.51138742150902,0.6127604166666667,45.09654471544715,1019.6138211382112,25.49034552845528,0
3190,4,1,1,49,0.02,0.02,0.98,50,1550,1100,450,0.7096774193548387,20,11,9,341.6412150983884,0.44369047619047614,0.2977131189382334,0.19399279431238972,130129.69970703154,-1108.4662543402476,129021.23345269129,1471,0,304.02,39,11,21,36.20735494299812,0.6161858974358974,44.921875000000014,1020.3125000000023,26.16185897435903,0
3191,4,1,0,50,0.02,0.0,1.0,50,1450,1100,350,0.7586206896551724,18,11,7,338.7324278440691,0.4438180272108843,0.3122739961348504,0.19355544987359907,130374.54433094825,-1167.4471802621633,129207.09715068608,1472,0,304.68,37,13,22,36.03356953689787,0.6221846846846847,44.682017543859665,1021.2719298245636,27.60194404931253,0
3192,4,1,0,51,0.0196078431372549,0.0,1.0,51,1850,1300,550,0.7027027027027027,24,13,11,337.79820792582944,0.44588235294117645,0.33076563958916916,0.1953354854527625,130835.79881656823,-1360.780325443766,129475.01849112447,1473,0,299.6862745098039,38,13,19,35.590930451127825,0.625,44.23076923076924,1023.0769230769245,26.92307692307696,0
3193,4,1,0,52,0.019230769230769232,0.0,1.0,52,1950,1600,350,0.8205128205128205,23,16,7,339.53249664342667,0.4470839617898441,0.3493500747566589,0.19859893829189823,131276.04683059076,-1485.5032140259918,129790.54361656477,1474,0,294.90384615384613,40,12,20,35.10201804839351,0.6260416666666666,43.800813008130106,1024.7967479674837,25.619918699187092,0
3194,4,0,1,51,0.0,0.019230769230769232,0.9807692307692307,52,1500,1000,500,0.6666666666666666,20,10,10,338.0243154413846,0.4468640020110608,0.3448887992956877,0.19813099216686547,131356.2240905856,-1519.6494710213965,129836.5746195642,1475,1,295.90384615384613,37,15,20,35.059788034370875,0.6320382882882882,43.72258771929825,1025.1096491228072,27.705666192508303,0
3195,4,2,1,52,0.03773584905660377,0.018867924528301886,0.9811320754716981,53,850,500,350,0.5882352941176471,12,5,7,331.99602285940296,0.44722121432027095,0.3479459749278728,0.19627604871447887,131684.2689043209,-1856.2692901234693,129827.99961419743,1476,0,291.1320754716981,38,15,18,34.88385205232296,0.6334978070175439,43.40277777777777,1026.3888888888882,27.010233918128637,0
3196,4,0,0,52,0.0,0.0,1.0,52,1550,1100,450,0.7096774193548387,20,11,9,338.0441096894077,0.4461569884364002,0.34707874885888623,0.19970797771687893,131656.85609796195,-1498.8350591715912,130158.02103879036,1477,1,297.7307692307692,38,14,18,34.75627212159067,0.6332236842105263,43.42948717948718,1026.282051282052,27.00742240215926,0
3197,4,0,2,50,0.0,0.038461538461538464,0.9615384615384616,52,1800,1400,400,0.7777777777777778,22,14,8,339.1031929349787,0.4460234414278532,0.3470257554596732,0.2012774460653797,131835.77609592024,-1458.813476562495,130376.96261935774,1478,2,298.7307692307692,39,13,19,34.54891047097406,0.6332799145299146,43.255208333333336,1026.9791666666674,26.332799145299166,0
3198,4,0,2,48,0.0,0.04,0.96,50,1650,1100,550,0.6666666666666666,22,11,11,347.1334017394898,0.4455952380952381,0.34425022812531725,0.20662502965338472,131942.77479383672,-839.6511501736156,131103.1236436631,1479,3,307.66,39,11,19,34.23495640271722,0.6343482905982907,43.151041666666664,1027.3958333333328,26.343482905982892,0
3199,4,0,0,48,0.0,0.0,1.0,48,1200,800,400,0.6666666666666666,16,8,8,353.0069719679742,0.44389036643026003,0.33367138201234314,0.2097533392150867,131876.23844875436,-289.3536781357426,131586.8847706186,1480,4,318.8333333333333,38,10,20,34.15115109909159,0.6354166666666667,43.21581196581196,1027.1367521367513,27.029914529914507,0
3200,4,0,1,47,0.0,0.020833333333333332,0.9791666666666666,48,1350,900,450,0.6666666666666666,18,9,9,379.377481209241,0.44388113179669025,0.31190456408552203,0.21022962080268998,129172.7681017166,266.4060149193205,129439.17411663593,1481,5,319.8333333333333,36,12,20,36.220043572984764,0.6119791666666667,45.86148648648649,1016.5540540540542,28.237612612612615,8
3201,4,0,0,47,0.0,0.0,1.0,47,1150,700,450,0.6086956521739131,16,7,9,391.5480758506974,0.44220243601603454,0.32714026096457194,0.21731335638365973,129234.48562622059,720.3155177007643,129954.80114392134,1482,6,327.4468085106383,31,16,21,35.847659751568706,0.623991935483871,45.80078124999999,1016.7968749999991,32.799899193548356,0
3202,4,0,2,45,0.0,0.0425531914893617,0.9574468085106383,47,1100,800,300,0.7272727272727273,14,8,6,388.68067519419697,0.4421446191797718,0.3209184643664562,0.2162438894588708,129329.78777675742,653.5978471584492,129983.38562391588,1483,7,328.4468085106383,32,15,21,35.82319596160213,0.6223958333333333,45.707070707070706,1017.1717171717168,31.78661616161615,0
3203,4,0,1,44,0.0,0.022222222222222223,0.9777777777777777,45,1300,1000,300,0.7692307692307693,16,10,6,404.98315676745483,0.44166666666666665,0.34005932975005115,0.22497081968447602,129269.7222944849,1470.412041854546,130740.13433633946,1484,8,342.84444444444443,30,15,21,35.47008547008548,0.6270833333333333,45.766129032258064,1016.9354838709677,33.89784946236559,0
3204,4,0,0,44,0.0,0.0,1.0,44,1150,800,350,0.6956521739130435,15,8,7,417.1417377891026,0.44083641649048627,0.34534861437894593,0.2311468720948179,129171.13272392271,1976.5341553287751,131147.66687925148,1485,9,350.9318181818182,34,10,21,35.261984229222776,0.6161151960784313,45.86309523809523,1016.5476190476176,29.89845938375346,0
3205,4,1,0,45,0.022222222222222223,0.0,1.0,45,1050,700,350,0.6666666666666666,14,7,7,410.1784130013111,0.44240319865319866,0.34179642825723566,0.23024681583140275,129680.10210717999,1638.413411453718,131318.5155186337,1486,0,344.1111111111111,30,15,21,34.91823920119643,0.63125,45.36290322580645,1018.548387096774,33.9516129032258,0
3206,4,0,0,45,0.0,0.0,1.0,45,1400,900,500,0.6428571428571429,19,9,10,405.7575115885768,0.44271885521885523,0.33920399704763526,0.22883788189592086,129864.12896050356,1538.6691623263987,131402.79812282996,1487,1,345.1111111111111,31,14,21,34.84287174246295,0.6303763440860215,45.18229166666667,1019.270833333334,32.87970430107529,0
3207,4,0,0,45,0.0,0.0,1.0,45,1700,1200,500,0.7058823529411765,22,12,10,404.0692727425717,0.4430345117845118,0.336674892916915,0.2290505559092117,130063.28158908414,1510.9151204427026,131574.19670952685,1488,2,346.1111111111111,31,14,22,34.68268657986555,0.6323924731182795,44.986979166666664,1020.0520833333328,32.904905913978475,0
3208,4,1,0,46,0.021739130434782608,0.0,1.0,46,1550,1200,350,0.7741935483870968,19,12,7,391.2708037856885,0.4454911433172302,0.3288909659328969,0.22460609119442299,130552.75769054181,1016.2964876033056,131569.0541781451,1489,0,339.5652173913044,32,14,21,34.510903138127006,0.634765625,44.50757575757576,1021.9696969696971,31.936553030303035,0
3209,4,0,1,45,0.0,0.021739130434782608,0.9782608695652174,46,1500,900,600,0.6,21,9,12,386.2135795427196,0.44431360708534623,0.3225071515593889,0.22300186798828017,130778.6693481532,901.6996033567964,131680.36895151,1490,1,340.5652173913044,32,14,22,34.410618030695794,0.6370442708333333,44.28661616161616,1022.853535353535,31.96417297979797,0
3210,4,0,0,45,0.0,0.0,1.0,45,1150,900,250,0.782608695652174,14,9,5,387.5084914567859,0.44379208754208754,0.31987387757899843,0.22450009458593626,130907.84940631047,1145.5806486582883,132053.43005496878,1491,2,345.15555555555557,32,13,22,34.24634998971828,0.6383463541666667,44.16035353535353,1023.358585858585,31.97995580808078,0
3211,4,0,0,45,0.0,0.0,1.0,45,1100,700,400,0.6363636363636364,15,7,8,388.2864384582193,0.4437289562289562,0.32355423998245936,0.22551765351140676,131004.77629833671,1173.4756019793654,132178.25190031607,1492,3,346.15555555555557,32,13,22,34.12807309653018,0.6393229166666667,44.06565656565655,1023.7373737373722,31.99179292929288,0
3212,4,0,0,45,0.0,0.0,1.0,45,1450,900,550,0.6206896551724138,20,9,11,387.0555860200037,0.4436026936026936,0.323025370990905,0.2252253813915841,131077.01965590141,1146.818531334084,132223.8381872355,1493,4,347.15555555555557,33,12,22,34.0862853039732,0.6376262626262627,43.99509803921568,1024.019607843136,31.03089720736776,0
3213,4,0,0,45,0.0,0.0,1.0,45,1100,700,400,0.6363636363636364,15,7,8,388.95953343046045,0.4432449494949495,0.3256973514598198,0.22726000412383493,131233.9323367214,1208.9378183871481,132442.87015510854,1494,5,348.15555555555557,33,12,22,33.878398716262005,0.6392045454545454,43.84191176470588,1024.632352941176,31.049465240641695,0
3214,4,0,0,45,0.0,0.0,1.0,45,1100,600,500,0.5454545454545454,16,6,10,387.666071782669,0.4434132996632996,0.3206865401987351,0.22706155632984915,131328.12500000012,1182.3930399365781,132510.5180399367,1495,6,349.15555555555557,30,15,22,33.816056910569095,0.6479166666666667,43.75000000000001,1025.000000000001,34.1666666666667,0
3215,4,0,0,45,0.0,0.0,1.0,45,1650,1500,150,0.9090909090909091,18,15,3,388.2825162542053,0.4428240740740741,0.323138077141484,0.2284490271037658,131500.39247673156,1211.8606558561912,132712.25313258776,1496,7,350.15555555555557,30,15,22,33.62572620451667,0.6496527777777779,43.58198924731184,1025.672043010754,34.18906810035846,0
3216,4,0,0,45,0.0,0.0,1.0,45,1350,1100,250,0.8148148148148148,16,11,5,388.6425909700483,0.4423821548821549,0.3184923233646222,0.22948849049159473,131638.28775364213,1232.0490446872582,132870.3367983294,1497,8,351.15555555555557,30,15,22,33.47686094739139,0.6510416666666667,43.447580645161295,1026.2096774193556,34.20698924731185,0
3217,4,0,0,45,0.0,0.0,1.0,45,1150,700,450,0.6086956521739131,16,7,9,388.68705487370835,0.4417718855218855,0.3203966644128913,0.23087074464185342,131862.521701389,1250.6510416666772,133113.17274305568,1498,9,352.15555555555557,31,14,22,33.24881676808655,0.6505376344086021,43.22916666666667,1027.0833333333342,33.131720430107556,0
3218,4,0,0,45,0.0,0.0,1.0,45,1150,700,450,0.6086956521739131,16,7,9,389.6235042910803,0.44154040404040407,0.3227530660809077,0.2320391752725222,131962.84188164625,1283.1649780273663,133246.00685967362,1499,10,353.15555555555557,31,14,22,33.12331031132514,0.6515456989247312,43.13151041666668,1027.473958333335,33.14432123655919,0
3219,4,0,0,45,0.0,0.0,1.0,45,1850,1300,550,0.7027027027027027,24,13,11,386.55510639773615,0.4412247474747475,0.3247300716717665,0.23075001262333203,132051.39136690221,1209.027927960402,133260.41929486263,1500,11,354.15555555555557,33,12,22,33.11262966495765,0.6474116161616161,43.0453431372549,1027.818627450981,31.14601901366609,0
3220,4,0,0,45,0.0,0.0,1.0,45,1150,600,550,0.5217391304347826,17,6,11,387.83871597107174,0.4406776094276094,0.3204120817277776,0.23228798470473003,132177.37956855557,1252.7010344579278,133430.08060301348,1501,12,355.15555555555557,33,12,22,32.95234477416282,0.6486742424242424,42.92279411764707,1028.3088235294133,31.16087344028525,0
3221,4,0,0,45,0.0,0.0,1.0,45,1600,1400,200,0.875,18,14,4,356.019258842206,0.44027777777777777,0.2457240204429305,0.20055979360880494,129819.89354263114,256.48327950120574,130076.37682213234,1502,13,356.15555555555557,35,10,19,36.15523850085181,0.6205357142857143,45.22569444444444,1019.097222222222,29.117063492063483,8
3222,4,1,0,46,0.021739130434782608,0.0,1.0,46,1350,900,450,0.6666666666666666,18,9,9,351.35360266555597,0.4418377616747182,0.26149068322981317,0.20018984337921225,130262.58680555565,-46.35416666665566,130216.23263888899,1503,0,349.39130434782606,37,9,22,35.8248299319728,0.6210585585585586,44.79166666666667,1020.8333333333342,27.59009009009011,0
3223,4,1,0,47,0.02127659574468085,0.0,1.0,47,1400,1100,300,0.7857142857142857,17,11,6,343.5693978148227,0.44270351526364476,0.2694535570343992,0.19794480534001213,130694.03863322789,-419.50556975893846,130274.53306346895,1504,0,342.93617021276594,36,11,18,35.586683186490454,0.6273148148148149,44.36936936936937,1022.522522522523,28.403403403403416,0
3224,4,0,0,47,0.0,0.0,1.0,47,1250,700,550,0.56,18,7,11,343.1896983998439,0.4416049953746531,0.26105614549534084,0.19853087884494375,130850.90033712289,-418.6637955909551,130432.23654153194,1505,1,343.93617021276594,37,10,18,35.43776569142286,0.6269707207207207,44.21600877192982,1023.1359649122801,27.65232337600757,0
3225,4,1,0,48,0.020833333333333332,0.0,1.0,48,1550,1200,350,0.7741935483870968,19,12,7,334.0481831211482,0.44202497044917255,0.2589186394132166,0.19495970955256792,131191.27498584625,-835.1585899262262,130356.11639592002,1506,0,337.75,38,10,20,35.32802342962423,0.6285635964912281,43.883547008547005,1024.4658119658116,26.959626630679253,0
3226,4,1,1,48,0.02040816326530612,0.02040816326530612,0.9795918367346939,49,1450,1000,450,0.6896551724137931,19,10,9,327.2695739925927,0.4424780328798186,0.26356595735639354,0.19320370363852815,131629.4461451713,-1184.2661078238038,130445.1800373475,1507,0,331.83673469387753,38,11,16,35.06029845566544,0.6329495614035088,43.45619658119658,1026.1752136752136,27.004610886189834,0
3227,4,0,0,48,0.0,0.0,1.0,48,1150,800,350,0.6956521739130435,15,8,7,328.28223294157743,0.4408244680851064,0.2713186059764219,0.1938418560315598,131637.3803117305,-957.1573705370943,130680.2229411934,1508,1,339.3125,37,11,16,35.026333831962084,0.6348536036036037,43.4484649122807,1026.206140350877,27.735301090564242,0
3228,4,0,1,47,0.0,0.020833333333333332,0.9791666666666666,48,1350,900,450,0.6666666666666666,18,9,9,330.5387077594679,0.4401134013002364,0.27204822172380694,0.1957516711418024,131749.9269606993,-890.309879001245,130859.61708169804,1509,2,340.3125,37,11,17,34.855170173377495,0.6359797297297297,43.33881578947368,1026.644736842104,27.747155049786596,0
3229,4,1,1,47,0.020833333333333332,0.020833333333333332,0.9791666666666666,48,1450,1000,450,0.6896551724137931,19,10,9,330.3814887350983,0.4399102393617021,0.2832722435964101,0.1967355279978598,131958.55391418273,-880.6673013003267,131077.8866128824,1510,0,340.2291666666667,38,10,18,34.64936224047695,0.6362390350877193,43.135683760683754,1027.4572649572635,27.038349077822726,0
3230,4,0,0,47,0.0,0.0,1.0,47,1100,900,200,0.8181818181818182,13,9,4,340.2194619192019,0.439350138760407,0.2900176945319586,0.20208216232068246,131862.52170138876,-427.5607638888944,131434.96093749985,1511,1,348.3829787234043,37,10,18,34.493323191345524,0.6371058558558558,43.229166666666664,1027.0833333333323,27.75900900900898,0
3231,4,0,1,46,0.0,0.02127659574468085,0.9787234042553191,47,1450,800,650,0.5517241379310345,21,8,13,340.4680575282273,0.43954286154794947,0.2852017529916666,0.20268015876997994,131946.99931709733,-415.25228916592727,131531.74702793141,1512,2,349.3829787234043,37,10,19,34.4019032372821,0.6379504504504505,43.14692982456139,1027.4122807017525,27.767899478425743,0
3232,4,0,0,46,0.0,0.0,1.0,46,900,500,400,0.5555555555555556,13,5,8,341.98928448961306,0.43831521739130436,0.28245099767163584,0.2041915638729701,132059.6782182978,-167.40102723916993,131892.27719105865,1513,3,354.10869565217394,37,9,20,34.24943105042314,0.6390765765765766,43.037280701754376,1027.8508771929812,27.77975343764814,0
3233,4,0,1,45,0.0,0.021739130434782608,0.9782608695652174,46,1050,600,450,0.5714285714285714,15,6,9,343.33275022222216,0.437469806763285,0.2860915942028983,0.20514624176758,132087.85545792925,-129.98266293476712,131957.87279499447,1514,4,355.10869565217394,37,9,20,34.18655555555556,0.6393581081081081,43.00986842105262,1027.9605263157885,27.78271692745374,0
3234,4,0,0,45,0.0,0.0,1.0,45,1250,800,450,0.64,17,8,9,341.3930256607647,0.4371843434343434,0.2763357150474568,0.20429115517683372,132144.21895438957,22.62294648350519,132166.84190087309,1515,5,355.22222222222223,37,8,21,34.17970832888984,0.6399211711711712,42.95504385964911,1028.1798245614016,27.78864390706491,0
3235,4,1,0,46,0.021739130434782608,0.0,1.0,46,1350,1200,150,0.8888888888888888,15,12,3,333.21223359003744,0.4364432367149758,0.27736081386144407,0.20169540506694922,132576.73852237655,-364.0313739697713,132212.70714840677,1516,0,348.4782608695652,35,11,23,33.95566419420095,0.6482142857142856,42.53472222222222,1029.861111111111,29.424603174603174,0
3236,4,0,0,46,0.0,0.0,1.0,46,1400,800,600,0.5714285714285714,20,8,12,335.3675056562534,0.43597020933977454,0.27544291554930367,0.2034837196895917,132666.15125868045,-301.61675347222797,132364.53450520823,1517,1,349.4782608695652,35,11,19,33.810456690259535,0.6491071428571429,42.447916666666664,1030.2083333333326,29.43452380952379,0
3237,4,0,0,46,0.0,0.0,1.0,46,1600,1100,500,0.6875,21,11,10,336.930129187193,0.4356179549114332,0.277105659248567,0.205821827416086,132920.0542392056,-243.0457907231381,132677.00844848246,1518,2,350.4782608695652,36,10,19,33.5155709657457,0.6495949074074074,42.201576576576585,1031.1936936936952,28.644269269269312,0
3238,4,0,0,46,0.0,0.0,1.0,46,1200,1000,200,0.8333333333333334,14,10,4,337.312884956427,0.43554750402576486,0.2778004556673621,0.2065364990775986,133007.16256797354,-226.99405486566053,132780.16851310787,1519,3,351.4782608695652,36,10,20,33.41839519650653,0.650462962962963,42.117117117117125,1031.531531531533,28.65365365365369,0
3239,4,1,0,47,0.02127659574468085,0.0,1.0,47,1350,700,650,0.5185185185185185,20,7,13,333.23423478045305,0.43451279679309285,0.28684575218922914,0.206305689173067,133418.40820312494,-508.0837673611099,132910.32443576382,1520,0,344.97872340425533,39,8,21,33.11193452981113,0.6490384615384616,41.71875,1033.1249999999995,26.490384615384603,0
3240,4,0,1,46,0.0,0.02127659574468085,0.9787234042553191,47,1800,1300,500,0.7222222222222222,23,13,10,333.7331630797974,0.43349136601911814,0.28453278196491705,0.20758388667331135,133591.84777949256,-483.15061299724556,133108.69716649532,1521,1,345.97872340425533,35,12,21,32.92562322734736,0.6583333333333333,41.55092592592593,1033.796296296297,29.537037037037056,0
3241,4,0,0,46,0.0,0.0,1.0,46,1450,1000,450,0.6896551724137931,19,10,9,345.8122022616708,0.4313909017713366,0.2893677527887364,0.21511698885675878,133595.2664399095,39.77465986396669,133635.04109977346,1522,2,354.10869565217394,34,12,21,32.610020343927545,0.6605392156862745,41.54761904761906,1033.8095238095252,30.406162464986036,0
3242,4,0,1,45,0.0,0.021739130434782608,0.9782608695652174,46,1350,1100,250,0.8148148148148148,16,11,5,352.0663924654269,0.4313607085346216,0.266003267124195,0.2073331851442575,131535.81700370784,113.44478683318356,131649.26179054103,1523,3,355.10869565217394,35,11,21,34.51862142239273,0.6377976190476191,43.547453703703695,1025.8101851851839,29.308862433862394,8
3243,4,0,0,45,0.0,0.0,1.0,45,900,600,300,0.6666666666666666,12,6,6,354.5623782055895,0.4304503367003367,0.2571351204982404,0.20883554429238296,131541.75347222213,327.9513888888836,131869.704861111,1524,4,358.46666666666664,34,11,21,34.448619008935836,0.6400122549019608,43.541666666666664,1025.8333333333328,30.171568627450966,0
3244,4,0,0,45,0.0,0.0,1.0,45,1600,1200,400,0.75,20,12,8,354.83594879181953,0.42944023569023565,0.2600987253347766,0.209666944107901,131663.9048327664,343.81731859409643,132007.72215136047,1525,5,359.46666666666664,34,11,18,34.31833120674321,0.6412377450980392,43.422619047619044,1026.3095238095234,30.185574229691866,0
3245,4,1,0,46,0.021739130434782608,0.0,1.0,46,1600,1200,400,0.75,20,12,8,344.8830803791876,0.43042471819645733,0.2688143093506161,0.20614074831278226,132100.37964034636,-88.16283007544911,132012.2168102709,1526,0,352.6304347826087,35,11,19,34.134110185393666,0.6434523809523809,42.99768518518518,1028.0092592592591,29.371693121693117,0
3246,4,0,0,46,0.0,0.0,1.0,46,1500,1200,300,0.8,18,12,6,343.9424084078384,0.4288848631239936,0.2760160318351881,0.20641064115618918,132253.17166829002,-102.50512336659403,132150.6665449234,1527,1,353.6304347826087,36,10,20,34.00458908108899,0.6429398148148149,42.84909909909911,1028.6036036036046,28.57232232232235,0
3247,4,0,1,45,0.0,0.021739130434782608,0.9782608695652174,46,1100,700,400,0.6363636363636364,15,7,8,343.5201715520691,0.42769726247987117,0.28076260622151117,0.20679099655090985,132369.0307706357,-105.71356829800317,132263.3172023377,1528,2,354.6304347826087,36,10,20,33.89896585686147,0.6440972222222222,42.7364864864865,1029.0540540540558,28.584834834834883,0
3248,4,1,2,44,0.021739130434782608,0.043478260869565216,0.9565217391304348,46,1300,1000,300,0.7692307692307693,16,10,6,340.9291897423736,0.42875402576489535,0.2736844419044271,0.20685826297865456,132666.15125868042,-154.0441386276657,132512.10712005274,1529,0,353.82608695652175,35,11,17,33.66721435793731,0.6491071428571429,42.44791666666666,1030.2083333333321,29.434523809523775,0
3249,4,0,0,44,0.0,0.0,1.0,44,1450,1200,250,0.8275862068965517,17,12,5,360.95781743624525,0.4277440098661029,0.21783773236500692,0.20508674088837467,130153.54624379062,595.987996749213,130749.53424053984,1530,4,370.6136363636364,38,6,17,35.690416361288534,0.6181469298245614,44.89850427350427,1020.4059829059828,26.852789023841652,8
3250,4,0,0,44,0.0,0.0,1.0,44,1050,700,350,0.6666666666666666,14,7,7,360.6830487296958,0.4276999647639183,0.21901669758812603,0.20550545799715247,130262.58680555565,596.701388888899,130859.28819444455,1531,5,371.6136363636364,38,6,17,35.58673469387755,0.6192434210526316,44.79166666666667,1020.8333333333342,26.86403508771932,0
3251,4,0,0,44,0.0,0.0,1.0,44,1350,800,550,0.5925925925925926,19,8,11,359.2824318694668,0.4278321000704722,0.21412459397682126,0.2051620335133705,130348.82010388764,566.4082156480777,130915.22831953572,1532,6,372.6136363636364,36,8,17,35.53498566387295,0.6238425925925926,44.707207207207205,1021.171171171171,28.36586586586586,0
3252,4,0,0,44,0.0,0.0,1.0,44,950,300,650,0.3157894736842105,16,3,13,360.4619761257226,0.4277440098661029,0.21546176284846497,0.20598800639471812,130377.5708774652,599.2313681925076,130976.8022456577,1533,7,373.6136363636364,36,8,17,35.47570478185761,0.6241319444444444,44.67905405405405,1021.2837837837831,28.368993993993975,0
3253,4,1,1,44,0.022222222222222223,0.022222222222222223,0.9777777777777777,45,1350,800,550,0.5925925925925926,19,8,11,358.1546107699873,0.42889309764309763,0.22400419287211792,0.20673677037515056,130766.77439212028,366.9446368112872,131133.71902893158,1534,0,366.2888888888889,37,8,17,35.14016938250429,0.6261261261261262,44.29824561403507,1022.8070175438567,27.64343290659072,0
3254,4,1,0,45,0.022222222222222223,0.0,1.0,45,1550,1200,350,0.7741935483870968,19,12,7,363.3766665779224,0.42927188552188555,0.25186611973128903,0.21236741395689038,131243.8457626382,538.190236418865,131782.03599905706,1535,0,365.55555555555554,37,8,18,34.52369805600142,0.6309121621621622,43.832236842105246,1024.6710526315765,27.69381223328585,0
3255,4,0,1,44,0.0,0.022222222222222223,0.9777777777777777,45,1500,1000,500,0.6666666666666666,20,10,10,363.04990111785776,0.4291245791245791,0.2483893855541366,0.2131526106563129,131419.6588010205,542.4599813090196,131962.11878232952,1536,1,366.55555555555554,34,11,18,34.35431905259492,0.6387867647058824,43.66071428571429,1025.3571428571436,30.157563025210106,0
3256,4,0,0,44,0.0,0.0,1.0,44,1200,800,400,0.6666666666666666,16,8,8,371.0536916483681,0.4277219873150106,0.2566894572465601,0.21837422180617078,131511.22448979592,959.5450680272079,132470.76955782314,1537,2,375.52272727272725,34,10,19,34.0565517641597,0.6397058823529411,43.57142857142857,1025.7142857142856,30.168067226890752,0
3257,4,0,0,44,0.0,0.0,1.0,44,1250,800,450,0.64,17,8,9,375.5606554437918,0.42736962649753346,0.26429219122329806,0.2220908073550323,131694.4515306122,1091.850907029471,132786.30243764166,1538,3,376.52272727272725,34,10,18,33.755702466558425,0.6415441176470589,43.39285714285714,1026.4285714285709,30.189075630252084,0
3258,4,1,0,45,0.022222222222222223,0.0,1.0,45,1000,700,300,0.7,13,7,6,369.8071053027236,0.42939814814814814,0.2651399682146389,0.22051828663417597,132011.15779588892,763.7328264317413,132774.89062232067,1539,0,369.1333333333333,35,10,19,33.58357266208657,0.6425595238095239,43.08449074074073,1027.662037037036,29.36177248677246,0
3259,4,0,0,45,0.0,0.0,1.0,45,1500,1300,200,0.8666666666666667,17,13,4,368.52594086392384,0.4286826599326599,0.26496288183035177,0.2204876697305126,132137.36329234633,739.2092261180019,132876.57251846432,1540,1,370.1333333333333,36,9,19,33.489184008762315,0.6417824074074074,42.96171171171171,1028.1531531531525,28.559809809809792,0
3260,4,0,1,44,0.0,0.022222222222222223,0.9777777777777777,45,1750,1400,350,0.8,21,14,7,367.6769441290368,0.4279882154882155,0.2712772585669794,0.2210192866393643,132315.55103550255,729.8754930966068,133045.42652859914,1541,2,371.1333333333333,38,7,20,33.3313862928349,0.6398026315789473,42.78846153846152,1028.8461538461506,27.074898785425017,0
3261,4,0,0,44,0.0,0.0,1.0,44,1850,1300,550,0.7027027027027027,24,13,11,370.2732383746661,0.42789816772374917,0.27355539197644463,0.2230670484842499,132398.00347222216,1004.7645463510763,133402.76801857323,1542,3,376.59090909090907,34,10,21,33.18151147098515,0.6485906862745099,42.70833333333333,1029.166666666666,30.269607843137237,0
3262,4,0,0,44,0.0,0.0,1.0,44,1150,900,250,0.782608695652174,14,9,5,367.7875502434189,0.4280743481324876,0.2698889916743752,0.22211080548219875,132489.90929705213,945.6278344671105,133435.53713151923,1543,4,377.59090909090907,34,10,21,33.15289662349675,0.6495098039215687,42.61904761904761,1029.5238095238092,30.280112044817916,0
3263,4,1,0,45,0.022222222222222223,0.0,1.0,45,1250,900,350,0.72,16,9,7,359.34702377015634,0.4283880471380472,0.2760226039444633,0.21907624508698015,132845.06715374222,547.4959008487554,133392.56305459098,1544,0,370.1777777777778,35,10,18,33.01300943078476,0.6508928571428572,42.27430555555555,1030.9027777777771,29.45436507936506,0
3264,4,0,0,45,0.0,0.0,1.0,45,900,400,500,0.4444444444444444,14,4,10,356.9839812264055,0.42817760942760946,0.2760942760942764,0.21815687741613665,132934.57031249988,491.1024305555427,133425.67274305542,1545,1,371.1777777777778,35,10,18,32.984006734006726,0.6517857142857143,42.18749999999999,1031.249999999999,29.464285714285687,0
3265,4,0,0,45,0.0,0.0,1.0,45,1300,800,500,0.6153846153846154,18,8,10,354.8510229580518,0.4273569023569024,0.2736894570919475,0.21807074925685346,133143.52823055966,449.2234385716576,133592.7516691313,1546,2,372.1777777777778,35,10,20,32.82926339202274,0.6538690476190476,41.984953703703695,1032.0601851851839,29.487433862433825,0
3266,4,0,0,45,0.0,0.0,1.0,45,1250,700,550,0.56,18,7,11,350.9129028920585,0.42643097643097644,0.2741403126135953,0.21654584922746786,133297.72973987483,355.1786583881001,133652.90839826292,1547,3,373.1777777777778,36,9,21,32.77626317702654,0.6533564814814814,41.83558558558558,1032.6576576576563,28.684934934934898,0
3267,4,0,0,45,0.0,0.0,1.0,45,1150,700,450,0.6086956521739131,16,7,9,351.7843861143792,0.4266835016835017,0.27767869780608656,0.2174415299998329,133358.94217451525,382.71872114497137,133741.66089566023,1548,4,374.1777777777778,37,8,21,32.69240976645435,0.652027027027027,41.776315789473685,1032.8947368421054,27.916073968705554,0
3268,4,0,0,45,0.0,0.0,1.0,45,1100,700,400,0.6363636363636364,15,7,8,354.77367325702426,0.42590488215488215,0.2804659498207891,0.21995967741935452,133472.2222222218,470.5822945521218,133942.80451677393,1549,5,375.1777777777778,35,10,21,32.501680107526866,0.6571428571428571,41.66666666666664,1033.33333333333,29.52380952380943,0
3269,4,0,0,45,0.0,0.0,1.0,45,1450,1000,450,0.6896551724137931,19,10,9,354.92839970942305,0.42537878787878786,0.27741831162854336,0.22094602052991444,133621.76254125923,485.2316690243192,134106.99421028356,1550,6,376.1777777777778,35,10,21,32.34787212209411,0.6586309523809524,41.521990740740726,1033.9120370370354,29.54034391534387,0
3270,4,0,0,45,0.0,0.0,1.0,45,1350,800,550,0.5925925925925926,19,8,11,355.1969701894061,0.42512626262626263,0.2770232812519422,0.22219074293373697,133801.32144043632,505.1647965963572,134306.4862370327,1551,7,377.1777777777778,35,10,16,32.16115244061603,0.6604166666666667,41.348379629629626,1034.606481481481,29.560185185185173,0
3271,4,1,0,46,0.021739130434782608,0.0,1.0,46,1200,900,300,0.75,15,9,6,349.60559551062914,0.425774959742351,0.28575635975407776,0.22079369427703335,134152.91243459497,180.12176823635195,134333.03420283133,1552,0,369.95652173913044,37,9,17,31.954293677674286,0.6599099099099099,41.00877192982455,1035.9649122806995,27.99905168326215,0
3272,4,0,0,46,0.0,0.0,1.0,46,950,600,350,0.631578947368421,13,6,7,352.2382343379969,0.42502012882447665,0.28409430638536715,0.22332045802797304,134294.94081111465,260.76256636654153,134555.7033774812,1553,1,370.95652173913044,37,9,17,31.744221411192207,0.6613175675675675,40.87171052631577,1036.5131578947344,28.013869132290118,0
3273,4,0,1,45,0.0,0.021739130434782608,0.9782608695652174,46,1600,1000,600,0.625,22,10,12,350.12724562378423,0.42469806763285023,0.2815605836329036,0.22284680276647018,134437.04433094777,214.01440827944754,134651.0587392272,1554,2,371.95652173913044,37,9,18,31.657062803975464,0.6627252252252251,40.73464912280701,1037.0614035087704,28.02868658131812,0
3274,4,0,0,45,0.0,0.0,1.0,45,1300,1000,300,0.7692307692307693,16,10,6,353.3813970742408,0.4238846801346801,0.28362338241856344,0.22562043043970756,134550.78125,509.6447945521703,135060.42604455218,1555,3,376.4,35,10,18,31.45917001338687,0.6678571428571429,40.625,1037.5,29.642857142857142,0
3275,4,0,0,45,0.0,0.0,1.0,45,1300,1000,300,0.7692307692307693,16,10,6,352.5821858815896,0.422790404040404,0.28215533259011516,0.22622762570514024,134730.96305941365,500.74749228395996,135231.71055169762,1556,4,377.4,35,10,18,31.300167224080266,0.6696428571428572,40.45138888888889,1038.194444444445,29.66269841269843,0
3276,4,0,0,45,0.0,0.0,1.0,45,1500,1100,400,0.7333333333333333,19,11,8,352.7944560327182,0.42184343434343435,0.28479811120747844,0.2272469317350416,134872.27091956834,516.4378905933156,135388.70881016165,1557,5,378.4,36,9,16,31.153783607979204,0.6689814814814814,40.315315315315324,1038.7387387387398,28.853853853853884,0
3277,4,0,1,44,0.0,0.022222222222222223,0.9777777777777777,45,1550,1200,350,0.7741935483870968,19,12,7,351.31443391138305,0.42156986531986534,0.27872437796565297,0.22665922848016934,134930.7648019642,480.6250507264111,135411.3898526906,1558,6,379.4,36,9,16,31.13393308765084,0.6695601851851851,40.25900900900901,1038.9639639639645,28.860110110110124,0
3278,4,0,1,43,0.0,0.022727272727272728,0.9772727272727273,44,1550,1200,350,0.7741935483870968,19,12,7,350.47638293276253,0.4193644291754757,0.26980417458800865,0.22666759201727188,135018.52940355914,664.161162852064,135682.6905664112,1559,7,382.97727272727275,36,8,16,31.068281142774605,0.6704282407407407,40.17454954954956,1039.301801801803,28.869494494494532,0
3279,4,0,0,43,0.0,0.0,1.0,43,1000,600,400,0.6,14,6,8,356.5949589415868,0.4195967146548542,0.27090937823015415,0.23013320966345258,134941.32754897553,1023.8794313700332,135965.20698034557,1560,8,387.5348837209302,35,8,16,30.986247261520173,0.6717261904761904,40.248842592592595,1039.00462962963,29.68584656084657,0
3280,4,0,0,43,0.0,0.0,1.0,43,1200,900,300,0.75,15,9,6,357.9687033366142,0.41865079365079366,0.2678392519202939,0.23217565791139383,135121.77057881086,1073.8730013288741,136195.64358013973,1561,9,388.5348837209302,35,8,16,30.770738246317112,0.6735119047619047,40.07523148148148,1039.699074074074,29.705687830687825,0
3281,4,0,0,43,0.0,0.0,1.0,43,1550,1000,550,0.6451612903225806,21,10,11,357.72563445457075,0.41752030269472135,0.26067519215992707,0.2331831564983421,135302.3341719179,1080.222666966742,136382.55683888463,1562,10,389.5348837209302,35,8,16,30.597234583008863,0.675297619047619,39.901620370370374,1040.393518518519,29.725529100529112,0
3282,4,0,0,43,0.0,0.0,1.0,43,1050,700,350,0.6666666666666666,14,7,7,358.24108111719727,0.4166435954226652,0.26240008277931515,0.23371460952420933,135332.43982553162,1096.3279106653051,136428.76773619693,1563,11,390.5348837209302,35,8,16,30.5538561364479,0.6755952380952381,39.87268518518519,1040.50925925926,29.728835978836003,0
3283,4,0,0,43,0.0,0.0,1.0,43,1300,800,500,0.6153846153846154,18,8,10,361.3335842749754,0.41606681432262826,0.2655243483950045,0.23632530351889844,135422.7768802512,1186.5594725222832,136609.33635277348,1564,12,391.5348837209302,35,8,16,30.383469550391034,0.6764880952380952,39.785879629629626,1040.8564814814813,29.738756613756607,0
3284,4,0,0,43,0.0,0.0,1.0,43,1650,1400,250,0.8484848484848485,19,14,5,371.7860516713307,0.4151439645625692,0.31921075093365214,0.2225305702207403,132153.07716836734,1291.7253954693983,133444.80256383674,1565,13,392.5348837209302,34,9,19,33.38953533248427,0.6461397058823529,42.94642857142857,1028.2142857142856,30.24159663865546,8
3285,4,0,0,43,0.0,0.0,1.0,43,1200,700,500,0.5833333333333334,17,7,10,377.15746857021077,0.41456718346253235,0.3284059881367103,0.2272143774069321,132398.00347222236,1386.9791666666847,133784.98263888905,1566,14,393.5348837209302,34,9,19,33.004385964912295,0.6485906862745099,42.70833333333334,1029.1666666666679,30.26960784313729,0
3286,4,0,0,43,0.0,0.0,1.0,43,750,500,250,0.6666666666666666,10,5,5,377.5383021135811,0.41447489848652636,0.32983662293088867,0.2276287419856361,132428.6352040817,1399.3764172335639,133828.01162131524,1567,15,394.5348837209302,34,9,19,32.96370190454161,0.6488970588235294,42.67857142857143,1029.2857142857147,30.27310924369749,0
3287,4,1,0,44,0.022727272727272728,0.0,1.0,44,1050,500,550,0.47619047619047616,16,5,11,369.48487071562334,0.4163253171247357,0.3322214282068292,0.22489834406853232,132785.41512613607,1012.440388160161,133797.8555142962,1568,0,386.54545454545456,35,9,17,32.811739659367404,0.6502976190476191,42.33217592592593,1030.671296296297,29.447751322751344,0
3288,4,0,0,44,0.0,0.0,1.0,44,950,400,550,0.42105263157894735,15,4,11,370.4554109768608,0.41625924947145876,0.3359181236412625,0.2258484836119713,132845.06715374242,1042.634789737672,133887.7019434801,1569,1,387.54545454545456,35,9,17,32.72671775008421,0.6508928571428572,42.274305555555564,1030.9027777777787,29.454365079365108,0
3289,4,0,1,43,0.0,0.022727272727272728,0.9772727272727273,44,850,600,250,0.7058823529411765,11,6,5,349.5654630304887,0.4154994714587738,0.28202654730668364,0.20146189601267842,130706.03358892715,350.42076581786625,131056.45435474502,1570,2,388.54545454545456,35,9,15,35.42126485568762,0.6294642857142857,44.35763888888887,1022.5694444444418,29.216269841269767,8
3290,4,2,0,45,0.044444444444444446,0.0,1.0,45,1200,600,600,0.5,18,6,12,334.782564842401,0.42032828282828283,0.2830970252988605,0.19580697329075034,131273.37643363263,-210.39246840530996,131062.98396522732,1571,0,374.93333333333334,38,7,18,35.22640394773423,0.6293859649122807,43.80341880341879,1024.7863247863231,26.96806117858745,0
3291,4,0,0,45,0.0,0.0,1.0,45,1150,800,350,0.6956521739130435,15,8,7,333.2024819233942,0.4202651515151515,0.2827572739699278,0.19545588888083623,131385.8453047641,-244.35922242143,131141.4860823427,1572,1,375.93333333333334,36,9,19,35.153503954305805,0.6342592592592593,43.69369369369369,1025.2252252252244,28.478478478478458,0
3292,4,0,1,44,0.0,0.022222222222222223,0.9777777777777777,45,1600,1400,200,0.875,18,14,4,350.9867999487377,0.4199915824915825,0.2805010893246187,0.19889251997095134,130050.0,145.60202093985765,130195.60202093986,1573,2,376.93333333333334,39,6,14,36.0498366013072,0.6153846153846154,45.0,1020.0,26.153846153846153,8
3293,4,0,0,44,0.0,0.0,1.0,44,1250,900,350,0.72,16,9,7,360.2724378279282,0.41686486962649755,0.2888732796799849,0.20384116295599133,129990.07100819997,566.3679551099369,130556.4389633099,1574,3,386.45454545454544,38,6,14,35.87393050462719,0.6165021929824561,45.05876068376068,1019.7649572649569,26.83591992802518,0
3294,4,0,0,44,0.0,0.0,1.0,44,1550,1100,450,0.7096774193548387,20,11,9,358.87419904418795,0.41734936575052856,0.2786607831376917,0.20361792790688943,130099.04308431946,537.8379766600833,130636.88106097955,1575,4,387.45454545454544,38,6,14,35.798905644570105,0.6175986842105263,44.95192307692307,1020.1923076923072,26.84716599190282,0
3295,4,0,1,43,0.0,0.022727272727272728,0.9772727272727273,44,750,300,450,0.4,12,3,9,355.89660269928544,0.4173053206483439,0.2723886136317242,0.20250144676234627,130209.42382812516,468.21831597223644,130677.6421440974,1576,5,388.45454545454544,39,5,14,35.76282574675105,0.6169871794871795,44.84375000000001,1020.6250000000013,26.169871794871828,0
3296,4,0,0,43,0.0,0.0,1.0,43,1150,900,250,0.782608695652174,14,9,5,362.34902124114933,0.4161129568106312,0.29387755102040813,0.20645467489321329,130262.58680555575,840.1041666666911,131102.69097222245,1577,6,397.3255813953488,38,5,14,35.54421768707484,0.6192434210526316,44.79166666666668,1020.833333333335,26.86403508771934,0
3297,4,0,0,43,0.0,0.0,1.0,43,1100,800,300,0.7272727272727273,14,8,6,359.11755208611964,0.415859173126615,0.29687279590238425,0.20562167862559766,130453.51765103391,769.6295839725556,131223.14723500647,1578,7,398.3255813953488,38,5,16,35.43300739036463,0.6211622807017544,44.604700854700866,1021.5811965811985,26.883715699505224,0
3298,4,0,0,43,0.0,0.0,1.0,43,850,300,550,0.35294117647058826,14,3,11,349.0548949985782,0.41615909929863415,0.2551587907567876,0.18412158204338397,127199.76463766515,297.2469911973044,127497.01162886246,1579,8,399.3255813953488,38,5,16,39.00700769610961,0.5882675438596492,47.809829059829056,1008.7606837606827,26.54633378317586,8
3299,4,2,0,45,0.044444444444444446,0.0,1.0,45,1650,1300,350,0.7878787878787878,20,13,7,319.01356323954536,0.41963383838383833,0.2041794906106429,0.17237804469191043,128170.25662634676,-803.2681835486092,127366.98844279815,1580,0,382.53333333333336,40,5,19,38.77375217449486,0.5947916666666666,46.84959349593496,1012.6016260162602,25.315040650406505,8
3300,4,0,0,45,0.0,0.0,1.0,45,1300,700,600,0.5384615384615384,19,7,12,319.92829038771293,0.4198653198653199,0.19615736097180436,0.17354108025927628,128324.66310562493,-789.0619836076435,127535.6011220173,1581,1,383.53333333333336,40,5,19,38.593279839518566,0.5963541666666667,46.697154471544714,1013.2113821138208,25.33028455284552,0
3301,4,0,0,45,0.0,0.0,1.0,45,950,700,250,0.7368421052631579,12,7,5,319.5232712479477,0.4188341750841751,0.19453800231667073,0.17399367652672085,128479.16253552787,-789.583539890272,127689.5789956376,1582,2,384.53333333333336,40,5,15,38.44622928361399,0.5979166666666667,46.54471544715447,1013.8211382113827,25.34552845528457,0
3302,4,1,0,46,0.021739130434782608,0.0,1.0,46,1950,1500,450,0.7692307692307693,24,15,9,315.55552479601835,0.4205716586151369,0.2113825109916947,0.17354706052053998,128873.80248685124,-1066.6319247606452,127807.1705620906,1583,0,377.1521739130435,41,5,17,38.14555854095422,0.6003556910569106,46.15575396825397,1015.3769841269843,24.765292295780107,0
3303,4,1,1,46,0.02127659574468085,0.02127659574468085,0.9787234042553191,47,1200,1000,200,0.8333333333333334,14,10,4,310.3817744553695,0.42352759790317607,0.21627114930940872,0.17179917848350243,129127.51379311638,-1384.2346275764673,127743.2791655399,1584,0,370.1063829787234,42,5,18,38.01939333269776,0.6014384920634921,45.906007751937985,1016.3759689922479,24.199427833148757,0
3304,4,1,1,46,0.02127659574468085,0.02127659574468085,0.9787234042553191,47,1450,1100,350,0.7586206896551724,18,11,7,303.931606108215,0.424722479185939,0.20079369420287185,0.16970726522884552,129472.44498715524,-1529.825243374799,127942.61974378044,1585,0,359.74468085106383,42,5,15,37.83383319051699,0.6049107142857143,45.56686046511628,1017.7325581395351,24.231727574750835,0
3305,4,0,1,45,0.0,0.021739130434782608,0.9782608695652174,46,1550,900,650,0.5806451612903226,22,9,13,310.3915013570338,0.42215177133655396,0.20642528565068985,0.17289868801827166,129377.95380015431,-1168.4365354938277,128209.51726466048,1586,2,368.5652173913044,41,5,20,37.76521615472126,0.6054369918699187,45.65972222222222,1017.3611111111111,24.813685636856366,0
3306,4,1,1,45,0.021739130434782608,0.021739130434782608,0.9782608695652174,46,1250,900,350,0.72,16,9,7,307.8998376359806,0.424969806763285,0.20230582825383991,0.1731154488184331,129743.78511657943,-1210.3819256655345,128533.40319091389,1587,0,364.17391304347825,42,4,16,37.458190666413046,0.6076388888888888,45.30038759689922,1018.7984496124022,24.257105943152435,0
3307,4,1,2,44,0.021739130434782608,0.043478260869565216,0.9565217391304348,46,1300,1000,300,0.7692307692307693,16,10,6,301.50169758995094,0.42505032206119164,0.21851854944430982,0.15938267404577383,127287.50244125938,-1523.485198455639,125764.01724280373,1588,0,365.0869565217391,42,4,18,40.11666986748606,0.5828373015873016,47.722868217054256,1009.1085271317817,24.02639350313766,7
3308,4,5,0,49,0.10204081632653061,0.0,1.0,49,1300,1000,300,0.7692307692307693,16,10,6,286.0545731216463,0.4336203231292517,0.23597521626087747,0.15510451630807998,128308.64626200264,-2453.593949033378,125855.05231296926,1589,0,328.1020408163265,44,5,20,39.46757143727532,0.5904356060606061,46.712962962962955,1013.1481481481474,23.02609427609426,0
3309,4,0,2,47,0.0,0.04081632653061224,0.9591836734693877,49,1150,700,450,0.6086956521739131,16,7,9,283.1180287082031,0.43386833900226757,0.23226681977138708,0.15405448202273384,128449.39986282567,-2526.7318244170215,125922.66803840865,1590,1,329.1020408163265,44,5,14,39.39912921690414,0.5918560606060606,46.57407407407407,1013.7037037037028,23.03872053872052,0
3310,4,2,1,48,0.04081632653061224,0.02040816326530612,0.9795918367346939,49,1950,1400,550,0.717948717948718,25,14,11,286.10491407860275,0.4340809240362811,0.2355354137370762,0.15682580515345731,128741.3522631801,-2433.2932944759405,126308.05896870416,1591,0,330.0204081632653,45,4,18,39.02735630132098,0.5935185185185186,46.286231884057976,1014.8550724637689,22.55233494363931,0
3311,4,1,2,47,0.02040816326530612,0.04081632653061224,0.9591836734693877,49,1250,800,450,0.64,17,8,9,286.94485940099815,0.4357107426303855,0.23585961629813812,0.1581087326026237,128948.26721178596,-2399.7915189823434,126548.47569280362,1592,0,330.53061224489795,45,4,19,38.79639332322603,0.5956018518518518,46.08242753623189,1015.6702898550732,22.570450885668293,0
3312,4,0,0,47,0.0,0.0,1.0,47,1250,1100,150,0.88,14,11,3,297.89473860896067,0.43528368794326244,0.2349969542502588,0.16389560195504832,128888.68375695912,-1720.9478485135155,127167.7359084456,1593,1,341.9574468085106,43,4,19,38.578775373807076,0.5976259689922481,46.1410984848485,1015.4356060606086,23.614781536293222,0
3313,4,2,0,49,0.04081632653061224,0.0,1.0,49,1400,1000,400,0.7142857142857143,18,10,8,292.25117853060914,0.4386337868480725,0.25454524253278055,0.16298086169675682,129423.14093391344,-2234.050273924277,127189.09065998916,1594,0,328.9591836734694,42,7,21,38.18088753452052,0.6044146825396826,45.61531007751939,1017.5387596899242,24.227113325950576,0
3314,4,0,1,48,0.0,0.02040816326530612,0.9795918367346939,49,950,700,250,0.7368421052631579,12,7,5,291.7791011329119,0.43826176303854875,0.251736296612886,0.1631261020437062,129521.75842985701,-2241.6515496364345,127280.10688022058,1595,1,329.9591836734694,42,7,15,38.09316991908615,0.605406746031746,45.51841085271318,1017.9263565891475,24.236341823551133,0
3315,4,1,0,49,0.02040816326530612,0.0,1.0,49,2000,1400,600,0.7,26,14,12,294.7474032721029,0.43815547052154197,0.2585965893206599,0.1655120033758734,129694.42942130908,-2154.580741842411,127539.84867946667,1596,0,330.9183673469388,42,7,16,37.84306031202436,0.6071428571428572,45.34883720930234,1018.6046511627927,24.25249169435221,0
3316,4,1,0,50,0.02,0.0,1.0,50,1650,1300,350,0.7878787878787878,20,13,7,285.00111987759004,0.4393027210884353,0.24640036314117086,0.16140294783813164,130026.38996056266,-2588.4666495198658,127437.9233110428,1597,0,325.28,44,6,18,37.75627931608413,0.607717803030303,45.02314814814816,1019.9074074074094,23.179713804713852,0
3317,4,0,0,50,0.0,0.0,1.0,50,1850,1600,250,0.8648648648648649,21,16,5,281.65873882881937,0.4388095238095238,0.24007987929351238,0.16019429633439228,130193.2459452453,-2665.9869086063745,127527.25903663893,1598,1,326.28,45,5,18,37.67334916126744,0.6081018518518518,44.85960144927537,1020.5615942028992,22.679146537842204,0
3318,4,1,2,49,0.0196078431372549,0.0392156862745098,0.9607843137254902,51,1650,1400,250,0.8484848484848485,19,14,5,277.5875441596714,0.43939542483660127,0.2432099438477895,0.1591482253710337,130504.37345758721,-2954.6669123460924,127549.70654524112,1599,0,320.8627450980392,43,8,13,37.46408711770159,0.6138565891472868,44.55492424242424,1021.7803030303029,23.762332628611695,0
3319,4,0,0,49,0.0,0.0,1.0,49,950,300,650,0.3157894736842105,16,3,13,289.2080851459247,0.43514384920634924,0.2470278170543312,0.16488866505466523,130287.90632282988,-2263.9368189405645,128023.96950388931,1600,1,334.6326530612245,41,8,20,37.38531645774624,0.6145833333333333,44.76686507936507,1020.9325396825382,24.900793650793613,0
3320,4,0,1,48,0.0,0.02040816326530612,0.9795918367346939,49,1300,900,400,0.6923076923076923,17,9,8,293.1023868251799,0.4342403628117914,0.25221278409372516,0.16754520113077317,130389.20899667729,-2156.5223253653385,128232.68667131195,1601,2,335.6326530612245,41,8,20,37.18380686417357,0.615599593495935,44.66765873015873,1021.3293650793645,24.91047231900889,0
3321,4,0,1,47,0.0,0.020833333333333332,0.9791666666666666,48,1400,700,700,0.5,21,7,14,302.20847528539844,0.4322824320330969,0.25876554001554064,0.172863247863248,130414.54081632655,-1717.5240929705155,128697.01672335604,1602,3,343.25,41,7,21,36.92574786324789,0.6158536585365854,44.642857142857146,1021.4285714285716,24.91289198606272,0
3322,4,0,0,47,0.0,0.0,1.0,47,1250,900,350,0.72,16,9,7,306.6758460662704,0.43272047486894855,0.2543662759181462,0.17508402848147078,130340.40584308289,-1405.5491522902976,128934.85669079259,1603,4,346.72340425531917,40,7,21,36.88648653131634,0.6166666666666667,44.71544715447155,1021.1382113821144,25.52845528455286,0
3323,4,0,0,47,0.0,0.0,1.0,47,850,400,450,0.47058823529411764,13,4,9,307.16922848444364,0.43273974714770275,0.2507801418439717,0.17560015621550948,130392.29811124328,-1389.4996777711674,129002.79843347211,1604,5,347.72340425531917,40,7,21,36.82151741293533,0.6171875,44.66463414634146,1021.3414634146338,25.533536585365844,0
3324,4,0,0,47,0.0,0.0,1.0,47,1400,1100,300,0.7857142857142857,17,11,6,308.4217311994375,0.43221939562133826,0.24693970396859877,0.1769070454769164,130522.07396597593,-1348.8311975345339,129173.2427684414,1605,6,348.72340425531917,40,7,15,36.658586109729825,0.6184895833333333,44.53760162601626,1021.8495934959349,25.54623983739837,0
3325,4,0,0,47,0.0,0.0,1.0,47,900,600,300,0.6666666666666666,12,6,6,310.46812559534857,0.43162195497995687,0.24529642964423326,0.17843933755645813,130599.97046235713,-1290.5743935488124,129309.39606880832,1606,7,349.72340425531917,40,7,15,36.52772254258632,0.6192708333333333,44.46138211382114,1022.154471544716,25.5538617886179,0
3326,4,0,0,47,0.0,0.0,1.0,47,1100,600,500,0.5454545454545454,16,6,10,309.28490867385005,0.43125578168362627,0.23525841764221433,0.1781889074176281,130693.35322381253,-1315.7036367787957,129377.64958703374,1607,8,350.72340425531917,41,6,16,36.46379078943116,0.6186483739837398,44.37003968253968,1022.5198412698401,24.939508323654636,0
3327,4,0,1,46,0.0,0.02127659574468085,0.9787234042553191,47,1350,700,650,0.5185185185185185,20,7,13,307.98777174476663,0.4309859697810669,0.2300992330025573,0.17790823050197668,130794.81336805545,-1343.3593750000095,129451.45399305543,1608,9,351.72340425531917,41,6,17,36.39468771215206,0.6196646341463414,44.27083333333333,1022.9166666666657,24.949186991869894,0
3328,4,0,0,46,0.0,0.0,1.0,46,1650,1200,450,0.7272727272727273,21,12,9,304.417225578043,0.43171296296296297,0.21895463394490022,0.17665787027639188,130972.46334876539,-1225.9452160493843,129746.51813271601,1609,10,356.3478260869565,41,5,19,36.30710085933967,0.6214430894308943,44.09722222222222,1023.6111111111109,24.966124661246607,0
3329,4,0,2,44,0.0,0.043478260869565216,0.9565217391304348,46,1350,900,450,0.6666666666666666,18,9,9,299.50269971551523,0.4312902576489533,0.13722050954962595,0.17253042842767005,130688.28125000001,-1371.701388888888,129316.57986111112,1610,11,357.3478260869565,44,2,12,36.718962238522145,0.6143465909090908,44.375,1022.5000000000001,23.238636363636367,8
3330,4,0,2,42,0.0,0.045454545454545456,0.9545454545454546,44,1000,600,400,0.6,14,6,8,312.07212951710085,0.4286249119097956,0.15491950218912698,0.17928849793825577,130584.26852352606,-649.6578480860703,129934.61067543998,1611,12,372.79545454545456,42,2,13,36.502575527746174,0.6160714285714286,44.4767441860465,1022.0930232558126,24.33554817275744,0
3331,4,0,1,41,0.0,0.023809523809523808,0.9761904761904762,42,750,500,250,0.6666666666666666,10,5,5,326.07018325896223,0.42246176926054974,0.15998512052845815,0.1862807999755151,130366.35068618214,101.71597180910413,130468.06665799124,1612,13,390.6904761904762,40,2,16,36.3651441271105,0.6169270833333333,44.6900406504065,1021.2398373983738,25.530995934959343,0
3332,4,0,1,40,0.0,0.024390243902439025,0.975609756097561,41,1050,600,450,0.5714285714285714,15,6,9,330.56350094339626,0.4195376016260162,0.16456799384356957,0.18859576910722897,130314.4635819453,415.4410610417117,130729.904642987,1613,14,400.8292682926829,40,1,16,36.3029179522909,0.61640625,44.74085365853659,1021.0365853658539,25.525914634146346,0
3333,4,0,0,40,0.0,0.0,1.0,40,1150,800,350,0.6956521739130435,15,8,7,329.0665469520773,0.41846955128205127,0.15147029555179614,0.187992594105823,130366.35068618225,579.8409718091201,130946.19165799137,1614,15,405.975,40,0,16,36.288643977841915,0.6169270833333333,44.69004065040651,1021.2398373983747,25.530995934959368,0
3334,4,0,0,40,0.0,0.0,1.0,40,1250,1200,50,0.96,13,12,1,328.3435155353056,0.4189903846153846,0.14415655460513221,0.18820785092314501,130496.11363110584,569.5105426664022,131065.62417377224,1615,16,406.975,40,0,13,36.17590013924807,0.6182291666666666,44.5630081300813,1021.7479674796749,25.543699186991873,0
3335,4,0,1,39,0.0,0.025,0.975,40,1000,700,300,0.7,13,7,6,329.41114927732133,0.4186431623931624,0.14348777092861376,0.18932670511035984,130599.9704623571,604.2172731178532,131204.18773547496,1616,17,407.975,40,0,13,36.04365513355869,0.6192708333333333,44.46138211382114,1022.1544715447158,25.553861788617894,0
3336,4,0,0,39,0.0,0.0,1.0,39,1500,1000,500,0.6666666666666666,20,10,10,332.792712822661,0.41489541160593796,0.14851950493498323,0.19223673175991385,130794.81336805575,905.5121527777976,131700.32552083355,1617,18,418.8205128205128,39,0,15,35.76035302104548,0.6228632478632479,44.27083333333334,1022.9166666666682,26.22863247863252,0
3337,4,1,0,40,0.025,0.0,1.0,40,1400,1000,400,0.7142857142857143,18,10,8,321.4829076210128,0.418482905982906,0.14544056360389046,0.18727773080951246,131119.87428944407,430.559686694428,131550.4339761385,1618,0,409.325,40,0,16,35.721786730171345,0.6244791666666667,43.953252032520325,1024.1869918699183,25.604674796747958,0
3338,4,0,0,40,0.0,0.0,1.0,40,1300,1000,300,0.7692307692307693,16,10,6,323.0013857417606,0.41746794871794873,0.14515073383578003,0.18892958084802275,131276.04683059014,480.46900819617224,131756.51583878632,1619,1,410.325,40,0,17,35.52554376570144,0.6260416666666666,43.80081300813008,1024.796747967479,25.619918699186975,0
3339,4,0,0,40,0.0,0.0,1.0,40,1000,600,400,0.6,14,6,8,323.0013857417606,0.41746794871794873,0.14515073383578003,0.18892958084802275,131276.04683059014,480.46900819617224,131756.51583878632,1620,2,411.325,40,0,17,35.52554376570144,0.6260416666666666,43.80081300813008,1024.796747967479,25.619918699186975,0
3340,4,0,0,40,0.0,0.0,1.0,40,1050,900,150,0.8571428571428571,12,9,3,323.3032740300199,0.41669337606837603,0.14235419630156487,0.1896275818238054,131381.51584201382,495.2251715971763,131876.741013611,1621,3,412.325,39,1,17,35.411586398428504,0.6287393162393162,43.697916666666664,1025.2083333333328,26.287393162393148,0
3341,4,0,0,40,0.0,0.0,1.0,40,1150,700,450,0.6086956521739131,16,7,9,322.70224740138843,0.41662660256410255,0.13929877119935052,0.18993718052369812,131515.0404188367,488.03982204860176,132003.0802408853,1622,4,413.325,39,1,17,35.29258065062116,0.6300747863247863,43.56770833333333,1025.7291666666658,26.300747863247842,0
3342,4,0,1,39,0.0,0.025,0.975,40,1200,900,300,0.75,15,9,6,325.27506506222795,0.4165064102564102,0.14510152284264,0.19185385574029606,131595.1877170138,560.9266493055463,132156.11436631932,1623,5,414.325,39,1,14,35.14593908629441,0.6308760683760684,43.48958333333333,1026.0416666666658,26.308760683760664,0
3343,4,0,0,39,0.0,0.0,1.0,39,1250,900,350,0.72,16,9,7,333.09912098192865,0.4140800719748088,0.1418344304040744,0.19678660246939758,131656.85609796178,970.9566074950613,132627.81270545683,1624,6,411.46153846153845,38,1,14,34.883145950447634,0.6332236842105263,43.429487179487175,1026.2820512820506,27.007422402159225,0
3344,4,0,0,39,0.0,0.0,1.0,39,1000,800,200,0.8,12,8,4,334.3776308680331,0.41438933873144396,0.14102163836787707,0.19796886352501075,131739.1030777447,1010.1218359631598,132749.22491370785,1625,7,412.46153846153845,38,1,14,34.767535643667394,0.634046052631579,43.349358974358964,1026.6025641025624,27.01585695006743,0
3345,4,0,1,38,0.0,0.02564102564102564,0.9743589743589743,39,1500,1300,200,0.8666666666666667,17,13,4,335.050781126409,0.4128992352676563,0.13835753430137188,0.19922778358258614,131903.6740836619,1038.8858070348263,132942.55989069672,1626,8,413.46153846153845,38,1,14,34.584633385335415,0.6356907894736843,43.189102564102555,1027.2435897435885,27.03272604588391,0
3346,4,0,1,37,0.0,0.02631578947368421,0.9736842105263158,38,1500,1300,200,0.8666666666666667,17,13,4,342.28574699852186,0.4125770507349455,0.13632073351611318,0.20346020798744616,131890.67790089254,1428.8598414896865,133319.53774238224,1627,9,421.3421052631579,37,1,14,34.41191645317392,0.6373873873873874,43.20175438596491,1027.19298245614,27.761972498814597,0
3347,4,0,1,36,0.0,0.02702702702702703,0.972972972972973,37,950,800,150,0.8421052631578947,11,8,3,347.8947849338256,0.4132882882882883,0.12721669037458483,0.20656252855445917,131848.06428049685,1773.8507933609405,133621.9150738578,1628,10,427.3783783783784,36,1,14,34.310809576023395,0.6388888888888888,43.24324324324325,1027.027027027028,28.528528528528554,0
3348,4,0,0,36,0.0,0.0,1.0,36,1000,700,300,0.7,13,7,6,357.95767245532033,0.40816798941798943,0.13237504697482172,0.21195491019216925,131743.67310742475,2231.73171724968,133975.40482467442,1629,30,439.97222222222223,35,1,14,34.15774145058249,0.6398809523809523,43.34490740740742,1026.6203703703718,29.33201058201062,0
3349,4,0,0,36,0.0,0.0,1.0,36,900,600,300,0.6666666666666666,12,6,6,361.22930777872807,0.4082175925925926,0.13410533829219706,0.21439382260338866,131832.80452942848,2324.3745445387863,134157.17907396727,1630,31,440.97222222222223,35,1,14,33.98383203726661,0.6407738095238096,43.25810185185187,1026.967592592595,29.34193121693129,0
3350,4,0,0,36,0.0,0.0,1.0,36,1400,1000,400,0.7142857142857143,18,10,8,361.3962180668753,0.40828373015873015,0.13250535090683768,0.21516527349293485,131951.69331114998,2337.3685860339856,134289.06189718397,1631,32,441.97222222222223,35,1,15,33.859623183507956,0.6419642857142858,43.14236111111113,1027.430555555558,29.3551587301588,0
3351,4,0,0,36,0.0,0.0,1.0,36,950,600,350,0.631578947368421,13,6,7,360.5431911711415,0.4083829365079365,0.12560508837104578,0.21567038162782853,132130.12695312526,2327.723524305585,134457.85047743085,1632,33,442.97222222222223,35,1,16,33.701663289429256,0.64375,42.968750000000014,1028.125000000002,29.375000000000057,0
3352,4,0,1,35,0.0,0.027777777777777776,0.9722222222222222,36,1400,1100,300,0.7857142857142857,17,11,6,364.2734669617348,0.4071924603174603,0.12266044034357293,0.21858867662990825,132249.14969403745,2434.971252357712,134684.12094639515,1633,34,443.97222222222223,35,1,17,33.485826675668584,0.6449404761904762,42.853009259259274,1028.5879629629649,29.388227513227566,0
3353,4,0,0,35,0.0,0.0,1.0,35,1250,1000,250,0.8,15,10,5,385.96850724780364,0.40668767507002807,0.09498951293404811,0.22112027564757367,130475.34722222228,3071.8750000000045,133547.22222222228,1634,35,454.8285714285714,34,1,19,34.725054377379,0.6292892156862745,44.583333333333336,1021.6666666666671,30.04901960784315,8
3354,4,0,0,35,0.0,0.0,1.0,35,850,400,450,0.47058823529411764,13,4,9,385.63233228729587,0.4064425770308124,0.08951537744641214,0.22127459494345908,130536.16780045354,3067.793367346943,133603.96116780047,1635,36,455.8285714285714,34,1,14,34.67182160608887,0.6299019607843137,44.523809523809526,1021.904761904762,30.05602240896359,0
3355,4,2,1,36,0.05405405405405406,0.02702702702702703,0.972972972972973,37,850,700,150,0.8235294117647058,10,7,3,372.011574494182,0.4107232232232232,0.09939124570321667,0.21707436133249355,131183.87972009167,2360.384328585338,133544.26404867703,1636,0,432.13513513513516,36,1,17,34.363205818768094,0.6322337962962963,43.890765765765764,1024.4369369369367,28.456581581581574,0
3356,4,0,0,36,0.0,0.0,1.0,36,750,400,350,0.5333333333333333,11,4,7,371.6613830771885,0.4083829365079365,0.11896292113683415,0.2175189390051886,131298.46810967507,2559.7140507115864,133858.18216038667,1637,1,444.1111111111111,35,1,18,34.25618765292678,0.6354166666666667,43.77893518518518,1024.8842592592591,29.282407407407405,0
3357,4,0,0,36,0.0,0.0,1.0,36,800,500,300,0.625,11,5,6,373.7079260794776,0.40839947089947093,0.12002333107548768,0.21922548405377573,131387.4488275892,2620.1062028463725,134007.55503043556,1638,2,445.1111111111111,35,1,18,34.113701362233776,0.6363095238095238,43.69212962962963,1025.2314814814818,29.29232804232805,0
3358,4,0,0,36,0.0,0.0,1.0,36,600,300,300,0.5,9,3,6,374.4807033868108,0.40780423280423284,0.12165594310870276,0.21984920817122336,131417.1157648535,2642.6347897376654,134059.75055459116,1639,3,446.1111111111111,35,1,18,34.063875719607175,0.6366071428571429,43.66319444444445,1025.347222222223,29.295634920634946,0
3359,4,0,0,36,0.0,0.0,1.0,36,1150,900,250,0.782608695652174,14,9,5,369.3473163441469,0.40740740740740744,0.11655386350817842,0.2178485668257394,131595.18771701393,2520.86588541667,134116.0536024306,1640,4,447.1111111111111,35,1,13,34.0154399323181,0.6383928571428572,43.489583333333336,1026.041666666667,29.3154761904762,0
3360,4,0,0,36,0.0,0.0,1.0,36,1100,800,300,0.7272727272727273,14,8,6,367.78368412604,0.40671296296296294,0.11395248298936145,0.2172643522415453,131654.57182623883,2484.0806916580896,134138.6525178969,1641,5,448.1111111111111,35,1,13,33.995549979324096,0.6389880952380953,43.43171296296296,1026.2731481481478,29.32208994708994,0
3361,4,0,0,36,0.0,0.0,1.0,36,1250,1000,250,0.8,15,10,5,367.1737346946576,0.4060681216931217,0.11872557859933885,0.21775169613709902,131803.09070644717,2478.926611796983,134282.01731824415,1642,6,449.1111111111111,35,1,13,33.8612113014728,0.6404761904761904,43.28703703703704,1026.8518518518517,29.338624338624335,0
3362,4,0,0,36,0.0,0.0,1.0,36,800,500,300,0.625,11,5,6,371.26409699028534,0.40608465608465605,0.1250704066689199,0.22104033460648995,131951.69331114984,2597.7852527006376,134549.47856385048,1643,7,450.1111111111111,35,1,13,33.6061591753971,0.6419642857142858,43.14236111111112,1027.4305555555568,29.355158730158767,0
3363,4,0,1,35,0.0,0.027777777777777776,0.9722222222222222,36,500,200,300,0.4,8,2,6,370.13588643382167,0.40578703703703706,0.1229211247512858,0.22071434087615233,132011.1577958893,2572.4133819873387,134583.57117787664,1644,8,451.1111111111111,35,1,13,33.57512576491347,0.6425595238095239,43.084490740740755,1027.662037037039,29.361772486772544,0
3364,4,0,1,34,0.0,0.02857142857142857,0.9714285714285714,35,750,500,250,0.6666666666666666,10,5,5,380.25284059588705,0.40308123249299715,0.13215899872522874,0.22613382229510076,131908.37762188225,3031.707057823144,134940.08467970538,1645,9,464.77142857142854,34,1,13,33.41904237648241,0.6436887254901961,43.18452380952382,1027.261904761906,30.213585434173705,0
3365,4,0,0,34,0.0,0.0,1.0,34,1000,700,300,0.7,13,7,6,389.1912947257317,0.40086527035056446,0.13746558795437935,0.23021654552420426,131705.233564014,3451.706074586712,135156.9396386007,1646,10,477.94117647058823,33,1,13,33.395017510347024,0.6439393939393939,43.38235294117648,1026.4705882352953,31.105169340463494,0
3366,4,0,0,34,0.0,0.0,1.0,34,1150,700,450,0.6086956521739131,16,7,9,387.93242723656226,0.4008467023172906,0.13710277617850664,0.22985133489306375,131768.13755526734,3423.4266868512236,135191.56424211856,1647,11,478.94117647058823,33,1,13,33.36367072491445,0.6445707070707071,43.321078431372555,1026.7156862745107,31.112596553773052,0
3367,4,0,0,34,0.0,0.0,1.0,34,1350,1000,350,0.7407407407407407,17,10,7,387.3323498068682,0.3994912358882947,0.13464169209723242,0.2308302596397008,131988.4197934689,3424.676957179936,135413.09675064884,1648,12,479.94117647058823,33,1,14,33.15630590339893,0.646780303030303,43.106617647058826,1027.573529411765,31.13859180035652,0
3368,4,0,0,34,0.0,0.0,1.0,34,950,700,250,0.7368421052631579,12,7,5,387.838715971072,0.39915701128936426,0.13165015738150831,0.2322879847047297,132177.37956855525,3452.701034457884,135630.08060301314,1649,13,480.94117647058823,33,1,16,32.95234477416279,0.6486742424242424,42.92279411764705,1028.3088235294108,31.160873440285176,0
3369,4,0,0,34,0.0,0.0,1.0,34,1400,1200,200,0.8571428571428571,16,12,4,392.5650313888118,0.3988413547237077,0.12753036437247012,0.2364964945196011,132398.00347222213,3594.965277777769,135992.9687499999,1650,14,481.94117647058823,33,1,17,32.607962213225385,0.6508838383838385,42.70833333333333,1029.1666666666658,31.18686868686866,0
3370,4,0,0,34,0.0,0.0,1.0,34,1050,800,250,0.7619047619047619,13,8,5,392.1437300622339,0.398544266191325,0.1365138603947711,0.23683677039919673,132492.61289227704,3591.2294850538265,136083.84237733088,1651,15,482.94117647058823,33,1,17,32.52328591834305,0.6518308080808081,42.61642156862745,1029.5343137254904,31.198009506833042,0
3371,4,0,1,33,0.0,0.029411764705882353,0.9705882352941176,34,600,300,300,0.5,9,3,6,392.9431396531335,0.3980429292929293,0.1369235938068709,0.23791744565165196,132587.25610342162,3619.8505382545,136207.10664167613,1652,16,483.94117647058823,33,1,18,32.407187053783915,0.6527777777777778,42.52450980392156,1029.9019607843125,31.209150326797346,0
3372,4,0,0,33,0.0,0.0,1.0,33,1250,900,350,0.72,16,9,7,399.6896507366943,0.3963068181818182,0.1375282802278024,0.2420392339316417,132592.99314164364,3999.209423783282,136592.20256542694,1653,17,496.1818181818182,32,1,20,32.2276878754444,0.6552734375,42.51893939393939,1029.9242424242418,32.18513257575756,0
3373,4,0,0,33,0.0,0.0,1.0,33,1300,1000,300,0.7692307692307693,16,10,6,400.4892949826991,0.39595170454545453,0.1378342245989308,0.24315421481092434,132690.5417814507,4028.2283057851064,136718.7700872358,1654,18,497.1818181818182,32,1,15,32.10860906862744,0.65625,42.424242424242415,1030.3030303030291,32.19696969696966,0
3374,4,0,0,33,0.0,0.0,1.0,33,1100,700,400,0.6363636363636364,15,7,8,394.4732197114639,0.39516256313131315,0.12711928508909343,0.24066013034318667,132871.3884833957,3882.840884515558,136754.22936791126,1655,19,498.1818181818182,33,0,15,32.08117892943461,0.6556186868686869,42.248774509803916,1031.0049019607836,31.242572786690413,0
3375,4,0,0,33,0.0,0.0,1.0,33,800,400,400,0.5,12,4,8,393.9764670572647,0.39532039141414144,0.12367554796839353,0.2405600866342398,132902.97752066504,3872.129108996526,136775.10662966158,1656,20,499.1818181818182,33,0,15,32.06213849932652,0.6559343434343434,42.218137254901954,1031.1274509803914,31.246286393345194,0
3376,4,0,0,33,0.0,0.0,1.0,33,750,300,450,0.4,12,3,9,393.0809591506432,0.39445233585858586,0.1150629498021678,0.24062272241243354,132997.7671598663,3855.7779760188205,136853.5451358851,1657,21,500.1818181818182,33,0,16,31.989698427785033,0.6568813131313131,42.12622549019607,1031.4950980392148,31.25742721330954,0
3377,4,0,0,33,0.0,0.0,1.0,33,900,700,200,0.7777777777777778,11,7,4,392.27099413040486,0.3941366792929293,0.027445077121103,0.22422403738565114,130387.71896626298,3629.4640282583678,134017.18299452134,1658,22,501.1818181818182,33,0,20,34.65322774178066,0.6306818181818181,44.669117647058826,1021.3235294117649,30.94919786096257,8
3378,4,1,0,34,0.029411764705882353,0.0,1.0,34,800,400,400,0.5,12,4,8,371.4838601501629,0.40051247771836,-0.07240879939314515,0.20443595658586397,128898.98667800475,2776.7786281179397,131675.7653061227,1659,0,487.4117647058824,34,0,16,36.70012700273546,0.6133578431372548,46.130952380952394,1015.4761904761922,29.866946778711537,8
3379,4,2,0,36,0.05555555555555555,0.0,1.0,36,850,700,150,0.8235294117647058,10,7,3,354.8490699632821,0.4071924603174603,-0.08550582819442876,0.19663735755423872,129172.76810171665,1967.3673250953748,131140.13542681202,1660,0,461.27777777777777,36,0,17,36.84340497027437,0.6119791666666667,45.86148648648649,1016.5540540540545,28.237612612612626,8
3380,4,0,0,36,0.0,0.0,1.0,36,700,500,200,0.7142857142857143,9,5,4,355.07927976350425,0.40720899470899474,-0.08765938069216728,0.19690760059612528,129201.38888888904,1975.3472222222404,131176.73611111127,1661,1,462.27777777777777,36,0,17,36.80840163934427,0.6122685185185186,45.83333333333334,1016.6666666666679,28.240740740740776,0
3381,4,1,0,37,0.02702702702702703,0.0,1.0,37,950,500,450,0.5263157894736842,14,5,9,382.3009185141577,0.4112862862862863,-0.04138367136634036,0.2061566635352047,128089.02739304399,2393.7105647891613,130482.73795783315,1662,0,450.7567567567568,37,0,15,37.25492850953206,0.5990990990990991,46.92982456140351,1012.2807017543857,27.35893788525367,8
3382,4,5,2,40,0.11904761904761904,0.047619047619047616,0.9523809523809523,42,1450,1000,450,0.6896551724137931,19,10,9,345.1535069564113,0.4247362562911343,-0.00743087360930228,0.19178905454840342,129280.82817925364,529.1794635729457,129810.00764282659,1663,0,397.9761904761905,39,3,15,36.979860186418115,0.6076388888888888,45.75520833333334,1016.9791666666681,26.076388888888925,0
3383,4,0,1,39,0.0,0.025,0.975,40,1450,1100,350,0.7586206896551724,18,11,7,362.3322863806267,0.41972489316239314,-0.006686821069890936,0.2006605250001222,129148.44292534713,1358.9301215277726,130507.3730468749,1664,1,418.875,39,1,16,36.67802486848399,0.6063034188034189,45.885416666666664,1016.4583333333326,26.06303418803417,0
3384,4,0,0,39,0.0,0.0,1.0,39,950,600,350,0.631578947368421,13,6,7,370.5237381361788,0.4165823211875843,-0.004484147836748997,0.20533100572893054,129174.23575726843,1772.4241407334164,130946.65989800185,1665,2,430.5128205128205,38,1,17,36.44355403748466,0.6082785087719298,45.860042735042725,1016.5598290598276,26.751574448942833,0
3385,4,0,1,38,0.0,0.02564102564102564,0.9743589743589743,39,950,700,250,0.7368421052631579,12,7,5,369.7418984699025,0.4163011695906433,0.00026694610812483255,0.20518743707957895,129230.01284646132,1756.3557649652153,130986.36861142654,1666,3,431.5128205128205,36,3,17,36.406532654040674,0.6125578703703703,45.80518018018018,1016.7792792792792,28.243868868868866,0
3386,4,1,1,38,0.02564102564102564,0.02564102564102564,0.9743589743589743,39,1400,700,700,0.5,21,7,14,367.0646136857469,0.4155982905982906,0.02084420695083078,0.20543670512791798,129563.94184989603,1711.667652546926,131275.60950244297,1667,0,430.05128205128204,37,2,13,36.13433405133728,0.6140202702702703,45.47697368421052,1018.0921052631571,27.516002844950194,0
3387,4,0,0,38,0.0,0.0,1.0,38,1100,600,500,0.5454545454545454,16,6,10,370.61448771741607,0.4133920104314841,0.022002107358874312,0.2074752683252729,129573.74762854067,2004.3816197954693,131578.12924833613,1668,5,442.36842105263156,36,2,13,36.03399328982783,0.6160300925925926,45.46734234234234,1018.1306306306303,28.281406406406397,0
3388,4,1,0,39,0.02564102564102564,0.0,1.0,39,1500,1100,400,0.7333333333333333,19,11,8,358.41443433637767,0.41691970310391363,0.02772874196954689,0.20250733847673485,129935.60209155164,1514.1590647600299,131449.76115631167,1669,0,432.0,38,1,14,35.976632086346015,0.615953947368421,45.11217948717949,1019.5512820512823,26.830296896086377,0
3389,4,0,2,37,0.0,0.05128205128205128,0.9487179487179487,39,1050,500,550,0.47619047619047616,16,5,11,360.42497856360205,0.41691970310391363,0.024623119626786316,0.20421230091078366,130044.5513391225,1574.2609257432841,131618.8122648658,1670,1,433.0,38,1,14,35.814697461680815,0.6170504385964912,45.005341880341874,1019.9786324786312,26.841542959963977,0
3390,4,0,0,37,0.0,0.0,1.0,37,1050,700,350,0.6666666666666666,14,7,7,373.14611886084043,0.41028528528528524,0.025575630879498323,0.2102722525336617,129831.84831791249,2289.250060871679,132121.09837878417,1671,2,456.94594594594594,36,1,16,35.70672191528544,0.6186342592592593,45.21396396396396,1019.1441441441441,28.30955955955956,0
3391,4,1,0,38,0.02631578947368421,0.0,1.0,38,1200,1000,200,0.8333333333333334,14,10,4,363.73789817407715,0.4138661688003793,0.03301558763166379,0.20709700881360754,130234.60493853867,1874.252293975061,132108.85723251372,1672,0,445.89473684210526,37,1,17,35.53718175958751,0.620777027027027,44.81907894736842,1020.7236842105254,27.58712660028447,0
3392,4,0,0,38,0.0,0.0,1.0,38,1050,400,650,0.38095238095238093,17,4,13,364.2943709893286,0.41333274063537223,0.02358846399350134,0.20833227899578868,130406.32482144302,1901.2610205040594,132307.5858419471,1673,1,446.89473684210526,36,2,17,35.34867695700111,0.6244212962962963,44.6509009009009,1021.396396396396,28.37212212212211,0
3393,4,0,0,38,0.0,0.0,1.0,38,1050,600,450,0.5714285714285714,15,6,9,367.4484947733852,0.4125622332859175,0.025040012989724136,0.21107357839007873,130578.91506371234,1996.2051578605615,132575.1202215729,1674,2,447.89473684210526,36,2,14,35.09301087116204,0.6261574074074074,44.48198198198198,1022.0720720720719,28.390890890890887,0
3394,4,1,0,39,0.02564102564102564,0.0,1.0,39,1350,1100,250,0.8148148148148148,16,11,5,363.90299515794123,0.4146142600089968,0.024803083626612876,0.2108197798764161,130906.99932912037,1727.4898286010912,132634.48915772146,1675,0,437.38461538461536,37,2,16,34.851133076181284,0.6275337837837838,44.16118421052631,1023.3552631578937,27.658250355618748,0
3395,4,0,0,39,0.0,0.0,1.0,39,1050,1000,50,0.9523809523809523,11,10,1,362.40104736876543,0.4140519568151147,0.017039087733175418,0.21040896630813358,130991.17036011055,1694.267466912871,132685.43782702342,1676,1,438.38461538461536,37,2,16,34.80434161668095,0.6283783783783784,44.07894736842104,1023.6842105263138,27.667140825035506,0
3396,4,0,1,38,0.0,0.02564102564102564,0.9743589743589743,39,950,500,450,0.5263157894736842,14,5,9,362.15214889334203,0.41391138101664415,0.013023664415527492,0.21087911911869148,131103.4404816865,1695.8785395506136,132799.3190212371,1677,2,439.38461538461536,37,2,16,34.69709136331192,0.6295045045045045,43.96929824561403,1024.1228070175425,27.678994784257906,0
3397,4,0,0,38,0.0,0.0,1.0,38,1050,1000,50,0.9523809523809523,11,10,1,369.34129277122054,0.4094505689900427,0.010767128997152042,0.21470914538848687,131039.71370018659,2079.6754524794983,133119.3891526661,1678,3,451.7368421052632,36,2,16,34.577559026250185,0.630787037037037,44.03153153153153,1023.8738738738732,28.440940940940923,0
3398,4,0,0,38,0.0,0.0,1.0,38,950,600,350,0.631578947368421,13,6,7,370.62274093322776,0.4091097676623992,0.014079656415866282,0.21561564832411,131068.54056336742,2115.3963507426365,133183.93691411006,1679,4,452.7368421052632,36,2,16,34.51556142087319,0.6310763888888888,44.00337837837838,1023.9864864864866,28.444069069069073,0
3399,4,0,1,37,0.0,0.02631578947368421,0.9736842105263158,38,1150,1000,150,0.8695652173913043,13,10,3,370.9296021470807,0.4090356804172594,0.02142749707859437,0.2166057458494312,131212.72243527306,2134.1365859102257,133346.85902118328,1680,5,453.7368421052632,36,2,17,34.36171869275298,0.6325231481481481,43.86261261261261,1024.549549549549,28.459709709709696,0
3400,4,0,0,37,0.0,0.0,1.0,37,850,600,250,0.7058823529411765,11,6,5,373.3177809947157,0.40853353353353355,0.009704201998857576,0.21781382198973134,131179.87403817286,2394.355897419392,133574.22993559224,1681,6,434.1081081081081,35,2,17,34.33380879749935,0.6342261904761906,43.89467592592592,1024.4212962962952,29.26917989417986,0
3401,4,1,0,38,0.02631578947368421,0.0,1.0,38,1050,700,350,0.6666666666666666,14,7,7,365.33791254987284,0.4112434803224277,0.007853154330521583,0.21464813694906312,131446.7860510974,2004.5826099537044,133451.36866105112,1682,0,423.6578947368421,35,3,18,34.268246802106844,0.6369047619047619,43.63425925925926,1025.462962962963,29.2989417989418,0
3402,4,0,0,38,0.0,0.0,1.0,38,750,600,150,0.8,9,6,3,369.8847331530733,0.41105085348506404,0.005935378896298804,0.21782647109207218,131535.81700370798,2130.618114497597,133666.43511820558,1683,1,424.6578947368421,35,3,18,34.06166553838054,0.6377976190476191,43.5474537037037,1025.810185185185,29.30886243386243,0
3403,4,0,0,38,0.0,0.0,1.0,38,700,300,400,0.42857142857142855,11,3,8,372.31569996650273,0.4105470602181129,0.012636922254875449,0.2195993799203622,131595.18771701382,2198.990885416658,133794.17860243047,1684,2,425.6578947368421,35,3,14,33.93929780033841,0.6383928571428572,43.48958333333333,1026.041666666666,29.315476190476172,0
3404,4,0,1,37,0.0,0.02631578947368421,0.9736842105263158,38,950,500,450,0.5263157894736842,14,5,9,373.4154152651152,0.4097913703176861,0.021187949576240817,0.22076319350473625,131684.26890432098,2234.587191358026,133918.85609567902,1685,3,426.6578947368421,35,3,14,33.821041948579165,0.6392857142857142,43.40277777777778,1026.388888888889,29.325396825396826,0
3405,4,0,0,37,0.0,0.0,1.0,37,1150,600,550,0.5217391304347826,17,6,11,386.5181604319533,0.4059684684684685,0.024644133692857784,0.22820455773448167,131633.36167800435,2775.7369614512263,134409.09863945557,1686,11,439.1081081081081,34,3,14,33.53634957463263,0.6409313725490196,43.45238095238094,1026.1904761904748,30.182072829131613,0
3406,4,0,0,37,0.0,0.0,1.0,37,1050,800,250,0.7619047619047619,13,8,5,390.33513968969527,0.40618743743743746,0.021056194777637538,0.23101303428580938,131725.00177154198,2883.379393424041,134608.38116496603,1687,12,440.1081081081081,34,3,14,33.345655031118326,0.6418504901960784,43.36309523809524,1026.5476190476193,30.19257703081233,0
3407,4,0,0,37,0.0,0.0,1.0,37,1100,900,200,0.8181818181818182,13,9,4,390.2692275257208,0.40621871871871873,0.022420147420147307,0.23115946553446556,131755.55555555562,2884.0277777777837,134639.5833333334,1688,13,441.1081081081081,34,3,15,33.31642316017316,0.642156862745098,43.333333333333336,1026.6666666666672,30.196078431372566,0
3408,4,1,0,38,0.02631578947368421,0.0,1.0,38,1100,800,300,0.7272727272727273,14,8,6,386.88905856075695,0.4101469890943575,0.03918194473239933,0.23179428761377774,132189.63162562152,2628.5444262259884,134818.17605184752,1689,0,430.4736842105263,35,3,17,32.964382854999045,0.6443452380952381,42.910879629629626,1028.356481481481,29.381613756613746,0
3409,4,0,1,37,0.0,0.02631578947368421,0.9736842105263158,38,800,400,400,0.5,12,4,8,386.3940808057882,0.4095987434803224,0.03712323716471566,0.23224317909484757,132311.09487866246,2624.8447772096474,134935.93965587212,1690,1,431.4736842105263,36,2,17,32.85445855224752,0.6435185185185186,42.792792792792795,1028.828828828829,28.578578578578586,0
3410,4,0,0,37,0.0,0.0,1.0,37,750,300,450,0.4,12,3,9,396.21994708525995,0.4074386886886887,0.041447120240456714,0.2371979791041407,132159.87761488333,3072.875943072692,135232.75355795602,1691,2,443.72972972972974,35,2,17,32.7545775176347,0.644047619047619,42.93981481481481,1028.24074074074,29.378306878306855,0
3411,4,1,0,38,0.02631578947368421,0.0,1.0,38,1150,700,450,0.6086956521739131,16,7,9,386.1548343409971,0.4095098387861546,0.036958942621903246,0.2333929533344015,132520.55165816328,2635.1190038772734,135155.67066204056,1692,0,433.0263157894737,34,4,18,32.64924654102594,0.6498161764705883,42.589285714285715,1029.6428571428573,30.28361344537816,0
3412,4,0,0,38,0.0,0.0,1.0,38,1050,600,450,0.5714285714285714,15,6,9,382.849286027843,0.4088430535798957,0.03625339058299759,0.23234065366654655,132673.81660997734,2558.815192743762,135232.6318027211,1693,1,434.0263157894737,34,4,16,32.579828210461436,0.6513480392156863,42.44047619047619,1030.2380952380954,30.301120448179276,0
3413,4,0,1,37,0.0,0.02631578947368421,0.9736842105263158,38,1250,800,450,0.64,17,8,9,377.4225742347709,0.4084874348032243,0.034327850117323644,0.2297977951986391,132796.49234693887,2424.078798185951,135220.57114512482,1694,2,435.0263157894737,34,4,16,32.5960575960576,0.6525735294117647,42.32142857142858,1030.7142857142865,30.31512605042019,0
3414,4,0,0,37,0.0,0.0,1.0,37,700,400,300,0.5714285714285714,10,4,6,382.53012632041566,0.40625,0.02949279718638609,0.23219716765167767,132681.93310565653,2750.967326268751,135432.90043192529,1695,6,447.72972972972974,33,4,16,32.57986895840768,0.6537247474747474,42.43259803921569,1030.2696078431377,31.22029114676175,0
3415,4,0,0,37,0.0,0.0,1.0,37,750,500,250,0.6666666666666666,10,5,5,368.08104440023675,0.4058433433433433,0.08577703851420271,0.2101992915691444,130351.21588059382,2195.962336033914,132547.17821662774,1696,7,448.72972972972974,35,2,17,35.30793097585855,0.6258928571428571,44.70486111111109,1021.180555555553,29.17658730158723,8
3416,4,0,0,37,0.0,0.0,1.0,37,850,600,250,0.7058823529411765,11,6,5,367.95963261187876,0.4057494994994995,0.08634322395790295,0.21109263134049855,130528.56445312475,2205.8485243055275,132734.41297743027,1697,8,449.72972972972974,35,2,13,35.131031260618414,0.6276785714285714,44.531249999999986,1021.8749999999981,29.196428571428516,0
3417,4,0,1,36,0.0,0.02702702702702703,0.972972972972973,37,900,500,400,0.5555555555555556,13,5,8,370.3913806380054,0.40549924924924924,0.08895567518600034,0.2128123801180365,130587.70743580657,2273.7122503000483,132861.41968610662,1698,9,450.72972972972974,35,2,13,35.00889385875514,0.6282738095238095,44.47337962962962,1022.10648148148,29.203042328042287,0
3418,4,0,0,36,0.0,0.0,1.0,36,750,600,150,0.8,9,6,3,370.8172726864729,0.403207671957672,0.10093808158543371,0.21387346093065746,130735.62349965691,2495.8054698216574,133231.42896947855,1699,10,462.52777777777777,35,1,13,34.84797042402294,0.6297619047619047,44.328703703703695,1022.685185185184,29.219576719576686,0
3419,4,0,0,36,0.0,0.0,1.0,36,1000,700,300,0.7,13,7,6,372.44743467963076,0.4034060846560847,0.10234215885947062,0.21514316520905705,130794.81336805537,2542.8385416666433,133337.65190972202,1700,11,463.52777777777777,35,1,13,34.74626612355736,0.6303571428571428,44.27083333333332,1022.9166666666652,29.226190476190432,0
3420,4,0,0,36,0.0,0.0,1.0,36,1250,900,350,0.72,16,9,7,372.130957399999,0.4037037037037037,0.10338459219056251,0.21595316189275532,130972.4633487654,2547.781635802469,133520.24498456786,1701,12,464.52777777777777,35,1,14,34.574287652645864,0.6321428571428571,44.09722222222222,1023.611111111111,29.246031746031743,0
3421,4,0,0,36,0.0,0.0,1.0,36,850,500,350,0.5882352941176471,12,5,7,373.1699315629178,0.4037202380952381,0.10661806262009743,0.21705683001559042,131061.33355034706,2581.6297743055366,133642.9633246526,1702,13,465.52777777777777,35,1,14,34.45765513733469,0.6330357142857144,44.01041666666666,1023.958333333332,29.255952380952344,0
3422,4,0,0,36,0.0,0.0,1.0,36,1200,1000,200,0.8333333333333334,14,10,4,372.1367423154268,0.40401785714285715,0.10306967984934112,0.2169571916661084,131150.23389274685,2561.1641589506103,133711.39805169747,1703,14,466.52777777777777,35,1,16,34.39406779661017,0.6339285714285714,43.92361111111111,1024.305555555555,29.265873015872998,0
3423,4,0,0,36,0.0,0.0,1.0,36,1100,700,400,0.6363636363636364,15,7,8,372.4634807323683,0.4034887566137566,0.09981933152664846,0.21815718157181585,131328.12500000012,2583.1066743827314,133911.23167438284,1704,15,467.52777777777777,34,2,16,34.20562330623306,0.6378676470588236,43.75000000000001,1025.000000000001,30.147058823529438,0
3424,4,0,0,36,0.0,0.0,1.0,36,1150,900,250,0.782608695652174,14,9,5,372.33246842131325,0.40342261904761906,0.09614838892758559,0.21877707250894915,131450.1771541951,2588.633786848085,134038.81094104316,1705,16,468.52777777777777,34,2,18,34.08550034827026,0.639093137254902,43.63095238095239,1025.4761904761913,30.16106442577033,0
3425,4,0,0,36,0.0,0.0,1.0,36,800,500,300,0.625,11,5,6,371.0375719710355,0.4031415343915344,0.09590829947765545,0.2181903537563461,131480.6990504535,2556.855867346936,134037.55491780041,1706,17,469.52777777777777,34,2,18,34.08783130199266,0.6393995098039216,43.601190476190474,1025.5952380952378,30.164565826330524,0
3426,4,0,0,36,0.0,0.0,1.0,36,950,600,350,0.631578947368421,13,6,7,370.0671620452986,0.4022652116402117,0.0967677470926489,0.21814218895392484,131572.28599773237,2538.1164965986345,134110.402494331,1707,18,470.52777777777777,34,2,14,34.02012261158816,0.6403186274509804,43.51190476190476,1025.9523809523805,30.17507002801119,0
3427,4,0,0,36,0.0,0.0,1.0,36,650,500,150,0.7692307692307693,8,5,3,370.0543893446136,0.4023478835978836,0.09675329697954127,0.21830929375504618,131602.82206632654,2540.0403911564567,134142.862457483,1708,19,471.52777777777777,34,2,15,33.98958695904396,0.640625,43.482142857142854,1026.0714285714284,30.178571428571423,0
3428,4,0,0,36,0.0,0.0,1.0,36,950,600,350,0.631578947368421,13,6,7,368.9692193926398,0.4017030423280423,0.09851413696229305,0.2181929087519439,131694.45153061228,2518.239795918374,134212.69132653065,1709,20,472.52777777777777,34,2,15,33.92484342379959,0.6415441176470589,43.392857142857146,1026.4285714285718,30.189075630252113,0
3429,4,0,0,36,0.0,0.0,1.0,36,850,600,250,0.7058823529411765,11,6,5,369.1749044469076,0.40145502645502645,0.10225750785556054,0.2193692200804352,131877.806122449,2537.195294784583,134415.00141723358,1710,21,473.52777777777777,34,2,15,33.734401560809765,0.6433823529411764,43.214285714285715,1027.1428571428573,30.21008403361345,0
3430,4,0,0,36,0.0,0.0,1.0,36,850,700,150,0.8235294117647058,10,7,3,368.28869085582244,0.4015542328042328,0.09704519119351107,0.21919526910936196,131938.95266439908,2518.324829931974,134457.27749433107,1711,22,474.52777777777777,34,2,15,33.69544225569719,0.6439950980392157,43.154761904761905,1027.3809523809523,30.21708683473389,0
3431,4,0,0,36,0.0,0.0,1.0,36,650,400,250,0.6153846153846154,9,4,5,366.8447249174334,0.4015707671957672,0.09770658736595483,0.2185118578856017,131969.53125000012,2482.4652777777924,134451.9965277779,1712,23,475.52777777777777,34,2,15,33.70167612868343,0.6443014705882353,43.12500000000001,1027.500000000001,30.220588235294144,0
3432,4,0,0,36,0.0,0.0,1.0,36,1250,1000,250,0.8,15,10,5,365.68479466411475,0.40140542328042333,0.09296688310875911,0.2184025999604576,132070.63567654754,2459.2446577074825,134529.88033425502,1713,24,476.52777777777777,35,1,16,33.629494613969904,0.643154761904762,43.026620370370374,1027.893518518519,29.368386243386254,0
3433,4,0,0,36,0.0,0.0,1.0,36,700,500,200,0.7142857142857143,9,5,4,367.51716185904485,0.40160383597883603,0.0921621959607326,0.22018813102613718,132189.63162562164,2516.391648448224,134706.02327406986,1714,25,477.52777777777777,35,1,17,33.46241324329395,0.6443452380952381,42.91087962962963,1028.356481481482,29.38161375661377,0
3434,4,0,0,36,0.0,0.0,1.0,36,1000,700,300,0.7,13,7,6,367.7062864329809,0.4010251322751323,0.08260842394700663,0.22117110192078507,132338.45191400903,2532.3361411179812,134870.78805512702,1715,26,478.52777777777777,35,1,18,33.30755530558681,0.6458333333333333,42.76620370370371,1028.935185185186,29.39814814814817,0
3435,4,0,0,36,0.0,0.0,1.0,36,500,300,200,0.6,7,3,4,368.73459195711513,0.4010251322751323,0.07970972591650316,0.22250160618654374,132459.27047902485,2568.476406123138,135027.746885148,1716,27,479.52777777777777,34,2,18,33.15938090281793,0.649203431372549,42.64880952380952,1029.4047619047612,30.276610644257683,0
3436,4,0,0,36,0.0,0.0,1.0,36,1300,900,400,0.6923076923076923,17,9,8,365.20501951474495,0.3997685185185185,0.08008462061969501,0.2214519294927181,132643.15653344675,2488.389314058956,135131.5458475057,1717,28,480.52777777777777,34,2,16,33.06512192303248,0.6510416666666667,42.470238095238095,1030.1190476190477,30.29761904761905,0
3437,4,0,0,36,0.0,0.0,1.0,36,550,100,450,0.18181818181818182,10,1,9,365.7162463493071,0.39874338624338623,0.08093322038684181,0.22248809168277933,132765.81809807252,2510.923327664396,135276.74142573692,1718,29,481.52777777777777,34,2,16,32.92855492664894,0.6522671568627452,42.351190476190474,1030.5952380952378,30.311624649859937,0
3438,4,0,0,36,0.0,0.0,1.0,36,550,300,250,0.5454545454545454,8,3,5,363.5479948156958,0.3980654761904762,0.0838144726712855,0.22171307289464265,132857.85147392287,2460.0410997732365,135317.8925736961,1719,30,482.52777777777777,34,2,17,32.89188799076211,0.6531862745098039,42.26190476190476,1030.9523809523807,30.32212885154061,0
3439,4,0,0,36,0.0,0.0,1.0,36,1100,700,400,0.6363636363636364,15,7,8,369.1313438813721,0.3970899470899471,0.08759154514089307,0.22567288864109583,132949.91673752837,2615.1962868480796,135565.11302437645,1720,31,483.52777777777777,34,2,17,32.655402285582376,0.6541053921568627,42.17261904761905,1031.309523809524,30.332633053221297,0
3440,4,0,0,36,0.0,0.0,1.0,36,750,600,150,0.8,9,6,3,366.4030011529809,0.3965277777777778,0.07704236339158799,0.21052081347963392,130587.70743580667,2369.545583633396,132957.25301944008,1721,32,484.52777777777777,35,1,16,35.11080757181143,0.6282738095238095,44.473379629629626,1022.1064814814808,29.20304232804231,7
3441,4,0,0,36,0.0,0.0,1.0,36,900,500,400,0.5555555555555556,13,5,8,367.46751927526407,0.39596560846560847,0.07686768054140436,0.21145541353474948,130646.86381440745,2401.695789394705,133048.55960380216,1722,33,485.52777777777777,35,1,16,35.0236093814861,0.6288690476190476,44.41550925925925,1022.3379629629619,29.209656084656054,0
3442,4,0,2,34,0.0,0.05555555555555555,0.9444444444444444,36,1100,800,300,0.7272727272727273,14,8,6,367.8289870028047,0.39586640211640217,0.07669307677796655,0.21198754730396463,130706.03358892743,2415.4935860339447,133121.52717496137,1723,34,486.52777777777777,35,1,16,34.95437181663836,0.6294642857142857,44.357638888888886,1022.5694444444441,29.21626984126983,0
3443,4,0,0,34,0.0,0.0,1.0,34,1300,1100,200,0.8461538461538461,15,11,4,379.0319396046764,0.3911356209150327,0.08305950047244992,0.2180609958746353,130638.16350682438,3103.2073000769037,133741.37080690128,1724,35,507.38235294117646,33,1,19,34.73687365140254,0.6332070707070707,44.42401960784314,1022.3039215686281,30.97890671420085,0
3444,4,0,0,34,0.0,0.0,1.0,34,800,400,400,0.5,12,4,8,382.8405677464558,0.39080139631610217,0.08583636157165597,0.2109695894602809,128952.32602845058,3073.636341791617,132025.9623702422,1725,36,508.38235294117646,33,1,17,36.35728362290863,0.6161616161616161,46.07843137254902,1015.6862745098038,30.778371954842537,8
3445,4,0,0,34,0.0,0.0,1.0,34,800,400,400,0.5,12,4,8,380.4607466637999,0.3902814913844326,0.08595102295621593,0.21031870075574852,129076.82742214529,3021.733227604762,132098.56064975006,1726,37,509.38235294117646,33,1,18,36.29050088438656,0.6174242424242424,45.955882352941174,1016.1764705882349,30.793226381461665,0
3446,4,0,0,34,0.0,0.0,1.0,34,950,600,350,0.631578947368421,13,6,7,380.9240408228666,0.3905600118835413,0.08314363720171603,0.21107314085675866,129170.24289035462,3040.8101751730014,132211.05306552764,1727,38,510.38235294117646,33,1,18,36.18331826401447,0.6183712121212122,45.86397058823529,1016.5441176470584,30.804367201426015,0
3447,4,1,1,34,0.02857142857142857,0.02857142857142857,0.9714285714285714,35,1200,800,400,0.6666666666666666,16,8,8,375.9578775600813,0.3962535014005602,0.09056918990260132,0.21025610274795656,129534.44054705225,2739.898667800465,132274.33921485272,1728,0,496.77142857142854,34,1,15,35.938048181499234,0.6197916666666667,45.50595238095239,1017.9761904761912,29.94047619047621,0
3448,4,1,0,35,0.02857142857142857,0.0,1.0,35,750,300,450,0.4,12,3,9,376.07388640053887,0.3953081232492997,0.0894142790355974,0.21113439449101118,129685.96938775518,2754.3013038548834,132440.27069161006,1729,0,497.74285714285713,34,1,16,35.78068996415771,0.6213235294117647,45.35714285714286,1018.5714285714291,29.95798319327733,0
3449,4,0,0,35,0.0,0.0,1.0,35,1000,700,300,0.7,13,7,6,375.8246318165352,0.3961834733893557,0.08633852419341381,0.2114847484364052,129776.92920918361,2754.673327664391,132531.602536848,1730,1,498.74285714285713,34,1,17,35.69439576274486,0.6222426470588236,45.26785714285714,1018.9285714285709,29.968487394957968,0
3450,4,1,0,36,0.027777777777777776,0.0,1.0,36,1100,700,400,0.6363636363636364,15,7,8,382.05264800554164,0.40178571428571425,0.11957905321979112,0.20347392095426306,127588.4951158479,2550.0115122888155,130138.5066281367,1731,0,485.8611111111111,35,1,16,37.77506491770727,0.5979166666666667,47.42476851851852,1010.3009259259259,28.86574074074074,8
3451,4,0,0,36,0.0,0.0,1.0,36,800,500,300,0.625,11,5,6,379.67693738194413,0.4016203703703704,0.12039794347090194,0.20250209775697944,127646.96830257626,2492.9219982424497,130139.89030081872,1732,1,486.8611111111111,35,1,16,37.775001908906944,0.5985119047619047,47.366898148148145,1010.5324074074072,28.87235449735449,0
3452,4,1,0,37,0.02702702702702703,0.0,1.0,37,1150,700,450,0.6086956521739131,16,7,9,374.7845214745795,0.4048110610610611,0.1298873147098365,0.20180877738118894,128030.53634293067,2196.7726594837995,130227.30900241448,1733,0,474.6756756756757,36,1,17,37.50509995920034,0.6004050925925926,46.98761261261261,1012.0495495495488,28.112487487487467,0
3453,4,1,0,38,0.02631578947368421,0.0,1.0,38,1450,1100,350,0.7586206896551724,18,11,7,362.8390928667434,0.4078799193930773,0.12127242806789829,0.19716177162653165,128394.4473900621,1717.3049640273682,130111.75235408946,1734,0,463.1578947368421,37,1,16,37.434973313137874,0.6021959459459459,46.6282894736842,1013.4868421052612,27.391536273115168,0
3454,4,1,1,38,0.02564102564102564,0.02564102564102564,0.9743589743589743,39,850,800,50,0.9411764705882353,9,8,1,359.5581163434908,0.40997525865946916,0.1370256410256414,0.19721721162027447,128767.2812111911,1459.8642157936615,130227.14542698476,1735,0,452.2564102564103,38,1,17,37.137280701754364,0.6041666666666667,46.26068376068374,1014.957264957262,26.709401709401632,0
3455,4,0,0,38,0.0,0.0,1.0,38,1150,900,250,0.782608695652174,14,9,5,366.4173818173543,0.4112286628733997,0.1353663737951034,0.20078110531199575,128728.04763244434,1833.638835987967,130561.68646843231,1736,1,459.1578947368421,37,1,17,37.00330902215018,0.6055743243243243,46.29934210526314,1014.8026315789454,27.427098150782307,0
3456,4,0,0,38,0.0,0.0,1.0,38,1250,700,550,0.56,18,7,11,363.4988925289047,0.41149537695590327,0.12749845134377913,0.20002158310815094,128895.01006319224,1770.638682094458,130665.6487452867,1737,2,460.1578947368421,37,1,17,36.90689900298742,0.6072635135135135,46.134868421052616,1015.4605263157871,27.444879089615867,0
3457,4,1,0,39,0.02564102564102564,0.0,1.0,39,1050,900,150,0.8571428571428571,12,9,3,356.03225634898365,0.4148110661268556,0.12831296817061966,0.1975755304083856,129229.25954380188,1402.3206659741388,130631.58020977602,1738,0,449.3333333333333,37,2,18,36.755791904813265,0.6106418918918919,45.805921052631575,1016.7763157894731,27.480440967283055,0
3458,4,0,0,39,0.0,0.0,1.0,39,1550,1300,250,0.8387096774193549,18,13,5,358.64195520131847,0.41503598740440845,0.12675145505496865,0.19972869509951005,129368.65790435538,1479.4056825177158,130848.06358687309,1739,1,450.3333333333333,37,2,18,36.54747790472085,0.6120495495495495,45.668859649122815,1017.3245614035103,27.49525841631109,0
3459,4,1,0,40,0.025,0.0,1.0,40,900,600,300,0.6666666666666666,12,6,6,352.1080461527314,0.4170806623931624,0.13113593455003203,0.1977030690235653,129690.6332182774,1133.023093359632,130823.65631163704,1740,0,440.05,38,2,16,36.386222991399215,0.6134868421052632,45.3525641025641,1018.5897435897432,26.804993252361662,0
3460,4,0,1,39,0.0,0.025,0.975,40,950,500,450,0.5263157894736842,14,5,9,355.76098946320826,0.41741452991452993,0.12953920220082527,0.18878703601441774,127442.37075617281,1067.8047839506135,128510.17554012343,1741,1,441.05,38,2,12,38.588950022925246,0.590734649122807,47.56944444444444,1009.7222222222221,26.57163742690058,8
3461,4,0,0,39,0.0,0.0,1.0,39,900,600,300,0.6666666666666666,12,6,6,360.3876938331437,0.4151484480431849,0.141675926622163,0.19102415066907036,127396.24361582405,1382.4076879424317,128778.65130376647,1742,4,453.3333333333333,37,2,13,38.51949151008289,0.5920608108108107,47.61513157894736,1009.5394736842101,27.284850640113785,0
3462,4,2,0,41,0.04878048780487805,0.0,1.0,41,850,500,350,0.5882352941176471,12,5,7,351.70528736669763,0.4211128048780488,0.165360479920047,0.18904889076882847,127960.02739800327,800.8436414930354,128760.8710394963,1743,0,432.1707317073171,39,2,15,38.16116287449811,0.594284188034188,47.05729166666666,1011.7708333333317,25.942841880341838,0
3463,4,0,1,40,0.0,0.024390243902439025,0.975609756097561,41,1300,1000,300,0.7692307692307693,16,10,6,356.4835983674577,0.42083333333333334,0.16922613670581144,0.1925011431184269,128144.53124999974,936.55056423608,129081.08181423582,1744,1,433.1707317073171,37,4,18,37.85150891632371,0.5996621621621622,46.874999999999986,1012.499999999998,27.36486486486481,0
3464,4,1,0,41,0.024390243902439025,0.0,1.0,41,1300,1000,300,0.7692307692307693,16,10,6,362.0851249774888,0.4240853658536585,0.17769055042919057,0.19716366699304216,128477.80687326848,1103.980551708199,129581.78742497668,1745,0,433.9024390243902,37,4,16,37.36886221068571,0.6030405405405406,46.54605263157894,1013.8157894736823,27.400426742531955,0
3465,4,0,0,41,0.0,0.0,1.0,41,1550,1100,450,0.7096774193548387,20,11,9,392.75414552843773,0.42306910569105693,0.2153330652013512,0.20125627927274264,126016.311809884,1710.9972539627765,127727.30906384678,1746,1,434.9024390243902,37,4,19,39.12705671435331,0.5779842342342343,48.985745614035096,1004.0570175438612,27.136676149834088,8
3466,4,4,1,44,0.08888888888888889,0.022222222222222223,0.9777777777777777,45,1050,600,450,0.5714285714285714,15,6,9,365.29604229327265,0.4312710437710438,0.24905856962119466,0.1927162512875819,127205.59030314117,298.12348117636554,127503.71378431754,1747,0,397.15555555555557,36,9,19,38.59143596040783,0.5920138888888888,47.80405405405406,1008.7837837837853,28.021771771771814,0
3467,4,1,2,43,0.022222222222222223,0.044444444444444446,0.9555555555555556,45,850,500,350,0.5882352941176471,12,5,7,341.27065868354487,0.4313552188552188,0.2023636539765572,0.17712101606788527,126539.80070791024,-259.27029389105587,126280.53041401919,1748,0,398.0444444444444,37,8,19,39.88075777390294,0.5833333333333333,48.46491228070176,1006.1403508771939,27.192982456140374,8
3468,4,3,0,46,0.06521739130434782,0.0,1.0,46,1200,900,300,0.75,15,9,6,328.10764506913966,0.4326288244766506,0.21888419927382574,0.17238439526015603,127038.15563591212,-863.5619840748002,126174.59365183732,1749,0,390.0869565217391,38,8,22,39.70079129574676,0.5866228070175439,47.97008547008547,1008.1196581196588,26.52946468735944,0
3469,4,1,1,46,0.02127659574468085,0.02127659574468085,0.9787234042553191,47,1000,600,400,0.6,14,6,8,320.08343757511057,0.4344164353993216,0.22045899134314095,0.1695969706692401,127381.02349175377,-1245.488823784688,126135.53466796908,1750,0,382.7659574468085,39,8,16,39.55226928765522,0.5884081196581197,47.63020833333335,1009.4791666666691,25.88408119658126,0
3470,4,1,3,44,0.02127659574468085,0.06382978723404255,0.9361702127659575,47,1050,700,350,0.6666666666666666,14,7,7,314.94860899311345,0.4356884057971015,0.23263010567675457,0.16780380871433753,127604.89477989315,-1362.2031776719957,126242.69160222115,1751,0,383.29787234042556,40,7,17,39.45320358076847,0.5890625,47.408536585365866,1010.3658536585385,25.259146341463463,0
3471,4,0,1,43,0.0,0.022727272727272728,0.9772727272727273,44,1450,1200,250,0.8275862068965517,17,12,5,325.8857668915475,0.4296819943622269,0.04243434861700646,0.17891587596383854,128804.55864800363,-316.51788273192415,128488.04076527171,1752,1,410.29545454545456,39,5,13,37.953758337609045,0.6028311965811965,46.22395833333334,1015.104166666668,26.028311965812,8
3472,4,1,2,42,0.022727272727272728,0.045454545454545456,0.9545454545454546,44,1150,900,250,0.782608695652174,14,9,5,322.7169181596995,0.4289332276250881,0.06035366478728843,0.17836280660894488,129069.04432508718,-469.4471571180174,128599.59716796916,1753,0,411.15909090909093,39,5,15,37.76535537331283,0.6055021367521367,45.963541666666686,1016.1458333333363,26.055021367521444,0
3473,4,1,0,43,0.023255813953488372,0.0,1.0,43,1450,1200,250,0.8275862068965517,17,12,5,331.1516849770185,0.4238418235511259,0.08398788438831573,0.18326038273335524,129119.93805473375,-48.3429898093334,129071.59506492442,1754,0,421.5348837209302,38,5,17,37.4993430043099,0.6077302631578947,45.91346153846154,1016.346153846154,26.745951417004054,0
3474,4,1,2,42,0.022727272727272728,0.045454545454545456,0.9545454545454546,44,1100,700,400,0.6363636363636364,15,7,8,323.08080739296537,0.4257069238900634,0.0903275332650968,0.18037139932738708,129466.28146701399,-434.3858506944356,129031.89561631955,1755,0,412.9318181818182,39,5,14,37.352865916069604,0.6095085470085471,45.57291666666667,1017.7083333333342,26.09508547008549,0
3475,4,0,0,42,0.0,0.0,1.0,42,1150,900,250,0.782608695652174,14,9,5,337.6017741663758,0.42265534262485477,0.0985976583152397,0.18787832387171374,129340.77222077947,333.1348347568482,129673.90705553631,1756,1,429.0952380952381,37,5,18,37.11093295246309,0.6117680180180181,45.69627192982456,1017.2149122807017,27.49229492650545,0
3476,4,0,0,42,0.0,0.0,1.0,42,1250,900,350,0.72,16,9,7,337.49844041978685,0.4223649825783972,0.09812417586364375,0.18835375980373073,129452.3329894776,337.99209853032545,129790.32508800793,1757,2,430.0952380952381,37,5,14,37.000211004561294,0.6128941441441442,45.58662280701755,1017.6535087719303,27.504148885727847,0
3477,4,0,1,41,0.0,0.023809523809523808,0.9761904761904762,42,1150,600,550,0.5217391304347826,17,6,11,340.5762722945641,0.42232868757259,0.0950611204300742,0.1903413326737169,129508.13140822177,421.47932536934263,129929.61073359112,1758,3,431.0952380952381,37,5,14,36.86521508851307,0.6134572072072072,45.531798245614034,1017.8728070175439,27.510075865339026,0
3478,4,0,1,40,0.0,0.024390243902439025,0.975609756097561,41,1200,900,300,0.75,15,9,6,346.93694534902534,0.4219766260162601,0.09492200464653111,0.19393710878230352,129516.42679419322,786.8066968996401,130303.23349109286,1759,4,438.4878048780488,36,5,15,36.6949238485083,0.6154513888888888,45.52364864864867,1017.9054054054085,28.275150150150235,0
3479,4,0,1,39,0.0,0.025,0.975,40,950,600,350,0.631578947368421,13,6,7,352.2856859182452,0.4226095085470085,0.09499772494596748,0.19638195719133125,129407.39300679452,1117.6744416581105,130525.06744845262,1760,5,443.025,35,5,20,36.66972377052289,0.6163690476190475,45.630787037037045,1017.4768518518528,29.07076719576722,0
3480,4,0,0,39,0.0,0.0,1.0,39,1050,800,250,0.7619047619047619,13,8,5,357.7268889660394,0.4184941520467836,0.10441275328915745,0.19898558198735966,129322.44897959201,1452.4234693877727,130774.87244897978,1761,6,455.0,34,5,20,36.61780196629213,0.6176470588235294,45.71428571428572,1017.1428571428585,29.91596638655466,0
3481,4,1,0,40,0.025,0.0,1.0,40,1150,800,350,0.6956521739130435,15,8,7,351.7479338842975,0.4212873931623931,0.11440909090909113,0.19740955473098334,129672.49657064477,1122.4065500685947,130794.90312071337,1762,0,444.6,35,5,16,36.413825757575765,0.6190476190476191,45.370370370370374,1018.5185185185189,29.100529100529112,0
3482,4,0,0,40,0.0,0.0,1.0,40,600,400,200,0.6666666666666666,8,4,4,352.7502812383689,0.4205662393162393,0.11549079754601244,0.19826998566156606,129731.4453125001,1152.5607638889035,130884.006076389,1763,1,445.6,35,5,17,36.32839127471029,0.6196428571428572,45.31250000000001,1018.7500000000008,29.10714285714288,0
3483,4,0,1,39,0.0,0.025,0.975,40,1250,800,450,0.64,17,8,9,353.9691131039273,0.4203525641025641,0.11744833068362426,0.19955518629917962,129849.38298396781,1192.5341863854605,131041.91717035326,1764,2,446.6,35,5,17,36.177511545158595,0.6208333333333333,45.19675925925926,1019.2129629629634,29.12037037037038,0
3484,4,0,1,38,0.0,0.02564102564102564,0.9743589743589743,39,1100,800,300,0.7272727272727273,14,8,6,352.84989865542104,0.41686347278452546,0.12750646265632648,0.19922448124082995,129908.37191358021,1367.6311728395003,131276.00308641972,1765,3,458.20512820512823,35,4,17,36.14611716621252,0.6214285714285714,45.138888888888886,1019.4444444444441,29.126984126984116,0
3485,4,1,0,39,0.02564102564102564,0.0,1.0,39,1400,1100,300,0.7857142857142857,17,11,6,353.27329826628034,0.415710751237067,0.13408737847131325,0.20037006762670473,130085.41907793198,1391.1410108024559,131476.56008873443,1766,0,458.79487179487177,35,4,18,35.95558202859088,0.6232142857142857,44.96527777777777,1020.1388888888879,29.146825396825367,0
3486,4,0,0,39,0.0,0.0,1.0,39,1000,600,400,0.6,14,6,8,357.1902820199912,0.4155420602789024,0.13611816333830595,0.20305265741910125,130173.98787133476,1499.3766878857864,131673.36455922056,1767,1,459.79487179487177,35,4,19,35.765779176590684,0.6241071428571429,44.878472222222214,1020.4861111111102,29.156746031746007,0
3487,4,0,0,39,0.0,0.0,1.0,39,1000,700,300,0.7,13,7,6,359.1622577348343,0.41520467836257313,0.13749821957508201,0.20479445866056672,130292.12648158839,1559.2028624399559,131851.32934402835,1768,2,460.79487179487177,35,4,20,35.59557211956316,0.625297619047619,44.76273148148147,1020.949074074072,29.169973544973484,0
3488,4,0,0,39,0.0,0.0,1.0,39,850,600,250,0.7058823529411765,11,6,5,357.08261374102835,0.4151484480431849,0.1392738238421447,0.20438464000507856,130439.8750964504,1515.56230709874,131955.43740354915,1769,3,461.79487179487177,35,4,20,35.498810333106725,0.6267857142857143,44.61805555555554,1021.527777777776,29.186507936507887,0
3489,4,0,0,39,0.0,0.0,1.0,39,700,400,300,0.5714285714285714,10,4,6,359.0909720971028,0.4151484480431849,0.13979309483782387,0.20631960797589552,130587.70743580669,1578.5733614111723,132166.28079721786,1770,4,462.79487179487177,35,4,17,35.29764937908127,0.6282738095238095,44.473379629629626,1022.106481481481,29.20304232804231,0
3490,4,0,1,38,0.0,0.02564102564102564,0.9743589743589743,39,1550,1100,450,0.7096774193548387,20,11,9,357.53094510183166,0.4150641025641026,0.1392455381365647,0.20636844950129887,130765.21675936642,1550.5223068844323,132315.73906625086,1771,5,463.79487179487177,35,4,17,35.1576939760854,0.6300595238095238,44.29976851851852,1022.800925925926,29.222883597883598,0
3491,4,0,0,38,0.0,0.0,1.0,38,1250,900,350,0.72,16,9,7,358.38374855031947,0.4148885727833096,0.14391782247940998,0.20742816961548793,130870.93431122444,1780.4032029478433,132651.33751417228,1772,6,470.7894736842105,34,4,17,35.028844289315494,0.6332720588235294,44.19642857142857,1023.2142857142852,30.094537815126035,0
3492,4,0,0,38,0.0,0.0,1.0,38,1150,900,250,0.782608695652174,14,9,5,360.6814494321252,0.4151552868658132,0.14629742962056258,0.20958516656191087,131023.24263038569,1851.5306122449201,132874.77324263062,1773,7,471.7894736842105,34,4,17,34.815891472868216,0.6348039215686274,44.04761904761906,1023.8095238095254,30.11204481792722,0
3493,4,1,2,37,0.02564102564102564,0.05128205128205128,0.9487179487179487,39,1250,900,350,0.72,16,9,7,351.771278435193,0.41599190283400805,0.14337180082651524,0.20636609331634095,131389.14399092994,1444.1397392290523,132833.283730159,1774,0,460.6666666666667,34,5,18,34.67424330391702,0.6384803921568627,43.690476190476204,1025.238095238097,30.154061624649913,0
3494,4,0,1,36,0.0,0.02702702702702703,0.972972972972973,37,1150,1000,150,0.8695652173913043,13,10,3,366.3900734249101,0.41344469469469475,0.1507939330645398,0.2137232814904973,131171.15600069697,2211.9618956651484,133383.11789636212,1775,1,480.81081081081084,33,4,18,34.52005323603302,0.6385732323232323,43.903186274509814,1024.3872549019618,31.042038027332175,0
3495,4,0,0,36,0.0,0.0,1.0,36,750,500,250,0.6666666666666666,10,5,5,380.03256700029334,0.41013558201058203,0.1585833675846009,0.22109498697075922,131069.41415416815,2762.1291832466363,133831.54333741477,1776,2,494.80555555555554,32,4,18,34.273787505137705,0.6399739583333333,44.00252525252527,1023.9898989899006,31.999684343434392,0
3496,4,0,1,35,0.0,0.027777777777777776,0.9722222222222222,36,1350,1200,150,0.8888888888888888,15,12,3,386.62336749439805,0.4091104497354497,0.13607342945709955,0.21548323777469527,129400.03289116762,2812.5150249486314,132212.54791611625,1777,3,495.80555555555554,31,5,19,35.803792338537654,0.6256720430107527,45.638020833333336,1017.4479166666673,32.82090053763443,8
3497,4,0,0,35,0.0,0.0,1.0,35,1100,800,300,0.7272727272727273,14,8,6,400.89276977314097,0.4062324929971988,0.1510198690491913,0.22366685040180181,129440.63484579146,3378.3629249046194,132818.99777069606,1778,12,510.8857142857143,30,5,17,35.39933077972968,0.6288194444444444,45.598118279569896,1017.6075268817207,33.920250896057354,0
3498,4,0,0,35,0.0,0.0,1.0,35,750,600,150,0.8,9,6,3,406.61878234916077,0.40693277310924375,0.15077143611603594,0.22745425830964125,129543.23657359225,3534.9426234246653,133078.17919701693,1779,13,511.8857142857143,30,5,17,35.14875451104657,0.6298611111111111,45.497311827956985,1018.0107526881715,33.93369175627238,0
3499,4,1,0,36,0.027777777777777776,0.0,1.0,36,1250,900,350,0.72,16,9,7,395.033279444303,0.410978835978836,0.1507394161309097,0.22297877035107763,129897.31046888555,3062.7521091037233,132960.06257798927,1780,0,498.6388888888889,31,5,18,35.0823061693703,0.6307123655913979,45.14973958333333,1019.401041666666,32.88390456989245,0
3500,4,2,0,38,0.05263157894736842,0.0,1.0,38,1300,900,400,0.6923076923076923,17,9,8,379.3641761932249,0.4161036036036036,0.16788224457090917,0.21825213502095742,130638.1635068243,2311.8878556324444,132950.05136245675,1781,0,473.3421052631579,33,5,20,34.728382482218485,0.6332070707070707,44.424019607843135,1022.3039215686275,30.978906714200832,0
3501,4,0,0,38,0.0,0.0,1.0,38,700,500,200,0.7142857142857143,9,5,4,380.4445745687134,0.41613323850165956,0.16545138012817295,0.21922855871556224,130700.81218761996,2344.8829777008636,133045.69516532082,1782,1,474.3421052631579,33,5,20,34.6371644295302,0.6338383838383839,44.362745098039206,1022.5490196078416,30.98633392751035,0
3502,4,0,0,38,0.0,0.0,1.0,38,850,500,350,0.5882352941176471,12,5,7,380.78554268708086,0.41637031768610716,0.16995272612669354,0.22049648276263004,130888.84833958096,2368.116229334874,133256.96456891584,1783,2,475.3421052631579,33,5,20,34.437624750499,0.6357323232323233,44.17892156862745,1023.2843137254905,31.008615567439108,0
3503,4,0,0,38,0.0,0.0,1.0,38,1050,800,250,0.7619047619047619,13,8,5,383.69110663378405,0.415851706970128,0.1726658600524298,0.22254084184759462,130951.5570934255,2448.9895713187097,133400.5466647442,1784,3,476.3421052631579,33,5,20,34.299668742017865,0.6363636363636364,44.11764705882352,1023.5294117647051,31.016042780748638,0
3504,4,1,0,39,0.02564102564102564,0.0,1.0,39,1100,800,300,0.7272727272727273,14,8,6,381.77565227415545,0.41722896986054886,0.19693140849514057,0.22490105455221354,131548.0392907775,2244.9083585640074,133792.9476493415,1785,0,465.1025641025641,33,6,21,33.7443505355792,0.6423611111111112,43.53553921568627,1025.8578431372543,31.086601307189525,0
3505,4,0,0,39,0.0,0.0,1.0,39,850,600,250,0.7058823529411765,11,6,5,385.1361553374488,0.41663855150697254,0.20041275498643563,0.2274421836950491,131642.34459102261,2340.045295078804,133982.38988610142,1786,1,466.1025641025641,33,6,17,33.562713955895234,0.6433080808080809,43.44362745098039,1026.2254901960778,31.09774212715387,0
3506,4,0,0,39,0.0,0.0,1.0,39,1150,900,250,0.782608695652174,14,9,5,385.30147019472105,0.4161605937921728,0.2005277985806495,0.2289518653471112,131877.80612244902,2362.542517006805,134240.34863945583,1787,2,467.1025641025641,34,5,17,33.32029439035696,0.6433823529411764,43.214285714285715,1027.1428571428576,30.21008403361346,0
3507,4,0,0,39,0.0,0.0,1.0,39,1650,1300,350,0.7878787878787878,20,13,7,389.5211665110253,0.41551394511920825,0.20904100723482455,0.23314582918612087,132153.07716836734,2495.2841553287935,134648.36132369612,1788,3,468.1025641025641,34,5,18,32.93364787156034,0.6461397058823529,42.94642857142857,1028.2142857142856,30.24159663865546,0
3508,4,0,0,39,0.0,0.0,1.0,39,900,600,300,0.6666666666666666,12,6,6,391.1876286008229,0.41512033288349076,0.20868945868945898,0.2347125771604939,132244.89795918373,2546.5136054421846,134791.41156462592,1789,4,469.1025641025641,34,5,18,32.798032407407405,0.6470588235294117,42.85714285714286,1028.5714285714291,30.25210084033615,0
3509,4,0,1,38,0.0,0.02564102564102564,0.9743589743589743,39,1100,600,500,0.5454545454545454,16,6,10,392.5650313888116,0.41495164192532613,0.20803488009965765,0.23649649451960097,132398.00347222216,2595.0538548752734,134993.05732709743,1790,5,470.1025641025641,33,6,19,32.60796221322538,0.6508838383838385,42.70833333333333,1029.166666666666,31.186868686868667,0
3510,4,0,0,38,0.0,0.0,1.0,38,1100,500,600,0.45454545454545453,17,5,12,400.00659693497744,0.4125918681839735,0.21079747946903526,0.2411874096312082,132430.49178655236,2994.6140699928537,135425.1058565452,1791,6,482.5,32,6,21,32.383668629375194,0.6536458333333333,42.676767676767675,1029.292929292929,32.165404040404034,0
3511,4,0,0,38,0.0,0.0,1.0,38,1550,900,650,0.5806451612903226,22,9,13,397.9321395158032,0.4124733285917497,0.21245327841866457,0.24014365162637621,132462.98408644524,2942.2557328333855,135405.23981927862,1792,7,483.5,32,6,21,32.404227482726206,0.6539713541666667,42.64520202020202,1029.4191919191917,32.16934974747474,0
3512,4,0,0,38,0.0,0.0,1.0,38,1150,900,250,0.782608695652174,14,9,5,397.54699976259906,0.4123696064485538,0.2093260370150487,0.24053362982668822,132560.48489950004,2939.8046117743115,135500.28951127434,1793,8,484.5,32,6,21,32.31567761974824,0.6549479166666667,42.55050505050505,1029.79797979798,32.18118686868687,0
3513,4,0,0,38,0.0,0.0,1.0,38,1150,900,250,0.782608695652174,14,9,5,393.0938544303842,0.4112138454243717,0.20752514536430233,0.2390112958716631,132745.069879974,2836.254235149935,135581.32411512395,1794,9,485.5,33,5,20,32.24409858484956,0.6543560606060606,42.37132352941176,1030.5147058823527,31.227718360071293,0
3514,4,0,0,38,0.0,0.0,1.0,38,850,600,250,0.7058823529411765,11,6,5,392.9999238006344,0.41111012328117597,0.20602147308356478,0.23955908398629977,132839.80320069205,2841.2065071126517,135681.0097078047,1795,10,486.5,33,5,20,32.150994610873354,0.6553030303030303,42.279411764705884,1030.8823529411766,31.238859180035654,0
3515,4,0,0,38,0.0,0.0,1.0,38,1050,800,250,0.7619047619047619,13,8,5,392.8548522993791,0.4114212897107634,0.20713847313121714,0.23978265509266541,132888.53635204077,2841.1812641723286,135729.7176162131,1796,11,487.5,34,4,20,32.105607512604394,0.6534926470588236,42.232142857142854,1031.0714285714282,30.32563025210083,0
3516,4,0,0,38,0.0,0.0,1.0,38,900,700,200,0.7777777777777778,11,7,4,392.9628953071084,0.41050260787102894,0.2117262161521778,0.2402425943574792,132949.9167375284,2848.8768424036352,135798.79357993204,1797,12,488.5,34,4,20,32.040959636769415,0.6541053921568627,42.17261904761905,1031.3095238095243,30.332633053221304,0
3517,4,0,0,38,0.0,0.0,1.0,38,1050,700,350,0.6666666666666666,14,7,7,389.14963584287955,0.40962837837837834,0.20431704043771592,0.2386949677176389,133072.7200255102,2757.040107709755,135829.76013321997,1798,13,489.5,34,4,20,32.01559555401715,0.6553308823529411,42.05357142857143,1031.7857142857144,30.34663865546219,0
3518,4,0,0,38,0.0,0.0,1.0,38,1100,700,400,0.6363636363636364,15,7,8,374.04883440317286,0.4097321005215742,0.14526030265537204,0.21773579518416292,131090.96364883418,2206.884430727036,133297.84807956123,1799,14,490.5,35,3,19,34.40513863773355,0.6333333333333333,43.98148148148149,1024.0740740740753,29.259259259259295,8
3519,4,0,0,38,0.0,0.0,1.0,38,1250,1000,250,0.8,15,10,5,373.49646310090145,0.40908013276434324,0.15093823578376564,0.21808645721432604,131209.517532579,2201.2581447188077,133410.7756772978,1800,15,491.5,35,3,19,34.299216749510464,0.6345238095238095,43.86574074074075,1024.537037037038,29.272486772486804,0
3520,4,0,0,38,0.0,0.0,1.0,38,900,700,200,0.7777777777777778,11,7,4,376.28930370442174,0.4082207207207207,0.1493625367767244,0.2202274807866923,131298.46810967507,2281.2418284893656,133579.70993816445,1801,16,492.5,35,3,19,34.137610577827964,0.6354166666666667,43.77893518518518,1024.8842592592591,29.282407407407405,0
3521,4,0,0,38,0.0,0.0,1.0,38,1200,900,300,0.75,15,9,6,378.5278382358692,0.40633890469416784,0.1491307239217179,0.22308981104539527,131565.50068587105,2360.240912208507,133925.74159807956,1802,17,493.5,35,3,16,33.809980445246694,0.638095238095238,43.51851851851852,1025.9259259259259,29.31216931216931,0
3522,4,0,0,38,0.0,0.0,1.0,38,1100,600,500,0.5454545454545454,16,6,10,378.0035047706803,0.4059091986723566,0.15418197574685522,0.22330160405074106,131654.57182623888,2353.177913880314,134007.7497401192,1803,18,494.5,35,3,17,33.73334179166197,0.6389880952380953,43.43171296296296,1026.2731481481483,29.32208994708995,0
3523,4,0,1,37,0.0,0.02631578947368421,0.9736842105263158,38,1450,1200,250,0.8275862068965517,17,12,5,378.0198302482142,0.4043089141773352,0.15850866318280765,0.22435919423360567,131832.8045294282,2367.082877872092,134199.8874073003,1804,19,495.5,35,3,18,33.552748976295135,0.6407738095238096,43.258101851851855,1026.9675925925928,29.341931216931226,0
3524,4,0,1,36,0.0,0.02702702702702703,0.972972972972973,37,900,600,300,0.6666666666666666,12,6,6,382.53531118130553,0.4026839339339339,0.15632813430170245,0.2269428881877538,131816.6737528344,2684.906462585023,134501.58021541944,1805,20,508.2432432432432,34,3,18,33.45312620758944,0.6427696078431373,43.27380952380952,1026.9047619047615,30.203081232492984,0
3525,4,0,0,36,0.0,0.0,1.0,36,750,500,250,0.6666666666666666,10,5,5,384.4893463946469,0.40223214285714287,0.16258569704684978,0.22799973343529673,131799.59518274208,2935.1080413782984,134734.70322412037,1806,21,521.4166666666666,33,3,18,33.42023212793889,0.6448863636363636,43.29044117647058,1026.8382352941167,31.116310160427776,0
3526,4,0,0,36,0.0,0.0,1.0,36,900,700,200,0.7777777777777778,11,7,4,388.19966967251344,0.40109126984126986,0.16565945716709107,0.23115525785045107,131956.93963860045,3045.128075740092,135002.06771434055,1807,22,522.4166666666666,33,3,19,33.1658516221374,0.6464646464646464,43.13725490196078,1027.4509803921562,31.134878193701702,0
3527,4,0,0,36,0.0,0.0,1.0,36,1200,800,400,0.6666666666666666,16,8,8,394.09317129403786,0.40130621693121693,0.13228717457275252,0.22783170318300727,130826.15460399835,3136.7845299884557,133962.9391339868,1808,23,523.4166666666666,33,3,15,34.160876856732166,0.6351010101010102,44.24019607843137,1023.0392156862737,31.001188354129507,8
3528,4,0,0,36,0.0,0.0,1.0,36,1400,1200,200,0.8571428571428571,16,12,4,393.63435100776576,0.40138888888888885,0.13099989357173314,0.228307923584504,130951.55709342546,3109.4062379853754,134060.96333141084,1809,24,524.4166666666666,33,3,15,34.04523866538953,0.6363636363636364,44.11764705882352,1023.5294117647048,31.01604278074863,0
3529,4,1,0,37,0.02702702702702703,0.0,1.0,37,850,600,250,0.7058823529411765,11,6,5,383.1255126436934,0.40484234234234234,0.1263647753713979,0.2238670256160401,131236.62308673473,2656.019699546489,133892.6427862812,1810,0,511.2162162162162,34,3,16,34.025115216296804,0.6369485294117647,43.839285714285715,1024.6428571428576,30.136554621848752,0
3530,4,0,0,37,0.0,0.0,1.0,37,950,700,250,0.7368421052631579,12,7,5,382.3782140260427,0.4044044044044044,0.12326961107448908,0.22396438250096784,131328.125,2643.43466553288,133971.55966553287,1811,1,512.2162162162163,33,4,16,33.95155826558265,0.6401515151515151,43.75,1025.0,31.060606060606062,0
3531,4,0,0,37,0.0,0.0,1.0,37,950,700,250,0.7368421052631579,12,7,5,382.93845492922117,0.40368493493493496,0.12286209849166774,0.2255489177119005,131541.7534722224,2674.4791666666906,134216.23263888908,1812,2,513.2162162162163,34,3,19,33.72089087462768,0.6400122549019608,43.54166666666668,1025.8333333333348,30.171568627451023,0
3532,4,0,0,37,0.0,0.0,1.0,37,1100,800,300,0.7272727272727273,14,8,6,388.29271377972645,0.40330955955955955,0.12333274833274821,0.22998876123876144,131755.5555555558,2831.9444444444784,134587.50000000026,1813,3,514.2162162162163,34,3,13,33.36715367965369,0.642156862745098,43.33333333333335,1026.6666666666688,30.196078431372612,0
3533,4,0,0,37,0.0,0.0,1.0,37,1000,600,400,0.6,14,6,8,388.8078106634971,0.40240240240240244,0.1265186846366586,0.23122140580395045,131908.37762188227,2857.40150226759,134765.77912414988,1814,4,515.2162162162163,34,3,16,33.19933750531154,0.6436887254901961,43.18452380952382,1027.2619047619062,30.213585434173712,0
3534,4,0,1,36,0.0,0.02702702702702703,0.972972972972973,37,1050,800,250,0.7619047619047619,13,8,5,386.76431683818004,0.40249624624624625,0.1269381058537684,0.23056281650187663,132000.11337868497,2810.586734693892,134810.70011337887,1815,5,516.2162162162163,34,3,17,33.15907862218102,0.6446078431372548,43.0952380952381,1027.6190476190488,30.224089635854376,0
3535,4,0,1,35,0.0,0.027777777777777776,0.9722222222222222,36,900,700,200,0.7777777777777778,11,7,4,396.84098404543107,0.3995535714285714,0.1285600636435955,0.2355189409561414,131831.056564783,3263.1932429834933,135094.2498077665,1816,31,531.4166666666666,33,3,17,33.07130071599044,0.6452020202020202,43.25980392156864,1026.9607843137273,31.120023767082646,0
3536,4,0,1,34,0.0,0.02857142857142857,0.9714285714285714,35,750,500,250,0.6666666666666666,10,5,5,395.3319812488859,0.39656862745098037,0.13208408572109942,0.2357933139938236,132019.90370290293,3438.33801903116,135458.2417219341,1817,32,538.8571428571429,33,2,17,32.91895222195723,0.6470959595959596,43.07598039215687,1027.696078431374,31.14230540701133,0
3537,4,0,0,34,0.0,0.0,1.0,34,1150,800,350,0.6956521739130435,15,8,7,407.31455633750414,0.39204545454545453,0.14047307506018236,0.2424519784139192,131943.58555568324,3948.508602438543,135892.0941581218,1818,33,554.6470588235294,32,2,17,32.68838843144483,0.6487630208333333,43.15025252525253,1027.3989898989912,32.106218434343475,0
3538,4,0,1,33,0.0,0.029411764705882353,0.9705882352941176,34,600,400,200,0.6666666666666666,8,4,4,407.31455633750414,0.39204545454545453,0.14047307506018236,0.2424519784139192,131943.58555568324,3948.508602438543,135892.0941581218,1819,34,555.6470588235294,32,2,17,32.68838843144483,0.6487630208333333,43.15025252525253,1027.3989898989912,32.106218434343475,0
3539,4,0,0,33,0.0,0.0,1.0,33,1050,600,450,0.5714285714285714,15,6,9,415.66451204594813,0.3915719696969697,0.1398418204096996,0.24711208255693182,131895.95752292217,4364.8937649197105,136260.85128784188,1820,35,549.6666666666666,31,2,19,32.522209194236694,0.6508736559139785,43.196614583333336,1027.2135416666672,33.13592069892475,0
3540,4,0,0,33,0.0,0.0,1.0,33,1100,800,300,0.7272727272727273,14,8,6,419.96405481860734,0.3919665404040404,0.1493311839100313,0.250992900287124,132096.66146172432,4495.169915093336,136591.83137681766,1821,36,550.6666666666666,31,2,19,32.208280557314744,0.6528897849462365,43.00130208333334,1027.9947916666679,33.161122311827995,0
3541,4,1,0,34,0.029411764705882353,0.0,1.0,34,500,400,100,0.8,6,4,2,411.2507990624332,0.39535056446821154,0.14062872112407732,0.2477535301668808,132398.00347222236,4089.7569444444634,136487.76041666683,1822,0,535.4411764705883,32,2,20,32.127192982456144,0.6533203125,42.70833333333334,1029.1666666666679,32.16145833333337,0
3542,4,0,0,34,0.0,0.0,1.0,34,700,500,200,0.7142857142857143,9,5,4,406.3121215355837,0.3957033571004159,0.14505068685711708,0.245870127714226,132565.56404961488,3972.599114312076,136538.16316392695,1823,1,536.4411764705883,31,3,20,32.084887469970916,0.6575940860215054,42.54557291666667,1029.8177083333342,33.219926075268845,0
3543,4,0,0,34,0.0,0.0,1.0,34,700,400,300,0.5714285714285714,10,4,6,407.93672257454034,0.3946078431372549,0.15153396124025265,0.24773624602704059,132699.68880547426,4026.615227593321,136726.30403306757,1824,2,537.4411764705883,31,3,18,31.907541387590033,0.6589381720430108,42.415364583333336,1030.3385416666672,33.236727150537654,0
3544,4,0,0,34,0.0,0.0,1.0,34,600,400,200,0.6666666666666666,8,4,4,409.0114127162056,0.394570707070707,0.1538218572331016,0.24883361503833734,132766.77661471904,4060.6253729926325,136827.40198771167,1825,3,538.4411764705883,31,3,18,31.812092019372507,0.6596102150537635,42.35026041666667,1030.598958333334,33.24512768817206,0
3545,4,0,1,33,0.0,0.029411764705882353,0.9705882352941176,34,1150,800,350,0.6956521739130435,15,8,7,407.4387087686872,0.393939393939394,0.15506637053103844,0.24876693405853778,132901.0030958388,4029.802619086376,136930.80571492517,1826,4,539.4411764705883,31,3,18,31.71709917077072,0.6609543010752688,42.220052083333336,1031.119791666667,33.26192876344087,0
3546,4,0,0,33,0.0,0.0,1.0,33,800,500,300,0.625,11,5,6,417.9523817529526,0.38979640151515155,0.16472578643202218,0.25388454504898045,132709.42630650938,4493.244161174703,137202.67046768407,1827,42,556.6666666666666,30,3,18,31.63970780067833,0.6618055555555555,42.405913978494624,1030.3763440860212,34.3458781362007,0
3547,4,0,0,33,0.0,0.0,1.0,33,900,800,100,0.8888888888888888,10,8,2,403.24752886213963,0.3899147727272727,0.05020487189877998,0.22805511506236972,129972.73875114787,3882.237144168968,133854.97589531683,1828,43,557.6666666666666,32,1,18,34.7960004952947,0.62890625,45.07575757575758,1019.6969696969699,31.865530303030308,8
3548,4,0,0,33,0.0,0.0,1.0,33,1000,700,300,0.7,13,7,6,402.2572859812176,0.389520202020202,0.04822829108012927,0.22805870971524617,130069.3188992195,3864.2662419651124,133933.58514118462,1829,44,558.6666666666666,32,1,18,34.72273796261914,0.6298828125,44.98106060606061,1020.075757575758,31.877367424242436,0
3549,4,0,0,33,0.0,0.0,1.0,33,1150,800,350,0.6956521739130435,15,8,7,403.21343599372767,0.38924400252525254,0.050293805522118706,0.22897876150845498,130133.72559241408,3894.3333269564364,134028.05891937052,1830,45,559.6666666666666,32,1,19,34.63267747391,0.6305338541666667,44.917929292929294,1020.3282828282831,31.885258838383848,0
3550,4,0,0,33,0.0,0.0,1.0,33,700,400,300,0.5714285714285714,10,4,6,401.9991670137443,0.38825757575757575,0.06035868893011753,0.22904603701945908,130262.58680555562,3873.0902777777887,134135.6770833334,1831,46,560.6666666666666,32,1,19,34.53231292517006,0.6318359375,44.79166666666667,1020.8333333333339,31.901041666666686,0
3551,4,0,0,33,0.0,0.0,1.0,33,750,400,350,0.5333333333333333,11,4,7,401.33558463146267,0.3874289772727273,0.056061765319607604,0.22905921795341533,130329.0557861327,3861.1375596788052,134190.1933458115,1832,47,561.6666666666666,31,2,20,34.48153107200544,0.6350806451612903,44.72656249999999,1021.0937499999991,32.9385080645161,0
3552,4,0,0,33,0.0,0.0,1.0,33,850,600,250,0.7058823529411765,11,6,5,405.4188850989192,0.38790246212121215,0.05382312609846096,0.2319847668563836,130428.79104614258,3975.6590101453994,134404.45005628798,1833,48,562.6666666666666,31,2,20,34.275679838538345,0.6360887096774194,44.62890625,1021.484375,32.951108870967744,0
3553,4,1,0,34,0.029411764705882353,0.0,1.0,34,800,600,200,0.75,10,6,4,395.17851246898243,0.3922311348781937,0.05257652579431382,0.22760708349742678,130681.82615294354,3528.5299331700794,134210.3560861136,1834,0,547.0882352941177,32,2,17,34.2798118877089,0.6360677083333333,44.38131313131313,1022.4747474747472,31.95233585858585,0
3554,4,1,0,35,0.02857142857142857,0.0,1.0,35,700,400,300,0.5714285714285714,10,4,6,384.69451542686363,0.3964985994397759,0.04685594670476667,0.22336179190787317,130992.77388038553,3078.440334467129,134071.21421485266,1835,0,532.4285714285714,34,1,19,34.232178160251195,0.6344975490196079,44.077380952380956,1023.6904761904766,30.10854341736696,0
3555,4,1,1,35,0.027777777777777776,0.027777777777777776,0.9722222222222222,36,950,600,350,0.631578947368421,13,6,7,351.84758963241256,0.401223544973545,0.08181955797759621,0.19865856214630062,129908.3719135803,1941.589506172847,131849.96141975315,1836,0,518.6111111111111,35,1,22,36.1716621253406,0.6214285714285714,45.13888888888889,1019.4444444444448,29.126984126984137,7
3556,4,0,0,35,0.0,0.0,1.0,35,1400,1200,200,0.8571428571428571,16,12,4,356.36962292390825,0.4011554621848739,0.07949440544281261,0.2017857607130947,130019.6446286848,2267.0103458049894,132286.6549744898,1837,1,521.7428571428571,34,1,22,35.94339714408,0.6246936274509804,45.029761904761905,1019.8809523809523,29.996498599439775,0
3557,4,0,0,35,0.0,0.0,1.0,35,950,700,250,0.7368421052631579,12,7,5,366.8156894468833,0.4009103641456582,0.10839373392564888,0.20561870298352825,129625.34722222232,2509.722222222232,132135.06944444455,1838,2,522.7428571428571,34,1,16,36.078150572831426,0.6207107843137255,45.41666666666667,1018.3333333333342,29.950980392156886,8
3558,4,1,0,36,0.027777777777777776,0.0,1.0,36,900,700,200,0.7777777777777778,11,7,4,360.40171976532866,0.40282738095238096,0.12691163306731212,0.20425854381298006,130055.90284475728,2174.474210176595,132230.37705493387,1839,0,509.19444444444446,35,1,17,35.80376054313702,0.6229166666666667,44.994212962962955,1020.0231481481474,29.143518518518494,0
3559,4,1,0,37,0.02702702702702703,0.0,1.0,37,900,400,500,0.4444444444444444,14,4,10,350.99397314800717,0.4046859359359359,0.1286700865171122,0.20074671503766442,130410.31867551865,1754.81127829218,132165.12995381083,1840,0,496.4054054054054,35,2,19,35.68425401322003,0.6264880952380952,44.64699074074074,1021.4120370370367,29.18320105820105,0
3560,4,0,0,37,0.0,0.0,1.0,37,800,600,200,0.75,10,6,4,348.9350624500983,0.4044044044044044,0.1297101360535886,0.20002589164347198,130498.99798525378,1707.1352023319578,132206.13318758574,1841,1,497.4054054054054,35,2,15,35.64699441172028,0.6273809523809524,44.56018518518518,1021.7592592592594,29.193121693121697,0
3561,4,0,0,37,0.0,0.0,1.0,37,1300,800,500,0.6153846153846154,18,8,10,347.9051426693685,0.40352852852852855,0.13602532923415822,0.2005050186225618,130706.03358892752,1694.6602527006255,132400.69384162815,1842,2,498.4054054054054,35,2,16,35.463709677419345,0.6294642857142857,44.35763888888889,1022.5694444444448,29.216269841269852,0
3562,4,0,1,36,0.0,0.02702702702702703,0.972972972972973,37,1200,1000,200,0.8333333333333334,14,10,4,357.08897326838985,0.4031218718718719,0.12864150873715907,0.1977273242902267,129142.56071030506,1852.0422078617792,130994.60291816684,1843,3,499.4054054054054,35,2,19,36.81725878691262,0.6136904761904762,45.891203703703695,1016.435185185184,29.041005291005256,8
3563,4,0,0,36,0.0,0.0,1.0,36,900,500,400,0.5555555555555556,13,5,8,365.97987540807645,0.40244708994708994,0.13431461868428052,0.202499639946964,129113.15164448299,2250.563030478389,131363.71467496137,1844,4,509.25,35,1,19,36.621327297574304,0.6133928571428571,45.920138888888886,1016.3194444444441,29.037698412698404,0
3564,4,2,1,37,0.05263157894736842,0.02631578947368421,0.9736842105263158,38,950,700,250,0.7368421052631579,12,7,5,348.28960069957975,0.4101469890943575,0.12541866672711732,0.19520612683747704,129619.76431450043,1429.043191174185,131048.80750567462,1845,0,483.39473684210526,37,1,15,36.55546731990954,0.6145833333333333,45.42214912280701,1018.3114035087705,27.521929824561365,0
3565,4,0,0,37,0.0,0.0,1.0,37,750,200,550,0.26666666666666666,13,2,11,358.4479501135563,0.4048736236236236,0.13786175556087077,0.20051791268728625,129545.08562616662,1887.034077996905,131432.11970416352,1846,1,497.4594594594595,36,1,15,36.372833702064895,0.6157407407407407,45.49549549549549,1018.0180180180174,28.27827827827826,0
3566,4,0,0,37,0.0,0.0,1.0,37,1050,800,250,0.7619047619047619,13,8,5,359.7476560591869,0.40459209209209207,0.1388740282912575,0.20168617816139028,129631.081144489,1926.8955188296286,131557.97666331864,1847,2,498.4594594594595,36,1,15,36.25225773157874,0.6166087962962963,45.41103603603603,1018.3558558558551,28.28766266266264,0
3567,4,1,0,38,0.02631578947368421,0.0,1.0,38,950,700,250,0.7368421052631579,12,7,5,350.84291791980365,0.4078058321479374,0.1422795511518289,0.19861168469702292,130010.85820877542,1522.6777710448996,131533.53597982033,1848,0,486.3157894736842,37,1,16,36.09322922266423,0.6185247747747749,45.03837719298244,1019.8464912280673,27.563418681839657,0
3568,4,1,0,39,0.02564102564102564,0.0,1.0,39,750,300,450,0.4,12,3,9,345.10625550827865,0.40955353126405764,0.15293943277622302,0.19707912571841674,130351.21588059395,1197.7343957061348,131548.95027630008,1849,0,474.8205128205128,35,4,18,35.89446616797007,0.6258928571428571,44.7048611111111,1021.1805555555541,29.176587301587258,0
3569,4,0,0,39,0.0,0.0,1.0,39,800,600,200,0.75,10,6,4,343.61360822312525,0.40949730094466935,0.14599235532629318,0.19697538528530806,130498.9979852535,1168.2463134430402,131667.24429869655,1850,1,475.8205128205128,35,4,14,35.78292553994864,0.6273809523809524,44.56018518518517,1021.7592592592571,29.19312169312163,0
3570,4,1,0,40,0.025,0.0,1.0,40,1150,500,650,0.43478260869565216,18,5,13,337.5870794684921,0.4104700854700855,0.16086992406734923,0.1955164940172202,130895.62694028475,837.7344827935926,131733.36142307834,1851,0,464.9,36,4,15,35.535884597043406,0.6293402777777778,44.17229729729729,1023.3108108108098,28.42530030030027,0
3571,4,0,0,40,0.0,0.0,1.0,40,950,300,650,0.3157894736842105,16,3,13,337.2654293387969,0.41079059829059833,0.16250550176056344,0.19547628965758826,130924.43795146485,831.2573553282834,131755.69530679312,1852,1,465.9,36,4,15,35.51501063673708,0.6296296296296297,44.144144144144136,1023.4234234234224,28.4284284284284,0
3572,4,0,0,40,0.0,0.0,1.0,40,1100,1000,100,0.9090909090909091,12,10,2,337.9290242875311,0.4109909188034188,0.16251237759929626,0.19600746022650703,130953.252133045,850.5809441197723,131803.83307716477,1853,2,466.9,36,4,15,35.46892764147138,0.6299189814814814,44.11599099099098,1023.5360360360344,28.43155655655651,0
3573,4,0,1,39,0.0,0.025,0.975,40,1050,600,450,0.5714285714285714,15,6,9,337.9025609149916,0.41059027777777773,0.16395061049389525,0.19628576238199275,131010.89000740601,853.7830482509498,131864.67305565695,1854,3,467.9,36,4,17,35.41139588604115,0.6304976851851851,44.05968468468468,1023.7612612612609,28.4378128128128,0
3574,4,0,1,38,0.0,0.02564102564102564,0.9743589743589743,39,950,500,450,0.5263157894736842,14,5,9,363.35655009742425,0.4079228520017994,0.13992477676504222,0.20832927651878377,130505.75573979596,1721.53957943051,132227.29531922648,1855,4,480.6666666666667,34,5,17,35.27175812652919,0.6295955882352942,44.55357142857143,1021.7857142857147,30.052521008403374,8
3575,4,1,0,39,0.02564102564102564,0.0,1.0,39,1350,700,650,0.5185185185185185,20,7,13,365.2446443939173,0.4058704453441295,0.1510396140112027,0.21023599236293306,130657.85147392287,1744.4160997732433,132402.26757369612,1856,0,481.15384615384613,34,5,18,35.06928272007454,0.6311274509803921,44.404761904761905,1022.3809523809521,30.07002801120447,0
3576,4,0,0,39,0.0,0.0,1.0,39,1200,800,400,0.6666666666666666,16,8,8,365.22532765560686,0.40578609986504727,0.15420422705422143,0.21105455551745994,130810.03578514738,1755.0276360544194,132565.0634212018,1857,1,482.15384615384613,34,5,18,34.91553202218859,0.6326593137254901,44.25595238095238,1022.9761904761904,30.0875350140056,0
3577,4,0,1,38,0.0,0.02564102564102564,0.9743589743589743,39,950,700,250,0.7368421052631579,12,7,5,362.5767912656896,0.4053924876293297,0.15572538210974685,0.2100208960727675,130901.38888888899,1692.361111111121,132593.75000000012,1858,2,483.15384615384613,34,5,19,34.890743756786094,0.633578431372549,44.16666666666667,1023.3333333333342,30.0980392156863,0
3578,4,1,1,38,0.02564102564102564,0.02564102564102564,0.9743589743589743,39,1050,900,150,0.8571428571428571,12,9,3,357.9063487503594,0.4079228520017994,0.1735593220338989,0.20866081597105904,131150.2338927467,1587.9002700617057,132738.13416280842,1859,0,483.53846153846155,35,4,20,34.75847457627118,0.6339285714285714,43.9236111111111,1024.3055555555538,29.265873015872966,0
3579,4,1,1,38,0.02564102564102564,0.02564102564102564,0.9743589743589743,39,800,600,200,0.75,10,6,4,353.29499636459786,0.4100596041385515,0.16614550760892222,0.20692992644212144,131328.12499999988,1479.7550154320852,132807.88001543196,1860,0,446.4102564102564,33,6,21,34.69681571815719,0.6401515151515151,43.74999999999999,1024.999999999999,31.060606060606034,0
3580,4,0,0,38,0.0,0.0,1.0,38,1050,600,450,0.5714285714285714,15,6,9,367.1002318684153,0.40785028449502136,0.17647076804568074,0.21484472441571634,131297.62081916098,2039.8774092970539,133337.49822845802,1861,1,458.86842105263156,34,4,21,34.37391102334767,0.6375612745098039,43.779761904761905,1024.8809523809523,30.143557422969185,0
3581,4,0,1,37,0.0,0.02631578947368421,0.9736842105263158,38,1050,800,250,0.7619047619047619,13,8,5,362.5303036338528,0.40722795163584635,0.16976609585162983,0.21268783451618598,131390.93888168014,1926.6429365863974,133317.58181826654,1862,2,459.86842105263156,33,5,22,34.396665072914175,0.6407828282828283,43.68872549019608,1025.2450980392157,31.068033273915628,0
3582,4,0,1,36,0.0,0.02702702702702703,0.972972972972973,37,850,500,350,0.5882352941176471,12,5,7,363.22471852914947,0.40618743743743746,0.1833912268694875,0.21414910869901677,131579.47063629367,2158.583237216446,133738.05387351013,1863,3,470.3783783783784,33,4,18,34.18836598184424,0.6426767676767677,43.50490196078431,1025.9803921568623,31.090314913844313,0
3583,4,0,0,36,0.0,0.0,1.0,36,650,300,350,0.46153846153846156,10,3,7,367.55629175320905,0.4053571428571428,0.17695346675415635,0.21711464675654646,131651.87225793276,2477.8947938985784,134129.76705183132,1864,4,465.25,32,4,20,34.00411130249347,0.6458333333333333,43.43434343434343,1026.2626262626254,32.070707070707044,0
3584,4,0,0,36,0.0,0.0,1.0,36,1100,700,400,0.6363636363636364,15,7,8,369.1709976745422,0.4043154761904762,0.1762264846919952,0.218998375206933,131813.89534550047,2532.373450413217,134346.2687959137,1865,5,466.25,32,4,20,33.799028648715115,0.6474609375,43.27651515151515,1026.8939393939393,32.0904356060606,0
3585,4,0,0,36,0.0,0.0,1.0,36,1100,700,400,0.6363636363636364,15,7,8,371.06740717536417,0.40433201058201057,0.17908062930186852,0.22068745795166375,131911.15702479324,2589.586202938458,134500.7432277317,1866,6,467.25,32,4,20,33.6521324975418,0.6484375,43.18181818181817,1027.2727272727261,32.10227272727269,0
3586,4,0,0,36,0.0,0.0,1.0,36,650,500,150,0.7692307692307693,8,5,3,371.876974564498,0.40424933862433865,0.1796627575697345,0.2216196468886506,131988.4197934687,2616.690846068797,134605.11063953748,1867,7,468.25,33,3,20,33.553344265553555,0.646780303030303,43.10661764705881,1027.5735294117633,31.138591800356462,0
3587,4,1,2,35,0.02702702702702703,0.05405405405405406,0.9459459459459459,37,1150,800,350,0.6956521739130435,15,8,7,365.5432440139148,0.40746996996997,0.18560247161427323,0.21986014321588473,132336.75063775506,2274.9610260770896,134611.71166383216,1868,0,456.56756756756755,34,3,21,33.364909946392075,0.6479779411764706,42.76785714285714,1028.9285714285709,30.26260504201679,0
3588,4,0,0,35,0.0,0.0,1.0,35,1300,800,500,0.6153846153846154,18,8,10,380.14715957557684,0.4062675070028012,0.18921554869492008,0.22764106379290414,132170.69686766653,3048.8629986736014,135219.55986634013,1869,1,446.3142857142857,32,3,22,33.15682301899148,0.6510416666666667,42.92929292929293,1028.2828282828282,32.13383838383838,0
3589,4,0,0,35,0.0,0.0,1.0,35,1450,1100,350,0.7586206896551724,18,11,7,379.2800916287925,0.40682773109243703,0.18579667969777214,0.22809988684007584,132333.0388002499,3038.2574163350628,135371.29621658495,1870,2,447.3142857142857,32,3,22,33.01529840062175,0.6526692708333333,42.77146464646464,1028.9141414141409,32.1535669191919,0
3590,4,0,0,35,0.0,0.0,1.0,35,1150,700,450,0.6086956521739131,16,7,9,381.54692780963666,0.406967787114846,0.18953611997090292,0.23028115997588708,132467.17693158166,3108.5207632736924,135575.69769485536,1871,3,448.3142857142857,30,5,22,32.82168037602821,0.659375,42.641129032258064,1029.4354838709676,34.31451612903225,0
3591,4,0,0,35,0.0,0.0,1.0,35,900,700,200,0.7777777777777778,11,7,4,377.6026441589245,0.4060574229691876,0.18279934982842683,0.22870114205950168,132599.0888807509,3013.953314887158,135613.04219563806,1872,4,449.3142857142857,31,4,22,32.79024441635062,0.6579301075268817,42.513020833333336,1029.947916666667,33.22412634408603,0
3592,4,0,0,35,0.0,0.0,1.0,35,1050,700,350,0.6666666666666666,14,7,7,377.5187286088542,0.40549719887955177,0.1902114061851201,0.22926367609223827,132699.68880547426,3019.3235609266544,135719.01236640092,1873,5,450.3142857142857,31,4,19,32.691062176165794,0.6589381720430108,42.415364583333336,1030.3385416666672,33.236727150537654,0
3593,4,0,0,35,0.0,0.0,1.0,35,750,400,350,0.5333333333333333,11,4,7,381.95941336307703,0.4052871148459383,0.19485440046187774,0.23300112750453322,132867.44011772992,3149.9938964843695,136017.4340142143,1874,6,451.3142857142857,31,4,20,32.407699755830606,0.6606182795698925,42.252604166666664,1030.9895833333326,33.257728494623635,0
3594,4,0,0,35,0.0,0.0,1.0,35,1200,700,500,0.5833333333333334,17,7,10,383.16180121329904,0.4053571428571428,0.20052799972026492,0.23486984829061275,133048.52701573828,3195.8226520253165,136244.3496677636,1875,7,452.3142857142857,32,3,20,32.19439685065068,0.6598307291666667,42.07702020202021,1031.6919191919199,32.240372474747495,0
3595,4,0,0,35,0.0,0.0,1.0,35,1100,900,200,0.8181818181818182,13,9,4,381.58701293118844,0.40521708683473384,0.19368031039183498,0.23451821381199525,133146.24304917877,3161.375433629235,136307.618482808,1876,8,453.3142857142857,32,3,21,32.136703776200974,0.6608072916666667,41.98232323232324,1032.0707070707078,32.25220959595962,0
3596,4,0,0,35,0.0,0.0,1.0,35,700,600,100,0.8571428571428571,8,6,2,384.7760405088039,0.4051820728291316,0.20238968661565893,0.23730757611470568,133276.58689164364,3256.327479338835,136532.91437098247,1877,9,454.3142857142857,32,3,21,31.92330031792614,0.662109375,41.8560606060606,1032.575757575757,32.26799242424241,0
3597,4,0,0,35,0.0,0.0,1.0,35,1150,900,250,0.782608695652174,14,9,5,384.21737780334814,0.40486694677871143,0.1947271013025107,0.2377962621170193,133406.99450311196,3251.457121722273,136658.45162483424,1878,10,455.3142857142857,32,3,21,31.806608001303662,0.6634114583333333,41.72979797979798,1033.0808080808083,32.28377525252526,0
3598,4,0,0,35,0.0,0.0,1.0,35,1000,800,200,0.8,12,8,4,382.2548377754143,0.40437675070028006,0.19090706485402276,0.23788869030489368,133611.14724245577,3214.733367331966,136825.88060978774,1879,11,456.3142857142857,30,5,22,31.652203588143525,0.6708333333333334,41.53225806451613,1033.8709677419354,34.46236559139785,0
3599,4,0,0,35,0.0,0.0,1.0,35,1400,1200,200,0.8571428571428571,16,12,4,381.9407976538946,0.4041666666666666,0.19157523438225188,0.23836451240443782,133715.38843002077,3214.2724231124957,136929.66085313327,1880,12,457.3142857142857,30,5,17,31.555663850985486,0.671875,41.431451612903224,1034.2741935483868,34.4758064516129,0
3600,4,2,0,37,0.05405405405405406,0.0,1.0,37,500,300,200,0.6,7,3,4,363.31919811466,0.408252002002002,0.15328653013713578,0.22309600347040706,133113.6670524692,2430.9228708200135,135544.5899232892,1881,0,433.5405405405405,32,5,18,32.640758187528036,0.6604817708333333,42.01388888888889,1031.944444444445,32.24826388888891,7
3601,4,0,0,37,0.0,0.0,1.0,37,1300,1000,300,0.7692307692307693,16,10,6,362.6311990349712,0.40887762762762764,0.15692728678788836,0.22364992049079926,133276.5868916439,2266.0497015610863,135542.63659320498,1882,1,434.5405405405405,32,5,18,32.494955979457096,0.662109375,41.856060606060616,1032.575757575759,32.26799242424247,0
3602,4,0,0,37,0.0,0.0,1.0,37,1250,900,350,0.72,16,9,7,362.5456567093694,0.4085022522522523,0.1586004097006546,0.2239896882086588,133341.7827262525,2268.4968370574607,135610.27956330997,1883,2,435.5405405405405,32,5,18,32.43174409127957,0.6627604166666667,41.7929292929293,1032.8282828282836,32.27588383838386,0
3603,4,0,0,37,0.0,0.0,1.0,37,1000,700,300,0.7,13,7,6,362.81308121033317,0.4081894394394394,0.15605704714615598,0.22435176246271665,133374.386621901,2277.9944329660475,135652.38105486706,1884,3,436.5405405405405,32,5,18,32.39212810169906,0.6630859375,41.76136363636365,1032.9545454545469,32.27982954545459,0
3604,4,0,0,37,0.0,0.0,1.0,37,1050,900,150,0.8571428571428571,12,9,3,359.12051879078933,0.40803303303303307,0.16187161997081345,0.22304708397734468,133537.46588358338,2191.2088052239637,135728.67468880734,1885,4,437.5405405405405,32,5,19,32.32398810978091,0.6647135416666667,41.60353535353536,1033.5858585858591,32.2995580808081,0
3605,4,0,1,36,0.0,0.02702702702702703,0.972972972972973,37,1150,1000,150,0.8695652173913043,13,10,3,356.80645048735033,0.40693818818818817,0.15374158189443254,0.22258961431392912,133700.6447843334,2141.0504986736237,135841.69528300702,1886,5,438.5405405405405,32,5,16,32.2203231188703,0.6663411458333333,41.44570707070708,1034.217171717173,32.319286616161655,0
3606,4,0,1,35,0.0,0.027777777777777776,0.9722222222222222,36,1300,1000,300,0.7692307692307693,16,10,6,365.27058492176985,0.4036044973544974,0.15046412794273878,0.2289566726307751,133876.1732313369,2580.2056206597326,136456.37885199662,1887,6,428.4166666666667,31,5,16,31.825616507297433,0.6706989247311828,41.27604166666667,1034.8958333333342,33.38373655913981,0
3607,4,0,0,35,0.0,0.0,1.0,35,1100,800,300,0.7272727272727273,14,8,6,375.08104855310694,0.4041666666666666,0.1464169713617549,0.23452468161764956,133784.90513715462,3036.036499884386,136820.941637039,1888,7,401.62857142857143,30,5,16,31.66331038066779,0.6725694444444444,41.36424731182796,1034.5430107526886,34.48476702508962,0
3608,4,0,1,34,0.0,0.02857142857142857,0.9714285714285714,35,1400,1100,300,0.7857142857142857,17,11,6,382.237212278726,0.4038165266106442,0.15839344618842222,0.2258466047362005,131661.99578179233,3065.2228461371196,134727.21862792945,1889,8,402.62857142857143,31,4,17,33.6172079844371,0.648521505376344,43.42447916666665,1026.3020833333317,33.10651881720425,8
3609,4,0,0,34,0.0,0.0,1.0,34,1050,800,250,0.7619047619047619,13,8,5,393.19827317049436,0.4017008318478907,0.1648195691946308,0.2189635144890284,129366.91496107297,3373.3695136176025,132740.28447469056,1890,9,412.2647058823529,31,3,21,35.67038376210589,0.6253360215053764,45.67057291666666,1017.317708333332,32.816700268817165,8
3610,4,0,0,34,0.0,0.0,1.0,34,600,500,100,0.8333333333333334,7,5,2,389.9798592561791,0.40173796791443855,0.1646599793812884,0.2179036854757362,129499.41211276568,3300.432501898848,132799.84461466453,1891,10,413.2647058823529,31,3,16,35.616951302716295,0.6266801075268817,45.54036458333332,1017.8385416666654,32.83350134408598,0
3611,4,0,0,34,0.0,0.0,1.0,34,850,600,250,0.7058823529411765,11,6,5,390.8896461954072,0.4014965834818776,0.1651421693997297,0.21896540352779956,129598.82948133672,3331.768120659714,132930.59760199644,1892,11,414.2647058823529,31,3,18,35.49232736572889,0.6276881720430108,45.44270833333333,1018.229166666666,32.84610215053761,0
3612,4,0,0,34,0.0,0.0,1.0,34,1150,1000,150,0.8695652173913043,13,10,3,387.39291000214365,0.40121806298276885,0.1527945874835559,0.21792591809969614,129764.60986667206,3253.9779663085897,133018.58783298064,1893,12,415.2647058823529,31,3,20,35.41227369542066,0.6293682795698925,45.279947916666664,1018.880208333333,32.86710349462365,0
3613,4,0,0,34,0.0,0.0,1.0,34,900,600,300,0.6666666666666666,12,6,6,386.34586152819026,0.4015522875816993,0.14807315185622083,0.2180751081401732,129897.31046888568,3237.0576646592926,133134.36813354498,1894,13,416.2647058823529,31,3,20,35.30370524119726,0.6307123655913979,45.149739583333336,1019.4010416666671,32.883904569892486,0
3614,4,0,0,34,0.0,0.0,1.0,34,800,500,300,0.625,11,5,6,386.8845889753141,0.40075386215092096,0.14926579844419208,0.218801116286039,129972.73875114787,3256.889921946745,133229.62867309462,1895,14,417.2647058823529,32,2,20,35.21313150074294,0.62890625,45.07575757575758,1019.6969696969699,31.865530303030308,0
3615,4,0,0,34,0.0,0.0,1.0,34,1000,700,300,0.7,13,7,6,384.8927188510929,0.3999368686868687,0.14759027373325573,0.2183941831683169,130101.52025303549,3215.025571370281,133316.54582440577,1896,15,418.2647058823529,32,2,20,35.13278671617164,0.6302083333333333,44.949494949494955,1020.2020202020209,31.881313131313153,0
3616,4,0,0,34,0.0,0.0,1.0,34,750,700,50,0.9333333333333333,8,7,1,383.20196967466546,0.4002710932857992,0.14849283358931986,0.21761455495017373,130133.72559241409,3173.4999936231025,133307.22558603718,1897,16,419.2647058823529,32,2,20,35.143134100565106,0.6305338541666667,44.917929292929294,1020.3282828282832,31.88525883838385,0
3617,4,0,0,34,0.0,0.0,1.0,34,850,700,150,0.8235294117647058,10,7,3,380.3415243648479,0.39975118835412954,0.15066026410564226,0.21670621737066928,130262.58680555563,3108.854166666677,133371.4409722223,1898,17,420.2647058823529,32,2,20,35.085034013605444,0.6318359375,44.79166666666667,1020.833333333334,31.90104166666669,0
3618,4,0,0,34,0.0,0.0,1.0,34,800,600,200,0.75,10,6,4,381.510963704392,0.39939839572192515,0.15738650426382472,0.21793084401555318,130362.29663425019,3146.9290839301175,133509.2257181803,1899,18,421.2647058823529,31,3,20,34.953807004122574,0.6354166666666667,44.694010416666664,1021.223958333333,32.94270833333332,0
3619,4,0,0,34,0.0,0.0,1.0,34,550,300,250,0.5454545454545454,8,3,5,380.91858643402423,0.3993426916221034,0.15499092831116656,0.21815235249352974,130462.04460991762,3139.083523220496,133601.12813313812,1900,19,422.2647058823529,31,3,21,34.86755459257372,0.6364247311827957,44.59635416666667,1021.614583333334,32.95530913978497,0
3620,4,1,0,35,0.02857142857142857,0.0,1.0,35,850,600,250,0.7058823529411765,11,6,5,367.2206777116836,0.4037114845938375,0.15309740570880992,0.21229627545271004,130826.15460399838,2608.4138312187515,133434.56843521714,1901,0,411.1714285714286,33,2,18,34.848167225682786,0.6351010101010102,44.24019607843137,1023.0392156862739,31.00118835412951,0
3621,4,0,1,34,0.0,0.02857142857142857,0.9714285714285714,35,1000,900,100,0.9,11,9,2,369.2223978610287,0.40343137254901956,0.15128867301739302,0.21432346694462637,130982.91710219628,2672.3653462610514,133655.28244845732,1902,1,412.1714285714286,33,2,18,34.63812901552335,0.6366792929292929,44.08700980392157,1023.6519607843138,31.019756387403447,0
3622,4,0,0,34,0.0,0.0,1.0,34,900,500,400,0.5555555555555556,13,5,8,369.7595716186407,0.40017825311942956,0.1239993038635574,0.215480577943277,131134.06795224987,2897.6153581267336,134031.6833103766,1903,2,382.9117647058824,32,2,18,34.47130793885603,0.640625,43.939393939393945,1024.242424242425,32.00757575757578,0
3623,4,0,0,34,0.0,0.0,1.0,34,900,500,400,0.5555555555555556,13,5,8,368.2978647948753,0.40051247771836,0.12590235699997132,0.2153534200774648,131263.42337516596,2868.8077109478813,134132.23108611384,1904,3,383.9117647058824,32,2,18,34.377823640545415,0.6419270833333333,43.81313131313132,1024.747474747476,32.023358585858624,0
3624,4,0,0,34,0.0,0.0,1.0,34,1200,900,300,0.75,15,9,6,369.7383183975656,0.399212715389186,0.13049636654760444,0.2167440727126236,131360.48179076132,2913.8007282420363,134274.28251900335,1905,4,384.9117647058824,32,2,18,34.24272283121895,0.6429036458333333,43.71843434343435,1025.126262626264,32.03519570707075,0
3625,4,0,0,34,0.0,0.0,1.0,34,1350,900,450,0.6666666666666666,18,9,9,367.32370401773403,0.39859997029114674,0.1307822053552603,0.21620952198512214,131516.61169982716,2861.833789888527,134378.4454897157,1906,5,385.9117647058824,33,1,18,34.146754281162885,0.6420454545454546,43.566176470588246,1025.7352941176484,31.0828877005348,0
3626,4,0,0,34,0.0,0.0,1.0,34,1250,1000,250,0.8,15,10,5,388.4757513031352,0.39941696375519903,0.15183084023538784,0.2052278300515578,127261.48118640887,3200.0866870972586,130461.56787350612,1907,6,386.9117647058824,30,4,23,37.94930287287419,0.6065972222222222,47.748655913978496,1009.0053763440864,33.633512544802876,8
3627,4,2,0,36,0.05555555555555555,0.0,1.0,36,1150,800,350,0.6956521739130435,15,8,7,370.7737196003294,0.4059523809523809,0.14354856603982857,0.1991044933939574,127920.90730537722,2285.94212325275,130206.84942862997,1908,0,366.3611111111111,32,4,21,37.718942419703765,0.6080729166666667,47.095959595959606,1011.6161616161634,31.613005050505105,0
3628,4,0,0,36,0.0,0.0,1.0,36,1150,900,250,0.782608695652174,14,9,5,369.79244702209553,0.40504298941798944,0.14155056491301043,0.19905214660054388,128016.72222541082,2267.9233942965225,130284.64561970734,1909,1,367.3611111111111,32,4,21,37.645560407569135,0.6090494791666667,47.00126262626264,1011.9949494949508,31.624842171717212,0
3629,4,2,0,38,0.05263157894736842,0.0,1.0,38,950,600,350,0.631578947368421,13,6,7,351.18417668413673,0.41308084400189665,0.1388198422133362,0.19216482476985913,128672.41753472228,1437.6071717809511,130110.02470650323,1910,0,348.9736842105263,33,5,18,37.44652635181383,0.6133207070707071,46.35416666666667,1014.5833333333338,30.74494949494951,0
3630,4,0,1,37,0.0,0.02631578947368421,0.9736842105263158,38,1150,800,350,0.6956521739130435,15,8,7,352.23366732939166,0.41253259838786155,0.13819523449367277,0.19304083382890083,128734.5931402585,1468.9315707900748,130203.52471104857,1911,1,349.9736842105263,33,5,19,37.35647365455058,0.6139520202020202,46.29289215686274,1014.8284313725485,30.752376708259046,0
3631,4,0,2,35,0.0,0.05405405405405406,0.9459459459459459,37,1350,1000,350,0.7407407407407407,17,10,7,356.8106952916216,0.41009759759759756,0.12921761746827043,0.19642905011844694,128912.72454660227,1799.4877754820798,130712.21232208435,1912,2,358.35135135135135,32,5,21,37.05862240457541,0.6181640625,46.117424242424235,1015.5303030303021,31.73532196969694,0
3632,4,0,0,35,0.0,0.0,1.0,35,1250,1100,150,0.88,14,11,3,375.7447103842469,0.40444677871148454,0.14827462189327867,0.20533999487834229,128621.2843428429,2665.7534469302564,131287.03778977317,1913,3,379.6,30,5,21,36.87585574842101,0.6204861111111111,46.404569892473106,1014.3817204301058,33.81272401433686,0
3633,4,0,0,35,0.0,0.0,1.0,35,800,600,200,0.75,10,6,4,377.00385739647993,0.40462184873949575,0.1532539787672924,0.20638158952037883,128689.46419022416,2703.2848812001225,131392.74907142427,1914,4,380.6,30,5,21,36.77418642645826,0.6211805555555556,46.33736559139784,1014.6505376344073,33.82168458781358,0
3634,4,1,0,36,0.027777777777777776,0.0,1.0,36,950,700,250,0.7368421052631579,12,7,5,367.7594424202752,0.408994708994709,0.15501608449340964,0.20359788705905432,129135.2081298827,2298.138427734361,131433.34655761707,1915,0,371.0,31,5,22,36.55361260568794,0.622983870967742,45.89843749999999,1016.4062499999991,32.78729838709675,0
3635,4,3,2,37,0.07692307692307693,0.05128205128205128,0.9487179487179487,39,650,200,450,0.3076923076923077,11,2,9,340.47213485690384,0.41857849752586596,0.1521036180074009,0.19233531417641983,129928.59977324257,1047.413548752823,130976.0133219954,1916,0,343.38461538461536,34,5,20,36.44106141989723,0.6237745098039216,45.11904761904761,1019.5238095238091,29.98599439775909,0
3636,4,1,0,38,0.02631578947368421,0.0,1.0,38,900,700,200,0.7777777777777778,11,7,4,349.92245804507525,0.4157035324798483,0.1608018423266966,0.19762423139694357,129918.78311526799,1492.299986783907,131411.0831020519,1917,0,353.2368421052632,33,5,23,36.21015646912689,0.6259469696969697,45.128676470588225,1019.4852941176456,30.893493761140775,0
3637,4,0,0,38,0.0,0.0,1.0,38,1450,1100,350,0.7586206896551724,18,11,7,351.88515737711793,0.41457740635372214,0.15774934574004096,0.19984964667952826,130137.51471789693,1558.6919694348323,131696.20668733175,1918,1,354.2368421052632,33,5,23,35.93812555048442,0.6281565656565656,44.91421568627451,1020.3431372549018,30.919489007724295,0
3638,4,0,0,38,0.0,0.0,1.0,38,750,700,50,0.9333333333333333,8,7,1,350.9337445924498,0.41491820768136556,0.15808119433927703,0.1994693031550394,130168.77710796313,1536.1232759034822,131704.90038386662,1919,2,355.2368421052632,33,5,23,35.930682318562106,0.6284722222222222,44.88357843137254,1020.4656862745086,30.923202614379047,0
3639,4,1,0,39,0.02564102564102564,0.0,1.0,39,1200,900,300,0.75,15,9,6,343.36638968200924,0.41734143049932526,0.15911121469914158,0.19655950566119562,130444.94224773246,1158.0817743764223,131603.02402210888,1920,0,347.1025641025641,34,5,24,35.84396729207941,0.6289828431372548,44.61309523809524,1021.5476190476193,30.04551820728292,0
3640,4,2,0,41,0.04878048780487805,0.0,1.0,41,1200,800,400,0.6666666666666666,16,8,8,325.7622301432038,0.42060467479674796,0.15507218396722156,0.18994443880657602,131155.04017531063,345.07167640615023,131500.11185171676,1921,0,331.1219512195122,36,5,22,35.57676451187334,0.6319444444444444,43.918918918918926,1024.3243243243257,28.45345345345349,0
3641,4,0,1,40,0.0,0.024390243902439025,0.975609756097561,41,500,500,0,1.0,5,5,0,325.61249839985226,0.42037601626016263,0.15645893763839802,0.19014265150461218,131212.72243527326,344.90047479914296,131557.62291007242,1922,1,332.1219512195122,36,5,22,35.522459148530814,0.6325231481481481,43.86261261261262,1024.5495495495506,28.459709709709742,0
3642,4,0,1,39,0.0,0.025,0.975,40,850,500,350,0.5882352941176471,12,5,7,333.21009269916925,0.41649305555555555,0.1620832862470336,0.19411297631961485,131120.5970963007,738.1412626457648,131858.7383589465,1923,2,341.25,35,5,22,35.420786717896576,0.6336309523809525,43.952546296296305,1024.189814814816,29.262566137566168,0
3643,4,0,0,39,0.0,0.0,1.0,39,1000,500,500,0.5,15,5,10,340.9580061756115,0.41230881691408006,0.1667218311014107,0.19796744733991115,130992.77388038552,1132.607001133794,132125.38088151932,1924,3,350.6666666666667,34,5,23,35.35149435980929,0.6344975490196079,44.077380952380956,1023.6904761904765,30.108543417366956,0
3644,4,0,0,39,0.0,0.0,1.0,39,1450,1200,250,0.8275862068965517,17,12,5,342.68313702958915,0.4128430049482681,0.1684137331594957,0.19978562336705302,131150.23389274697,1188.5947145061796,132338.82860725315,1925,4,351.6666666666667,35,4,23,35.14830508474577,0.6339285714285714,43.923611111111114,1024.3055555555559,29.265873015873026,0
3645,4,0,0,39,0.0,0.0,1.0,39,950,800,150,0.8421052631578947,11,8,3,339.769273186505,0.4123369320737742,0.16592819122749103,0.19869994351342898,131268.81456832992,1120.221943587113,132389.03651191705,1926,5,352.6666666666667,35,4,23,35.10324900233418,0.6351190476190476,43.807870370370374,1024.7685185185187,29.279100529100536,0
3646,4,0,0,39,0.0,0.0,1.0,39,700,200,500,0.2857142857142857,12,2,10,339.9270702047319,0.4118870895186684,0.16916416916416877,0.1989460810748778,131298.4681096751,1126.380717378254,132424.84882705336,1927,6,353.6666666666667,35,4,23,35.0692875964615,0.6354166666666667,43.77893518518518,1024.8842592592594,29.28240740740741,0
3647,4,0,1,38,0.0,0.02564102564102564,0.9743589743589743,39,1550,1100,450,0.7096774193548387,20,11,9,341.4689394121355,0.41169028340080976,0.16889547954464934,0.20016263017548677,131358.63272392293,1170.9819487530083,132529.61467267593,1928,7,354.6666666666667,34,5,23,34.96908024619673,0.6381740196078431,43.720238095238095,1025.1190476190477,30.150560224089638,0
3648,4,0,0,38,0.0,0.0,1.0,38,1350,900,450,0.6666666666666666,18,9,9,350.8134885331877,0.4105174253200569,0.17713632361573084,0.2051496269900598,131267.12018140592,1610.055272108846,132877.17545351476,1929,8,363.2105263157895,34,4,23,34.82201634138785,0.6372549019607843,43.80952380952381,1024.7619047619048,30.140056022408967,0
3649,4,0,1,37,0.0,0.02631578947368421,0.9736842105263158,38,750,400,350,0.5333333333333333,11,4,7,350.8134885331877,0.41029516358463725,0.17713632361573084,0.2051496269900598,131267.12018140592,1610.055272108846,132877.17545351476,1930,9,364.2105263157895,34,4,23,34.82201634138785,0.6372549019607843,43.80952380952381,1024.7619047619048,30.140056022408967,0
3650,4,0,0,37,0.0,0.0,1.0,37,1100,800,300,0.7272727272727273,14,8,6,349.29590799530604,0.40853353353353355,0.1665681457721615,0.20509184997871752,131422.35145436847,1781.0720887619716,133203.42354313046,1931,10,368.0810810810811,33,4,23,34.70417015258356,0.6410984848484849,43.658088235294116,1025.3676470588234,31.071746880570405,0
3651,4,0,0,37,0.0,0.0,1.0,37,1200,900,300,0.75,15,9,6,345.9713374697937,0.4082207207207207,0.16456498281010834,0.2036126395928785,131511.22448979586,1699.8228458049841,133211.04733560083,1932,11,369.0810810810811,34,3,23,34.699734989167446,0.6397058823529411,43.57142857142857,1025.714285714285,30.168067226890738,0
3652,4,0,0,37,0.0,0.0,1.0,37,700,500,200,0.7142857142857143,9,5,4,348.5998137391593,0.4081268768768769,0.16557973286511585,0.20581715030353112,131633.3616780046,1777.4730725623656,133410.83475056698,1933,12,370.0810810810811,34,3,17,34.509135730858475,0.6409313725490196,43.452380952380956,1026.1904761904768,30.18207282913167,0
3653,4,0,1,36,0.0,0.02702702702702703,0.972972972972973,37,700,400,300,0.5714285714285714,10,4,6,349.47771420429916,0.40806431431431434,0.1673274805595346,0.20683228068522128,131725.0017715421,1806.990504535167,133531.99227607728,1934,13,371.0810810810811,34,3,17,34.39420735242955,0.6418504901960784,43.36309523809525,1026.5476190476202,30.19257703081236,0
3654,4,0,0,36,0.0,0.0,1.0,36,1200,1000,200,0.8333333333333334,14,10,4,359.51279648036916,0.4045138888888889,0.16925103175551026,0.212135352003533,131610.90573637557,2263.160953719741,133874.06669009532,1935,14,382.02777777777777,33,3,17,34.25183625940522,0.6429924242424243,43.47426470588236,1026.1029411764719,31.094028520499148,0
3655,4,0,0,36,0.0,0.0,1.0,36,1000,500,500,0.5,15,5,10,360.85044001645673,0.4043650793650793,0.16439828080229213,0.21345220943346338,131705.23356401385,2305.17829680892,134010.41186082276,1936,15,383.02777777777777,33,3,19,34.12229385546005,0.6439393939393939,43.38235294117647,1026.4705882352941,31.10516934046346,0
3656,4,0,0,36,0.0,0.0,1.0,36,1200,1000,200,0.8333333333333334,14,10,4,362.7549599622641,0.4044312169312169,0.1586472795745979,0.21511138071647612,131799.59518274208,2362.1913747116323,134161.7865574537,1937,16,384.02777777777777,33,3,20,33.978174603174594,0.6448863636363636,43.29044117647058,1026.8382352941167,31.116310160427776,0
3657,4,0,0,36,0.0,0.0,1.0,36,1100,500,600,0.45454545454545453,17,5,12,366.85178360801433,0.40472883597883597,0.12574808209824484,0.2039184830651649,129294.84941188485,2314.8275302768184,131609.67694216166,1938,17,385.02777777777777,33,3,21,36.41390026910874,0.6196338383838385,45.74142156862745,1017.0343137254902,30.819221628045156,8
3658,4,1,1,36,0.02702702702702703,0.02702702702702703,0.972972972972973,37,800,300,500,0.375,13,3,10,356.38685427021704,0.4082832832832833,0.12823226499439255,0.1999271828381447,129655.65653344677,1841.5143140589664,131497.17084750574,1939,0,375.5945945945946,34,3,21,36.31282875511397,0.6210171568627452,45.386904761904766,1018.4523809523814,29.9544817927171,0
3659,4,0,0,36,0.0,0.0,1.0,36,1050,600,450,0.5714285714285714,15,6,9,362.9857002448189,0.4070436507936508,0.1328259736092734,0.20369845744326048,129669.02941476826,2213.6006884371263,131882.6301032054,1940,1,384.27777777777777,33,3,21,36.131206633778525,0.6234217171717171,45.373774509803916,1018.5049019607835,30.86378490790253,0
3660,4,0,0,36,0.0,0.0,1.0,36,800,500,300,0.625,11,5,6,362.70340120692026,0.40701058201058204,0.13445807770961138,0.20386432550595862,129731.44531250001,2210.807291666667,131942.2526041667,1941,2,385.27777777777777,33,3,21,36.07489775051123,0.6240530303030303,45.3125,1018.7500000000001,30.871212121212125,0
3661,4,0,0,36,0.0,0.0,1.0,36,1150,800,350,0.6956521739130435,15,8,7,362.48991965847114,0.40692791005291,0.13251716491678045,0.20455842277606262,129887.55076172622,2216.585568050744,132104.13632977696,1942,3,386.27777777777777,33,3,21,35.92159573615452,0.6256313131313131,45.15931372549019,1019.3627450980389,30.889780154486026,0
3662,4,1,0,37,0.02702702702702703,0.0,1.0,37,850,700,150,0.8235294117647058,10,7,3,354.6855476884629,0.4089089089089089,0.1352454495311637,0.20208827717133376,130262.58680555565,1840.4513888888982,132103.03819444455,1943,0,376.81081081081084,34,3,23,35.73979591836734,0.6271446078431373,44.79166666666667,1020.8333333333342,30.024509803921593,0
3663,4,0,0,37,0.0,0.0,1.0,37,1550,1100,450,0.7096774193548387,20,11,9,357.8546346408588,0.4091278778778779,0.13435385727577187,0.20504701642617448,130481.60750973174,1938.6895965493914,132420.29710628113,1944,1,377.81081081081084,33,4,23,35.43678281556116,0.6316287878787878,44.577205882352935,1021.6911764705874,30.960338680926892,0
3664,4,1,1,37,0.02631578947368421,0.02631578947368421,0.9736842105263158,38,1000,600,400,0.6,14,6,8,352.83549399635984,0.4095098387861546,0.14764330274330661,0.20453990167813235,130931.84700963703,1639.4805839002067,132571.32759353722,1945,0,368.8421052631579,34,4,19,35.109146601527655,0.6338848039215687,44.13690476190475,1023.4523809523797,30.101540616246464,0
3665,4,1,0,38,0.02631578947368421,0.0,1.0,38,800,500,300,0.625,11,5,6,354.0478547539899,0.4090208629682314,0.15317123312815917,0.20605680964775452,131084.1907596368,1682.0153061224103,132766.2060657592,1946,0,369.7631578947368,34,4,20,34.92404867085176,0.6354166666666667,43.98809523809522,1024.047619047616,30.11904761904753,0
3666,4,0,1,37,0.0,0.02631578947368421,0.9736842105263158,38,1100,800,300,0.7272727272727273,14,8,6,355.12034575792586,0.40813181602655285,0.14959173063396425,0.2071735983218268,131175.63952664364,1716.6276927437234,132892.26721938737,1947,1,370.7631578947368,34,4,20,34.80413519271741,0.6363357843137255,43.898809523809504,1024.4047619047592,30.12955182072821,0
3667,4,0,0,37,0.0,0.0,1.0,37,700,400,300,0.5714285714285714,10,4,6,363.92060385759726,0.40387262262262263,0.15558093709656018,0.21124592105785298,130982.91710219604,2133.476457372133,133116.39355956815,1948,2,381.56756756756755,33,4,20,34.773808811205555,0.6366792929292929,44.08700980392155,1023.6519607843118,31.019756387403387,0
3668,4,0,1,36,0.0,0.02702702702702703,0.972972972972973,37,1200,900,300,0.75,15,9,6,362.9594786751537,0.4039351851851852,0.1500991238935474,0.21137647130928633,131108.39468293445,2117.4069168108363,133225.8015997453,1949,3,382.56756756756755,33,4,20,34.67140820070997,0.6379419191919191,43.96446078431372,1024.142156862745,31.034610814022574,0
3669,4,0,0,36,0.0,0.0,1.0,36,750,300,450,0.4,12,3,9,371.68910596886053,0.39960317460317457,0.15705563093622765,0.21569674889688994,130972.46334876544,2536.2075617283945,133508.67091049382,1950,4,393.30555555555554,32,4,20,34.5855947535052,0.6389973958333333,44.09722222222222,1023.6111111111112,31.987847222222225,0
3670,4,0,0,36,0.0,0.0,1.0,36,1550,1100,450,0.7096774193548387,20,11,9,372.74741113633274,0.39869378306878306,0.15622688039457455,0.2168566358906499,131069.41415416797,2571.1569610243864,133640.57111519235,1951,5,394.30555555555554,32,4,20,34.46028565556926,0.6399739583333333,44.00252525252525,1023.9898989898992,31.99968434343435,0
3671,4,1,0,37,0.02702702702702703,0.0,1.0,37,1250,900,350,0.72,16,9,7,368.14596654411406,0.4034972472472473,0.14514347002991546,0.21598240926423956,131390.9388816801,2274.2088379469405,133665.14771962704,1952,0,384.6216216216216,33,4,21,34.25272930113954,0.6407828282828283,43.68872549019608,1025.2450980392155,31.06803327391562,0
3672,4,0,0,37,0.0,0.0,1.0,37,900,700,200,0.7777777777777778,11,7,4,369.6338262184025,0.4039039039039039,0.14011430785624324,0.2175692774576673,131516.61169982693,2322.597678777386,133839.2093786043,1953,1,385.6216216216216,33,4,21,34.08751493428912,0.6420454545454546,43.56617647058823,1025.7352941176466,31.082887700534744,0
3673,4,0,0,37,0.0,0.0,1.0,37,1500,1300,200,0.8666666666666667,17,13,4,366.7822468160726,0.404247997997998,0.1301659826015127,0.21696102396408345,131705.23356401373,2261.428296808906,133966.66186082264,1954,2,386.6216216216216,33,4,19,33.97007322508756,0.6439393939393939,43.382352941176464,1026.4705882352932,31.10516934046343,0
3674,4,0,2,35,0.0,0.05405405405405406,0.9459459459459459,37,1000,600,400,0.6,14,6,8,367.8397895658362,0.4039977477477477,0.1316059434942225,0.21794637602422712,131768.13755526696,2293.912797962292,134062.05035322925,1955,3,387.6216216216216,33,4,19,33.87940638179359,0.6445707070707071,43.321078431372534,1026.7156862745078,31.112596553772963,0
3675,4,0,0,35,0.0,0.0,1.0,35,1300,900,400,0.6923076923076923,17,9,8,385.8531614483143,0.3978641456582633,0.14512747978094542,0.22718618878100305,131528.3966064453,3150.1295301649307,134678.52613661025,1956,10,409.7142857142857,31,4,20,33.6596640433274,0.6471774193548387,43.5546875,1025.78125,33.08971774193548,0
3676,4,0,0,35,0.0,0.0,1.0,35,800,600,200,0.75,10,6,4,386.28406829975563,0.39751400560224087,0.14542817253821227,0.22763890606834505,131561.79004245327,3164.044698079422,134725.83474053268,1957,11,410.7142857142857,31,4,19,33.6148041206583,0.647513440860215,43.522135416666664,1025.9114583333328,33.093918010752674,0
3677,4,0,0,35,0.0,0.0,1.0,35,1000,900,100,0.9,11,9,2,387.5116609935652,0.3978641456582633,0.14447384637691663,0.22896303687790723,131661.9957817926,3204.1117350260515,134866.10751681865,1958,12,411.7142857142857,31,4,19,33.48187854182526,0.648521505376344,43.42447916666667,1026.302083333334,33.10651881720432,0
3678,4,1,0,36,0.027777777777777776,0.0,1.0,36,700,400,300,0.5714285714285714,10,4,6,374.90320426586953,0.39923941798941803,0.1453497891849853,0.22430836093585427,132138.24043783802,2707.809949239879,134846.0503870779,1959,0,401.25,32,4,21,33.32437881206761,0.6507161458333333,42.96085858585859,1028.156565656566,32.12989267676769,0
3679,4,0,0,36,0.0,0.0,1.0,36,750,500,250,0.6666666666666666,10,5,5,399.52480461673855,0.39923941798941803,0.04826139088728998,0.24145194713794166,132517.14677640583,3388.7774348422263,135905.92421124806,1960,1,402.25,35,1,16,32.30852817745803,0.6476190476190475,42.59259259259258,1029.6296296296282,29.41798941798938,8
3680,4,0,1,35,0.0,0.027777777777777776,0.9722222222222222,36,750,500,250,0.6666666666666666,10,5,5,401.8943004493789,0.3989914021164021,0.05141246112921927,0.2430763828074861,132546.94097490128,3453.972023962601,136000.91299886387,1961,2,403.25,35,1,16,32.21743752575773,0.6479166666666667,42.5636574074074,1029.7453703703693,29.421296296296266,0
3681,4,0,0,35,0.0,0.0,1.0,35,550,300,250,0.5454545454545454,8,3,5,410.6405125894348,0.39670868347338933,0.06489540993357812,0.24758702035203994,132428.63520408157,3876.1125283446618,136304.74773242624,1962,16,415.7142857142857,34,1,16,32.11191109568972,0.6488970588235294,42.67857142857142,1029.2857142857138,30.273109243697462,0
3682,4,0,0,35,0.0,0.0,1.0,35,1050,700,350,0.6666666666666666,14,7,7,408.4332921246954,0.39586834733893556,0.062361684558216446,0.24705929908242033,132551.19756235805,3827.6643990929438,136378.86196145098,1963,17,416.7142857142857,34,1,16,32.044797687861255,0.6501225490196079,42.559523809523796,1029.761904761903,30.287114845938323,0
3683,4,0,0,35,0.0,0.0,1.0,35,700,200,500,0.2857142857142857,12,2,10,403.45904211889075,0.39527310924369746,0.06029251543464631,0.24484814519613454,132673.81660997722,3705.6901927437493,136379.50680272098,1964,18,417.7142857142857,34,1,16,32.04900431399737,0.6513480392156863,42.44047619047618,1030.2380952380945,30.30112044817925,0
3684,4,0,0,35,0.0,0.0,1.0,35,1050,700,350,0.6666666666666666,14,7,7,401.4435513550129,0.39527310924369746,0.055460244143847204,0.24482402498129657,132857.85147392284,3666.985544217682,136524.83701814053,1965,19,418.7142857142857,34,1,16,31.915175134719018,0.6531862745098039,42.26190476190476,1030.9523809523805,30.322128851540604,0
3685,4,0,0,35,0.0,0.0,1.0,35,1200,900,300,0.75,15,9,6,405.9390178019163,0.39544817927170867,0.06286637433648723,0.24878836833602586,133042.01388888882,3801.3888888888787,136843.4027777777,1966,20,419.7142857142857,34,1,16,31.613489499192244,0.6550245098039216,42.08333333333333,1031.666666666666,30.343137254901944,0
3686,4,0,1,34,0.0,0.02857142857142857,0.9714285714285714,35,900,600,300,0.6666666666666666,12,6,6,407.21628226567134,0.39450280112044817,0.07325753830944182,0.25039469271229564,133164.85969387743,3845.3798185940923,137010.2395124715,1967,21,420.7142857142857,34,1,16,31.456651287966164,0.65625,41.96428571428571,1032.1428571428562,30.35714285714283,0
3687,4,0,0,34,0.0,0.0,1.0,34,1200,800,400,0.6666666666666666,16,8,8,410.09706384733784,0.38955733808674986,0.10081241799045215,0.2533942854915956,133345.6182718185,4136.929306036141,137482.54757785465,1968,23,433.47058823529414,33,1,16,31.200067236196812,0.6603535353535354,41.78921568627451,1032.8431372549019,31.298276886512177,0
3688,4,0,0,34,0.0,0.0,1.0,34,950,800,150,0.8421052631578947,11,8,3,410.4052796328442,0.38887032085561496,0.10484067900674687,0.2542341596314849,133440.56560277296,4152.942528114183,137593.50813088714,1969,24,434.47058823529414,33,1,16,31.09642490017,0.661300505050505,41.697303921568626,1033.2107843137253,31.309417706476523,0
3689,4,0,0,34,0.0,0.0,1.0,34,400,100,300,0.25,7,1,6,410.2695418896179,0.38861036838978014,0.10127205433181197,0.2545910690194484,133504.84206012153,4154.597832975934,137659.43989309747,1970,25,435.47058823529414,32,2,16,31.035176135206676,0.6643880208333333,41.63510101010102,1033.459595959597,32.295612373737406,0
3690,4,0,0,34,0.0,0.0,1.0,34,1150,800,350,0.6956521739130435,15,8,7,413.4632156610177,0.38773767082590616,0.0971988795518206,0.25770652482981243,133668.00103305787,4253.3603076216705,137921.36134067955,1971,26,436.47058823529414,32,2,16,30.788308913308907,0.666015625,41.47727272727273,1034.0909090909092,32.315340909090914,0
3691,4,0,0,34,0.0,0.0,1.0,34,1000,600,400,0.6,14,6,8,411.94439368113166,0.3872363339275104,0.09077691860339887,0.2574416794377965,133765.94424357213,4220.826159320478,137986.7704028926,1972,27,437.47058823529414,32,2,16,30.728975955083605,0.6669921875,41.38257575757576,1034.4696969696972,32.32717803030304,0
3692,4,0,0,34,0.0,0.0,1.0,34,500,400,100,0.8,6,4,2,413.5788839608222,0.387106357694593,0.09975454310567566,0.25915080527086387,133863.92332415062,4272.65840220386,138136.5817263545,1973,28,438.47058823529414,32,2,16,30.58809175207418,0.66796875,41.28787878787879,1034.848484848485,32.339015151515156,0
3693,4,0,0,34,0.0,0.0,1.0,34,1350,900,450,0.6666666666666666,18,9,9,414.1478526269366,0.3874591503267974,0.09783474311788365,0.26019909913319966,133961.93827479344,4296.009814049593,138257.94808884303,1974,29,439.47058823529414,32,2,17,30.474753018660813,0.6689453125,41.19318181818182,1035.2272727272732,32.35085227272729,0
3694,4,0,0,34,0.0,0.0,1.0,34,750,300,450,0.4,12,3,9,415.64703902271697,0.3871434937611408,0.10205208363208751,0.26230525447248987,134125.3762371186,4349.763098153237,138475.13933527182,1975,30,440.47058823529414,32,2,17,30.271564683894034,0.6705729166666667,41.03535353535353,1035.8585858585852,32.37058080808079,0
3695,4,0,0,34,0.0,0.0,1.0,34,1300,1000,300,0.7692307692307693,16,10,6,420.76844876142894,0.38671642899584074,0.11052073405802854,0.2667249572110091,134288.91383851125,4500.907592337502,138789.82143084874,1976,31,441.47058823529414,32,2,17,29.974469078653517,0.6722005208333333,40.877525252525245,1036.489898989898,32.39030934343431,0
3696,4,1,0,35,0.02857142857142857,0.0,1.0,35,1000,500,500,0.5,15,5,10,411.3901150161587,0.387640056022409,0.10632102025923484,0.2638416166663694,134714.57791296803,4084.3042164064864,138798.8821293745,1977,0,429.8285714285714,32,3,19,29.790247709397548,0.6764322916666667,40.467171717171716,1038.131313131313,32.44160353535353,0
3697,4,0,0,35,0.0,0.0,1.0,35,750,400,350,0.5333333333333333,11,4,7,410.57590088540235,0.3876750700280112,0.1073435138374943,0.26355703614212833,134747.3492022498,4064.8028581267254,138812.15206037654,1978,1,430.8285714285714,32,3,19,29.778517572662047,0.6767578125,40.43560606060606,1038.257575757576,32.44554924242425,0
3698,4,0,0,35,0.0,0.0,1.0,35,1150,800,350,0.6956521739130435,15,8,7,409.75201649532926,0.3870798319327731,0.10997081712062262,0.26326567059824896,134780.12447709413,4045.2855575961576,138825.41003469029,1979,2,431.8285714285714,32,3,17,29.767043612191955,0.6770833333333333,40.4040404040404,1038.383838383838,32.44949494949494,0
3699,4,0,0,35,0.0,0.0,1.0,35,700,400,300,0.5714285714285714,10,4,6,404.20124855646196,0.3859243697478992,0.1065986146554867,0.26087624112714725,134944.06063475672,3908.9115587695205,138852.97219352625,1980,3,432.8285714285714,32,3,18,29.746931583424473,0.6787109375,40.246212121212125,1039.015151515152,32.4692234848485,0
3700,4,0,0,35,0.0,0.0,1.0,35,1200,800,400,0.6666666666666666,16,8,8,403.6852462777098,0.3849789915966386,0.11405671179362886,0.26183987992508284,135123.5402249132,3909.4759227219947,139033.01614763518,1981,4,433.8285714285714,33,2,19,29.58068128241395,0.678030303030303,40.07352941176469,1039.7058823529387,31.506238859179962,0
3701,4,0,1,34,0.0,0.02857142857142857,0.9714285714285714,35,1050,800,250,0.7619047619047619,13,8,5,406.5321092348021,0.38518907563025206,0.11279772425053447,0.2643860544885643,135219.11832288053,3994.1826761341695,139213.3009990147,1982,5,434.8285714285714,33,2,19,29.41103550528258,0.6789772727272727,39.98161764705882,1040.073529411764,31.517379679144362,0
3702,4,0,0,34,0.0,0.0,1.0,34,600,400,200,0.6666666666666666,8,4,4,402.8723600549946,0.384451128936423,0.10472528233908407,0.2627024836303303,135314.7302119375,4102.912942137611,139417.6431540751,1983,6,441.70588235294116,33,1,19,29.410581075775408,0.6799242424242424,39.88970588235293,1040.4411764705867,31.528520499108687,0
3703,4,0,0,34,0.0,0.0,1.0,34,650,200,450,0.3076923076923077,11,2,9,401.37403242257045,0.3839497920380273,0.09718383997894464,0.26242260641762033,135410.37589208462,4070.0417207323944,139480.41761281702,1984,7,442.70588235294116,33,1,19,29.35395325562229,0.6808712121212122,39.79779411764705,1040.8088235294106,31.539661319073048,0
3704,4,0,0,34,0.0,0.0,1.0,34,750,600,150,0.8,9,6,3,402.0189529194235,0.38335561497326204,0.10118103967490288,0.26378031219740045,135537.9560295317,4097.765432766222,139635.72146229792,1985,8,443.70588235294116,33,1,19,29.209696559570045,0.6821338383838385,39.675245098039206,1041.2990196078415,31.554515745692168,0
3705,4,1,0,35,0.02857142857142857,0.0,1.0,35,700,400,300,0.5714285714285714,10,4,6,396.1609252625431,0.3868697478991597,0.0898936352132429,0.2301480090155275,131014.28086553245,3385.687746299498,134399.96861183195,1986,0,432.0,33,2,17,33.9168861224164,0.6369949494949495,44.056372549019606,1023.7745098039213,31.02346999405822,8
3706,4,0,0,35,0.0,0.0,1.0,35,750,500,250,0.6666666666666666,10,5,5,394.44280137725036,0.3865546218487395,0.09454944032949197,0.22956677790575816,131084.1907596371,3341.043083900219,134425.2338435373,1987,1,433.0,34,1,18,33.889889948074085,0.6354166666666667,43.988095238095234,1024.0476190476184,30.1190476190476,0
3707,4,1,0,36,0.027777777777777776,0.0,1.0,36,1050,800,250,0.7619047619047619,13,8,5,384.8794698119685,0.3906580687830688,0.09271728194412177,0.22614950565895608,131450.17715419497,2918.7216553287954,134368.89880952376,1988,0,421.94444444444446,34,2,19,33.76383406857053,0.639093137254902,43.63095238095238,1025.4761904761904,30.161064425770306,0
3708,4,1,0,37,0.02702702702702703,0.0,1.0,37,800,500,300,0.625,11,5,6,374.07700339622136,0.39645895895895894,0.09079839556871327,0.21172758392226163,130004.05811216644,2326.3056975895074,132330.36380975595,1989,0,411.5135135135135,36,1,17,35.50776648998823,0.6203703703703703,45.04504504504506,1019.8198198198216,28.32832832832838,7
3709,4,0,0,37,0.0,0.0,1.0,37,900,800,100,0.8888888888888888,10,8,2,370.1745537476425,0.3970533033033033,0.09454686474554075,0.21013668276651915,130118.92804967143,2233.3432249817583,132352.2712746532,1990,1,412.5135135135135,36,1,17,35.49048013245035,0.6215277777777778,44.93243243243244,1020.2702702702715,28.340840840840873,0
3710,4,0,0,37,0.0,0.0,1.0,37,950,800,150,0.8421052631578947,11,8,3,370.5717388751113,0.3967717717717718,0.09178393885444547,0.2108281022865748,130205.11379200162,2250.067085666767,132455.18087766838,1991,2,413.5135135135135,36,1,17,35.3927599396815,0.6223958333333333,44.84797297297298,1020.6081081081094,28.35022522522526,0
3711,4,0,0,37,0.0,0.0,1.0,37,900,600,300,0.6666666666666666,12,6,6,406.03320202436885,0.3961461461461462,0.045799494075356106,0.2227695675971539,128778.12500000012,3094.2633511890435,131872.38835118915,1992,3,414.5135135135135,34,3,16,35.94690749863164,0.6121323529411764,46.25000000000001,1015.0000000000009,29.852941176470615,8
3712,4,0,0,37,0.0,0.0,1.0,37,1150,900,250,0.782608695652174,14,9,5,403.31289303364764,0.3962087087087087,0.0438717934908297,0.22212151649257916,128929.21095521556,2999.7626133786966,131928.97356859426,1993,4,415.5135135135135,34,3,17,35.86112413550579,0.6136642156862745,46.10119047619048,1015.5952380952392,29.87044817927174,0
3713,4,1,1,37,0.02631578947368421,0.02631578947368421,0.9736842105263158,38,800,700,100,0.875,9,7,2,389.4933964443063,0.4006786391654813,0.04079621364167396,0.2161528419307159,129230.80800165057,2466.9092667609975,131697.71726841156,1994,0,405.55263157894734,35,3,18,35.90364731549992,0.6145833333333333,45.80439814814816,1016.782407407409,29.05092592592597,0
3714,4,0,0,37,0.0,0.0,1.0,37,450,200,250,0.4444444444444444,7,2,5,397.31715442524796,0.3959897397397398,0.04349518742304759,0.22016166006730659,129171.13272392299,2864.381377551028,132035.51410147402,1995,1,417.35135135135135,34,3,18,35.76580005465119,0.6161151960784313,45.86309523809524,1016.5476190476197,29.898459383753522,0
3715,4,2,0,39,0.05128205128205128,0.0,1.0,39,750,500,250,0.6666666666666666,10,5,5,381.8474183313177,0.4024403958614485,0.07154897178099051,0.21533339459917528,129860.54202428808,2117.3825430160264,131977.92456730412,1996,0,396.8974358974359,36,3,17,35.455796781202835,0.6189236111111112,45.18581081081083,1019.256756756759,28.312687687687752,0
3716,4,0,2,37,0.0,0.05128205128205128,0.9487179487179487,39,900,500,400,0.5555555555555556,13,5,8,387.46942194168275,0.40235605038236616,0.07539112829007877,0.21914650941173927,129975.34855379058,2272.2946341612196,132247.6431879518,1997,1,397.8974358974359,36,3,18,35.19556414503956,0.6200810185185186,45.07319819819821,1019.7072072072096,28.325200200200268,0
3717,4,1,0,38,0.02631578947368421,0.0,1.0,38,1000,900,100,0.9,11,9,2,399.3605093527362,0.4003822901849217,0.0756758047569015,0.22685323778696664,130144.4615912208,2794.9116941015045,132939.3732853223,1998,0,367.6842105263158,35,3,19,34.72001663641864,0.6238095238095238,44.907407407407405,1020.3703703703699,29.153439153439137,0
3718,4,0,0,38,0.0,0.0,1.0,38,1250,1000,250,0.8,15,10,5,407.1678643948166,0.39974513987671884,0.07116736817562663,0.2325356818095031,130353.74858276639,3015.225068937033,133368.97365170342,1999,1,368.6842105263158,34,4,19,34.307482319110896,0.6280637254901961,44.70238095238095,1021.1904761904758,30.03501400560223,0
3719,4,0,0,38,0.0,0.0,1.0,38,900,700,200,0.7777777777777778,11,7,4,409.91939196687366,0.39953769559032715,0.07890443891130827,0.23484167035111533,130475.34722222213,3096.8749999999914,133572.22222222213,2000,2,369.6842105263158,34,4,19,34.113308863512785,0.6292892156862745,44.58333333333333,1021.6666666666658,30.049019607843114,0
3720,4,0,0,38,0.0,0.0,1.0,38,1250,800,450,0.64,17,8,9,405.1490178275569,0.3993598862019914,0.06962207385920993,0.22433913458774316,129142.56071030528,2878.4588263031665,132021.01953660845,2001,3,370.6842105263158,35,3,16,35.596010779625004,0.6136904761904762,45.89120370370371,1016.4351851851857,29.041005291005305,8
3721,4,0,0,38,0.0,0.0,1.0,38,1100,900,200,0.8181818181818182,13,9,4,404.94278933336466,0.399656235182551,0.06238524196231654,0.22490385607838767,129261.91184807269,2868.7492235834848,132130.66107165618,2002,4,371.6842105263158,34,4,16,35.479103254507145,0.6170343137254901,45.77380952380953,1016.9047619047628,29.9089635854342,0
3722,4,0,0,38,0.0,0.0,1.0,38,1250,900,350,0.72,16,9,7,406.14819799293525,0.39916725936462777,0.06748269832278364,0.22661584833182843,129443.56575963722,2914.6541950113383,132358.21995464855,2003,5,372.6842105263158,34,4,15,35.26263453439401,0.6188725490196079,45.595238095238095,1017.6190476190479,29.92997198879553,0
3723,4,1,0,39,0.02564102564102564,0.0,1.0,39,950,700,250,0.7368421052631579,12,7,5,391.87931938312124,0.40190620782726044,0.14159216765543037,0.20182143593123386,126223.21605725613,2139.810090702934,128363.02614795906,2004,0,364.1025641025641,34,5,17,38.93496031275916,0.5860906862745099,48.7797619047619,1004.8809523809515,29.555322128851515,8
3724,4,1,1,39,0.025,0.025,0.975,40,1250,900,350,0.72,16,9,7,378.3454208913379,0.4075587606837607,0.14678661761324507,0.19705679466544035,126683.87372470835,1586.0527049039642,128269.92642961231,2005,0,355.975,35,5,14,38.79962826703458,0.5886904761904762,48.32175925925925,1006.7129629629617,28.763227513227477,0
3725,4,1,0,40,0.025,0.0,1.0,40,1500,1000,500,0.6666666666666666,20,10,10,369.4151505806865,0.40976228632478634,0.1567171265780356,0.19393753741042383,127006.86486740128,1383.652021954396,128390.51688935567,2006,0,354.35,36,4,16,38.691905932298056,0.5899884259259259,48.00112612612613,1007.9954954954964,27.999874874874898,0
3726,4,3,0,43,0.06976744186046512,0.0,1.0,43,1350,1300,50,0.9629629629629629,14,13,1,349.20374230057894,0.4198966408268734,0.16580489651570063,0.1868451776609384,127775.65646701407,323.9474826389081,128099.60394965297,2007,0,330.5581395348837,39,4,17,38.41309499278797,0.5924145299145299,47.23958333333334,1011.0416666666681,25.924145299145337,0
3727,4,2,3,42,0.044444444444444446,0.06666666666666667,0.9333333333333333,45,950,500,450,0.5263157894736842,14,5,9,360.2241621317321,0.4266624579124579,0.19701674277016723,0.18070618358724871,125137.0989751654,220.8307183460273,125357.92969351143,2008,0,316.8222222222222,37,8,18,40.85239726027396,0.5689752252252251,49.862938596491226,1000.5482456140348,27.041844476054997,8
3728,4,3,0,45,0.06666666666666667,0.0,1.0,45,1250,800,450,0.64,17,8,9,358.94375992267567,0.4271885521885522,0.23050270913817839,0.18258618622095577,125713.73523584151,24.832159895319876,125738.56739573683,2009,0,317.44444444444446,37,8,21,40.28810408921933,0.5748873873873874,49.28728070175437,1002.8508771929801,27.104077761972434,0
3729,4,5,4,46,0.1,0.08,0.92,50,900,400,500,0.4444444444444444,14,4,10,328.1289241127117,0.43983843537414963,0.24752264671130386,0.17177718315921106,126892.0264865203,-1672.1783486145287,125219.84813790578,2010,0,286.6,41,9,20,39.850006564264135,0.5802845528455285,48.11507936507935,1007.5396825396806,24.574138598528794,0
3730,4,1,0,47,0.02127659574468085,0.0,1.0,47,700,500,200,0.7142857142857143,9,5,4,349.20530465792615,0.4300801726796177,0.2566887704595695,0.18082611320405448,126446.46819526599,-568.8445101906959,125877.62368507529,2011,0,305.82978723404256,38,9,21,39.777193541533876,0.580592105263158,48.55769230769229,1005.7692307692284,26.467611336032327,0
3731,4,1,0,48,0.020833333333333332,0.0,1.0,48,1250,800,450,0.64,17,8,9,350.48002950028086,0.4329011524822695,0.27324579542321525,0.18343305440079632,126882.03125,-706.0763888888897,126175.95486111111,2012,0,300.4375,39,9,23,39.297284256961674,0.5833333333333333,48.125,1007.5,25.833333333333332,0
3732,4,1,1,48,0.02040816326530612,0.02040816326530612,0.9795918367346939,49,1100,800,300,0.7272727272727273,14,8,6,343.66714379820155,0.4371811224489796,0.2807392406678042,0.18143276024090116,127233.99233270457,-1054.077007750969,126179.9153249536,2013,0,295.2857142857143,36,13,24,39.10778732745471,0.5923032407407407,47.775900900900915,1008.8963963963984,28.024899899899953,0
3733,4,1,1,48,0.02040816326530612,0.02040816326530612,0.9795918367346939,49,1650,900,750,0.5454545454545454,24,9,15,353.8454321696231,0.4396435657596372,0.28130720726828984,0.1805211442085703,125834.72222222213,-891.5451769336948,124943.17704528844,2014,0,295.9591836734694,39,10,21,40.29104374307864,0.5726495726495726,49.166666666666664,1003.3333333333326,25.726495726495706,8
3734,4,3,2,49,0.058823529411764705,0.0392156862745098,0.9607843137254902,51,1600,1100,500,0.6875,21,11,10,338.84921442763397,0.44534313725490193,0.3004151526322256,0.17604398721658907,126581.54776397996,-1620.7203402727357,124960.82742370723,2015,0,285.2156862745098,36,15,16,39.89877088928678,0.5856481481481481,48.42342342342341,1006.3063063063044,27.9529529529529,0
3735,4,0,0,49,0.0,0.0,1.0,49,1000,500,500,0.5,15,5,10,354.85553056748887,0.4423185941043084,0.3041282840271009,0.18302047920472264,126283.0374858277,-837.5531462585029,125445.4843395692,2016,1,297.7755102040816,34,15,16,39.80343677207943,0.586703431372549,48.720238095238095,1005.1190476190479,29.562324929971997,0
3736,4,3,0,52,0.057692307692307696,0.0,1.0,52,1600,1100,500,0.6875,21,11,10,332.78544423440474,0.44667546505781797,0.31340301003344484,0.17555195452732344,127202.60080024612,-1933.765196983697,125268.83560326241,2017,0,281.53846153846155,37,15,22,39.41440217391307,0.5900900900900901,47.807017543859644,1008.7719298245605,27.26410621147461,0
3737,4,2,2,52,0.037037037037037035,0.037037037037037035,0.962962962962963,54,1550,800,750,0.5161290322580645,23,8,15,325.98267720512155,0.4510030864197531,0.3298715801228369,0.17457091701781222,127810.33631601525,-2467.208878643698,125343.12743737156,2018,0,272.0740740740741,40,14,17,38.96461474036852,0.5911458333333333,47.20528455284551,1011.1788617886151,25.279471544715378,0
3738,4,2,3,51,0.037037037037037035,0.05555555555555555,0.9444444444444444,54,1300,800,500,0.6153846153846154,18,8,10,323.72258340731304,0.45031155369205683,0.33006995347591794,0.17436199070597214,128041.65556423069,-2510.004895399593,125531.6506688311,2019,0,273.0,40,14,19,38.78568798741504,0.5934895833333333,46.97662601626015,1012.0934959349573,25.302337398373933,0
3739,4,1,2,50,0.019230769230769232,0.038461538461538464,0.9615384615384616,52,1450,800,650,0.5517241379310345,21,8,13,348.0898892800493,0.4489221970839618,0.3555198657163696,0.1886582539237322,128291.05748724725,-1468.512066562551,126822.5454206847,2020,0,279.0576923076923,35,17,21,37.914262728969106,0.6050595238095238,46.73032407407408,1013.0787037037051,28.94510582010586,0
3740,4,0,0,50,0.0,0.0,1.0,50,1300,900,400,0.6923076923076923,17,9,8,364.4628338407106,0.44537414965986394,0.36040271442874605,0.1965300787878914,128087.5274556652,-663.3713527716807,127424.15610289352,2021,1,290.72,36,14,21,37.707892980309275,0.6009837962962963,46.93130630630631,1012.2747747747754,28.118743743743764,0
3741,4,0,0,50,0.0,0.0,1.0,50,1700,1300,400,0.7647058823529411,21,13,8,366.67029940857685,0.44579081632653056,0.36661503086046254,0.19815544041942926,128175.55334787109,-600.3282506136542,127575.22509725743,2022,2,291.72,33,17,21,37.56189741417565,0.608270202020202,46.844362745098046,1012.6225490196084,30.685531788472982,0
3742,4,0,0,50,0.0,0.0,1.0,50,1350,1100,250,0.8148148148148148,16,11,5,364.6404843056354,0.4454506802721088,0.36558606507802116,0.19767100877079927,128299.67928501061,-643.3485618512032,127656.33072315941,2023,3,292.72,33,17,21,37.48626567477118,0.6095328282828283,46.7218137254902,1013.1127450980396,30.70038621509211,0
3743,4,1,1,50,0.0196078431372549,0.0196078431372549,0.9803921568627451,51,1650,1200,450,0.7272727272727273,21,12,9,357.8371499214034,0.44599673202614376,0.36121575066808354,0.19632686874066188,128778.125,-983.6805555555538,127794.44444444445,2024,0,287.96078431372547,34,17,18,37.16988232074438,0.6121323529411764,46.25,1015.0,29.852941176470587,0
3744,4,1,2,49,0.0196078431372549,0.0392156862745098,0.9607843137254902,51,1850,1500,350,0.8108108108108109,22,15,7,359.88723830853314,0.449281045751634,0.36930458762248075,0.1988525750923391,129058.31665702879,-910.7117675107382,128147.60488951804,2025,0,288.01960784313724,36,15,19,36.832031105692856,0.6108217592592593,45.97409909909911,1016.1036036036047,28.225100100100132,0
3745,4,0,1,48,0.0,0.02040816326530612,0.9795918367346939,49,1200,700,500,0.5833333333333334,17,7,10,357.9296402048577,0.44759778911564624,0.287622682660851,0.18755513146734515,126930.47337278086,-702.379095271528,126228.09427750934,2026,1,300.53061224489795,38,11,18,39.05984944868533,0.5855263157894737,48.076923076923066,1007.692307692306,26.518218623481737,8
3746,4,0,1,47,0.0,0.020833333333333332,0.9791666666666666,48,1100,900,200,0.8181818181818182,13,9,4,371.2653529644095,0.44479536052009455,0.29846533078880433,0.19454304495335026,126930.47337278085,-175.0226002630082,126755.45077251784,2027,2,307.625,38,10,19,38.723892069550466,0.5855263157894737,48.076923076923066,1007.6923076923059,26.518218623481733,0
3747,4,1,0,48,0.020833333333333332,0.0,1.0,48,1100,900,200,0.8181818181818182,13,9,4,366.54603434706405,0.4475195774231679,0.2801952049833407,0.1938902126511711,127313.23580332407,-266.56220234355624,127046.67360098052,2028,0,275.9791666666667,37,11,20,38.449315514993465,0.5912162162162162,47.69736842105263,1009.2105263157893,27.275960170697008,0
3748,4,1,1,48,0.02040816326530612,0.02040816326530612,0.9795918367346939,49,1550,1200,350,0.7741935483870968,19,12,7,359.1179307510776,0.4495819160997732,0.2792487911376027,0.19177332317433723,127696.68104383687,-628.3664279513839,127068.31461588548,2029,0,271.3265306122449,39,10,16,38.24343416125595,0.5916132478632479,47.317708333333336,1010.7291666666672,25.91613247863249,0
3749,4,1,2,47,0.02040816326530612,0.04081632653061224,0.9591836734693877,49,1300,700,600,0.5384615384615384,19,7,12,359.7531291066044,0.4482532596371882,0.2745749175056218,0.19299463445442708,127880.99500868062,-598.8823784722117,127282.1126302084,2030,0,272.2857142857143,39,10,18,38.03853415722624,0.593482905982906,47.13541666666667,1011.4583333333339,25.934829059829074,0
3750,4,0,1,46,0.0,0.02127659574468085,0.9787234042553191,47,1000,700,300,0.7,13,7,6,371.3668017802713,0.4472132284921369,0.2701636075357783,0.198471335977526,127728.54538175218,86.8282788935191,127815.3736606457,2031,1,283.8723404255319,37,10,18,37.901232056983766,0.5954391891891893,47.28618421052632,1010.8552631578956,27.320412517780962,0
3751,4,0,1,45,0.0,0.021739130434782608,0.9782608695652174,46,1200,900,300,0.75,15,9,6,375.02156827900524,0.4457628824476651,0.27362538378839063,0.20065218355237846,127774.23327043267,383.61866934502643,128157.8519397777,2032,2,290.54347826086956,36,10,18,37.7619829954704,0.5978009259259259,47.240990990990994,1011.0360360360366,28.08433433433435,0
3752,4,2,2,45,0.0425531914893617,0.0425531914893617,0.9574468085106383,47,1450,1200,250,0.8275862068965517,17,12,5,319.05004391468367,0.4482732038236201,0.1936088932793969,0.1726116533293592,128219.87714356583,-1136.1085715558984,127083.76857200993,2033,0,283.468085106383,41,6,19,38.722267117249494,0.59375,46.80059523809524,1012.7976190476196,24.702380952380967,8
3753,4,3,2,46,0.0625,0.041666666666666664,0.9583333333333334,48,1300,900,400,0.6923076923076923,17,9,8,315.6091541622161,0.44945885047281325,0.22051428935140982,0.17307278956518618,128758.45520852132,-1472.5305720809847,127285.92463644034,2034,0,278.25,42,6,19,38.261409203742595,0.597718253968254,46.26937984496125,1014.9224806201566,24.164820967146586,0
3754,4,2,0,48,0.041666666666666664,0.0,1.0,48,1250,800,450,0.64,17,8,9,321.6132936261548,0.4479259013002364,0.2384365261082495,0.1772424050362436,128955.22072742016,-1305.2573463133278,127649.96338110683,2035,0,279.2083333333333,42,6,21,37.90903453539402,0.5997023809523809,46.075581395348834,1015.697674418604,24.183277962347717,0
3755,4,0,1,47,0.0,0.020833333333333332,0.9791666666666666,48,1250,900,350,0.72,16,9,7,319.5486643847371,0.44754728132387706,0.2435322908721076,0.17676299536219012,129102.89345592217,-1349.068565591005,127753.82489033116,2036,1,280.2083333333333,42,6,21,37.811467073480806,0.6011904761904762,45.93023255813954,1016.2790697674423,24.197120708748624,0
3756,4,3,1,49,0.06,0.02,0.98,50,1100,700,400,0.6363636363636364,15,7,8,311.9341254009479,0.45103741496598637,0.25828220858895734,0.175328491173636,129731.44531249984,-1906.4294560498313,127825.01585645,2037,0,269.42,43,7,17,37.36792774369463,0.6061046511627908,45.31249999999999,1018.7499999999987,23.69186046511625,0
3757,4,1,0,50,0.02,0.0,1.0,50,1100,900,200,0.8181818181818182,13,9,4,314.16787399321686,0.4510544217687075,0.26179885527391655,0.17706327644871137,129837.58680555534,-1841.8402777778008,127995.74652777755,2038,0,270.4,44,6,18,37.203597710547804,0.6058238636363636,45.20833333333332,1019.1666666666649,23.16287878787875,0
3758,4,0,1,49,0.0,0.02,0.98,50,750,500,250,0.6666666666666666,10,5,5,315.50165639217107,0.45053571428571426,0.2597638724911455,0.1782446761690196,129931.9712362824,-1801.2495713306055,128130.7216649518,2039,1,271.4,44,6,18,37.07410014228196,0.6067708333333333,45.11574074074073,1019.5370370370357,23.171296296296266,0
3759,4,0,1,48,0.0,0.02040816326530612,0.9795918367346939,49,1050,700,350,0.6666666666666666,14,7,7,321.06206809366773,0.44965277777777773,0.2643373745224984,0.1812392848992309,129900.32717982383,-1458.786461920336,128441.5407179035,2040,2,277.85714285714283,43,6,18,36.96441012540641,0.6078003875968992,45.146780303030305,1019.412878787879,23.707276250880906,0
3760,4,0,0,48,0.0,0.0,1.0,48,1350,900,450,0.6666666666666666,18,9,9,326.71044548060445,0.44670692966903075,0.2569800874441599,0.1845045945733459,129916.60399202252,-1110.9776868878243,128805.62630513469,2041,3,284.5208333333333,42,6,18,36.80397142223491,0.609375,45.130813953488364,1019.4767441860449,24.27325581395345,0
3761,4,0,0,48,0.0,0.0,1.0,48,1400,1200,200,0.8571428571428571,16,12,4,324.1394947449369,0.4461805555555556,0.2556677499226241,0.18354271074673864,130021.02434142557,-1171.0101727502388,128850.01416867533,2042,4,285.5208333333333,43,5,19,36.76377282575053,0.6090116279069768,45.028409090909086,1019.8863636363633,23.71828752642705,0
3762,4,1,1,48,0.02040816326530612,0.02040816326530612,0.9795918367346939,49,1050,600,450,0.5714285714285714,15,6,9,319.40257409088713,0.44641085600907027,0.2569940167649072,0.18187468888315814,130238.95747599451,-1480.2683470507495,128758.68912894376,2043,0,280.6734693877551,44,5,20,36.66413431301405,0.6098484848484849,44.81481481481482,1020.7407407407406,23.198653198653197,0
3763,4,0,0,48,0.0,0.0,1.0,48,1200,900,300,0.75,15,9,6,325.6349588213021,0.4453679078014185,0.2560937886661723,0.18507607153261352,130165.93491735542,-1122.68422865013,129043.25068870529,2044,1,287.3125,43,5,20,36.5789717891611,0.6104651162790697,44.88636363636364,1020.4545454545458,23.73150105708246,0
3764,4,0,1,47,0.0,0.020833333333333332,0.9791666666666666,48,1800,1500,300,0.8333333333333334,21,15,6,324.2353255811947,0.4453125,0.25922539066387973,0.1849853671842285,130314.4635819453,-1149.3818843210065,129165.0816976243,2045,2,288.3125,40,8,20,36.46445041637635,0.61640625,44.74085365853659,1021.0365853658539,25.525914634146346,0
3765,4,0,0,47,0.0,0.0,1.0,47,1550,1300,250,0.8387096774193549,18,13,5,326.5391078180611,0.44391766882516187,0.2682108480790517,0.18679821130787344,130418.24811826645,-882.6683232533363,129535.57979501311,2046,3,294.8510638297872,40,7,21,36.30069976453421,0.6174479166666667,44.63922764227643,1021.443089430896,25.5360772357724,0
3766,4,0,0,47,0.0,0.0,1.0,47,1350,900,450,0.6666666666666666,18,9,9,326.71099603597406,0.44411039161270427,0.26569188611572514,0.18739755077819295,130522.07396597609,-871.4006419789634,129650.67332399712,2047,4,295.8510638297872,40,7,15,36.19136416376597,0.6184895833333333,44.53760162601627,1021.8495934959362,25.546239837398407,0
3767,4,0,0,47,0.0,0.0,1.0,47,1600,1000,600,0.625,22,10,12,332.3366505127954,0.44305041628122105,0.2794080953408018,0.19152184292438437,130703.86860499716,-712.4628197501356,129991.40578524703,2048,5,296.8510638297872,40,7,16,35.86389385807992,0.6203125,44.35975609756098,1022.5609756097572,25.56402439024393,0
3768,4,0,0,47,0.0,0.0,1.0,47,650,400,250,0.6153846153846154,9,4,5,333.7975323524385,0.4433395004625347,0.28174051261672983,0.19288208729389483,130807.80805902583,-667.3352914931463,130140.47276753269,2049,6,297.8510638297872,40,7,17,35.7215295714948,0.6213541666666667,44.25813008130082,1022.9674796747977,25.574186991869944,0
3769,4,1,2,46,0.020833333333333332,0.041666666666666664,0.9583333333333334,48,1450,1000,450,0.6896551724137931,19,10,9,329.8321634433942,0.4441304669030733,0.29178769687580663,0.19267571176715942,131226.45817586305,-943.4586797681901,130282.99949609487,2050,0,292.625,41,7,18,35.40052930544796,0.6239837398373984,43.849206349206355,1024.6031746031756,24.99032133178477,0
3770,4,0,0,46,0.0,0.0,1.0,46,1750,1300,450,0.7428571428571429,22,13,9,343.4642168845321,0.4399255233494364,0.30372424209731363,0.1996769754824965,131041.82287535544,-198.36458539888486,130843.45828995656,2051,1,305.9347826086956,40,6,18,35.237799834574034,0.6236979166666667,44.029471544715456,1023.8821138211395,25.597052845528488,0
3771,4,0,0,46,0.0,0.0,1.0,46,1750,1300,450,0.7428571428571429,22,13,9,346.4730722981517,0.43956320450885666,0.30880696894779747,0.20169896877807514,131093.85456945293,-115.90188958289355,130977.95267987004,2052,2,306.9347826086956,40,6,18,35.10820846151304,0.62421875,43.97865853658538,1024.0853658536603,25.602134146341506,0
3772,4,0,0,46,0.0,0.0,1.0,46,1150,800,350,0.6956521739130435,15,8,7,352.7486562678244,0.4390096618357488,0.22963507771619596,0.1998629923672948,130044.55133912252,-12.27290415294317,130032.27843496959,2053,3,307.9347826086956,38,8,16,36.01043957962362,0.6170504385964912,45.005341880341874,1019.9786324786314,26.841542959963984,8
3773,4,0,2,44,0.0,0.043478260869565216,0.9565217391304348,46,1400,1000,400,0.7142857142857143,18,10,8,354.9552917844537,0.4389694041867955,0.23678148884933514,0.20167626364267188,130153.5462437905,39.73799674919803,130193.2842405397,2054,4,308.9347826086956,38,8,16,35.843541688479384,0.6181469298245614,44.898504273504265,1020.4059829059818,26.852789023841627,0
3774,4,0,0,44,0.0,0.0,1.0,44,1500,1100,400,0.7333333333333333,19,11,8,368.4014327029929,0.433557963354475,0.24969382428525555,0.2085152109098941,130004.05811216628,778.7362531450485,130782.79436531133,2055,5,322.6818181818182,36,8,17,35.65246797703182,0.6203703703703703,45.04504504504505,1019.8198198198203,28.32832832832834,0
3775,4,0,0,44,0.0,0.0,1.0,44,850,500,350,0.5882352941176471,12,5,7,369.6406383025296,0.43306245595489784,0.252072502458901,0.20952471224933136,130061.48674011863,815.2021954386969,130876.68893555734,2056,6,323.6818181818182,36,8,17,35.56248620004416,0.6209490740740741,44.988738738738746,1020.0450450450461,28.334584584584615,0
3776,4,1,0,45,0.022222222222222223,0.0,1.0,45,1200,900,300,0.75,15,9,6,363.8223301656398,0.43522727272727274,0.26250655980153637,0.20819218844122242,130430.54112803943,490.70867959372674,130921.24980763315,2057,0,317.46666666666664,37,8,18,35.33616001144985,0.6227477477477478,44.627192982456144,1021.4912280701757,27.607871028923668,0
3777,4,0,0,45,0.0,0.0,1.0,45,1100,900,200,0.8181818181818182,13,9,4,366.0989532685026,0.4352483164983165,0.26169713011648876,0.2099493012621031,130514.55886667047,556.2486774776827,131070.80754414815,2058,1,318.46666666666664,37,8,17,35.192773723933186,0.6235923423423424,44.54495614035088,1021.8201754385962,27.616761498340438,0
3778,4,0,1,44,0.0,0.022222222222222223,0.9777777777777777,45,1400,1000,400,0.7142857142857143,18,10,8,364.46317323932914,0.43444865319865317,0.264664449926705,0.20961691327022003,130626.62459843417,521.7188221375872,131148.34342057176,2059,2,319.46666666666664,37,8,17,35.120915120311786,0.6247184684684685,44.43530701754386,1022.2587719298248,27.62861545756283,0
3779,4,0,0,44,0.0,0.0,1.0,44,1450,1000,450,0.6896551724137931,19,10,9,370.7331181852812,0.4347031360112756,0.25986595174262717,0.2135322005607009,130682.6754987111,889.679156086484,131572.3546547976,2060,3,314.3636363636364,37,7,17,34.903820375335116,0.6252815315315315,44.38048245614035,1022.4780701754383,27.63454243717401,0
3780,4,0,0,44,0.0,0.0,1.0,44,1400,1000,400,0.7142857142857143,18,10,8,364.99438821168326,0.4344278541226216,0.25216311020169524,0.2109911798026645,130822.85534972296,749.9216104955296,131572.7769602185,2061,4,315.3636363636364,37,7,17,34.90844944623079,0.6266891891891893,44.243421052631575,1023.0263157894733,27.64935988620198,0
3781,4,0,0,44,0.0,0.0,1.0,44,1250,1000,250,0.8,15,10,5,364.95801434000236,0.43424066243833687,0.2491526579270309,0.21158497551860753,130935.05333371808,757.1594144352102,131692.21274815328,2062,5,316.3636363636364,37,7,17,34.795728876508825,0.6278153153153153,44.13377192982456,1023.4649122807018,27.661213845424374,0
3782,4,0,0,44,0.0,0.0,1.0,44,1650,1300,350,0.7878787878787878,20,13,7,363.4694923477061,0.4341966173361522,0.24405231239474712,0.21149168779035699,131075.36844269402,728.3795254309123,131803.74796812492,2063,6,317.3636363636364,37,7,17,34.6917719598815,0.629222972972973,43.996710526315795,1024.0131578947376,27.676031294452365,0
3783,4,1,0,45,0.022222222222222223,0.0,1.0,45,1100,800,300,0.7272727272727273,14,8,6,348.2858188380184,0.4367213804713805,0.1391919403436519,0.19788684448078017,130153.54624379064,66.37034997328254,130219.91659376392,2064,0,311.2888888888889,38,7,15,36.013680940913694,0.6181469298245614,44.89850427350427,1020.4059829059829,26.852789023841655,8
3784,4,0,0,45,0.0,0.0,1.0,45,1100,600,500,0.5454545454545454,16,6,10,347.02207413577685,0.4371422558922559,0.14294784580498887,0.1977218794494542,130262.5868055555,40.79861111110705,130303.38541666661,2065,1,312.2888888888889,38,7,16,35.935374149659864,0.6192434210526316,44.791666666666664,1020.8333333333329,26.864035087719287,0
3785,4,1,0,46,0.021739130434782608,0.0,1.0,46,1400,1100,300,0.7857142857142857,17,11,6,336.9077812169038,0.43878824476650563,0.1393054109725571,0.1939442740553614,130661.65500217026,-395.8143446180445,130265.84065755221,2066,0,306.4782608695652,39,7,14,35.78971387332315,0.6215277777777778,44.40104166666667,1022.3958333333343,26.215277777777803,0
3786,4,0,2,44,0.0,0.043478260869565216,0.9565217391304348,46,1550,1000,550,0.6451612903225806,21,10,11,343.3584172107317,0.43802334943639293,0.1478141362994565,0.19875131009198707,130874.74093967033,-212.61121961803525,130662.1297200523,2067,1,307.4782608695652,39,7,15,35.409349655570274,0.6236645299145299,44.19270833333334,1023.2291666666682,26.23664529914534,0
3787,4,0,0,44,0.0,0.0,1.0,44,1100,800,300,0.7272727272727273,14,8,6,346.9340441341885,0.4363438160676533,0.13660811773083292,0.2004763713086818,130808.47447083436,276.38261103806997,131084.85708187244,2068,2,304.52272727272725,38,6,15,35.384899912967796,0.6247258771929824,44.25747863247864,1022.9700854700864,26.920265407107536,0
3788,4,0,1,43,0.0,0.022727272727272728,0.9772727272727273,44,1200,600,600,0.5,18,6,12,352.48686856338446,0.4357932522903453,0.13491138491138477,0.20474237259107256,131008.00781250026,435.7204861111414,131443.72829861142,2069,3,305.52272727272725,39,5,16,35.041039207705886,0.625,44.062500000000014,1023.750000000002,26.250000000000053,0
3789,4,0,0,43,0.0,0.0,1.0,43,1800,1400,400,0.7777777777777778,22,14,8,376.9687062908264,0.4351698043558509,0.19153816914624122,0.203712119292059,128173.82979948969,1174.0514349708262,129347.88123446051,2070,4,308.27906976744185,35,8,18,37.30295367089571,0.6038690476190476,46.8460648148148,1012.6157407407392,28.93187830687826,8
3790,4,2,0,45,0.044444444444444446,0.0,1.0,45,1450,1100,350,0.7586206896551724,18,11,7,364.5814327534638,0.4373316498316498,0.19418338074490182,0.20005514659151208,128783.68975309689,390.42842509231116,129174.1181781892,2071,0,295.53333333333336,37,8,18,36.99306380756903,0.6061373873873874,46.24451754385964,1015.0219298245596,27.433025130393503,0
3791,4,1,0,46,0.021739130434782608,0.0,1.0,46,1550,1100,450,0.7096774193548387,20,11,9,360.0435161718382,0.4401469404186795,0.19854923896329635,0.1989928895329335,129069.04432508662,94.09450954859244,129163.13883463522,2072,0,290.0869565217391,39,7,19,36.81712369724925,0.6055021367521367,45.96354166666666,1016.1458333333319,26.05502136752133,0
3792,4,0,1,45,0.0,0.021739130434782608,0.9782608695652174,46,1750,1500,250,0.8571428571428571,20,15,5,354.72538592594395,0.4393619162640902,0.1926513106510097,0.19711797715289292,129282.86540516086,-27.949318268226193,129254.91608689264,2073,1,291.0869565217391,38,8,20,36.734425885071964,0.609375,45.75320512820512,1016.9871794871777,26.76282051282047,0
3793,4,0,0,45,0.0,0.0,1.0,45,1300,1000,300,0.7692307692307693,16,10,6,362.2219232669666,0.4380260942760943,0.19409179629030926,0.20186529885850918,129396.54659366322,374.0531942520536,129770.59978791527,2074,2,297.0888888888889,37,8,20,36.42802295505981,0.6123310810810811,45.64144736842104,1017.4342105263141,27.498221906116598,0
3794,4,1,0,46,0.021739130434782608,0.0,1.0,46,900,600,300,0.6666666666666666,12,6,6,355.78934944895343,0.43987520128824475,0.19688346512709676,0.19977006228776892,129690.63321827717,28.50920447071516,129719.14242274789,2075,0,291.60869565217394,38,8,15,36.29247954688481,0.6134868421052632,45.35256410256409,1018.5897435897414,26.804993252361616,0
3795,4,1,2,45,0.02127659574468085,0.0425531914893617,0.9574468085106383,47,1150,700,450,0.6086956521739131,16,7,9,348.21092325053155,0.4424722479185939,0.20686568850229659,0.19758851577727124,130103.13042534704,-339.33376736112973,129763.79665798592,2076,0,286.3829787234043,39,8,16,36.06672452521953,0.6159188034188035,44.94791666666666,1020.2083333333319,26.159188034188,0
3796,4,0,2,43,0.0,0.044444444444444446,0.9555555555555556,45,950,700,250,0.7368421052631579,12,7,5,366.1995412456155,0.4388468013468014,0.2078677322629583,0.20730504766436206,130010.85820877572,521.9833266004845,130532.84153537621,2077,1,295.68888888888887,37,8,16,35.7016942622657,0.6185247747747749,45.03837719298245,1019.8464912280698,27.563418681839725,0
3797,4,0,1,42,0.0,0.023255813953488372,0.9767441860465116,43,1350,900,450,0.6666666666666666,18,9,9,382.838490213976,0.4363695090439277,0.21467839980556302,0.21534359292994437,129760.92470689719,1335.4953007115805,131096.42000760877,2078,2,310.16279069767444,35,8,17,35.532039266916584,0.6199404761904762,45.28356481481481,1018.86574074074,29.110449735449713,0
3798,4,0,0,42,0.0,0.0,1.0,42,1250,900,350,0.72,16,9,7,386.92840543771223,0.43498354626403407,0.21616712079927347,0.2184657304548312,129908.3719135802,1653.0478395061668,131561.41975308637,2079,3,313.3333333333333,35,7,17,35.27758855585831,0.6214285714285714,45.138888888888886,1019.444444444444,29.126984126984116,0
3799,4,2,1,43,0.045454545454545456,0.022727272727272728,0.9772727272727273,44,1100,700,400,0.6363636363636364,15,7,8,372.59172358929817,0.4374669661733615,0.21922599005932297,0.2133934416920529,130463.84222059917,922.4318208974935,131386.27404149665,2080,0,300.04545454545456,36,8,20,35.07840057319224,0.625,44.594594594594604,1021.6216216216231,28.37837837837842,0
3800,4,0,1,42,0.0,0.023255813953488372,0.9767441860465116,43,950,400,550,0.42105263157894735,15,4,11,381.39976259847265,0.43489294942783313,0.2235752749816149,0.21780518481594333,130351.21588059419,1343.1845582561796,131694.40043885037,2081,1,307.6511627906977,35,8,20,34.96791057463449,0.6258928571428571,44.704861111111114,1021.180555555556,29.176587301587315,0
3801,4,1,2,41,0.023255813953488372,0.046511627906976744,0.9534883720930233,43,1200,800,400,0.6666666666666666,16,8,8,374.99823647633855,0.43443152454780365,0.22413021148831946,0.21529482627347662,130558.13426997604,1191.8140217764103,131749.94829175246,2082,0,306.93023255813955,35,8,19,34.92119667799169,0.6279761904761905,44.50231481481482,1021.9907407407411,29.19973544973546,0
3802,4,0,0,41,0.0,0.0,1.0,41,1350,1000,350,0.7407407407407407,17,10,7,382.97236280854537,0.4345782520325203,0.2092264678471576,0.21974831299121358,130536.16780045356,1798.348922902498,132334.51672335606,2083,1,316.5121951219512,34,7,19,34.73977749301025,0.6299019607843137,44.523809523809526,1021.9047619047623,30.056022408963596,0
3803,4,1,1,41,0.023809523809523808,0.023809523809523808,0.9761904761904762,42,1500,1200,300,0.8,18,12,6,375.69664830777424,0.4359877080913666,0.20754147812971357,0.21735329653407884,130854.01663237308,1432.283093278461,132286.29972565154,2084,0,309.95238095238096,35,7,21,34.60312971342383,0.6309523809523809,44.21296296296296,1023.1481481481479,29.232804232804227,0
3804,4,0,1,40,0.0,0.024390243902439025,0.975609756097561,41,1300,700,600,0.5384615384615384,19,7,12,383.5683403902638,0.43391768292682925,0.21125153290639065,0.22147978364470086,130779.59183673479,1832.5821995464971,132612.1740362813,2085,1,318.4146341463415,34,7,22,34.47732386716326,0.6323529411764706,44.28571428571429,1022.8571428571436,30.0840336134454,0
3805,4,0,0,40,0.0,0.0,1.0,40,900,700,200,0.7777777777777778,11,7,4,386.4627101533692,0.4322916666666667,0.22564686152371816,0.22342040888921924,130826.15460399848,2111.8860534409873,132938.04065743947,2086,2,326.175,33,7,22,34.356033381249006,0.6351010101010102,44.240196078431374,1023.0392156862747,31.001188354129535,0
3806,4,2,0,42,0.047619047619047616,0.0,1.0,42,1400,1100,300,0.7857142857142857,17,11,6,368.8280785246877,0.43475367789392183,0.22183507549361225,0.21602787456445993,131328.125,1289.4223375624751,132617.5473375625,2087,0,311.5952380952381,33,9,25,34.298780487804876,0.6401515151515151,43.75,1025.0,31.060606060606062,0
3807,4,1,1,42,0.023255813953488372,0.023255813953488372,0.9767441860465116,43,950,700,250,0.7368421052631579,12,7,5,358.55287838249376,0.4358850129198966,0.21110939176093257,0.21181135060743306,131654.57182623883,841.025136102535,132495.59696234137,2088,0,305.3255813953488,35,8,15,34.23238318108343,0.6389880952380953,43.43171296296296,1026.2731481481478,29.32208994708994,0
3808,4,0,0,42,0.0,0.0,1.0,42,1250,900,350,0.72,16,9,7,368.4204621868982,0.4337374177313202,0.22124869444122086,0.2169978894507518,131541.75347222207,1292.5347222222026,132834.28819444426,2089,2,313.5952380952381,34,8,25,34.09321689683185,0.6400122549019608,43.54166666666666,1025.8333333333321,30.171568627450945,0
3809,4,0,3,39,0.0,0.07142857142857142,0.9285714285714286,42,1050,600,450,0.5714285714285714,15,6,9,368.50018796070236,0.43268486256291133,0.21827946599674686,0.21836774665326597,131773.38023244598,1311.7030767746903,133085.08330922067,2090,3,314.5952380952381,35,7,19,33.85716097396009,0.6401785714285715,43.31597222222222,1026.736111111111,29.33531746031746,0
3810,4,0,0,39,0.0,0.0,1.0,39,1200,900,300,0.75,15,9,6,396.734109964412,0.4288686459739091,0.24152354955706357,0.23198083836247613,131263.42337516585,2615.335488725644,133878.7588638915,2091,7,339.43589743589746,32,7,22,33.64932437982586,0.6419270833333333,43.813131313131315,1024.747474747475,32.023358585858595,0
3811,4,0,0,39,0.0,0.0,1.0,39,1150,900,250,0.782608695652174,14,9,5,396.589331746976,0.4287843004948268,0.23973316656243449,0.23228803716608584,131328.12500000003,2616.6666666666674,133944.7916666667,2092,8,340.43589743589746,32,7,22,33.58739837398374,0.642578125,43.75,1025.0000000000002,32.03125000000001,0
3812,4,0,0,39,0.0,0.0,1.0,39,950,600,350,0.631578947368421,13,6,7,395.63451703221494,0.42805330634278005,0.23809117861574447,0.23231727496880833,131425.20732897165,2599.269685491293,134024.47701446293,2093,9,341.43589743589746,32,7,22,33.51342199236548,0.6435546875,43.65530303030304,1025.378787878789,32.04308712121215,0
3813,4,0,1,38,0.0,0.02564102564102564,0.9743589743589743,39,1000,700,300,0.7,13,7,6,400.87669173597305,0.4276596941070625,0.2373703907053648,0.23639506509771538,131587.0909218448,2750.039536781975,134337.13045862678,2094,10,342.43589743589746,32,7,20,33.21488637295923,0.6451822916666667,43.497474747474755,1026.0101010101018,32.06281565656568,0
3814,4,0,0,38,0.0,0.0,1.0,38,700,500,200,0.7142857142857143,9,5,4,404.8442371614831,0.4265499051683262,0.24004808976756586,0.2387853734156053,131595.18771701393,3055.1106770833376,134650.29839409728,2095,11,350.13157894736844,31,7,20,33.10490693739425,0.6478494623655914,43.489583333333336,1026.041666666667,33.0981182795699,0
3815,4,0,0,38,0.0,0.0,1.0,38,1000,800,200,0.8,12,8,4,409.6507579637883,0.426090564248459,0.2417026646280802,0.24225633346050574,131695.40617201055,3189.8245917426116,134885.23076375318,2096,12,351.13157894736844,31,7,20,32.87995792633937,0.6488575268817205,43.39192708333333,1026.432291666666,33.11071908602148,0
3816,4,0,0,38,0.0,0.0,1.0,38,1400,1100,300,0.7857142857142857,17,11,6,405.50716631417623,0.42494962067330483,0.2356868851120999,0.241260935075354,131925.4632382977,3099.3441524894192,135024.80739078711,2097,13,352.13157894736844,33,5,20,32.75316612986599,0.6461489898989898,43.16789215686274,1027.3284313725485,31.131164587046925,0
3817,4,0,0,38,0.0,0.0,1.0,38,1150,800,350,0.6956521739130435,15,8,7,406.60464481636825,0.4240161213845424,0.2288974791814402,0.24271837409785602,132051.391366902,3138.541816849276,135189.9331837513,2098,14,353.13157894736844,33,5,20,32.597447438496076,0.6474116161616161,43.045343137254896,1027.8186274509794,31.14601901366604,0
3818,4,0,1,37,0.0,0.02631578947368421,0.9736842105263158,38,900,700,200,0.7777777777777778,11,7,4,404.79318026840684,0.42363086770981506,0.22987809851246288,0.24203920094594897,132114.37795859767,3095.799842608612,135210.17780120627,2099,15,354.13157894736844,33,5,20,32.5802390034569,0.6480429292929293,42.98406862745098,1028.0637254901962,31.153446226975642,0
3819,4,0,0,37,0.0,0.0,1.0,37,1000,700,300,0.7,13,7,6,414.6245928702762,0.4206081081081081,0.24269533078969152,0.24722560889166106,132008.45457415047,3546.790346648285,135555.24492079875,2100,20,364.2972972972973,32,5,21,32.43488143506573,0.6494140625,43.087121212121204,1027.651515151514,32.114109848484816,0
3820,4,0,0,37,0.0,0.0,1.0,37,1200,800,400,0.6666666666666666,16,8,8,413.99053082963815,0.419700950950951,0.24430202030595005,0.2476947018769835,132138.24043783802,3540.79606035099,135679.036498189,2101,21,365.2972972972973,32,5,22,32.31968152605509,0.6507161458333333,42.96085858585859,1028.156565656566,32.12989267676769,0
3821,4,0,0,37,0.0,0.0,1.0,37,500,300,200,0.6,7,3,4,440.61229091766995,0.41954454454454454,0.2760897828345015,0.25495812827916436,130861.41798231343,4153.909851329554,135015.32783364298,2102,22,366.2972972972973,31,6,19,32.93511919911767,0.6404569892473118,44.20572916666667,1023.1770833333339,33.005712365591414,8
3822,4,0,0,37,0.0,0.0,1.0,37,1250,1000,250,0.8,15,10,5,441.53604102325033,0.4193255755755756,0.27541434564335354,0.2559346078497602,130928.03955078125,4161.889648437501,135089.92919921875,2103,23,367.2972972972973,31,6,19,32.84351145038168,0.6411290322580645,44.140625,1023.4375,33.01411290322581,0
3823,4,0,0,37,0.0,0.0,1.0,37,850,500,350,0.5882352941176471,12,5,7,437.6515270152539,0.4192317317317317,0.2666911054087375,0.2546164909679851,131069.41415416807,4072.545849913289,135141.96000408137,2104,24,368.2972972972973,32,5,20,32.79875667899712,0.6399739583333333,44.00252525252526,1023.9898989899,31.999684343434375,0
3824,4,0,0,37,0.0,0.0,1.0,37,1250,800,450,0.64,17,8,9,440.2051235090771,0.4193255755755756,0.27279193068666774,0.25699125925529936,131202.5422914264,4151.206266820459,135353.74855824685,2105,25,369.2972972972973,33,4,20,32.59768740031898,0.6388888888888888,43.872549019607845,1024.5098039215688,31.045751633986935,0
3825,4,1,0,38,0.02631578947368421,0.0,1.0,38,900,700,200,0.7777777777777778,11,7,4,416.53841775274157,0.4194967994310099,0.2851507619150542,0.22792607802874745,128672.4175347223,3138.984855584401,131811.4023903067,2106,0,360.55263157894734,31,7,18,35.78884325804243,0.6182795698924731,46.35416666666667,1014.583333333334,32.72849462365594,8
3826,4,1,0,39,0.02564102564102564,0.0,1.0,39,1200,800,400,0.6666666666666666,16,8,8,402.6190767917345,0.42175551057130006,0.2728946831829535,0.22254658860026663,129073.05377002357,2593.454749515369,131666.50851953894,2107,0,352.28205128205127,32,7,20,35.731444665341286,0.6197916666666667,45.959595959595966,1016.161616161617,31.75505050505053,0
3827,4,0,0,39,0.0,0.0,1.0,39,1050,700,350,0.6666666666666666,14,7,7,401.20890397746984,0.4216992802519118,0.2687498009237137,0.22212735055148794,129137.21335833086,2562.1999668401277,131699.413325171,2108,1,353.28205128205127,32,7,20,35.70160455486542,0.6204427083333333,45.89646464646465,1016.4141414141421,31.76294191919194,0
3828,4,0,0,39,0.0,0.0,1.0,39,950,700,250,0.7368421052631579,12,7,5,399.52227205592953,0.42141812865497075,0.26954090192688995,0.2217451201836469,129235.55333347792,2526.5282641408558,131762.08159761876,2109,2,354.28205128205127,30,9,20,35.643864287287954,0.6267361111111112,45.7997311827957,1016.8010752688177,33.89336917562726,0
3829,4,1,0,40,0.025,0.0,1.0,40,1350,1100,250,0.8148148148148148,16,11,5,385.9158720133165,0.42457264957264956,0.26097991818519906,0.2166446304475591,129683.21352731864,2009.3620867768607,131692.5756140955,2110,0,346.4,32,8,18,35.53288087269121,0.6259765625,45.359848484848484,1018.5606060606061,31.83001893939394,0
3830,4,1,0,41,0.024390243902439025,0.0,1.0,41,1000,600,400,0.6,14,6,8,375.2162629757786,0.42629573170731705,0.253985333970987,0.21262254901960798,130050.0000000001,1559.3750000000157,131609.37500000012,2111,0,338.9268292682927,34,7,19,35.43198529411766,0.625,45.00000000000001,1020.0000000000008,30.000000000000025,0
3831,4,2,0,43,0.046511627906976744,0.0,1.0,43,950,500,450,0.5263157894736842,14,5,9,356.7644173975053,0.43191675895164267,0.25174003839539894,0.20498286077016073,130587.70743580679,717.9830836334098,131305.6905194402,2112,0,324.1162790697674,35,8,16,35.357099045030765,0.6282738095238095,44.47337962962963,1022.1064814814818,29.203042328042336,0
3832,4,0,2,41,0.0,0.046511627906976744,0.9534883720930233,43,1650,1200,450,0.7272727272727273,21,12,9,358.07493945803253,0.43127076411960136,0.1259687951582118,0.2087107812501978,131141.34250217036,791.6856553819688,131933.02815755233,2113,1,325.1162790697674,39,4,19,34.76314875080512,0.6263354700854701,43.93229166666668,1024.270833333335,26.263354700854745,8
3833,4,0,0,41,0.0,0.0,1.0,41,950,700,250,0.7368421052631579,12,7,5,367.76521077019845,0.4253048780487805,0.16817832918213482,0.21446083639295885,131159.59357687013,1447.1871152662661,132606.7806921364,2114,2,341.8780487804878,37,4,19,34.49653892813815,0.6300675675675675,43.91447368421054,1024.3421052631604,27.684921763869202,0
3834,4,0,0,41,0.0,0.0,1.0,41,1200,900,300,0.75,15,9,6,368.2327151617271,0.4248983739837398,0.1705046878220997,0.21552105125965382,131300.02891514724,1469.793229647611,132769.82214479486,2115,3,342.8780487804878,37,4,20,34.342458364537656,0.6314752252252251,43.77741228070177,1024.890350877195,27.699739212897164,0
3835,4,0,0,41,0.0,0.0,1.0,41,800,400,400,0.5,12,4,8,367.5740572428813,0.4248221544715447,0.16922104428599716,0.21594383001636638,131443.57829112906,1463.0528799310634,132906.63117106011,2116,4,343.8780487804878,36,5,20,34.214162823047076,0.634837962962963,43.63738738738739,1025.4504504504512,28.484734734734754,0
3836,4,0,0,41,0.0,0.0,1.0,41,1500,1200,300,0.8,18,12,6,366.84545788891563,0.42510162601626017,0.1685611281658741,0.21665992597159348,131645.74361100968,1458.7286188215292,133104.4722298312,2117,5,344.8780487804878,36,5,17,34.028539814916414,0.6368634259259259,43.44031531531532,1026.238738738739,28.506631631631635,0
3837,4,0,0,41,0.0,0.0,1.0,41,1550,1200,350,0.7741935483870968,19,12,7,364.6833641120346,0.42441565040650403,0.15721544715447178,0.21653074744152062,131848.06428049668,1416.5591266942602,133264.62340719093,2118,6,345.8780487804878,36,5,18,33.879751461988306,0.6388888888888888,43.24324324324324,1027.0270270270266,28.52852852852852,0
3838,4,0,1,40,0.0,0.024390243902439025,0.975609756097561,41,1700,1000,700,0.5882352941176471,24,10,14,365.7400564793776,0.4238821138211382,0.15057046011056308,0.21782064460299244,131963.74584043512,1452.8855713822006,133416.63141181733,2119,7,346.8780487804878,36,5,18,33.73588886453309,0.6400462962962963,43.130630630630634,1027.4774774774783,28.541041041041062,0
3839,4,0,0,40,0.0,0.0,1.0,40,1200,800,400,0.6666666666666666,16,8,8,372.3557072009524,0.4203792735042735,0.15555774647887377,0.22134339594162428,131892.24222232925,1822.1658254029348,133714.4080477322,2120,9,356.375,35,5,18,33.63814553990611,0.6413690476190477,43.200231481481474,1027.199074074073,29.348544973544943,0
3840,4,0,0,40,0.0,0.0,1.0,40,1150,800,350,0.6956521739130435,15,8,7,387.5964249353901,0.4206196581196581,0.1188882743362829,0.2168237426618769,129545.08562616688,2051.649695495219,131596.7353216621,2121,10,357.375,36,4,15,35.63099188790559,0.6157407407407407,45.495495495495504,1018.0180180180195,28.278278278278318,8
3841,4,0,0,40,0.0,0.0,1.0,40,1700,1400,300,0.8235294117647058,20,14,6,385.13550092599695,0.4200854700854701,0.10678050397877925,0.21671057290910611,129774.47041636254,1996.1511342423719,131770.6215506049,2122,11,358.375,36,4,16,35.45972406424993,0.6180555555555556,45.27027027027028,1018.9189189189208,28.303303303303355,0
3842,4,1,2,39,0.024390243902439025,0.04878048780487805,0.9512195121951219,41,950,700,250,0.7368421052631579,12,7,5,380.5499981087515,0.4223069105691057,0.10664604657868137,0.21604745164136258,130122.70752779703,1703.6392207217589,131826.3467485188,2123,0,350.609756097561,37,4,17,35.221990865126266,0.6196509009009009,44.92872807017544,1020.2850877192984,27.57527264106212,0
3843,4,0,0,39,0.0,0.0,1.0,39,950,700,250,0.7368421052631579,12,7,5,391.8912208396549,0.41860661268556004,0.13208096185853813,0.22193736748322845,130026.38996056227,2391.2401406035447,132417.63010116582,2124,1,368.87179487179486,35,4,18,35.03082917234073,0.6226190476190476,45.02314814814814,1019.9074074074063,29.140211640211607,0
3844,4,3,1,41,0.07142857142857142,0.023809523809523808,0.9761904761904762,42,1400,1000,400,0.7142857142857143,18,10,8,367.0325554863351,0.4224375725900116,0.14192929483550376,0.2120943851169127,130809.21292914537,1202.6766099182278,132011.88953906362,2125,0,343.45238095238096,36,6,18,34.87014714516366,0.6284722222222222,44.25675675675676,1022.9729729729731,28.41591591591592,0
3845,4,0,0,41,0.0,0.0,1.0,41,1500,900,600,0.6,21,9,12,374.1371618349645,0.4211382113821138,0.14406695447669748,0.21578824817060988,130735.6234996569,1582.6110253772117,132318.23452503412,2126,1,352.8292682926829,35,6,18,34.76309038780746,0.6297619047619047,44.328703703703695,1022.6851851851839,29.219576719576683,0
3846,4,0,1,40,0.0,0.024390243902439025,0.975609756097561,41,1850,1200,650,0.6486486486486487,25,12,13,373.06647118522875,0.42101117886178857,0.14250322760738365,0.21606469239389253,130895.6269402849,1566.5539272380497,132462.18086752295,2127,2,353.8292682926829,36,5,19,34.628223469425194,0.6293402777777778,44.1722972972973,1023.310810810811,28.425300300300304,0
3847,4,0,0,40,0.0,0.0,1.0,40,1200,800,400,0.6666666666666666,16,8,8,382.8834855502679,0.41833600427350426,0.15648608912010875,0.22185162380311052,130913.23329260966,2024.9030135459443,132938.1363061556,2128,3,363.575,35,5,20,34.359213601749225,0.631547619047619,44.15509259259259,1023.379629629629,29.239417989417973,0
3848,4,1,1,40,0.024390243902439025,0.024390243902439025,0.975609756097561,41,1200,700,500,0.5833333333333334,17,7,10,370.7233425914744,0.42014735772357725,0.1574001608147948,0.21681120935619658,131270.41737683638,1533.0015826637555,132803.41895950015,2129,0,355.6829268292683,36,5,21,34.308608058608066,0.6331018518518519,43.80630630630631,1024.7747747747753,28.46596596596598,0
3849,4,0,0,40,0.0,0.0,1.0,40,1000,500,500,0.5,15,5,10,370.66968579992397,0.418215811965812,0.16460474308300377,0.2169385371948663,131298.4681096751,1733.6723840449208,133032.14049372,2130,1,364.225,35,5,21,34.28159702616224,0.6354166666666667,43.77893518518518,1024.8842592592594,29.28240740740741,0
3850,4,1,2,39,0.024390243902439025,0.04878048780487805,0.9512195121951219,41,1050,900,150,0.8571428571428571,12,9,3,362.83860962056866,0.4207571138211382,0.16301606119703926,0.21434310136612816,131654.5718262389,1353.8757073045388,133008.44753354345,2131,0,356.3170731707317,35,6,16,34.12242490883803,0.6389880952380953,43.43171296296297,1026.2731481481487,29.322089947089964,0
3851,4,0,0,39,0.0,0.0,1.0,39,1400,900,500,0.6428571428571429,19,9,10,376.00903377704003,0.41770692757534866,0.16674020689317093,0.2209581176015642,131453.76778162262,2085.560841983877,133539.3286236065,2132,3,366.71794871794873,33,6,22,33.98761153601022,0.6414141414141414,43.62745098039217,1025.4901960784327,31.075460487225236,0
3852,4,0,0,39,0.0,0.0,1.0,39,1750,1400,350,0.8,21,14,7,376.8935989790409,0.4175101214574899,0.1591984959551238,0.2225745414563111,131642.34459102285,2123.0314061899444,133765.3759972128,2133,4,367.71794871794873,33,6,18,33.77418199187963,0.6433080808080809,43.4436274509804,1026.2254901960796,31.09774212715393,0
3853,4,0,1,38,0.0,0.02564102564102564,0.9743589743589743,39,700,500,200,0.7142857142857143,9,5,4,371.05611055217605,0.41708839406207826,0.06448147406136351,0.21319430789110366,130587.70743580667,2088.413326809097,132676.12076261578,2134,5,368.71794871794873,35,4,19,34.991908239912426,0.6282738095238095,44.473379629629626,1022.1064814814808,29.20304232804231,8
3854,4,0,1,37,0.0,0.02631578947368421,0.9736842105263158,38,700,400,300,0.5714285714285714,10,4,6,374.8023325195073,0.414073613086771,0.10101867572156165,0.21600643234245567,130706.03358892744,2197.7852527006116,132903.81884162806,2135,10,379.2894736842105,35,3,20,34.77610356536501,0.6294642857142857,44.357638888888886,1022.5694444444442,29.216269841269835,0
3855,4,0,0,37,0.0,0.0,1.0,37,850,600,250,0.7058823529411765,11,6,5,376.11811694912967,0.41266266266266266,0.09649844480669412,0.21709704764725435,130765.21675936657,2436.6334179955584,133201.85017736212,2136,11,383.3243243243243,35,2,20,34.68241956169137,0.6300595238095238,44.299768518518526,1022.8009259259271,29.222883597883634,0
3856,4,0,0,37,0.0,0.0,1.0,37,950,700,250,0.7368421052631579,12,7,5,376.69171392887125,0.41250625625625625,0.09940075822428773,0.21792897585937318,130854.0166323731,2458.324759945129,133312.34139231822,2137,12,384.3243243243243,35,2,20,34.57767722473605,0.6309523809523809,44.21296296296296,1023.148148148148,29.23280423280423,0
3857,4,1,0,38,0.02631578947368421,0.0,1.0,38,700,500,200,0.7142857142857143,9,5,4,368.63586700034216,0.415866524419156,0.09951842655136667,0.2144597529516389,131068.54056336755,2063.3130174093176,133131.85358077686,2138,0,375.1842105263158,36,2,21,34.56642472231386,0.6310763888888888,44.003378378378386,1023.9864864864876,28.4440690690691,0
3858,4,0,0,38,0.0,0.0,1.0,38,900,600,300,0.6666666666666666,12,6,6,369.36473844265583,0.4149033902323376,0.1037617953865646,0.21552989259864266,131183.87972009167,2090.9398841408947,133274.81960423256,2139,1,376.1842105263158,36,2,21,34.43099373419808,0.6322337962962963,43.890765765765764,1024.4369369369367,28.456581581581574,0
3859,4,0,0,38,0.0,0.0,1.0,38,1100,700,400,0.6363636363636364,15,7,8,371.1415162932118,0.4145033191085823,0.11253744116388509,0.2173828881145953,131328.1249999999,2148.343148892122,133476.46814889205,2140,2,377.1842105263158,35,3,22,34.23949864498643,0.6357142857142857,43.74999999999999,1024.9999999999993,29.285714285714267,0
3860,4,0,0,38,0.0,0.0,1.0,38,700,600,100,0.8571428571428571,8,6,2,371.83856487843383,0.4143995969653864,0.11192008127328146,0.21829806800914783,131417.11576485322,2173.1903452931933,133590.30611014643,2141,3,378.1842105263158,35,3,22,34.131603454114455,0.6366071428571429,43.663194444444436,1025.347222222221,29.295634920634885,0
3861,4,0,1,37,0.0,0.02631578947368421,0.9736842105263158,38,800,500,300,0.625,11,5,6,354.25225150929344,0.4138809862494073,0.10660071039605534,0.1944513849735904,128796.78376405715,1581.824160679391,130378.60792473654,2142,4,379.1842105263158,33,5,19,37.24181556601874,0.6145833333333333,46.231617647058826,1015.0735294117652,30.759803921568643,8
3862,4,0,1,36,0.0,0.02702702702702703,0.972972972972973,37,950,800,150,0.8421052631578947,11,8,3,354.9617035603062,0.4103478478478479,0.07143565583932499,0.18781954217511349,127325.5315500686,1639.137517146773,128964.66906721536,2143,18,390.3243243243243,35,2,16,38.72897553516818,0.5952380952380952,47.68518518518518,1009.2592592592594,28.83597883597884,8
3863,4,1,0,37,0.02702702702702703,0.0,1.0,37,1150,800,350,0.6956521739130435,15,8,7,360.7850792863248,0.41453953953953954,0.09921767939394144,0.1932666608046978,127822.46823827589,1823.2878675840202,129645.75610585991,2144,0,385.27027027027026,35,2,19,38.07239803899127,0.600297619047619,47.19328703703704,1011.2268518518518,28.892195767195766,0
3864,4,0,1,36,0.0,0.02702702702702703,0.972972972972973,37,1000,800,200,0.8,12,8,4,362.05589752262165,0.41463338338338335,0.09998330519950271,0.19465514490422864,127968.81028163576,1866.3724922839422,129835.1827739197,2145,1,386.27027027027026,35,2,19,37.89035689773507,0.6017857142857144,47.04861111111111,1011.8055555555552,28.908730158730148,0
3865,4,3,2,37,0.07692307692307693,0.05128205128205128,0.9487179487179487,39,1050,700,350,0.6666666666666666,14,7,7,338.35607494940257,0.4215587044534413,0.09633740288568249,0.185211921949825,128686.69979100728,908.505891167074,129595.20568217436,2146,0,363.7692307692308,36,3,14,37.757352941176464,0.6070601851851851,46.340090090090094,1014.6396396396401,28.184434434434447,0
3866,4,0,0,37,0.0,0.0,1.0,37,1100,800,300,0.7272727272727273,14,8,6,357.9865895972488,0.41475850850850854,0.10508783228585972,0.19536756930038207,128566.75347222229,1805.0347222222265,130371.78819444453,2147,1,384.43243243243245,34,3,15,37.38188167625307,0.6099877450980392,46.458333333333336,1014.1666666666672,29.828431372549034,0
3867,4,0,0,37,0.0,0.0,1.0,37,950,600,350,0.631578947368421,13,6,7,361.8152090383449,0.41447697697697694,0.10676357455660512,0.19805722714411136,128687.51594387757,1912.2200963718844,130599.73604024945,2148,2,385.43243243243245,34,3,16,37.16145527787557,0.6112132352941176,46.339285714285715,1014.6428571428573,29.842436974789923,0
3868,4,1,1,37,0.02631578947368421,0.02631578947368421,0.9736842105263158,38,1050,700,350,0.6666666666666666,14,7,7,352.8041169292546,0.4166370317686107,0.1063692663713045,0.19491927895040445,129054.34355977798,1506.1807430984236,130560.5243028764,2149,0,376.2631578947368,35,3,19,37.016008846869404,0.612797619047619,45.97800925925926,1016.0879629629632,29.031084656084662,0
3869,4,0,0,37,0.0,0.0,1.0,37,1150,800,350,0.6956521739130435,15,8,7,358.320875300508,0.4162912912912913,0.12239418424985438,0.19809760308064348,129080.38548752827,1850.4393424036216,130930.8248299319,2150,1,386.7837837837838,34,3,19,36.84932442986565,0.6151960784313726,45.95238095238095,1016.1904761904757,29.887955182072815,0
3870,4,0,0,37,0.0,0.0,1.0,37,1150,800,350,0.6956521739130435,15,8,7,364.04594180750604,0.41638513513513514,0.1275202394247228,0.20234511911916223,129292.17864229016,2013.6585884353626,131305.83723072553,2151,2,387.7837837837838,34,3,19,36.48796285457878,0.6173406862745099,45.74404761904761,1017.0238095238088,29.912464985994376,0
3871,4,0,0,37,0.0,0.0,1.0,37,1500,1100,400,0.7333333333333333,19,11,8,370.27764272648693,0.4161036036036036,0.13310866135757982,0.20676052042251683,129473.85381235811,2188.254676870732,131662.10848922885,2152,3,388.7837837837838,34,3,14,36.14433462003354,0.6191789215686274,45.56547619047618,1017.7380952380938,29.9334733893557,0
3872,4,0,0,37,0.0,0.0,1.0,37,950,500,450,0.5263157894736842,14,5,9,371.8809775168373,0.4168230730730731,0.13388063616053802,0.2082971840668964,129595.0414540816,2238.7861394557785,131833.82759353737,2153,4,389.7837837837838,34,3,15,35.98006547410265,0.6204044117647058,45.44642857142857,1018.2142857142853,29.947478991596626,0
3873,4,2,0,39,0.05128205128205128,0.0,1.0,39,850,700,150,0.8235294117647058,10,7,3,355.8310681265419,0.4218398560503824,0.14567218671061788,0.20289501305392524,130292.12648158851,1474.1121594921256,131766.23864108062,2154,0,370.7435897435897,35,4,17,35.680596493216946,0.625297619047619,44.762731481481474,1020.9490740740729,29.169973544973512,0
3874,4,0,0,39,0.0,0.0,1.0,39,1550,1200,350,0.7741935483870968,19,12,7,357.5824255689305,0.4211932073774179,0.14894333879381438,0.20498296447548822,130498.99798525377,1532.8296467764023,132031.82763203018,2155,1,371.7435897435897,35,4,15,35.42610632834919,0.6273809523809524,44.56018518518518,1021.7592592592592,29.193121693121693,0
3875,4,0,0,39,0.0,0.0,1.0,39,1100,800,300,0.7272727272727273,14,8,6,358.043784124183,0.421221322537112,0.14536690187879353,0.205560898167525,130558.13426997601,1549.1056884430764,132107.2399584191,2156,2,372.7435897435897,35,4,15,35.35437901094753,0.6279761904761905,44.50231481481482,1021.9907407407409,29.199735449735453,0
3876,4,0,0,39,0.0,0.0,1.0,39,1150,800,350,0.6956521739130435,15,8,7,355.85689611674957,0.4213618983355825,0.1385236642945895,0.20502415080838132,130694.03863322802,1501.67498579663,132195.71361902464,2157,3,373.7435897435897,36,3,15,35.27257709251102,0.6273148148148149,44.36936936936938,1022.5225225225241,28.40340340340345,0
3877,4,1,0,40,0.025,0.0,1.0,40,1000,800,200,0.8,12,8,4,350.20567616017576,0.42294337606837606,0.13544120796744497,0.20362519327420442,131047.29940943375,1178.7016197291568,132226.0010291629,2158,0,365.375,37,3,16,35.05970229171129,0.6289414414414414,44.02412280701755,1023.9035087719304,27.67306780464677,0
3878,4,0,0,40,0.0,0.0,1.0,40,1400,1100,300,0.7857142857142857,17,11,6,347.53731791846513,0.4216613247863248,0.1352739726027401,0.20296179366438352,131215.758694983,1120.4745690981758,132336.23326408118,2159,1,366.375,37,3,16,34.9578160673516,0.6306306306306306,43.859649122807014,1024.5614035087713,27.690848743480306,0
3879,4,0,0,40,0.0,0.0,1.0,40,650,300,350,0.46153846153846156,10,3,7,345.7545107525251,0.42162126068376066,0.1288889483256661,0.2023648974329274,131300.02891514695,1079.5154518698039,132379.54436701676,2160,2,367.375,37,3,18,34.91840073463857,0.6314752252252251,43.77741228070175,1024.8903508771928,27.6997392128971,0
3880,4,0,2,38,0.0,0.05,0.95,40,850,600,250,0.7058823529411765,11,6,5,345.97780126208306,0.4219684829059829,0.014768574908647913,0.19227849373525382,129287.27027280677,1108.300438982931,130395.5707117897,2161,3,368.375,36,4,18,36.9523493153213,0.6131365740740741,45.74887387387388,1017.0045045045059,28.250125125125166,8
3881,4,1,0,39,0.02564102564102564,0.0,1.0,39,950,800,150,0.8421052631578947,11,8,3,353.6272716428102,0.4232456140350877,0.021595512893430868,0.19712982530196216,129407.39300679434,1352.3966638803045,130759.78967067465,2162,0,361.87179487179486,35,4,19,36.63559796003488,0.6163690476190475,45.63078703703703,1017.4768518518513,29.07076719576718,0
3882,4,0,0,39,0.0,0.0,1.0,39,950,600,350,0.631578947368421,13,6,7,353.5942336351245,0.42363922627080525,0.01787729041850694,0.19770256101849465,129525.18332315247,1359.871586719825,130885.05490987228,2163,1,362.87179487179486,35,4,15,36.51660507864316,0.6175595238095238,45.5150462962963,1017.9398148148151,29.08399470899472,0
3883,4,0,2,37,0.0,0.05128205128205128,0.9487179487179487,39,1450,900,550,0.6206896551724138,20,9,11,355.0921918192046,0.42338618983355825,0.024330134759582567,0.19958630091907015,129731.44531249999,1413.3246527777783,131144.76996527775,2164,2,363.87179487179486,35,4,15,36.26874573960463,0.6196428571428572,45.3125,1018.7499999999999,29.107142857142854,0
3884,4,1,0,38,0.02631578947368421,0.0,1.0,38,1000,500,500,0.5,15,5,10,358.44267906719494,0.42614983404457085,0.048297864493047404,0.2021730051497579,129867.92091836738,1710.041099773247,131577.96201814062,2165,0,373.7631578947368,34,4,17,36.044683874484136,0.6231617647058824,45.17857142857143,1019.2857142857147,29.978991596638668,0
3885,4,0,0,38,0.0,0.0,1.0,38,1100,800,300,0.7272727272727273,14,8,6,355.6087437828725,0.42634246088193456,0.056045373904628715,0.20123754922741727,129996.88042534716,1645.6054687499907,131642.48589409716,2166,1,374.7631578947368,35,3,17,35.98591249574395,0.6223214285714286,45.05208333333333,1019.7916666666661,29.136904761904745,0
3886,4,1,0,39,0.02564102564102564,0.0,1.0,39,1300,1000,300,0.7692307692307693,16,10,6,350.4337427875732,0.4260008996851102,0.062040645515653914,0.20012148301713625,130351.21588059395,1336.1641589505948,131687.38003954454,2167,0,366.12820512820514,35,4,18,35.75845800748045,0.6258928571428571,44.7048611111111,1021.1805555555541,29.176587301587258,0
3887,4,0,0,39,0.0,0.0,1.0,39,1100,1000,100,0.9090909090909091,12,10,2,354.17700018695786,0.4251855600539811,0.06605606922815488,0.2028760792115691,130469.43486636235,1441.8546114111864,131911.28947777353,2168,1,367.12820512820514,35,4,18,35.543054454136936,0.6270833333333333,44.589120370370374,1021.6435185185189,29.189814814814827,0
3888,4,0,0,39,0.0,0.0,1.0,39,1400,1100,300,0.7857142857142857,17,11,6,354.44854391591343,0.42414529914529914,0.07658699563094329,0.20406076919547106,130665.25298524875,1462.8217322051764,132128.0747174539,2169,2,368.12820512820514,36,3,17,35.337729926203316,0.627025462962963,44.39752252252252,1022.4099099099099,28.400275275275273,0
3889,4,0,0,39,0.0,0.0,1.0,39,1550,1200,350,0.7741935483870968,19,12,7,354.66069234085927,0.4240890688259109,0.07740303446095154,0.20463967012958617,130751.61944038639,1474.4919750832034,132226.11141546958,2170,3,369.12820512820514,36,3,17,35.2448524554063,0.6278935185185186,44.31306306306307,1022.7477477477482,28.409659659659674,0
3890,4,0,0,39,0.0,0.0,1.0,39,950,600,350,0.631578947368421,13,6,7,351.18198657490507,0.423582995951417,0.07827468375504076,0.20339010274099198,130895.62694028488,1393.6372605713836,132289.26420085627,2171,4,370.12820512820514,36,3,17,35.18808921169438,0.6293402777777778,44.1722972972973,1023.3108108108108,28.4253003003003,0
3891,4,0,1,38,0.0,0.02564102564102564,0.9743589743589743,39,1100,800,300,0.7272727272727273,14,8,6,352.84369779266615,0.4236111111111111,0.08125347348584255,0.20465835157865606,130953.2521330451,1441.2059441197866,132394.4580771649,2172,5,371.12820512820514,36,3,17,35.08728499651594,0.6299189814814814,44.11599099099099,1023.5360360360352,28.431556556556533,0
3892,4,0,0,38,0.0,0.0,1.0,38,1500,1100,400,0.7333333333333333,19,11,8,353.77402314010067,0.42329006638217165,0.08712691319147003,0.2056594257282477,131039.71370018658,1671.6893413683865,132711.40304155496,2173,6,377.7631578947368,36,2,18,34.97603204282154,0.630787037037037,44.03153153153153,1023.8738738738731,28.44094094094092,0
3893,4,1,0,39,0.02564102564102564,0.0,1.0,39,1300,800,500,0.6153846153846154,18,8,10,346.2682156221832,0.42313315339631125,0.10069418043058898,0.20327350762346724,131414.71021274655,1301.2644823877918,132715.97469513433,2174,0,369.05128205128204,36,3,19,34.789492952590145,0.6345486111111112,43.66554054054054,1025.337837837838,28.481606606606608,0
3894,4,0,0,39,0.0,0.0,1.0,39,1400,1200,200,0.8571428571428571,16,12,4,347.28514569640043,0.4226833108412056,0.10022286756263887,0.20495221810787567,131616.85333982628,1341.7156176446658,132958.56895747094,2175,1,370.05128205128204,36,3,16,34.5595094381036,0.6365740740740741,43.468468468468465,1026.1261261261259,28.503503503503495,0
3895,4,1,0,40,0.025,0.0,1.0,40,750,500,250,0.6666666666666666,10,5,5,338.7490653854097,0.4228766025641026,0.09574927953890522,0.20150730118069218,131918.83710612875,937.4765552862408,132856.31366141498,2176,0,361.775,37,3,17,34.47439694737966,0.6376689189189189,43.17434210526316,1027.302631578947,27.76493598862019,0
3896,4,0,0,40,0.0,0.0,1.0,40,1150,900,250,0.782608695652174,14,9,5,335.8238440703576,0.42291666666666666,0.08826127624194591,0.20070167873571315,132095.80342793488,872.1840985462868,132967.98752648116,2177,1,362.775,38,2,17,34.371535716760214,0.637609649122807,43.00213675213676,1027.9914529914533,27.052406657669824,0
3897,4,0,0,40,0.0,0.0,1.0,40,1150,900,250,0.782608695652174,14,9,5,338.7731117297578,0.4223023504273504,0.08345450768591611,0.20334834911060518,132260.59701219955,961.2668018116708,133221.86381401122,2178,2,363.775,38,2,17,34.13005470156489,0.6392543859649122,42.84188034188034,1028.6324786324785,27.069275753486277,0
3898,4,0,0,40,0.0,0.0,1.0,40,1000,800,200,0.8,12,8,4,338.4681670233605,0.42202190170940174,0.08184390902482042,0.2033131615887674,132288.07259706708,955.0602901965153,133243.13288726358,2179,3,364.775,38,2,17,34.11028317236126,0.6395285087719298,42.815170940170944,1028.739316239317,27.07208726945571,0
3899,4,2,2,40,0.047619047619047616,0.047619047619047616,0.9523809523809523,42,1100,900,200,0.8181818181818182,13,9,4,321.7589643250081,0.42755516840882696,0.0792247166678699,0.19592645858436672,132800.32687717033,145.98478470112542,132946.31166187144,2180,0,348.35714285714283,39,3,14,34.02654960417719,0.6428952991452992,42.31770833333334,1030.7291666666683,26.428952991453034,0
3900,4,0,0,40,0.0,0.0,1.0,40,800,600,200,0.75,10,6,4,336.90095452579885,0.42028579059829063,0.07822614991482091,0.20387717557385973,132567.32840874116,932.4118959679928,133499.74030470915,2181,5,366.775,37,3,18,33.870137705848954,0.6441441441441442,42.54385964912281,1029.8245614035088,27.833096254148888,0
3901,4,1,1,40,0.024390243902439025,0.024390243902439025,0.975609756097561,41,950,700,250,0.7368421052631579,12,7,5,330.2423311050072,0.41933434959349597,0.08593859698823181,0.2019598097758296,132961.427137587,581.8983289930752,133543.32546658005,2182,0,358.8048780487805,39,2,16,33.64653822846177,0.6444978632478633,42.16145833333334,1031.3541666666683,26.444978632478676,0
3902,4,0,0,40,0.0,0.0,1.0,40,1250,1000,250,0.8,15,10,5,333.8652909433766,0.41841613247863246,0.08617092866756404,0.20500984394291633,133113.66705246904,888.4066358024623,134002.0736882715,2183,1,365.1,38,2,16,33.400628084342756,0.6477521929824561,42.013888888888886,1031.944444444444,27.156432748538,0
3903,4,0,0,40,0.0,0.0,1.0,40,800,600,200,0.75,10,6,4,333.8652909433766,0.41841613247863246,0.08617092866756404,0.20500984394291633,133113.66705246904,888.4066358024623,134002.0736882715,2184,2,366.1,38,2,16,33.400628084342756,0.6477521929824561,42.013888888888886,1031.944444444444,27.156432748538,0
3904,4,0,0,40,0.0,0.0,1.0,40,1500,1100,400,0.7333333333333333,19,11,8,333.4397951955992,0.4182692307692308,0.09265679983440256,0.20520352236814515,133196.36774965297,882.5939166483993,134078.96166630136,2185,3,367.1,38,2,16,33.32880528531014,0.6485745614035088,41.93376068376068,1032.264957264957,27.16486729644624,0
3905,4,0,1,39,0.0,0.025,0.975,40,1200,1000,200,0.8333333333333334,14,10,4,333.9471302393812,0.41784188034188036,0.09813780260707672,0.2061259872856868,133306.67529585786,903.4763313609382,134210.1516272188,2186,4,368.1,38,2,17,33.20530726256983,0.649671052631579,41.82692307692307,1032.6923076923067,27.17611336032386,0
3906,4,0,0,39,0.0,0.0,1.0,39,500,200,300,0.4,8,2,6,341.47550562544893,0.41708839406207826,0.10296180677568145,0.20994833014058473,133160.81781173058,1294.231518351802,134455.04933008237,2187,5,378.05128205128204,37,2,17,33.15704787704946,0.6500563063063063,41.968201754385966,1032.1271929824566,27.895329540066392,0
3907,4,0,0,39,0.0,0.0,1.0,39,1050,700,350,0.6666666666666666,14,7,7,342.09511289023703,0.41621682411156097,0.10808544467495351,0.211130522490187,133302.32018505695,1320.4144544475193,134622.73463950446,2188,6,379.05128205128204,37,2,18,32.999309832236136,0.6514639639639639,41.83114035087719,1032.6754385964914,27.91014698909436,0
3908,4,0,0,39,0.0,0.0,1.0,39,900,600,300,0.6666666666666666,12,6,6,339.9591259088628,0.415710751237067,0.11184951749587668,0.21045301473806227,133415.57618690375,1271.1685326254283,134686.74471952918,2189,7,380.05128205128204,37,2,18,32.94107761975517,0.6525900900900901,41.72149122807018,1033.1140350877201,27.92200094831676,0
3909,4,0,0,39,0.0,0.0,1.0,39,1450,1100,350,0.7586206896551724,18,11,7,342.3467662109759,0.41495164192532613,0.10901515398757655,0.21290536357764392,133585.55036164974,1346.5162357648533,134932.0665974146,2190,8,381.05128205128204,37,2,19,32.709305614481686,0.6542792792792793,41.55701754385965,1033.7719298245615,27.93978188715031,0
3910,4,0,0,39,0.0,0.0,1.0,39,1650,1200,450,0.7272727272727273,21,12,9,341.44722119451353,0.4138270355375619,0.11296190553878804,0.2126715519064903,133642.23246575872,1326.3537819329092,134968.58624769162,2191,9,382.05128205128204,37,2,19,32.675857193354545,0.6548423423423424,41.502192982456144,1033.9912280701758,27.945708866761507,0
3911,4,0,0,39,0.0,0.0,1.0,39,1200,500,700,0.4166666666666667,19,5,14,339.24400526491354,0.4120838956365272,0.1094368427772392,0.21276572529538326,133897.45071800938,1284.7814952677716,135182.23221327714,2192,10,383.05128205128204,37,2,18,32.47772980894868,0.6573761261261262,41.25548245614035,1034.9780701754385,27.97238027501185,0
3912,4,0,0,39,0.0,0.0,1.0,39,1350,1000,350,0.7407407407407407,17,10,7,338.5207217068896,0.4109311740890688,0.11208651606703701,0.21346239901490494,134096.12212411495,1278.8632079101083,135374.98533202507,2193,11,384.05128205128204,37,2,19,32.2980626720305,0.6593468468468469,41.06359649122806,1035.7456140350864,27.993124703650984,0
3913,4,0,0,39,0.0,0.0,1.0,39,900,500,400,0.5555555555555556,13,5,8,336.7148736037626,0.4099190283400809,0.11398182064848728,0.21298229956864487,134209.71476800548,1238.0814289011905,135447.79619690665,2194,12,385.05128205128204,37,2,19,32.23148148148148,0.660472972972973,40.95394736842105,1036.1842105263152,28.004978662873384,0
3914,4,0,0,39,0.0,0.0,1.0,39,1650,1200,450,0.7272727272727273,21,12,9,337.26237967931297,0.40930049482681063,0.11456443876873212,0.21449161564406574,134408.6176155161,1266.1940452831395,135674.81166079923,2195,13,386.05128205128204,37,2,20,32.01894099608755,0.6624436936936937,40.76206140350876,1036.951754385963,28.025723091512518,0
3915,4,0,0,39,0.0,0.0,1.0,39,1150,900,250,0.782608695652174,14,9,5,359.1216481846032,0.40921614934772826,0.09476459263148662,0.21474008758793614,132116.03570329322,1689.1456986765002,133805.18140196972,2196,14,387.05128205128204,37,2,18,33.752399744027294,0.6396396396396397,42.98245614035087,1028.0701754385957,27.785680417259343,8
3916,4,0,1,38,0.0,0.02564102564102564,0.9743589743589743,39,1050,800,250,0.7619047619047619,13,8,5,358.78974610098044,0.4095254161043635,0.09324158444533737,0.2150216631745108,132200.59447378037,1686.443545129262,133887.03801890963,2197,15,388.05128205128204,37,2,19,33.67574279418559,0.6404842342342343,42.90021929824561,1028.3991228070172,27.79457088667614,0
3917,4,1,0,39,0.02564102564102564,0.0,1.0,39,950,700,250,0.7368421052631579,12,7,5,356.67827428202474,0.40986279802069275,0.11961068568768884,0.21557724627989058,132520.55165816328,1653.8821771494868,134174.43383531278,2198,0,387.71794871794873,34,5,21,33.40800477897252,0.6498161764705883,42.589285714285715,1029.6428571428573,30.28361344537816,0
3918,4,0,0,39,0.0,0.0,1.0,39,750,600,150,0.8,9,6,3,356.0525130654265,0.40904745838956363,0.12579868890548473,0.21572593438669968,132612.5,1643.4027777777785,134255.90277777778,2199,1,388.71794871794873,34,5,21,33.331647788565256,0.6507352941176471,42.5,1030.0,30.294117647058822,0
3919,4,0,0,39,0.0,0.0,1.0,39,1200,900,300,0.75,15,9,6,355.36961123977983,0.40885065227170486,0.12819327656397195,0.21566399829376262,132673.8166099773,1629.6485260770962,134303.4651360544,2200,2,389.71794871794873,34,5,19,33.287593405746854,0.6513480392156863,42.44047619047619,1030.2380952380952,30.30112044817927,0
3920,4,0,0,39,0.0,0.0,1.0,39,850,600,250,0.7058823529411765,11,6,5,353.78266650198685,0.40904745838956363,0.12350542539221765,0.21516945782333957,132755.59413580247,1593.3256172839433,134348.9197530864,2201,3,390.71794871794873,35,4,19,33.24629380053908,0.65,42.36111111111111,1030.5555555555554,29.44444444444444,0
3921,4,0,0,39,0.0,0.0,1.0,39,900,500,400,0.5555555555555556,13,5,8,356.079851062302,0.4087944219523167,0.12209929960014154,0.21708441022668887,132845.0671537423,1660.6903452932127,134505.7574990355,2202,4,391.71794871794873,35,4,19,33.09721286628495,0.6508928571428572,42.27430555555556,1030.9027777777778,29.45436507936508,0
3922,4,0,0,39,0.0,0.0,1.0,39,1050,700,350,0.6666666666666666,14,7,7,356.65748393021096,0.40893499775078723,0.11655011655011616,0.21795735129068466,132934.57031250015,1682.4218750000152,134616.99218750017,2203,5,392.71794871794873,35,4,19,32.99242424242424,0.6517857142857143,42.18750000000001,1031.2500000000011,29.464285714285747,0
3923,4,0,0,39,0.0,0.0,1.0,39,1250,700,550,0.56,18,7,11,349.3016869848725,0.40882253711201083,0.09755078594182476,0.20177309212890857,130794.81336805546,1364.4965277777667,132159.30989583323,2204,6,393.71794871794873,37,2,17,35.3381704005431,0.6264076576576576,44.27083333333333,1022.9166666666658,27.646396396396373,8
3924,4,0,0,39,0.0,0.0,1.0,39,1250,1000,250,0.8,15,10,5,349.57354449080276,0.40834457939721097,0.10390495345488926,0.20237098741862083,130878.9483302553,1350.363573407183,132229.31190366248,2205,7,394.71794871794873,37,2,17,35.24610658665523,0.6272522522522522,44.18859649122806,1023.2456140350864,27.655286865813146,0
3925,4,0,1,38,0.0,0.02564102564102564,0.9743589743589743,39,1100,900,200,0.8181818181818182,13,9,4,347.2783852929514,0.40882253711201083,0.10677693913602115,0.2013878287594717,130945.12473518869,1294.8822960040782,132240.00703119277,2206,8,395.71794871794873,38,1,18,35.23790883785666,0.6260964912280702,44.12393162393162,1023.5042735042723,26.934322986954534,0
3926,4,0,0,38,0.0,0.0,1.0,38,1100,800,300,0.7272727272727273,14,8,6,354.0190668985091,0.4078799193930773,0.12480123600193971,0.20524310375345847,130935.05333371795,1670.7010811018627,132605.75441481982,2207,9,406.3421052631579,37,1,18,35.0756195986001,0.6278153153153153,44.133771929824555,1023.4649122807008,27.661213845424346,0
3927,4,0,0,38,0.0,0.0,1.0,38,600,200,400,0.3333333333333333,10,2,8,353.5176694613255,0.40820590327169276,0.11707116366628689,0.20555093383747547,131047.29940943362,1665.5071752846961,132712.80658471832,2208,10,407.3421052631579,37,1,18,34.97492325265939,0.6289414414414414,44.02412280701754,1023.9035087719294,27.67306780464674,0
3928,4,0,1,37,0.0,0.02631578947368421,0.9736842105263158,38,1150,800,350,0.6956521739130435,15,8,7,355.52132731506674,0.40859115694642006,0.12219292611747767,0.20732086390620166,131159.59357686967,1726.006559710668,132885.60013658032,2209,11,408.3421052631579,37,1,18,34.81008706201385,0.6300675675675675,43.91447368421052,1024.3421052631568,27.684921763869102,0
3929,4,0,0,37,0.0,0.0,1.0,37,950,700,250,0.7368421052631579,12,7,5,360.72961169868574,0.4069069069069069,0.1288153529684546,0.20970291749133332,131039.71370018675,2053.9810080350685,133093.69470822182,2210,12,419.1081081081081,36,1,18,34.797990907757736,0.630787037037037,44.031531531531535,1023.8738738738745,28.44094094094096,0
3930,4,0,0,37,0.0,0.0,1.0,37,1100,600,500,0.5454545454545454,16,6,10,363.0785028202807,0.4055930930930931,0.13615418210339603,0.21186177935574704,131183.8797200918,2126.0093285853527,133309.88904867714,2211,13,420.1081081081081,36,1,18,34.591990033344324,0.6322337962962963,43.89076576576577,1024.4369369369376,28.456581581581602,0
3931,4,0,1,36,0.0,0.02702702702702703,0.972972972972973,37,850,700,150,0.8235294117647058,10,7,3,366.51464075616366,0.4059997497497498,0.14172709294660524,0.21467286101432445,131328.125,2226.736111111111,133554.86111111112,2212,14,421.1081081081081,36,1,18,34.3580623306233,0.6336805555555556,43.75,1025.0,28.47222222222222,0
3932,4,1,0,37,0.02702702702702703,0.0,1.0,37,850,400,450,0.47058823529411764,13,4,9,360.8425344557139,0.4097847847847848,0.14733821140139702,0.21360003533105767,131732.4334469605,2106.9330310039795,133839.36647796448,2213,0,416.2432432432432,36,1,16,34.09504351323679,0.6377314814814814,43.35585585585586,1026.5765765765768,28.516016016016025,0
3933,4,0,0,37,0.0,0.0,1.0,37,1600,1200,400,0.75,20,12,8,365.0437062095431,0.40972222222222227,0.15179701135188495,0.21690968367017877,131876.97991488117,2228.1723023699437,134105.1522172511,2214,1,417.2432432432432,36,1,17,33.841318568870385,0.6391782407407407,43.215090090090094,1027.13963963964,28.53165665665667,0
3934,4,0,0,37,0.0,0.0,1.0,37,1100,600,500,0.5454545454545454,16,6,10,366.3533017265379,0.4089089089089089,0.14583401194554857,0.2186858459684835,132050.5402995902,2275.430286705631,134325.97058629585,2215,2,418.2432432432432,36,1,18,33.63258281289945,0.6409143518518519,43.046171171171174,1027.815315315316,28.550425425425445,0
3935,4,0,0,37,0.0,0.0,1.0,37,1150,1000,150,0.8695652173913043,13,10,3,364.5242736023022,0.4089401901901902,0.14405337327251688,0.21826040277131947,132166.31063073207,2235.565675472771,134401.87630620485,2216,3,419.2432432432432,36,1,18,33.56286277516154,0.6420717592592593,42.93355855855856,1028.2657657657658,28.56293793793794,0
3936,4,0,0,37,0.0,0.0,1.0,37,1400,1100,300,0.7857142857142857,17,11,6,365.6898735140108,0.40862737737737737,0.14184972227236536,0.21929386833903228,132224.21481870388,2270.6112785082437,134494.82609721212,2217,4,420.2432432432432,36,1,18,33.47453374210739,0.642650462962963,42.877252252252255,1028.4909909909913,28.569194194194203,0
3937,4,1,0,38,0.02631578947368421,0.0,1.0,38,600,400,200,0.6666666666666666,8,4,4,358.50921111797925,0.412265884305358,0.14050345752796822,0.2163123893616799,132455.95838659615,1897.4503642155764,134353.40875081174,2218,0,410.1578947368421,36,2,19,33.425865149691866,0.6449652777777778,42.65202702702703,1029.3918918918926,28.594219219219237,0
3938,4,0,0,38,0.0,0.0,1.0,38,1200,800,400,0.6666666666666666,16,8,8,361.34855963195974,0.4117028212422949,0.14937022779973885,0.21903613485444245,132629.89921932074,1985.1246094067133,134615.02382872746,2219,1,411.1578947368421,36,2,15,33.17777231150469,0.6467013888888888,42.48310810810811,1030.0675675675682,28.612987987988006,0
3939,4,0,0,38,0.0,0.0,1.0,38,650,300,350,0.46153846153846156,10,3,7,361.3346471975871,0.41139165481270745,0.14869140063272912,0.21953599082721936,132716.91243608482,1991.0437464491604,134707.956182534,2220,2,412.1578947368421,36,2,16,33.09061930783242,0.6475694444444444,42.39864864864865,1030.405405405406,28.622372372372393,0
3940,4,0,1,37,0.0,0.02631578947368421,0.9736842105263158,38,1150,800,350,0.6956521739130435,15,8,7,360.3677308183208,0.4108137743006164,0.1475610106642904,0.21979790643848934,132861.99787202728,1975.8353370261998,134837.83320905347,2221,3,413.1578947368421,36,2,16,32.96968869470234,0.6490162037037037,42.257882882882875,1030.9684684684673,28.63801301301298,0
3941,4,0,0,37,0.0,0.0,1.0,37,1000,600,400,0.6,14,6,8,370.1295398900036,0.40646896896896895,0.15327456836890785,0.22511157262162512,132755.59413580244,2427.353395061721,135182.94753086416,2222,9,425.2432432432432,35,2,16,32.82513477088949,0.65,42.36111111111111,1030.5555555555552,29.444444444444436,0
3942,4,0,0,37,0.0,0.0,1.0,37,800,600,200,0.75,10,6,4,368.8311426275418,0.4064064064064064,0.15380973337177695,0.2245004323375433,132785.41512613595,2395.0792770490366,135180.49440318497,2223,10,426.2432432432432,35,2,16,32.8285841287666,0.6502976190476191,42.332175925925924,1030.671296296296,29.447751322751316,0
3943,4,0,0,37,0.0,0.0,1.0,37,600,300,300,0.5,9,3,6,369.12981051224847,0.40590590590590586,0.15563295671064004,0.2252197501399388,132874.89819101492,2409.617198216714,135284.51538923162,2224,11,427.2432432432432,35,2,17,32.730878610986366,0.6511904761904762,42.24537037037036,1031.018518518517,29.457671957671916,0
3944,4,0,0,37,0.0,0.0,1.0,37,1250,900,350,0.72,16,9,7,361.98154116442004,0.40540540540540543,0.10520736113324292,0.20313494858997247,129669.02941476816,1999.4010142258635,131668.43042899403,2225,12,428.2432432432432,33,4,18,36.15677515742188,0.6234217171717171,45.37377450980391,1018.5049019607827,30.863784907902506,8
3945,4,0,0,37,0.0,0.0,1.0,37,1500,1200,300,0.8,18,12,6,359.11109321398163,0.40628128128128127,0.10432647082962454,0.2025500118641705,129867.92091836724,1927.4022108843428,131795.32312925157,2226,13,429.2432432432432,34,3,19,36.02765124970803,0.6231617647058824,45.17857142857142,1019.2857142857133,29.978991596638625,0
3946,4,0,0,37,0.0,0.0,1.0,37,1300,1100,200,0.8461538461538461,15,11,4,359.17884434814226,0.40484234234234234,0.1059979634650543,0.20341156660641535,130026.38996056208,1940.5456961590874,131966.93565672118,2227,14,430.2432432432432,35,2,19,35.8649190497806,0.6226190476190476,45.02314814814813,1019.9074074074047,29.14021164021156,0
3947,4,1,0,38,0.02631578947368421,0.0,1.0,38,1000,600,400,0.6,14,6,8,349.4348389227058,0.4057017543859649,0.10643533348843093,0.19955104102362636,130351.21588059391,1510.065559627893,131861.2814402218,2228,0,419.89473684210526,35,3,20,35.783959537572265,0.6258928571428571,44.7048611111111,1021.1805555555537,29.17658730158725,0
3948,4,0,0,38,0.0,0.0,1.0,38,1150,700,450,0.6086956521739131,16,7,9,349.3387616497343,0.40478307254623047,0.10985031385803934,0.20041013168326885,130528.56445312512,1519.737413194459,132048.30186631958,2229,1,420.89473684210526,35,3,16,35.606736323479424,0.6276785714285714,44.53125000000001,1021.8750000000009,29.196428571428598,0
3949,4,0,1,37,0.0,0.02631578947368421,0.9736842105263158,38,550,400,150,0.7272727272727273,7,4,3,354.5111551964599,0.4040125651967757,0.1123388966018577,0.20399980676549406,130646.86381440762,1663.1541227280525,132310.01793713568,2230,2,421.89473684210526,35,3,16,35.354753952979344,0.6288690476190476,44.41550925925926,1022.3379629629634,29.209656084656096,0
3950,4,0,0,37,0.0,0.0,1.0,37,1150,900,250,0.782608695652174,14,9,5,360.92621955571514,0.4025275275275275,0.10837875602663694,0.20775029313300816,130657.85147392287,2031.5688775510207,132689.4203514739,2231,18,434.2432432432432,34,3,18,35.1796596025462,0.6311274509803921,44.404761904761905,1022.3809523809521,30.07002801120447,0
3951,4,0,0,37,0.0,0.0,1.0,37,1100,800,300,0.7272727272727273,14,8,6,360.816988105128,0.40249624624624625,0.10867444860459985,0.20801462602839257,130718.71456916102,2033.106575963718,132751.82114512473,2232,19,435.2432432432432,34,3,18,35.12077997671711,0.6317401960784313,44.345238095238095,1022.6190476190478,30.077030812324935,0
3952,4,0,0,37,0.0,0.0,1.0,37,950,700,250,0.7368421052631579,12,7,5,361.9136542562783,0.40202702702702703,0.10295800686680101,0.20963677708807077,130901.388888889,2075.0000000000095,132976.38888888902,2233,20,436.2432432432432,34,3,18,34.90770901194352,0.633578431372549,44.16666666666667,1023.3333333333343,30.098039215686303,0
3953,4,1,0,38,0.02631578947368421,0.0,1.0,38,950,800,150,0.8421052631578947,11,8,3,357.46054167057633,0.4053313181602655,0.102919971160778,0.2087569563356163,131215.75869498288,1780.891235764827,132996.64993074772,2234,0,425.7368421052632,37,1,19,34.70364226598172,0.6306306306306306,43.85964912280701,1024.5614035087704,27.69084874348028,0
3954,4,0,0,38,0.0,0.0,1.0,38,1200,800,400,0.6666666666666666,16,8,8,355.60843413312193,0.40527204836415365,0.09542148053059485,0.20828493999225692,131328.12499999988,1740.325869498293,133068.45086949816,2235,1,426.7368421052632,36,2,19,34.637533875338754,0.6336805555555556,43.74999999999999,1024.999999999999,28.472222222222197,0
3955,4,0,1,37,0.0,0.02631578947368421,0.9736842105263158,38,850,500,350,0.5882352941176471,12,5,7,352.6260445014897,0.4047682550972025,0.10033316824996641,0.20714565126745782,131440.53939673738,1669.8714989227387,133110.4108956601,2236,2,427.7368421052632,37,1,19,34.60044197319647,0.6328828828828829,43.64035087719298,1025.4385964912276,27.71455666192507,0
3956,4,0,0,37,0.0,0.0,1.0,37,900,500,400,0.5555555555555556,13,5,8,363.6116473625008,0.40352852852852855,0.1129282148390427,0.21361597812147953,131443.57829112894,2158.8832075318496,133602.4614986608,2237,3,439.27027027027026,36,1,20,34.31574419796469,0.634837962962963,43.637387387387385,1025.4504504504503,28.48473473473473,0
3957,4,0,1,36,0.0,0.02702702702702703,0.972972972972973,37,950,700,250,0.7368421052631579,12,7,5,366.37372669117383,0.4039039039039039,0.12071221512433516,0.21572710254879793,131530.2015486771,2237.842022766017,133768.04357144312,2238,4,440.27027027027026,36,1,21,34.15738097851942,0.6357060185185186,43.55292792792793,1025.7882882882889,28.494119119119134,0
3958,4,0,0,36,0.0,0.0,1.0,36,1450,1100,350,0.7586206896551724,18,11,7,375.22888998944325,0.4048776455026455,0.12642900120336953,0.22114553729165068,131565.50068587108,2673.435356652951,134238.93604252403,2239,5,451.94444444444446,35,1,16,33.8945923586041,0.638095238095238,43.51851851851852,1025.925925925926,29.312169312169317,0
3959,4,0,0,36,0.0,0.0,1.0,36,1200,800,400,0.6666666666666666,16,8,8,376.07579911318214,0.4043650793650793,0.13518769022658095,0.22285694147849308,131773.3802324461,2711.3558545524825,134484.73608699857,2240,6,452.94444444444446,35,1,17,33.66270713561042,0.6401785714285715,43.31597222222223,1026.736111111112,29.335317460317487,0
3960,4,1,0,37,0.02702702702702703,0.0,1.0,37,1000,700,300,0.7,13,7,6,366.6488142925505,0.4081894394394394,0.13826775943340386,0.21902947492554992,132079.47812677556,2285.3568095122314,134364.83493628778,2241,0,441.6756756756757,36,1,19,33.595804119193694,0.6412037037037037,43.018018018018026,1027.927927927929,28.553553553553584,0
3961,4,0,1,36,0.0,0.02702702702702703,0.972972972972973,37,1200,900,300,0.75,15,9,6,363.2704671119006,0.40775150150150147,0.13321689707231843,0.21734333975961037,132137.36329234648,2200.320337229128,134337.6836295756,2242,1,442.6756756756757,36,1,19,33.62426980649873,0.6417824074074074,42.961711711711715,1028.1531531531537,28.559809809809824,0
3962,4,0,0,36,0.0,0.0,1.0,36,1100,900,200,0.8181818181818182,13,9,4,370.70854638422196,0.40572089947089945,0.13828828828828832,0.22122929380993897,132040.89506172843,2589.737654320991,134630.6327160494,2243,2,455.75,35,1,19,33.53040540540542,0.6428571428571428,43.05555555555556,1027.777777777778,29.365079365079374,0
3963,4,1,0,37,0.02702702702702703,0.0,1.0,37,1000,800,200,0.8,12,8,4,361.42208526610796,0.4067192192192192,0.13699529489003148,0.21773476844080197,132398.0034722224,2170.3125000000205,134568.31597222242,2244,0,444.4054054054054,36,1,20,33.40924426450743,0.6443865740740741,42.70833333333334,1029.166666666668,28.587962962963005,0
3964,4,0,0,37,0.0,0.0,1.0,37,1150,800,350,0.6956521739130435,15,8,7,360.63533242056894,0.4057182182182182,0.1420035298870863,0.21812185945246768,132546.94097490128,2160.222023962601,134707.16299886387,2245,1,445.4054054054054,35,2,20,33.27959330860589,0.6479166666666667,42.5636574074074,1029.7453703703693,29.421296296296266,0
3965,4,0,0,37,0.0,0.0,1.0,37,850,500,350,0.5882352941176471,12,5,7,360.63533242056894,0.4057182182182182,0.1420035298870863,0.21812185945246768,132546.94097490128,2160.222023962601,134707.16299886387,2246,2,446.4054054054054,35,2,20,33.27959330860589,0.6479166666666667,42.5636574074074,1029.7453703703693,29.421296296296266,0
3966,4,0,0,37,0.0,0.0,1.0,37,1000,800,200,0.8,12,8,4,357.94139988815306,0.40524899899899897,0.13450659962287914,0.2171803953922595,132666.15125868042,2097.3415798610927,134763.4928385415,2247,3,447.4054054054054,35,2,15,33.22906134142231,0.6491071428571429,42.44791666666666,1030.2083333333321,29.434523809523775,0
3967,4,0,1,36,0.0,0.02702702702702703,0.972972972972973,37,950,800,150,0.8421052631578947,11,8,3,356.07122877630974,0.40490490490490494,0.13243971734537818,0.21656135389509953,132755.5941358023,2054.0895061728183,134809.6836419751,2248,4,448.4054054054054,35,2,15,33.18733153638814,0.65,42.3611111111111,1030.555555555554,29.4444444444444,0
3968,4,0,2,34,0.0,0.05555555555555555,0.9444444444444444,36,1100,700,400,0.6363636363636364,15,7,8,364.76552760457434,0.4056216931216931,0.015847681692139126,0.2145020491681507,131480.6990504535,2393.85432413706,133874.55337459056,2249,5,455.22222222222223,34,2,20,34.24864577287678,0.6393995098039216,43.601190476190474,1025.5952380952378,30.164565826330524,8
3969,4,0,0,34,0.0,0.0,1.0,34,1200,900,300,0.75,15,9,6,381.10364992510085,0.3999925727866904,0.045622460288141875,0.22378472458725548,131425.20732897145,3217.325241046819,134642.53257001826,2250,37,482.61764705882354,32,2,21,33.885913064893494,0.6435546875,43.655303030303024,1025.378787878787,32.043087121212096,0
3970,4,0,2,32,0.0,0.058823529411764705,0.9411764705882353,34,1000,600,400,0.6,14,6,8,381.85382205805956,0.3998440285204991,0.04550984495731081,0.22460525681228238,131489.9488094327,3241.987903020098,134731.93671245282,2251,38,483.61764705882354,32,2,22,33.80114079363125,0.6442057291666667,43.592171717171716,1025.6313131313132,32.050978535353536,0
3971,4,0,0,32,0.0,0.0,1.0,32,600,400,200,0.6666666666666666,8,4,4,392.7685212402956,0.3933761760752688,0.08780152071316194,0.23046448307853654,131397.0184414383,3921.7225257255113,135318.74096716382,2252,78,510.96875,30,2,22,33.61546276874672,0.6486111111111111,43.68279569892473,1025.2688172043008,34.17562724014336,0
3972,4,0,0,32,0.0,0.0,1.0,32,450,300,150,0.6666666666666666,6,3,3,389.9110669413493,0.39266213037634407,0.08616366175723744,0.22917459427090042,131461.62245008672,3851.6682942708276,135313.29074435754,2253,79,511.96875,31,1,23,33.62324360927713,0.646505376344086,43.619791666666664,1025.5208333333328,33.08131720430106,0
3973,4,0,0,32,0.0,0.0,1.0,32,1400,1200,200,0.8571428571428571,16,12,4,404.590324985746,0.39327116935483875,0.11297185430463541,0.22167321869683482,128723.56088854208,4096.492239212989,132820.05312775506,2254,80,512.96875,30,2,20,36.03945916114789,0.6215277777777778,46.303763440860216,1014.7849462365596,33.826164874551985,8
3974,4,0,0,32,0.0,0.0,1.0,32,900,700,200,0.7777777777777778,11,7,4,407.1171021060237,0.3932081653225807,0.10744137153015121,0.22435925905812767,128954.40055941376,4118.199865149814,133072.60042456357,2255,81,513.96875,29,3,23,35.73872441770363,0.6267959770114943,46.0763888888889,1015.6944444444459,35.02394636015331,8
3975,4,0,0,32,0.0,0.0,1.0,32,1200,1100,100,0.9166666666666666,13,11,2,407.10155396349967,0.3933971774193548,0.11127528013118337,0.2253531900079344,129130.79668209888,4113.869598765447,133244.66628086433,2256,82,514.96875,29,3,23,35.558440375330235,0.6285919540229885,45.902777777777786,1016.3888888888898,35.04789272030654,0
3976,4,0,0,32,0.0,0.0,1.0,32,900,600,300,0.6666666666666666,12,6,6,405.47555601063874,0.39295614919354843,0.11085831853571904,0.22505584120954403,129236.69222608028,4080.4639274691403,133317.1561535494,2257,83,515.96875,29,3,23,35.49136616127122,0.6296695402298851,45.798611111111114,1016.8055555555559,35.062260536398476,0
3977,4,1,0,33,0.030303030303030304,0.0,1.0,33,1300,900,400,0.6923076923076923,17,9,8,391.8768145495734,0.39595170454545453,0.10324795352521776,0.21920790202352078,129543.23657359244,3552.998178980248,133096.2347525727,2258,0,501.3030303030303,30,3,21,35.52394155444064,0.6298611111111111,45.497311827957,1018.0107526881729,33.93369175627243,0
3978,4,0,0,33,0.0,0.0,1.0,33,1250,1000,250,0.8,15,10,5,393.7785484380235,0.39650410353535354,0.10599262618265004,0.22104102518987712,129680.10210717995,3613.048473811996,133293.15058099193,2259,1,502.3030303030303,30,3,21,35.335840591185004,0.63125,45.36290322580645,1018.5483870967737,33.95161290322579,0
3979,4,1,0,34,0.029411764705882353,0.0,1.0,34,700,500,200,0.7142857142857143,9,5,4,383.1952097207859,0.4017008318478907,0.10890464459532523,0.21684861868014427,129996.88042534729,3162.836371527784,133159.7167968751,2260,0,488.5,31,3,22,35.28260129383724,0.6317204301075269,45.052083333333336,1019.7916666666672,32.8965053763441,0
3980,4,0,0,34,0.0,0.0,1.0,34,1200,800,400,0.6666666666666666,16,8,8,381.7410659632921,0.40197935234699944,0.10234633600792664,0.2169474063781232,130162.9151238335,3137.70599365234,133300.62111748583,2261,1,489.5,31,3,23,35.15070073582577,0.6334005376344086,44.889322916666664,1020.4427083333329,32.9175067204301,0
3981,4,0,0,34,0.0,0.0,1.0,34,1150,900,250,0.782608695652174,14,9,5,377.8486275237472,0.40168226381461675,0.1005355093714142,0.21583880449153303,130362.2966342502,3051.4429728190075,133413.7396070692,2262,2,490.5,31,3,23,35.047308640401205,0.6354166666666667,44.694010416666664,1021.2239583333331,32.94270833333333,0
3982,4,1,0,35,0.02857142857142857,0.0,1.0,35,950,700,250,0.7368421052631579,12,7,5,366.7281899060251,0.404656862745098,0.10534964911662081,0.21192808806124205,130810.95838434849,2594.413197632896,133405.3715819814,2263,0,477.45714285714286,32,3,18,34.87616226446146,0.6373697916666667,44.255050505050505,1022.9797979797977,31.968118686868678,0
3983,4,0,0,35,0.0,0.0,1.0,35,800,600,200,0.75,10,6,4,366.4815683195482,0.40462184873949575,0.1051673983180832,0.21196289422507486,130843.25140610656,2590.3279958677745,133433.57940197433,2264,1,478.45714285714286,32,3,19,34.84974700728125,0.6376953125,44.22348484848485,1023.1060606060609,31.9720643939394,0
3984,4,0,1,34,0.0,0.02857142857142857,0.9714285714285714,35,1200,800,400,0.6666666666666666,16,8,8,365.79339872073393,0.4037114845938375,0.1015677294345605,0.2128109371323641,131069.4141541681,2588.8652943577335,133658.27944852583,2265,2,479.45714285714286,32,3,19,34.63830661734483,0.6399739583333333,44.00252525252526,1023.9898989899002,31.99968434343438,0
3985,4,1,0,35,0.02857142857142857,0.0,1.0,35,1000,800,200,0.8,12,8,4,365.76950354378243,0.4040616246498599,0.11217974679086451,0.21333486572614738,131166.4008296349,2595.3338626160757,133761.73469225096,2266,0,480.22857142857146,32,3,20,34.54075763178438,0.6409505208333333,43.90782828282829,1024.3686868686882,32.011521464646506,0
3986,4,0,0,35,0.0,0.0,1.0,35,850,600,250,0.7058823529411765,11,6,5,362.9484697352108,0.4038165266106442,0.10959010190253271,0.21240466682341053,131295.7721948015,2530.7199201612043,133826.49211496272,2267,1,481.22857142857146,32,3,22,34.48215679027556,0.6422526041666667,43.781565656565654,1024.873737373737,32.02730429292928,0
3987,4,0,0,35,0.0,0.0,1.0,35,950,600,350,0.631578947368421,13,6,7,366.6738455191829,0.40360644257703077,0.10927515833919821,0.215129452717902,131392.84256708494,2635.6637715539205,134028.50633863886,2268,2,482.22857142857146,32,3,22,34.288536535303784,0.6432291666666667,43.686868686868685,1025.252525252525,32.039141414141405,0
3988,4,0,0,35,0.0,0.0,1.0,35,900,500,400,0.5555555555555556,13,5,8,367.7155218934915,0.40255602240896354,0.10906021978022018,0.2166561722541417,131554.7062321445,2674.9414919395786,134229.6477240841,2269,3,483.22857142857146,32,3,19,34.09820512820514,0.6448567708333333,43.529040404040394,1025.883838383837,32.058869949494905,0
3989,4,0,0,35,0.0,0.0,1.0,35,950,700,250,0.7368421052631579,12,7,5,366.38400647475567,0.40220588235294114,0.11389909143630361,0.21660622462787543,131684.2689043209,2649.4020061728265,134333.67091049373,2270,4,484.22857142857146,32,3,19,34.001465944970676,0.6461588541666667,43.40277777777777,1026.3888888888882,32.07465277777776,0
3990,4,0,0,35,0.0,0.0,1.0,35,1000,700,300,0.7,13,7,6,365.3147739465263,0.40126050420168063,0.11113140609083616,0.21689564753876217,131846.31191970193,2633.0811269258083,134479.39304662772,2271,5,485.22857142857146,32,3,19,33.86530817146135,0.6477864583333333,43.24494949494949,1027.020202020201,32.09438131313128,0
3991,4,0,0,35,0.0,0.0,1.0,35,900,500,400,0.5555555555555556,13,5,8,364.88006958505485,0.4011554621848739,0.11406099123931268,0.21719305970838285,131943.5855556831,2628.716935771862,134572.30249145496,2272,6,486.22857142857146,32,3,21,33.77831715210355,0.6487630208333333,43.150252525252526,1027.39898989899,32.10621843434344,0
3992,4,1,0,36,0.027777777777777776,0.0,1.0,36,1650,1400,250,0.8484848484848485,19,14,5,354.7309117312691,0.40347222222222223,0.11344137273593913,0.21263584366062918,132208.8860053825,2179.7157343329463,134388.60173971544,2273,0,473.69444444444446,33,3,22,33.77174690181126,0.648989898989899,42.8921568627451,1028.4313725490192,31.164587046939975,0
3993,4,0,0,36,0.0,0.0,1.0,36,1250,900,350,0.72,16,9,7,351.9169990008029,0.40267857142857144,0.11421737922273856,0.21183132907596725,132366.4745080018,2116.4024954344545,134482.87700343624,2274,1,474.69444444444446,33,3,22,33.68551764519075,0.6505681818181819,42.7389705882353,1029.0441176470592,31.183155080213915,0
3994,4,0,0,36,0.0,0.0,1.0,36,1050,800,250,0.7619047619047619,13,8,5,352.88687849591605,0.40153769841269843,0.11137900014551994,0.2127707747657717,132429.53619100832,2146.52912942138,134576.06532042968,2275,2,475.69444444444446,33,3,22,33.59712961860538,0.651199494949495,42.677696078431374,1029.289215686275,31.190582293523484,0
3995,4,0,0,36,0.0,0.0,1.0,36,1200,600,600,0.5,18,6,12,354.47129432800415,0.4013723544973545,0.11506236030102213,0.21408435252692767,132492.61289227707,2192.965596164937,134685.578488442,2276,3,476.69444444444446,33,3,22,33.49291255009324,0.6518308080808081,42.61642156862745,1029.5343137254906,31.19800950683305,0
3996,4,0,0,36,0.0,0.0,1.0,36,1150,900,250,0.782608695652174,14,9,5,352.79173450331245,0.40125661375661376,0.11499246211219538,0.21324864412207434,132524.15687475976,2150.6854334871196,134674.84230824688,2277,4,477.69444444444446,33,3,22,33.504423549948406,0.6521464646464646,42.58578431372549,1029.6568627450984,31.20172311348783,0
3997,4,0,1,35,0.0,0.027777777777777776,0.9722222222222222,36,850,600,250,0.7058823529411765,11,6,5,383.8639844931321,0.4008267195767196,0.12584590374655025,0.21821590917317488,130173.98787133476,2793.8211323302326,132967.809003665,2278,5,478.69444444444446,35,1,19,35.085275603946926,0.6241071428571429,44.878472222222214,1020.4861111111102,29.156746031746007,8
3998,4,1,0,36,0.027777777777777776,0.0,1.0,36,1050,500,550,0.47619047619047616,16,5,11,377.9350991987416,0.4019179894179894,0.15304677766451502,0.21681539901401478,130528.56445312487,2666.265190972209,133194.82964409707,2279,0,479.52777777777777,35,1,19,34.876189262657164,0.6276785714285714,44.53124999999999,1021.874999999999,29.19642857142854,0
3999,4,0,1,35,0.0,0.027777777777777776,0.9722222222222222,36,550,400,150,0.7272727272727273,7,4,3,381.02705926473686,0.40185185185185185,0.15583676191195184,0.21892322448711057,130587.70743580667,2751.4900280778406,133339.1974638845,2280,1,480.52777777777777,35,1,19,34.737123957271734,0.6282738095238095,44.473379629629626,1022.1064814814808,29.20304232804231,0
4000,4,0,0,35,0.0,0.0,1.0,35,1050,900,150,0.8571428571428571,12,9,3,391.2022269438658,0.39800420168067224,0.1613868139546495,0.225000235952242,130627.42524092959,3220.347930838989,133847.77317176858,2281,2,494.77142857142854,34,1,19,34.43674546795543,0.6308210784313726,44.4345238095238,1022.2619047619038,30.066526610644228,0
4001,4,0,0,35,0.0,0.0,1.0,35,1000,700,300,0.7,13,7,6,385.71937751480255,0.39775910364145656,0.1613836687177781,0.22237110421826536,130718.71456916099,3084.148242630385,133802.8628117914,2282,3,495.77142857142854,34,1,19,34.48413853317811,0.6317401960784313,44.345238095238095,1022.6190476190476,30.077030812324928,0
4002,4,0,0,35,0.0,0.0,1.0,35,900,700,200,0.7777777777777778,11,7,4,388.5635038838079,0.396953781512605,0.1644810105543093,0.22489584618729475,130870.93431122442,3170.3337585033996,134041.2680697278,2283,4,496.77142857142854,34,1,19,34.25683536940083,0.6332720588235294,44.19642857142857,1023.2142857142851,30.09453781512603,0
4003,4,0,0,35,0.0,0.0,1.0,35,800,600,200,0.75,10,6,4,389.6310364359217,0.39733893557422967,0.16292726698682292,0.22587039920698726,130931.84700963725,3203.022250566902,134134.86926020414,2284,5,497.77142857142854,34,1,19,34.16768446357257,0.6338848039215687,44.136904761904766,1023.4523809523814,30.101540616246513,0
4004,4,0,0,35,0.0,0.0,1.0,35,1000,600,400,0.6,14,6,8,386.35120138335026,0.3973039215686274,0.1576528832256241,0.22432369889908374,130992.77388038556,3121.8431122449065,134114.61699263047,2285,6,498.77142857142854,34,1,19,34.18977981935884,0.6344975490196079,44.077380952380956,1023.6904761904768,30.108543417366967,0
4005,4,0,0,35,0.0,0.0,1.0,35,1100,1000,100,0.9090909090909091,12,10,2,387.0957493092959,0.39663865546218485,0.15563525270638245,0.22564849776810192,131145.1530612245,3153.1462585034055,134298.2993197279,2286,7,499.77142857142854,34,1,20,34.01615527661553,0.6360294117647058,43.92857142857143,1024.2857142857144,30.12605042016807,0
4006,4,0,0,35,0.0,0.0,1.0,35,1200,1000,200,0.8333333333333334,14,10,4,387.65575946479026,0.39656862745098037,0.15757112977656784,0.22633415644192587,131206.12953514748,3172.5623582766607,134378.69189342414,2287,8,500.77142857142854,34,1,21,33.93998373227982,0.6366421568627452,43.86904761904763,1024.5238095238103,30.133053221288538,0
4007,4,0,0,35,0.0,0.0,1.0,35,1200,1000,200,0.8333333333333334,14,10,4,385.0221429043556,0.3964985994397759,0.1526132404181184,0.2255129694154087,131328.12500000023,3112.84722222225,134440.97222222248,2288,9,501.77142857142854,34,1,21,33.88380758807588,0.6378676470588236,43.750000000000014,1025.0000000000018,30.147058823529466,0
4008,4,0,0,35,0.0,0.0,1.0,35,950,500,450,0.5263157894736842,14,5,9,388.2962863985798,0.39628851540616244,0.15659301253372515,0.22780411865431419,131390.93888168022,3203.7227268358447,134594.66160851606,2289,10,502.77142857142854,33,2,21,33.73625388477169,0.6407828282828283,43.688725490196084,1025.2450980392164,31.06803327391565,0
4009,4,0,0,35,0.0,0.0,1.0,35,800,500,300,0.625,11,5,6,388.92640673236235,0.3962535014005602,0.15788557086513344,0.22836121018453878,131422.35145436856,3222.7245830930515,134645.0760374616,2290,11,503.77142857142854,33,2,21,33.68827437153899,0.6410984848484849,43.65808823529412,1025.367647058824,31.071746880570426,0
4010,4,0,0,35,0.0,0.0,1.0,35,1250,900,350,0.72,16,9,7,389.10485619546375,0.3954831932773109,0.15549411162314408,0.2290300735834059,131516.61169982696,3234.750456555164,134751.36215638212,2291,12,504.77142857142854,33,2,21,33.58821186778175,0.6420454545454546,43.56617647058823,1025.7352941176468,31.08288770053475,0
4011,4,0,0,35,0.0,0.0,1.0,35,800,400,400,0.5,12,4,8,369.0503818708553,0.39467787114845937,0.08232841297639903,0.20864135450322613,129958.94451530615,2592.279620181408,132551.22413548757,2292,13,505.77142857142854,34,1,19,35.68179606927418,0.6240808823529411,45.089285714285715,1019.6428571428575,29.989495798319336,8
4012,4,1,0,36,0.027777777777777776,0.0,1.0,36,550,300,250,0.5454545454545454,8,3,5,364.00566628633743,0.40041335978835974,0.0946106509525968,0.2080877621618506,130391.51178770038,2293.7127504430164,132685.2245381434,2293,0,492.69444444444446,32,4,22,35.37108006758149,0.6331380208333333,44.66540404040405,1021.338383838385,31.91682449494953,0
4013,4,1,0,37,0.02702702702702703,0.0,1.0,37,1000,400,600,0.4,16,4,12,354.0012966476325,0.40515515515515516,0.09840908870035059,0.2038255912995997,130669.48596993955,1851.4334931276526,132520.9194630672,2294,0,480.35135135135135,33,4,16,35.344874945063715,0.6335227272727273,44.39338235294118,1022.4264705882362,30.98262032085564,0
4014,4,0,0,37,0.0,0.0,1.0,37,800,400,400,0.5,12,4,8,355.60910641066647,0.4034972472472473,0.09971639104365515,0.20558343630998926,130826.15460399847,1904.5943867743204,132730.7489907728,2295,1,481.35135135135135,33,4,18,35.14514454559974,0.6351010101010102,44.240196078431374,1023.0392156862746,31.001188354129532,0
4015,4,0,0,37,0.0,0.0,1.0,37,900,500,400,0.5555555555555556,13,5,8,358.89992470149514,0.4037474974974975,0.10296811781841742,0.2078234654131405,130888.84833958103,1995.19956266822,132884.04790224927,2296,2,482.35135135135135,33,4,18,34.99750499001997,0.6357323232323233,44.17892156862746,1023.2843137254911,31.008615567439122,0
4016,4,0,0,37,0.0,0.0,1.0,37,1050,800,250,0.7619047619047619,13,8,5,361.4845275318918,0.4039977477477477,0.09983690587138883,0.20966102596849737,130951.5570934257,2067.392349096515,133018.94944252222,2297,3,483.35135135135135,33,4,18,34.86789591315454,0.6363636363636364,44.117647058823536,1023.5294117647067,31.016042780748688,0
4017,4,0,0,37,0.0,0.0,1.0,37,900,800,100,0.8888888888888888,10,8,2,360.47905607001695,0.40352852852852855,0.09855241237647006,0.20958959731837104,131045.64838343431,2047.8423262687527,133093.49070970307,2298,4,484.35135135135135,33,4,19,34.79839916217834,0.6373106060606061,44.02573529411765,1023.8970588235298,31.027183600713027,0
4018,4,0,0,37,0.0,0.0,1.0,37,1300,1000,300,0.7692307692307693,16,10,6,357.20961485013635,0.4035910910910911,0.09972297378110095,0.2087092655319351,131233.93233672148,1975.6044850538292,133209.5368217753,2299,5,485.35135135135135,33,4,20,34.691698560778214,0.6392045454545454,43.841911764705884,1024.6323529411766,31.049465240641716,0
4019,4,1,0,38,0.02631578947368421,0.0,1.0,38,800,600,200,0.75,10,6,4,347.6106394776084,0.4084874348032243,0.10193552326291333,0.2052331309792456,131633.36167800458,1551.4314058956998,133184.7930839003,2300,0,473.55263157894734,34,4,16,34.53451276102089,0.6409313725490196,43.452380952380956,1026.1904761904766,30.182072829131666,0
4020,4,0,0,38,0.0,0.0,1.0,38,850,600,250,0.7058823529411765,11,6,5,343.681897330331,0.40777619724988146,0.09404859238288155,0.20389271295539446,131816.6737528345,1460.6009070294824,133277.274659864,2301,1,474.55263157894734,34,4,17,34.45059510008501,0.6427696078431373,43.273809523809526,1026.9047619047622,30.203081232493005,0
4021,4,0,0,38,0.0,0.0,1.0,38,850,700,150,0.8235294117647058,10,7,3,345.99204546137776,0.4067093409198672,0.0944953904687571,0.2062571364932744,132000.11337868482,1534.1978458049875,133534.31122448982,2302,2,475.55263157894734,34,4,18,34.2065376892184,0.6446078431372548,43.095238095238095,1027.6190476190477,30.224089635854344,0
4022,4,0,0,38,0.0,0.0,1.0,38,1050,900,150,0.8571428571428571,12,9,3,345.8641977999209,0.40712422949265054,0.09098528022430119,0.20668078532887993,132091.8810232426,1537.1704931972768,133629.05151643988,2303,3,476.55263157894734,34,4,18,34.11744836904074,0.6455269607843137,43.00595238095238,1027.9761904761904,30.234593837535012,0
4023,4,0,0,38,0.0,0.0,1.0,38,1100,600,500,0.5454545454545454,16,6,10,347.4190491811182,0.40647226173541967,0.09725479922749347,0.20828266244799987,132214.2874858276,1586.7524092970464,133801.03989512465,2304,4,477.55263157894734,34,4,18,33.95430605394143,0.6467524509803921,42.88690476190476,1028.4523809523805,30.248599439775898,0
4024,4,0,0,38,0.0,0.0,1.0,38,1100,900,200,0.8181818181818182,13,9,4,346.0603982432456,0.4061314604077762,0.09855544372742875,0.20815134914630928,132338.45191400877,1559.419474451287,133897.87138846004,2305,5,478.55263157894734,35,3,19,33.86436070491188,0.6458333333333333,42.766203703703695,1028.935185185184,29.398148148148117,0
4025,4,0,0,38,0.0,0.0,1.0,38,1000,700,300,0.7,13,7,6,347.31628842286693,0.40562766714082504,0.06545941123996402,0.2024867689421854,131150.233892747,1510.1224922839574,132660.35638503096,2306,6,479.55263157894734,35,3,18,35.02966101694915,0.6339285714285714,43.923611111111114,1024.305555555556,29.26587301587303,8
4026,4,0,0,38,0.0,0.0,1.0,38,1200,1100,100,0.9166666666666666,13,11,2,347.46704205250103,0.4050942389758179,0.06189892377355832,0.20336318647715823,131299.269603218,1524.433766536797,132823.7033697548,2307,7,480.55263157894734,36,2,18,34.87528842984286,0.6333912037037037,43.77815315315315,1024.8873873873868,28.469094094094075,0
4027,4,0,1,37,0.0,0.02631578947368421,0.9736842105263158,38,750,500,250,0.6666666666666666,10,5,5,349.11536718321037,0.40513869132290187,0.00375939849624074,0.19586844794075406,129659.75265806356,1453.2424316208226,131112.99508968438,2308,8,481.55263157894734,36,2,17,36.49380804953561,0.6168981481481481,45.38288288288289,1018.4684684684692,28.29079079079081,7
4028,4,2,1,38,0.05128205128205128,0.02564102564102564,0.9743589743589743,39,850,500,350,0.5882352941176471,12,5,7,356.5021580033779,0.40800719748088166,-0.014611872146118365,0.1942138621958699,128496.33487654311,1420.4680046036906,129916.80288114681,2309,0,469.94871794871796,35,4,18,37.49143835616437,0.6071428571428572,46.52777777777777,1013.8888888888881,28.968253968253947,8
4029,4,0,0,38,0.0,0.0,1.0,38,850,700,150,0.8235294117647058,10,7,3,356.66241133690147,0.40371621621621623,0.009880805836610884,0.19501846758377667,128643.06205257624,1576.4289426868916,130219.49099526313,2310,1,482.92105263157896,35,3,18,37.33754040692147,0.6086309523809523,46.38310185185185,1014.467592592592,28.984788359788343,0
4030,4,0,0,38,0.0,0.0,1.0,38,1050,600,450,0.5714285714285714,15,6,9,365.09392228273555,0.4040125651967757,-0.0016610891390329563,0.18382202722617375,125289.51930084029,1548.4884044924647,126838.00770533275,2311,2,483.92105263157896,35,3,17,40.572736030828516,0.5744047619047619,49.71064814814815,1001.1574074074082,28.604497354497376,7
4031,4,1,1,38,0.02564102564102564,0.02564102564102564,0.9743589743589743,39,1200,900,300,0.75,15,9,6,358.14680647774463,0.4094410706252811,0.006181267246196498,0.1817686927745088,125620.13660620087,1198.0901509617797,126818.22675716266,2312,0,472.4871794871795,36,3,18,40.40477795252002,0.5758101851851851,49.380630630630634,1002.4774774774781,27.846596596596616,0
4032,4,1,0,39,0.02564102564102564,0.0,1.0,39,600,300,300,0.5,9,3,6,354.53240859231227,0.40997525865946916,0.04635323901378974,0.18154914614492224,125988.78981994448,1133.4218220990938,127122.21164204356,2313,0,472.61538461538464,37,2,19,40.11486092908111,0.5777027027027026,49.013157894736835,1003.9473684210516,27.133712660028422,0
4033,4,5,2,42,0.11363636363636363,0.045454545454545456,0.9545454545454546,44,600,500,100,0.8333333333333334,7,5,2,317.6456002861602,0.4258720930232558,0.05727181085043975,0.16689853574357577,127040.782602948,-729.1868239923333,126311.59577895567,2314,0,419.79545454545456,40,4,18,39.96177755376347,0.5833333333333333,47.96747967479675,1008.1300813008132,25.203252032520332,0
4034,4,1,1,42,0.023255813953488372,0.023255813953488372,0.9767441860465116,43,1250,700,550,0.56,18,7,11,321.6758840082995,0.4218346253229974,0.05812236600837295,0.1687096182571149,126967.00330884672,-431.5553941484046,126535.4479146983,2315,0,430.5348837209302,41,2,19,39.9357507300587,0.5810467479674797,48.0406746031746,1007.8373015873018,24.581397599690288,0
4035,4,1,0,43,0.023255813953488372,0.0,1.0,43,1000,700,300,0.7,13,7,6,320.7030638773766,0.41922757475083056,0.054735794341636224,0.16882968320906588,127118.94729572987,-446.3282894587508,126672.61900627112,2316,0,431.4418604651163,38,5,20,39.804710951018826,0.5874451754385965,47.88995726495725,1008.4401709401686,26.537899235267595,0
4036,4,3,2,44,0.06521739130434782,0.043478260869565216,0.9565217391304348,46,1050,500,550,0.47619047619047616,16,5,11,304.52849185849004,0.42805958132045085,0.07343966565025428,0.16331762096250893,127868.45243016137,-1412.0826050328092,126456.36982512857,2317,0,404.2391304347826,41,5,15,39.44774807912373,0.5901930894308943,47.147817460317434,1011.408730158726,24.668505613627463,0
4037,4,2,4,42,0.043478260869565216,0.08695652173913043,0.9130434782608696,46,1100,800,300,0.7272727272727273,14,8,6,303.4002227582206,0.42939814814814814,0.07818033059330443,0.16352839264670435,128069.20750070806,-1428.7547831633156,126640.45271754474,2318,0,405.17391304347825,41,5,17,39.27184406547094,0.5922256097560976,46.94940476190474,1012.2023809523764,24.687862950057962,0
4038,4,1,0,43,0.023255813953488372,0.0,1.0,43,1100,900,200,0.8181818181818182,13,9,4,327.18775704334746,0.4245108896271687,0.0892337107313923,0.17502418003963782,127766.20513048784,-239.29238348310008,127526.91274700474,2319,0,434.06976744186045,38,5,18,38.97922610870409,0.5940241228070176,47.24893162393162,1011.0042735042723,26.605375618533483,0
4039,4,1,0,44,0.022727272727272728,0.0,1.0,44,700,300,400,0.42857142857142855,11,3,8,323.0192888295202,0.42788715644820297,0.09348891820333671,0.17408643536086799,128065.44189453137,-526.4784071180406,127538.96348741332,2320,0,425.1818181818182,39,5,19,38.77922283969676,0.5953525641025641,46.95312500000001,1012.1875000000009,25.953525641025664,0
4040,4,0,0,44,0.0,0.0,1.0,44,950,700,250,0.7368421052631579,12,7,5,323.2908262629339,0.42778805496828753,0.09156378600823034,0.17457704618198455,128144.53125000028,-514.4097222221928,127630.12152777809,2321,1,426.1818181818182,39,5,20,38.691700960219485,0.5961538461538461,46.875000000000014,1012.5000000000022,25.961538461538517,0
4041,4,2,0,46,0.043478260869565216,0.0,1.0,46,1250,700,550,0.56,18,7,11,310.69509125066276,0.43142109500805154,0.10661230112500975,0.1699020322529028,128647.25548784353,-1205.9858434114121,127441.26964443212,2322,0,408.60869565217394,41,5,17,38.49908729382621,0.598069105691057,46.37896825396827,1014.4841269841289,24.74351529229583,0
4042,4,0,0,46,0.0,0.0,1.0,46,1100,700,400,0.6363636363636364,15,7,8,309.29350713180537,0.430384460547504,0.10197334874392383,0.16977956893630036,128798.26467624109,-1232.7066011589586,127565.55807508212,2323,1,409.60869565217394,41,5,18,38.381222309095655,0.5995934959349594,46.23015873015874,1015.0793650793669,24.758033294618706,0
4043,4,2,1,47,0.041666666666666664,0.020833333333333332,0.9791666666666666,48,1200,900,300,0.75,15,9,6,310.3488721426499,0.43415706264775417,0.1404154295075255,0.17291371558569668,129386.78521050357,-1566.471901622328,127820.31330888125,2324,0,393.5,39,9,20,37.757350431725875,0.6087072649572649,45.65104166666667,1017.3958333333342,26.087072649572672,0
4044,4,1,2,46,0.020833333333333332,0.041666666666666664,0.9583333333333334,48,1450,1000,450,0.6896551724137931,19,10,9,312.3530034184401,0.43337211879432624,0.13943619924940354,0.1743822196227519,129466.28146701382,-1512.1636284722265,127954.11783854158,2325,0,394.3541666666667,39,9,12,37.625810303650645,0.6095085470085471,45.572916666666664,1017.7083333333327,26.095085470085454,0
4045,4,0,0,46,0.0,0.0,1.0,46,1600,1200,400,0.75,20,12,8,326.09876032983,0.42971014492753623,0.14832188346439001,0.18160530002041747,129368.65790435481,-762.6082063712333,128606.04969798357,2326,2,412.32608695652175,37,9,20,37.37515269095351,0.6120495495495495,45.66885964912279,1017.3245614035058,27.495258416310968,0
4046,4,0,0,46,0.0,0.0,1.0,46,1100,700,400,0.6363636363636364,15,7,8,323.9392398784801,0.429579307568438,0.14555973981513204,0.18075695722568924,129445.89548405622,-813.4790023011517,128632.41648175508,2327,3,413.32608695652175,38,8,13,37.351706036745405,0.6110197368421053,45.5929487179487,1017.6282051282026,26.77968960863691,0
4047,4,0,0,46,0.0,0.0,1.0,46,1450,1300,150,0.896551724137931,16,13,3,319.5859211709157,0.4298409822866345,0.14600510113292575,0.17882174062464173,129554.63927469104,-919.232253086459,128635.40702160458,2328,4,414.32608695652175,38,8,13,37.35220554797634,0.6121162280701755,45.48611111111109,1018.0555555555529,26.79093567251455,0
4048,4,0,0,46,0.0,0.0,1.0,46,1000,700,300,0.7,13,7,6,319.16272370525735,0.42967995169082124,0.13715829552449765,0.17932920274187522,129717.84056770006,-919.780138249725,128798.06042945033,2329,5,415.32608695652175,38,8,13,37.19760531375633,0.6137609649122807,45.325854700854684,1018.6965811965788,26.80780476833102,0
4049,4,1,0,47,0.02127659574468085,0.0,1.0,47,1050,700,350,0.6666666666666666,14,7,7,311.8686028576801,0.43114014801110084,0.13764390902596557,0.17674902128077538,130055.18297846832,-1287.97435802104,128767.20862044729,2330,0,407.468085106383,40,7,14,37.042110856497615,0.6138020833333333,44.99491869918698,1020.0203252032506,25.500508130081265,0
4050,4,1,5,43,0.020833333333333332,0.10416666666666667,0.8958333333333334,48,1000,200,800,0.2,18,2,16,347.77581801849016,0.43291038711583923,0.12346653964433729,0.1888900031198467,128376.15258774544,-561.0784751140164,127815.07411263142,2331,0,399.9583333333333,40,8,13,37.835313878860795,0.596875,46.646341463414636,1013.4146341463419,25.335365853658548,8
4051,4,0,0,43,0.0,0.0,1.0,43,1900,1500,400,0.7894736842105263,23,15,8,367.9994580771902,0.4215577703949797,0.15446454206144122,0.19871970736168268,128144.53124999999,831.423611111111,128975.9548611111,2332,1,445.95348837209303,36,7,17,37.56001371742113,0.6015625,46.875,1012.4999999999999,28.124999999999996,0
4052,4,0,0,43,0.0,0.0,1.0,43,1150,1000,150,0.8695652173913043,13,10,3,369.0184438520636,0.4215808416389812,0.15033339458362804,0.19996254561578972,128283.34349270926,867.783957563861,129151.12745027312,2333,2,446.95348837209303,37,6,18,37.39210141790236,0.6010698198198199,46.737938596491226,1013.0482456140348,27.379682313892832,0
4053,4,1,0,44,0.022727272727272728,0.0,1.0,44,1250,1000,250,0.8,15,10,5,373.2225886678202,0.4234716349541931,0.2059241310160429,0.1952241233031673,126858.71056241411,726.7167616151388,127585.42732402925,2334,0,437.77272727272725,35,9,16,38.748468137254896,0.5904761904761905,48.14814814814814,1007.4074074074061,28.783068783068746,7
4054,4,1,0,45,0.022222222222222223,0.0,1.0,45,1200,1000,200,0.8333333333333334,14,10,4,363.54043750432817,0.4260942760942761,0.2007574888098247,0.19139140978702165,127121.19187510703,242.95307677467585,127364.14495188171,2335,0,429.02222222222224,35,10,18,38.7224310417384,0.5931547619047619,47.887731481481474,1008.449074074073,28.812830687830658,0
4055,4,2,1,46,0.0425531914893617,0.02127659574468085,0.9787234042553191,47,1950,1400,550,0.717948717948718,25,14,11,349.62501054928674,0.4316797718162195,0.20819481382978755,0.18646667229295247,127645.42936288055,-474.3930824869548,127171.03628039359,2336,0,411.72340425531917,37,10,15,38.53578920717591,0.5945945945945945,47.36842105263156,1010.5263157894709,27.31152204836408,0
4056,4,2,0,48,0.041666666666666664,0.0,1.0,48,650,400,250,0.6153846153846154,9,4,5,346.22806218893413,0.4342863475177305,0.23155478150728337,0.1865850205448214,128063.41428336618,-732.1704470742952,127331.24383629188,2337,0,404.0833333333333,38,10,17,38.194004644289656,0.5970394736842105,46.955128205128204,1012.179487179487,26.636302294197026,0
4057,4,0,0,48,0.0,0.0,1.0,48,1150,600,550,0.5217391304347826,17,6,11,339.5688896769103,0.4335660460992908,0.21820758058802725,0.1753755901130472,126339.0370461682,-1019.8130113595134,125319.22403480869,2338,1,405.0833333333333,38,10,15,40.12995926319518,0.5794956140350878,48.6645299145299,1005.3418803418783,26.45636527215469,7
4058,4,2,1,49,0.04,0.02,0.98,50,1300,1000,300,0.7692307692307693,16,10,6,325.68523255935344,0.4387585034013606,0.2230930537352558,0.1710149190977356,127015.17083292018,-1726.6069097428795,125288.5639231773,2339,0,389.84,40,10,19,39.78538663171692,0.5830729166666666,47.99288617886179,1008.0284552845526,25.200711382113816,0
4059,4,3,1,51,0.057692307692307696,0.019230769230769232,0.9807692307692307,52,1050,400,650,0.38095238095238093,17,4,13,311.9375306787642,0.4450964680744092,0.23538391882792697,0.16588267080878746,127527.89680621655,-2443.8060802101936,125084.09072600635,2340,0,375.7307692307692,40,12,17,39.60785793339369,0.58828125,47.484756097560975,1010.0609756097563,25.251524390243908,0
4060,4,0,1,50,0.0,0.0196078431372549,0.9803921568627451,51,950,600,350,0.631578947368421,13,6,7,317.63419263675183,0.44267973856209153,0.2328183594461095,0.1686279224217235,127459.90125868049,-2102.8754340277883,125357.0258246527,2341,1,384.0980392156863,39,12,17,39.533474314008664,0.5892094017094017,47.55208333333333,1009.7916666666661,25.892094017094003,0
4061,4,1,0,51,0.0196078431372549,0.0,1.0,51,1850,1400,450,0.7567567567567568,23,14,9,320.80586471438085,0.44312091503267975,0.25036619490660805,0.171538342537359,127749.32861328125,-2003.4532335069418,125745.87537977431,2342,0,385.03921568627453,39,12,18,39.15775802850765,0.5921474358974359,47.265625,1010.9375,25.921474358974358,0
4062,4,1,0,52,0.019230769230769232,0.0,1.0,52,850,400,450,0.47058823529411764,13,4,9,315.93955839648356,0.4458427601809955,0.2588209350191124,0.17028691570625018,128069.20750070839,-2307.574227607728,125761.63327310067,2343,0,378.61538461538464,41,11,19,38.95453543075566,0.5922256097560976,46.94940476190475,1012.2023809523791,24.68786295005803,0
4063,4,1,1,52,0.018867924528301886,0.018867924528301886,0.9811320754716981,53,1400,1000,400,0.7142857142857143,18,10,8,310.9239364001794,0.44762941461054667,0.2646693761399841,0.16887437329970556,128376.15258774557,-2616.91197095285,125759.24061679273,2344,0,372.45283018867923,40,13,13,38.76896978205642,0.596875,46.64634146341464,1013.4146341463429,25.335365853658573,0
4064,4,1,0,53,0.018867924528301886,0.0,1.0,53,1250,600,650,0.48,19,6,13,313.7803382488462,0.44691884373488144,0.26896627377403903,0.17086641126476482,128479.16253552795,-2537.152984334698,125942.00955119326,2345,0,373.4339622641509,40,13,16,38.59178695535955,0.5979166666666667,46.54471544715448,1013.8211382113834,25.345528455284587,0
4065,4,2,1,54,0.03636363636363636,0.01818181818181818,0.9818181818181818,55,1500,800,700,0.5333333333333333,22,8,14,302.0035908717786,0.44974747474747473,0.27853699143283195,0.1666424024578808,129004.4355807948,-3208.0394432425624,125796.39613755223,2346,0,360.8181818181818,42,13,19,38.357059964390174,0.6001984126984127,46.02713178294575,1015.8914728682201,24.1878922111481,0
4066,4,1,1,54,0.01818181818181818,0.01818181818181818,0.9818181818181818,55,1150,500,650,0.43478260869565216,18,5,13,303.10184306591486,0.4495089786756454,0.29544001162706146,0.16852462474464874,129304.72932778116,-3161.199182009478,126143.53014577167,2347,0,361.58181818181816,40,15,20,38.02478850253129,0.60625,45.73170731707317,1017.0731707317079,25.4268292682927,0
4067,4,0,1,53,0.0,0.018518518518518517,0.9814814814814815,54,1850,1400,450,0.7567567567567568,23,14,9,312.0319336535553,0.4478802702073142,0.2983437983437982,0.17396848903698195,129413.28124999975,-2723.784722222252,126689.4965277775,2348,1,369.14814814814815,39,15,22,37.687687687687685,0.608974358974359,45.624999999999986,1017.4999999999981,26.08974358974354,0
4068,4,1,0,54,0.018518518518518517,0.0,1.0,54,1000,600,400,0.6,14,6,8,356.5799842395593,0.44798218029350106,0.3549382716049394,0.18621399176954723,126792.09183673441,-1515.3344671202121,125276.7573696142,2349,0,369.81481481481484,34,20,21,39.23611111111114,0.5919117647058824,48.2142857142857,1007.1428571428548,29.621848739495732,8
4069,4,1,1,54,0.01818181818181818,0.01818181818181818,0.9818181818181818,55,1500,1200,300,0.8,18,12,6,349.3419707201351,0.44876543209876546,0.35010221536150876,0.18431383878914623,127208.74592764053,-2112.1292009602234,125096.61672668031,2350,0,364.07272727272726,35,20,22,38.990553770842894,0.594047619047619,47.800925925925924,1008.7962962962957,28.822751322751305,0
4070,4,1,1,54,0.01818181818181818,0.01818181818181818,0.9818181818181818,55,1700,1100,600,0.6470588235294118,23,11,12,345.7709983747343,0.4488215488215488,0.3526322370889079,0.18348577796965823,127442.37075617282,-2186.824845679018,125255.5459104938,2351,0,365.0,35,20,17,38.84112792297109,0.5964285714285714,47.56944444444444,1009.7222222222222,28.849206349206348,0
4071,4,2,0,56,0.03571428571428571,0.0,1.0,56,1850,1300,550,0.7027027027027027,24,13,11,341.0467277409117,0.4500676406926407,0.36160148470034437,0.18305161101195874,127901.25739644974,-2475.9389381985447,125425.3184582512,2352,0,359.44642857142856,38,18,20,38.49083755809042,0.5953947368421053,47.11538461538462,1011.5384615384619,26.619433198380577,0
4072,4,0,1,55,0.0,0.017857142857142856,0.9821428571428571,56,1500,1200,300,0.8,18,12,6,344.80436390170684,0.45,0.36697365713109664,0.18594943442823478,128091.80230034738,-2366.6775173610918,125725.12478298628,2353,1,360.44642857142856,39,17,20,38.20101872813337,0.5956196581196581,46.92708333333334,1012.291666666668,25.956196581196615,0
4073,4,0,2,53,0.0,0.03636363636363636,0.9636363636363636,55,1400,1000,400,0.7142857142857143,18,10,8,360.83881343070533,0.4484988776655443,0.37294698968577533,0.1945900829400077,128090.45041867568,-1755.9987718240839,126334.4516468516,2354,2,367.8727272727273,38,17,20,37.796613896218105,0.5973135964912281,46.92841880341881,1012.2863247863256,26.639113810166464,0
4074,4,2,4,51,0.03636363636363636,0.07272727272727272,0.9272727272727272,55,1050,600,450,0.5714285714285714,15,6,9,356.8673700785323,0.4489057239057239,0.28442041230145265,0.19147713932030416,127887.41949443161,-1862.6140617355948,126024.80543269601,2355,0,359.0,40,15,19,38.1049264878261,0.5919270833333333,47.129065040650424,1011.4837398374016,25.28709349593504,8
4075,4,1,1,51,0.019230769230769232,0.019230769230769232,0.9807692307692307,52,1800,1300,500,0.7222222222222222,23,13,10,376.1286030108115,0.44655762946204125,0.32633097604910266,0.20170989733556546,127867.13219452147,-781.1028393351712,127086.0293551863,2356,0,379.5,37,15,20,37.63867808615208,0.5968468468468469,47.14912280701755,1011.4035087719304,27.33522996680893,0
4076,4,2,1,52,0.03773584905660377,0.018867924528301886,0.9811320754716981,53,1250,800,450,0.64,17,8,9,377.93893747979837,0.4461780358006773,0.35708621476385205,0.2061001196832858,128536.57171201818,-883.002638959548,127653.56907305864,2357,0,373.22641509433964,34,19,19,36.90689324567583,0.6096813725490196,46.48809523809524,1014.0476190476194,29.824929971988805,0
4077,4,0,1,51,0.0,0.019230769230769232,0.9807692307692307,52,1650,1500,150,0.9090909090909091,18,15,3,383.0298088529652,0.4455992332830568,0.3622190009122028,0.20871816263600151,128506.3934948979,-555.6441326530676,127950.74936224484,2358,1,381.40384615384613,34,18,19,36.80873547023599,0.609375,46.51785714285714,1013.928571428571,29.82142857142856,0
4078,4,1,1,51,0.019230769230769232,0.019230769230769232,0.9807692307692307,52,1150,700,450,0.6086956521739131,16,7,9,380.71937939048354,0.4452692936148819,0.37468771701976133,0.209358838608732,128868.76594387752,-587.432681405897,128281.33326247161,2359,0,381.9807692307692,34,18,20,36.496560753507644,0.6130514705882353,46.160714285714285,1015.3571428571425,29.86344537815125,0
4079,4,0,1,50,0.0,0.0196078431372549,0.9803921568627451,51,1750,1400,350,0.8,21,14,7,392.7262681138208,0.4448856209150327,0.37670911956382924,0.21607767978692688,128890.09785899652,-76.29457420222906,128813.8032847943,2360,1,388.6470588235294,33,18,20,36.16994528924292,0.615530303030303,46.13970588235294,1015.4411764705881,30.770944741532972,0
4080,4,1,1,50,0.0196078431372549,0.0196078431372549,0.9803921568627451,51,1750,1100,650,0.6285714285714286,24,11,13,392.6130159999269,0.4449019607843137,0.38519916691351597,0.21755499958620222,129171.13272392281,-57.14640022676434,129113.98632369605,2361,0,389.52941176470586,34,17,22,35.88534957254949,0.6161151960784313,45.863095238095234,1016.5476190476184,29.89845938375348,0
4081,4,0,0,50,0.0,0.0,1.0,50,1450,1000,450,0.6896551724137931,19,10,9,396.3988175221712,0.44366496598639454,0.39672131147541,0.21982116244411343,129201.38888888904,243.06264172337643,129444.45153061241,2362,1,398.08,31,19,22,35.758196721311464,0.6236559139784946,45.83333333333334,1016.6666666666679,32.79569892473122,0
4082,4,0,0,50,0.0,0.0,1.0,50,1500,1000,500,0.6666666666666666,20,10,10,393.94087512473374,0.44303571428571425,0.392535683256795,0.21934911063441467,129361.8974626314,192.18781884502084,129554.08528147642,2363,2,399.08,32,18,22,35.65662363989905,0.6227213541666667,45.67550505050505,1017.2979797979801,31.79056186868688,0
4083,4,1,0,51,0.0196078431372549,0.0,1.0,51,1550,1000,550,0.6451612903225806,21,10,11,383.5972158021938,0.4437418300653595,0.3943743041008507,0.2154364903883672,129700.23548635142,-249.4701557093405,129450.76533064208,2364,0,392.2352941176471,33,18,20,35.574570901507855,0.6237373737373737,45.34313725490196,1018.6274509803923,30.86749851455734,0
4084,4,1,0,52,0.019230769230769232,0.0,1.0,52,1100,700,400,0.6363636363636364,15,7,8,376.42047237681294,0.4451828808446456,0.3912991297820536,0.21333721048597082,130055.90284475709,-608.8591231567525,129447.04372160033,2365,0,385.6730769230769,35,17,21,35.39527308143274,0.6229166666666667,44.99421296296295,1020.0231481481458,29.14351851851845,0
4085,4,1,0,53,0.018867924528301886,0.0,1.0,53,1200,700,500,0.5833333333333334,17,7,10,316.3509032019763,0.4464501693275278,0.27843734219905847,0.17431649876113192,128949.36244173587,-2441.35054484758,126508.01189688829,2366,0,379.37735849056605,41,12,19,38.04860975450933,0.6011178861788617,46.0813492063492,1015.6746031746026,24.772551296941526,8
4086,4,1,0,54,0.018518518518518517,0.0,1.0,54,1400,900,500,0.6428571428571429,19,9,10,310.4104131048201,0.4466427905893315,0.27636539785925174,0.17249251152041922,129282.86540516102,-2772.866278469538,126509.99912669149,2367,0,373.3333333333333,38,16,21,37.861119865532075,0.609375,45.753205128205124,1016.9871794871791,26.762820512820504,0
4087,4,1,1,54,0.01818181818181818,0.01818181818181818,0.9818181818181818,55,1450,1000,450,0.6896551724137931,19,10,9,306.7467407405428,0.4477553310886644,0.2901353965183764,0.1719470262316252,129625.3472222221,-3047.5694444444493,126577.77777777765,2368,0,367.5272727272727,39,16,19,37.60740589198038,0.6111111111111112,45.416666666666664,1018.3333333333323,26.111111111111086,0
4088,4,2,0,56,0.03571428571428571,0.0,1.0,56,1550,1100,450,0.7096774193548387,20,11,9,336.9126783035371,0.44969561688311693,0.29308182906026414,0.18661569970001468,129155.34830524062,-2440.935137051026,126714.4131681896,2369,0,356.7857142857143,45,11,18,37.31695182082814,0.5976851851851852,45.878623188405804,1016.4855072463779,22.588566827697285,8
4089,4,0,2,54,0.0,0.03571428571428571,0.9642857142857143,56,1550,900,650,0.5806451612903226,22,9,13,315.70704184061333,0.44977678571428575,0.24556504599211593,0.16991022548847717,128009.92565923496,-3099.132452696565,124910.7932065384,2370,1,357.7857142857143,46,10,14,39.02084245875312,0.5849184782608696,47.00797872340426,1011.968085106383,21.99930619796485,8
4090,4,1,2,53,0.01818181818181818,0.03636363636363636,0.9636363636363636,55,1200,900,300,0.75,15,9,6,325.58173055267787,0.4482463524130191,0.25365059995932504,0.17551258267854186,128075.75651287807,-2660.174710538755,125415.58180233932,2371,0,365.1818181818182,45,10,16,38.70385906040269,0.5868055555555556,46.942934782608695,1012.2282608695651,22.493961352657003,0
4091,4,1,1,53,0.018518518518518517,0.018518518518518517,0.9814814814814815,54,1650,1100,550,0.6666666666666666,22,11,11,295.6272006507231,0.4480986489634288,0.1991252349933752,0.15831029330734286,127809.16856777997,-3238.2464126409805,124570.922155139,2372,0,369.1666666666667,43,11,11,39.73317412748955,0.5867248062015504,47.20643939393939,1011.1742424242416,23.51568005637771,8
4092,4,1,0,54,0.018518518518518517,0.0,1.0,54,1750,1400,350,0.8,21,14,7,298.3569029961092,0.44887025390170043,0.2161633733291699,0.1612162788206741,128170.25662634666,-3150.585610487079,125019.67101585958,2373,0,370.0,40,14,14,39.29667636825907,0.5947916666666666,46.849593495934954,1012.6016260162594,25.315040650406484,0
4093,4,1,2,53,0.01818181818181818,0.03636363636363636,0.9636363636363636,55,1500,1000,500,0.6666666666666666,20,10,10,294.33458001688325,0.450645342312009,0.21516723464457654,0.1600434488575035,128420.90778730443,-3440.25720820739,124980.65057909704,2374,0,364.25454545454545,41,14,10,39.143808521744795,0.5957825203252032,46.602182539682524,1013.5912698412674,24.721738288811398,0
4094,4,2,0,55,0.03636363636363636,0.0,1.0,55,1600,1100,500,0.6875,21,11,10,300.2526721134223,0.4499158249158249,0.23539491108168376,0.16450372699776067,128722.74900990466,-3270.13012959816,125452.6188803065,2375,0,364.8727272727273,41,14,13,38.68729022061459,0.5988313008130082,46.30456349206348,1014.7817460317442,24.750774293457177,0
4095,4,0,0,55,0.0,0.0,1.0,55,1650,1400,250,0.8484848484848485,19,14,5,302.5023760194582,0.44981762065095393,0.23781457183519095,0.16609092721068325,128807.63250405592,-3207.0770236164,125600.55548043952,2376,1,365.8727272727273,42,13,13,38.54405307369225,0.5982142857142857,46.220930232558125,1015.1162790697648,24.16943521594678,0
4096,4,1,1,55,0.017857142857142856,0.017857142857142856,0.9821428571428571,56,1300,900,400,0.6923076923076923,17,9,8,299.9086591258145,0.45031791125541126,0.24832095264720344,0.16580730659861498,129081.07284672008,-3457.4937048037173,125623.57914191636,2377,0,360.32142857142856,43,13,16,38.3325761811574,0.5995639534883721,45.95170454545455,1016.1931818181822,23.63239957716703,0
4097,4,0,0,55,0.0,0.0,1.0,55,1850,1400,450,0.7567567567567568,23,14,9,308.2676224394561,0.45001402918069583,0.2528364676315107,0.17073534104487312,129152.1364776756,-3037.3155910101605,126114.82088666543,2378,1,366.6363636363636,42,13,18,38.0481410867493,0.6016865079365079,45.88178294573643,1016.472868217054,24.201734957548904,0
4098,4,0,0,55,0.0,0.0,1.0,55,1700,1000,700,0.5882352941176471,24,10,14,309.56403399194664,0.4497755331088664,0.2466507416052819,0.17223048450391326,129330.57089240887,-2992.7625722933412,126337.80832011552,2379,2,367.6363636363636,40,15,19,37.83428247910213,0.6065104166666666,45.70630081300814,1017.1747967479695,25.429369918699237,0
4099,4,0,0,55,0.0,0.0,1.0,55,2050,1700,350,0.8292682926829268,24,17,7,312.601674381692,0.4492143658810326,0.2576713621841418,0.1747220072883388,129511.53413973181,-2902.8955152356207,126608.63862449619,2380,3,368.6363636363636,40,15,15,37.57363218849841,0.6083333333333334,45.528455284552855,1017.88617886179,25.44715447154475,0
4100,4,0,1,54,0.0,0.01818181818181818,0.9818181818181818,55,1350,800,550,0.5925925925925926,19,8,11,311.2628234723644,0.4492564534231201,0.2551405684426342,0.17454755198749686,129640.87106095931,-2929.5232872297984,126711.34777372952,2381,4,369.6363636363636,40,15,15,37.476715563982296,0.6096354166666667,45.401422764227654,1018.3943089430912,25.45985772357728,0
4101,4,0,0,54,0.0,0.0,1.0,54,1450,1100,350,0.7586206896551724,18,11,7,315.90599900706644,0.44821511763335664,0.2520178250687759,0.17684222418643,129572.31445312504,-2613.465711805556,126958.84874131948,2382,5,377.0740740740741,39,15,15,37.42795511902325,0.6105769230769231,45.46875,1018.1250000000003,26.10576923076924,0
4102,4,0,0,54,0.0,0.0,1.0,54,1350,900,450,0.6666666666666666,18,9,9,319.5603928735266,0.4476764500349406,0.25367851745804515,0.1794934567438378,129704.9167209201,-2510.2891710069493,127194.62754991314,2383,6,378.0740740740741,39,15,15,37.20057009919215,0.6119123931623931,45.338541666666664,1018.6458333333329,26.11912393162392,0
4103,4,0,1,53,0.0,0.018518518518518517,0.9814814814814815,54,1300,900,400,0.6923076923076923,17,9,8,286.2765151686589,0.4479093873747962,0.07245646286742158,0.16043472500129904,129616.12335249929,-3378.7895793951066,126237.33377310418,2384,7,379.0740740740741,45,9,13,38.13786099745002,0.6023148148148147,45.42572463768115,1018.2971014492739,22.628824476650532,8
4104,4,1,0,54,0.018518518518518517,0.0,1.0,54,1900,1400,500,0.7368421052631579,24,14,10,285.6499116053878,0.4472615303983229,0.09671293828038041,0.16121886184588952,129892.98220568174,-3379.2162229573532,126513.76598272438,2385,0,379.77777777777777,45,9,15,37.874311355962334,0.6050925925925925,45.15398550724638,1019.3840579710157,22.65297906602257,0
4105,4,0,0,54,0.0,0.0,1.0,54,1650,1200,450,0.7272727272727273,21,12,9,286.67363869647573,0.4463880153738644,0.10158950885528317,0.16248605353899734,130059.04271037653,-3343.1001961672164,126715.94251420931,2386,1,380.77777777777777,46,8,16,37.6807028217162,0.6055253623188406,44.99113475177304,1020.0354609929061,22.174683934628394,0
4106,4,0,1,53,0.0,0.018518518518518517,0.9814814814814815,54,1350,800,550,0.5925925925925926,19,8,11,287.6074613489276,0.4459658164453762,0.10282257415932361,0.1636789274597235,130217.34103069533,-3309.704224510822,126907.63680618451,2387,2,381.77777777777777,46,8,16,37.49728567706071,0.6071105072463768,44.835992907801426,1020.6560283687959,22.18817452975643,0
4107,4,0,0,53,0.0,0.0,1.0,53,1500,1200,300,0.8,18,12,6,289.0462307371929,0.44398584905660377,0.11382364266461353,0.16468913146654024,130262.58680555562,-3069.6180555555447,127192.96875000007,2388,3,389.7169811320755,45,8,16,37.41496598639457,0.6087962962962963,44.79166666666667,1020.8333333333339,22.685185185185198,0
4108,4,0,3,50,0.0,0.05660377358490566,0.9433962264150944,53,1700,1100,600,0.6470588235294118,23,11,12,286.3263206592331,0.4430787373004354,0.12425858519426813,0.16385156609820414,130431.81392224814,-3130.787724546587,127301.02619770155,2389,4,390.7169811320755,43,10,16,37.31391567009675,0.6131298449612403,44.625946969696976,1021.4962121212128,23.75572586328402,0
4109,4,1,1,50,0.0196078431372549,0.0196078431372549,0.9803921568627451,51,1400,1100,300,0.7857142857142857,17,11,6,291.17145975797837,0.44073529411764706,0.17262409133479029,0.1677096748562331,130683.32732407918,-2589.7489634036287,128093.57836067554,2390,0,405.70588235294116,42,9,15,36.9369155926207,0.6170634920634921,44.379844961240316,1022.4806201550394,24.344776670358083,0
4110,4,1,2,49,0.0196078431372549,0.0392156862745098,0.9607843137254902,51,750,400,350,0.5333333333333333,11,4,7,294.11141109249576,0.4418464052287581,0.1822487449085919,0.1699471355721664,130807.20364048141,-2505.621751246908,128301.58188923451,2391,0,406.4313725490196,42,9,16,36.737078084051646,0.6183035714285714,44.25872093023256,1022.9651162790703,24.35631229235882,0
4111,4,0,0,49,0.0,0.0,1.0,49,1850,1400,450,0.7567567567567568,23,14,9,297.3585648330656,0.4397675736961451,0.16794382609521707,0.1718812511523866,130820.18455530376,-2019.8995338876107,128800.28502141614,2392,1,412.2040816326531,41,8,16,36.64096845099559,0.6199186991869918,44.246031746031754,1023.0158730158743,24.95160665892376,0
4112,4,0,0,49,0.0,0.0,1.0,49,1300,900,400,0.6923076923076923,17,9,8,296.8540477111113,0.4396967120181406,0.1672294390277198,0.17215532379064277,130947.07739866778,-2025.5660076530587,128921.51139101472,2393,2,413.2040816326531,41,8,17,36.526182514296806,0.6211890243902439,44.12202380952381,1023.5119047619046,24.963704994192796,0
4113,4,1,1,49,0.02,0.02,0.98,50,2050,1600,450,0.7804878048780488,25,16,9,291.3147047038259,0.44074829931972787,0.16016452143617466,0.17074049028387042,131353.54785722174,-2346.4023919752967,129007.14546524645,2394,0,405.92,41,9,19,36.25953659795477,0.6252540650406504,43.72519841269842,1025.0992063492076,25.002419667053843,0
4114,4,0,0,49,0.0,0.0,1.0,49,1400,1000,400,0.7142857142857143,18,10,8,297.11150770044304,0.4395727040816326,0.1630993860959018,0.17402245451025955,131328.12500000012,-1996.180555555542,129331.94444444457,2395,1,415.0204081632653,41,8,19,36.13651761517616,0.625,43.75000000000001,1025.000000000001,25.00000000000002,0
4115,4,0,0,49,0.0,0.0,1.0,49,1700,1100,600,0.6470588235294118,23,11,12,299.1902612988232,0.4389349489795918,0.1721881895162185,0.17583744477381627,131458.36560785584,-1933.7874487738745,129524.57815908197,2396,2,416.0204081632653,40,9,19,35.9524163445975,0.6278645833333334,43.6229674796748,1025.5081300813013,25.63770325203253,0
4116,4,0,0,49,0.0,0.0,1.0,49,1300,700,600,0.5384615384615384,19,7,12,299.4286116950417,0.43820861678004536,0.1700889130535843,0.17669963134335692,131614.73954202188,-1918.156252065574,129696.58328995631,2397,3,417.0204081632653,40,9,15,35.78930210293488,0.6294270833333333,43.47052845528455,1026.1178861788615,25.652947154471537,0
4117,4,0,0,49,0.0,0.0,1.0,49,1700,1200,500,0.7058823529411765,22,12,10,302.19217164864233,0.4371279761904762,0.1722436055364156,0.17943326008702584,131849.4747256924,-1831.224180382047,130018.25054531034,2398,4,418.0204081632653,40,9,16,35.48284022692789,0.6317708333333334,43.24186991869919,1027.0325203252034,25.675813008130085,0
4118,4,0,1,48,0.0,0.02040816326530612,0.9795918367346939,49,1250,700,550,0.56,18,7,11,298.09649664176885,0.4362953514739229,0.14085558047252422,0.1663448144384626,129447.79178685218,-2072.4882929243595,127375.30349392781,2399,5,419.0204081632653,42,7,10,38.00724465181238,0.6046626984126984,45.59108527131785,1017.6356589147322,24.229420450350766,8
4119,4,0,2,46,0.0,0.041666666666666664,0.9583333333333334,48,1950,1300,650,0.6666666666666666,26,13,13,301.63995868191296,0.4362163859338062,0.12491674595623237,0.16916947522662287,129645.08311549819,-1778.7724971455714,127866.31061835261,2400,6,413.4166666666667,42,6,12,37.717451633365066,0.6066468253968254,45.39728682170544,1018.4108527131809,24.24787744555193,0
4120,4,0,0,46,0.0,0.0,1.0,46,950,600,350,0.631578947368421,13,6,7,312.2919372002028,0.43338365539452495,0.12593852804083094,0.17477880597048234,129563.26116233732,-1107.687636327569,128455.57352600976,2401,10,431.0869565217391,40,6,14,37.529114260996884,0.6088541666666667,45.47764227642277,1018.0894308943098,25.452235772357746,0
4121,4,0,1,45,0.0,0.021739130434782608,0.9782608695652174,46,1100,700,400,0.6363636363636364,15,7,8,310.49423920499834,0.4330615942028986,0.1286390922655194,0.17446156131114932,129718.50419723711,-1144.6303456936953,128573.87385154341,2402,11,432.0869565217391,40,6,16,37.41769752593776,0.6104166666666666,45.32520325203252,1018.69918699187,25.46747967479675,0
4122,4,0,0,45,0.0,0.0,1.0,45,1550,1200,350,0.7741935483870968,19,12,7,315.67037871786266,0.43284932659932657,0.14089513868111636,0.17772189148815323,129796.16057117129,-805.4393672747692,128990.72120389652,2403,12,441.9111111111111,40,5,16,37.2072487616768,0.6111979166666667,45.2489837398374,1019.0040650406506,25.475101626016265,0
4123,4,0,0,45,0.0,0.0,1.0,45,1150,700,450,0.6086956521739131,16,7,9,317.094821018676,0.43257575757575756,0.1333466228113891,0.17923449798762672,129951.543032008,-758.6077442329358,129192.93528777506,2404,13,442.9111111111111,40,5,17,37.01368816239742,0.6127604166666667,45.09654471544715,1019.6138211382109,25.490345528455272,0
4124,4,0,0,45,0.0,0.0,1.0,45,1600,1400,200,0.875,18,14,4,318.7171474041201,0.4321548821548822,0.12485444200925389,0.18075043647698066,130081.0994199881,-708.1846123339294,129372.91480765416,2405,14,443.9111111111111,40,5,17,36.84125323769675,0.6140625,44.96951219512195,1020.1219512195121,25.503048780487802,0
4125,4,0,1,44,0.0,0.022222222222222223,0.9777777777777777,45,1150,700,450,0.6086956521739131,16,7,9,320.1278810583772,0.431986531986532,0.12272118778142849,0.18215548495576658,130210.72035701293,-663.1836002049174,129547.53675680801,2406,15,444.9111111111111,40,5,18,36.67417604301503,0.6153645833333333,44.84247967479674,1020.6300813008123,25.515752032520307,0
4126,4,0,1,43,0.0,0.022727272727272728,0.9772727272727273,44,1100,800,300,0.7272727272727273,14,8,6,320.8690744378324,0.4308491895701198,0.11277489640304306,0.1827018210786305,130237.26974875582,-442.1775596812968,129795.09218907452,2407,16,436.4318181818182,41,3,18,36.628417889655594,0.6140752032520325,44.816468253968246,1020.7341269841256,24.89595431668599,0
4127,4,0,0,43,0.0,0.0,1.0,43,1200,900,300,0.75,15,9,6,323.79448050768934,0.4299326319675157,0.11175665568288884,0.184241811203327,130210.72035701293,-167.69748909380547,130043.02286791914,2408,17,446.09302325581393,40,3,19,36.580620000663814,0.6153645833333333,44.84247967479674,1020.6300813008123,25.515752032520307,0
4128,4,1,3,41,0.022727272727272728,0.06818181818181818,0.9318181818181819,44,1650,1100,550,0.6666666666666666,22,11,11,317.3728725394849,0.429825140944327,0.11772143690831216,0.18257311671175305,130635.03146701398,-507.9763061111893,130127.05516090279,2409,0,436.9318181818182,39,5,15,36.315892262753884,0.6212606837606838,44.427083333333336,1022.2916666666674,26.212606837606856,0
4129,4,0,1,40,0.0,0.024390243902439025,0.975609756097561,41,1200,900,300,0.75,15,9,6,337.15893079363946,0.42543191056910573,0.11083589499474233,0.1926713511888794,130377.57087746532,591.5924793036323,130969.16335676896,2410,19,466.2439024390244,36,5,21,36.070680339618484,0.6241319444444444,44.679054054054056,1021.283783783784,28.368993993994,0
4130,4,0,0,40,0.0,0.0,1.0,40,1000,700,300,0.7,13,7,6,336.6177996517648,0.4243990384615384,0.11377011240908064,0.19307648002782002,130521.37230135537,787.1634303222079,131308.53573167758,2411,20,469.1,36,4,15,35.93899235912129,0.6255787037037037,44.538288288288285,1021.8468468468466,28.384634634634626,0
4131,4,1,0,41,0.024390243902439025,0.0,1.0,41,1000,600,400,0.6,14,6,8,335.2310650868026,0.426244918699187,0.13810688235417112,0.19463415569965087,130991.17036011067,582.4619113573311,131573.632271468,2412,0,458.6341463414634,37,4,17,35.49967866323908,0.6283783783783784,44.07894736842105,1023.6842105263147,27.66714082503553,0
4132,4,0,0,41,0.0,0.0,1.0,41,700,400,300,0.5714285714285714,10,4,6,334.56594608943124,0.426244918699187,0.13766666157582041,0.19429156941993508,130999.80481591052,565.6147271531831,131565.4195430637,2413,1,459.6341463414634,38,3,17,35.50798371947402,0.6266447368421053,44.07051282051282,1023.7179487179483,26.939946018893377,0
4133,4,0,0,41,0.0,0.0,1.0,41,1250,900,350,0.72,16,9,7,334.0063690376427,0.42571138211382115,0.13228425776122577,0.1947964152270629,131163.91354372108,561.9165023011003,131725.83004602217,2414,2,460.6341463414634,38,3,17,35.35669586983728,0.6282894736842105,43.9102564102564,1024.3589743589732,26.956815114709823,0
4134,4,0,0,41,0.0,0.0,1.0,41,1000,700,300,0.7,13,7,6,335.06617844170955,0.42611788617886176,0.13107618015909828,0.19611636702486482,131301.43364800335,598.9339192708283,131900.36756727417,2415,3,461.6341463414634,39,2,18,35.190843412270915,0.6279380341880342,43.776041666666664,1024.8958333333326,26.279380341880323,0
4135,4,0,0,41,0.0,0.0,1.0,41,900,700,200,0.7777777777777778,11,7,4,329.4451288456526,0.4261432926829268,0.13090981175519745,0.19337522333527385,131410.26925131484,458.49732970186955,131868.7665810167,2416,4,462.6341463414634,38,3,18,35.22520058351566,0.6307565789473684,43.66987179487179,1025.320512820512,26.982118758434527,0
4136,4,0,0,41,0.0,0.0,1.0,41,750,500,250,0.6666666666666666,10,5,5,329.4451288456526,0.4261432926829268,0.13090981175519745,0.19337522333527385,131410.26925131484,458.49461702825823,131868.76386834309,2417,5,463.6341463414634,38,3,18,35.22520058351566,0.6307565789473684,43.66987179487179,1025.320512820512,26.982118758434527,0
4137,4,0,0,41,0.0,0.0,1.0,41,1250,1000,250,0.8,15,10,5,326.8363662019241,0.4266514227642277,0.1343988592139269,0.1930450767278989,131648.63281249988,405.5121527777632,132054.14496527764,2418,6,464.6341463414634,39,2,16,35.05210447963188,0.6314102564102564,43.43749999999999,1026.249999999999,26.31410256410254,0
4138,4,0,0,41,0.0,0.0,1.0,41,1450,1200,250,0.8275862068965517,17,12,5,329.1949527744983,0.42654979674796745,0.13418593601520468,0.19498470279720276,131755.55555555545,474.6527777777682,132230.20833333323,2419,7,465.6341463414634,39,2,16,34.88399621212121,0.6324786324786325,43.33333333333333,1026.6666666666658,26.324786324786302,0
4139,4,0,0,41,0.0,0.0,1.0,41,1200,800,400,0.6666666666666666,16,8,8,329.3152365800663,0.42543191056910573,0.14109289860772045,0.1957430710015692,131889.27001953125,486.62923177083326,132375.8992513021,2420,8,466.6341463414634,39,2,16,34.74641263563532,0.6338141025641026,43.203125,1027.1875,26.338141025641026,0
4140,4,0,0,41,0.0,0.0,1.0,41,1250,1100,150,0.88,14,11,3,308.7207739854876,0.42560975609756097,0.11995201919232246,0.17119970193740694,129201.3888888891,-220.61089409720307,128980.77799479189,2421,9,467.6341463414634,39,2,19,37.98668032786886,0.6068376068376069,45.83333333333334,1016.6666666666683,26.06837606837611,8
4141,4,0,0,41,0.0,0.0,1.0,41,1100,600,500,0.5454545454545454,16,6,10,308.9884207582221,0.4247459349593496,0.12497436895041525,0.17207650466955476,129368.65790435507,-205.3165397045359,129163.34136465054,2422,10,468.6341463414634,37,4,20,37.8103219084573,0.6120495495495495,45.6688596491228,1017.3245614035078,27.49525841631102,0
4142,4,1,0,42,0.023809523809523808,0.0,1.0,42,1300,900,400,0.6923076923076923,17,9,8,300.6069282492906,0.42675667828106856,0.12735698306168097,0.16902049927978957,129745.05077069161,-599.5477664548405,129145.50300423677,2423,0,458.45238095238096,38,4,16,37.642661143736014,0.6140350877192983,45.29914529914529,1018.8034188034173,26.810616284300455,0
4143,4,0,0,42,0.0,0.0,1.0,42,1100,800,300,0.7272727272727273,14,8,6,301.5094031435383,0.42655100658149436,0.12209679512131855,0.1702368476210436,129908.37191357992,-566.2808641975666,129342.09104938235,2424,1,459.45238095238096,38,4,17,37.45458673932789,0.6156798245614035,45.13888888888887,1019.4444444444417,26.827485380116887,0
4144,4,0,0,42,0.0,0.0,1.0,42,1000,700,300,0.7,13,7,6,301.934080017193,0.4259702864885792,0.12274400646493677,0.17095271220902236,130017.30974687672,-548.6686390532942,129468.64110782342,2425,2,460.45238095238096,38,4,18,37.33369997904881,0.6167763157894737,45.03205128205126,1019.8717948717922,26.838731443994533,0
4145,4,0,0,42,0.0,0.0,1.0,42,1050,700,350,0.6666666666666666,14,7,7,302.9511832796942,0.4262001548586914,0.11649529643404088,0.17202358494055664,130129.69970703113,-515.4106987847379,129614.2890082464,2426,3,461.45238095238096,39,3,19,37.194253020248404,0.6161858974358974,44.92187499999999,1020.3124999999991,26.16185897435895,0
4146,4,1,0,43,0.023255813953488372,0.0,1.0,43,1300,800,500,0.6153846153846154,18,8,10,295.61673369289616,0.4281330749354005,0.12072299530797337,0.1691437217736551,130426.23325525952,-888.6289537619334,129537.60430149759,2427,0,451.69767441860466,38,5,22,37.082287417634134,0.6208881578947368,44.63141025641025,1021.4743589743575,26.880904183535723,0
4147,4,0,0,43,0.0,0.0,1.0,43,1100,900,200,0.8181818181818182,13,9,4,292.2707798840559,0.4279485049833887,0.11763032501244552,0.16767113161769512,130528.56445312488,-970.062934027794,129558.50151909709,2428,1,452.69767441860466,39,4,14,37.0646449201495,0.6201923076923077,44.53124999999999,1021.8749999999991,26.201923076923055,0
4148,4,0,0,43,0.0,0.0,1.0,43,1350,1000,350,0.7407407407407407,17,10,7,292.9113169283725,0.4281792174234034,0.11538543590132577,0.16815406263219784,130555.17713758672,-951.7822265625098,129603.39491102421,2429,2,453.69767441860466,39,4,14,37.021476743790984,0.6204594017094017,44.50520833333333,1021.979166666666,26.204594017094,0
4149,4,0,0,43,0.0,0.0,1.0,43,1200,900,300,0.75,15,9,6,294.40075883730793,0.42718715393133994,0.11316929446232615,0.16994244861984276,130768.17626953124,-900.349934895834,129867.8263346354,2430,3,454.69767441860466,39,4,15,36.7689555962929,0.6225961538461539,44.296875,1022.8124999999999,26.225961538461537,0
4150,4,0,0,43,0.0,0.0,1.0,43,1150,900,250,0.782608695652174,14,9,5,334.04966245115486,0.42741786637135476,0.01665190846809872,0.18237503453296078,128582.21379469884,-8.234687869229788,128573.9791068296,2431,4,455.69767441860466,40,3,19,37.97302939211757,0.5989583333333333,46.443089430894304,1014.2276422764221,25.35569105691055,8
4151,4,1,0,44,0.022727272727272728,0.0,1.0,44,1350,1000,350,0.7407407407407407,17,10,7,332.92676948906427,0.42947278012684986,0.03058646442938695,0.18333358468313865,128924.17332963258,-215.53829286346155,128708.63503676912,2432,0,446.3181818181818,41,3,21,37.653344892709434,0.6008638211382114,46.106150793650784,1015.5753968253953,24.77013162988769,0
4152,4,1,0,45,0.022222222222222223,0.0,1.0,45,1300,900,400,0.6923076923076923,17,9,8,322.29237533861493,0.4314814814814815,0.03873443241309782,0.17906878805399098,129277.04480229558,-666.7011133157291,128610.34368897985,2433,0,437.3777777777778,41,4,22,37.5649326894937,0.6044207317073171,45.758928571428555,1016.964285714283,24.80400696864105,0
4153,4,0,0,45,0.0,0.0,1.0,45,1600,1100,500,0.6875,21,11,10,324.25294671693325,0.4313552188552188,0.045787831513260935,0.18073577290917697,129403.18720080575,-608.1270471151906,128795.06015369056,2434,1,438.3777777777778,41,4,22,37.387057982319284,0.6056910569105691,45.63492063492061,1017.4603174603135,24.816105303910085,0
4154,4,0,0,45,0.0,0.0,1.0,45,1000,700,300,0.7,13,7,6,321.6986856010795,0.4311447811447811,0.04809207951167416,0.17962792636194205,129472.44498715489,-669.7769252148616,128802.66806194003,2435,2,439.3777777777778,42,3,20,37.38177980894346,0.6049107142857143,45.566860465116264,1017.7325581395322,24.231727574750767,0
4155,4,0,0,45,0.0,0.0,1.0,45,1300,1100,200,0.8461538461538461,15,11,4,324.2838284890065,0.4307449494949495,0.04815907768787331,0.1812986491898354,129521.75842985664,-599.6376607475888,128922.12076910905,2436,3,440.3777777777778,42,3,20,37.26598445184831,0.605406746031746,45.51841085271316,1017.9263565891445,24.236341823551058,0
4156,4,1,1,45,0.021739130434782608,0.021739130434782608,0.9782608695652174,46,1600,1000,600,0.625,22,10,12,318.75380931203097,0.43223631239935584,0.061623145328692175,0.18004740351801227,129924.46212838564,-917.216554752107,129007.24557363354,2437,0,431.7826086956522,43,3,21,36.99880797572606,0.6080426356589148,45.12310606060604,1019.5075757575718,23.70947850599004,0
4157,4,0,0,45,0.0,0.0,1.0,45,1100,800,300,0.7272727272727273,14,8,6,323.129433558416,0.4323232323232323,0.0685011029838618,0.18317628147923729,130064.82600392067,-594.4452894958613,129470.3807144248,2438,1,440.9111111111111,42,3,21,36.74519489566511,0.6108630952380952,44.98546511627905,1020.0581395348806,24.287098560354302,0
4158,4,1,1,45,0.021739130434782608,0.021739130434782608,0.9782608695652174,46,1200,900,300,0.75,15,9,6,362.3176108860243,0.43409822866344605,0.1642137775950021,0.19255146614894697,127502.23597891463,137.1626541377234,127639.39863305235,2439,0,432.30434782608694,40,6,15,38.362011135708066,0.5880208333333333,47.510162601626014,1009.9593495934956,25.248983739837392,8
4159,4,0,0,45,0.0,0.0,1.0,45,1300,900,400,0.6923076923076923,17,9,8,365.88188521822485,0.43276515151515155,0.17081041437477085,0.19449510740547737,127512.49999999999,330.90277777777743,127843.40277777777,2440,1,442.77777777777777,39,6,15,38.26148239823983,0.5897435897435898,47.5,1009.9999999999999,25.897435897435894,0
4160,4,1,0,46,0.021739130434782608,0.0,1.0,46,1150,800,350,0.6956521739130435,15,8,7,361.6187278844144,0.43374597423510464,0.18173458734312087,0.19402647971070505,127887.4194944313,49.29718999934471,127936.71668443065,2441,0,434.1304347826087,40,6,16,37.98477845875617,0.5919270833333333,47.12906504065041,1011.483739837399,25.287093495934975,0
4161,4,0,1,45,0.0,0.021739130434782608,0.9782608695652174,46,1300,700,600,0.5384615384615384,19,7,12,358.641079759218,0.4331421095008052,0.1789818851233016,0.19330242666578437,128069.20750070855,-13.824227607715443,128055.38327310083,2442,1,435.1304347826087,41,5,18,37.87397089091443,0.5922256097560976,46.94940476190476,1012.2023809523804,24.687862950058058,0
4162,4,0,0,45,0.0,0.0,1.0,45,1400,900,500,0.6428571428571429,19,9,10,366.2744442505078,0.43169191919191924,0.18336569145968662,0.19715464409981384,128015.94309769312,377.7936826624325,128393.73678035555,2443,2,445.3777777777778,40,5,18,37.73536352681261,0.5932291666666667,47.0020325203252,1011.9918699186987,25.29979674796747,0
4163,4,2,1,46,0.0425531914893617,0.02127659574468085,0.9787234042553191,47,1050,600,450,0.5714285714285714,15,6,9,353.9637062581264,0.4346284304656183,0.1931552284967739,0.19262345716992968,128453.40617563952,-306.30215562826504,128147.10402001126,2444,0,427.3829787234043,40,7,16,37.599624060150376,0.59765625,46.57012195121951,1013.7195121951221,25.342987804878053,0
4164,4,1,2,45,0.02127659574468085,0.0425531914893617,0.9574468085106383,47,1400,1000,400,0.7142857142857143,18,10,8,358.225333459465,0.4340502621029911,0.21211705247395063,0.1963904159319572,128747.91843820846,-175.84679705216888,128572.07164115629,2445,0,428.36170212765956,41,6,17,37.19086021505375,0.5990853658536586,46.2797619047619,1014.8809523809512,24.753193960511005,0
4165,4,1,0,46,0.021739130434782608,0.0,1.0,46,1650,1300,350,0.7878787878787878,20,13,7,357.778935160993,0.43543679549114334,0.23024081137384744,0.19749950385446924,129020.64252635631,32.17361937335329,129052.81614572967,2446,0,435.10869565217394,40,6,19,36.92399386482611,0.6033854166666667,46.0111788617886,1015.9552845528427,25.398882113821067,0
4166,4,1,0,47,0.02127659574468085,0.0,1.0,47,1600,1100,500,0.6875,21,11,10,353.94320860186474,0.43541859389454207,0.24309637738133993,0.1974683726345864,129439.78000216973,-236.88075680660756,129202.89924536312,2447,0,426.82978723404256,39,8,18,36.594606237417686,0.6092414529914529,45.598958333333314,1017.6041666666634,26.092414529914446,0
4167,4,0,0,47,0.0,0.0,1.0,47,1050,700,350,0.6666666666666666,14,7,7,351.903374458409,0.4348789700894234,0.24421128573827544,0.19703133290052613,129579.88989866742,-280.07989654199343,129299.81000212542,2448,1,427.82978723404256,41,6,19,36.50400711292995,0.6074695121951219,45.461309523809504,1018.1547619047589,24.8330429732868,0
4168,4,1,1,47,0.020833333333333332,0.020833333333333332,0.9791666666666666,48,1450,900,550,0.6206896551724138,20,9,11,347.1061819601269,0.4366042405437352,0.25641634980988637,0.1958989825225607,129891.90853915014,-582.7431118923294,129309.16542725782,2449,0,419.8958333333333,42,6,20,36.30921261089988,0.6091269841269842,45.155038759689916,1019.3798449612391,24.27094868955331,0
4169,4,0,0,47,0.0,0.0,1.0,47,1500,1000,500,0.6666666666666666,20,10,10,350.86158730718466,0.4357847671908726,0.262238905420338,0.1988731444703677,130060.11924445696,-273.3800233056287,129786.73922115134,2450,1,427.4468085106383,41,6,20,36.04276081177462,0.6122967479674797,44.99007936507936,1020.039682539682,24.879016647309317,0
4170,4,3,1,49,0.06,0.02,0.98,50,650,300,350,0.46153846153846156,10,3,7,338.64695512249415,0.43884353741496596,0.2837979839120248,0.19575348712525142,130821.45317925383,-1138.7552912513006,129682.69788800253,2451,0,402.74,39,11,20,35.58371941078643,0.6231303418803419,44.244791666666686,1023.0208333333362,26.231303418803492,0
4171,4,0,0,49,0.0,0.0,1.0,49,1750,1200,550,0.6857142857142857,23,12,11,339.3787850097903,0.43765943877551017,0.27685128820947047,0.19644771980855508,130874.74093967059,-916.7778862846728,129957.96305338592,2452,1,411.9591836734694,39,10,20,35.511151549085476,0.6236645299145299,44.19270833333336,1023.2291666666704,26.236645299145394,0
4172,4,0,0,49,0.0,0.0,1.0,49,1000,500,500,0.5,15,5,10,337.26304417814356,0.4375708616780045,0.27073528373286937,0.1956284930398139,130954.69292534768,-966.7643229166185,129987.92860243107,2453,2,412.9591836734694,39,10,21,35.48451387475405,0.624465811965812,44.11458333333336,1023.5416666666704,26.244658119658215,0
4173,4,0,0,49,0.0,0.0,1.0,49,1400,1000,400,0.7142857142857143,18,10,8,336.8358592789529,0.4370039682539682,0.2651542910587499,0.19662086261674205,131197.94894118953,-961.5652265516137,130236.38371463792,2454,3,413.9591836734694,40,9,21,35.24989253711601,0.6252604166666667,43.87703252032522,1024.4918699187026,25.612296747967566,0
4174,4,0,0,49,0.0,0.0,1.0,49,1150,1000,150,0.8695652173913043,13,10,3,341.3285195686167,0.43673823696145125,0.2727346152922605,0.20006773225373037,131356.22409058563,-832.6812518727432,130523.54283871289,2455,4,414.9591836734694,37,12,22,34.975108746033435,0.6320382882882882,43.72258771929825,1025.1096491228075,27.70566619250831,0
4175,4,0,0,49,0.0,0.0,1.0,49,1700,1200,500,0.7058823529411765,22,12,10,342.05937385890536,0.4369508219954648,0.27195754264066574,0.200938396000533,131440.53939673756,-807.9062788550237,130632.63311788253,2456,5,415.9591836734694,37,12,22,34.87132877102936,0.6328828828828829,43.640350877192986,1025.438596491229,27.71455666192511,0
4176,4,0,0,49,0.0,0.0,1.0,49,1300,800,500,0.6153846153846154,18,8,10,333.1902782276625,0.43640164399092973,0.21241124558903568,0.18561869089243901,129382.26176754912,-1162.6359233376863,128219.62584421143,2457,6,416.9591836734694,40,9,21,37.18097592648086,0.60703125,45.65548780487805,1017.3780487804881,25.434451219512205,8
4177,4,0,0,49,0.0,0.0,1.0,49,1600,1100,500,0.6875,21,11,10,330.75309563382064,0.4357107426303855,0.21783556533117965,0.1850702435874737,129554.63927469135,-1229.8804012345752,128324.75887345677,2458,7,417.9591836734694,41,8,16,37.06798544793085,0.6072154471544715,45.48611111111111,1018.0555555555555,24.83062330623306,0
4178,4,0,0,49,0.0,0.0,1.0,49,1050,600,450,0.5714285714285714,15,6,9,328.53009472078077,0.43526785714285715,0.21890513633607322,0.1841813993614863,129630.3985280455,-1282.50257857773,128347.89594946777,2459,8,418.9591836734694,41,8,16,37.047714726416615,0.6079776422764227,45.41170634920635,1018.3531746031748,24.83788230739451,0
4179,4,0,0,49,0.0,0.0,1.0,49,1550,1200,350,0.7741935483870968,19,12,7,328.4961834623814,0.4345060941043084,0.2149681054160204,0.1851147170986856,129832.53146455319,-1270.1017849269613,128562.42967962624,2460,9,419.9591836734694,41,8,17,36.84364758752716,0.610010162601626,45.21329365079364,1019.1468253968236,24.857239643824965,0
4180,4,1,0,50,0.02,0.0,1.0,50,1100,800,300,0.7272727272727273,14,8,6,305.60816635745067,0.4359778911564626,0.21254690216893923,0.1642587522768257,127957.09983710574,-2094.1322375143386,125862.9675995914,2461,0,412.54,44,6,15,39.33013788475032,0.5868844696969697,47.06018518518519,1011.7592592592601,22.99452861952864,8
4181,4,3,1,52,0.05660377358490566,0.018867924528301886,0.9811320754716981,53,1700,1300,400,0.7647058823529411,21,13,8,291.34086807279334,0.442489114658926,0.23360549886875126,0.15946619542166177,128684.16066529481,-3101.3974622770993,125582.7632030177,2462,0,390.1320754716981,44,9,14,38.95251566587576,0.5942234848484849,46.34259259259259,1014.6296296296287,23.059764309764287,0
4182,4,1,1,52,0.018867924528301886,0.018867924528301886,0.9811320754716981,53,1800,1300,500,0.7222222222222222,23,13,10,292.3718212679974,0.44200532172230284,0.2476879567317618,0.16098062930057214,128919.1358024692,-3061.5354938271544,125857.60030864205,2463,0,391.1132075471698,44,9,16,38.688115426695845,0.5965909090909092,46.111111111111114,1015.5555555555561,23.080808080808094,0
4183,4,0,0,52,0.0,0.0,1.0,52,1800,1200,600,0.6666666666666666,24,12,12,295.98465402044275,0.4415064102564103,0.262438490978677,0.16355164114906037,129060.22376543209,-2760.0308641975303,126300.19290123456,2464,1,399.2692307692308,44,8,17,38.45338983050847,0.5980113636363636,45.97222222222222,1016.1111111111111,23.093434343434343,0
4184,4,1,0,53,0.018867924528301886,0.0,1.0,53,1300,1000,300,0.7692307692307693,16,10,6,293.9300557777979,0.4430938558297049,0.2702242267452777,0.16369572779786876,129369.92550684429,-2994.7037949730643,126375.22171187123,2465,0,392.7169811320755,43,10,19,38.1920203853672,0.6024709302325582,45.66761363636365,1017.3295454545478,23.658826638477855,0
4185,4,2,2,53,0.03636363636363636,0.03636363636363636,0.9636363636363636,55,1750,1200,550,0.6857142857142857,23,12,11,300.76767933655935,0.4447811447811448,0.3031142538867633,0.1705561734485565,130077.7188681475,-3175.3652725267793,126902.35359562072,2466,0,379.4,45,10,14,37.30243296039781,0.6069444444444445,44.97282608695652,1020.1086956521743,22.669082125603875,0
4186,4,0,2,51,0.0,0.03773584905660377,0.9622641509433962,53,1400,900,500,0.6428571428571429,19,9,10,340.4963711298813,0.44183901790033864,0.23103838447900626,0.18648943506653323,128709.28730244574,-1753.395367275342,126955.8919351704,2467,1,394.22641509433964,42,11,16,37.68004360835244,0.5972222222222222,46.31782945736434,1014.7286821705424,24.160206718346245,8
4187,4,1,1,51,0.019230769230769232,0.019230769230769232,0.9807692307692307,52,1500,1100,400,0.7333333333333333,19,11,8,347.3725441531296,0.43913398692810457,0.2429106272929571,0.1906821819621687,128798.26467624096,-1451.8038233811942,127346.46085285976,2468,0,402.38461538461536,41,11,17,37.41489119103466,0.5995934959349594,46.230158730158735,1015.0793650793659,24.75803329461868,0
4188,4,2,0,53,0.03773584905660377,0.0,1.0,53,1400,800,600,0.5714285714285714,20,8,12,331.37775163108546,0.44211115142718915,0.2607803919868348,0.18436686581853987,129330.57089240853,-2027.285476937271,127303.28541547127,2469,0,395.64150943396226,40,13,19,37.27957338395444,0.6065104166666666,45.70630081300813,1017.1747967479668,25.42936991869917,0
4189,4,0,1,52,0.0,0.018867924528301886,0.9811320754716981,53,2000,1600,400,0.8,24,16,8,327.6153346328786,0.44162735849056606,0.2590532936113872,0.18307915758896143,129504.14540816312,-2114.4912131519436,127389.65419501119,2470,1,396.64150943396226,41,12,15,37.199074074074076,0.6067073170731707,45.53571428571428,1017.8571428571418,24.825783972125407,0
4190,4,0,2,50,0.0,0.038461538461538464,0.9615384615384616,52,1100,700,400,0.6363636363636364,15,7,8,329.6931379441456,0.4417263700351936,0.2562246559351191,0.1842749146009242,129511.5341397316,-1860.187181902315,127651.34695782927,2471,2,402.5769230769231,40,12,15,37.13870307507986,0.6083333333333334,45.52845528455284,1017.8861788617883,25.447154471544707,0
4191,4,1,2,49,0.0196078431372549,0.0392156862745098,0.9607843137254902,51,1750,1100,650,0.6285714285714286,24,11,13,327.5747424943865,0.4414869281045752,0.2578291030113484,0.18411959664339594,129731.44531249953,-1700.6510416667109,128030.79427083282,2472,0,409.8235294117647,41,10,17,36.96958077709613,0.6089939024390244,45.31249999999998,1018.7499999999962,24.847560975609664,0
4192,4,0,0,49,0.0,0.0,1.0,49,2000,1700,300,0.85,23,17,6,339.126191403632,0.43973214285714285,0.2636733892536107,0.18096796814189647,127667.85483001084,-1112.6855198097624,126555.16931020108,2473,1,426.265306122449,41,8,15,38.77807908772619,0.588160569105691,47.346230158730165,1010.6150793650804,24.649148277197085,7
4193,4,2,0,51,0.0392156862745098,0.0,1.0,51,1350,900,450,0.6666666666666666,18,9,9,331.2692361082213,0.44243464052287584,0.2876623651620467,0.1792393312565524,128223.6450195317,-1701.1372868736153,126522.50773265808,2474,0,410.5098039215686,39,12,18,38.409034420103524,0.5969551282051282,46.79687500000002,1012.8125000000036,25.969551282051377,0
4194,4,0,0,51,0.0,0.0,1.0,51,1350,800,550,0.5925925925925926,19,8,11,329.12485622607,0.44166666666666665,0.2846018158542123,0.17864474368155434,128350.40655570469,-1751.3381791591848,126599.0683765455,2475,1,411.5098039215686,40,11,18,38.33408551465919,0.5966145833333334,46.671747967479696,1013.3130081300845,25.332825203252114,0
4195,4,1,1,51,0.019230769230769232,0.019230769230769232,0.9807692307692307,52,1350,900,450,0.6666666666666666,18,9,9,319.47195038678274,0.444350175967823,0.2820656955714147,0.17503366794356764,128722.7490099052,-2175.3384629314355,126547.41054697376,2476,0,404.5769230769231,41,11,18,38.19970590152182,0.5988313008130082,46.30456349206351,1014.7817460317484,24.75077429345728,0
4196,4,1,0,52,0.019230769230769232,0.0,1.0,52,1500,1200,300,0.8,18,12,6,322.91535109118394,0.4450571895424837,0.29877127070201515,0.1780705747232452,128979.82698042525,-2070.0867773871405,126909.7402030381,2477,0,405.40384615384613,42,10,19,37.85096505453273,0.5999503968253967,46.051356589147304,1015.794573643414,24.185585086747952,0
4197,4,0,0,52,0.0,0.0,1.0,52,1400,1000,400,0.7142857142857143,18,10,8,326.1357162148634,0.4450414781297134,0.3046583227600834,0.1803071803555748,129081.0728467204,-1980.4103714703524,127100.66247525005,2478,1,406.40384615384613,43,9,19,37.66628226633121,0.5995639534883721,45.95170454545456,1016.1931818181847,23.632399577167085,0
4198,4,1,1,52,0.018867924528301886,0.018867924528301886,0.9811320754716981,53,1750,1200,550,0.6857142857142857,23,12,11,317.7908315284766,0.4448778422835027,0.31193938991256465,0.17789175635960075,129571.08126201855,-2364.5875747889854,127206.49368722957,2479,0,399.7169811320755,42,11,16,37.38122997366834,0.6059027777777778,45.46996124031008,1018.12015503876,24.24095607235143,0
4199,4,0,0,52,0.0,0.0,1.0,52,1750,1200,550,0.6857142857142857,23,12,11,318.7859222678726,0.44519859225741576,0.30320312968403407,0.17860364116579933,129605.14298311918,-2136.7409926933733,127468.4019904258,2480,1,405.21153846153845,41,11,17,37.32138217718888,0.6077235772357723,45.43650793650794,1018.2539682539683,24.83546264034069,0
4200,4,0,1,51,0.0,0.019230769230769232,0.9807692307692307,52,1150,800,350,0.6956521739130435,15,8,7,317.44328517448696,0.4447036827551534,0.30446308994972293,0.17814449388515918,129669.7550947209,-2167.4413909921273,127502.31370372877,2481,2,406.21153846153845,42,10,18,37.290100846732,0.6068948412698413,45.373062015503876,1018.5077519379847,24.25018456995202,0
4201,4,0,0,51,0.0,0.0,1.0,51,1550,1400,150,0.9032258064516129,17,14,3,320.3134620311224,0.44459150326797386,0.30028064483044825,0.18020845656807133,129768.46648526231,-1886.6826475271853,127881.78383773513,2482,3,407.03921568627453,42,9,18,37.117015374861325,0.6078869047619048,45.276162790697676,1018.8953488372093,24.259413067552604,0
4202,4,0,1,50,0.0,0.0196078431372549,0.9803921568627451,51,1200,800,400,0.6666666666666666,16,8,8,323.3861422841836,0.4442973856209151,0.30457677890055157,0.18239672014409272,129867.21543364285,-1800.5484383450457,128066.6669952978,2483,4,408.03921568627453,42,9,18,36.93871407294736,0.6088789682539683,45.179263565891475,1019.2829457364344,24.2686415651532,0
4203,4,0,2,48,0.0,0.04,0.96,50,1100,700,400,0.6363636363636364,15,7,8,324.1409747704868,0.44368197278911564,0.2999182839632284,0.18343006606954124,129996.88042534713,-1572.536892361119,128424.34353298601,2484,5,408.54,43,7,18,36.78817671092951,0.6087693798449613,45.05208333333333,1019.7916666666658,23.71608527131781,0
4204,4,1,0,49,0.02040816326530612,0.0,1.0,49,1050,800,250,0.7619047619047619,13,8,5,331.96641915725485,0.44074192176870747,0.3094927822896554,0.1878287416780078,129990.70443482949,-1169.4902650081235,128821.21416982137,2485,0,417.265306122449,42,7,19,36.594925883694415,0.6101190476190477,45.058139534883715,1019.7674418604639,24.280177187153903,0
4205,4,1,0,50,0.02,0.0,1.0,50,1000,700,300,0.7,13,7,6,328.067759054372,0.4407057823129252,0.323811324509901,0.1874219960623871,130366.3506861824,-1445.348601383586,128921.00208479882,2486,0,409.9,40,10,20,36.31414402759811,0.6169270833333333,44.690040650406516,1021.2398373983758,25.530995934959396,0
4206,4,0,2,48,0.0,0.04,0.96,50,950,600,350,0.631578947368421,13,6,7,328.34351553530547,0.4405187074829932,0.3154605132285655,0.1882078509231452,130496.11363110608,-1430.4894573335678,129065.62417377252,2487,1,410.9,40,10,16,36.17590013924808,0.6182291666666666,44.563008130081315,1021.7479674796768,25.543699186991923,0
4207,4,0,0,48,0.0,0.0,1.0,48,1500,1000,500,0.6666666666666666,20,10,10,332.52920567735123,0.44058436761229314,0.31253823019675764,0.19063582574454385,130501.95448133704,-920.8577473958103,129581.09673394123,2488,2,425.3541666666667,39,9,17,36.06307557685118,0.6199252136752137,44.55729166666668,1021.7708333333353,26.199252136752186,0
4208,4,0,0,48,0.0,0.0,1.0,48,1600,900,700,0.5625,23,9,14,329.41114927732133,0.4399656471631206,0.31010555445085153,0.18932670511035998,130599.97046235719,-995.7827268821322,129604.18773547506,2489,3,426.3541666666667,40,8,17,36.043655133558694,0.6192708333333333,44.461382113821145,1022.1544715447164,25.553861788617912,0
4209,4,0,0,48,0.0,0.0,1.0,48,1550,1100,450,0.7096774193548387,20,11,9,358.843990901596,0.4405104905437352,0.2870509733092512,0.19414979442591235,128221.7151249256,-360.80344454359476,127860.911680382,2490,4,427.3541666666667,40,8,18,37.712806876714154,0.5953125,46.798780487804876,1012.8048780487802,25.320121951219505,8
4210,4,0,0,48,0.0,0.0,1.0,48,1150,800,350,0.6956521739130435,15,8,7,352.7484098983545,0.44032579787234044,0.22308314813025398,0.1793903338593648,125703.50644680315,-704.3585143875789,124999.14793241557,2491,5,428.3541666666667,42,6,17,40.45398911327987,0.5667162698412698,49.29748062015504,1002.8100775193805,23.876430417128105,8
4211,4,5,0,53,0.09433962264150944,0.0,1.0,53,1500,1100,400,0.7333333333333333,19,11,8,335.61186227179496,0.44957970488630866,0.2797453298332355,0.1757520830241427,126905.35408093322,-2080.4313063413597,124824.92277459186,2492,0,388.8490566037736,44,9,18,39.647851191570176,0.5762310606060606,48.10185185185187,1007.5925925925961,22.89983164983173,0
4212,4,3,2,54,0.05357142857142857,0.03571428571428571,0.9642857142857143,56,1250,800,450,0.64,17,8,9,320.9955783762372,0.45401109307359305,0.29149751843170146,0.17073333810367483,127535.88070130307,-3011.897719478744,124523.98298182433,2493,0,368.9642857142857,44,12,13,39.37097045253153,0.5826231060606061,47.47685185185185,1010.0925925925919,22.956649831649816,0
4213,4,1,0,55,0.01818181818181818,0.0,1.0,55,2050,1600,450,0.7804878048780488,25,16,9,362.90485533344304,0.4518939393939394,0.4065277712458266,0.18908223325055107,126698.43885633661,-1675.7135001393372,125022.72535619728,2494,0,376.6545454545454,39,16,17,39.17324107604761,0.5814636752136753,48.30729166666666,1006.7708333333318,25.814636752136714,8
4214,4,1,0,56,0.017857142857142856,0.0,1.0,56,1200,800,400,0.6666666666666666,16,8,8,357.0796734988591,0.45282061688311687,0.413165795498726,0.18773648334828721,127066.39695493745,-2125.4344925309115,124940.96246240653,2495,0,370.9107142857143,40,16,18,38.94159694923227,0.58359375,47.9420731707317,1008.2317073170724,25.20579268292681,0
4215,4,0,0,56,0.0,0.0,1.0,56,1700,1200,500,0.7058823529411765,22,12,10,350.71554470928174,0.45275974025974025,0.4062822630600875,0.1852252326092748,127249.61480034713,-2274.313824288212,124975.30097605892,2496,1,371.9107142857143,39,17,18,38.913982380067466,0.5870726495726496,47.760416666666664,1008.9583333333326,25.870726495726476,0
4216,4,2,2,56,0.034482758620689655,0.034482758620689655,0.9655172413793104,58,1600,1100,500,0.6875,21,11,10,383.4311114312576,0.45465315587820126,0.39712524839800767,0.2007013765858767,126886.59424392204,-1763.687053665191,125122.90719025685,2497,0,360.05172413793105,45,13,17,38.462626239923296,0.5747685185185185,48.12047101449276,1007.5181159420295,22.38929146537843,8
4217,4,4,2,58,0.06666666666666667,0.03333333333333333,0.9666666666666667,60,1400,1000,400,0.7142857142857143,18,10,8,363.7845670812706,0.4567031544256121,0.40824175824175835,0.1947317388493858,127793.20987654304,-2700.997479885777,125092.21239665727,2498,0,343.01666666666665,41,19,17,38.026556776556774,0.589430894308943,47.222222222222214,1011.1111111111098,24.661246612466094,0
4218,4,2,1,59,0.03333333333333333,0.016666666666666666,0.9833333333333333,60,1450,800,650,0.5517241379310345,21,8,13,367.1695501730107,0.45732697740112993,0.4241372549019611,0.19752792256142956,127993.90589569148,-2600.907029478469,125392.998866213,2499,0,343.9166666666667,41,19,19,37.735294117647065,0.5914634146341464,47.02380952380952,1011.9047619047609,24.680603948896607,0
4219,4,2,4,57,0.03278688524590164,0.06557377049180328,0.9344262295081968,61,1450,1000,450,0.6896551724137931,19,10,9,355.965815913836,0.4583219489981785,0.4269362637940608,0.19358795244954236,128427.65239771323,-3056.563454377362,125371.08894333587,2500,0,338.8360655737705,40,21,15,37.575195508321634,0.5973958333333333,46.595528455284565,1013.6178861788637,25.340447154471594,0
4220,4,0,1,56,0.0,0.017543859649122806,0.9824561403508771,57,1700,1100,600,0.6470588235294118,23,11,12,376.4547436187767,0.4562578320802005,0.4249874830727465,0.20241711806731552,127972.89544648766,-1764.7992909079899,126208.09615557967,2501,1,360.4561403508772,42,15,20,37.52194662580605,0.589781746031746,47.04457364341086,1011.8217054263571,24.090992986341835,0
4221,4,0,1,55,0.0,0.017857142857142856,0.9821428571428571,56,1200,900,300,0.75,15,9,6,376.3048930804342,0.45654761904761904,0.4136893363243419,0.20258393316144624,128021.92251066645,-1564.9448275344018,126456.97768313205,2502,2,365.30357142857144,42,14,21,37.47546438146303,0.5902777777777778,46.99612403100775,1012.0155038759692,24.095607235142126,0
4222,4,1,0,56,0.017857142857142856,0.0,1.0,56,1650,900,750,0.5454545454545454,24,9,15,364.8482365302893,0.4563108766233766,0.40206573632023446,0.19766847355192604,128276.4010959205,-1839.5402019695862,126436.86089395091,2503,0,365.8392857142857,39,17,22,37.50482005141389,0.5974893162393162,46.744791666666686,1013.0208333333363,25.97489316239324,0
4223,4,1,2,55,0.017543859649122806,0.03508771929824561,0.9649122807017544,57,1950,1600,350,0.8205128205128205,23,16,7,358.53619798087186,0.4576023391812865,0.4060250787224471,0.19625139257900376,128685.30636525892,-2172.331903959266,126512.97446129966,2504,0,360.4035087719298,40,17,17,37.24688668536325,0.6,46.341463414634156,1014.6341463414645,25.365853658536615,0
4224,4,2,3,54,0.03508771929824561,0.05263157894736842,0.9473684210526316,57,1100,700,400,0.6363636363636364,15,7,8,360.8535316244193,0.45954730576441105,0.32846701578570703,0.19463798597656867,128098.67937408085,-2127.1323150521334,125971.54705902872,2505,0,360.2105263157895,45,12,16,37.78781913624433,0.587037037037037,46.920289855072454,1012.3188405797083,22.49597423510463,8
4225,4,0,0,54,0.0,0.0,1.0,54,1550,1000,550,0.6451612903225806,21,10,11,370.91733422354747,0.45772187281621246,0.3440817977200328,0.19972334338697303,128029.9169439848,-1302.296901255008,126727.6200427298,2506,1,380.35185185185185,45,9,16,37.6035793132253,0.5863425925925926,46.98822463768115,1012.0471014492739,22.489935587761643,0
4226,4,1,3,52,0.01818181818181818,0.05454545454545454,0.9454545454545454,55,1850,1400,450,0.7567567567567568,23,14,9,369.8672376504278,0.4583333333333333,0.3469016152716595,0.20086091614030396,128370.63536352028,-1503.7251441613303,126866.91021935895,2507,0,374.41818181818184,41,14,13,37.281265296133135,0.5952743902439024,46.65178571428571,1013.3928571428562,24.716898954703808,0
4227,4,0,0,52,0.0,0.0,1.0,52,1300,1000,300,0.7692307692307693,16,10,6,383.3971238839877,0.45751633986928103,0.35431253411814967,0.20744408656227145,128223.6450195315,-567.884657118024,127655.76036241348,2508,1,382.7307692307692,39,13,18,37.08914001165623,0.5969551282051282,46.796875000000014,1012.8125000000019,25.96955128205133,0
4228,4,1,1,52,0.018867924528301886,0.018867924528301886,0.9811320754716981,53,1950,1600,350,0.8205128205128205,23,16,7,379.2125140968647,0.45922532656023224,0.2850059177165938,0.20192388518763593,127581.01695360857,-807.519261303029,126773.49769230555,2509,0,376.49056603773585,42,11,13,37.85448238378414,0.5858134920634921,47.43217054263566,1010.2713178294575,24.054078995939467,8
4229,4,0,0,52,0.0,0.0,1.0,52,1900,1500,400,0.7894736842105263,23,15,8,363.4920128749701,0.4578070010055304,0.3045296207885919,0.18778206179488682,126350.17108078873,-1004.412982470528,125345.7580983182,2510,1,384.5192307692308,40,12,14,39.517209137774195,0.5763020833333333,48.653455284552855,1005.3861788617901,25.134654471544753,8
4230,4,2,0,54,0.037037037037037035,0.0,1.0,54,2000,1500,500,0.75,25,15,10,363.6076340607805,0.45918501048218024,0.3404503858957706,0.19153090023456407,127143.255502677,-1549.6054762376864,125593.65002643931,2511,0,371.24074074074076,40,14,17,38.698063616821166,0.584375,47.86585365853659,1008.5365853658539,25.213414634146346,0
4231,4,3,1,56,0.05263157894736842,0.017543859649122806,0.9824561403508771,57,1150,800,350,0.6956521739130435,15,8,7,350.38671882955936,0.4627062447786132,0.35558095763655495,0.18808195630840965,127904.94163940537,-2436.7614353764984,125468.18020402887,2512,0,352.64912280701753,43,14,15,38.250873743993004,0.5876937984496124,47.11174242424242,1011.55303030303,23.524489076814653,0
4232,4,5,3,58,0.08196721311475409,0.04918032786885246,0.9508196721311475,61,1250,800,450,0.64,17,8,9,331.0543347139536,0.46538023679417123,0.3601266139838948,0.18131804357345832,128709.28730244574,-3676.925564607617,125032.36173783812,2513,0,330.42622950819674,42,19,12,37.91957123758595,0.5972222222222222,46.31782945736434,1014.7286821705424,24.160206718346245,0
4233,4,1,1,58,0.01694915254237288,0.01694915254237288,0.9830508474576272,59,1650,1000,650,0.6060606060606061,23,10,13,342.5425544128961,0.4649449639586986,0.36460683894984225,0.1865706791682527,128488.14791967142,-2997.4683199627316,125490.67959970869,2514,0,342.6101694915254,42,17,13,37.85362706680684,0.5949900793650793,46.5358527131783,1013.8565891472879,24.13944259874495,0
4234,4,0,1,57,0.0,0.017241379310344827,0.9827586206896551,58,2050,1700,350,0.8292682926829268,24,17,7,350.98517545505695,0.4637212643678161,0.3652338214454418,0.19120834185238197,128496.33487654338,-2579.9382716049217,125916.39660493846,2515,1,348.7413793103448,41,17,14,37.63127853881279,0.5965447154471545,46.527777777777786,1013.8888888888902,24.72899728997293,0
4235,4,1,3,55,0.017241379310344827,0.05172413793103448,0.9482758620689655,58,1600,1100,500,0.6875,21,11,10,358.58486757467455,0.46344399072393627,0.3769320491772885,0.19646302144731415,128722.74900990521,-2368.39401848699,126354.35499141822,2516,0,349.67241379310343,41,17,16,37.20742904161372,0.5988313008130082,46.30456349206351,1014.7817460317485,24.75077429345728,0
4236,4,1,2,54,0.017857142857142856,0.03571428571428571,0.9642857142857143,56,1750,1100,650,0.6285714285714286,24,11,13,367.9448867570096,0.4622970779220779,0.37173167666992013,0.19809707832605294,128024.70842121466,-1777.9044001214377,126246.80402109322,2517,0,356.2142857142857,43,13,16,37.684121674308344,0.5889050387596899,46.9933712121212,1012.0265151515124,23.535500352360753,8
4237,4,0,2,52,0.0,0.037037037037037035,0.962962962962963,54,1750,1400,350,0.8,21,14,7,368.5326053179024,0.4616235732587934,0.36833470199547547,0.1986507825639462,128072.63082709175,-1360.2119382748092,126712.41888881694,2518,1,354.6296296296296,43,11,16,37.620158574235205,0.5893895348837209,46.94602272727272,1012.2159090909075,23.539904862579245,0
4238,4,2,1,53,0.037037037037037035,0.018518518518518517,0.9814814814814815,54,1350,700,650,0.5185185185185185,20,7,13,363.61901039313454,0.4623078266946192,0.36837841070981936,0.19771662741812926,128420.90778730452,-1460.7029654961718,126960.20482180835,2519,0,352.77777777777777,41,13,11,37.388156177612494,0.5957825203252032,46.60218253968253,1013.5912698412681,24.721738288811416,0
4239,4,1,0,54,0.018518518518518517,0.0,1.0,54,600,300,300,0.5,9,3,6,366.27717728451495,0.4613251222921034,0.37947564077479967,0.1997911049200804,128546.63190507666,-1383.2605032754034,127163.37140180125,2520,0,353.75925925925924,41,13,13,37.19224874453793,0.5970528455284553,46.478174603174594,1014.0873015873001,24.73383662408049,0
4240,4,2,1,55,0.03571428571428571,0.017857142857142856,0.9821428571428571,56,1700,1300,400,0.7647058823529411,21,13,8,356.9068216636533,0.46293966450216445,0.3876034762703293,0.19767997026510095,129153.25574638434,-1980.8643968089957,127172.39134957535,2521,0,342.0892857142857,43,13,16,36.81099000062108,0.6002906976744187,45.88068181818182,1016.4772727272731,23.639006342494724,0
4241,4,1,3,53,0.017857142857142856,0.05357142857142857,0.9464285714285714,56,1400,1100,300,0.7857142857142857,17,11,6,355.2050432061437,0.4631425865800866,0.38532998872443347,0.19762352848528597,129330.57089240872,-2012.1988931091282,127318.37199929959,2522,0,342.55357142857144,40,16,17,36.67366037233156,0.6065104166666666,45.706300813008134,1017.1747967479683,25.42936991869921,0
4242,4,1,1,53,0.018518518518518517,0.018518518518518517,0.9814814814814815,54,1250,600,650,0.48,19,6,13,366.5009406073638,0.46201665501979966,0.38403157255616294,0.20324143070044698,129201.38888888879,-1329.5138888888982,127871.87499999988,2523,0,355.4074074074074,38,16,18,36.518101092896174,0.6085526315789473,45.83333333333333,1016.6666666666658,26.75438596491226,0
4243,4,2,4,51,0.03636363636363636,0.07272727272727272,0.9272727272727272,55,1500,1100,400,0.7333333333333333,19,11,8,352.03328463460525,0.46299102132435466,0.3733086628028268,0.19767112671667497,129692.62390318264,-1868.7759228964183,127823.84798028623,2524,0,349.1090909090909,40,15,13,36.386103628321536,0.61015625,45.35060975609756,1018.5975609756098,25.464939024390244,0
4244,4,2,3,50,0.03773584905660377,0.05660377358490566,0.9433962264150944,53,1000,700,300,0.7,13,7,6,354.85967534143055,0.4587868892114175,0.3709602183199212,0.20010034601854304,129857.80915375394,-1383.7400006298942,128474.06915312404,2525,0,350.49056603773585,41,12,15,36.14625916553111,0.6102642276422765,45.188492063492056,1019.2460317460306,24.859659310878794,0
4245,4,0,0,50,0.0,0.0,1.0,50,1500,1000,500,0.6666666666666666,20,10,10,361.5776544360744,0.45668367346938776,0.36114350005114026,0.20281954833169819,129651.86767578126,-624.1563585069438,129027.71131727433,2526,1,371.32,39,11,16,36.184518939006516,0.6113782051282051,45.390625,1018.4375000000001,26.113782051282055,0
4246,4,1,0,51,0.0196078431372549,0.0,1.0,51,1650,1100,550,0.6666666666666666,22,11,11,360.5378291599803,0.45589869281045753,0.37422255028891427,0.20487608050907521,130158.8642363176,-814.5611284618979,129344.30310785571,2527,0,365.01960784313724,40,11,18,35.69573083690204,0.61484375,44.89329268292683,1020.4268292682921,25.5106707317073,0
4247,4,0,0,51,0.0,0.0,1.0,51,1600,900,700,0.5625,23,9,14,362.10083505687635,0.4552124183006536,0.3722649639329303,0.20659559867447633,130315.76063368065,-762.4695393057159,129553.29109437493,2528,1,366.01960784313724,39,12,19,35.49658233013668,0.6180555555555556,44.739583333333336,1021.0416666666674,26.180555555555575,0
4248,4,0,0,51,0.0,0.0,1.0,51,1350,900,450,0.6666666666666666,18,9,9,364.4927502553126,0.4546732026143791,0.37287491727597555,0.20867369537383829,130448.74267578124,-690.4758029513872,129758.26687282984,2529,2,367.01960784313724,39,12,19,35.30057187043269,0.6193910256410257,44.609375,1021.5624999999999,26.193910256410252,0
4249,4,0,0,51,0.0,0.0,1.0,51,1900,1300,600,0.6842105263157895,25,13,12,366.54506654422346,0.45395424836601306,0.37951385975217455,0.21086009865562777,130635.03146701393,-623.2747395833298,130011.7567274306,2530,3,368.01960784313724,39,12,14,35.05918415868488,0.6212606837606838,44.427083333333336,1022.2916666666671,26.21260683760685,0
4250,4,0,3,48,0.0,0.058823529411764705,0.9411764705882353,51,600,200,400,0.3333333333333333,10,2,8,366.4715214141186,0.45361111111111113,0.37877198765395126,0.2109629315354588,130661.65500217008,-623.2449001736179,130038.41010199646,2531,4,369.01960784313724,39,12,14,35.03406775343862,0.6215277777777778,44.401041666666664,1022.3958333333328,26.215277777777764,0
4251,4,1,0,49,0.02040816326530612,0.0,1.0,49,1850,1500,350,0.8108108108108109,22,15,7,377.2129366610523,0.45303642290249435,0.37999745938298046,0.21616667551092764,130486.5499480609,44.24294013542388,130530.79288819633,2532,0,384.3673469387755,37,12,19,34.937307719825434,0.6233108108108107,44.57236842105263,1021.7105263157891,27.613798008534843,0
4252,4,0,1,48,0.0,0.02040816326530612,0.9795918367346939,49,1150,700,450,0.6086956521739131,16,7,9,380.69682093596583,0.4521860827664399,0.38190074957596987,0.21927102255885617,130682.67549871112,150.09582275315014,130832.77132146427,2533,1,385.3673469387755,37,12,15,34.649128686327074,0.6252815315315315,44.38048245614035,1022.4780701754385,27.634542437174012,0
4253,4,0,2,46,0.0,0.041666666666666664,0.9583333333333334,48,1800,1200,600,0.6666666666666666,24,12,12,386.3366440150048,0.45101026891252954,0.3842452362595006,0.22241917508003964,130665.25298524862,496.15506553849383,131161.4080507871,2534,7,394.375,36,12,15,34.522662187465585,0.627025462962963,44.397522522522515,1022.4099099099087,28.40027527527524,0
4254,4,0,0,46,0.0,0.0,1.0,46,1350,900,450,0.6666666666666666,18,9,9,389.24508450566185,0.4498490338164251,0.37861794416397543,0.22452003111838614,130738.73842191813,977.8822570406154,131716.62067895874,2535,8,408.7173913043478,37,9,17,34.37365980486761,0.6258445945945945,44.325657894736835,1022.6973684210514,27.640469416785173,0
4255,4,0,2,44,0.0,0.043478260869565216,0.9565217391304348,46,1400,1100,300,0.7857142857142857,17,11,6,385.72070824887356,0.44913446054750406,0.36829795560856593,0.22329687651231273,130878.94833025515,896.5441289627245,131775.49245921787,2536,9,409.7173913043478,37,9,17,34.32142091727388,0.6272522522522522,44.188596491228054,1023.2456140350853,27.655286865813117,0
4256,4,1,0,45,0.022222222222222223,0.0,1.0,45,1500,1000,500,0.6666666666666666,20,10,10,383.96760139981916,0.4475799663299664,0.364018897337951,0.22309306124891765,131019.23338190577,1061.4281557786792,132080.66153768444,2537,0,417.6,37,8,18,34.22394327228589,0.6286599099099099,44.05153508771929,1023.7938596491211,27.67010431484111,0
4257,4,1,0,46,0.021739130434782608,0.0,1.0,46,1500,1100,400,0.7333333333333333,19,11,8,373.1244629519468,0.4478663446054751,0.3517143867090846,0.2185443283004257,131328.12499999977,601.4383031317036,131929.56330313146,2538,0,409.5,35,11,19,34.18868563685636,0.6357142857142857,43.749999999999986,1024.9999999999982,29.285714285714235,0
4258,4,0,2,44,0.0,0.043478260869565216,0.9565217391304348,46,1000,600,400,0.6,14,6,8,347.5057915523119,0.44784621578099837,0.18693201742341414,0.19812643218087703,130287.90632282967,-144.83959671835308,130143.06672611133,2539,1,410.5,41,5,17,35.89736582126778,0.6145833333333333,44.76686507936506,1020.9325396825366,24.900793650793574,8
4259,4,0,0,44,0.0,0.0,1.0,44,1100,600,500,0.5454545454545454,16,6,10,351.3536026655561,0.44594564834390416,0.21549165120593705,0.20018984337921217,130262.5868055555,353.6458333333294,130616.23263888883,2540,13,430.09090909090907,39,5,17,35.82482993197278,0.6175213675213675,44.791666666666664,1020.8333333333329,26.175213675213666,0
4260,4,0,1,43,0.0,0.022727272727272728,0.9772727272727273,44,1400,1000,400,0.7142857142857143,18,10,8,351.8077939966973,0.4461768851303735,0.20838472452774193,0.20086032641523752,130342.35161675359,371.091037326399,130713.44265407999,2541,14,431.09090909090907,39,5,17,35.73236509231867,0.6183226495726496,44.71354166666667,1021.1458333333343,26.18322649572652,0
4261,4,0,0,43,0.0,0.0,1.0,43,1150,900,250,0.782608695652174,14,9,5,355.6077106473523,0.44522886674049467,0.20421519230628893,0.20318315039318832,130371.67302441738,672.2344354956457,131043.90745991303,2542,15,440.5581395348837,38,5,17,35.60562471667189,0.6203399122807017,44.684829059829056,1021.2606837606834,26.87528115159693,0
4262,4,0,0,43,0.0,0.0,1.0,43,1200,900,300,0.75,15,9,6,350.81408303302925,0.44485972683647107,0.19207561664616435,0.20143382462748854,130562.68376981522,560.6456370078223,131123.32940682303,2543,16,441.5581395348837,38,5,16,35.53448846609518,0.6222587719298245,44.49786324786325,1022.0085470085473,26.894961763382824,0
4263,4,1,0,44,0.022727272727272728,0.0,1.0,44,900,700,200,0.7777777777777778,11,7,4,383.10041944130927,0.4463310429880197,0.18729222872270523,0.20776096887965398,128315.61872260773,1080.9002317859731,129396.5189543937,2544,0,432.5,36,8,16,37.002380423104,0.6032986111111112,46.70608108108108,1013.1756756756756,28.143768768768766,8
4264,4,0,1,43,0.0,0.022727272727272728,0.9772727272727273,44,1050,800,250,0.7619047619047619,13,8,5,382.36848129590356,0.4460227272727273,0.18639090606094277,0.20795762538637025,128429.74044568212,1021.4969614885086,129451.23740717063,2545,1,433.5,36,8,15,36.904001407251044,0.6044560185185186,46.593468468468465,1013.6261261261258,28.15628128128127,0
4265,4,1,0,44,0.022727272727272728,0.0,1.0,44,850,500,350,0.5882352941176471,12,5,7,381.4046089680694,0.4455822762508809,0.19583097852414055,0.20847649985342054,128629.57552146743,1011.9825906988092,129641.55811216624,2546,0,433.5681818181818,36,8,16,36.72383806986383,0.6064814814814814,46.3963963963964,1014.4144144144145,28.178178178178182,0
4266,4,0,2,42,0.0,0.045454545454545456,0.9545454545454546,44,1300,1000,300,0.7692307692307693,16,10,6,385.3206820555286,0.4460227272727273,0.2035114796433044,0.2112232351997823,128743.8367421475,1121.5325967859726,129865.36933893347,2547,1,434.5681818181818,36,8,17,36.507573235685754,0.6076388888888888,46.28378378378378,1014.8648648648644,28.19069069069068,0
4267,4,0,2,40,0.0,0.047619047619047616,0.9523809523809523,42,900,500,400,0.5555555555555556,13,5,8,392.3200390243421,0.4449888695315525,0.2111463453305853,0.21475112707225544,128686.69979100727,1697.2742167843603,130383.97400779162,2548,2,451.9047619047619,36,6,18,36.38850351461339,0.6070601851851851,46.340090090090094,1014.63963963964,28.184434434434444,0
4268,4,1,0,41,0.024390243902439025,0.0,1.0,41,1250,900,350,0.72,16,9,7,391.06946649811675,0.44702743902439024,0.22018294035235786,0.215303079907205,128915.32368517164,1882.9693713984227,130798.29305657005,2549,0,460.6829268292683,36,5,19,36.18619242995491,0.609375,46.11486486486486,1015.5405405405404,28.209459459459456,0
4269,4,1,0,42,0.023809523809523808,0.0,1.0,42,1200,1100,100,0.9166666666666666,13,11,2,381.21346148910294,0.44772309330236154,0.22897439230469274,0.21266679907437774,129436.8355624143,1469.2469058147299,130906.08246822903,2550,0,450.6904761904762,35,7,18,35.903851986654544,0.6166666666666667,45.601851851851855,1017.5925925925928,29.07407407407408,0
4270,4,0,0,42,0.0,0.0,1.0,42,950,600,350,0.631578947368421,13,6,7,377.8802666614455,0.4473722415795587,0.22464180362410469,0.21138846600368014,129545.08562616684,1390.506300219156,130935.591926386,2551,1,451.6904761904762,36,6,18,35.878272492625385,0.6157407407407407,45.495495495495504,1018.0180180180191,28.278278278278307,0
4271,4,0,0,42,0.0,0.0,1.0,42,1150,700,450,0.6086956521739131,16,7,9,377.9033203635042,0.4475416182733256,0.22510056654240596,0.21201970405505818,129659.75265806373,1399.7702093986147,131059.52286746235,2552,2,452.6904761904762,36,6,18,35.7608174848887,0.6168981481481481,45.382882882882896,1018.4684684684705,28.290790790790847,0
4272,4,0,1,41,0.0,0.023809523809523808,0.9761904761904762,42,1000,600,400,0.6,14,6,8,379.8128779130959,0.4476867982965544,0.2332670276641986,0.2138722297595275,129803.15778193747,1460.1821838730789,131263.33996581053,2553,3,453.6904761904762,36,6,18,35.56608465023759,0.6183449074074074,45.242117117117125,1019.0315315315326,28.30643143143146,0
4273,4,0,1,40,0.0,0.024390243902439025,0.975609756097561,41,1150,800,350,0.6956521739130435,15,8,7,383.4756866741625,0.44728150406504064,0.23736439090878858,0.21586444664190077,129790.40745027442,1754.2931241426681,131544.70057441707,2554,4,464.5853658536585,35,6,18,35.48576404664547,0.6202380952380953,45.25462962962963,1018.981481481482,29.113756613756628,0
4274,4,0,1,39,0.0,0.025,0.975,40,950,800,150,0.8421052631578947,11,8,3,390.3883094331069,0.4453926282051282,0.25100794671029525,0.21934029965982235,129716.28578514735,2127.9443027210814,131844.23008786843,2555,5,476.45,34,6,18,35.385259631490776,0.6216299019607843,45.32738095238095,1018.6904761904759,29.961484593837525,0
4275,4,0,0,39,0.0,0.0,1.0,39,1100,700,400,0.6363636363636364,15,7,8,393.65361798622274,0.4435166441745389,0.26567482713742074,0.2214368186696519,129762.65889321412,2416.3080305651656,132178.96692377928,2556,6,488.7692307692308,33,6,19,35.2547911153877,0.6243686868686869,45.28186274509804,1018.8725490196076,30.8749257278669,0
4276,4,0,0,39,0.0,0.0,1.0,39,1100,800,300,0.7272727272727273,14,8,6,392.56401049390377,0.44270130454340983,0.26623756943545374,0.22152967702091528,129887.55076172619,2397.8355680507443,132285.38632977693,2557,7,489.7692307692308,33,6,19,35.15518554139617,0.6256313131313131,45.15931372549019,1019.3627450980387,30.88978015448602,0
4277,4,2,0,41,0.04878048780487805,0.0,1.0,41,1000,500,500,0.5,15,5,10,377.131507903557,0.44545223577235776,0.25785005409673545,0.21630937586559096,130520.50053884814,1646.3006084269077,132166.80114727505,2558,0,466.8292682926829,32,9,19,34.90490753325921,0.6344401041666667,44.53914141414142,1021.8434343434349,31.93260732323234,0
4278,4,0,1,40,0.0,0.024390243902439025,0.975609756097561,41,1150,800,350,0.6956521739130435,15,8,7,377.9610704158789,0.44491869918699184,0.25695917285259817,0.2173276154891306,130617.28395061746,1673.64969135805,132290.9336419755,2559,1,467.8292682926829,32,9,19,34.7854393115942,0.6354166666666667,44.44444444444446,1022.2222222222236,31.94444444444449,0
4279,4,0,0,40,0.0,0.0,1.0,40,650,400,250,0.6153846153846154,9,4,5,380.80237731460886,0.44463141025641023,0.24591475842225186,0.21890231765548962,130606.84479827479,1947.0793985486453,132553.92419682344,2560,2,466.85,33,7,19,34.723429444910686,0.6328914141414141,44.454656862745104,1022.1813725490204,30.975193107546072,0
4280,4,0,1,39,0.0,0.025,0.975,40,1200,800,400,0.6666666666666666,16,8,8,380.49104491284623,0.4438969017094017,0.24956875898418796,0.21996809161581998,130826.15460399847,1955.6360534409878,132781.79065743944,2561,3,467.85,33,7,19,34.508764574349144,0.6351010101010102,44.240196078431374,1023.0392156862746,31.001188354129532,0
4281,4,0,0,39,0.0,0.0,1.0,39,1600,1300,300,0.8125,19,13,6,389.2004963078694,0.4434604138551507,0.25383380969111147,0.2247265303342873,130778.66934815331,2379.82460335681,133158.4939515101,2562,4,480.46153846153845,32,7,19,34.334238571369795,0.6370442708333333,44.286616161616166,1022.8535353535359,31.964172979797997,0
4282,4,0,1,38,0.0,0.02564102564102564,0.9743589743589743,39,750,600,150,0.8,9,6,3,389.1074472138603,0.44312303193882147,0.2517465259321132,0.22523762515865195,130875.54841342728,2384.9301091725433,133260.47852259982,2563,5,481.46153846153845,32,7,19,34.23823626192828,0.6380208333333333,44.1919191919192,1023.2323232323239,31.97601010101012,0
4283,4,1,0,39,0.02564102564102564,0.0,1.0,39,1350,1100,250,0.8148148148148148,16,11,5,388.64229665770125,0.44090193432298697,0.26343545480413555,0.22610394733816058,131069.41415416796,2387.823627691052,133457.237781859,2564,0,482.0769230769231,32,7,20,34.0533806000822,0.6399739583333333,44.00252525252525,1023.9898989898991,31.999684343434346,0
4284,4,1,0,40,0.025,0.0,1.0,40,900,800,100,0.8888888888888888,10,8,2,380.03795858937235,0.4410924145299145,0.26082357159933056,0.2229591557895294,131390.93888168014,1986.7088379469405,133377.64771962707,2565,0,471.0,33,7,22,33.947924137381456,0.6407828282828283,43.68872549019608,1025.2450980392157,31.068033273915628,0
4285,4,0,0,40,0.0,0.0,1.0,40,1600,1200,400,0.75,20,12,8,383.8245768796507,0.4408787393162393,0.2639725209080055,0.22592206107473106,131516.61169982693,2095.8615676662744,133612.47326749322,2566,1,472.0,33,7,22,33.72361608920748,0.6420454545454546,43.56617647058823,1025.7352941176466,31.082887700534744,0
4286,4,0,0,40,0.0,0.0,1.0,40,1350,1000,350,0.7407407407407407,17,10,7,385.5663016815225,0.44034455128205124,0.26615329512894004,0.2280722699777141,131705.23356401385,2156.2199634755875,133861.45352748944,2567,2,473.0,33,7,18,33.48804122890799,0.6439393939393939,43.38235294117647,1026.4705882352941,31.10516934046346,0
4287,4,1,0,41,0.024390243902439025,0.0,1.0,41,950,400,550,0.42105263157894735,15,4,11,376.75073737757447,0.4407520325203252,0.270792435776124,0.2251378973879139,132091.8810232426,1753.1427154194994,133845.0237386621,2568,0,462.4390243902439,34,7,20,33.323682686740014,0.6455269607843137,43.00595238095238,1027.9761904761904,30.234593837535012,0
4288,4,0,0,41,0.0,0.0,1.0,41,1300,1000,300,0.7692307692307693,16,10,6,378.1608341186773,0.44004065040650403,0.2710898975671854,0.22708045640163205,132275.5119756234,1804.283588435354,134079.79556405876,2569,1,463.4390243902439,34,7,21,33.10211973922771,0.6473651960784313,42.82738095238094,1028.6904761904748,30.255602240896316,0
4289,4,0,0,41,0.0,0.0,1.0,41,1300,1000,300,0.7692307692307693,16,10,6,379.10627276468523,0.44029471544715443,0.2634401888726592,0.2285795825520882,132429.53619100817,1841.0302632082146,134270.56645421637,2570,2,464.4390243902439,33,8,22,32.92244612453863,0.651199494949495,42.67769607843137,1029.2892156862738,31.19058229352345,0
4290,4,1,0,42,0.023809523809523808,0.0,1.0,42,950,500,450,0.5263157894736842,14,5,9,368.8218246229339,0.4406455671699574,0.2582158494923741,0.22485256618182545,132845.0671537422,1399.2320119598653,134244.29916570205,2571,0,454.35714285714283,35,7,18,32.76881946783429,0.6508928571428572,42.27430555555555,1030.902777777777,29.454365079365054,0
4291,4,0,1,41,0.0,0.023809523809523808,0.9761904761904762,42,1250,900,350,0.72,16,9,7,366.7789001122338,0.44019792876500197,0.25998075998076065,0.2241426611796981,132934.57031249974,1351.5190972221937,134286.08940972193,2572,1,455.35714285714283,35,7,18,32.731481481481474,0.6517857142857143,42.187499999999986,1031.249999999998,29.464285714285655,0
4292,4,0,1,40,0.0,0.024390243902439025,0.975609756097561,41,1350,800,550,0.5925925925925926,19,8,11,370.64515482709794,0.43955792682926825,0.24949890773145977,0.2267845777840376,132980.6122448978,1657.723922902473,134638.3361678003,2573,2,464.8780487804878,34,7,19,32.585507079101255,0.6544117647058824,42.14285714285713,1031.4285714285702,30.336134453781476,0
4293,4,1,0,41,0.024390243902439025,0.0,1.0,41,1150,600,550,0.5217391304347826,17,6,11,374.8925051231598,0.439380081300813,0.24886373863738598,0.2308997020190373,133226.30385487544,1789.1085600907186,135015.41241496615,2574,0,464.0,34,7,20,32.228964867773676,0.6568627450980392,41.90476190476191,1032.3809523809537,30.364145658263343,0
4294,4,0,1,40,0.0,0.024390243902439025,0.975609756097561,41,1150,800,350,0.6956521739130435,15,8,7,359.7745203865308,0.43920223577235773,0.18393971315128455,0.20812498758380146,130850.90033712289,1215.8174969260504,132066.71783404893,2575,1,465.0,37,4,17,35.01355249526669,0.6269707207207207,44.21600877192982,1023.1359649122801,27.65232337600757,8
4295,4,1,1,40,0.024390243902439025,0.024390243902439025,0.975609756097561,41,1400,1200,200,0.8571428571428571,16,12,4,342.25285514998365,0.4395071138211382,0.11116889238422889,0.19044941168223248,129337.19735051878,680.0702514431314,130017.26760196191,2576,0,465.8780487804878,38,3,16,36.99628890522706,0.6099232456140351,45.69978632478633,1017.2008547008555,26.768443544759357,8
4296,4,1,0,41,0.024390243902439025,0.0,1.0,41,1150,800,350,0.6956521739130435,15,8,7,349.04119197872825,0.44148882113821136,0.16027357986171187,0.18423677897457416,127226.70945878078,831.1164529914555,128057.82591177223,2577,0,465.4146341463415,38,3,15,38.97971160295104,0.5885416666666667,47.78311965811966,1008.8675213675215,26.5491452991453,8
4297,4,0,1,40,0.0,0.024390243902439025,0.975609756097561,41,1550,1100,450,0.7096774193548387,20,11,9,353.8814479492152,0.44197154471544714,0.16618096120637382,0.18753930463668744,127388.43831041362,816.0810002557016,128204.51931066932,2578,1,466.4146341463415,38,3,11,38.69170458955093,0.5901864035087719,47.62286324786326,1009.5085470085482,26.566014394961798,0
4298,4,0,0,40,0.0,0.0,1.0,40,900,600,300,0.6666666666666666,12,6,6,358.6842378855468,0.4405181623931624,0.1760535462148365,0.19012123075487783,127396.24361582405,1139.0049101646564,128535.2485259887,2579,2,478.975,37,3,11,38.56248416060242,0.5920608108108107,47.61513157894736,1009.5394736842101,27.284850640113785,0
4299,4,1,1,40,0.024390243902439025,0.024390243902439025,0.975609756097561,41,1100,700,400,0.6363636363636364,15,7,8,354.63861513665563,0.44222560975609754,0.18103963854392302,0.18975316419605187,127775.65646701396,862.8363715277824,128638.49283854174,2580,0,468.2682926829268,39,2,14,38.27572292053025,0.5924145299145299,47.239583333333336,1011.0416666666673,25.924145299145316,0
4300,4,1,0,41,0.024390243902439025,0.0,1.0,41,1100,800,300,0.7272727272727273,14,8,6,352.511730488894,0.4442073170731707,0.1849882241873686,0.1896068078609699,127986.37695312501,823.3398437500011,128809.71679687501,2581,0,468.8536585365854,39,2,15,38.11380481778876,0.594551282051282,47.03125,1011.8750000000001,25.945512820512825,0
4301,4,0,1,40,0.0,0.024390243902439025,0.975609756097561,41,1650,1300,350,0.7878787878787878,20,13,7,350.39975071823704,0.4444613821138212,0.18534320814826666,0.1893437193447806,128171.5759460151,782.3553083794584,128953.93125439456,2582,1,469.8536585365854,38,3,15,37.977861011465166,0.5981359649122807,46.8482905982906,1012.606837606838,26.647548358074683,0
4302,4,2,0,42,0.047619047619047616,0.0,1.0,42,700,400,300,0.5714285714285714,10,4,6,360.9302477412075,0.4463680797522261,0.23749664052383346,0.1981557895345393,128804.55864800367,897.8922526041866,129702.45090060786,2583,0,459.4761904761905,39,3,15,37.064413374380024,0.6028311965811965,46.22395833333334,1015.1041666666683,26.02831196581201,0
4303,4,0,1,41,0.0,0.023809523809523808,0.9761904761904762,42,1400,1000,400,0.7142857142857143,18,10,8,357.39644970414173,0.44635598141695704,0.24036630036630058,0.1968709256844852,128936.76757812525,816.3085937500298,129753.07617187528,2584,1,460.4761904761905,39,3,15,37.01923076923079,0.6041666666666667,46.093750000000014,1015.6250000000019,26.041666666666718,0
4304,4,1,0,42,0.023809523809523808,0.0,1.0,42,1200,900,300,0.75,15,9,6,356.9083018216967,0.4478319783197832,0.2460187273597152,0.19712817530967347,129042.58355034744,811.2738715277986,129853.85742187523,2585,0,461.07142857142856,39,3,17,36.92374068758115,0.6052350427350428,45.98958333333334,1016.0416666666684,26.052350427350472,0
4305,4,0,0,42,0.0,0.0,1.0,42,1450,1000,450,0.6896551724137931,19,10,9,355.751142166084,0.44797715834301205,0.23750975800156104,0.19728017883755597,129201.3888888891,792.7083333333525,129994.09722222245,2586,1,462.07142857142856,39,3,17,36.791325136612016,0.6068376068376069,45.83333333333334,1016.6666666666683,26.06837606837611,0
4306,4,0,0,42,0.0,0.0,1.0,42,1050,800,250,0.7619047619047619,13,8,5,354.9610266950592,0.4476263066202091,0.2386754572434968,0.19712027314790304,129257.13320444761,776.2489419821576,130033.38214642977,2587,2,463.07142857142856,37,5,17,36.75463661850335,0.6109234234234234,45.77850877192983,1016.8859649122815,27.48340445708869,0
4307,4,0,0,42,0.0,0.0,1.0,42,1250,900,350,0.72,16,9,7,354.1352990584745,0.44726335656213706,0.24081603318343303,0.196939990051943,129312.88954293626,758.8517620806396,130071.7413050169,2588,3,464.07142857142856,37,5,17,36.71886229696709,0.6114864864864865,45.723684210526315,1017.1052631578945,27.48933143669985,0
4308,4,0,1,41,0.0,0.023809523809523808,0.9761904761904762,42,950,700,250,0.7368421052631579,12,7,5,350.02972651605234,0.4468036198219125,0.23573481116584594,0.19520888594164462,129424.43828870427,660.4801477377728,130084.91843644205,2589,4,465.07142857142856,37,5,17,36.70977011494253,0.6126126126126126,45.6140350877193,1017.5438596491232,27.50118539592225,0
4309,4,0,0,41,0.0,0.0,1.0,41,1000,700,300,0.7,13,7,6,352.50613316125214,0.4474339430894309,0.22575683158911697,0.19690670157672405,129487.7711326191,929.0466987257519,130416.81783134486,2590,5,473.4634146341463,36,5,12,36.58234675813233,0.615162037037037,45.5518018018018,1017.7927927927927,28.27202202202202,0
4310,4,1,1,41,0.023809523809523808,0.023809523809523808,0.9761904761904762,42,1150,700,450,0.6086956521739131,16,7,9,344.3476377546701,0.44869096012388693,0.2253846981599057,0.19382329483065702,129787.3038458948,538.3902979762901,130325.6941438711,2591,0,463.1666666666667,37,5,13,36.48568366871122,0.6162725225225225,45.257675438596486,1018.9692982456133,27.539710763394954,0
4311,4,1,2,40,0.023809523809523808,0.047619047619047616,0.9523809523809523,42,1200,800,400,0.6666666666666666,16,8,8,349.20399624714196,0.44848528842431284,0.23995823608893319,0.1981093890904515,130094.7406894427,685.9206678977968,130780.66135734049,2592,0,463.35714285714283,37,5,16,36.04990685010033,0.6193693693693694,44.956140350877185,1020.1754385964896,27.572309151256476,0
4312,4,2,0,42,0.047619047619047616,0.0,1.0,42,1000,800,200,0.8,12,8,4,351.76521088446526,0.4475900116144019,0.2590897393478184,0.20072090415918462,130320.07250071004,768.5217635093934,131088.59426421943,2593,0,463.8809523809524,36,6,19,35.756038380941874,0.6235532407407407,44.73536036036035,1021.0585585585575,28.362737737737707,0
4313,4,0,0,42,0.0,0.0,1.0,42,950,400,550,0.42105263157894735,15,4,11,352.29821238051704,0.4469246031746032,0.2621567145376673,0.20177079436338693,130463.84222059888,792.4356789221556,131256.27789952102,2594,1,464.8809523809524,36,6,19,35.59670781893004,0.625,44.59459459459459,1021.6216216216208,28.378378378378354,0
4314,4,1,1,42,0.023255813953488372,0.023255813953488372,0.9767441860465116,43,1050,700,350,0.6666666666666666,14,7,7,344.96406730652194,0.4474667774086379,0.26208299876813523,0.19883404769472313,130710.70545744832,418.099319021221,131128.80477646954,2595,0,455.04651162790697,37,6,15,35.53416970476802,0.6255630630630631,44.35307017543859,1022.5877192982446,27.637505926979582,0
4315,4,0,0,42,0.0,0.0,1.0,42,1000,700,300,0.7,13,7,6,352.9867429481328,0.4456542779713511,0.2665318379604089,0.20316348094125863,130654.64854570637,823.8717682363765,131478.52031394275,2596,1,466.8333333333333,37,5,16,35.38583226083224,0.625,44.4078947368421,1022.3684210526316,27.63157894736842,0
4316,4,0,0,42,0.0,0.0,1.0,42,1350,1100,250,0.8148148148148148,16,11,5,350.7283837015744,0.445448606271777,0.26551829735109433,0.20274447459328943,130822.85534972309,776.657721606656,131599.51307132974,2597,2,467.8333333333333,37,5,17,35.27331189710611,0.6266891891891893,44.24342105263158,1023.0263157894744,27.649359886202014,0
4317,4,1,1,42,0.023255813953488372,0.023255813953488372,0.9767441860465116,43,1200,900,300,0.75,15,9,6,397.4392181047385,0.4459671465485419,0.32661287294048735,0.22307026567824267,129675.59880203522,1760.7510243536467,131436.34982638888,2598,0,457.93023255813955,37,6,14,35.247223418380166,0.6151463963963963,45.36732456140351,1018.5307017543859,27.52785680417259,8
4318,4,1,0,43,0.023255813953488372,0.0,1.0,43,1250,1000,250,0.8,15,10,5,395.1980609172733,0.4456672203765227,0.3366653578654366,0.22340101935986192,129954.95158366053,1671.5889744921676,131626.5405581527,2599,0,458.83720930232556,37,6,16,35.01933451625623,0.6179617117117118,45.09320175438597,1019.6271929824575,27.55749170222858,0
4319,4,0,0,43,0.0,0.0,1.0,43,950,300,650,0.3157894736842105,16,3,13,394.9105369116103,0.44472129937246213,0.33721930052590543,0.2240394899649771,130094.74068944299,1675.1567790089366,131769.89746845193,2600,1,459.83720930232556,37,6,16,34.884189595872755,0.6193693693693694,44.9561403508772,1020.175438596492,27.57230915125654,0
4320,4,0,0,43,0.0,0.0,1.0,43,1000,500,500,0.5,15,5,10,393.82996924887584,0.4445136581764489,0.3386148460398646,0.22390809552836236,130178.650221703,1653.6507627347064,131832.30098443772,2601,2,460.83720930232556,37,6,16,34.82627323519932,0.6202139639639639,44.87390350877194,1020.5043859649137,27.581199620673342,0
4321,4,0,0,43,0.0,0.0,1.0,43,1350,800,550,0.5925925925925926,19,8,11,393.0029154518946,0.44425987449243265,0.3381110583768385,0.22392026578073104,130262.58680555578,1638.7152777778028,131901.30208333358,2602,3,461.83720930232556,39,4,16,34.76190476190477,0.6175213675213675,44.79166666666668,1020.8333333333352,26.175213675213723,0
4322,4,3,1,45,0.06521739130434782,0.021739130434782608,0.9782608695652174,46,1200,600,600,0.5,18,6,12,370.40590475265526,0.4451388888888889,0.3434320074005548,0.21602504956012542,131163.91354372134,516.7776134122412,131680.69115713358,2603,0,432.6521739130435,38,8,17,34.424541093032964,0.6282894736842105,43.910256410256416,1024.3589743589753,26.956815114709876,0
4323,4,0,1,44,0.0,0.022222222222222223,0.9777777777777777,45,850,400,450,0.47058823529411764,13,4,9,376.0312875449754,0.44522306397306394,0.34206647197886264,0.21930583850250776,131163.91354372134,864.3470578566853,132028.26060157802,2604,1,437.4222222222222,38,7,18,34.28048080934502,0.6282894736842105,43.910256410256416,1024.3589743589753,26.956815114709876,0
4324,4,0,3,41,0.0,0.06818181818181818,0.9318181818181819,44,1150,800,350,0.6956521739130435,15,8,7,384.30390929838745,0.44296159267089497,0.35048071452952545,0.22413052812365825,131163.91354372134,1281.360946745574,132445.27449046692,2605,2,447.8181818181818,38,6,18,34.0686274509804,0.6282894736842105,43.910256410256416,1024.3589743589753,26.956815114709876,0
4325,4,0,0,41,0.0,0.0,1.0,41,1300,1000,300,0.7692307692307693,16,10,6,399.66304076730637,0.4417936991869919,0.35173560280872374,0.23246672726287737,131061.33355034742,2276.0742187500255,133337.40776909745,2606,3,468.2439024390244,35,6,19,33.77945913869109,0.6330357142857144,44.01041666666668,1023.958333333335,29.255952380952426,0
4326,4,0,0,41,0.0,0.0,1.0,41,700,400,300,0.5714285714285714,10,4,6,398.4198874344878,0.44164126016260163,0.35079614893787037,0.23210122343040068,131120.59709630074,2248.2107070902093,133368.80780339096,2607,4,469.2439024390244,35,6,19,33.7511065280446,0.6336309523809525,43.952546296296305,1024.1898148148161,29.262566137566175,0
4327,4,0,0,41,0.0,0.0,1.0,41,1250,600,650,0.48,19,6,13,409.1326360904475,0.4410315040650406,0.36018835741256416,0.2398314296353605,131359.53006355735,2549.022362118274,133908.55242567562,2608,5,470.2439024390244,33,8,19,33.23408547519427,0.6404671717171717,43.719362745098046,1025.1225490196084,31.06431966726086,0
4328,4,0,0,41,0.0,0.0,1.0,41,850,600,250,0.7058823529411765,11,6,5,407.0455052297929,0.44065040650406506,0.355687170638437,0.23919640363503566,131453.7677816225,2501.5330642060844,133955.30084582858,2609,6,471.2439024390244,33,8,20,33.191921606118555,0.6414141414141414,43.62745098039216,1025.4901960784318,31.075460487225207,0
4329,4,2,1,42,0.046511627906976744,0.023255813953488372,0.9767441860465116,43,900,500,400,0.5555555555555556,13,5,8,392.5241454155794,0.4416528239202658,0.35185873703282855,0.23461638355189607,132100.37964034633,1770.517725480107,133870.89736582644,2610,0,450.27906976744185,35,8,19,32.90972378593409,0.6434523809523809,42.99768518518518,1028.009259259259,29.371693121693113,0
4330,4,0,0,42,0.0,0.0,1.0,42,1500,1200,300,0.8,18,12,6,389.3233128738592,0.4407786488579171,0.33671019060483287,0.23306929323257167,132159.87761488333,1890.584276406024,134050.46189128936,2611,1,448.26190476190476,35,7,19,32.93186252438841,0.644047619047619,42.93981481481481,1028.24074074074,29.378306878306855,0
4331,4,0,0,42,0.0,0.0,1.0,42,950,500,450,0.5263157894736842,14,5,9,385.93397169814074,0.44030681378242353,0.3273293789215921,0.23158644203115306,132249.14969403722,1807.8879190243495,134057.03761306158,2612,2,449.26190476190476,35,7,19,32.92883331457934,0.6449404761904762,42.85300925925926,1028.587962962963,29.388227513227516,0
4332,4,0,0,42,0.0,0.0,1.0,42,750,400,350,0.5333333333333333,11,4,7,385.926368967975,0.4404036004645761,0.3264146698166279,0.23194722743450494,132308.68115837182,1812.2817804783879,134120.96293885022,2613,3,450.26190476190476,35,7,19,32.86892507593656,0.6455357142857143,42.795138888888886,1028.819444444444,29.394841269841255,0
4333,4,0,0,42,0.0,0.0,1.0,42,1000,600,400,0.6,14,6,8,390.87414965986386,0.439665602013163,0.33434240362811796,0.23587233169129726,132461.07266436,1955.1821097788425,134416.25477413883,2614,4,451.26190476190476,33,9,19,32.58779761904761,0.6515151515151515,42.64705882352942,1029.4117647058833,31.194295900178282,0
4334,4,0,0,42,0.0,0.0,1.0,42,1100,800,300,0.7272727272727273,14,8,6,384.2058585912059,0.4393994386372435,0.3228666105212168,0.23259376365797918,132581.8470096372,1787.7444727891166,134369.5914824263,2615,5,452.26190476190476,34,8,19,32.637604515855585,0.6504289215686274,42.529761904761905,1029.8809523809525,30.290616246498605,0
4335,4,1,0,43,0.023255813953488372,0.0,1.0,43,1200,900,300,0.75,15,9,6,374.2883379247016,0.4407991878922111,0.3128024430350014,0.2287317620650954,132934.5703125,1351.1718750000005,134285.7421875,2616,0,442.72093023255815,35,8,17,32.53787878787879,0.6517857142857143,42.1875,1031.25,29.464285714285715,0
4336,4,1,0,44,0.022727272727272728,0.0,1.0,44,1200,700,500,0.5833333333333334,17,7,10,365.9847394201218,0.44042899929527835,0.31839891163813894,0.22656427166993343,133415.57618690358,965.6129770698586,134381.18916397344,2617,0,433.6363636363636,37,7,18,32.26889195499893,0.6525900900900901,41.72149122807017,1033.1140350877188,27.922000948316725,0
4337,4,0,0,44,0.0,0.0,1.0,44,1550,1100,450,0.7096774193548387,20,11,9,364.22046504661864,0.4396361874559549,0.31810257730937663,0.22617154453300845,133530.41174620565,926.9137557440284,134457.32550194967,2618,1,434.6363636363636,36,8,19,32.1992808890826,0.6556712962962963,41.61036036036036,1033.5585585585584,28.709959959959956,0
4338,4,0,1,43,0.0,0.022727272727272728,0.9772727272727273,44,1400,1000,400,0.7142857142857143,18,10,8,365.63924247878134,0.43908562367864695,0.32118951193670764,0.2275887379795044,133617.7198101818,971.1763706273829,134588.89618080918,2619,2,435.6363636363636,36,8,19,32.0750735214029,0.6565393518518519,41.5259009009009,1033.8963963963963,28.719344344344343,0
4339,4,0,0,43,0.0,0.0,1.0,43,850,500,350,0.5882352941176471,12,5,7,375.9689821428321,0.4381229235880399,0.33874545662837563,0.23385480142756093,133591.84777949244,1445.278206447183,135037.12598593964,2620,3,446.5581395348837,35,8,19,31.834042394387215,0.6583333333333333,41.550925925925924,1033.796296296296,29.53703703703703,0
4340,4,0,0,43,0.0,0.0,1.0,43,1200,700,500,0.5833333333333334,17,7,10,373.6426891564213,0.43738464377999264,0.33106161736808826,0.23335043417127435,133741.455078125,1394.3033854166667,135135.75846354166,2621,4,447.5581395348837,35,8,17,31.744083585095673,0.6598214285714286,41.40625,1034.375,29.553571428571427,0
4341,4,0,0,43,0.0,0.0,1.0,43,900,400,500,0.4444444444444444,14,4,10,374.967185245355,0.43655407899593945,0.33327262225043874,0.23436760151908959,133771.3865847907,1431.976058813433,135203.36264360414,2622,5,448.5581395348837,35,8,17,31.679812784366376,0.6601190476190476,41.37731481481481,1034.49074074074,29.556878306878286,0
4342,4,0,0,43,0.0,0.0,1.0,43,1500,1100,400,0.7333333333333333,19,11,8,374.96000893954255,0.4365771502399409,0.3387032601827076,0.23531700771553168,133921.09435281626,1443.0109471450548,135364.10529996132,2623,6,449.5581395348837,35,8,18,31.5298976853405,0.6616071428571428,41.232638888888886,1035.069444444444,29.57341269841268,0
4343,4,0,0,43,0.0,0.0,1.0,43,1100,600,500,0.5454545454545454,16,6,10,374.7215571656355,0.4357235142118863,0.3375783597218036,0.23612735869845802,134070.88584533596,1447.850222908077,135518.73606824403,2624,7,450.5581395348837,35,8,18,31.385970794218437,0.6630952380952381,41.087962962962955,1035.6481481481471,29.58994708994706,0
4344,4,0,0,43,0.0,0.0,1.0,43,1350,900,450,0.6666666666666666,18,9,9,374.9703290320953,0.4357235142118863,0.33563164660511857,0.23764043145664623,134280.73459201376,1470.2582465277587,135750.9928385415,2625,8,451.5581395348837,35,8,18,31.169388609715234,0.6651785714285714,40.88541666666666,1036.4583333333321,29.6130952380952,0
4345,4,0,1,42,0.0,0.023255813953488372,0.9767441860465116,43,950,800,150,0.8421052631578947,11,8,3,374.17889030612247,0.43535437430786267,0.33394933554817263,0.23811383928571417,134430.72702331952,1460.2280521261875,135890.9550754457,2626,9,452.5581395348837,35,8,18,31.03980654761904,0.6666666666666667,40.74074074074073,1037.0370370370363,29.62962962962961,0
4346,4,0,0,42,0.0,0.0,1.0,42,1300,800,500,0.6153846153846154,18,8,10,356.55443239281954,0.43283004258614016,0.24217627584483714,0.21629707874864165,132658.9004545087,1194.7867364987796,133853.68719100748,2627,10,464.0952380952381,36,6,16,33.27207221979303,0.6469907407407407,42.454954954954964,1030.1801801801814,28.61611611611615,8
4347,4,0,0,42,0.0,0.0,1.0,42,1200,900,300,0.75,15,9,6,359.71437954447345,0.432624370886566,0.24028763881303505,0.21939941004194916,132861.99787202754,1158.4742259151167,134020.47209794266,2628,11,465.0952380952381,36,6,16,32.986528308756604,0.6490162037037037,42.25788288288289,1030.9684684684694,28.638013013013037,0
4348,4,0,0,42,0.0,0.0,1.0,42,950,400,550,0.42105263157894735,15,4,11,361.7824971582996,0.4319710607820364,0.24124332558659423,0.22134708693873537,132978.12328798402,1221.8315021102262,134199.95479009426,2629,12,466.0952380952381,36,6,17,32.81653746770026,0.6501736111111112,42.145270270270274,1031.4189189189196,28.650525525525545,0
4349,4,0,0,42,0.0,0.0,1.0,42,1150,800,350,0.6956521739130435,15,8,7,357.3859583813264,0.4312693573364305,0.23762767162287113,0.2198523284914925,133181.46482631282,1119.437089116146,134300.90191542896,2630,13,467.0952380952381,36,6,18,32.72578914830169,0.6521990740740741,41.9481981981982,1032.2072072072074,28.67242242242243,0
4350,4,0,0,42,0.0,0.0,1.0,42,900,700,200,0.7777777777777778,11,7,4,356.3504004914018,0.43112417731320174,0.23411875931784332,0.21938644199494156,133210.5262991031,1093.9248792711594,134304.45117837426,2631,14,468.0952380952381,36,6,18,32.72335551434494,0.6524884259259259,41.92004504504504,1032.3198198198195,28.67555055055054,0
4351,4,0,0,42,0.0,0.0,1.0,42,1600,1200,400,0.75,20,12,8,351.99597215782035,0.4304950638792102,0.22506090103203258,0.21790447106905267,133415.57618690358,992.3490881809703,134407.92527508456,2632,15,469.0952380952381,37,5,18,32.63019174980541,0.6525900900900901,41.72149122807017,1033.1140350877188,27.922000948316725,0
4352,4,0,0,42,0.0,0.0,1.0,42,1150,700,450,0.6086956521739131,16,7,9,351.1192344669171,0.4296118854045683,0.21693233933369704,0.21836095927137827,133585.55036164974,980.8912357648535,134566.4415974146,2633,16,470.0952380952381,37,5,20,32.482587328524964,0.6542792792792793,41.55701754385965,1033.7719298245615,27.93978188715031,0
4353,4,0,0,42,0.0,0.0,1.0,42,1650,800,850,0.48484848484848486,25,8,17,351.4474698662412,0.4287891986062718,0.2189376280285371,0.22024974904366423,133869.08111149582,1009.58996999076,134878.67108148657,2634,17,471.0952380952381,37,5,16,32.19034753125662,0.6570945945945945,41.2828947368421,1034.8684210526312,27.96941678520625,0
4354,4,0,0,42,0.0,0.0,1.0,42,1200,700,500,0.5833333333333334,17,7,10,354.6797940023682,0.4282084785133566,0.2212058851715668,0.22278988257993074,133954.1989482341,1102.1695377423828,135056.36848597648,2635,18,472.0952380952381,37,5,17,32.02156816015253,0.6579391891891893,41.20065789473684,1035.1973684210527,27.978307254623047,0
4355,4,0,1,41,0.0,0.023809523809523808,0.9761904761904762,42,1750,1300,450,0.7428571428571429,22,13,9,354.45857749105414,0.42755516840882696,0.22534373613967196,0.22385859893953738,134152.91243459526,1110.3301015697134,135263.24253616497,2636,19,473.0952380952381,37,5,17,31.82860570138301,0.6599099099099099,41.00877192982456,1035.9649122807016,27.999051683262206,0
4356,4,0,0,41,0.0,0.0,1.0,41,1000,600,400,0.6,14,6,8,361.12571939483826,0.42685467479674793,0.2379460958902293,0.22764038665348393,134083.84471887443,1484.2249766658765,135568.0696955403,2637,20,484.8292682926829,36,5,19,31.7250190279439,0.6611689814814814,41.07545045045046,1035.6981981981996,28.769394394394435,0
4357,4,0,0,41,0.0,0.0,1.0,41,1050,700,350,0.6666666666666666,14,7,7,360.76592311223214,0.42685467479674793,0.23734287130891696,0.22777527293818997,134142.16739966342,1478.7845700430412,135620.95196970645,2638,21,485.8292682926829,36,5,20,31.67599739102076,0.6617476851851851,41.01914414414416,1035.9234234234252,28.7756506506507,0
4358,4,0,0,41,0.0,0.0,1.0,41,1100,600,500,0.5454545454545454,16,6,10,357.41897632226545,0.42609247967479674,0.23556248258208345,0.22642923352533878,134266.529124346,1397.8810787934833,135664.4102031395,2639,22,486.8292682926829,37,4,20,31.638365777965873,0.6610360360360361,40.89912280701755,1036.4035087719303,28.0109056424846,0
4359,4,0,0,41,0.0,0.0,1.0,41,700,200,500,0.2857142857142857,12,2,10,354.4209390147186,0.42581300813008127,0.23835169823779445,0.22522879027709558,134380.19390581732,1325.4309018159602,135705.62480763328,2640,23,487.8292682926829,37,4,20,31.60250987027637,0.6621621621621622,40.789473684210535,1036.842105263159,28.022759601707,0
4360,4,0,0,41,0.0,0.0,1.0,41,1450,1100,350,0.7586206896551724,18,11,7,353.61732370576885,0.42548272357723577,0.23103561197362676,0.22524351952409902,134465.47405211237,1309.864213027108,135775.3382651395,2641,24,488.8292682926829,37,4,20,31.538195545688417,0.6630067567567568,40.707236842105274,1037.1710526315803,28.031650071123792,0
4361,4,0,0,41,0.0,0.0,1.0,41,1400,1200,200,0.8571428571428571,16,12,4,354.51615257479705,0.42497459349593497,0.22803580976986249,0.22652647918336904,134579.99173159653,1342.1832280395251,135922.17495963606,2642,25,489.8292682926829,36,5,20,31.400586064684163,0.666087962962963,40.59684684684685,1037.6126126126132,28.82257257257259,0
4362,4,0,0,41,0.0,0.0,1.0,41,1250,900,350,0.72,16,9,7,348.8871687974364,0.4240599593495935,0.22432675519813783,0.2240069426401369,134755.32119957803,1202.8804987419944,135958.20169832002,2643,26,490.8292682926829,36,5,20,31.371791395516993,0.6678240740740741,40.42792792792793,1038.2882882882889,28.84134134134136,0
4363,4,0,0,41,0.0,0.0,1.0,41,1400,900,500,0.6428571428571429,19,9,10,348.11850652758125,0.4232215447154472,0.22230803688657552,0.22435882522736778,134892.2805574793,1191.6998499538417,136083.98040743315,2644,27,491.8292682926829,37,4,16,31.255277601857717,0.6672297297297297,40.29605263157895,1038.8157894736848,28.0761024182077,0
4364,4,0,1,40,0.0,0.024390243902439025,0.975609756097561,41,1200,700,500,0.5833333333333334,17,7,10,349.8427139118183,0.42276422764227645,0.22587867153202046,0.22618071230942804,135006.20984341338,1246.1877693136385,136252.397612727,2645,28,492.8292682926829,37,4,17,31.097014138003804,0.6683558558558558,40.18640350877193,1039.2543859649124,28.087956377430068,0
4365,4,0,0,40,0.0,0.0,1.0,40,1200,800,400,0.6666666666666666,16,8,8,357.838152630589,0.42255608974358977,0.2283701777199827,0.23124162972514542,134989.27136596065,1660.8622981089331,136650.13366406958,2646,29,492.675,36,4,18,30.90616421037422,0.6701388888888888,40.20270270270271,1039.18918918919,28.866366366366393,0
4366,4,0,0,40,0.0,0.0,1.0,40,1100,900,200,0.8181818181818182,13,9,4,354.69579923181794,0.4218082264957265,0.2286228744720029,0.23014099186980858,135135.5932579539,1586.40545105917,136721.99870901307,2647,30,493.675,36,4,19,30.842043034044547,0.6715856481481481,40.06193693693694,1039.7522522522524,28.88200700700701,0
4367,4,0,0,40,0.0,0.0,1.0,40,1000,600,400,0.6,14,6,8,352.9890338348054,0.42095352564102567,0.23166883187181986,0.2297786966548344,135252.70783875103,1548.5445327083962,136801.2523714594,2648,31,494.675,36,4,19,30.76982064883982,0.6727430555555556,39.94932432432433,1040.2027027027036,28.894519519519545,0
4368,4,0,0,40,0.0,0.0,1.0,40,800,100,700,0.125,15,1,14,353.1406364198571,0.4205929487179487,0.23229978354978353,0.23043922885024581,135340.57706355012,1558.8515035305688,136899.4285670807,2649,32,495.675,36,4,19,30.678436147186137,0.6736111111111112,39.86486486486487,1040.5405405405413,28.903903903903924,0
4369,4,0,0,40,0.0,0.0,1.0,40,1350,1000,350,0.7407407407407407,17,10,7,350.5615236024872,0.4194310897435898,0.22532655640998644,0.22935083001780923,135433.8729825524,1495.5809720298603,136929.45395458225,2650,33,496.675,37,3,19,30.652739738052603,0.6725788288288288,39.77521929824562,1040.8991228070179,28.132408724513997,0
4370,4,0,0,40,0.0,0.0,1.0,40,950,700,250,0.7368421052631579,12,7,5,350.5615236024872,0.4193509615384616,0.22532655640998644,0.22935083001780923,135433.8729825524,1495.5809720298603,136929.45395458225,2651,34,497.675,37,3,19,30.652739738052603,0.6725788288288288,39.77521929824562,1040.8991228070179,28.132408724513997,0
4371,4,0,0,40,0.0,0.0,1.0,40,800,500,300,0.625,11,5,6,350.1754297179271,0.41917735042735044,0.22457405316637624,0.22913090743732473,135438.99441385423,1485.481613887069,136924.4760277413,2652,35,498.675,38,2,19,30.65769441308291,0.6707785087719298,39.77029914529915,1040.9188034188037,27.392600089968518,0
4372,4,0,0,40,0.0,0.0,1.0,40,1050,600,450,0.5714285714285714,15,6,9,349.22930836905454,0.4186698717948718,0.22440995382247264,0.22886614728019097,135494.6047579262,1463.7374214698066,136958.34217939602,2653,36,499.675,38,2,19,30.627030956045825,0.6713267543859649,39.71688034188035,1041.1324786324797,27.39822312190736,0
4373,4,0,0,40,0.0,0.0,1.0,40,1350,1100,250,0.8148148148148148,16,11,5,346.94805613566905,0.41861645299145295,0.22236356175625738,0.22790091989289132,135578.04167579825,1407.707602819797,136985.74927861805,2654,37,500.675,38,2,19,30.603499863219803,0.6721491228070176,39.63675213675214,1041.4529914529926,27.406657669815594,0
4374,4,0,0,40,0.0,0.0,1.0,40,1400,1200,200,0.8571428571428571,16,12,4,349.1580194924956,0.4170806623931624,0.22905049973698044,0.230628698768323,135776.49042253377,1481.5015121889635,137257.99193472273,2655,38,501.675,37,3,19,30.348829563387675,0.6759572072072072,39.446271929824555,1042.214912280701,28.167970602181107,0
4375,4,0,0,40,0.0,0.0,1.0,40,600,400,200,0.6666666666666666,8,4,4,348.53758916674735,0.4166800213675214,0.22767171557799504,0.2305878121230526,135833.63540945284,1468.62556267312,137302.26097212595,2656,39,502.675,37,3,19,30.308259703376457,0.6765202702702703,39.39144736842105,1042.4342105263152,28.1738975817923,0
4376,4,0,0,40,0.0,0.0,1.0,40,950,500,450,0.5263157894736842,14,5,9,346.74486206892743,0.4162660256410256,0.22470557308096728,0.22995422861056483,135919.37543282547,1425.8690173899613,137345.24445021542,2657,40,503.675,37,3,18,30.269891342446556,0.6773648648648649,39.30921052631579,1042.7631578947367,28.182788051209098,0
4377,4,0,0,40,0.0,0.0,1.0,40,1050,800,250,0.7619047619047619,13,8,5,345.5984278246522,0.4161725427350427,0.22132005046787917,0.22937799351292865,135947.96145208142,1396.6803487611555,137344.64180084257,2658,41,504.675,37,3,18,30.27141818245541,0.6776463963963963,39.281798245614034,1042.872807017544,28.1857515410147,0
4378,4,0,0,40,0.0,0.0,1.0,40,950,800,150,0.8421052631578947,11,8,3,343.28112518083293,0.4159588675213675,0.2161489540628614,0.22820638321769843,136005.1425077909,1337.5996700907995,137342.7421778817,2659,42,505.675,37,3,18,30.27512789516102,0.6782094594594594,39.22697368421053,1043.0921052631581,28.191678520625896,0
4379,4,0,0,40,0.0,0.0,1.0,40,1000,700,300,0.7,13,7,6,339.9743028197035,0.41582532051282056,0.21557277982133471,0.22637197280122315,136062.3355864304,1251.539536203439,137313.87512263382,2660,43,506.675,37,3,18,30.304672447013488,0.6787725225225225,39.172149122807014,1043.3114035087715,28.197605500237067,0
4380,4,0,0,40,0.0,0.0,1.0,40,950,400,550,0.42105263157894735,15,4,11,339.69440717463476,0.4147702991452991,0.2104411764705889,0.22709906996506454,136205.37088334846,1253.6405432440474,137459.0114265925,2661,44,507.675,37,3,18,30.170255602240886,0.6801801801801801,39.03508771929823,1043.859649122805,28.212422949264997,0
4381,4,0,0,40,0.0,0.0,1.0,40,950,500,450,0.5263157894736842,14,5,9,337.2289758368522,0.4148771367521367,0.20966708674648227,0.22581535217429705,136262.60604224366,1190.339816097251,137452.9458583409,2662,45,508.675,37,3,18,30.17792130504797,0.6807432432432432,38.98026315789473,1044.0789473684201,28.21834992887622,0
4382,4,0,0,40,0.0,0.0,1.0,40,1050,800,250,0.7619047619047619,13,8,5,338.5661986384744,0.41370192307692305,0.21629750157463778,0.22744581158181273,136377.11242882413,1234.5361072637581,137611.6485360879,2663,46,509.675,37,3,18,30.029655679193784,0.6818693693693694,38.87061403508771,1044.5175438596482,28.2302038880986,0
4383,4,0,0,40,0.0,0.0,1.0,40,1250,900,350,0.72,16,9,7,337.4978331397567,0.4125534188034188,0.21256688700031479,0.22764981228981018,136520.31304103168,1215.061966181882,137735.37500721356,2664,47,510.675,37,3,18,29.915866645682506,0.683277027027027,38.73355263157894,1045.065789473683,28.24502133712657,0
4384,4,0,0,40,0.0,0.0,1.0,40,600,300,300,0.5,9,3,6,336.4958003511023,0.41240651709401704,0.2101867394041126,0.22715849638432756,136548.96218067082,1189.6304632194344,137738.59264389024,2665,48,511.675,37,3,18,29.91371170793118,0.6835585585585586,38.706140350877185,1045.17543859649,28.247984826932164,0
4385,4,1,0,41,0.024390243902439025,0.0,1.0,41,1000,700,300,0.7,13,7,6,333.1551074752561,0.4119410569105691,0.21114477552859645,0.2274509120512252,136944.48011405132,924.7505981079587,137869.23071215927,2666,0,500.1707317073171,38,3,19,29.610254839916987,0.6855811403508771,38.32799145299145,1046.6880341880333,27.544421952316664,0
4386,4,0,0,41,0.0,0.0,1.0,41,1000,900,100,0.9,11,9,2,332.47964876977966,0.4115599593495935,0.2109076793685709,0.22789968652037604,137084.297839506,915.5478395061547,137999.84567901216,2667,1,501.1707317073171,38,3,19,29.489942528735632,0.6869517543859649,38.194444444444436,1047.222222222221,27.558479532163712,0
4387,4,0,0,41,0.0,0.0,1.0,41,1200,900,300,0.75,15,9,6,333.8114817569802,0.4107723577235773,0.2058211282632867,0.22973257555022442,137224.18690417465,961.4018326758455,138185.5887368505,2668,2,502.1707317073171,38,3,19,29.317069440195784,0.6883223684210527,38.060897435897424,1047.7564102564083,27.572537112010746,0
4388,4,0,0,41,0.0,0.0,1.0,41,1100,800,300,0.7272727272727273,14,8,6,330.64065655480624,0.4097815040650406,0.19927100701849665,0.22854172854172847,137375.34722222202,884.37499999998,138259.722222222,2669,3,503.1707317073171,39,2,19,29.251126126126124,0.688034188034188,37.91666666666666,1048.3333333333317,26.880341880341838,0
4389,4,0,1,40,0.0,0.024390243902439025,0.975609756097561,41,1050,800,250,0.7619047619047619,13,8,5,361.27731529656575,0.40940040650406506,0.19315499606608943,0.223991935483871,133472.2222222223,1528.4722222222313,135000.69444444453,2670,4,504.1707317073171,36,5,20,32.333669354838705,0.6550925925925926,41.66666666666667,1033.3333333333342,28.703703703703727,8
4390,4,0,0,40,0.0,0.0,1.0,40,1000,700,300,0.7,13,7,6,361.0653253768691,0.4091212606837607,0.18994568260723477,0.22404115985337508,133502.12358807027,1640.5975383659263,135142.7211264362,2671,5,513.475,35,5,21,32.30916582670699,0.6574404761904762,41.63773148148149,1033.449074074075,29.52711640211643,0
4391,4,0,0,40,0.0,0.0,1.0,40,1200,900,300,0.75,15,9,6,348.8348039308042,0.40853365384615387,0.12769391802556163,0.2003813088908848,130578.9150637124,1118.2990471781213,131697.21411089052,2672,6,514.475,36,4,15,35.56862421037166,0.6261574074074074,44.48198198198198,1022.0720720720724,28.3908908908909,8
4392,4,0,0,40,0.0,0.0,1.0,40,1550,1200,350,0.7741935483870968,19,12,7,350.2829536678189,0.4083600427350427,0.13750963550269812,0.20196314300047358,130722.82745160678,1157.9956223114746,131880.82307391826,2673,7,515.475,36,4,16,35.38592482472562,0.6276041666666667,44.3412162162162,1022.6351351351332,28.406531531531478,0
4393,4,0,0,40,0.0,0.0,1.0,40,1200,1000,200,0.8333333333333334,14,10,4,352.0579032790786,0.4082264957264958,0.1413106903005612,0.20328937924245824,130780.41459956563,1208.4557107783244,131988.87031034395,2674,8,516.475,36,4,17,35.282258064516114,0.6281828703703703,44.2849099099099,1022.8603603603592,28.412787787787757,0
4394,4,1,0,41,0.024390243902439025,0.0,1.0,41,850,600,250,0.7058823529411765,11,6,5,345.5938542433372,0.408765243902439,0.15095738625979727,0.20153169702504695,131159.59357686958,865.5898930439866,132025.18346991355,2675,0,504.8536585365854,37,4,18,35.064315278669795,0.6300675675675675,43.91447368421051,1024.342105263156,27.684921763869085,0
4395,4,0,0,41,0.0,0.0,1.0,41,1000,600,400,0.6,14,6,8,336.01065573572316,0.4079268292682927,0.08971486868814327,0.18686060207461458,129312.88954293645,666.3218490304835,129979.21139196694,2676,1,505.8536585365854,37,4,19,37.1797290498778,0.6114864864864865,45.72368421052632,1017.105263157896,27.489331436699892,8
4396,4,1,0,42,0.023809523809523808,0.0,1.0,42,750,500,250,0.6666666666666666,10,5,5,327.62628678420725,0.41114982578397213,0.09650490482686891,0.18332066275788086,129554.63927469132,89.10108024690606,129643.74035493823,2677,0,494.7857142857143,38,4,16,37.147567075943584,0.6121162280701755,45.48611111111111,1018.0555555555553,26.790935672514614,0
4397,4,0,1,41,0.0,0.023809523809523808,0.9761904761904762,42,1300,1100,200,0.8461538461538461,15,11,4,328.02825404741174,0.40956494386372433,0.10154369988716816,0.18469501104511307,129799.4797373805,115.57934290307244,129915.05908028358,2678,1,495.7857142857143,38,4,17,36.88906654085412,0.6145833333333333,45.2457264957265,1019.017094017095,26.816239316239344,0
4398,4,1,0,42,0.023809523809523808,0.0,1.0,42,950,700,250,0.7368421052631579,12,7,5,321.72697050037135,0.41140389082462253,0.08867564992513932,0.1828095941427868,130156.2717013891,-25.043402777757024,130131.22829861134,2679,0,482.42857142857144,39,3,19,36.68844426296446,0.6164529914529915,44.89583333333334,1020.4166666666683,26.164529914529957,0
4399,4,1,0,43,0.023255813953488372,0.0,1.0,43,1200,700,500,0.5833333333333334,17,7,10,313.7091929560084,0.413390550018457,0.09447125059562089,0.17981939714821632,130496.11363110608,-412.4339017780124,130083.67972932807,2680,0,472.1860465116279,40,3,11,36.54971487301905,0.6182291666666666,44.563008130081315,1021.7479674796768,25.543699186991923,0
4400,4,0,0,43,0.0,0.0,1.0,43,900,300,600,0.3333333333333333,15,3,12,313.1267955858009,0.41359819121447033,0.09014229099131965,0.17996738914297078,130599.97046235722,-421.12994910435447,130178.84051325286,2681,1,473.1860465116279,40,3,13,36.459783257108775,0.6192708333333333,44.461382113821145,1022.1544715447167,25.553861788617915,0
4401,4,0,0,43,0.0,0.0,1.0,43,1000,800,200,0.8,12,8,4,312.43733867479534,0.41394425987449246,0.08462333255513443,0.17993314621677836,130677.89019639444,-434.26955268027166,130243.62064371417,2682,2,474.1860465116279,40,3,13,36.398800649372184,0.6200520833333334,44.38516260162602,1022.4593495934967,25.561483739837417,0
4402,4,0,1,42,0.0,0.023255813953488372,0.9767441860465116,43,1200,1000,200,0.8333333333333334,14,10,4,310.2393268603653,0.4132982650424511,0.08319971906348345,0.1792691770480159,130807.80805902567,-483.6547359376035,130324.15332308807,2683,3,475.1860465116279,40,3,14,36.324011523942,0.6213541666666667,44.25813008130081,1022.9674796747964,25.57418699186991,0
4403,4,0,1,41,0.0,0.023809523809523808,0.9761904761904762,42,1200,800,400,0.6666666666666666,16,8,8,320.05560894571664,0.41044812233836625,0.08381592604448573,0.18462432248114283,130741.54188368078,-31.08723958330731,130710.45464409747,2684,4,487.4047619047619,39,3,14,36.13982820669518,0.6223290598290598,44.32291666666668,1022.7083333333352,26.223290598290646,0
4404,4,0,0,41,0.0,0.0,1.0,41,800,400,400,0.5,12,4,8,320.3786974903269,0.4094512195121951,0.09736224595088339,0.18486951603827,130753.83434007234,178.1486275476717,130931.98296762002,2685,5,499.8536585365854,38,3,14,36.11916327170167,0.6241776315789473,44.31089743589744,1022.7564102564104,26.914642375168693,0
4405,4,0,1,40,0.0,0.024390243902439025,0.975609756097561,41,1000,600,400,0.6,14,6,8,317.77864461887816,0.4087144308943089,0.10060593716584365,0.18428083628625022,130945.12473518883,122.3128515596508,131067.43758674848,2686,6,500.8536585365854,38,3,16,35.9927366040362,0.6260964912280702,44.123931623931625,1023.5042735042736,26.934322986954566,0
4406,4,1,1,40,0.024390243902439025,0.024390243902439025,0.975609756097561,41,1050,700,350,0.6666666666666666,14,7,7,316.41420912104235,0.4083841463414634,0.10324957322797346,0.18440504698136387,131136.5549551649,98.6938645993313,131235.24881976424,2687,0,501.609756097561,38,3,17,35.83476756719167,0.628015350877193,43.93696581196582,1024.252136752138,26.954003598740474,0
4407,4,1,0,41,0.024390243902439025,0.0,1.0,41,1350,1000,350,0.7407407407407407,17,10,7,308.1518233684819,0.40947662601626017,0.10518834399431398,0.1816270082798432,131568.46923828137,-91.38726128470711,131477.08197699665,2688,0,492.1707317073171,39,2,14,35.61201221782245,0.6306089743589743,43.51562500000001,1025.937500000001,26.306089743589766,0
4408,4,1,0,42,0.023809523809523808,0.0,1.0,42,1150,900,250,0.782608695652174,14,9,5,301.9658496999377,0.4125290360046458,0.1096878181201224,0.1790529897516533,131797.2932778109,-440.34366944278383,131356.94960836813,2689,0,481.42857142857144,40,2,15,35.54099861441013,0.63125,43.29268292682927,1026.8292682926835,25.67073170731709,0
4409,4,1,1,42,0.023255813953488372,0.023255813953488372,0.9767441860465116,43,1300,900,400,0.6923076923076923,17,9,8,298.447680898491,0.41812015503875966,0.12131244616709735,0.1790686085390947,132244.89795918376,-706.3633786847977,131538.53458049896,2690,0,471.2093023255814,41,2,17,35.18277391975307,0.6341463414634146,42.85714285714286,1028.5714285714294,25.0871080139373,0
4410,4,0,0,42,0.0,0.0,1.0,42,650,400,250,0.6153846153846154,9,4,5,303.01076886442263,0.41586817653890823,0.12179641056778556,0.1812868094974196,132136.6572993094,-392.2339753123015,131744.4233239971,2691,1,483.35714285714283,40,2,17,35.17388224440712,0.6346354166666667,42.962398373983746,1028.150406504066,25.70376016260165,0
4411,4,0,0,42,0.0,0.0,1.0,42,950,600,350,0.631578947368421,13,6,7,303.3509889299255,0.41533584978706933,0.12082174504350629,0.18174118750633014,132188.90587819752,-380.0729352567863,131808.83294294073,2692,2,484.35714285714283,40,2,17,35.11278288368416,0.63515625,42.91158536585366,1028.3536585365855,25.708841463414636,0
4412,4,0,0,42,0.0,0.0,1.0,42,1200,800,400,0.6666666666666666,16,8,8,304.50119189148006,0.415287456445993,0.11924985302763091,0.18318921972081015,132345.71358194522,-340.1144945138498,132005.5990874314,2693,3,485.35714285714283,40,2,17,34.92613168724281,0.63671875,42.75914634146341,1028.963414634146,25.724085365853647,0
4413,4,0,0,42,0.0,0.0,1.0,42,1300,900,400,0.6923076923076923,17,9,8,303.5733889182592,0.4148882113821138,0.11845996173175588,0.18313846672740014,132450.30369034642,-358.3224890937803,132091.98120125264,2694,4,486.35714285714283,40,2,18,34.84528745845263,0.6377604166666666,42.65752032520326,1029.3699186991876,25.73424796747969,0
4414,4,0,0,42,0.0,0.0,1.0,42,1150,800,350,0.6956521739130435,15,8,7,305.0262662662696,0.41471883468834686,0.11999238546469781,0.18427078733116156,132502.61423631775,-316.6444617952226,132185.96977452253,2695,5,487.35714285714283,40,2,18,34.755535814167736,0.63828125,42.60670731707317,1029.573170731708,25.7393292682927,0
4415,4,0,0,42,0.0,0.0,1.0,42,1800,1500,300,0.8333333333333334,21,15,6,304.6012550033562,0.4142832946186605,0.12266003372839696,0.1847841365630775,132659.60784131486,-318.3433926564749,132341.2644486584,2696,6,488.35714285714283,40,2,17,34.60939298280227,0.63984375,42.45426829268293,1030.1829268292695,25.75457317073174,0
4416,4,0,0,42,0.0,0.0,1.0,42,1350,1100,250,0.8148148148148148,16,11,5,304.59088143052185,0.414017131242741,0.126297772831645,0.18529430885344492,132764.32188388222,-312.2396349725414,132452.0822489097,2697,7,489.35714285714283,40,2,17,34.50493869769582,0.6408854166666667,42.35264227642278,1030.5894308943111,25.764735772357778,0
4417,4,0,0,42,0.0,0.0,1.0,42,1000,600,400,0.6,14,6,8,304.9114337602457,0.41359368950832365,0.11952624960114111,0.18640007408427578,132947.67086390397,-292.5470123603424,132655.12385154364,2698,8,490.35714285714283,40,2,17,34.31341150965709,0.6427083333333333,42.17479674796749,1031.3008130081319,25.782520325203297,0
4418,4,0,0,42,0.0,0.0,1.0,42,1350,1100,250,0.8148148148148148,16,11,5,304.7429445024144,0.4130371660859466,0.11836265540699031,0.1865585577020211,133000.07952442343,-293.83282933437374,132706.24669508907,2699,9,491.35714285714283,40,2,17,34.26539408866994,0.6432291666666667,42.123983739837406,1031.5040650406515,25.78760162601629,0
4419,4,0,0,42,0.0,0.0,1.0,42,550,400,150,0.7272727272727273,7,4,3,325.455099755544,0.41314605110336816,0.11709617365501446,0.1895917049327387,131119.8742894444,263.12473147600247,131382.9990209204,2700,10,492.35714285714283,40,2,19,35.62008004233643,0.6244791666666667,43.95325203252034,1024.186991869921,25.604674796748025,8
4420,4,0,0,42,0.0,0.0,1.0,42,1300,1000,300,0.7692307692307693,16,10,6,326.38749872548743,0.41333962446767325,0.11836275871189561,0.19065114496815572,131223.97898902785,165.97325500695544,131389.9522440348,2701,11,493.35714285714283,40,2,20,35.4912633075448,0.6255208333333333,43.85162601626017,1024.5934959349606,25.614837398374014,0
4421,4,0,1,41,0.0,0.023809523809523808,0.9761904761904762,42,1200,800,400,0.6666666666666666,16,8,8,329.0650197171339,0.41272260936895083,0.12724933305002728,0.19260712268411495,131302.08462431445,241.3846131601823,131543.46923747464,2702,12,494.35714285714283,40,2,20,35.34395141298959,0.6263020833333333,43.77540650406505,1024.8983739837417,25.622459349593544,0
4422,4,0,0,41,0.0,0.0,1.0,41,1300,1000,300,0.7692307692307693,16,10,6,332.08740501022066,0.41229674796747967,0.11639308015462113,0.1949261667206782,131410.26925131495,527.9416434345128,131938.21089474947,2703,13,501.1463414634146,38,3,21,35.15747108471396,0.6307565789473684,43.669871794871796,1025.3205128205132,26.982118758434556,0
4423,4,0,0,41,0.0,0.0,1.0,41,1100,900,200,0.8181818181818182,13,9,4,330.90100227707546,0.41183943089430897,0.10839318058840419,0.1947872791454446,131519.83486969466,504.00903553948444,132023.84390523416,2704,14,502.1463414634146,38,3,21,35.077509287227016,0.6318530701754386,43.56303418803419,1025.7478632478633,26.99336482231219,0
4424,4,0,0,41,0.0,0.0,1.0,41,900,400,500,0.4444444444444444,14,4,10,331.45079141276887,0.4112042682926829,0.10825551103730913,0.1958128107202371,131656.85609796178,527.5538297172831,132184.40992767905,2705,15,503.1463414634146,38,3,16,34.92543722673329,0.6332236842105263,43.429487179487175,1026.2820512820506,27.007422402159225,0
4425,4,1,0,42,0.023809523809523808,0.0,1.0,42,1500,1100,400,0.7333333333333333,19,11,8,321.9051314504978,0.4132186411149826,0.10602113185699857,0.19255779681311597,132130.126953125,106.67317708333391,132236.80013020834,2706,0,492.14285714285717,39,3,19,34.69478216818643,0.6362179487179487,42.96875,1028.125,26.362179487179485,0
4426,4,0,1,41,0.0,0.023809523809523808,0.9761904761904762,42,1250,800,450,0.64,17,8,9,323.02246268427876,0.41308555942702285,0.10770392536028339,0.19379432986529854,132241.1647849329,143.37334341331018,132384.5381283462,2707,1,493.14285714285717,40,2,19,34.554597701149426,0.6356770833333334,42.860772357723576,1028.5569105691056,25.71392276422764,0
4427,4,0,0,41,0.0,0.0,1.0,41,1500,1100,400,0.7333333333333333,19,11,8,298.1536401758612,0.4134908536585366,0.059198082845627775,0.17610369682329685,131648.63281250026,-343.9926269498682,131304.6401855504,2708,2,503.9756097560976,39,2,12,35.78799566923807,0.6314102564102564,43.437500000000014,1026.250000000002,26.314102564102615,8
4428,4,0,0,41,0.0,0.0,1.0,41,950,700,250,0.7368421052631579,12,7,5,300.6874388297223,0.4121443089430894,0.06216458284547244,0.17817273868015748,131771.20642681277,-275.6106856038037,131495.59574120896,2709,3,504.9756097560976,40,1,12,35.59998680259989,0.6309895833333333,43.31808943089431,1026.727642276423,25.668191056910576,0
4429,4,0,2,39,0.0,0.04878048780487805,0.9512195121951219,41,1200,800,400,0.6666666666666666,16,8,8,315.97301382803994,0.41232215447154474,0.011925891949025935,0.1780806432772777,129837.58680555545,6.521932216263195,129844.1087377717,2710,4,505.9756097560976,39,2,15,37.15760425183975,0.6132478632478633,45.20833333333333,1019.1666666666657,26.13247863247861,8
4430,4,1,1,39,0.025,0.025,0.975,40,950,300,650,0.3157894736842105,16,3,13,320.10737404347384,0.4076121794871795,0.04341994970662166,0.18098961954211557,129962.83512309141,320.4123748995386,130283.24749799095,2711,0,518.575,38,2,17,36.9254680078234,0.6162280701754386,45.08547008547008,1019.6581196581187,26.833108412055754,0
4431,4,1,0,40,0.025,0.0,1.0,40,1150,1000,150,0.8695652173913043,13,10,3,320.60750611031267,0.4103766025641025,0.05658308030572745,0.1821607549589289,130153.5462437905,345.64077452697535,130499.18701831748,2712,0,518.65,38,2,18,36.719758838516036,0.6181469298245614,44.898504273504265,1020.4059829059818,26.852789023841627,0
4432,4,1,0,41,0.024390243902439025,0.0,1.0,41,1000,700,300,0.7,13,7,6,313.2233068533272,0.41420223577235776,0.06730545253730247,0.1796263382502249,130514.55886667038,-23.868341661785138,130490.6905250086,2713,0,506.9756097560976,37,4,16,36.543508781342766,0.6235923423423424,44.54495614035087,1021.8201754385955,27.616761498340416,0
4433,4,0,0,41,0.0,0.0,1.0,41,950,700,250,0.7368421052631579,12,7,5,312.4591339135366,0.414405487804878,0.06187304095739954,0.1795773148176318,130598.60365689444,-38.65468220990607,130559.94897468454,2714,1,507.9756097560976,37,4,18,36.47822355717657,0.6244369369369369,44.46271929824562,1022.1491228070176,27.625651967757232,0
4434,4,0,0,41,0.0,0.0,1.0,41,1050,700,350,0.6666666666666666,14,7,7,311.3665040170009,0.413719512195122,0.06235808884052707,0.17941534075537108,130699.2056235846,-60.92905343706917,130638.27657014753,2715,2,508.9756097560976,38,3,19,36.40467732386028,0.6236293859649122,44.36431623931624,1022.5427350427348,26.90901934322986,0
4435,4,0,0,41,0.0,0.0,1.0,41,1150,900,250,0.782608695652174,14,9,5,313.7325120750157,0.41265243902439025,0.061875886588039775,0.1815478107638926,130863.1260158703,11.203452589655939,130874.32946845995,2716,3,509.9756097560976,38,3,19,36.17890954021788,0.6252741228070176,44.20405982905982,1023.1837606837597,26.925888439046307,0
4436,4,0,1,40,0.0,0.024390243902439025,0.975609756097561,41,850,500,350,0.5882352941176471,12,5,7,312.92286562745664,0.4127286585365854,0.06406989443028777,0.1815938204467997,130972.46334876539,-3.144290123459797,130969.31905864194,2717,4,510.9756097560976,38,3,20,36.08943916779738,0.6263706140350878,44.09722222222222,1023.6111111111109,26.93713450292397,0
4437,4,0,0,40,0.0,0.0,1.0,40,1250,1000,250,0.8,15,10,5,350.0863392260638,0.41139155982905984,0.12607162687395856,0.19094654662208993,128543.9128951587,1000.7758321384471,129544.68872729715,2718,5,524.6,36,4,14,37.60549694614103,0.6056134259259259,46.48085585585586,1014.0765765765768,28.1687937937938,8
4438,4,2,0,42,0.047619047619047616,0.0,1.0,42,1250,800,450,0.64,17,8,9,336.1516787965941,0.4151422764227642,0.12985101525892118,0.18589969585541885,129092.79348381919,278.9518500255763,129371.74533384477,2719,0,500.57142857142856,38,4,17,37.399907134847204,0.6074561403508771,45.940170940170944,1016.2393162393168,26.743139901034652,0
4439,4,0,0,42,0.0,0.0,1.0,42,1600,1200,400,0.75,20,12,8,333.47070187573894,0.41457365466511803,0.12155334421886121,0.18518606522129347,129257.13320444745,220.7390435235264,129477.87224797098,2720,1,501.57142857142856,37,5,18,37.30096686075768,0.6109234234234234,45.77850877192982,1016.8859649122801,27.48340445708865,0
4440,4,0,0,42,0.0,0.0,1.0,42,1300,1200,100,0.9230769230769231,14,12,2,331.2499999999997,0.41356949283778555,0.12789408866995045,0.18473557692307707,129424.43828870443,174.3690366266764,129598.80732533112,2721,2,502.57142857142856,37,5,19,37.18749999999999,0.6126126126126126,45.61403508771931,1017.5438596491246,27.501185395922285,0
4441,4,0,2,40,0.0,0.047619047619047616,0.9523809523809523,42,950,500,450,0.5263157894736842,14,5,9,354.93882210252207,0.413472706155633,0.06280862860608183,0.18347777982666433,126375.7157198097,571.1295359904908,126946.84525580019,2722,3,503.57142857142856,40,2,16,39.70588235294118,0.5765625,48.62804878048781,1005.4878048780492,25.13719512195123,8
4442,4,3,0,43,0.06976744186046512,0.0,1.0,43,1100,700,400,0.6363636363636364,15,7,8,350.29953554204656,0.41816629752676265,0.14260876247562515,0.18476583345256964,127197.07031249999,315.4634466504724,127512.53375915046,2723,0,492.6511627906977,39,4,19,38.97838358804901,0.5865384615384616,47.8125,1008.7499999999999,25.865384615384613,0
4443,4,0,0,43,0.0,0.0,1.0,43,750,500,250,0.6666666666666666,10,5,5,349.22878389207216,0.41788944259874494,0.20262418253898673,0.17440672369000476,124950.40174634646,130.77099474046565,125081.17274108692,2724,1,493.6511627906977,41,2,14,41.320615862935774,0.5604674796747968,50.04960317460316,999.8015873015854,24.385404568331353,8
4444,4,3,0,46,0.06521739130434782,0.0,1.0,46,1400,1100,300,0.7857142857142857,17,11,6,338.5003789396416,0.4248892914653784,0.23299136179904356,0.17267267765361108,125829.97163574668,-681.2915419673561,125148.68009377933,2725,0,462.39130434782606,43,3,15,40.680843951549484,0.5666182170542635,49.171401515151516,1003.314393939394,23.332892882311487,0
4445,4,1,0,47,0.02127659574468085,0.0,1.0,47,1000,500,500,0.5,15,5,10,331.65660056015605,0.4275362318840579,0.24353872455356518,0.17046524432360627,126141.15855605138,-1032.527248115244,125108.63130793613,2726,0,453.531914893617,42,5,16,40.532257805215266,0.5711805555555556,48.861434108527135,1004.5542635658919,23.91795865633076,0
4446,4,2,0,49,0.04081632653061224,0.0,1.0,49,1200,800,400,0.6666666666666666,16,8,8,320.1921432761693,0.4328762755102041,0.2604019205522967,0.16685118014602068,126704.1384835775,-1686.0660673965544,125018.07241618093,2727,0,435.9795918367347,45,4,15,40.24244639376219,0.5729166666666667,48.30163043478261,1006.7934782608695,22.3731884057971,0
4447,4,2,2,49,0.0392156862745098,0.0392156862745098,0.9607843137254902,51,1700,1400,300,0.8235294117647058,20,14,6,315.09265806626667,0.4386274509803922,0.2805977882482469,0.16662760214770714,127302.17013888899,-2175.825801433518,125126.34433745548,2728,0,419.84313725490193,44,7,17,39.75880814753646,0.5802556818181819,47.708333333333336,1009.1666666666675,22.93560606060608,0
4448,4,0,2,47,0.0,0.04081632653061224,0.9591836734693877,49,900,500,400,0.5555555555555556,13,5,8,325.22726856477107,0.43439980158730157,0.27826318844217157,0.1713039175719704,127140.87194279181,-1530.0642990205033,125610.8076437713,2729,1,437.85714285714283,42,7,19,39.66820394568279,0.5813492063492063,47.86821705426356,1008.527131782945,24.012550756736786,0
4449,4,0,0,47,0.0,0.0,1.0,47,1600,1000,600,0.625,22,10,12,331.4086345326865,0.4332215541165587,0.2704381066361472,0.17488813723730598,127217.08598080417,-967.8318491748757,126249.25413162929,2730,2,454.4468085106383,41,6,19,39.434289671223,0.5835873983739837,47.79265873015872,1008.8293650793636,24.60559427022838,0
4450,4,0,0,47,0.0,0.0,1.0,47,1600,900,700,0.5625,23,9,14,337.0190312037539,0.43254702436016035,0.2767611544375761,0.17869726646879944,127409.75907585165,-812.0972860705662,126597.66178978108,2731,3,455.4468085106383,42,5,15,39.09544262085292,0.5840773809523809,47.6017441860465,1009.5930232558127,24.037929125138398,0
4451,4,0,0,47,0.0,0.0,1.0,47,1700,1400,300,0.8235294117647058,20,14,6,333.85148339081695,0.43279756398396546,0.27532784659454057,0.17723210944552714,127458.67816124303,-889.5462449672768,126569.13191627576,2732,4,456.4468085106383,42,5,15,39.12532386527205,0.5845734126984127,47.5532945736434,1009.7868217054241,24.04254337393867,0
4452,4,1,2,46,0.020833333333333332,0.041666666666666664,0.9583333333333334,48,1550,1100,450,0.7096774193548387,20,11,9,335.44362198928536,0.4350620567375887,0.28761156882938543,0.17995345687933498,127880.99500868065,-1020.6271701388791,126860.36783854177,2733,0,447.9166666666667,43,5,16,38.65323549605219,0.5874515503875969,47.13541666666667,1011.4583333333342,23.522286821705446,0
4453,4,0,1,45,0.0,0.021739130434782608,0.9782608695652174,46,1050,800,250,0.7619047619047619,13,8,5,341.7524805216538,0.4318639291465378,0.2718959183934675,0.182824122257017,127768.13394628685,-466.98465844671097,127301.14928784013,2734,1,464.30434782608694,41,5,17,38.609128152291234,0.5891768292682926,47.24702380952381,1011.0119047619047,24.65882694541231,0
4454,4,0,1,44,0.0,0.022222222222222223,0.9777777777777777,45,1100,700,400,0.6363636363636364,15,7,8,350.4457955930053,0.4285563973063973,0.27326228299483923,0.18719301197465232,127707.5948922597,-49.08206094257986,127658.51283131712,2735,2,475.46666666666664,40,5,17,38.45138749245928,0.5901041666666667,47.30691056910568,1010.7723577235757,25.269308943089392,0
4455,4,2,0,46,0.043478260869565216,0.0,1.0,46,1750,1400,350,0.8,21,14,7,341.93638839929497,0.432487922705314,0.2814804623004954,0.18502037454482395,128225.67389875083,-428.75667252261417,127796.91722622821,2736,0,462.95652173913044,38,8,19,38.1368670886076,0.5986842105263157,46.794871794871796,1012.8205128205129,26.653171390013497,0
4456,4,1,1,46,0.02127659574468085,0.02127659574468085,0.9787234042553191,47,1200,900,300,0.75,15,9,6,334.3660840578563,0.43511023743447425,0.2757537193007136,0.1826660035567305,128607.98306439626,-799.5704648357384,127808.41259956053,2737,0,454.0851063829787,40,7,17,37.938750292221876,0.59921875,46.41768292682927,1014.3292682926835,25.35823170731709,0
4457,4,2,0,48,0.041666666666666664,0.0,1.0,48,1150,800,350,0.6956521739130435,15,8,7,329.30900812332567,0.43846040189125296,0.2904722725682851,0.18159633520025398,128979.82698042504,-1105.156221831601,127874.67075859345,2738,0,445.5625,42,6,19,37.68859900155808,0.5999503968253967,46.0513565891473,1015.7945736434124,24.185585086747913,0
4458,4,2,1,49,0.04,0.02,0.98,50,1750,1400,350,0.8,21,14,7,296.9495607306402,0.4407568027210884,0.16207842061968747,0.1609175405623544,128285.19483024697,-2359.77844422076,125925.4163860262,2739,0,428.7,44,6,15,39.21545105566219,0.5901988636363636,46.736111111111114,1013.055555555556,23.02398989898991,8
4459,4,3,1,51,0.057692307692307696,0.019230769230769232,0.9807692307692307,52,1450,900,550,0.6206896551724138,20,9,11,307.20602017061094,0.44164781297134237,0.1731100383401163,0.16629852557448935,128242.66049403556,-2313.9228578678085,125928.73763616776,2740,0,413.13461538461536,42,10,17,38.99897158710417,0.5925099206349207,46.778100775193785,1012.8875968992228,24.1163713547434,8
4460,4,0,2,49,0.0,0.0392156862745098,0.9607843137254902,51,1400,900,500,0.6428571428571429,19,9,10,305.19501016727406,0.4395588235294117,0.1905029723907925,0.16581997980984478,128389.92478103747,-2363.207120215164,126026.7176608223,2741,1,422.1764705882353,42,9,12,38.900109953150405,0.5939980158730158,46.63275193798448,1013.4689922480594,24.130214101144272,0
4461,4,0,1,48,0.0,0.02040816326530612,0.9795918367346939,49,1400,900,500,0.6428571428571429,19,9,10,312.92308572758475,0.4365610827664399,0.20267940786963723,0.17015088700791547,128420.90778730469,-1762.8266526518028,126658.0811346529,2742,2,440.0408163265306,41,8,13,38.67277984405077,0.5957825203252032,46.60218253968254,1013.5912698412694,24.721738288811448,0
4462,4,0,2,46,0.0,0.041666666666666664,0.9583333333333334,48,1500,1200,300,0.8,18,12,6,317.3973417972627,0.4326241134751773,0.221830985915493,0.1733477789815818,128596.93877551009,-1436.7346938775602,127160.20408163253,2743,3,450.0208333333333,41,7,13,38.380281690140855,0.5975609756097561,46.42857142857142,1014.2857142857133,24.73867595818813,0
4463,4,0,0,46,0.0,0.0,1.0,46,1550,1100,450,0.7096774193548387,20,11,9,326.0061894254432,0.43016304347826084,0.21643925598875846,0.17701831407119845,128365.37486479164,-830.4186572321505,127534.95620755949,2744,4,470.45652173913044,42,4,16,38.39783738127111,0.59375,46.65697674418604,1013.3720930232547,24.12790697674416,0
4464,4,2,0,48,0.041666666666666664,0.0,1.0,48,1550,900,650,0.5806451612903226,22,9,13,322.2721373334422,0.4334275265957446,0.2281256648734078,0.1773386116475595,128895.62864369003,-1292.10605281207,127603.52259087795,2745,0,451.8125,44,4,16,37.95287377283365,0.5963541666666667,46.13425925925926,1015.4629629629633,23.07870370370371,0
4465,4,1,0,49,0.02040816326530612,0.0,1.0,49,1150,900,250,0.782608695652174,14,9,5,322.2220579062206,0.43470096371882083,0.2450610405006175,0.17880668034238897,129227.86593967026,-1469.8128657085813,127758.05307396168,2746,0,443.57142857142856,39,10,17,37.61664190827443,0.6071047008547008,45.80729166666667,1016.7708333333343,26.071047008547033,0
4466,4,0,0,49,0.0,0.0,1.0,49,1250,900,350,0.72,16,9,7,318.0721552401917,0.43459467120181405,0.23284166464402078,0.17751818109107131,129453.6613835351,-1564.8789840009897,127888.78239953412,2747,1,444.57142857142856,41,8,14,37.49309482030284,0.6061991869918699,45.58531746031747,1017.6587301587318,24.82094463801785,0
4467,4,0,0,49,0.0,0.0,1.0,49,1250,800,450,0.64,17,8,9,312.48622981696775,0.434187216553288,0.23373370388482684,0.17529965220224022,129655.65653344695,-1696.878543083878,127958.77799036307,2748,2,445.57142857142856,41,8,15,37.43059614260667,0.6082317073170731,45.38690476190477,1018.4523809523828,24.840301974448362,0
4468,4,0,0,49,0.0,0.0,1.0,49,1400,1000,400,0.7142857142857143,18,10,8,311.95367206910606,0.4340100623582766,0.2228268804502196,0.17588042810266072,129852.06400833638,-1698.4343613693602,128153.62964696702,2749,3,446.57142857142856,43,6,15,37.24536606893988,0.6073158914728682,45.194128787878796,1019.2234848484864,23.702871740662474,0
4469,4,0,1,48,0.0,0.02040816326530612,0.9795918367346939,49,1250,900,350,0.72,16,9,7,312.2255165550005,0.43370890022675734,0.22686568270606444,0.17650037927636902,129955.57270233204,-1684.9108367626852,128270.66186556935,2750,4,447.57142857142856,44,5,15,37.133732897445206,0.6070075757575757,45.092592592592595,1019.6296296296302,23.17340067340069,0
4470,4,0,0,48,0.0,0.0,1.0,48,1400,900,500,0.6428571428571429,19,9,10,315.9493172779621,0.43217161643026003,0.22744906420279598,0.1785303973534509,129939.1540642722,-1389.1625971434537,128549.99146712874,2751,5,457.7916666666667,45,3,15,37.05542229329546,0.6055555555555556,45.108695652173914,1019.5652173913041,22.65700483091787,0
4471,4,0,1,47,0.0,0.020833333333333332,0.9791666666666666,48,1450,1100,350,0.7586206896551724,18,11,7,315.50665467955844,0.43237477836879434,0.22192688448903497,0.17902022426477898,130100.82018122487,-1390.4650907109994,128710.35509051387,2752,6,458.7916666666667,45,3,17,36.903189647518424,0.607175925925926,44.95018115942028,1020.1992753623174,22.6710950080515,0
4472,4,1,0,48,0.020833333333333332,0.0,1.0,48,1450,900,550,0.6206896551724138,20,9,11,317.1551199227745,0.4332243646572104,0.22282752902156,0.1813088142903232,130392.29811124325,-1328.5804742162427,129063.717637027,2753,0,459.2708333333333,40,8,19,36.56654228855722,0.6171875,44.66463414634146,1021.3414634146336,25.53353658536584,0
4473,4,0,1,47,0.0,0.020833333333333332,0.9791666666666666,48,1300,900,400,0.6923076923076923,17,9,8,305.96105691559563,0.43237477836879434,0.15182842543410136,0.16915343131175953,129081.07284671986,-1701.2437048037336,127379.82914191613,2754,1,460.2708333333333,43,5,17,38.17881604696673,0.5995639534883721,45.95170454545454,1016.1931818181804,23.632399577166986,8
4474,4,0,0,47,0.0,0.0,1.0,47,1100,600,500,0.5454545454545454,16,6,10,309.54470195536703,0.43027289546716,0.1696041096474057,0.1711225771958845,129078.27546609254,-1408.9007383871408,127669.3747277054,2755,2,470.7659574468085,42,5,17,38.090612186516644,0.6009424603174602,45.954457364341074,1016.1821705426337,24.19481358434842,0
4475,4,0,0,47,0.0,0.0,1.0,47,1450,900,550,0.6206896551724138,20,9,11,315.3831959273696,0.4306390687634906,0.17249551458141177,0.17522216205705343,129275.28511094567,-1245.749485457624,128029.53562548805,2756,3,471.7659574468085,42,5,17,37.74237732253454,0.6029265873015873,45.76065891472867,1016.9573643410838,24.213270579549615,0
4476,4,1,2,46,0.020833333333333332,0.041666666666666664,0.9583333333333334,48,1750,1300,450,0.7428571428571429,22,13,9,308.75471593814353,0.43207927009456265,0.19496592317224337,0.17375526901121452,129779.6860651973,-1585.9819788797204,128193.70408631758,2757,0,462.9166666666667,43,5,17,37.40009293680297,0.6065891472868217,45.26515151515151,1018.9393939393929,23.696264975334717,0
4477,4,0,1,45,0.0,0.021739130434782608,0.9782608695652174,46,1200,700,500,0.5833333333333334,17,7,10,316.99762039145304,0.4292673107890499,0.19309292672036027,0.17845540556940645,129793.1502013097,-971.1760486148975,128821.9741526948,2758,1,473.7608695652174,42,4,17,37.17648503867123,0.6081349206349207,45.25193798449611,1018.992248062013,24.26172019195269,0
4478,4,0,1,44,0.0,0.022222222222222223,0.9777777777777777,45,1350,1000,350,0.7407407407407407,17,10,7,313.0130901448834,0.4292087542087542,0.1747658122907625,0.17676922820259328,129916.60399202252,-866.880464665603,129049.72352735691,2759,2,463.24444444444447,42,3,17,37.15307480277542,0.609375,45.130813953488364,1019.4767441860449,24.27325581395345,0
4479,4,0,1,43,0.0,0.022727272727272728,0.9772727272727273,44,1450,1100,350,0.7586206896551724,18,11,7,359.36979188578795,0.42648872445384073,0.2454098127325588,0.18748452036421948,126751.58900454534,413.1736691159132,127164.76267366126,2760,3,474.45454545454544,36,8,14,39.20753187206441,0.5873842592592593,48.25450450450452,1006.9819819819841,27.971721721721778,8
4480,4,1,0,44,0.022727272727272728,0.0,1.0,44,1200,800,400,0.6666666666666666,16,8,8,353.50489383392124,0.4279642353770261,0.2497429153400441,0.1857213710805184,127036.73846760545,181.6217489996985,127218.36021660514,2761,0,474.95454545454544,37,7,15,39.06216010441592,0.5884009009009009,47.97149122807018,1008.1140350877196,27.24632527264107,0
4481,4,2,0,46,0.043478260869565216,0.0,1.0,46,1300,800,500,0.6153846153846154,18,8,10,358.37010420943375,0.4324174718196457,0.24477764652670175,0.18606305200721535,126554.60048788725,-13.710430841874086,126540.89005704537,2762,0,455.2608695652174,40,6,17,39.43541056458944,0.5783854166666667,48.45020325203251,1006.1991869918679,25.1549796747967,8
4482,4,0,0,46,0.0,0.0,1.0,46,1350,1200,150,0.8888888888888888,15,12,3,360.98218992799394,0.4328099838969404,0.24798061389337667,0.18777140803817485,126631.30411791909,-57.6709052151603,126573.63321270393,2763,1,456.2608695652174,40,6,17,39.29073270059235,0.5791666666666666,48.37398373983739,1006.5040650406494,25.162601626016233,0
4483,4,2,1,47,0.041666666666666664,0.020833333333333332,0.9791666666666666,48,1100,800,300,0.7272727272727273,14,8,6,349.3512096471788,0.43762005023640665,0.26047474017482264,0.1845046792062474,127249.61480034734,-706.528961607251,126543.08583874008,2764,0,438.2083333333333,39,9,19,38.94839631082661,0.5870726495726496,47.76041666666667,1008.9583333333343,25.87072649572652,0
4484,4,2,1,48,0.04081632653061224,0.02040816326530612,0.9795918367346939,49,1350,800,550,0.5925925925925926,19,8,11,348.4474357930307,0.4382440476190476,0.28583842052469,0.18663818775819016,127818.28826727433,-892.4090411627794,126925.87922611154,2765,0,429.38775510204084,41,8,17,38.38857958075803,0.5896849593495934,47.197420634920626,1011.2103174603161,24.663666279519905,0
4485,4,1,1,48,0.02040816326530612,0.02040816326530612,0.9795918367346939,49,1750,1100,650,0.6285714285714286,24,11,13,344.7754623847109,0.43842120181405897,0.28032499863216054,0.1856100478941196,128021.92251066644,-972.2364942010672,127049.68601646538,2766,0,430.3469387755102,42,7,19,38.27317119877441,0.5902777777777778,46.99612403100775,1012.0155038759691,24.095607235142122,0
4486,4,3,1,50,0.058823529411764705,0.0196078431372549,0.9803921568627451,51,1450,900,550,0.6206896551724138,20,9,11,335.30866027821435,0.44153594771241833,0.2989558463972384,0.1832459140216325,128622.09590143943,-1574.2034158518084,127047.89248558762,2767,0,414.3137254901961,41,10,17,37.900468622656874,0.5978150406504066,46.40376984126985,1014.3849206349219,24.741095625241996,0
4487,4,0,0,50,0.0,0.0,1.0,50,1300,800,500,0.6153846153846154,18,8,10,343.8385789615301,0.43973639455782315,0.3003126252505004,0.18771931170875666,128582.21379469898,-1157.6948658206047,127424.51892887837,2768,1,423.6,40,10,18,37.72482464929859,0.5989583333333333,46.44308943089431,1014.2276422764232,25.35569105691058,0
4488,4,1,0,51,0.0196078431372549,0.0,1.0,51,1900,1600,300,0.8421052631578947,22,16,6,345.7196035477213,0.4406862745098039,0.3131547041010405,0.19037824537482645,128924.17332963271,-1285.6771817523395,127638.49614788037,2769,0,416.27450980392155,41,10,19,37.32854270456839,0.6008638211382114,46.10615079365079,1015.5753968253963,24.770131629887715,0
4489,4,0,0,51,0.0,0.0,1.0,51,1600,1300,300,0.8125,19,13,6,344.7474061645377,0.44058823529411767,0.31581969896227613,0.19056922187497866,129075.34490937556,-1300.32192853996,127775.02298083561,2770,1,417.27450980392155,41,10,19,37.19928650460476,0.6023882113821138,45.95734126984126,1016.1706349206331,24.784649632210563,0
4490,4,1,0,52,0.019230769230769232,0.0,1.0,52,1200,800,400,0.6666666666666666,16,8,8,336.8422704928108,0.44267691050779284,0.3189740702536288,0.18792759225838152,129439.78000216973,-1679.6575867760687,127760.12241539366,2771,0,410.2307692307692,39,13,17,37.02965588425974,0.6092414529914529,45.598958333333314,1017.6041666666634,26.092414529914446,0
4491,4,1,0,53,0.018867924528301886,0.0,1.0,53,1550,900,650,0.5806451612903226,22,9,13,332.54132456983154,0.44360788582486693,0.3294833362722627,0.18727327225774712,129807.25623582758,-1966.744614512478,127840.51162131509,2772,0,403.47169811320754,41,12,18,36.766209112149525,0.6097560975609756,45.238095238095234,1019.0476190476184,24.85481997677118,0
4492,4,0,1,52,0.0,0.018867924528301886,0.9811320754716981,53,1300,900,400,0.6923076923076923,17,9,8,329.7428738877939,0.4433811078858249,0.3235146674011846,0.1860575523996199,129883.08930342953,-2034.3953727324467,127848.69393069709,2773,1,404.47169811320754,41,12,18,36.76064476885643,0.6105182926829269,45.16369047619047,1019.3452380952367,24.8620789779326,0
4493,4,0,1,51,0.0,0.019230769230769232,0.9807692307692307,52,1550,1200,350,0.7741935483870968,19,12,7,332.792445748327,0.44351747109100054,0.32596470110174924,0.18810741454608235,129951.543032008,-1750.6216331218222,128200.92139888619,2774,2,411.96153846153845,40,12,19,36.613550284062605,0.6127604166666667,45.09654471544715,1019.6138211382109,25.490345528455272,0
4494,4,0,0,51,0.0,0.0,1.0,51,1550,1300,250,0.8387096774193549,18,13,5,315.48655508273424,0.4439869281045752,0.25337320099069705,0.17215236107903492,128561.839920978,-2033.4128147472281,126528.42710623078,2775,3,417.6862745098039,42,9,13,38.46443244792662,0.595734126984127,46.46317829457363,1014.147286821703,24.14636397194531,8
4495,4,2,0,53,0.03773584905660377,0.0,1.0,53,1700,1200,500,0.7058823529411765,22,12,10,309.72856758935745,0.447160740203193,0.26832663161150583,0.17175856929955297,129201.38888888911,-2594.9409590769587,126606.44792981214,2776,0,402.8867924528302,43,10,18,37.96106557377049,0.6007751937984496,45.83333333333334,1016.6666666666684,23.64341085271322,0
4496,4,0,1,52,0.0,0.018867924528301886,0.9811320754716981,53,1200,700,500,0.5833333333333334,17,7,10,308.8031548377488,0.4468432510885341,0.26362034341414664,0.1715590832800098,129273.60541673865,-2615.9805620121433,126657.6248547265,2777,1,403.8867924528302,43,10,18,37.91137054970977,0.6015019379844961,45.762310606060616,1016.9507575757596,23.65001761804092,0
4497,4,3,2,53,0.05454545454545454,0.03636363636363636,0.9636363636363636,55,1000,800,200,0.8,12,8,4,302.2883414125813,0.44896184062850725,0.28965506096427696,0.17030776811381876,129823.73980157822,-3151.1594038804615,126672.58039769776,2778,0,390.03636363636366,45,10,12,37.52027597546885,0.6043981481481482,45.221920289855085,1019.1123188405821,22.646940418679602,0
4498,4,1,3,51,0.018518518518518517,0.05555555555555555,0.9444444444444444,54,1750,1300,450,0.7428571428571429,22,13,9,344.38388328921974,0.44637345679012347,0.20262235748339852,0.18644617950807457,128247.4482471578,-1745.6211239921422,126501.82712316565,2779,0,398.2037037037037,40,14,16,38.05265710176915,0.5955729166666667,46.77337398373984,1012.9065040650408,25.32266260162602,8
4499,4,1,1,51,0.019230769230769232,0.019230769230769232,0.9807692307692307,52,2250,1400,850,0.6222222222222222,31,14,17,348.9365916464606,0.4432110985419809,0.2107476559711905,0.18932005922053954,128333.90404704506,-1443.9209858280387,126889.98306121702,2780,0,409.15384615384613,38,14,18,37.84905279066497,0.5997807017543859,46.68803418803419,1013.247863247863,26.664417453891133,0
4500,4,2,2,51,0.03773584905660377,0.03773584905660377,0.9622641509433962,53,1950,1600,350,0.8205128205128205,23,16,7,342.0706770431285,0.4447115384615385,0.22040032945194632,0.1877253803465257,128788.44024720739,-1789.0502098618522,126999.39003734554,2781,0,402.1132075471698,40,13,15,37.55944633560273,0.6010416666666667,46.239837398373986,1015.0406504065044,25.376016260162608,0
4501,4,0,0,51,0.0,0.0,1.0,51,1050,600,450,0.5714285714285714,15,6,9,354.00184036155815,0.4429575163398693,0.2171610937839994,0.192681538612902,128461.13281250012,-1104.9045138888762,127356.22829861124,2782,1,418.8627450980392,39,12,15,37.59076585833676,0.5993589743589743,46.56250000000001,1013.7500000000009,25.993589743589766,0
4502,4,2,0,53,0.03773584905660377,0.0,1.0,53,1550,1000,550,0.6451612903225806,21,10,11,336.3465889531573,0.4437590711175617,0.22819943341217885,0.18607561292085956,129107.27023319609,-1915.0420096022003,127192.22822359389,2783,0,404.0188679245283,44,9,17,37.38023111030127,0.5984848484848485,45.925925925925924,1016.2962962962957,23.097643097643086,0
4503,4,0,1,52,0.0,0.018867924528301886,0.9811320754716981,53,1450,1000,450,0.6896551724137931,19,10,9,339.4461856728638,0.4433659893565554,0.23312892920711525,0.1886177069279544,129280.82817925306,-1823.051731020703,127457.77644823235,2784,1,405.0188679245283,39,14,17,37.12496585748916,0.6076388888888888,45.755208333333314,1016.9791666666633,26.076388888888804,0
4504,4,1,1,52,0.018867924528301886,0.018867924528301886,0.9811320754716981,53,1500,1200,300,0.8,18,12,6,338.99174855769525,0.4440009675858732,0.23666591921068725,0.189098851159231,129433.9629705365,-1824.5909139731846,127609.37205656331,2785,0,405.8867924528302,40,13,15,36.98088318519258,0.6075520833333333,45.60467479674796,1017.5813008130064,25.43953252032516,0
4505,4,0,1,51,0.0,0.019230769230769232,0.9807692307692307,52,1400,800,600,0.5714285714285714,20,8,12,349.91945845855764,0.44166352438411266,0.2416100380323951,0.1952234831343029,129439.7800021699,-1341.300455729191,128098.4795464407,2786,3,414.6923076923077,39,13,16,36.696970860204054,0.6092414529914529,45.59895833333332,1017.6041666666647,26.09241452991448,0
4506,4,1,1,51,0.019230769230769232,0.019230769230769232,0.9807692307692307,52,1550,1100,450,0.7096774193548387,20,11,9,346.29824343504384,0.4419620412267471,0.2477379971537721,0.19476905586406879,129756.71315980077,-1413.095631771245,128343.61752802953,2787,0,415.2692307692308,41,11,18,36.467056150600456,0.6092479674796748,45.287698412698404,1018.8492063492048,24.84998064266353,0
4507,4,0,0,51,0.0,0.0,1.0,51,1650,1000,650,0.6060606060606061,23,10,13,351.62915957969466,0.44173202614379087,0.2518875722813718,0.19789496427633044,129781.98346757634,-1072.9740449421001,128709.00942263425,2788,1,423.19607843137254,41,10,18,36.305597475091666,0.6095020325203252,45.2628968253968,1018.9484126984087,24.852400309717286,0
4508,4,0,0,51,0.0,0.0,1.0,51,1200,800,400,0.6666666666666666,16,8,8,352.4525076262494,0.4412581699346405,0.24799448296428905,0.19891632941138054,129891.9085391499,-1043.8542230034673,128848.05431614643,2789,2,424.19607843137254,42,9,18,36.17296419518376,0.6091269841269842,45.1550387596899,1019.379844961237,24.27094868955326,0
4509,4,0,0,51,0.0,0.0,1.0,51,1650,1100,550,0.6666666666666666,22,11,11,358.483278773247,0.44129084967320265,0.2531472299279909,0.20324115152344283,130069.31889921936,-874.4648186409627,129194.8540805784,2790,3,425.19607843137254,43,8,19,35.83905805173908,0.6094961240310077,44.9810606060606,1020.0757575757567,23.722692036645505,0
4510,4,0,1,50,0.0,0.0196078431372549,0.9803921568627451,51,1100,800,300,0.7272727272727273,14,8,6,358.18033208613366,0.44078431372549015,0.25064128453385437,0.20382616785767396,130214.25637769725,-871.9628816575035,129342.29349603975,2791,4,426.19607843137254,43,8,19,35.69965052266963,0.6109496124031008,44.83901515151514,1020.6439393939379,23.735905567300883,0
4511,4,0,2,48,0.0,0.04,0.96,50,1200,600,600,0.5,18,6,12,355.7107550016141,0.43929421768707483,0.2466695297401762,0.20325705350214926,130374.54433094799,-724.8206755129966,129649.723655435,2792,5,434.68,37,13,21,35.6000823133634,0.6221846846846847,44.68201754385965,1021.2719298245614,27.601944049312472,0
4512,4,0,1,47,0.0,0.020833333333333332,0.9791666666666666,48,1700,1400,300,0.8235294117647058,20,14,6,367.7480764452804,0.43816489361702127,0.24479343760625638,0.21000914423797457,130351.21588059407,-12.718219521614117,130338.49766107246,2491,6,395.1041666666667,35,13,21,35.31643148588915,0.6258928571428571,44.70486111111111,1021.1805555555551,29.17658730158729,0
4513,4,0,0,47,0.0,0.0,1.0,47,1450,1100,350,0.7586206896551724,18,11,7,363.82226081394,0.4365556583410422,0.21699191195715306,0.20109777699715808,129072.27143441417,-8.126879668171526,129064.144554746,2492,7,403.1063829787234,40,7,16,36.717838450511714,0.60390625,45.960365853658544,1016.158536585367,25.403963414634173,8
4514,4,0,0,47,0.0,0.0,1.0,47,1350,1000,350,0.7407407407407407,17,10,7,366.72163401464405,0.43618948504471167,0.22868033207059146,0.20323083130462516,129175.56023407035,74.29450475907133,129249.85473882942,2493,8,404.1063829787234,40,7,17,36.53883001766136,0.6049479166666667,45.858739837398375,1016.5650406504067,25.414126016260166,0
4515,4,0,0,47,0.0,0.0,1.0,47,1450,900,550,0.6206896551724138,20,9,11,342.67052667170367,0.43530296022201664,0.1821646829870298,0.18167009293978864,127404.47108848725,-558.4440760699638,126846.02701241728,2494,9,405.1063829787234,36,11,15,38.958217140732486,0.5940393518518519,47.60698198198199,1009.572072072073,28.043668668668694,8
4516,4,1,1,47,0.020833333333333332,0.020833333333333332,0.9791666666666666,48,1800,1200,600,0.6666666666666666,24,12,12,340.7467430881771,0.43643801713947994,0.19191984208719548,0.1827983909053151,127880.99500868074,-884.9934895833078,126996.00151909742,2495,0,397.6458333333333,39,9,18,38.51913834534845,0.593482905982906,47.13541666666668,1011.4583333333348,25.9348290598291,0
4517,4,2,2,47,0.04081632653061224,0.04081632653061224,0.9591836734693877,49,1550,1200,350,0.7741935483870968,19,12,7,340.4845154221851,0.4387755102040816,0.23276267853112786,0.1861197739743035,128631.77237426057,-1040.0321283283797,127591.74024593219,2496,0,390.0612244897959,38,11,14,37.759347024749864,0.602796052631579,46.39423076923078,1014.4230769230786,26.6953441295547,0
4518,4,1,1,47,0.020833333333333332,0.020833333333333332,0.9791666666666666,48,1650,1400,250,0.8484848484848485,19,14,5,336.589122072075,0.43786015070921985,0.23783150915596707,0.1848710888976218,128821.50472094389,-928.0165643947612,127893.48815654914,2497,0,398.0833333333333,38,10,15,37.664877569634456,0.6047149122807017,46.20726495726496,1015.1709401709408,26.715024741340546,0
4519,4,0,1,46,0.0,0.02127659574468085,0.9787234042553191,47,1050,500,550,0.47619047619047616,16,5,11,339.62141858845376,0.43634366327474555,0.24617437762262795,0.18653657337731153,128821.50472094389,-649.8915643947607,128171.61315654914,2498,1,406.8510638297872,38,9,16,37.58792008699922,0.6047149122807017,46.20726495726496,1015.1709401709408,26.715024741340546,0
4520,4,0,0,46,0.0,0.0,1.0,46,1850,1400,450,0.7567567567567568,23,14,9,342.78172347237825,0.43780193236714976,0.24502602475324586,0.18878812649643253,128929.9859832711,-361.03143947696213,128568.95454379413,2499,2,412.30434782608694,38,8,17,37.3972140402553,0.6058114035087719,46.100427350427346,1015.5982905982894,26.726270805218142,0
4521,4,0,0,46,0.0,0.0,1.0,46,1150,800,350,0.6956521739130435,15,8,7,345.85290741438894,0.4371779388083736,0.2439486544184537,0.19113346905393677,129065.65176647305,-272.45381784644945,128793.1979486266,2500,3,413.30434782608694,38,8,17,37.18107104054953,0.6071820175438596,45.96688034188034,1016.1324786324784,26.740328385065222,0
4522,4,0,0,46,0.0,0.0,1.0,46,1100,700,400,0.6363636363636364,15,7,8,345.97322229493625,0.4369061996779388,0.24312454871996425,0.19159425127555407,129147.08547921675,-263.7133373511735,128883.37214186558,2501,4,414.30434782608694,38,8,18,37.095114217644166,0.6080043859649122,45.88675213675213,1016.4529914529903,26.74876293297343,0
4523,4,0,0,46,0.0,0.0,1.0,46,1450,1000,450,0.6896551724137931,19,10,9,345.9564938016327,0.43705716586151366,0.24233281288828268,0.1919841153215163,129229.25954380186,-258.44828005479775,128970.81126374706,2502,5,415.30434782608694,37,9,18,37.01191182285489,0.6106418918918919,45.805921052631575,1016.776315789473,27.48044096728305,0
4524,4,2,1,47,0.041666666666666664,0.020833333333333332,0.9791666666666666,48,1450,1100,350,0.7586206896551724,18,11,7,329.9458038888092,0.4406213061465721,0.2450010808473846,0.1852687278642875,129692.6239031825,-1041.6925895631043,128650.9313136194,2503,0,398.9583333333333,40,8,17,36.94855997871563,0.61015625,45.350609756097555,1018.5975609756086,25.464939024390215,0
4525,4,1,0,48,0.020833333333333332,0.0,1.0,48,1400,800,600,0.5714285714285714,20,8,12,332.22341022183343,0.43957779255319146,0.24829452919865735,0.18728884660566425,129847.94439693629,-972.2946204309674,128875.64977650532,2504,0,399.9375,40,8,18,36.73305746667996,0.61171875,45.198170731707314,1019.2073170731702,25.480182926829254,0
4526,4,0,1,47,0.0,0.020833333333333332,0.9791666666666666,48,650,200,450,0.3076923076923077,11,2,9,333.5814627641308,0.4394392730496454,0.24627857522594376,0.18842844788568477,129925.6395002975,-931.8430249851224,128993.79647531238,2505,1,400.9375,40,8,18,36.61969198564594,0.6125,45.1219512195122,1019.5121951219517,25.48780487804879,0
4527,4,1,2,46,0.020833333333333332,0.041666666666666664,0.9583333333333334,48,1250,800,450,0.64,17,8,9,333.7468578492219,0.4406213061465721,0.2619439342924188,0.19028812994649377,130289.1723632814,-902.8432708524273,129386.32909242896,2506,0,400.1666666666667,39,9,20,36.247257932863995,0.6177884615384616,44.76562500000001,1020.9375000000011,26.177884615384645,0
4528,4,0,1,45,0.0,0.021739130434782608,0.9782608695652174,46,1050,700,350,0.6666666666666666,14,7,7,340.69137859225305,0.440006038647343,0.2637976929902395,0.19411485524442337,130262.58680555565,-324.13194444443536,129938.45486111121,2507,1,415.32608695652175,38,8,20,36.0969387755102,0.6192434210526316,44.79166666666667,1020.8333333333342,26.86403508771932,0
4529,4,0,1,44,0.0,0.022222222222222223,0.9777777777777777,45,1100,700,400,0.6363636363636364,15,7,8,345.3561016243235,0.44042508417508414,0.27102040816326567,0.19677266255339354,130262.58680555547,-2.6041666666714036,130259.9826388888,1373,2,369.84444444444443,37,8,20,35.9778911564626,0.6210585585585586,44.791666666666664,1020.8333333333327,27.590090090090072,0
4530,4,0,0,44,0.0,0.0,1.0,44,1200,800,400,0.6666666666666666,16,8,8,352.4313059371294,0.4396031536293164,0.2782492956475533,0.20110098495481116,130320.07250071004,385.77466824931537,130705.84716895936,1374,3,378.04545454545456,36,8,21,35.73903532958347,0.6235532407407407,44.73536036036035,1021.0585585585575,28.362737737737707,0
4531,4,0,0,44,0.0,0.0,1.0,44,1100,700,400,0.6363636363636364,15,7,8,353.47106252609797,0.43983439041578576,0.28460339417997416,0.2019930098329664,130377.57087746506,416.9397015258241,130794.51057899088,1375,4,379.04545454545456,36,8,21,35.654197449185865,0.6241319444444444,44.67905405405404,1021.2837837837818,28.36899399399394,0
4532,4,0,0,44,0.0,0.0,1.0,44,1150,600,550,0.5217391304347826,17,6,11,353.57702730649714,0.43959214235377025,0.2786983789849129,0.20280391566239875,130521.37230135516,429.8717636555266,130951.24406501069,1376,5,380.04545454545456,36,8,17,35.50574902652267,0.6255787037037037,44.53828828828828,1021.8468468468449,28.38463463463458,0
4533,4,0,0,44,0.0,0.0,1.0,44,1300,1000,300,0.7692307692307693,16,10,6,356.68499015241895,0.4387883192389006,0.2786106270904687,0.2051955855895852,130636.4705076696,519.2136393149633,131155.68414698457,1377,6,381.04545454545456,36,8,18,35.3097231401924,0.6267361111111112,44.42567567567566,1022.2972972972955,28.397147147147095,0
4534,4,0,1,43,0.0,0.022727272727272728,0.9772727272727273,44,1250,800,450,0.64,17,8,9,356.37228103081435,0.43766516913319237,0.2764179836457721,0.20578063754627368,130780.41459956569,521.30293300056,131301.71753256625,1378,7,382.04545454545456,36,8,19,35.17193291496936,0.6281828703703703,44.284909909909906,1022.8603603603597,28.412787787787767,0
4535,4,1,0,44,0.022727272727272728,0.0,1.0,44,1750,1300,450,0.7428571428571429,22,13,9,352.51226060366326,0.43841393587033123,0.26398293641664794,0.20446610954860836,130953.2521330451,432.52538856423143,131385.77752160933,1379,0,381.97727272727275,36,8,21,35.09576594418161,0.6299189814814814,44.11599099099099,1023.5360360360352,28.431556556556533,0
4536,4,0,0,44,0.0,0.0,1.0,44,1350,900,450,0.6666666666666666,18,9,9,356.99614934968713,0.4378853946441155,0.2690135353979648,0.20784398093380652,131097.3705969484,560.251298595905,131657.62189554432,1380,1,382.97727272727275,36,8,21,34.83523935195366,0.6313657407407407,43.97522522522523,1024.0990990991,28.44719719719722,0
4537,4,0,1,43,0.0,0.022727272727272728,0.9772727272727273,44,1850,1600,250,0.8648648648648649,21,16,5,357.89648802139016,0.4383368569415081,0.26478813157645287,0.20902724239495302,131218.63928153983,592.5380323617387,131811.17731390157,1381,2,383.97727272727275,38,6,21,34.68956378171707,0.6288377192982456,43.8568376068376,1024.5726495726487,26.96243814664865,0
4538,4,0,1,42,0.0,0.023255813953488372,0.9767441860465116,43,1100,700,400,0.6363636363636364,15,7,8,336.5891220720753,0.4367847914359542,0.19501402397536882,0.18487108889762183,128821.50472094373,77.30534096719106,128898.81006191092,1382,3,386.16279069767444,38,5,13,37.66487756963446,0.6047149122807017,46.207264957264954,1015.1709401709394,26.71502474134051,8
4539,4,0,0,42,0.0,0.0,1.0,42,950,700,250,0.7368421052631579,12,7,5,344.23435023180133,0.4357578397212543,0.19814867730437813,0.18868332907396868,128740.17373666792,463.35801099420513,129203.53174766213,1383,4,396.0238095238095,38,4,14,37.55373372635715,0.6038925438596492,46.28739316239315,1014.8504273504257,26.706590193432255,0
4540,4,1,0,43,0.023255813953488372,0.0,1.0,43,1000,600,400,0.6,14,6,8,336.05493583827104,0.4383305647840532,0.1915302487709274,0.18561041020195326,129042.58355034715,73.07942708332178,129115.66297743047,1384,0,387.7906976744186,39,4,15,37.45343790581641,0.6052350427350428,45.98958333333333,1016.041666666666,26.052350427350408,0
4541,4,0,0,43,0.0,0.0,1.0,43,950,700,250,0.7368421052631579,12,7,5,333.4303592312109,0.4378691399040236,0.18895408418614235,0.18465456557197224,129148.442925347,12.402343749979764,129160.84526909699,1385,1,388.7906976744186,39,4,15,37.4124649859944,0.6063034188034189,45.88541666666666,1016.4583333333316,26.06303418803414,0
4542,4,1,1,43,0.022727272727272728,0.022727272727272728,0.9772727272727273,44,1600,1200,400,0.75,20,12,8,322.9674709104589,0.43829281183932345,0.18626378613897354,0.1803970563953289,129485.67450137156,-436.06783743142216,129049.60666394014,1386,0,380.9318181818182,40,4,14,37.33607921451156,0.6080729166666667,45.55386178861789,1017.7845528455287,25.444613821138216,0
4543,4,0,0,43,0.0,0.0,1.0,43,1450,1000,450,0.6896551724137931,19,10,9,332.8185203495032,0.4363002953119232,0.19192652600656546,0.18568270275809814,129439.78000217017,15.991210937503638,129455.77121310767,1387,3,390.7906976744186,39,4,14,37.1320205070461,0.6092414529914529,45.598958333333336,1017.604166666667,26.09241452991454,0
4544,4,0,0,43,0.0,0.0,1.0,43,1550,1100,450,0.7096774193548387,20,11,9,331.18951251068086,0.4358388704318937,0.19308796102462544,0.18564843315965696,129625.34722222234,-13.88888888887908,129611.45833333346,1388,4,391.7906976744186,39,4,14,36.98513366066557,0.6111111111111112,45.41666666666667,1018.3333333333343,26.111111111111136,0
4545,4,0,0,43,0.0,0.0,1.0,43,1250,800,450,0.64,17,8,9,327.7167159442228,0.4357004429678848,0.18878081139751202,0.18432416323464312,129757.97661675354,-95.22840711805159,129662.7482096355,1389,5,392.7906976744186,39,4,14,36.939069795181126,0.6124465811965811,45.286458333333336,1018.8541666666672,26.124465811965827,0
4546,4,0,0,43,0.0,0.0,1.0,43,750,400,350,0.5333333333333333,11,4,7,327.4732345061713,0.4357465854558878,0.18740149618821444,0.18443699787990053,129811.04736328125,-98.07128906250034,129712.97607421875,1390,6,393.7906976744186,39,4,14,36.89148267402636,0.6129807692307692,45.234375,1019.0625,26.129807692307693,0
4547,4,0,0,43,0.0,0.0,1.0,43,1100,600,500,0.5454545454545454,16,6,10,326.71549810623566,0.43595422665190103,0.183480483933816,0.18463575608913588,129943.77170138883,-109.07118055556006,129834.70052083327,1391,7,394.7906976744186,39,4,14,36.776324751396274,0.6143162393162394,45.104166666666664,1019.5833333333328,26.14316239316238,0
4548,4,1,0,44,0.022727272727272728,0.0,1.0,44,1050,500,550,0.47619047619047616,16,5,11,321.5230065445946,0.43598044397463004,0.1829476419407703,0.18270585787856658,130158.8642363176,-430.1861284618995,129728.67810785571,1392,0,386.79545454545456,40,4,15,36.691025130299124,0.61484375,44.89329268292683,1020.4268292682921,25.5106707317073,0
4549,4,0,1,43,0.0,0.022727272727272728,0.9772727272727273,44,1450,1000,450,0.6896551724137931,19,10,9,306.63873041635895,0.4360685341789993,0.13563064585369422,0.16452696947892284,127887.41949443116,-956.9114986119458,126930.50799581921,1393,1,387.79545454545456,40,4,14,39.37506279513714,0.5919270833333333,47.1290650406504,1011.4837398373978,25.287093495934947,8
4550,4,0,0,43,0.0,0.0,1.0,43,1350,1100,250,0.8148148148148148,16,11,5,310.3685249833919,0.4349160206718346,0.14104391274458794,0.16639249083731394,127854.65630425356,-663.5877821180505,127191.06852213551,1394,10,397.7906976744186,39,4,15,39.31414580972979,0.593215811965812,47.161458333333336,1011.3541666666674,25.93215811965814,0
4551,4,1,1,43,0.022727272727272728,0.022727272727272728,0.9772727272727273,44,1650,1300,350,0.7878787878787878,20,13,7,303.4530700226213,0.43784134954193094,0.135526734117559,0.16408068669410047,128197.2710503473,-1019.3006727430459,127177.97037760426,1395,0,389.72727272727275,39,5,16,39.14018034697935,0.5966880341880342,46.82291666666667,1012.708333333334,25.966880341880362,0
4552,4,1,0,44,0.022727272727272728,0.0,1.0,44,1200,1100,100,0.9166666666666666,13,11,2,320.83915195631613,0.43740089852008457,0.05359613354206849,0.1760737060296531,128788.44024720741,-168.70515777851648,128619.7350894289,1396,0,359.8181818181818,40,4,18,38.09821786143373,0.6010416666666667,46.239837398373986,1015.0406504065046,25.376016260162615,8
4553,4,2,0,46,0.043478260869565216,0.0,1.0,46,950,500,450,0.5263157894736842,14,5,9,309.3834622248663,0.4423208534621578,0.07150371155885504,0.1717865919720953,129251.82370401862,-1201.66367449496,128050.16002952366,1397,0,345.1304347826087,41,5,20,37.91869918699186,0.6041666666666667,45.78373015873016,1016.8650793650792,24.801587301587297,0
4554,4,1,1,46,0.02127659574468085,0.02127659574468085,0.9787234042553191,47,1400,1000,400,0.7142857142857143,18,10,8,308.97938751850063,0.44335877274128893,0.07897817255387984,0.17285076918367248,129546.41867225533,-1394.5653806862529,128151.85329156907,1398,0,338.7659574468085,42,5,12,37.63048099498699,0.6056547619047619,45.49418604651163,1018.0232558139539,24.238648947951283,0
4555,4,0,1,45,0.0,0.021739130434782608,0.9782608695652174,46,1450,1100,350,0.7586206896551724,18,11,7,312.8689169317054,0.4412037037037037,0.07192982456140329,0.17483851240301185,129504.14540816327,-1096.4356575963732,128407.7097505669,1399,2,347.1304347826087,41,5,13,37.574317738791414,0.6067073170731707,45.535714285714285,1017.8571428571429,24.825783972125436,0
4556,4,2,2,45,0.0425531914893617,0.0425531914893617,0.9574468085106383,47,1300,1000,300,0.7692307692307693,16,10,6,311.3486560638845,0.4412002775208141,0.10067847216322146,0.17549652542764937,129842.52467550023,-1314.7408884682482,128527.78378703198,1400,0,340.6595744680851,42,5,16,37.270433225581534,0.6086309523809523,45.20348837209302,1019.1860465116276,24.266334440753038,0
4557,4,1,1,45,0.021739130434782608,0.021739130434782608,0.9782608695652174,46,1100,700,400,0.6363636363636364,15,7,8,305.1118747220058,0.44085144927536235,0.13243151522804597,0.17310621193033238,130097.22650891614,-1261.158264746244,128836.06824416989,1401,0,347.04347826086956,44,2,19,37.171938343316995,0.6084280303030303,44.953703703703695,1020.1851851851837,23.186026936026902,0
4558,4,1,1,45,0.021739130434782608,0.021739130434782608,0.9782608695652174,46,1350,1100,250,0.8148148148148148,16,11,5,303.73959125465296,0.4403884863123994,0.1418249510948444,0.1729558498962443,130238.9574759944,-1288.2544581618768,128950.70301783252,1402,0,347.9130434782609,44,2,21,37.06383043057572,0.6098484848484849,44.81481481481481,1020.7407407407397,23.198653198653176,0
4559,4,0,0,45,0.0,0.0,1.0,45,600,200,400,0.3333333333333333,10,2,8,304.7063723448565,0.43977272727272726,0.1474829931972792,0.17361177028951105,130262.58680555536,-1061.6276577503615,129200.959147805,1403,1,355.15555555555557,41,4,21,37.015306122448976,0.6143292682926829,44.79166666666666,1020.8333333333318,24.8983739837398,0
4560,4,0,0,45,0.0,0.0,1.0,45,1600,1300,300,0.8125,19,13,6,304.8709255002961,0.43920454545454546,0.14045584045584025,0.17438616938616916,130414.54081632636,-1048.0796485260998,129366.46116780027,1404,2,356.15555555555557,41,4,23,36.85776029526028,0.6158536585365854,44.64285714285713,1021.4285714285701,24.912891986062686,0
4561,4,0,0,45,0.0,0.0,1.0,45,1250,900,350,0.72,16,9,7,305.46902879441296,0.43897306397306396,0.13501569122262147,0.17552969345615327,130591.93244716826,-1021.6418453956105,129570.29060177265,1405,3,357.15555555555557,41,4,14,36.66357290756735,0.6176321138211383,44.46924603174601,1022.1230158730126,24.92982965543933,0
4562,4,1,0,46,0.021739130434782608,0.0,1.0,46,800,400,400,0.5,12,4,8,301.20704345228523,0.43947262479871174,0.13979651654581704,0.17436558602363544,130877.70168895727,-1315.7428840878183,129561.95880486946,1406,0,350.3695652173913,44,2,16,36.484631858353666,0.6162405303030303,44.1898148148148,1023.240740740739,23.25547138047134,0
4563,4,0,2,44,0.0,0.043478260869565216,0.9565217391304348,46,750,400,350,0.5333333333333333,11,4,7,302.7172835907736,0.43902979066022546,0.14309512664277713,0.17545538204136407,130925.07823216701,-1273.343192729795,129651.73503943722,1407,1,351.3695652173913,44,2,17,36.398300612201815,0.6167140151515151,44.143518518518505,1023.4259259259233,23.259680134680075,0
4564,4,0,3,41,0.0,0.06818181818181818,0.9318181818181819,44,1050,800,250,0.7619047619047619,13,8,5,303.24905884727775,0.4386892177589852,-0.0016899708735222951,0.16982964340921625,129589.1285465829,-939.204891686623,128649.92365489628,1408,2,336.6363636363636,40,4,12,37.7330987789866,0.6091145833333333,45.45223577235773,1018.1910569105705,25.45477642276426,8
4565,4,2,0,43,0.046511627906976744,0.0,1.0,43,1150,700,450,0.6086956521739131,16,7,9,306.3407667145028,0.4357235142118863,0.05641459404491522,0.1731214448384269,129943.77170138896,-638.5850694444349,129305.18663194453,1409,0,344.3953488372093,39,4,14,37.29566816510013,0.6143162393162394,45.10416666666667,1019.5833333333339,26.14316239316241,0
4566,4,1,0,44,0.022727272727272728,0.0,1.0,44,1450,1100,350,0.7586206896551724,18,11,7,298.01796123828535,0.4371035940803383,0.050760893167342225,0.17014116332513016,130340.40584308277,-1031.243596734756,129309.16224634802,1410,0,337.54545454545456,40,4,15,37.10750895700635,0.6166666666666667,44.71544715447154,1021.1382113821135,25.528455284552837,0
4567,4,0,1,43,0.0,0.022727272727272728,0.9772727272727273,44,1000,800,200,0.8,12,8,4,296.31610017087473,0.4364759513742072,0.05245450927902251,0.1696224054053318,130444.20070725068,-1069.45663130414,129374.74407594654,1411,1,338.54545454545456,40,4,17,37.04631748242474,0.6177083333333333,44.61382113821137,1021.5447154471522,25.538617886178805,0
4568,4,0,0,43,0.0,0.0,1.0,43,1450,1200,250,0.8275862068965517,17,12,5,300.9161842593373,0.4346160944998154,0.06087760472228165,0.17263086360140917,130528.56445312485,-744.3684895833474,129784.19596354151,1412,2,346.48837209302326,39,4,14,36.84378185524976,0.6201923076923077,44.53124999999999,1021.8749999999989,26.20192307692305,0
4569,4,0,0,43,0.0,0.0,1.0,43,850,500,350,0.5882352941176471,12,5,7,301.75737849743996,0.4347775932078258,0.057516315088554704,0.1735900886620089,130635.03146701366,-715.9830729166902,129919.04839409697,1413,3,347.48837209302326,39,4,15,36.71498199850553,0.6212606837606838,44.42708333333332,1022.2916666666648,26.21260683760679,0
4570,4,0,1,42,0.0,0.023255813953488372,0.9767441860465116,43,1200,700,500,0.5833333333333334,17,7,10,314.3909750511006,0.4341777408637874,0.047748960942606056,0.17377531009043407,129072.27143441391,-482.33477897375707,128589.93665544015,1414,4,348.48837209302326,40,3,16,37.9735890255692,0.60390625,45.96036585365853,1016.1585365853648,25.40396341463412,8
4571,4,0,0,42,0.0,0.0,1.0,42,1100,900,200,0.8181818181818182,13,9,4,318.43974657585915,0.4319952574525745,0.051903443629066626,0.17576360205740535,129016.1254882812,-183.2275390625008,128832.8979492187,1415,6,357.6904761904762,39,3,16,37.927752999077214,0.6049679487179487,46.015625,1015.9374999999997,26.04967948717948,0
4572,4,2,1,43,0.045454545454545456,0.022727272727272728,0.9772727272727273,44,1150,800,350,0.6956521739130435,15,8,7,306.86182159196045,0.4347802149400986,0.0712697881206168,0.171779349612819,129572.31445312499,-847.5748697916673,128724.73958333331,1416,0,342.3863636363636,39,5,15,37.65815769729214,0.6105769230769231,45.46875,1018.1249999999999,26.105769230769226,0
4573,4,1,0,44,0.022727272727272728,0.0,1.0,44,850,600,250,0.7058823529411765,11,6,5,304.8782600450233,0.4359914552501762,0.07355182235445645,0.17108006283153537,129666.74619108981,-893.4856071121861,128773.26058397762,1417,0,343.3636363636364,40,4,16,37.61308454732919,0.6098958333333333,45.376016260162594,1018.4959349593485,25.46239837398371,0
4574,4,0,0,44,0.0,0.0,1.0,44,1450,1100,350,0.7586206896551724,18,11,7,305.30423148214885,0.4357602184637068,0.07470964758787657,0.17188576805567124,129796.16057117115,-874.5365894970051,128921.62398167414,1418,1,344.3636363636364,40,4,16,37.47132741597686,0.6111979166666667,45.24898373983739,1019.0040650406495,25.475101626016237,0
4575,4,0,0,44,0.0,0.0,1.0,44,1100,800,300,0.7272727272727273,14,8,6,301.04780374728284,0.4356721282593376,0.07287682407323537,0.16982617950423196,129873.84018276139,-980.3531297508255,128893.48705301055,1419,2,345.3636363636364,40,4,16,37.50124626121636,0.6119791666666667,45.17276422764227,1019.3089430894292,25.48272357723573,0
4576,4,1,0,45,0.022222222222222223,0.0,1.0,45,1650,1100,550,0.6666666666666666,22,11,11,295.0310981523722,0.4361531986531986,0.07927250734404745,0.16788052753272106,130211.95515243092,-1316.6847757621988,128895.27037666872,1420,0,338.6666666666667,41,4,18,37.31329380508034,0.6138211382113821,44.84126984126982,1020.6349206349172,24.893534649632127,0
4577,4,1,0,46,0.021739130434782608,0.0,1.0,46,1250,700,550,0.56,18,7,11,296.8278194863367,0.43847624798711754,0.09128409201203613,0.17056425120846136,130591.93244716802,-1447.3264479403474,129144.60599922767,1421,0,332.2826086956522,41,5,16,36.88438238053643,0.6176321138211383,44.469246031746,1022.1230158730106,24.92982965543928,0
4578,4,0,1,45,0.0,0.021739130434782608,0.9782608695652174,46,700,200,500,0.2857142857142857,12,2,10,297.99363480227566,0.4385970209339775,0.08750279463935384,0.17168364415355208,130693.3532238123,-1410.842525667715,129282.51069814459,1422,1,333.2826086956522,41,5,17,36.75242957860352,0.6186483739837398,44.37003968253966,1022.5198412698383,24.939508323654593,0
4579,4,0,1,44,0.0,0.022222222222222223,0.9777777777777777,45,1200,900,300,0.75,15,9,6,301.0045237501202,0.4383627946127946,0.08432301153612642,0.17381586526362341,130781.81932257579,-1126.8161519267683,129655.00317064901,1423,2,339.53333333333336,40,5,17,36.58635535684717,0.62109375,44.28353658536585,1022.8658536585361,25.571646341463403,0
4580,4,0,2,42,0.0,0.045454545454545456,0.9545454545454546,44,1350,1000,350,0.7407407407407407,17,10,7,304.3713792933494,0.4366190979563072,0.09030387339210866,0.17564183263808855,130755.83316808757,-840.333341595635,129915.49982649194,1424,3,347.65909090909093,40,4,17,36.52643912294645,0.6208333333333333,44.30894308943088,1022.7642276422748,25.56910569105687,0
4581,4,0,0,42,0.0,0.0,1.0,42,1050,800,250,0.7619047619047619,13,8,5,315.24421660465634,0.43302361595044525,0.08581981820535023,0.18100997455222947,130562.68376981521,-168.17380743662272,130394.50996237858,1425,4,364.6904761904762,38,4,17,36.443306153738924,0.6222587719298245,44.49786324786325,1022.0085470085472,26.89496176338282,0
4582,4,0,0,42,0.0,0.0,1.0,42,1700,1100,600,0.6470588235294118,23,11,12,315.06761466090643,0.43232191250483937,0.07236871558400892,0.1818048387672609,130753.83434007232,-160.7402613412189,130593.09407873111,1426,5,365.6904761904762,38,4,18,36.25496187193149,0.6241776315789473,44.31089743589744,1022.7564102564103,26.914642375168693,0
4583,4,0,1,41,0.0,0.023809523809523808,0.9761904761904762,42,1500,1100,400,0.7333333333333333,19,11,8,311.88508362568376,0.4312330623306233,0.07169207210969564,0.18060673101371222,130890.45606874142,-235.44383263933503,130655.01223610209,1427,6,366.6904761904762,38,4,18,36.19862358181946,0.6255482456140351,44.17735042735043,1023.2905982905991,26.928699955015766,0
4584,4,0,0,41,0.0,0.0,1.0,41,1450,1200,250,0.8275862068965517,17,12,5,314.68678161032227,0.4312754065040651,0.08057791285489602,0.18274719644788526,130999.80481591051,44.78139381984943,131044.58620973036,1428,7,374.2682926829268,38,3,18,36.016750156543516,0.6266447368421053,44.07051282051282,1023.7179487179482,26.939946018893373,0
4585,4,0,0,41,0.0,0.0,1.0,41,1300,1000,300,0.7692307692307693,16,10,6,314.1980317528685,0.4307672764227642,0.08619124047116977,0.18337461512344824,131191.27498584625,44.008076740441254,131235.28306258668,1429,8,375.2682926829268,38,3,19,35.836418465602954,0.6285635964912281,43.883547008547005,1024.4658119658116,26.959626630679253,0
4586,4,0,0,41,0.0,0.0,1.0,41,1000,600,400,0.6,14,6,8,314.9580276290566,0.4304369918699187,0.08605988498909367,0.1844754161827333,131328.12500000015,72.56944444445833,131400.6944444446,1430,9,376.2682926829268,38,3,22,35.679200542005425,0.6299342105263157,43.75000000000001,1025.0000000000011,26.973684210526347,0
4587,4,0,0,41,0.0,0.0,1.0,41,900,600,300,0.6666666666666666,12,6,6,316.5882043042456,0.4301067073170732,0.0870382984780238,0.18569562399165906,131382.8849806415,118.8543264665118,131501.73930710802,1431,10,377.2682926829268,38,3,22,35.58231728497983,0.6304824561403508,43.6965811965812,1025.213675213676,26.979307242465158,0
4588,4,0,0,41,0.0,0.0,1.0,41,1350,900,450,0.6666666666666666,18,9,9,318.84268971261065,0.4301829268292683,0.0933680289084613,0.18728593242727293,131437.65637555713,181.58717766090717,131619.24355321802,1432,11,378.2682926829268,38,3,22,35.46941203028408,0.6310307017543859,43.6431623931624,1025.4273504273513,26.98493027440398,0
4589,4,0,0,41,0.0,0.0,1.0,41,1050,800,250,0.7619047619047619,13,8,5,355.0774068819638,0.4297256097560975,0.20202059794804428,0.19088286516829567,127964.52591050319,887.4624066362793,128851.98831713946,1433,12,379.2682926829268,40,1,15,38.07126355966253,0.5927083333333334,47.05284552845529,1011.7886178861803,25.29471544715451,8
4590,4,0,0,41,0.0,0.0,1.0,41,900,600,300,0.6666666666666666,12,6,6,353.8495443947083,0.42947154471544713,0.19755093645706023,0.19083353068303682,128093.08824319197,865.1361829929344,128958.22442618491,1434,13,380.2682926829268,40,1,15,37.97079443161664,0.5940104166666667,46.925813008130085,1012.2967479674804,25.30741869918701,0
4591,4,0,0,41,0.0,0.0,1.0,41,950,500,450,0.5263157894736842,14,5,9,357.8496170717043,0.42891260162601624,0.2059197422529193,0.19336936548492664,128171.575946015,973.2505300460277,129144.82647606103,1435,14,381.2682926829268,38,3,15,37.789266371245674,0.5981359649122807,46.848290598290596,1012.6068376068372,26.647548358074662,0
4592,4,2,1,42,0.046511627906976744,0.023255813953488372,0.9767441860465116,43,1500,1300,200,0.8666666666666667,17,13,4,344.3757767556546,0.43110926541159095,0.20583134249988122,0.18891734970440213,128773.09032698722,269.2666013164509,129042.35692830368,1436,0,364.48837209302326,41,2,16,37.51659580360343,0.599339430894309,46.254960317460316,1014.9801587301582,24.755613627564834,0
4593,4,0,1,41,0.0,0.023809523809523808,0.9761904761904762,42,1350,1000,350,0.7407407407407407,17,10,7,348.7861301502397,0.4292126403406891,0.20515291160452453,0.19121554723670692,128747.91843820861,581.097647392293,129329.0160856009,1437,1,374.1666666666667,41,1,16,37.43035190615836,0.5990853658536586,46.279761904761905,1014.8809523809523,24.75319396051103,0
4594,4,1,0,42,0.023809523809523808,0.0,1.0,42,1550,1000,550,0.6451612903225806,21,10,11,352.7288986151458,0.43130565234223767,0.2172151157113571,0.19473297308451232,129024.94454089487,702.1653163580092,129727.10985725287,1438,0,374.64285714285717,41,1,17,37.04787537024379,0.6018800813008129,46.006944444444436,1015.9722222222206,24.77981029810294,0
4595,4,0,1,41,0.0,0.023809523809523808,0.9761904761904762,42,1000,800,200,0.8,12,8,4,356.0816942450542,0.43112417731320174,0.21236161847131996,0.1972115156343147,129150.96391565869,797.658808893912,129948.62272455261,1439,1,375.64285714285717,41,1,17,36.834293057453316,0.603150406504065,45.8829365079365,1016.4682539682527,24.791908633372017,0
4596,4,1,0,42,0.023809523809523808,0.0,1.0,42,1450,1100,350,0.7586206896551724,18,11,7,354.62534234033,0.4329268292682927,0.21362271362271357,0.1977157730582388,129413.28125000001,778.6655171327805,130191.9467671328,1440,0,369.85714285714283,39,3,18,36.604217854217865,0.608974358974359,45.625,1017.5000000000001,26.08974358974359,0
4597,4,0,1,41,0.0,0.023809523809523808,0.9761904761904762,42,1200,800,400,0.6666666666666666,16,8,8,352.4716895695386,0.4324549941927991,0.20738623905512243,0.197178352728283,129545.8021375869,732.2455512152885,130278.0476888022,1441,1,370.85714285714283,39,3,15,36.52420358811693,0.610309829059829,45.49479166666667,1018.0208333333342,26.10309829059831,0
4598,4,0,0,41,0.0,0.0,1.0,41,1000,800,200,0.8,12,8,4,358.2079870372353,0.4304369918699187,0.208894602595753,0.19974080026596186,129418.71667031925,1071.763596683469,130490.48026700271,1442,4,380.8780487804878,38,3,17,36.507551098978006,0.6107456140350878,45.61965811965812,1017.5213675213676,26.776878092667566,0
4599,4,0,2,39,0.0,0.04878048780487805,0.9512195121951219,41,1100,800,300,0.7272727272727273,14,8,6,349.34633520538443,0.430005081300813,0.1483180819630996,0.1950687684153864,129473.07715136243,874.1539739937218,130347.23112535616,1443,5,381.8780487804878,38,3,16,36.677689131499775,0.6112938596491229,45.56623931623932,1017.735042735043,26.782501124606394,7
4600,4,0,1,38,0.0,0.02564102564102564,0.9743589743589743,39,1500,1100,400,0.7333333333333333,19,11,8,349.64507232091853,0.4240328385065227,0.15717658754815478,0.19568743197707852,129563.94184989628,1260.2787636580654,130824.22061355434,1444,8,395.4102564102564,37,2,17,36.57770148985821,0.6140202702702703,45.476973684210535,1018.092105263159,27.516002844950243,0
4601,4,0,0,38,0.0,0.0,1.0,38,1600,1500,100,0.9375,17,15,2,352.04677413935065,0.4244902797534376,0.15351538156478295,0.19773364762724163,129703.52055440178,1532.3412011388536,131235.86175554062,1445,9,401.7368421052632,37,1,17,36.37468604233943,0.615427927927928,45.339912280701775,1018.6403508771964,27.53082029397828,0
4602,4,0,0,38,0.0,0.0,1.0,38,1200,700,500,0.5833333333333334,17,7,10,352.2117804403562,0.42447546230440963,0.15168030350216588,0.19853295932038315,129843.17440222023,1546.459126846761,131389.63352906698,1446,10,402.7368421052632,37,1,17,36.2285951228259,0.6168355855855856,45.202850877193,1019.1885964912306,27.545637743006232,0
4603,4,1,0,39,0.02564102564102564,0.0,1.0,39,950,800,150,0.8421052631578947,11,8,3,349.5807680710504,0.426984930274404,0.15301919720767843,0.19848372979063839,130126.29323727108,1297.929907224811,131424.2231444959,1447,0,393.38461538461536,38,1,18,36.00828970331589,0.6178728070175439,44.92521367521369,1020.2991452991475,26.849977507872303,0
4604,4,1,0,40,0.025,0.0,1.0,40,1200,700,500,0.5833333333333334,17,7,10,346.13829945311494,0.42935363247863245,0.16659021406727748,0.19857407705468236,130528.5644531255,1036.1870659722672,131564.75151909777,1448,0,384.525,39,1,15,35.68849813115867,0.6201923076923077,44.53125000000002,1021.875000000004,26.20192307692318,0
4605,4,0,0,40,0.0,0.0,1.0,40,1300,1100,200,0.8461538461538461,15,11,4,345.6136596368009,0.4294070512820513,0.16217138781332774,0.19881901850384334,130635.0314670141,1029.850260416688,131664.8817274308,1449,1,385.525,39,1,15,35.594134230011555,0.6212606837606838,44.42708333333334,1022.2916666666683,26.21260683760688,0
4606,4,0,1,39,0.0,0.025,0.975,40,1050,900,150,0.8571428571428571,12,9,3,346.5100434163481,0.4294738247863248,0.15655107444749983,0.20002246421546885,130768.17626953138,1062.4972873264048,131830.67355685777,1450,2,386.525,39,1,16,35.4365049054554,0.6225961538461539,44.29687500000001,1022.812500000001,26.225961538461565,0
4607,4,0,0,39,0.0,0.0,1.0,39,1350,1100,250,0.8148148148148148,16,11,5,353.34558426116035,0.4269005847953216,0.16217345872518196,0.20346072451139063,130671.89554569396,1434.467455621334,132106.3630013153,1451,3,397.35897435897436,38,1,16,35.35919540229884,0.6233552631578947,44.39102564102566,1022.4358974359002,26.90620782726053,0
4608,4,0,0,39,0.0,0.0,1.0,39,900,400,500,0.4444444444444444,14,4,10,358.22016264994727,0.42664754835807467,0.16922594797869017,0.20670534159421033,130753.83434007247,1567.7319608810196,132321.56630095348,1452,4,398.35897435897436,38,1,16,35.15159824506426,0.6241776315789473,44.310897435897445,1022.7564102564115,26.914642375168725,0
4609,4,0,0,39,0.0,0.0,1.0,39,1450,1200,250,0.8275862068965517,17,12,5,357.1065306987598,0.4255791722896986,0.17246059087587406,0.206940318061913,130917.78897518087,1550.3194855358404,132468.1084607167,1453,5,399.35897435897436,38,1,16,35.01409332915754,0.6258223684210527,44.15064102564103,1023.3974358974364,26.931511470985168,0
4610,4,0,0,39,0.0,0.0,1.0,39,1300,1000,300,0.7692307692307693,16,10,6,359.83502778587507,0.42504498425551057,0.1702320080698454,0.20911455859745573,131027.1491366245,1629.6315700562693,132656.78070668076,1454,6,400.35897435897436,38,1,16,34.83360290792723,0.6269188596491229,44.04380341880343,1023.824786324788,26.942757534862842,0
4611,4,0,0,39,0.0,0.0,1.0,39,1000,700,300,0.7,13,7,6,360.0489429935309,0.42437022042285205,0.1703873704708252,0.20968585464981715,131109.19922017684,1641.1457191905974,132750.34493936744,1455,7,401.35897435897436,38,1,16,34.74511440294875,0.6277412280701755,43.96367521367522,1024.1452991452998,26.951192082771048,0
4612,4,0,0,39,0.0,0.0,1.0,39,1000,500,500,0.5,15,5,10,359.8169489082879,0.4244545659019343,0.16353775552774308,0.2098494468450527,131163.91354372134,1638.9998356344631,132802.9133793558,1456,8,402.35897435897436,38,1,17,34.69571339173969,0.6282894736842105,43.910256410256416,1024.3589743589753,26.956815114709876,0
4613,4,0,0,39,0.0,0.0,1.0,39,1450,1200,250,0.8275862068965517,17,12,5,358.09865881209055,0.42313315339631125,0.17383244206773618,0.210051597232939,131384.32618690372,1609.812927760208,132994.13911466394,1457,9,403.35897435897436,37,2,19,34.51693404634582,0.6323198198198199,43.69517543859649,1025.2192982456145,27.708629682313905,0
4614,4,1,0,40,0.025,0.0,1.0,40,1150,700,450,0.6086956521739131,16,7,9,353.81577663541094,0.4244925213675214,0.176998126756166,0.20947725186011495,131739.10307774498,1322.2746137409679,133061.37769148595,1458,0,394.25,38,2,15,34.268654386512644,0.634046052631579,43.34935897435898,1026.6025641025649,27.015856950067498,0
4615,4,0,0,40,0.0,0.0,1.0,40,1250,900,350,0.72,16,9,7,353.3360894669891,0.42402510683760686,0.1765134179321819,0.20994889765980448,131876.23844875462,1319.3268774198411,133195.56532617446,1459,1,395.25,38,2,15,34.142699882116354,0.6354166666666667,43.21581196581197,1027.1367521367533,27.02991452991456,0
4616,4,0,0,40,0.0,0.0,1.0,40,900,900,0,1.0,9,9,0,346.07451386789694,0.4233974358974359,0.1983833531253376,0.1907012624603408,128950.68825263543,944.5081592552178,129895.19641189065,1460,2,396.25,37,3,15,37.29252132138617,0.6078265765765766,46.08004385964912,1015.6798245614035,27.45080606922712,8
4617,4,0,0,40,0.0,0.0,1.0,40,850,600,250,0.7058823529411765,11,6,5,348.8266845498581,0.42283653846153846,0.1975531455703028,0.192759504217265,129062.0807003116,1004.0595423591817,130066.1402426708,1461,3,397.25,37,3,16,37.109164238696444,0.6089527027027026,45.9703947368421,1016.1184210526313,27.462660028449495,0
4618,4,1,0,41,0.024390243902439025,0.0,1.0,41,1100,700,400,0.6363636363636364,15,7,8,343.97758871903795,0.4267530487804878,0.1985555675326076,0.19142652012876493,129340.77222077936,698.140533625718,130038.91275440507,1462,0,388.5365853658537,37,4,18,36.94879361144047,0.6117680180180181,45.696271929824555,1017.2149122807008,27.492294926505426,0
4619,4,0,0,41,0.0,0.0,1.0,41,1100,800,300,0.7272727272727273,14,8,6,340.6304519727416,0.4269817073170732,0.19284832781143257,0.1902019745306176,129473.07715136246,620.4945576740505,130093.57170903652,1463,1,389.5365853658537,38,3,14,36.89945062635595,0.6112938596491229,45.56623931623932,1017.7350427350432,26.782501124606398,0
4620,4,0,2,39,0.0,0.04878048780487805,0.9512195121951219,41,850,600,250,0.7058823529411765,11,6,5,339.91316976599006,0.42654979674796745,0.1878279118572932,0.19032740939306023,129581.83235627146,609.3142760610726,130191.14663233254,1464,2,390.5365853658537,38,3,15,36.807231549492826,0.612390350877193,45.45940170940171,1018.1623931623932,26.79374718848403,0
4621,4,1,0,40,0.025,0.0,1.0,40,1000,700,300,0.7,13,7,6,348.59438703607566,0.42450587606837603,0.2220297029702969,0.196073792030219,129759.37307633132,1046.6778239458458,130806.05090027717,1465,0,399.5,37,3,16,36.40586884775435,0.615990990990991,45.285087719298254,1018.8596491228082,27.53674727358941,0
4622,4,0,0,40,0.0,0.0,1.0,40,1350,1000,350,0.7407407407407407,17,10,7,346.3338225262175,0.4247863247863248,0.22384371302570738,0.19549881894512727,129899.05698147518,997.6873893890539,130896.74437086424,1466,1,400.5,37,3,17,36.32164049334909,0.6173986486486487,45.14802631578948,1019.407894736843,27.55156472261738,0
4623,4,0,0,40,0.0,0.0,1.0,40,1100,700,400,0.6363636363636364,15,7,8,351.19544600100545,0.4249866452991453,0.2219791442700494,0.19895371733869407,130038.81602993248,1133.8079986149814,131172.62402854746,1467,2,401.5,37,3,17,36.05586612198093,0.6188063063063063,45.01096491228071,1019.9561403508787,27.566382171645373,0
4624,4,0,1,39,0.0,0.025,0.975,40,1450,900,550,0.6206896551724138,20,9,11,350.0739884188415,0.424065170940171,0.2209233000322266,0.19931735524103966,130234.60493853886,1118.3495161972983,131352.95445473617,1468,3,402.5,37,3,17,35.88585866723958,0.620777027027027,44.819078947368425,1020.723684210527,27.587126600284513,0
4625,4,0,1,38,0.0,0.02564102564102564,0.9743589743589743,39,1050,700,350,0.6666666666666666,14,7,7,386.4276053993673,0.4248200629779577,0.16195346427904544,0.21009224983206976,128415.8801020408,2195.052407216344,130610.93250925714,1469,4,376.3333333333333,34,5,17,36.81534335604102,0.6084558823529411,46.607142857142854,1013.5714285714284,29.810924369747895,8
4626,4,0,1,37,0.0,0.02631578947368421,0.9736842105263158,38,850,700,150,0.8235294117647058,10,7,3,391.8536624206589,0.4242532005689901,0.15628161808220198,0.21308492057076092,128423.86529519911,2464.6723916282394,130888.53768682735,1470,5,378.57894736842104,33,5,17,36.66966408737355,0.6107954545454546,46.59926470588236,1013.6029411764719,30.71524064171127,0
4627,4,1,0,38,0.02631578947368421,0.0,1.0,38,1150,700,450,0.6086956521739131,16,7,9,389.1065960412511,0.42429765291607396,0.16652255184954434,0.21274930000194697,128641.33536380246,2411.0384227220416,131052.37378652449,1471,0,379.2368421052632,33,5,18,36.51646935652734,0.6130050505050505,46.38480392156863,1014.460784313726,30.741235888294728,0
4628,4,0,0,38,0.0,0.0,1.0,38,950,600,350,0.631578947368421,13,6,7,386.4489252958063,0.424268018018018,0.16450546656496345,0.21162679242389396,128703.50346020765,2347.46611880047,131050.96957900812,1472,1,380.2368421052632,33,5,18,36.52022946859904,0.6136363636363636,46.32352941176471,1014.7058823529414,30.748663101604286,0
4629,4,1,0,39,0.02564102564102564,0.0,1.0,39,1450,800,650,0.5517241379310345,21,8,13,376.48460235309744,0.4281376518218623,0.16625025936632198,0.20772278885793835,129001.10995708556,1913.3863170603156,130914.49627414587,1473,0,371.46153846153845,36,3,20,36.46884122233308,0.6102430555555556,46.03040540540541,1015.8783783783791,28.218843843843864,0
4630,4,0,1,38,0.0,0.02564102564102564,0.9743589743589743,39,1350,900,450,0.6666666666666666,18,9,9,376.11854647054776,0.4277721547458389,0.1753168908054794,0.20827276076338433,129144.1504849444,1914.7020331141966,131058.8525180586,1474,1,372.46153846153845,36,3,21,36.33207770145506,0.6116898148148149,45.88963963963964,1016.4414414414415,28.234484484484486,0
4631,4,1,0,39,0.02564102564102564,0.0,1.0,39,1250,1000,250,0.8,15,10,5,373.04374983757833,0.42954340980656774,0.18196976433970624,0.20818247974806794,129450.6920415225,1858.1923604493827,131308.88440197188,1475,0,370.1025641025641,33,6,18,36.097563423249824,0.6212121212121212,45.588235294117645,1017.6470588235295,30.837789661319075,0
4632,4,1,0,40,0.025,0.0,1.0,40,1250,900,350,0.72,16,9,7,367.33612529723655,0.43084935897435894,0.18834812565689574,0.20734998292157142,129898.25857426309,1543.2645975056726,131441.52317176876,1476,0,361.825,34,6,21,35.787204640118325,0.623468137254902,45.148809523809526,1019.4047619047623,29.98249299719889,0
4633,4,1,0,41,0.024390243902439025,0.0,1.0,41,950,700,250,0.7368421052631579,12,7,5,357.3645547898608,0.4328760162601626,0.18755428198418977,0.20330584800883836,130203.51750042867,1106.024412722911,131309.5419131516,1477,0,353.9756097560976,35,6,22,35.73136387691842,0.6244047619047619,44.84953703703704,1020.6018518518518,29.16005291005291,0
4634,4,0,0,41,0.0,0.0,1.0,41,1350,1000,350,0.7407407407407407,17,10,7,361.01624323198655,0.4327997967479675,0.18556495769039283,0.2056953013763646,130262.58680555563,1205.3819444444543,131467.9687500001,1478,1,354.9756097560976,35,6,22,35.578231292517,0.625,44.79166666666667,1020.833333333334,29.166666666666686,0
4635,4,1,0,42,0.023809523809523808,0.0,1.0,42,1400,1000,400,0.7142857142857143,18,10,8,355.85689611674945,0.43506823461091754,0.19064925529683197,0.20502415080838132,130694.03863322803,901.6749857966286,131595.71361902467,1479,0,347.5,36,6,17,35.27257709251102,0.6273148148148149,44.36936936936938,1022.5225225225242,28.403403403403452,0
4636,4,0,1,41,0.0,0.023809523809523808,0.9761904761904762,42,1100,800,300,0.7272727272727273,14,8,6,358.7703608886777,0.435152922957801,0.18944623529103466,0.2074747758544646,130838.01442912518,988.1603309390588,131826.17476006423,1480,1,348.5,36,6,18,35.05228398458999,0.6287615740740741,44.22860360360361,1023.0855855855864,28.419044044044067,0
4637,4,1,2,40,0.023809523809523808,0.047619047619047616,0.9523809523809523,42,650,400,250,0.6153846153846154,9,4,5,358.46497741083243,0.43458430120015484,0.1884383676462884,0.20807449838214986,130982.06948502558,990.4969158347544,131972.56640086035,1481,0,349.4047619047619,36,6,19,34.914283094976156,0.6302083333333333,44.08783783783784,1023.6486486486488,28.434684684684687,0
4638,4,0,0,40,0.0,0.0,1.0,40,1550,1300,250,0.8387096774193549,18,13,5,372.9277124353319,0.4329326923076923,0.18594095726097604,0.21448963608052193,130627.4252409296,1742.9173752834338,132370.34261621305,1482,1,364.875,34,6,19,34.90377896820775,0.6308210784313726,44.4345238095238,1022.2619047619039,30.06652661064423,0
4639,4,0,1,39,0.0,0.025,0.975,40,1050,800,250,0.7619047619047619,13,8,5,375.09435803334145,0.4332799145299145,0.18210128055878916,0.21624567352391963,130718.71456916099,1806.3704648526061,132525.0850340136,1483,2,365.875,34,6,20,34.75577221575476,0.6317401960784313,44.345238095238095,1022.6190476190476,30.077030812324928,0
4640,4,1,0,40,0.025,0.0,1.0,40,900,600,300,0.6666666666666666,12,6,6,375.960968689604,0.43246527777777777,0.1872454915648638,0.21760165157489175,130870.93431122442,1840.4726473922854,132711.40695861672,1484,0,366.55,34,6,22,34.579212720574,0.6332720588235294,44.19642857142857,1023.2142857142851,30.09453781512603,0
4641,4,1,0,41,0.024390243902439025,0.0,1.0,41,1100,900,200,0.8181818181818182,13,9,4,369.0165410732097,0.43366361788617885,0.1966100013502674,0.2153042455529979,131179.87403817297,1481.5086751971828,132661.38271337014,1485,0,358.5853658536585,35,6,23,34.443965841901104,0.6342261904761906,43.894675925925924,1024.421296296296,29.26917989417989,0
4642,4,0,0,41,0.0,0.0,1.0,41,1400,900,500,0.6428571428571429,19,9,10,371.2062312748621,0.43356199186991873,0.19569977142112593,0.2175940679038692,131358.63272392293,1552.3123242674112,132910.94504819033,1486,1,359.5853658536585,34,7,23,34.20697363836952,0.6381740196078431,43.720238095238095,1025.1190476190477,30.150560224089638,0
4643,4,0,0,41,0.0,0.0,1.0,41,1600,1200,400,0.75,20,12,8,375.01532921994095,0.4325711382113821,0.19657098868505485,0.22105896766193234,131572.2859977324,1668.324829931967,133240.61082766435,1487,2,360.5853658536585,34,7,19,33.89320801423376,0.6403186274509804,43.51190476190476,1025.9523809523807,30.1750700280112,0
4644,4,0,1,40,0.0,0.024390243902439025,0.975609756097561,41,1050,700,350,0.6666666666666666,14,7,7,372.5945092207733,0.4317073170731707,0.19155195727322605,0.2203367529836426,131694.45153061228,1613.725907029485,133308.17743764177,1488,3,361.5853658536585,34,7,19,33.83181589731694,0.6415441176470589,43.392857142857146,1026.4285714285718,30.189075630252113,0
4645,4,0,0,40,0.0,0.0,1.0,40,1350,800,550,0.5925925925925926,19,8,11,376.49633428335125,0.43075587606837606,0.18562855154818458,0.2228227790339972,131725.00177154204,1918.7960600907095,133643.79783163275,1489,4,366.9,34,6,20,33.70080984962695,0.6418504901960784,43.36309523809524,1026.5476190476197,30.192577030812345,0
4646,4,0,0,40,0.0,0.0,1.0,40,1000,700,300,0.7,13,7,6,373.7701783276447,0.43046207264957265,0.18330233344605973,0.22149066479255441,131773.38023244613,1850.5919656635936,133623.97219810972,1490,5,367.9,35,5,20,33.7218887385864,0.6401785714285715,43.31597222222223,1026.7361111111122,29.33531746031749,0
4647,4,0,0,40,0.0,0.0,1.0,40,950,600,350,0.631578947368421,13,6,7,374.41833803433,0.43062232905982906,0.18516681695220938,0.2220480945882738,131803.09070644723,1869.8988340192068,133672.98954046643,1491,6,368.9,35,5,20,33.675232942590924,0.6404761904761904,43.28703703703704,1026.8518518518522,29.33862433862435,0
4648,4,0,1,39,0.0,0.025,0.975,40,1350,1100,250,0.8148148148148148,16,11,5,376.2560263982592,0.4301682692307693,0.17862776025236582,0.22383703018169898,131921.9660922497,1927.2869513031578,133849.25304355286,1492,7,369.9,35,5,20,33.50796154423914,0.6416666666666666,43.1712962962963,1027.3148148148152,29.351851851851865,0
4649,4,0,2,37,0.0,0.05128205128205128,0.9487179487179487,39,1450,1100,350,0.7586206896551724,18,11,7,359.94085707474414,0.4298245614035088,0.11630154157280503,0.20444354446571453,130141.08737244898,1577.6745471851268,131718.7619196341,1493,8,370.87179487179486,34,5,20,35.72900867265586,0.6259191176470589,44.910714285714285,1020.3571428571428,30.01050420168067,8
4650,4,1,0,38,0.02631578947368421,0.0,1.0,38,1000,600,400,0.6,14,6,8,363.6817992503122,0.4289651493598862,0.1378088077336197,0.20721404841006177,130262.58680555563,1874.8830782313016,132137.46988378692,1494,0,381.0,32,6,22,35.510204081632644,0.6318359375,44.79166666666667,1020.833333333334,31.90104166666669,0
4651,4,1,2,37,0.02564102564102564,0.05128205128205128,0.9487179487179487,39,1350,1100,250,0.8148148148148148,16,11,5,351.8908629717058,0.43027440395861444,0.12836805523533767,0.2022826800859405,130606.84479827467,1391.871065215299,131998.71586348998,1495,0,372.20512820512823,33,6,19,35.462249730248175,0.6328914141414141,44.4546568627451,1022.1813725490193,30.97519310754604,0
4652,4,1,0,38,0.02631578947368421,0.0,1.0,38,1200,800,400,0.6666666666666666,16,8,8,362.1598492491215,0.42964675201517305,0.1355570289190926,0.20841565738238363,130649.5530589991,1863.204488062445,132512.75754706154,1496,0,382.60526315789474,32,6,21,35.156539459058905,0.6357421875,44.41287878787879,1022.348484848485,31.948390151515156,0
4653,4,0,0,38,0.0,0.0,1.0,38,750,600,150,0.8,9,6,3,363.62658202638795,0.42978010905642483,0.13688890044325386,0.2094344282538898,130681.82615294354,1903.8771553922998,132585.70330833585,1497,1,383.60526315789474,32,6,21,35.0863381904997,0.6360677083333333,44.38131313131313,1022.4747474747472,31.95233585858585,0
4654,4,0,0,38,0.0,0.0,1.0,38,850,600,250,0.7058823529411765,11,6,5,362.5432098765433,0.429068871503082,0.13826510721247542,0.20915954415954405,130746.38429752059,1880.2427685950308,132626.62706611562,1498,2,384.60526315789474,32,6,21,35.048611111111114,0.63671875,44.31818181818181,1022.7272727272722,31.960227272727256,0
4655,4,0,0,38,0.0,0.0,1.0,38,950,800,150,0.8421052631578947,11,8,3,362.9820047026646,0.42883179231863444,0.13659457246993578,0.20958782751933602,130778.66934815317,1894.060714467906,132672.73006262106,1499,3,385.60526315789474,32,6,21,35.004680492120315,0.6370442708333333,44.28661616161616,1022.8535353535348,31.96417297979796,0
4656,4,1,0,39,0.02564102564102564,0.0,1.0,39,850,500,350,0.5882352941176471,12,5,7,347.2155141751944,0.43049932523616735,0.10707505082861624,0.18985302443827692,128643.06205257635,1143.3372938755604,129786.39934645192,1500,0,376.6923076923077,35,4,17,37.57712968244915,0.6086309523809523,46.383101851851855,1014.467592592593,28.98478835978837,8
4657,4,0,1,38,0.0,0.02564102564102564,0.9743589743589743,39,850,600,250,0.7058823529411765,11,6,5,349.6464317720022,0.4301057130004498,0.1552282233133302,0.18012982277630107,126236.59593576848,1027.635065597082,127264.23100136557,1501,1,377.6923076923077,37,2,17,39.982155846517564,0.5802364864864865,48.76644736842104,1004.934210526314,27.160384068278756,8
4658,4,1,0,39,0.02564102564102564,0.0,1.0,39,1100,800,300,0.7272727272727273,14,8,6,350.2660483667485,0.43041497975708504,0.17815470653470467,0.18215819025259944,126622.55603887713,1070.3164675669177,127692.87250644405,1502,0,378.02564102564105,37,2,14,39.569374841122844,0.584177927927928,48.38267543859648,1006.4692982456123,27.20187292555709,0
4659,4,6,3,42,0.13333333333333333,0.06666666666666667,0.9333333333333333,45,600,300,300,0.5,9,3,6,317.83236210609545,0.44183501683501686,0.2021219763964719,0.17079195536540062,127948.38543544523,-865.9038291762236,127082.48160626901,1503,0,328.4888888888889,42,3,15,39.02982632570317,0.5895337301587302,47.06879844961239,1011.7248062015475,24.088685861941606,0
4660,4,1,0,43,0.023255813953488372,0.0,1.0,43,800,400,400,0.5,12,4,8,329.643056727852,0.43980712440014763,0.20859391986832598,0.17619341672605796,127733.27637525585,-178.7224659594449,127554.5539092964,1504,0,344.74418604651163,40,3,16,38.950814315874126,0.5903645833333333,47.281504065040636,1010.8739837398351,25.27184959349588,0
4661,4,0,0,43,0.0,0.0,1.0,43,1400,900,500,0.6428571428571429,19,9,10,331.5361080453056,0.438999630860096,0.20803110745532072,0.1777719475898103,127861.72251966412,-121.84442957235609,127739.87809009176,1505,1,345.74418604651163,40,3,18,38.77172930064307,0.5916666666666667,47.15447154471544,1011.3821138211374,25.284552845528435,0
4662,4,0,0,43,0.0,0.0,1.0,43,1750,1400,350,0.8,21,14,7,334.3367313357511,0.4385612772240679,0.21264993019987544,0.1804259218616876,128118.80845561503,-33.03527166369582,128085.77318395133,1506,2,346.74418604651163,40,3,18,38.438357424881204,0.5942708333333333,46.90040650406504,1012.3983739837397,25.30995934959349,0
4663,4,1,3,41,0.022727272727272728,0.06818181818181818,0.9318181818181819,44,1500,1200,300,0.8,18,12,6,327.20019576771864,0.4402197850599014,0.21148236602463033,0.1778292944082537,128401.90120174823,-397.371976006351,128004.52922574188,1507,0,339.84090909090907,40,4,14,38.33036699087536,0.5971354166666667,46.62093495934959,1013.5162601626012,25.337906504065028,0
4664,4,4,4,41,0.08888888888888889,0.08888888888888889,0.9111111111111111,45,750,400,350,0.5333333333333333,11,4,7,313.59641774954844,0.4471380471380471,0.2008566581849025,0.1726097929629867,128906.0152635058,-915.1070773991942,127990.90818610661,1508,0,309.64444444444445,42,3,16,38.162571564885496,0.5992063492063492,46.12403100775194,1015.5038759689922,24.178663713547433,0
4665,4,1,1,41,0.023809523809523808,0.023809523809523808,0.9761904761904762,42,950,600,350,0.631578947368421,13,6,7,330.9529266447224,0.4433192992644212,0.20893383036386948,0.18037490414108237,128513.93771701396,106.41276041667624,128620.35047743063,1509,0,332.4047619047619,39,3,17,38.121104718854866,0.5998931623931624,46.51041666666667,1013.958333333334,25.998931623931643,0
4666,4,0,1,40,0.0,0.024390243902439025,0.975609756097561,41,1000,800,200,0.8,12,8,4,333.3217225078023,0.4417936991869919,0.21375956096019433,0.18195647566225226,128577.58881446782,371.54067590766675,128949.12949037549,1510,1,340.6829268292683,38,3,17,37.996198953614964,0.6022478070175439,46.447649572649574,1014.2094017094016,26.68972109761583,0
4667,4,0,0,40,0.0,0.0,1.0,40,1100,700,400,0.6363636363636364,15,7,8,341.3313576483289,0.441786858974359,0.20920369769704839,0.18625213727961026,128561.19340806788,776.3933373730406,129337.58674544092,1511,2,339.55,37,3,18,37.809830792518106,0.6038851351351351,46.463815789473685,1014.1447368421054,27.409317211948796,0
4668,4,0,0,40,0.0,0.0,1.0,40,1250,800,450,0.64,17,8,9,339.78123291657454,0.4421875,0.20856564019448975,0.18618563118075157,128728.04763244448,747.8749470990922,129475.92257954356,1512,3,340.55,37,3,18,37.67906987214117,0.6055743243243243,46.29934210526315,1014.8026315789464,27.427098150782335,0
4669,4,1,1,40,0.024390243902439025,0.024390243902439025,0.975609756097561,41,800,400,400,0.5,12,4,8,331.0563895486006,0.4437245934959349,0.19814797243756255,0.18295626502014745,129065.65176647295,345.6017377090931,129411.25350418204,1513,0,333.219512195122,38,3,19,37.55695159990187,0.6071820175438596,45.966880341880334,1016.1324786324776,26.7403283850652,0
4670,4,1,0,41,0.024390243902439025,0.0,1.0,41,750,200,550,0.26666666666666666,13,2,11,330.89223327062643,0.4433689024390244,0.2033186725309879,0.18349478390461973,129201.38888888869,350.3472222221978,129551.73611111089,1514,0,333.780487804878,38,3,20,37.423155737704896,0.6085526315789473,45.83333333333332,1016.666666666665,26.754385964912238,0
4671,4,1,1,41,0.023809523809523808,0.023809523809523808,0.9761904761904762,42,1200,1000,200,0.8333333333333334,14,10,4,322.9883378790849,0.4437306426635695,0.20470635813928628,0.18068488987362866,129545.80213758662,-31.643337673630867,129514.158799913,1515,0,326.8095238095238,39,3,17,37.274570244551306,0.610309829059829,45.49479166666666,1018.0208333333319,26.103098290598254,0
4672,4,0,2,39,0.0,0.04878048780487805,0.9512195121951219,41,950,800,150,0.8421052631578947,11,8,3,321.3215763015892,0.44359756097560976,0.0758630317292539,0.18109506351006638,129837.58680555575,176.95855034724062,130014.54535590298,1516,1,326.780487804878,39,2,16,37.02132733714908,0.6132478632478633,45.20833333333334,1019.1666666666682,26.132478632478673,7
4673,4,1,0,40,0.025,0.0,1.0,40,1200,700,500,0.5833333333333334,17,7,10,322.2852321756588,0.44334935897435895,0.10661764705882337,0.1826282982328734,130050.00000000003,382.6388888888889,130432.63888888892,1517,0,335.85,39,1,17,36.78172657952067,0.6153846153846154,45.0,1020.0000000000002,26.15384615384616,0
4674,4,0,0,40,0.0,0.0,1.0,40,1400,1300,100,0.9285714285714286,15,13,2,326.860339535164,0.4435363247863248,0.10912293240759707,0.1854733583665929,130103.13042534712,505.11067708332826,130608.24110243045,1518,1,336.85,39,1,17,36.611275610918256,0.6159188034188035,44.947916666666664,1020.2083333333325,26.159188034188013,0
4675,4,0,1,39,0.0,0.025,0.975,40,900,700,200,0.7777777777777778,11,7,4,327.72937045995513,0.4431089743589744,0.10876888525928918,0.18622023857457795,130156.27170138899,531.206597222227,130687.47829861123,1519,2,337.85,39,1,18,36.53532053899549,0.6164529914529915,44.895833333333336,1020.4166666666675,26.164529914529936,0
4676,4,1,1,39,0.025,0.025,0.975,40,1000,700,300,0.7,13,7,6,321.5603611106291,0.44302884615384613,0.1293121471879577,0.18463663951886441,130562.68376981532,396.84355367450434,130959.52732348983,1520,0,337.05,38,2,15,36.2819273120078,0.6222587719298245,44.49786324786326,1022.0085470085481,26.894961763382845,0
4677,4,0,0,39,0.0,0.0,1.0,39,1400,1100,300,0.7857142857142857,17,11,6,328.67143194706983,0.4403115159694107,0.13482441471571915,0.18898607336956533,130617.28395061739,786.0339506172954,131403.3179012347,1521,1,346.4102564102564,38,1,16,36.04506340579708,0.6228070175438596,44.44444444444445,1022.2222222222231,26.90058479532166,0
4678,4,0,0,39,0.0,0.0,1.0,39,1100,800,300,0.7272727272727273,14,8,6,330.51071531948696,0.4397210976158345,0.1389500409763622,0.19085100051078216,130781.15297866902,844.9144842574324,131626.06746292647,1522,2,347.4102564102564,38,1,16,35.83250644105562,0.6244517543859649,44.284188034188034,1022.863247863248,26.917453891138106,0
4679,4,0,1,38,0.0,0.02564102564102564,0.9743589743589743,39,950,700,250,0.7368421052631579,12,7,5,329.30863915914637,0.4387932973459289,0.13799078321773206,0.19101456247802687,130954.69292534741,824.9023437500196,131779.59526909742,1523,3,348.4102564102564,39,0,17,35.68805549901623,0.624465811965812,44.11458333333334,1023.5416666666681,26.24465811965816,0
4680,4,0,1,37,0.0,0.02631578947368421,0.9736842105263158,38,1100,900,200,0.8181818181818182,13,9,4,335.4284137872336,0.4384186818397345,0.12729830422789012,0.1942402265570814,130890.45606874154,1180.8756118051251,132071.33168054666,1524,4,346.7631578947368,38,0,18,35.59633187165033,0.6255482456140351,44.17735042735044,1023.2905982906,26.928699955015787,0
4681,4,0,0,37,0.0,0.0,1.0,37,900,500,400,0.5555555555555556,13,5,8,341.43889239266633,0.43502877877877877,0.1210857159410208,0.1973745270150917,130822.8553497231,1533.6021660510996,132356.4575157742,1525,5,356.94594594594594,37,0,18,35.51089674883885,0.6266891891891893,44.24342105263158,1023.0263157894746,27.649359886202014,0
4682,4,0,1,36,0.0,0.02702702702702703,0.972972972972973,37,1300,600,700,0.46153846153846156,20,6,14,342.4171529454103,0.4338088088088088,0.12191407177479663,0.19851687612375507,130935.05333371792,1566.8816366574185,132501.93497037535,1526,6,357.94594594594594,37,0,18,35.37247339475753,0.6278153153153153,44.133771929824555,1023.4649122807006,27.66121384542434,0
4683,4,0,0,36,0.0,0.0,1.0,36,550,200,350,0.36363636363636365,9,2,7,348.1977386734976,0.4318948412698413,0.14104092537568969,0.20166174960650549,130895.62694028486,1915.512260571384,132811.13920085624,1527,7,368.25,36,0,18,35.26443454018563,0.6293402777777778,44.1722972972973,1023.3108108108106,28.425300300300293,0
4684,4,0,1,35,0.0,0.027777777777777776,0.9722222222222222,36,1300,1000,300,0.7692307692307693,16,10,6,320.4063216868179,0.4313988095238095,0.066700448375407,0.17989293480181676,129688.42734203795,1110.5983940021024,130799.02573604004,1528,8,369.25,36,0,15,37.19573429150544,0.6171875,45.354729729729726,1018.5810810810808,28.293918918918912,8
4685,4,0,0,35,0.0,0.0,1.0,35,1100,900,200,0.8181818181818182,13,9,4,328.65289256198383,0.4281162464985995,0.07574025974026055,0.18444805194805183,129672.49657064448,1523.4482167352312,131195.9447873797,1529,9,380.37142857142857,35,0,15,37.00189393939395,0.6190476190476191,45.37037037037036,1018.5185185185165,29.100529100529045,0
4686,4,0,0,35,0.0,0.0,1.0,35,1100,700,400,0.6363636363636364,15,7,8,329.60713238857835,0.42825630252100844,0.0752299829642249,0.18568079338972687,129819.89354263114,1557.91256751543,131377.80611014657,1530,10,381.37142857142857,35,0,15,36.82815161839865,0.6205357142857143,45.22569444444444,1019.097222222222,29.117063492063483,0
4687,4,0,0,35,0.0,0.0,1.0,35,650,400,250,0.6153846153846154,9,4,5,354.9744036832082,0.42808123249299723,0.05600174522998458,0.1928460177763338,128385.7160572562,2199.3941572578055,130585.110214514,1531,11,382.37142857142857,34,1,17,37.64316339715729,0.6081495098039216,46.63690476190476,1013.4523809523806,29.807422969187666,8
4688,4,1,0,36,0.027777777777777776,0.0,1.0,36,600,300,300,0.5,9,3,6,346.88344598155754,0.4302414021164021,0.05937713894592789,0.18981150358766125,128672.41753472216,1726.8663194444403,130399.2838541666,1532,0,372.72222222222223,35,1,18,37.555612594113626,0.6089285714285715,46.354166666666664,1014.5833333333328,28.988095238095223,0
4689,4,0,0,36,0.0,0.0,1.0,36,850,700,150,0.8235294117647058,10,7,3,346.8415994561752,0.42943121693121694,0.04931197019804623,0.19020975519894945,128760.50407503865,1731.8998360339576,130492.40391107262,1533,1,373.72222222222223,35,1,18,37.46685768046528,0.6098214285714285,46.267361111111114,1014.9305555555561,28.998015873015888,0
4690,4,0,0,36,0.0,0.0,1.0,36,1150,800,350,0.6956521739130435,15,8,7,340.82061119848663,0.42772817460317464,0.05821909371959255,0.18804542713281644,129001.10995708557,1593.2474281714249,130594.357385257,1534,2,374.72222222222223,36,0,19,37.37459815984924,0.6102430555555556,46.03040540540541,1015.8783783783792,28.218843843843867,0
4691,4,1,0,37,0.02702702702702703,0.0,1.0,37,1000,800,200,0.8,12,8,4,372.282621989914,0.43105605605605607,0.11626043876458825,0.1907552632966545,126013.95266439904,2123.6754508231247,128137.62811522216,1535,0,365.56756756756755,34,3,17,39.64335823255078,0.5839460784313726,48.988095238095234,1004.0476190476186,29.530812324929958,8
4692,4,2,1,38,0.05128205128205128,0.02564102564102564,0.9743589743589743,39,1100,800,300,0.7272727272727273,14,8,6,362.6416554688847,0.4362629329734593,0.12453310842212217,0.18866653763567467,126638.21549590128,1384.8584226118014,128023.07391851308,1536,0,347.7692307692308,36,3,18,39.241860595211456,0.5862268518518519,48.36711711711712,1006.5315315315314,27.959209209209206,0
4693,4,1,1,38,0.02564102564102564,0.02564102564102564,0.9743589743589743,39,1300,1000,300,0.7692307692307693,16,10,6,365.31432237839135,0.43960863697705804,0.12703923641249082,0.19178466273366468,127006.86486740128,1479.4853552877285,128486.35022268901,1537,0,310.35897435897436,36,3,19,38.795246341190925,0.5899884259259259,48.00112612612613,1007.9954954954962,27.999874874874894,0
4694,4,4,3,39,0.09523809523809523,0.07142857142857142,0.9285714285714286,42,1200,800,400,0.6666666666666666,16,8,8,350.3022870534807,0.44506145954316684,0.14854739023077812,0.1881459078904941,127928.27641034777,562.742094672107,128491.01850501988,1538,0,288.2857142857143,38,4,18,38.2291336642377,0.5956688596491229,47.08867521367522,1011.6452991452995,26.62224471434999,0
4695,4,1,1,39,0.025,0.025,0.975,40,1300,1000,300,0.7692307692307693,16,10,6,360.3067967302543,0.443883547008547,0.1491412937479688,0.19389337766900924,128005.79415060367,1224.2715306632413,129230.06568126692,1539,0,298.4,37,3,19,37.89673402679957,0.5982545045045045,47.01206140350875,1011.9517543859621,27.350047415836812,0
4696,4,0,0,39,0.0,0.0,1.0,39,1700,1100,600,0.6470588235294118,23,11,12,372.677588810002,0.44244826810616283,0.15819953670420994,0.2008169165602099,128059.030314098,1744.9461285610093,129803.97644265901,1540,1,306.97435897435895,36,3,19,37.52920560747664,0.6006944444444444,46.95945945945947,1012.1621621621631,28.115615615615642,0
4697,4,0,0,39,0.0,0.0,1.0,39,700,300,400,0.42857142857142855,11,3,8,372.50362224248687,0.4421108861898336,0.1611363052964836,0.20100885738054966,128116.02776763252,1744.7368821524283,129860.76464978495,1541,2,307.97435897435895,36,3,21,37.47520393029291,0.6012731481481481,46.903153153153156,1012.3873873873875,28.121871871871875,0
4698,4,2,1,40,0.04878048780487805,0.024390243902439025,0.975609756097561,41,1100,900,200,0.8181818181818182,13,9,4,352.91247687862113,0.44443597560975606,0.15926333938736104,0.19331880420384548,128715.26668137748,885.0510561237087,129600.31773750119,1542,0,293.9024390243902,36,5,18,37.35896866792439,0.607349537037037,46.311936936936945,1014.7522522522536,28.1875625625626,0
4699,4,0,1,39,0.0,0.025,0.975,40,750,500,250,0.6666666666666666,10,5,5,362.33479206473635,0.44314903846153847,0.1636441451723356,0.19768228194714924,128555.01570001707,1315.990976508911,129871.00667652598,1543,1,302.25,35,5,18,37.2836300692384,0.6077380952380953,46.469907407407405,1014.1203703703698,28.974867724867707,0
4700,4,0,0,39,0.0,0.0,1.0,39,950,700,250,0.7368421052631579,12,7,5,367.6441091243959,0.44253261358524515,0.157730036019875,0.20052302862902396,128543.9128951587,1651.6824679409165,130195.59536309962,1544,2,310.0,36,3,18,37.160373866370534,0.6056134259259259,46.48085585585586,1014.0765765765768,28.1687937937938,0
4701,4,1,1,39,0.025,0.025,0.975,40,900,600,300,0.6666666666666666,12,6,6,394.4045034365176,0.4433627136752137,0.05866788321167893,0.21613366788321162,128731.13854595338,2167.5187371430507,130898.65728309643,1545,0,303.225,35,5,17,36.29010796836983,0.6095238095238096,46.2962962962963,1014.814814814815,28.994708994709,8
4702,4,2,0,41,0.04878048780487805,0.0,1.0,41,1000,500,500,0.5,15,5,10,380.5979818819284,0.44435975609756095,0.09844345342986927,0.21184773038380417,129348.51794249397,1646.8143164866192,130995.33225898059,1546,0,296.6341463414634,35,6,19,36.009619031364956,0.6157738095238094,45.688657407407405,1017.2453703703701,29.064153439153433,0
4703,4,0,1,40,0.0,0.024390243902439025,0.975609756097561,41,1050,700,350,0.6666666666666666,14,7,7,367.0417606188275,0.44308943089430897,-0.01186469331612039,0.20438430670248403,129364.36760355037,1311.458619482854,130675.82622303323,1547,1,297.6341463414634,38,3,15,36.338216761184626,0.6101973684210527,45.67307692307693,1017.307692307693,26.771255060728762,8
4704,4,0,0,40,0.0,0.0,1.0,40,1450,1000,450,0.6896551724137931,19,10,9,369.1661548960255,0.44075854700854705,-0.010829752404337922,0.20665693000880628,129572.31445312513,1566.742621527792,131139.05707465293,1548,2,306.05,39,1,12,36.0723177136621,0.6105769230769231,45.46875000000001,1018.125000000001,26.10576923076926,0
4705,4,0,2,38,0.0,0.05,0.95,40,950,600,350,0.631578947368421,13,6,7,369.6454932858258,0.4399973290598291,-0.006492842535786858,0.20776626001927473,129731.44531250013,1590.9288194444587,131322.37413194458,1549,3,307.05,39,1,12,35.898091342876626,0.6121794871794872,45.31250000000001,1018.750000000001,26.121794871794897,0
4706,4,0,1,37,0.0,0.02631578947368421,0.9736842105263158,38,1300,900,400,0.6923076923076923,17,9,8,378.0909758421056,0.43664058795637745,0.003386170821692014,0.21190892532562663,129619.76431450054,2201.6126356186437,131821.3769501192,1550,4,323.7368421052632,37,1,13,35.796790316212636,0.6145833333333333,45.422149122807014,1018.3114035087714,27.52192982456139,0
4707,4,1,2,36,0.02631578947368421,0.05263157894736842,0.9473684210526316,38,1050,800,250,0.7619047619047619,13,8,5,378.45897976889233,0.43529220009483166,0.018051420226194548,0.21378563753895252,129927.00277970132,2234.4081832871507,132161.41096298848,1551,0,324.3421052631579,37,1,14,35.474474797447485,0.6176801801801801,45.12061403508771,1019.5175438596482,27.554528212422923,0
4708,4,0,0,36,0.0,0.0,1.0,36,1250,900,350,0.72,16,9,7,390.2597725076458,0.43053902116402115,0.025280826004617785,0.2208035146169411,129989.2928004533,2953.432698679631,132942.72549913294,1552,1,341.8888888888889,34,2,16,35.11022258541521,0.6243872549019608,45.059523809523796,1019.761904761903,29.9929971988795,8
4709,4,1,0,37,0.02702702702702703,0.0,1.0,37,1400,900,500,0.6428571428571429,19,9,10,377.3047184285982,0.4319632132132132,0.025291577558212763,0.21598744421853214,130444.94224773225,2443.7854308389806,132888.72767857125,1553,0,333.6216216216216,34,3,17,34.97722681894106,0.6289828431372548,44.61309523809523,1021.5476190476177,30.04551820728287,0
4710,4,1,1,37,0.02631578947368421,0.02631578947368421,0.9736842105263158,38,1300,1000,300,0.7692307692307693,16,10,6,376.5163513246887,0.43292140825035563,0.04929560699214952,0.2183301045747028,130942.84664619756,2260.424570258898,133203.27121645646,1554,0,325.8157894736842,35,3,17,34.492088846168336,0.6318452380952381,44.1261574074074,1023.4953703703692,29.242724867724835,0
4711,4,0,1,36,0.0,0.02702702702702703,0.972972972972973,37,1100,900,200,0.8181818181818182,13,9,4,386.5736299057759,0.4306493993993994,0.05276480669150829,0.22374413124849407,130870.93431122422,2718.2504251700357,133589.18473639427,1555,1,335.5945945945946,34,3,17,34.30773705642816,0.6332720588235294,44.196428571428555,1023.2142857142835,30.094537815125985,0
4712,4,0,0,36,0.0,0.0,1.0,36,950,700,250,0.7368421052631579,12,7,5,392.6466080180007,0.42792658730158734,0.06866108462224307,0.2279789454656842,130992.77388038531,3086.773667800433,134079.54754818574,1556,2,345.44444444444446,34,2,17,34.028666123967895,0.6344975490196079,44.07738095238094,1023.6904761904748,30.108543417366906,0
4713,4,0,0,36,0.0,0.0,1.0,36,1000,700,300,0.7,13,7,6,394.2452642008576,0.4271660052910053,0.07296061884669514,0.22949224326639375,131090.9636488339,3136.3983196158974,134227.36196844978,1557,3,346.44444444444446,35,1,17,33.88807263411694,0.6333333333333333,43.981481481481474,1024.074074074073,29.259259259259228,0
4714,4,0,1,35,0.0,0.027777777777777776,0.9722222222222222,36,1050,700,350,0.6666666666666666,14,7,7,394.77873138327783,0.42666997354497355,0.07507753544028861,0.22998005227193036,131120.59709630045,3152.7245959790694,134273.3216922795,1558,4,347.44444444444446,35,1,17,33.84433740158964,0.6336309523809525,43.95254629629629,1024.1898148148139,29.26256613756611,0
4715,4,2,1,36,0.05405405405405406,0.02702702702702703,0.972972972972973,37,1000,700,300,0.7,13,7,6,386.18843567810285,0.4259884884884885,0.09083213143537949,0.2280098846263865,131633.36167800435,2767.3846059128177,134400.74628391716,1559,0,337.64864864864865,34,3,19,33.54480858468678,0.6409313725490196,43.45238095238094,1026.1904761904748,30.182072829131613,0
4716,4,0,1,35,0.0,0.027777777777777776,0.9722222222222222,36,950,600,350,0.631578947368421,13,6,7,394.6618275803611,0.4224702380952381,0.10158436459618314,0.23364538018662076,131736.6836823577,3198.288068291042,134934.97175064872,1560,1,347.3611111111111,33,3,19,33.222787593012626,0.6442550505050505,43.35171568627451,1026.5931372549016,31.108882947118232,0
4717,4,0,0,35,0.0,0.0,1.0,35,950,700,250,0.7368421052631579,12,7,5,397.39103126015397,0.4216736694677871,0.09108987421825576,0.23553818266819065,131781.4827568617,3473.755866748308,135255.23862361,1561,2,344.85714285714283,32,3,19,33.10737415969831,0.6471354166666667,43.30808080808082,1026.767676767678,32.08648989898994,0
4718,4,1,0,36,0.027777777777777776,0.0,1.0,36,1100,800,300,0.7272727272727273,14,8,6,388.038443192323,0.42323082010582014,0.08618097773539435,0.2320209907298929,132114.37795859767,3053.0915092752784,135167.46946787296,1562,0,336.25,33,3,20,33.01086243890809,0.6480429292929293,42.98406862745098,1028.0637254901962,31.153446226975642,0
4719,4,0,0,36,0.0,0.0,1.0,36,1550,1500,50,0.967741935483871,16,15,1,391.1710367402431,0.42318121693121696,0.08913250714966625,0.23447909573743703,132208.8860053825,3143.2574009996124,135352.1434063821,1563,1,337.25,33,3,20,32.83484270734033,0.648989898989899,42.8921568627451,1028.4313725490192,31.164587046939975,0
4720,4,0,1,35,0.0,0.027777777777777776,0.9722222222222222,36,900,400,500,0.4444444444444444,14,4,10,389.62533461219437,0.4225033068783069,0.09239741706694216,0.23452931431817908,132366.4745080018,3114.666384323344,135481.14089232514,1564,2,338.25,33,3,21,32.715429121511654,0.6505681818181819,42.7389705882353,1029.0441176470592,31.183155080213915,0
4721,4,0,1,34,0.0,0.02857142857142857,0.9714285714285714,35,850,800,50,0.9411764705882353,9,8,1,396.17105672933496,0.4197478991596639,0.09971081550028948,0.23866890490767267,132398.00347222228,3490.458898019998,135888.46237024228,1565,3,348.14285714285717,30,5,21,32.515182186234824,0.6586805555555555,42.708333333333336,1029.166666666667,34.305555555555564,0
4722,4,1,0,35,0.02857142857142857,0.0,1.0,35,950,600,350,0.631578947368421,13,6,7,386.0426168930837,0.42023809523809524,0.10206631090893192,0.2354023873735643,132853.20255905003,3257.399595704513,136110.60215475454,1566,0,344.9714285714286,32,3,18,32.31679934680547,0.6578776041666667,42.26641414141414,1030.934343434343,32.21669823232322,0
4723,4,0,0,35,0.0,0.0,1.0,35,1150,800,350,0.6956521739130435,15,8,7,385.68503312798106,0.4200980392156863,0.0984838151198788,0.23600457195673974,132983.402921258,3257.9416322314055,136241.3445534894,1567,1,345.9714285714286,32,3,19,32.19488309462604,0.6591796875,42.140151515151516,1031.4393939393938,32.232481060606055,0
4724,4,0,0,35,0.0,0.0,1.0,35,800,500,300,0.625,11,5,6,383.09115286736665,0.4194327731092437,0.04680178439706384,0.2274498859432965,131846.31191970222,3102.7278785328162,134949.03979823503,1568,2,346.9714285714286,32,3,19,33.40889066469961,0.6477864583333333,43.2449494949495,1027.020202020203,32.09438131313134,8
4725,4,1,0,36,0.027777777777777776,0.0,1.0,36,700,500,200,0.7142857142857143,9,5,4,370.4352296125826,0.42076719576719573,0.03747070273705955,0.22186452617267527,132177.37956855536,2592.6315900134546,134770.0111585688,1569,0,338.30555555555554,33,3,21,33.399748738728,0.6486742424242424,42.92279411764706,1028.3088235294117,31.160873440285204,0
4726,4,0,1,35,0.0,0.027777777777777776,0.9722222222222222,36,950,600,350,0.631578947368421,13,6,7,391.39675140736495,0.4204034391534392,0.0017232202262140728,0.2266409760229886,130888.84833958093,3067.0134383410236,133955.86177792196,1570,1,339.30555555555554,33,3,18,34.16616766467066,0.6357323232323233,44.17892156862745,1023.2843137254903,31.0086155674391,8
4727,4,0,1,34,0.0,0.02857142857142857,0.9714285714285714,35,1050,600,450,0.5714285714285714,15,6,9,411.8084721079076,0.4184873949579832,0.03511775741789802,0.23523771644153818,130362.29663425016,3738.33142918194,134100.6280634321,1571,2,349.8857142857143,31,4,18,34.18029346763569,0.6354166666666667,44.694010416666664,1021.2239583333328,32.942708333333314,6
4728,4,0,1,33,0.0,0.029411764705882353,0.9705882352941176,34,600,500,100,0.8333333333333334,7,5,2,417.74259116449684,0.4168523469994058,0.04367623826781908,0.23822618036678064,130296.8912591051,4086.1121950514485,134383.00345415654,1572,10,361.11764705882354,30,4,18,34.09552176584166,0.6375,44.75806451612903,1020.9677419354839,34.03225806451613,0
4729,4,0,1,32,0.0,0.030303030303030304,0.9696969696969697,33,950,800,150,0.8421052631578947,11,8,3,424.5637973341443,0.4159169823232323,0.0591615390140543,0.24168946603864253,130228.28686842411,4458.043198635686,134686.3300670598,1573,11,372.6666666666667,30,3,19,33.991473531735586,0.6368055555555556,44.825268817204304,1020.6989247311828,34.02329749103943,0
4730,4,0,1,31,0.0,0.03125,0.96875,32,700,600,100,0.8571428571428571,8,6,2,427.92049340471874,0.4138734879032258,0.0867120563035495,0.24448324693122733,130368.94531249999,4757.513196973638,135126.45850947362,1574,12,384.03125,29,3,20,33.762154902760784,0.6411637931034483,44.6875,1021.2499999999999,35.21551724137931,0
4731,4,0,0,31,0.0,0.0,1.0,31,1250,1000,250,0.8,15,10,5,437.5390977477559,0.4114247311827957,0.10024241213694918,0.24953072460638456,130299.25724996685,5202.203890870641,135501.4611408375,1575,16,397.03225806451616,28,3,20,33.587813115676894,0.6436011904761905,44.75574712643677,1020.9770114942519,36.463464696223284,0
4732,4,1,0,32,0.03125,0.0,1.0,32,950,800,150,0.8421052631578947,11,8,3,419.5856220588205,0.41561659946236557,0.0904882016563695,0.24161906336119957,130674.53833174356,4565.831490634758,135240.36982237833,1576,0,385.59375,30,2,17,33.6633473555059,0.6413194444444444,44.388440860215056,1022.4462365591398,34.081541218637994,0
4733,4,0,0,32,0.0,0.0,1.0,32,650,400,250,0.6153846153846154,9,4,5,418.4779832958531,0.415070564516129,0.08413145617032458,0.2414100814934152,130743.26014929471,4542.635167360386,135285.8953166551,1577,1,386.59375,30,2,17,33.62164322950892,0.6420138888888889,44.321236559139784,1022.7150537634408,34.090501792114694,0
4734,4,1,0,33,0.030303030303030304,0.0,1.0,33,1250,1100,150,0.88,14,11,3,412.10393158198127,0.41508838383838387,0.08919179084363327,0.24095527054607663,131261.40170627163,4218.667941623256,135480.06964789488,1578,0,375.8484848484849,31,2,22,33.25762388818299,0.644489247311828,43.815104166666664,1024.7395833333328,33.056115591397834,0
4735,4,0,0,33,0.0,0.0,1.0,33,1000,600,400,0.6,14,6,8,408.81750280917436,0.41508838383838387,0.08351810790835157,0.23945025164537356,131328.125,4137.864176432291,135465.98917643228,1579,1,376.8484848484849,30,3,22,33.2740514905149,0.6479166666666667,43.75,1025.0,34.166666666666664,0
4736,4,0,0,33,0.0,0.0,1.0,33,1200,900,300,0.75,15,9,6,405.54575861197355,0.41303661616161613,0.0788255796507662,0.23857236300123355,131495.00740898988,4065.4485066731813,135560.45591566307,1580,2,377.8484848484849,31,2,22,33.18852883923659,0.6468413978494624,43.587239583333336,1025.6510416666672,33.085517473118294,0
4737,4,0,0,33,0.0,0.0,1.0,33,600,300,300,0.5,9,3,6,407.0680284383157,0.4124842171717172,0.07537489375286022,0.23988698549480117,131561.79004245342,4110.919698079437,135672.70974053285,1581,3,378.8484848484849,31,2,16,33.081741549265985,0.647513440860215,43.52213541666667,1025.911458333334,33.09391801075271,0
4738,4,0,0,33,0.0,0.0,1.0,33,850,700,150,0.8235294117647058,10,7,3,404.58935535523733,0.41224747474747475,0.07241812875615694,0.23884409809397944,131628.58963012695,4051.1052449544263,135679.6948750814,1582,4,379.8484848484849,31,2,17,33.07757581525187,0.6481854838709677,43.45703125,1026.171875,33.102318548387096,0
4739,4,0,0,33,0.0,0.0,1.0,33,700,300,400,0.42857142857142855,11,3,8,401.1948207974526,0.41118213383838387,0.06798205175487126,0.23830005620860725,131862.52170138882,3980.512152777773,135843.0338541666,1583,5,380.8484848484849,31,2,18,32.927653820148755,0.6505376344086021,43.229166666666664,1027.0833333333328,33.13172043010751,0
4740,4,0,1,32,0.0,0.030303030303030304,0.9696969696969697,33,600,300,300,0.5,9,3,6,400.5273705044356,0.41114267676767674,0.06429358869465296,0.23811306902106208,131895.95752292217,3965.588209364154,135861.54573228632,1584,6,381.8484848484849,31,2,18,32.91093611357585,0.6508736559139785,43.196614583333336,1027.2135416666672,33.13592069892475,0
4741,4,0,0,32,0.0,0.0,1.0,32,950,700,250,0.7368421052631579,12,7,5,411.22318945327106,0.4085181451612903,0.0665376685430028,0.243703176433944,131776.255293242,4437.890399179096,136214.1456924211,1585,9,394.59375,30,2,18,32.75761443469911,0.6524305555555556,43.31317204301075,1026.747311827957,34.22491039426523,0
4742,4,0,0,32,0.0,0.0,1.0,32,1150,900,250,0.782608695652174,14,9,5,409.9937116614946,0.40795110887096775,0.06668738550117759,0.24363700968251484,131879.77837033186,4413.975965429527,136293.7543357614,1586,10,395.59375,30,2,18,32.68423405740207,0.6534722222222222,43.21236559139785,1027.1505376344087,34.23835125448029,0
4743,4,0,1,31,0.0,0.03125,0.96875,32,1100,1000,100,0.9090909090909091,12,10,2,407.9019209222531,0.40685903897849457,0.06749313546025126,0.24372139775104606,132086.94646779966,4375.703838594053,136462.6503063937,1587,11,396.59375,30,2,19,32.52811192468621,0.6555555555555556,43.01075268817204,1027.9569892473112,34.265232974910376,0
4744,4,0,0,31,0.0,0.0,1.0,31,850,500,350,0.5882352941176471,12,5,7,421.346338649848,0.40161290322580645,0.07452620014038502,0.25121205154474013,132005.21074459868,4923.982445987642,136929.19319058632,1588,29,410.03225806451616,29,2,19,32.265480695589495,0.6576867816091954,43.09027777777777,1027.6388888888882,35.43582375478925,0
4745,4,0,0,31,0.0,0.0,1.0,31,1100,700,400,0.6363636363636364,15,7,8,420.6046095898048,0.40174731182795703,0.06803740924423196,0.25147942812469576,132112.27816358022,4913.40663580246,137025.6847993827,1589,30,411.03225806451616,29,2,19,32.175988471584255,0.6587643678160919,42.98611111111111,1028.0555555555552,35.450191570881216,0
4746,4,0,0,31,0.0,0.0,1.0,31,800,600,200,0.75,10,6,4,422.06002568660614,0.40098566308243727,0.07566814053277016,0.2530651409076372,132219.38898533958,4960.903742283964,137180.29272762354,1590,31,412.03225806451616,29,2,19,32.03001913121764,0.6598419540229885,42.88194444444445,1028.4722222222229,35.4645593869732,0
4747,4,0,0,31,0.0,0.0,1.0,31,1050,700,350,0.6666666666666666,14,7,7,408.0169410813752,0.40129928315412183,0.05894283849803372,0.2254570952380165,129060.22376543198,4337.659143518504,133397.88290895047,1591,32,413.03225806451616,29,2,20,35.6074585383634,0.6278735632183908,45.972222222222214,1016.1111111111102,35.03831417624518,7
4748,4,0,0,31,0.0,0.0,1.0,31,850,600,250,0.7058823529411765,11,6,5,413.2360946783774,0.4012544802867384,0.071373196081439,0.2240689932189866,128309.37915378161,4404.413350423196,132713.79250420482,1592,33,414.03225806451616,31,0,19,36.24547508889174,0.6145833333333333,46.71223958333334,1013.1510416666679,32.68229166666671,8
4749,4,1,0,32,0.03125,0.0,1.0,32,650,400,250,0.6153846153846154,9,4,5,404.58874346684075,0.40538894489247307,0.08532801418439706,0.2216550600710977,128720.46100206631,4015.7699150597136,132736.23091712603,1593,0,402.0625,32,0,17,36.04267761602588,0.6162109375,46.306818181818194,1014.7727272727288,31.711647727272776,0
4750,4,1,0,33,0.030303030303030304,0.0,1.0,33,1100,900,200,0.8181818181818182,13,9,4,396.73474872346105,0.4078282828282828,0.09736711376055607,0.22000745156482854,129201.38888888898,3651.736111111117,132853.1250000001,1594,0,390.8484848484849,33,0,20,35.749658469945324,0.6186868686868687,45.833333333333336,1016.6666666666674,30.80808080808083,0
4751,4,2,0,35,0.05714285714285714,0.0,1.0,35,1500,1300,200,0.8666666666666667,17,13,4,389.02210467027464,0.4144607843137255,0.13090484832771643,0.22098059760136216,130144.4615912208,3125.814471879282,133270.2760631001,1595,0,369.45714285714286,35,0,20,34.98374168179069,0.6238095238095238,44.907407407407405,1020.3703703703699,29.153439153439137,0
4752,4,1,0,36,0.027777777777777776,0.0,1.0,36,950,800,150,0.8421052631578947,11,8,3,380.45763402243426,0.4148148148148148,0.1290075903477963,0.21792988549747128,130469.4348663625,2727.6720839763593,133197.10695033887,1596,0,360.1666666666667,35,1,21,34.8718184736226,0.6270833333333333,44.58912037037038,1021.6435185185201,29.18981481481486,0
4753,4,0,1,35,0.0,0.027777777777777776,0.9722222222222222,36,1000,800,200,0.8,12,8,4,383.2553480450683,0.414781746031746,0.13537773247253404,0.21986754177322354,130528.5644531251,2805.1540798611254,133333.71853298624,1597,1,361.1666666666667,35,1,16,34.74027353041116,0.6276785714285714,44.53125000000001,1021.8750000000008,29.196428571428594,0
4754,4,0,0,35,0.0,0.0,1.0,35,650,400,250,0.6153846153846154,9,4,5,393.8494049720037,0.41362044817927174,0.1405655663990939,0.22492944046936414,130353.74858276651,3267.949263038556,133621.69784580506,1598,3,372.45714285714286,34,1,20,34.64749941711355,0.6280637254901961,44.702380952380956,1021.1904761904767,30.035014005602257,0
4755,4,0,1,34,0.0,0.02857142857142857,0.9714285714285714,35,900,500,400,0.5555555555555556,13,5,8,392.2888796042246,0.4134103641456583,0.14015381030062923,0.2247411992498972,130475.3472222224,3236.8055555555757,133712.15277777796,1599,4,373.45714285714286,34,1,21,34.563621533442095,0.6292892156862745,44.58333333333334,1021.666666666668,30.049019607843178,0
4756,4,0,0,34,0.0,0.0,1.0,34,1600,1300,300,0.8125,19,13,6,394.19744779715774,0.4135286690433749,0.12345887995485949,0.22641919522233458,130575.52984429078,3494.5081218762143,134070.037966167,1600,5,372.11764705882354,33,1,18,34.41296962430056,0.6325757575757576,44.485294117647065,1022.0588235294127,30.971479500891295,0
4757,4,0,0,34,0.0,0.0,1.0,34,1200,800,400,0.6666666666666666,16,8,8,394.6470592664663,0.41312017231134873,0.12804800654378257,0.22704453575178368,130638.16350682439,3511.1934111880146,134149.3569180124,1601,6,373.11764705882354,33,1,18,34.33778869975225,0.6332070707070707,44.42401960784314,1022.3039215686282,30.978906714200853,0
4758,4,0,0,34,0.0,0.0,1.0,34,900,800,100,0.8888888888888888,10,8,2,396.75193346659455,0.41286021984551396,0.12020552289931086,0.22899665537428757,130763.47588667824,3576.132376970402,134339.60826364864,1602,7,374.11764705882354,33,1,19,34.15658199536704,0.634469696969697,44.3014705882353,1022.7941176470591,30.993761140819974,0
4759,4,0,0,34,0.0,0.0,1.0,34,850,600,250,0.7058823529411765,11,6,5,397.69715658503367,0.4130087641117053,0.12147234941880969,0.23028926889632673,130888.8483395809,3610.824562668206,134499.67290224912,1603,8,375.11764705882354,33,1,19,34.00499001996008,0.6357323232323233,44.17892156862745,1023.28431372549,31.008615567439094,0
4760,4,0,0,34,0.0,0.0,1.0,34,850,500,350,0.5882352941176471,12,5,7,392.2400022006041,0.4116904337492573,0.1293761516188472,0.2240781606556533,130365.51371545841,3512.067424039656,133877.58113949807,1604,9,376.11764705882354,30,4,21,34.6766144599456,0.6381944444444445,44.69086021505376,1021.2365591397847,34.04121863799283,8
4761,4,0,0,34,0.0,0.0,1.0,34,750,500,250,0.6666666666666666,10,5,5,407.22182189202914,0.41213606654783125,0.10846343768544875,0.22166671240482066,128464.33280086228,3662.6959302622304,132127.0287311245,1605,10,377.11764705882354,32,2,17,36.23868684352554,0.6136067708333333,46.55934343434344,1013.7626262626272,31.6800820707071,8
4762,4,1,0,35,0.02857142857142857,0.0,1.0,35,1000,700,300,0.7,13,7,6,396.1794722876281,0.4158263305322129,0.11246464785817789,0.21763599127524608,128827.88470780471,3207.7926758938925,132035.6773836986,1606,0,367.3142857142857,33,2,19,36.1459842266216,0.6148989898989898,46.200980392156865,1015.1960784313727,30.763517528223417,0
4763,4,0,0,35,0.0,0.0,1.0,35,1000,600,400,0.6,14,6,8,395.0834658310321,0.4157212885154062,0.11183062653011921,0.21737460809269163,128890.09785899671,3184.469314686677,132074.56717368338,1607,1,368.3142857142857,33,2,19,36.11010539866441,0.615530303030303,46.13970588235295,1015.4411764705897,30.770944741533018,0
4764,4,0,1,34,0.0,0.02857142857142857,0.9714285714285714,35,1150,700,450,0.6086956521739131,16,7,9,390.2624382706862,0.4157212885154062,0.11441663364972188,0.21590703139284873,129107.96215698296,3077.1976223087363,132185.1597792917,1608,2,369.3142857142857,33,2,19,36.00966176293259,0.617739898989899,45.92524509803922,1016.2990196078438,30.796939988116478,0
4765,4,0,1,33,0.0,0.029411764705882353,0.9705882352941176,34,850,600,250,0.7058823529411765,11,6,5,400.26522030836827,0.4142713903743316,0.12256607414337495,0.22124550089572467,129073.05377002367,3532.6908606264924,132605.74463065018,1609,3,380.7647058823529,32,2,19,35.79124213055003,0.6197916666666667,45.95959595959597,1016.1616161616178,31.755050505050555,0
4766,4,2,0,35,0.05714285714285714,0.0,1.0,35,800,500,300,0.625,11,5,6,387.6683902375652,0.41750700280112046,0.12691169958373938,0.21727210335413244,129618.91842987972,3049.895259412321,132668.81368929203,1610,0,367.77142857142854,32,3,18,35.55383343666048,0.6253255208333333,45.42297979797981,1018.3080808080817,31.822127525252554,0
4767,4,0,0,35,0.0,0.0,1.0,35,750,400,350,0.5333333333333333,11,4,7,389.7089783936195,0.41673669467787117,0.13321764997521068,0.21895348451808655,129715.36705438224,3110.2486353433364,132825.6156897256,1611,1,368.77142857142854,32,3,18,35.40349735580895,0.6263020833333333,45.32828282828283,1018.6868686868689,31.833964646464654,0
4768,4,0,0,35,0.0,0.0,1.0,35,750,300,450,0.4,12,3,9,390.56950567294564,0.4167717086834734,0.13134360063728123,0.21979748331803825,129779.68606519731,3137.597566574827,132917.28363177215,1612,2,369.77142857142854,32,3,18,35.315985130111535,0.626953125,45.26515151515151,1018.939393939393,31.84185606060603,0
4769,4,0,1,34,0.0,0.02857142857142857,0.9714285714285714,35,1050,700,350,0.6666666666666666,14,7,7,411.97956755459074,0.4163165266106443,0.14294780316639577,0.22314030173914776,128265.0953089569,3568.519699546483,131833.61500850337,1613,3,370.77142857142854,34,1,18,36.32281505856543,0.6069240196078431,46.75595238095238,1012.9761904761903,29.793417366946773,8
4770,4,1,2,33,0.02857142857142857,0.05714285714285714,0.9428571428571428,35,800,400,400,0.5,12,4,8,415.47019124732753,0.4170868347338936,0.1886934083978422,0.2279471589816417,128778.12499999988,3700.6944444444307,132478.81944444432,1614,0,371.65714285714284,34,1,17,35.70744389709906,0.6121323529411764,46.24999999999999,1014.9999999999991,29.852941176470562,0
4771,4,1,0,34,0.029411764705882353,0.0,1.0,34,1050,800,250,0.7619047619047619,13,8,5,419.50960168013904,0.4178735888294712,0.2037544066221697,0.23208760018234753,129107.96215698268,4032.4059556420398,133140.36811262474,1615,0,366.88235294117646,33,1,18,35.26656517544916,0.617739898989899,45.925245098039206,1016.2990196078415,30.79693998811641,0
4772,4,0,0,34,0.0,0.0,1.0,34,750,600,150,0.8,9,6,3,422.2655200214998,0.41818924539512775,0.20660559305689552,0.23416542473919524,129201.3888888888,4111.525915513254,133312.91480440207,1616,1,367.88235294117646,31,3,18,35.10075136612023,0.6236559139784946,45.83333333333333,1016.666666666666,32.79569892473116,0
4773,4,0,0,34,0.0,0.0,1.0,34,850,600,250,0.7058823529411765,11,6,5,415.19289255252977,0.41796642899584074,0.2038451428237631,0.2309940567957996,129329.78777675742,3939.3617360473386,133269.14951280475,1617,2,368.88235294117646,32,2,18,35.149009020192,0.6223958333333333,45.707070707070706,1017.1717171717168,31.78661616161615,0
4774,4,1,0,35,0.02857142857142857,0.0,1.0,35,800,500,300,0.625,11,5,6,411.27339152284605,0.42195378151260504,0.1983903420523141,0.22461854460093905,128596.93877551022,3577.6998299319775,132174.6386054422,1618,0,359.3142857142857,34,1,16,35.99985328638498,0.6102941176470589,46.42857142857143,1014.2857142857144,29.831932773109248,8
4775,4,0,0,35,0.0,0.0,1.0,35,1300,1000,300,0.7692307692307693,16,10,6,411.0570139568508,0.4213235294117647,0.20151857997686928,0.22501213422955957,128687.5159438777,3579.5812074830114,132267.0971513607,1619,1,360.3142857142857,34,1,16,35.91238413704095,0.6112132352941176,46.33928571428572,1014.6428571428584,29.84243697478995,0
4776,4,0,0,35,0.0,0.0,1.0,35,650,400,250,0.6153846153846154,9,4,5,411.3041048468216,0.421218487394958,0.2024024527132302,0.22583323258395688,128808.33510487541,3595.8793934240502,132404.21449829947,1620,2,361.3142857142857,34,1,17,35.782172315390326,0.6124387254901961,46.2202380952381,1015.1190476190486,29.85644257703084,0
4777,4,0,0,35,0.0,0.0,1.0,35,1050,600,450,0.5714285714285714,15,6,9,411.2167386604616,0.4205532212885154,0.20552671244347676,0.2263018568241124,128898.98667800475,3601.084183673497,132500.07086167825,1621,3,362.3142857142857,34,1,17,35.691432200078154,0.6133578431372548,46.130952380952394,1015.4761904761922,29.866946778711537,0
4778,4,0,0,35,0.0,0.0,1.0,35,1100,600,500,0.5454545454545454,16,6,10,410.5481165855507,0.42048319327731093,0.20221686424218022,0.2262788456529666,128959.43877551034,3588.8109410430948,132548.24971655343,1622,4,363.3142857142857,34,1,17,35.646438896702605,0.6139705882352942,46.07142857142858,1015.7142857142868,29.873949579831965,0
4779,4,0,0,35,0.0,0.0,1.0,35,1400,1200,200,0.8571428571428571,16,12,4,411.6582568279959,0.41988795518207284,0.20580801740731425,0.2274112117816796,129050.14349489815,3624.911422902518,132675.05491780068,1623,5,364.3142857142857,34,1,17,35.525288029681704,0.6148897058823529,45.98214285714287,1016.07142857143,29.884453781512647,0
4780,4,1,1,35,0.027777777777777776,0.027777777777777776,0.9722222222222222,36,950,700,250,0.7368421052631579,12,7,5,401.99698203234976,0.4213955026455027,0.2033178082925131,0.22398516408272284,129388.3437259709,3202.9218917959474,132591.26561776685,1624,0,355.1666666666667,33,3,18,35.42469686019434,0.6205808080808081,45.649509803921575,1017.4019607843147,30.830362448009538,0
4781,4,0,0,35,0.0,0.0,1.0,35,1100,700,400,0.6363636363636364,15,7,8,409.6429385071023,0.41911764705882354,0.21804324707550515,0.22865111387584797,129458.25043362926,3606.3316243240542,133064.58205795332,1625,1,365.48571428571427,32,3,16,35.15870554177007,0.6236979166666667,45.58080808080808,1017.676767676768,31.802398989899,0
4782,4,0,1,34,0.0,0.02857142857142857,0.9714285714285714,35,700,200,500,0.2857142857142857,12,2,10,408.42134607000963,0.4186624649859944,0.21318840081180546,0.22828719383967022,129513.0553753364,3579.179282006915,133092.2346573433,1626,2,366.48571428571427,33,2,16,35.13373866281402,0.6218434343434344,45.52696078431372,1017.892156862745,30.845216874628637,0
4783,4,0,0,34,0.0,0.0,1.0,34,1100,600,500,0.5454545454545454,16,6,10,416.1915376644968,0.4165738265002971,0.22048424877952666,0.23249618746455364,129490.37606175388,3978.559745179059,133468.93580693295,1627,9,378.20588235294116,32,2,17,34.95921721870736,0.6240234375,45.54924242424242,1017.8030303030301,31.806344696969692,0
4784,4,1,0,35,0.02857142857142857,0.0,1.0,35,1050,700,350,0.6666666666666666,14,7,7,415.8763448132816,0.41939775910364147,0.24639725439725413,0.23600344720999114,130106.25608239621,3821.6228433775477,133927.87892577375,1628,0,368.37142857142857,33,2,18,34.337712712712715,0.6278409090909092,44.94485294117647,1020.2205882352943,30.915775401069524,0
4785,4,2,2,35,0.05405405405405406,0.05405405405405406,0.9459459459459459,37,850,500,350,0.5882352941176471,12,5,7,396.9181391742246,0.42292292292292294,0.23227187583623232,0.22792924580673685,130566.58340419493,2964.9429287646317,133531.52633295956,1629,0,349.4054054054054,34,3,15,34.35255290234907,0.6302083333333333,44.49404761904761,1022.0238095238088,30.05952380952379,0
4786,4,0,0,35,0.0,0.0,1.0,35,1050,800,250,0.7619047619047619,13,8,5,416.3102425898395,0.41862745098039217,0.2494167695896803,0.23681910521094166,130200.04325259523,3840.7223183391134,134040.76557093434,1630,2,370.37142857142857,33,2,19,34.230907780979834,0.6287878787878788,44.852941176470594,1020.5882352941184,30.92691622103389,0
4787,4,0,0,35,0.0,0.0,1.0,35,1300,1100,200,0.8461538461538461,15,11,4,418.59553535039856,0.4185924369747899,0.24503823534606095,0.239294649148366,130391.51178770045,3916.2759546462808,134307.78774234673,1631,3,371.37142857142857,32,3,19,33.97721185148558,0.6331380208333333,44.665404040404056,1021.3383838383855,31.916824494949548,0
4788,4,0,0,35,0.0,0.0,1.0,35,800,400,400,0.5,12,4,8,420.33135596494185,0.4179621848739496,0.24405953705175065,0.24068655351113583,130455.99819214895,3966.9493227732137,134422.94751492215,1632,4,372.37142857142857,32,3,19,33.867105425781745,0.6337890625,44.60227272727274,1021.5909090909107,31.92471590909096,0
4789,4,1,0,36,0.027777777777777776,0.0,1.0,36,1200,800,400,0.6666666666666666,16,8,8,411.56704844491304,0.42017195767195764,0.23782742481834873,0.2380220198072397,130840.48327664396,3569.9263038548706,134410.40958049885,1633,0,363.0,34,2,17,33.6993832906679,0.6329656862745099,44.226190476190474,1023.095238095238,30.09103641456582,0
4790,4,0,0,36,0.0,0.0,1.0,36,1200,1000,200,0.8333333333333334,14,10,4,419.5068071065076,0.41987433862433865,0.2285913724232831,0.2365449569291403,129856.32216274976,3696.0292480962785,133552.35141084602,1634,1,364.0,33,3,13,34.50049597210531,0.6253156565656566,45.18995098039215,1019.2401960784302,30.88606654783122,8
4791,4,0,1,35,0.0,0.027777777777777776,0.9722222222222222,36,1550,1100,450,0.7096774193548387,20,11,9,419.1799186390534,0.4197916666666666,0.2260283119658122,0.23692778010033438,129950.01922337545,3694.4876970395785,133644.50692041503,1635,2,365.0,33,3,14,34.41306089743589,0.6262626262626263,45.09803921568626,1019.6078431372536,30.897207367795563,0
4792,4,0,0,35,0.0,0.0,1.0,35,1250,1000,250,0.8,15,10,5,425.629851002781,0.4153011204481793,0.2403084596473235,0.24091186450942248,130004.92814827558,4066.7956394755456,134071.7237877511,1636,8,376.37142857142857,32,3,16,34.19251165861911,0.6292317708333333,45.04419191919191,1019.8232323232314,31.869476010100982,0
4793,4,0,0,35,0.0,0.0,1.0,35,550,300,250,0.5454545454545454,8,3,5,423.2915138307666,0.4150560224089636,0.23659321614260964,0.23978603427243556,130037.12153096613,4008.7220054075988,134045.84353637372,1637,9,377.37142857142857,32,3,16,34.21922711892382,0.6295572916666667,45.012626262626256,1019.9494949494942,31.873421717171695,0
4794,4,0,0,35,0.0,0.0,1.0,35,750,500,250,0.6666666666666666,10,5,5,426.5162926330284,0.41467086834733896,0.24460706331530413,0.2424124245471262,130165.9349173553,4103.578397612483,134269.5133149678,1638,10,378.37142857142857,32,3,16,34.00535139816877,0.630859375,44.88636363636363,1020.4545454545449,31.88920454545453,0
4795,4,0,0,35,0.0,0.0,1.0,35,900,700,200,0.7777777777777778,11,7,4,425.458997872129,0.4134103641456583,0.24100836050345253,0.24303531830379502,130362.29663425016,4092.798287327729,134455.0949215779,1639,11,379.37142857142857,31,4,18,33.831787368778954,0.6354166666666667,44.694010416666664,1021.2239583333328,32.942708333333314,0
4796,4,0,1,34,0.0,0.02857142857142857,0.9714285714285714,35,700,400,300,0.5714285714285714,10,4,6,427.6877388007202,0.4129201680672269,0.23958060288335514,0.24535770278567637,130528.56445312501,4165.093315972223,134693.65776909725,1640,12,380.37142857142857,31,4,15,33.605164797825346,0.6370967741935484,44.53125,1021.8750000000001,32.96370967741936,0
4797,4,0,0,34,0.0,0.0,1.0,34,850,600,250,0.7058823529411765,11,6,5,423.3104799895549,0.41185754604872254,0.17939173613682935,0.22991105832231012,128375.34798516164,4081.8181355794236,132457.16612074108,1641,13,378.3235294117647,31,3,14,35.92244314531671,0.615255376344086,46.647135416666664,1013.411458333333,32.690692204301065,8
4798,4,0,0,34,0.0,0.0,1.0,34,1150,800,350,0.6956521739130435,15,8,7,419.54470897466507,0.4104092394533571,0.17875452067619513,0.2293805493067799,128639.3928527831,3993.9953274196905,132633.3881802028,1642,14,379.3235294117647,31,3,15,35.74650772258589,0.6179435483870968,46.38671874999999,1014.4531249999992,32.72429435483868,0
4799,4,0,0,34,0.0,0.0,1.0,34,750,500,250,0.6666666666666666,10,5,5,416.2269114632045,0.41026069518716574,0.18531864317247115,0.22832433320588852,128771.51701185423,3919.634162055104,132691.15117390934,1643,15,380.3235294117647,31,3,16,35.695023519350016,0.6192876344086021,46.25651041666666,1014.9739583333321,32.741095430107485,0
4800,4,1,0,35,0.02857142857142857,0.0,1.0,35,1250,1000,250,0.8,15,10,5,405.8648226610137,0.4138305322128852,0.17885976897279865,0.22488765913584444,129169.29913082837,3485.0549369962114,132654.35406782458,1644,0,370.42857142857144,32,3,18,35.55044921955865,0.6207682291666667,45.86489898989898,1016.5404040404031,31.766887626262598,0
4801,4,1,0,36,0.027777777777777776,0.0,1.0,36,450,300,150,0.6666666666666666,6,3,3,397.18421560656566,0.41542658730158727,0.17440055662599074,0.22165441709656702,129450.69204152231,3083.154315647811,132533.8463571701,1645,0,361.1111111111111,33,3,13,35.48340157353886,0.6212121212121212,45.58823529411764,1017.6470588235279,30.83778966131903,0
4802,4,0,0,36,0.0,0.0,1.0,36,700,300,400,0.42857142857142855,11,3,8,393.4800503207173,0.41476521164021163,0.17462419087358927,0.22028519259194843,129575.43372741235,2997.0696366781776,132572.50336409052,1646,1,362.1111111111111,33,3,13,35.45026881720431,0.6224747474747474,45.46568627450979,1018.1372549019593,30.85264408793816,0
4803,4,0,0,36,0.0,0.0,1.0,36,1150,700,450,0.6086956521739131,16,7,9,396.1229498979781,0.4139384920634921,0.17990548001978657,0.22229424960176172,129669.02941476816,3072.9756884371145,132742.00510320527,1647,2,363.1111111111111,33,3,14,35.287445353547504,0.6234217171717171,45.37377450980391,1018.5049019607827,30.863784907902506,0
4804,4,1,0,37,0.02702702702702703,0.0,1.0,37,1150,1000,150,0.8695652173913043,13,10,3,388.08684252048744,0.4173861361361361,0.17999084899260032,0.21940355156356256,129958.94451530604,2687.071286848061,132646.01580215408,1648,0,354.27027027027026,34,3,15,35.19653629110722,0.6240808823529411,45.08928571428571,1019.6428571428565,29.98949579831931,0
4805,4,0,0,37,0.0,0.0,1.0,37,850,400,450,0.47058823529411764,13,4,9,391.42041605352756,0.4168230730730731,0.1849460058868253,0.22163243254002457,130019.64462868481,2778.468679138323,132798.11330782314,1649,1,355.27027027027026,34,3,15,35.04970623711141,0.6246936274509804,45.029761904761905,1019.8809523809524,29.996498599439775,0
4806,4,0,0,37,0.0,0.0,1.0,37,900,300,600,0.3333333333333333,15,3,12,390.2345251826221,0.4167605105105105,0.1841105811694046,0.22113289760348565,130049.99999999991,2749.999999999987,132799.9999999999,1650,2,356.27027027027026,34,3,15,35.04901960784313,0.625,44.99999999999999,1019.9999999999993,29.99999999999998,0
4807,4,0,0,37,0.0,0.0,1.0,37,1400,1100,300,0.7857142857142857,17,11,6,390.8562316250641,0.41638513513513514,0.1870286206378733,0.22252815408014454,130233.05047850218,2780.4798686128174,133013.53034711498,1651,3,357.27027027027026,35,2,16,34.846756056998146,0.624702380952381,44.82060185185185,1020.7175925925922,29.163359788359777,0
4808,4,1,0,38,0.02631578947368421,0.0,1.0,38,700,400,300,0.5714285714285714,10,4,6,386.34489857810274,0.41896337126600286,0.19207158991352258,0.22197864667164763,130587.70743580667,2490.382265946495,133078.08970175317,1652,0,348.8421052631579,35,3,12,34.60123900653003,0.6282738095238095,44.473379629629626,1022.1064814814808,29.20304232804231,0
4809,4,0,0,38,0.0,0.0,1.0,38,950,600,350,0.631578947368421,13,6,7,384.76080711013697,0.41788169748696063,0.1951704748516836,0.2219155673384576,130735.62349965703,2460.3888031550046,133196.01230281204,1653,1,349.8421052631579,35,3,13,34.49147427191791,0.6297619047619047,44.3287037037037,1022.6851851851849,29.21957671957671,0
4810,4,0,0,38,0.0,0.0,1.0,38,1000,600,400,0.6,14,6,8,383.0883063918672,0.417689070649597,0.19253080647755016,0.22112027195198736,130765.21675936627,2418.925084662195,133184.14184402846,1654,2,350.8421052631579,35,3,13,34.50419165629363,0.6300595238095238,44.29976851851851,1022.8009259259247,29.222883597883563,0
4811,4,0,0,38,0.0,0.0,1.0,38,950,500,450,0.5263157894736842,14,5,9,382.6548566419575,0.4174964438122333,0.19421545056918532,0.22128703835723645,130838.01442912506,2413.1603309390443,133251.1747600641,1655,3,351.8421052631579,36,2,13,34.441386901485956,0.6287615740740741,44.2286036036036,1023.0855855855855,28.419044044044043,0
4812,4,0,1,37,0.0,0.02631578947368421,0.9736842105263158,38,1150,600,550,0.5217391304347826,17,6,11,380.66638347003027,0.4174223565670934,0.1884083145156621,0.22096152143950018,130982.06948502547,2372.094138056963,133354.16362308242,1656,4,352.8421052631579,36,2,13,34.34612211221121,0.6302083333333333,44.08783783783783,1023.6486486486478,28.43468468468466,0
4813,4,0,1,36,0.0,0.02702702702702703,0.972972972972973,37,650,500,150,0.7692307692307693,8,5,3,390.23886420530397,0.41557182182182184,0.19703042030833018,0.22593986892200985,130883.62328800143,2815.175298996901,133698.79858699834,1657,5,363.0810810810811,35,2,13,34.201094333220226,0.63125,44.18402777777777,1023.263888888888,29.236111111111086,0
4814,4,0,0,36,0.0,0.0,1.0,36,1200,900,300,0.75,15,9,6,398.8445194369742,0.4120701058201058,0.20937560597246496,0.23084637337109692,130870.93431122434,3239.430980725605,134110.36529194994,1658,6,373.9166666666667,34,2,14,33.99384331975955,0.6332720588235294,44.19642857142856,1023.2142857142844,30.094537815126014,0
4815,4,0,0,36,0.0,0.0,1.0,36,900,400,500,0.4444444444444444,14,4,10,396.7780905787396,0.41241732804232806,0.20810395182342178,0.23019554809689596,130962.3086734692,3192.594954648506,134154.9036281177,1659,7,374.9166666666667,34,2,14,33.95387493215476,0.6341911764705883,44.10714285714285,1023.5714285714271,30.105042016806678,0
4816,4,1,0,37,0.02702702702702703,0.0,1.0,37,1350,1200,150,0.8888888888888888,15,12,3,388.85080254976936,0.412474974974975,0.20318952492865572,0.22757923705077343,131298.4681096748,2811.1029396004474,134109.57104927526,1660,0,365.7567567567568,35,2,15,33.81575851684547,0.6354166666666667,43.77893518518517,1024.884259259257,29.282407407407344,0
4817,4,0,0,37,0.0,0.0,1.0,37,1400,1000,400,0.7142857142857143,18,10,8,387.5578162563245,0.41234984984984985,0.20765363251147195,0.22826969943135658,131541.75347222216,2796.0102934242072,134337.76376564638,1661,1,366.7567567567568,34,3,15,33.60242350392635,0.6400122549019608,43.541666666666664,1025.833333333333,30.17156862745097,0
4818,4,0,0,37,0.0,0.0,1.0,37,850,400,450,0.47058823529411764,13,4,9,386.56105262744063,0.412474974974975,0.20480076270282832,0.22786478464728327,131572.28599773237,2772.1442743764123,134344.4302721088,1662,2,367.7567567567568,34,3,13,33.59707395374024,0.6403186274509804,43.51190476190476,1025.9523809523805,30.17507002801119,0
4819,4,0,0,37,0.0,0.0,1.0,37,1150,900,250,0.782608695652174,14,9,5,386.76609673075023,0.4120683183183183,0.2015146670679031,0.22871723498028299,131694.45153061216,2786.989795918359,134481.44132653053,1663,3,368.7567567567568,34,3,13,33.46816283924844,0.6415441176470589,43.39285714285714,1026.4285714285706,30.189075630252077,0
4820,4,0,1,36,0.0,0.02702702702702703,0.972972972972973,37,900,600,300,0.6666666666666666,12,6,6,387.8882587691661,0.4120995995995996,0.20239717978848382,0.22993376164151605,131786.1128826531,2823.6571712018194,134609.7700538549,1664,4,369.7567567567568,34,3,13,33.34661835748792,0.6424632352941176,43.30357142857143,1026.7857142857147,30.199579831932784,0
4821,4,0,0,36,0.0,0.0,1.0,36,600,300,300,0.5,9,3,6,396.11173599195024,0.4115410052910053,0.20602515122572407,0.23431016247659442,131705.23356401388,3233.9977412533653,134939.23130526725,1665,13,380.9166666666667,33,3,13,33.21742677491244,0.6439393939393939,43.38235294117647,1026.4705882352944,31.105169340463465,0
4822,4,0,0,36,0.0,0.0,1.0,36,1150,700,450,0.6086956521739131,16,7,9,397.80338513845066,0.410978835978836,0.21529600466608345,0.23648141661209182,131893.9905925606,3293.5751874279213,135187.56577998854,1666,14,381.9166666666667,33,3,13,32.98287998091148,0.6458333333333333,43.19852941176471,1027.2058823529417,31.127450980392172,0
4823,4,0,0,36,0.0,0.0,1.0,36,650,400,250,0.6153846153846154,9,4,5,397.4093238301964,0.410978835978836,0.21981022052586963,0.23663918828070787,131956.93963860057,3288.183631295662,135245.12326989623,1667,15,382.9166666666667,33,3,13,32.9292899173028,0.6464646464646464,43.13725490196079,1027.4509803921571,31.13487819370173,0
4824,4,0,0,36,0.0,0.0,1.0,36,1150,700,450,0.6086956521739131,16,7,9,395.10081129748085,0.41109457671957667,0.2224110064517839,0.2358512814485391,132051.39136690227,3234.7223724048613,135286.11373930713,1668,16,383.9166666666667,33,3,13,32.89304379794126,0.6474116161616161,43.04534313725491,1027.8186274509815,31.146019013666105,0
4825,4,0,0,36,0.0,0.0,1.0,36,1250,900,350,0.72,16,9,7,407.48753639594884,0.41091269841269845,0.17537788695234058,0.22753827228275408,129473.85381235824,3351.796343537415,132825.65015589565,1669,17,384.9166666666667,34,2,14,35.19758646235428,0.6191789215686274,45.56547619047619,1017.738095238095,29.933473389355733,8
4826,4,1,0,37,0.02702702702702703,0.0,1.0,37,900,600,300,0.6666666666666666,12,6,6,400.6266287521624,0.41419544544544545,0.17799543412622443,0.22619995808006702,129908.37191358021,3008.9506172839456,132917.32253086416,1670,0,375.4864864864865,35,2,15,34.928474114441414,0.6214285714285714,45.138888888888886,1019.4444444444441,29.126984126984116,0
4827,4,0,0,37,0.0,0.0,1.0,37,1100,700,400,0.6363636363636364,15,7,8,401.44977333225586,0.4133821321321321,0.17864272987386576,0.22752262716251886,130055.90284475726,3042.182543509928,133098.08538826718,1671,1,376.4864864864865,35,2,15,34.75701142251976,0.6229166666666667,44.994212962962955,1020.0231481481472,29.143518518518494,0
4828,4,1,0,38,0.02631578947368421,0.0,1.0,38,1300,1100,200,0.8461538461538461,15,11,4,396.28069372407055,0.4153330962541489,0.18120546063363974,0.22702809836715374,130475.3472222218,2741.300422239316,133216.6476444611,1672,0,367.55263157894734,34,4,16,34.4616639477977,0.6292892156862745,44.58333333333331,1021.6666666666632,30.049019607843036,0
4829,4,0,0,38,0.0,0.0,1.0,38,1100,700,400,0.6363636363636364,15,7,8,394.94222546292184,0.41534791370317686,0.1814207583263845,0.22661658177631788,130536.16780045322,2710.848922902456,133247.01672335566,1673,1,368.55263157894734,34,4,13,34.43397600186392,0.6299019607843137,44.523809523809504,1021.9047619047595,30.056022408963514,0
4830,4,0,0,38,0.0,0.0,1.0,38,1100,500,600,0.45454545454545453,17,5,12,399.2450702811215,0.41512565196775725,0.18249394598902602,0.22926548015808854,130566.5834041948,2825.612953514713,133392.1963577095,1674,2,369.55263157894734,34,4,13,34.29309842748981,0.6302083333333333,44.494047619047606,1022.0238095238077,30.059523809523757,0
4831,4,0,0,38,0.0,0.0,1.0,38,1600,1300,300,0.8125,19,13,6,376.9639956276467,0.4147848506401138,0.10304390292150356,0.20494709187572055,128415.8801020408,2096.602182539678,130512.48228458047,1675,3,370.55263157894734,34,4,16,37.05514446793515,0.6084558823529411,46.607142857142854,1013.5714285714284,29.810924369747895,8
4832,4,0,0,38,0.0,0.0,1.0,38,1100,900,200,0.8181818181818182,13,9,4,376.21641913483904,0.4140143432906591,0.1044198417160398,0.20531631483726429,128566.7534722223,2073.7847222222285,130640.53819444454,1676,4,371.55263157894734,34,4,16,36.91967953985209,0.6099877450980392,46.458333333333336,1014.1666666666673,29.828431372549037,0
4833,4,0,0,38,0.0,0.0,1.0,38,850,700,150,0.8235294117647058,10,7,3,375.2497825978692,0.4126511379800854,0.10242696573731713,0.20603701842962216,128808.33510487531,2067.059948979592,130875.3950538549,1677,5,372.55263157894734,34,4,17,36.69715804698798,0.6124387254901961,46.220238095238095,1015.1190476190478,29.85644257703082,0
4834,4,1,0,39,0.02564102564102564,0.0,1.0,39,950,600,350,0.631578947368421,13,6,7,369.61256980737284,0.41728520017993703,0.09973169584820063,0.20467792844171726,129145.65659626042,1746.7716028008629,130892.42819906128,1678,0,363.97435897435895,37,2,18,36.49586479683567,0.6097972972972974,45.88815789473684,1016.4473684210529,27.471550497866296,0
4835,4,0,1,38,0.0,0.02564102564102564,0.9743589743589743,39,800,400,400,0.5,12,4,8,369.7664895800126,0.41722896986054886,0.11027811635582441,0.19693805982602489,127590.03371229586,1676.1489112034214,129266.18262349928,1679,1,364.97435897435895,37,2,16,38.08380363215397,0.5940315315315315,47.423245614035075,1010.3070175438577,27.30559506875291,7
4836,4,0,1,37,0.0,0.02631578947368421,0.9736842105263158,38,500,300,200,0.6,7,3,4,349.7226528644702,0.4145922238027501,0.10986779627130505,0.17790239297888225,125715.30612244873,1204.4116498168669,126919.7177722656,1680,2,375.3421052631579,34,4,18,40.51766777461219,0.5808823529411764,49.28571428571427,1002.8571428571408,29.495798319327672,8
4837,4,3,0,40,0.075,0.0,1.0,40,1000,500,500,0.5,15,5,10,340.0789037370678,0.4205528846153846,0.15051739568184375,0.17705097964505828,126666.55411746215,615.3245728837062,127281.87869034585,1681,0,357.45,36,4,17,39.78050303911698,0.5865162037037037,48.33896396396397,1006.6441441441449,27.96233733733736,0
4838,4,1,0,41,0.024390243902439025,0.0,1.0,41,950,600,350,0.631578947368421,13,6,7,331.9847988520439,0.42497459349593497,0.16490808223648457,0.1742967593287745,127009.1052655625,233.01845279317095,127242.12371835567,1682,0,349.7073170731707,37,4,19,39.632850175858444,0.5881193693693694,47.99890350877193,1008.0043859649124,27.24336178283547,0
4839,4,1,0,42,0.023809523809523808,0.0,1.0,42,1150,900,250,0.782608695652174,14,9,5,328.5541413922879,0.42992644212156406,0.1638379621225874,0.17353832837297367,127253.65713346493,-38.0567882971601,127215.60034516777,1683,0,342.35714285714283,38,4,20,39.468842651418896,0.5888157894736843,47.75641025641026,1008.9743589743599,26.551956815114735,0
4840,4,2,2,42,0.045454545454545456,0.045454545454545456,0.9545454545454546,44,900,700,200,0.7777777777777778,11,7,4,324.8358159811606,0.43417459478505993,0.1915721409392297,0.1744021419782347,127913.11905115997,-489.8475196642236,127423.27153149575,1684,0,327.75,40,4,16,38.888679592793515,0.5921875,47.103658536585364,1011.5853658536581,25.289634146341452,0
4841,4,2,1,43,0.045454545454545456,0.022727272727272728,0.9772727272727273,44,950,500,450,0.5263157894736842,14,5,9,329.1764209802331,0.43030963706835795,0.21155090322776293,0.17800863222340554,128201.54772593532,-358.97811546836454,127842.56961046696,1685,0,327.0,36,8,18,38.484562066792684,0.6021412037037037,46.81869369369369,1012.7252252252247,28.13125625625624,0
4842,4,2,1,44,0.044444444444444446,0.022222222222222223,0.9777777777777777,45,1000,700,300,0.7,13,7,6,322.2500511322135,0.43440656565656566,0.21501501501501585,0.17596298541753086,128588.99493113252,-712.4379616805285,127876.556969452,1686,0,320.6,37,8,17,38.26531531531533,0.6041666666666667,46.436403508771924,1014.2543859649112,27.412280701754355,0
4843,4,1,0,45,0.022222222222222223,0.0,1.0,45,1300,1100,200,0.8461538461538461,15,11,4,323.5972437110375,0.43316498316498314,0.22118494507473474,0.17731749499974228,128728.04763244434,-668.7917195675893,128059.25591287676,1687,0,321.5777777777778,37,8,18,38.089658743021786,0.6055743243243243,46.29934210526314,1014.8026315789454,27.427098150782307,0
4844,4,1,0,46,0.021739130434782608,0.0,1.0,46,1100,900,200,0.8181818181818182,13,9,4,318.2286713685684,0.4348731884057971,0.22643553146535234,0.1757645787389022,129042.5835503471,-986.9900173611218,128055.59353298598,1688,0,315.5652173913044,39,7,19,37.90624359237238,0.6052350427350428,45.98958333333333,1016.0416666666656,26.0523504273504,0
4845,4,1,0,47,0.02127659574468085,0.0,1.0,47,1250,1100,150,0.88,14,11,3,310.68432199332193,0.43632439099599135,0.22554890654374637,0.17310061454128758,129386.78521050328,-1360.2132161458544,128026.57199435742,1689,0,309.82978723404256,39,8,20,37.74881829971673,0.6087072649572649,45.65104166666666,1017.3958333333318,26.087072649572608,0
4846,4,1,1,47,0.020833333333333332,0.020833333333333332,0.9791666666666666,48,1400,1100,300,0.7857142857142857,17,11,6,311.73546134743077,0.4372414302600473,0.2070266562132499,0.16812624987257804,128094.31295666391,-1613.6920508944534,126480.62090576945,1690,0,304.3541666666667,41,7,17,39.035345616098255,0.592479674796748,46.92460317460316,1012.3015873015854,24.69028261711184,8
4847,4,2,1,48,0.04081632653061224,0.02040816326530612,0.9795918367346939,49,1150,600,550,0.5217391304347826,17,6,11,304.98154542331656,0.43725198412698413,0.23759910696396314,0.16672101787598848,128633.7549160554,-1953.7960426200023,126679.9588734354,1691,0,299.0204081632653,40,9,16,38.65770887597675,0.5994791666666667,46.39227642276423,1014.4308943089443,25.360772357723608,0
4848,4,2,1,49,0.04,0.02,0.98,50,900,800,100,0.8888888888888888,10,8,2,309.7285675893575,0.4383928571428572,0.27606557377049135,0.1717585692995529,129201.38888888896,-1995.2781082688825,127206.11078062007,1692,0,293.92,40,10,18,37.96106557377048,0.6052083333333333,45.833333333333336,1016.6666666666673,25.416666666666682,0
4849,4,1,2,48,0.02,0.04,0.96,50,1100,900,200,0.8181818181818182,13,9,4,313.0625835105508,0.44021258503401356,0.29014284287283965,0.17440564961180446,129382.26176754921,-1899.0509741225296,127483.21079342668,1693,0,294.76,40,10,19,37.6929127959245,0.60703125,45.65548780487806,1017.3780487804888,25.43445121951222,0
4850,4,0,3,45,0.0,0.0625,0.9375,48,1350,800,550,0.5925925925925926,19,8,11,323.73422641496575,0.4398548315602837,0.28177803379416266,0.18012904392832704,129333.80126953128,-1226.0443793402783,128107.756890191,1694,1,300.375,39,9,19,37.47066478921317,0.6081730769230769,45.703125,1017.1875000000002,26.081730769230774,0
4851,4,0,0,45,0.0,0.0,1.0,45,1200,900,300,0.75,15,9,6,349.16182573155356,0.4340488215488216,0.2850181068182358,0.19280890805891393,129034.22807979377,10.76533164049846,129044.99341143428,1695,2,312.44444444444446,37,8,19,37.12902007338657,0.6086711711711712,45.997807017543856,1016.0087719298244,27.459696538643904,0
4852,4,0,0,45,0.0,0.0,1.0,45,1100,800,300,0.7272727272727273,14,8,6,350.48261605530666,0.43345959595959593,0.2865897076275763,0.19394766377412748,129117.79495854478,50.70851127268233,129168.50346981746,1696,3,313.44444444444446,37,8,19,37.010352609055275,0.6095157657657657,45.91557017543859,1016.3377192982443,27.46858700806066,0
4853,4,1,0,46,0.021739130434782608,0.0,1.0,46,500,400,100,0.8,6,4,2,343.30645034507336,0.4346417069243156,0.2883030027510771,0.19105302578591743,129340.77222077934,-319.26866920592397,129021.50355157342,1697,0,307.60869565217394,37,9,20,36.96586091049549,0.6117680180180181,45.696271929824555,1017.2149122807007,27.492294926505423,0
4854,4,1,0,47,0.02127659574468085,0.0,1.0,47,1600,1200,400,0.75,20,12,8,333.88484838652283,0.43669056429232195,0.2847471242566577,0.18760118028081876,129717.84056770032,-737.8356938052508,128980.00487389507,1698,0,302.0425531914894,38,9,19,36.82267086173745,0.6137609649122807,45.3258547008547,1018.6965811965811,26.80780476833108,0
4855,4,0,3,44,0.0,0.06382978723404255,0.9361702127659575,47,1000,600,400,0.6,14,6,8,335.05030325113324,0.4369796484736355,0.2853535466197916,0.18864874807611037,129799.47973738037,-702.1289904302764,129097.35074695009,1699,1,303.0425531914894,38,9,19,36.71017683651359,0.6145833333333333,45.245726495726494,1019.017094017094,26.816239316239315,0
4856,4,0,2,42,0.0,0.045454545454545456,0.9545454545454546,44,1000,800,200,0.8,12,8,4,336.4693053323416,0.4363217935165609,0.2595949538355993,0.18984350338118697,129881.14458917745,-59.79630086200973,129821.34828831544,1700,2,277.4318181818182,38,6,19,36.591202878803756,0.6154057017543859,45.16559829059829,1019.3376068376069,26.824673864147552,0
4857,4,0,1,41,0.0,0.023809523809523808,0.9761904761904762,42,1350,1100,250,0.8148148148148148,16,11,5,354.270058715302,0.4333623693379791,0.26851647136856016,0.1990513634247594,129717.1051964128,790.977294862447,130508.08249127524,1701,3,290.3333333333333,36,6,19,36.30425970963224,0.6174768518518519,45.326576576576585,1018.6936936936951,28.297047047047087,0
4858,4,3,1,43,0.06818181818181818,0.022727272727272728,0.9772727272727273,44,750,400,350,0.5333333333333333,11,4,7,336.7626427227907,0.4384800035236082,0.27910364758111283,0.19295752860144086,130480.80490037624,-11.787863430488073,130469.01703694575,1702,0,275.6136363636364,38,6,22,35.97633239220607,0.6214364035087719,44.577991452991455,1021.6880341880344,26.88652721547459,0
4859,4,0,0,43,0.0,0.0,1.0,43,1100,800,300,0.7272727272727273,14,8,6,347.84958854151216,0.43664636397194534,0.2878268944651361,0.1990520127059415,130430.54112803943,474.04201292706097,130904.5831409665,1703,1,282.7674418604651,37,6,22,35.744060397881796,0.6227477477477478,44.627192982456144,1021.4912280701757,27.607871028923668,0
4860,4,0,0,43,0.0,0.0,1.0,43,1600,1200,400,0.75,20,12,8,346.27903324388006,0.43676172019195275,0.28233426676050843,0.19843960834972157,130486.5499480609,436.9512734687565,130923.50122152966,1704,2,283.7674418604651,37,6,22,35.72744508835945,0.6233108108108107,44.57236842105263,1021.7105263157891,27.613798008534843,0
4861,4,1,0,44,0.022727272727272728,0.0,1.0,44,1300,900,400,0.6923076923076923,17,9,8,339.0759719812772,0.43738988724453837,0.29164372900017166,0.19635245826098352,130890.45606874111,76.36172291619192,130966.8177916573,1705,0,278.29545454545456,38,6,20,35.50301907148327,0.6255482456140351,44.17735042735042,1023.2905982905966,26.9286999550157,0
4862,4,0,0,44,0.0,0.0,1.0,44,1400,900,500,0.6428571428571429,19,9,10,347.07301363388126,0.4365420190274842,0.29771660264618016,0.20198511449184872,131081.84633875726,298.99428829715447,131380.84062705442,1706,1,279.29545454545456,38,6,20,35.10498174230567,0.627467105263158,43.990384615384606,1024.0384615384603,26.948380566801585,0
4863,4,1,0,45,0.022222222222222223,0.0,1.0,45,650,400,250,0.6153846153846154,9,4,5,341.7278075219777,0.4385732323232323,0.30009033423667586,0.2001548586914441,131328.125,-23.612138395792385,131304.51286160422,1707,0,274.06666666666666,36,9,21,34.993224932249326,0.6336805555555556,43.75,1025.0,28.47222222222222,0
4864,4,0,0,45,0.0,0.0,1.0,45,1250,800,450,0.64,17,8,9,341.8247880652968,0.43869949494949495,0.29580674675316976,0.2006530818078208,131412.43128895407,-15.994705101593013,131396.43658385248,1708,1,275.06666666666666,37,8,21,34.90569190460913,0.6326013513513513,43.667763157894726,1025.3289473684194,27.711593172119443,0
4865,4,0,0,45,0.0,0.0,1.0,45,1700,1300,400,0.7647058823529411,21,13,8,341.0590231903243,0.43865740740740744,0.30081121206722483,0.20079340226214484,131524.88175448202,-28.45046071869689,131496.43129376334,1709,2,276.06666666666666,37,8,22,34.81193212185995,0.6337274774774775,43.55811403508771,1025.7675438596482,27.723447131341842,0
4866,4,0,0,45,0.0,0.0,1.0,45,1400,1100,300,0.7857142857142857,17,11,6,339.6082670541212,0.4387626262626263,0.29763906702769427,0.20008658353642056,131553.00188519547,-64.70260080024525,131488.2992843952,1710,3,277.06666666666666,37,8,22,34.82079236140801,0.634009009009009,43.530701754385966,1025.8771929824563,27.72641062114747,0
4867,4,0,0,45,0.0,0.0,1.0,45,950,700,250,0.7368421052631579,12,7,5,338.9966396376652,0.4385521885521886,0.2965052231718892,0.2003161961495294,131665.51246537396,-73.16674361342365,131592.34572176053,1711,4,278.06666666666666,37,8,18,34.723112535612515,0.6351351351351351,43.421052631578945,1026.3157894736842,27.738264580369844,0
4868,4,0,2,43,0.0,0.044444444444444446,0.9555555555555556,45,1650,1100,550,0.6666666666666666,22,11,11,340.7771709969622,0.43817340067340066,0.30039623223479706,0.20226356042823526,131834.3685076179,-14.7713719605822,131819.59713565733,1712,5,279.06666666666666,37,8,18,34.50734927752866,0.6368243243243243,43.25657894736843,1026.9736842105278,27.756045519203454,0
4869,4,0,2,41,0.0,0.046511627906976744,0.9534883720930233,43,1200,1000,200,0.8333333333333334,14,10,4,355.82846804923463,0.436000369139904,0.3042506049163305,0.2114339711450864,131876.9799148815,785.1167468144201,132662.09666169592,1713,6,266.25581395348837,36,7,19,34.077951978949656,0.6391782407407407,43.21509009009011,1027.1396396396426,28.53165665665674,0
4870,4,0,1,40,0.0,0.024390243902439025,0.975609756097561,41,950,600,350,0.631578947368421,13,6,7,364.457845665542,0.4347306910569106,0.29814084507042127,0.21664858541739387,131892.24222232957,1413.8324920696296,133306.0747143992,1714,7,275.4390243902439,35,6,20,33.840962441314545,0.6413690476190477,43.20023148148149,1027.1990740740755,29.348544973545014,0
4871,4,0,0,40,0.0,0.0,1.0,40,950,700,250,0.7368421052631579,12,7,5,374.96218814255633,0.4342147435897436,0.30361697194528237,0.22245005742212456,131816.67375283447,1885.2536848072605,133701.92743764172,1715,8,282.725,34,6,20,33.64754811036403,0.6427696078431373,43.273809523809526,1026.904761904762,30.203081232493,0
4872,4,0,0,40,0.0,0.0,1.0,40,1050,900,150,0.8571428571428571,12,9,3,375.52921137698,0.4342013888888889,0.3035383099571116,0.2229656233000143,131847.23816609985,1902.497874149677,133749.73604024953,1716,9,283.725,34,6,20,33.60211158765119,0.6430759803921569,43.24404761904763,1027.0238095238103,30.206582633053245,0
4873,4,0,0,40,0.0,0.0,1.0,40,750,300,450,0.4,12,3,9,373.4533810738785,0.43434829059829055,0.3014313861845155,0.2219115545389411,131877.8061224491,1850.0425170068195,133727.84863945594,1717,10,284.725,34,6,20,33.62453639313861,0.6433823529411764,43.21428571428572,1027.1428571428582,30.210084033613477,0
4874,4,0,0,40,0.0,0.0,1.0,40,1650,1200,450,0.7272727272727273,21,12,9,371.96792803208245,0.43356036324786323,0.29483317886932303,0.22174220682133539,132000.11337868485,1819.9617346938765,133820.07511337873,1718,11,285.725,34,6,20,33.5392048965091,0.6446078431372548,43.095238095238095,1027.619047619048,30.22408963585435,0
4875,4,0,0,40,0.0,0.0,1.0,40,1450,1200,250,0.8275862068965517,17,12,5,370.2759995692023,0.43356036324786323,0.2925445705024312,0.22180610847980362,132183.6805555555,1788.8888888888855,133972.56944444438,1719,12,286.725,34,6,21,33.397487844408424,0.6464460784313726,42.916666666666664,1028.333333333333,30.245098039215677,0
4876,4,0,0,40,0.0,0.0,1.0,40,900,600,300,0.6666666666666666,12,6,6,369.6746682374675,0.4332932692307692,0.2932984469952735,0.2216551350848945,132219.3889853395,1775.6317515432088,133995.0207368827,1720,13,287.725,35,5,22,33.376941255908164,0.6446428571428571,42.88194444444444,1028.4722222222222,29.384920634920633,0
4877,4,0,0,40,0.0,0.0,1.0,40,1550,1000,550,0.6451612903225806,21,10,11,371.8205716151127,0.4329193376068376,0.2970047249409382,0.22346944294027946,132308.6811583718,1839.0178915894858,134147.6990499613,1721,14,288.725,35,5,22,33.23173304083698,0.6455357142857143,42.79513888888888,1028.8194444444434,29.39484126984124,0
4878,4,0,0,40,0.0,0.0,1.0,40,850,700,150,0.8235294117647058,10,7,3,372.8958022586827,0.4328792735042735,0.2950404858299591,0.2246469833119384,132398.00347222234,1874.2223668981542,134272.22583912048,1722,15,289.725,32,8,22,33.11403508771929,0.6533203125,42.708333333333336,1029.1666666666674,32.16145833333336,0
4879,4,0,0,40,0.0,0.0,1.0,40,1050,400,650,0.38095238095238093,17,4,13,377.10330137004667,0.43253205128205124,0.3042570798087536,0.22836166512809725,132592.99314164364,2000.2510904499495,134593.2442320936,1723,16,290.725,32,8,22,32.80924359445875,0.6552734375,42.51893939393939,1029.9242424242418,32.18513257575756,0
4880,4,0,0,40,0.0,0.0,1.0,40,1400,1200,200,0.8571428571428571,16,12,4,379.22794117647067,0.4317975427350427,0.3070404411764711,0.23024553571428563,132690.5417814507,2063.992194673996,134754.53397612472,1724,17,291.725,32,8,20,32.65624999999999,0.65625,42.424242424242415,1030.3030303030291,32.19696969696966,0
4881,4,0,0,40,0.0,0.0,1.0,40,1250,900,350,0.72,16,9,7,381.25751214808656,0.43127670940170937,0.3088110988607138,0.23208091511296258,132788.12629132217,2125.2941345270733,134913.42042584924,1725,18,292.725,32,8,20,32.5056658091388,0.6572265625,42.329545454545446,1030.681818181817,32.208806818181785,0
4882,4,0,0,40,0.0,0.0,1.0,40,900,700,200,0.7777777777777778,11,7,4,380.25744532243283,0.43124999999999997,0.30737042320494545,0.23179171232263082,132839.803200692,2102.664840445973,134942.46804113797,1726,19,293.725,33,7,20,32.47939451577112,0.6553030303030303,42.27941176470588,1030.8823529411761,31.23885918003564,0
4883,4,0,0,40,0.0,0.0,1.0,40,1400,1100,300,0.7857142857142857,17,11,6,383.3486378940924,0.43112980769230774,0.3138888888888891,0.23426861204638974,132934.5703124999,2192.057291666654,135126.62760416657,1727,20,294.725,33,7,20,32.30429292929291,0.65625,42.18749999999999,1031.2499999999993,31.24999999999998,0
4884,4,0,0,40,0.0,0.0,1.0,40,1250,900,350,0.72,16,9,7,384.90957739210955,0.43092948717948715,0.3173502942194528,0.23609421848955503,133072.72002551012,2244.19288548752,135316.91291099763,1728,21,295.725,34,6,20,32.12496634744818,0.6553308823529411,42.05357142857142,1031.7857142857138,30.34663865546217,0
4885,4,0,0,40,0.0,0.0,1.0,40,1200,700,500,0.5833333333333334,17,7,10,383.8865943570713,0.43026175213675216,0.3197064929073927,0.23624419160185695,133195.58000283435,2226.399518140578,135421.97952097494,1729,22,296.725,34,6,20,32.02773613193404,0.6565563725490196,41.9345238095238,1032.261904761904,30.360644257703058,0
4886,4,0,0,40,0.0,0.0,1.0,40,1150,600,550,0.5217391304347826,17,6,11,391.8186368362324,0.42946047008547006,0.34022439871063703,0.21977810324903013,129651.06398581795,2160.5146106499146,131811.57859646785,1730,23,297.725,32,8,19,35.415375237622946,0.6256510416666667,45.39141414141415,1018.4343434343448,31.826073232323274,7
4887,4,1,0,41,0.024390243902439025,0.0,1.0,41,1050,800,250,0.7619047619047619,13,8,5,382.205156983921,0.43084349593495935,0.33395691975674224,0.21568402278102167,129887.55076172647,1728.7383458285503,131616.28910755503,1731,0,291.4390243902439,33,8,20,35.419171275146276,0.6256313131313131,45.15931372549021,1019.3627450980409,30.88978015448609,0
4888,4,0,0,41,0.0,0.0,1.0,41,1200,1000,200,0.8333333333333334,14,10,4,384.3040522132452,0.4306910569105691,0.3351328538519702,0.21756315119174324,130012.50270328722,1792.8663254517528,131805.36902873896,1732,1,292.4390243902439,33,8,21,35.23842425698951,0.6268939393939394,45.036764705882355,1019.8529411764707,30.904634581105174,0
4889,4,0,1,40,0.0,0.024390243902439025,0.975609756097561,41,800,600,200,0.75,10,6,4,377.85197939149907,0.43066565040650406,0.275616247573073,0.204673948994111,128268.64216887746,1506.5581747404935,129775.20034361795,1733,2,293.4390243902439,33,8,20,37.1834422130817,0.6092171717171717,46.75245098039216,1012.9901960784322,30.69667260843734,8
4890,4,0,0,40,0.0,0.0,1.0,40,1100,600,500,0.5454545454545454,16,6,10,343.9551631366249,0.429553952991453,0.12017290280353476,0.17743595838342352,126291.69702456506,687.7362505770801,126979.43327514215,1734,3,301.0,37,3,15,40.068429329842544,0.5807995495495495,48.711622807017534,1005.1535087719283,27.166311047889952,8
4891,4,2,1,41,0.047619047619047616,0.023809523809523808,0.9761904761904762,42,1550,1300,250,0.8387096774193549,18,13,5,341.32297070822403,0.4334712543554007,0.14028546819244525,0.17898643585919063,126960.75439453124,266.92437065972206,127227.67876519095,1735,0,287.6190476190476,39,3,17,39.44713608957794,0.5841346153846154,48.046875,1007.8124999999999,25.84134615384615,0
4892,4,0,0,41,0.0,0.0,1.0,41,1000,800,200,0.8,12,8,4,337.41507217939176,0.43191056910569103,0.16260519732366285,0.16716548679355497,124616.52263196364,220.55274068703898,124837.07537265068,1736,1,295.5365853658537,37,4,17,41.96134416868001,0.5636261261261262,50.38377192982456,998.4649122807014,26.985538169748686,8
4893,4,4,1,44,0.08888888888888889,0.022222222222222223,0.9777777777777777,45,1250,700,550,0.56,18,7,11,315.63859431609467,0.44433922558922556,0.18826217928742062,0.16052048322667953,125704.11376953125,-1063.4077988539752,124640.70597067727,1737,0,270.1777777777778,39,6,19,41.38371680343479,0.5713141025641026,49.296875,1002.8125,25.713141025641026,0
4894,4,2,0,46,0.043478260869565216,0.0,1.0,46,1300,900,400,0.6923076923076923,17,9,8,311.9949515645237,0.44635668276972623,0.20525435662735547,0.1598812303660524,126018.32573203761,-1336.5837133981215,124681.74201863949,1738,0,265.2608695652174,40,6,21,41.15215924426452,0.5729166666666667,48.98373983739837,1004.0650406504049,25.10162601626012,0
4895,4,3,1,48,0.061224489795918366,0.02040816326530612,0.9795918367346939,49,1100,800,300,0.7272727272727273,14,8,6,318.533966803306,0.4542765022675737,0.2421504733352451,0.16137563353294898,125546.2303555684,-1726.5751493879534,123819.65520618045,1739,0,249.9591836734694,41,8,18,41.47363558371276,0.5665650406504066,49.45436507936509,1002.1825396825417,24.443476577622967,8
4896,4,3,0,51,0.058823529411764705,0.0,1.0,51,950,600,350,0.631578947368421,13,6,7,307.6601422557696,0.4580392156862745,0.29010158280179477,0.1588837220459739,126335.91473056035,-2425.3107104243018,123910.60402013606,1740,0,241.07843137254903,42,9,15,40.93514056224897,0.5731646825396826,48.66763565891474,1005.3294573643435,23.936415651531988,0
4897,4,3,0,54,0.05555555555555555,0.0,1.0,54,1700,1400,300,0.8235294117647058,20,14,6,290.8413419889529,0.46187106918238996,0.2936289240988674,0.15275003751746385,127023.52221336127,-3411.261667060484,123612.2605463008,1741,0,228.62962962962962,45,9,19,40.65495177763799,0.5761574074074074,47.98460144927537,1008.0615942028994,22.401368760064432,0
4898,4,1,1,54,0.01818181818181818,0.01818181818181818,0.9818181818181818,55,1200,900,300,0.75,15,9,6,287.17782638549727,0.46195286195286195,0.29449448401061384,0.151994117867446,127336.39805300148,-3686.288155321111,123650.10989768038,1742,0,225.45454545454547,42,13,11,40.42818740399387,0.5833333333333333,47.67441860465116,1009.3023255813941,24.031007751937956,0
4899,4,1,0,55,0.01818181818181818,0.0,1.0,55,900,500,400,0.5555555555555556,13,5,8,287.5401779314079,0.4614618406285073,0.2939588767436381,0.15264677504957733,127458.67816124338,-3670.1018005227997,123788.57636072059,1743,0,226.34545454545454,42,13,13,40.29443751399416,0.5845734126984127,47.55329457364341,1009.786821705427,24.042543373938738,0
4900,4,0,3,52,0.0,0.05454545454545454,0.9454545454545454,55,1250,900,350,0.72,16,9,7,287.8198527750025,0.4615319865319865,0.2901182065333183,0.15312590371825174,127545.97757582906,-3657.9471024162344,123888.03047341283,1744,1,227.34545454545454,43,12,14,40.19845082966155,0.5840600775193798,47.46685606060605,1010.1325757575738,23.491455250176134,0
4901,4,1,2,51,0.018867924528301886,0.03773584905660377,0.9622641509433962,53,1250,800,450,0.64,17,8,9,297.7106532487369,0.4583484518626028,0.2958268045060497,0.15768901076553335,127367.25368677556,-3016.2823404825003,124350.97134629305,1745,0,236.62264150943398,41,12,15,40.130937755937765,0.5851117886178862,47.6438492063492,1009.4246031746026,24.62011227255128,0
4902,4,3,0,54,0.05555555555555555,0.0,1.0,54,1600,1300,300,0.8125,19,13,6,296.8401814418463,0.4590248660610296,0.3055626507733791,0.15941417151506546,127923.87777176837,-3205.410582296751,124718.46718947162,1746,0,232.14814814814815,42,12,21,39.58572796934867,0.5892857142857143,47.09302325581395,1011.6279069767429,24.086378737541498,0
4903,4,0,2,52,0.0,0.037037037037037035,0.962962962962963,54,1150,700,450,0.6086956521739131,16,7,9,297.57889750983145,0.45818774749592356,0.3089427867312027,0.1602997207060434,128046.43956380297,-3179.2163369088726,124867.2232268941,1747,1,233.14814814814815,42,12,21,39.44231689803732,0.5905257936507937,46.97189922480619,1012.1124031007728,24.09791435954221,0
4904,4,1,1,52,0.018867924528301886,0.018867924528301886,0.9811320754716981,53,1600,1100,500,0.6875,21,11,10,303.8487084029991,0.4543420416061925,0.30076703432058705,0.16387751454239186,128095.48071217166,-2815.6707266690782,125279.80998550258,1748,0,238.24528301886792,42,11,23,39.23375131616731,0.5910218253968254,46.9234496124031,1012.3062015503868,24.102528608342546,0
4905,4,1,0,53,0.018867924528301886,0.0,1.0,53,1400,900,500,0.6428571428571429,19,9,10,299.94842301809564,0.45571782776971453,0.30238823908657153,0.16252062554614774,128279.783265761,-2904.498703027298,125375.2845627337,1749,0,238.28301886792454,38,15,25,39.14500281234621,0.5992324561403508,46.741452991453,1013.0341880341894,26.65879442195235,0
4906,4,0,0,53,0.0,0.0,1.0,53,1300,1000,300,0.7692307692307693,16,10,6,302.5634627157327,0.4548560716013546,0.30728160650878755,0.16427100422774624,128360.96871804023,-2832.53216542477,125528.43655261546,1750,1,239.28301886792454,38,15,25,38.99622210507821,0.6000548245614035,46.6613247863248,1013.3547008547024,26.667228969860588,0
4907,4,1,1,53,0.018518518518518517,0.018518518518518517,0.9814814814814815,54,1200,800,400,0.6666666666666666,16,8,8,298.5051026404774,0.4563824831120429,0.3048285378676425,0.1636654594837467,128751.69406467048,-3113.392469618018,125638.30159505246,1751,0,235.83333333333334,39,15,14,38.70225204420269,0.6022970085470085,46.276041666666686,1014.8958333333361,26.022970085470156,0
4908,4,4,6,51,0.07017543859649122,0.10526315789473684,0.8947368421052632,57,1300,900,400,0.6923076923076923,17,9,8,282.14179163583486,0.4589337928153718,0.31545205964544776,0.1575404166693876,129472.44498715548,-4094.0824807703625,125378.36250638512,1752,0,224.31578947368422,42,15,12,38.38823828112606,0.6049107142857143,45.56686046511629,1017.732558139537,24.23172757475088,0
4909,4,0,1,50,0.0,0.0196078431372549,0.9803921568627451,51,1700,1200,500,0.7058823529411765,22,12,10,317.67856980312746,0.4543790849673202,0.3146114569490106,0.1735879769195942,128616.79945992985,-2028.2398189827704,126588.55964094709,1753,1,250.88235294117646,37,14,18,38.35294832991028,0.6044481981981982,46.40899122807017,1014.3640350877183,27.415244191559953,0
4910,4,0,0,50,0.0,0.0,1.0,50,1750,1400,350,0.8,21,14,7,323.07800742327754,0.4534098639455782,0.304568538615531,0.1761248344890479,128523.41666894934,-1695.3821270728486,126828.03454187649,1754,2,256.68,38,12,19,38.31107540476942,0.6016995614035088,46.50106837606837,1013.9957264957251,26.684098065676977,0
4911,4,1,0,51,0.0196078431372549,0.0,1.0,51,1700,1200,500,0.7058823529411765,22,12,10,323.74474424769716,0.45364379084967316,0.31797372211092134,0.17809614937508741,128883.87586805543,-1854.9045138888994,127028.97135416653,1755,0,252.62745098039215,39,12,20,37.92743810696211,0.6036324786324787,46.14583333333333,1015.4166666666656,26.03632478632476,0
4912,4,0,0,51,0.0,0.0,1.0,51,1000,600,400,0.6,14,6,8,324.6989658544203,0.45364379084967316,0.31366114944747414,0.17909866035137462,128989.6701388887,-1823.4375000000182,127166.23263888869,1756,1,253.62745098039215,39,12,20,37.795665846322116,0.6047008547008548,46.04166666666666,1015.8333333333318,26.047008547008506,0
4913,4,0,2,49,0.0,0.0392156862745098,0.9607843137254902,51,1350,900,450,0.6666666666666666,18,9,9,327.1382690748024,0.45444444444444443,0.31370588431352964,0.18105754449458186,129123.91067031841,-1751.7254734285366,127372.18519688987,1757,2,254.62745098039215,40,11,20,37.59728193847282,0.6044270833333334,45.909552845528445,1016.3617886178847,25.409044715447116,0
4914,4,0,0,49,0.0,0.0,1.0,49,1500,1000,500,0.6666666666666666,20,10,10,336.7048436871754,0.4536210317460318,0.30898884638496815,0.18510220594579227,128857.4340820311,-1122.615559895849,127734.81852213526,1758,3,264.265306122449,39,10,20,37.62535908484661,0.6033653846153846,46.17187499999999,1015.3124999999989,26.03365384615382,0
4915,4,2,0,51,0.0392156862745098,0.0,1.0,51,1500,1000,500,0.6666666666666666,20,10,10,325.4277666211393,0.4554575163398693,0.3105977031899205,0.18123162177136395,129368.65790435483,-1778.135550121233,127590.52235423359,1759,0,254.86274509803923,37,14,22,37.39221815046346,0.6120495495495495,45.66885964912279,1017.3245614035059,27.495258416310968,0
4916,4,0,3,48,0.0,0.058823529411764705,0.9411764705882353,51,1450,900,550,0.6206896551724138,20,9,11,322.69730789485357,0.4551633986928105,0.3083666716056701,0.18043779047078418,129527.44904667969,-1840.3681788297345,127687.08086784995,1760,1,255.86274509803923,38,13,19,37.30058774139379,0.611842105263158,45.512820512820504,1017.9487179487169,26.78812415654518,0
4917,4,1,1,48,0.02040816326530612,0.02040816326530612,0.9795918367346939,49,1400,1100,300,0.7857142857142857,17,11,6,332.986530526402,0.45388676303854875,0.32068379875824826,0.18631994418004008,129554.63927469128,-1172.0100308642056,128382.62924382708,1761,0,264.265306122449,38,11,20,37.01114142792177,0.6121162280701755,45.48611111111111,1018.055555555555,26.790935672514603,0
4918,4,2,0,50,0.04,0.0,1.0,50,1600,1300,300,0.8125,19,13,6,326.1546354244756,0.4548639455782313,0.3384659198784892,0.1857142124087253,130237.85848957361,-1504.4637491737599,128733.39474039985,1762,0,258.54,42,8,22,36.492943484589574,0.6125992063492063,44.8158914728682,1020.7364341085245,24.303248431155346,0
4919,4,0,0,50,0.0,0.0,1.0,50,1800,1300,500,0.7222222222222222,23,13,10,324.0726074635522,0.4543027210884354,0.3357010647825658,0.1851396038886432,130366.3506861821,-1550.3626667943481,128815.98801938775,1763,1,259.54,40,10,22,36.4161442266229,0.6169270833333333,44.6900406504065,1021.2398373983734,25.530995934959336,0
4920,4,0,0,50,0.0,0.0,1.0,50,1300,900,400,0.6923076923076923,17,9,8,312.5891362492869,0.45380952380952383,0.2845795107033644,0.1703610792558613,128512.70957274197,-1965.6646235202259,126547.04494922174,1764,2,260.54,42,8,14,38.58785677879715,0.5952380952380952,46.51162790697674,1013.9534883720926,24.14174972314506,8
4921,4,0,0,50,0.0,0.0,1.0,50,1600,900,700,0.5625,23,9,14,316.0313560978681,0.45312074829931975,0.2936095558044045,0.17313865091742087,128720.46100206596,-1864.0596303948746,126856.40137167109,1765,3,261.54,43,7,14,38.28931815353988,0.5959302325581395,46.30681818181817,1014.7727272727261,23.599365750528513,0
4922,4,0,2,48,0.0,0.04,0.96,50,1900,1600,300,0.8421052631578947,22,16,6,317.46482577251817,0.45289115646258504,0.29429743589743595,0.17487469216282775,128936.76757812485,-1813.4223090277924,127123.34526909706,1766,4,262.54,43,7,15,38.03311965811965,0.5981104651162791,46.09374999999999,1015.6249999999989,23.6191860465116,0
4923,4,1,1,48,0.02040816326530612,0.02040816326530612,0.9795918367346939,49,1450,1000,450,0.6896551724137931,19,10,9,320.2079690329546,0.45409934807256236,0.2960345869555112,0.17704193753837144,129083.74592764048,-1533.2711762688687,127550.47475137161,1767,0,263.2244897959184,44,5,16,37.81416097190585,0.5982481060606061,45.94907407407407,1016.2037037037028,23.0955387205387,0
4924,4,0,0,48,0.0,0.0,1.0,48,1350,900,450,0.6666666666666666,18,9,9,324.7016516161244,0.4528110224586288,0.291028059877636,0.17973299777183416,129129.19253795056,-1214.3075822141866,127914.88495573637,1768,1,269.125,43,5,16,37.65382853504766,0.6000484496124031,45.90435606060606,1016.382575757576,23.63680408738549,0
4925,4,1,1,48,0.02040816326530612,0.02040816326530612,0.9795918367346939,49,1550,1100,450,0.7096774193548387,20,11,9,346.1629183298694,0.45459537981859416,0.3164094394314343,0.18729783277247214,128223.64501953148,-875.6707926207803,127347.97422691071,1769,0,264.61224489795916,39,10,18,38.03192173197576,0.5969551282051282,46.796875000000014,1012.8125000000018,25.969551282051327,8
4926,4,2,1,49,0.04,0.02,0.98,50,1100,600,500,0.5454545454545454,16,6,10,338.6840469627775,0.4557738095238095,0.32168085745767794,0.1852648131961321,128659.52934967628,-1285.0139839050678,127374.5153657712,1770,0,259.0,40,10,16,37.77672042472203,0.5997395833333333,46.366869918699194,1014.5325203252045,25.363313008130113,0
4927,4,0,0,49,0.0,0.0,1.0,49,1550,1100,450,0.7096774193548387,20,11,9,341.65510669606897,0.45498511904761907,0.32594392993336974,0.18695060332695024,128672.4175347223,-1007.6822916666554,127664.73524305565,1771,1,265.2857142857143,39,10,17,37.688227241615344,0.6014957264957265,46.35416666666667,1014.583333333334,26.014957264957282,0
4928,4,2,2,49,0.0392156862745098,0.0392156862745098,0.9607843137254902,51,1300,900,400,0.6923076923076923,17,9,8,330.2130545107699,0.45580065359477123,0.33186587629617637,0.18277597513263696,129127.51379311652,-1672.0818497986716,127455.43194331785,1772,0,255.84313725490196,42,9,19,37.515492420631155,0.6014384920634921,45.90600775193799,1016.375968992249,24.199427833148786,0
4929,4,1,2,48,0.02,0.04,0.96,50,1350,1100,250,0.8148148148148148,16,11,5,327.7052063802912,0.45648809523809525,0.32467388125182817,0.18277717791422743,129428.4230619329,-1517.1052555182655,127911.31780641463,1773,0,252.6,41,9,15,37.273630203763275,0.6059451219512195,45.61011904761904,1017.5595238095221,24.818524970963956,0
4930,4,0,2,46,0.0,0.041666666666666664,0.9583333333333334,48,1050,700,350,0.6666666666666666,14,7,7,330.3879418568415,0.4561908983451537,0.3078446426830461,0.1842734703439707,129428.42306193302,-1047.6819373582816,128380.74112457474,1774,1,251.20833333333334,41,7,15,37.205384127912666,0.6059451219512195,45.610119047619044,1017.5595238095231,24.818524970963978,0
4931,4,1,0,47,0.02127659574468085,0.0,1.0,47,1800,1400,400,0.7777777777777778,22,14,8,333.8444583667828,0.4558086648165279,0.30373043842620806,0.18734859059761097,129669.7550947209,-742.0941687699058,128927.66092595099,1775,0,242.27659574468086,42,5,18,36.87248279580122,0.6068948412698413,45.373062015503876,1018.5077519379847,24.25018456995202,0
4932,4,0,1,46,0.0,0.02127659574468085,0.9787234042553191,47,1750,1200,550,0.6857142857142857,23,12,11,336.7476759820154,0.45536540240518036,0.3084661435158973,0.1900528729254721,129891.90853915026,-651.8403341145345,129240.06820503573,1776,1,243.27659574468086,42,5,19,36.57319391634982,0.6091269841269842,45.15503875968992,1019.37984496124,24.270948689553332,0
4933,4,0,0,46,0.0,0.0,1.0,46,1600,1200,400,0.75,20,12,8,339.374410679417,0.45420692431561993,0.3036962445207907,0.19161601341437834,129908.3719135801,-382.484567901256,129525.88734567884,1777,2,249.47826086956522,41,5,19,36.48955495004539,0.6107723577235773,45.13888888888888,1019.4444444444432,24.86449864498642,0
4934,4,0,0,46,0.0,0.0,1.0,46,1450,1100,350,0.7586206896551724,18,11,7,340.8501914934846,0.45384460547504024,0.3109655539862828,0.19319854845292186,130060.1192444568,-333.79668997231033,129726.32255448449,1778,3,250.47826086956522,41,5,22,36.298061336964274,0.6122967479674797,44.99007936507935,1020.0396825396805,24.87901664730928,0
4935,4,1,0,47,0.02127659574468085,0.0,1.0,47,1400,1000,400,0.7142857142857143,18,10,8,333.87153522240567,0.45415124884366326,0.30585784499875257,0.1908810730528096,130395.54172092002,-692.4556487091481,129703.08607221088,1779,0,246.12765957446808,39,8,23,36.13643124256333,0.6188568376068376,44.66145833333333,1021.3541666666657,26.188568376068353,0
4936,4,0,1,46,0.0,0.02127659574468085,0.9787234042553191,47,1350,900,450,0.6666666666666666,18,9,9,332.99989090144595,0.454131976564909,0.29891352653119996,0.19087690439698587,130496.11363110566,-708.9616795558363,129787.15195154982,1780,1,247.12765957446808,40,7,17,36.05695908759365,0.6182291666666666,44.56300813008129,1021.7479674796735,25.543699186991837,0
4937,4,0,0,46,0.0,0.0,1.0,46,1500,1000,500,0.6666666666666666,20,10,10,336.75247112074766,0.45424718196457325,0.3007408851628002,0.19345522521292566,130581.79253472199,-405.251736111132,130176.54079861085,1781,2,251.80434782608697,39,7,17,35.87443946188342,0.6207264957264957,44.47916666666666,1022.0833333333314,26.207264957264908,0
4938,4,1,0,47,0.02127659574468085,0.0,1.0,47,1150,800,350,0.6956521739130435,15,8,7,334.7919084777955,0.4539392537773666,0.31086648777705017,0.19397897113759488,130911.78882444298,-634.3584754445267,130277.43034899844,1782,0,247.4255319148936,40,7,18,35.59107083747101,0.6223958333333333,44.15650406504064,1023.3739837398363,25.584349593495908,0
4939,4,0,1,46,0.0,0.02127659574468085,0.9787234042553191,47,1150,600,550,0.5217391304347826,17,6,11,337.687839982627,0.45332254085723095,0.31120505435287615,0.1964516556388537,131067.83743142299,-547.9970173177446,130519.84041410525,1783,1,248.4255319148936,40,7,19,35.359393608574834,0.6239583333333334,44.0040650406504,1023.9837398373975,25.599593495934936,0
4940,4,0,0,46,0.0,0.0,1.0,46,1600,1200,400,0.75,20,12,8,346.3352951918957,0.45379428341384864,0.31715155241587656,0.2013086703986485,131034.66932508697,-123.61382378470256,130911.05550130227,1784,2,254.65217391304347,39,7,20,35.171537457184535,0.625267094017094,44.03645833333334,1023.854166666668,26.252670940170976,0
4941,4,0,1,45,0.0,0.021739130434782608,0.9782608695652174,46,1400,1000,400,0.7142857142857143,18,10,8,349.1568456870678,0.4528683574879227,0.3130925388175081,0.2040793755807301,131248.05908203137,-34.76833767359642,131213.29074435777,1785,3,255.65217391304347,39,7,21,34.883708617125826,0.6274038461538461,43.82812500000001,1024.687500000001,26.274038461538485,0
4942,4,0,2,43,0.0,0.044444444444444446,0.9555555555555556,45,1600,1400,200,0.875,18,14,4,358.2572198405536,0.45235690235690235,0.31164396256139404,0.20953678370186551,131273.37643363292,405.9269760391654,131679.30340967208,1786,4,260.6,38,7,21,34.62499131220463,0.6293859649122807,43.80341880341881,1024.7863247863254,26.96806117858751,0
4943,4,1,1,43,0.022727272727272728,0.022727272727272728,0.9772727272727273,44,1300,1100,200,0.8461538461538461,15,11,4,359.90726828216157,0.4501739781536293,0.3093403851910983,0.21207989741594396,131559.0823086601,669.8368148320551,132228.91912349215,1787,0,264.0681818181818,36,8,18,34.29404500548847,0.6359953703703703,43.52477477477478,1025.9009009009014,28.497247247247262,0
4944,4,0,1,42,0.0,0.023255813953488372,0.9767441860465116,43,1300,1000,300,0.7692307692307693,16,10,6,370.0547806515201,0.4501199704688077,0.3160649094674073,0.21758828210704168,131476.4596863211,1130.6984900119935,132607.1581763331,1788,6,271.2093023255814,35,8,22,34.11731651807545,0.637202380952381,43.60532407407407,1025.5787037037032,29.302248677248663,0
4945,4,0,0,42,0.0,0.0,1.0,42,1150,800,350,0.6956521739130435,15,8,7,372.31569996650285,0.4495257452574526,0.2996132463137542,0.2195993799203622,131595.1877170137,1398.9908854166433,132994.17860243036,1563,7,236.0952380952381,35,7,19,33.9392978003384,0.6383928571428572,43.48958333333332,1026.0416666666652,29.315476190476147,0
4946,4,1,0,43,0.023255813953488372,0.0,1.0,43,1550,1200,350,0.7741935483870968,19,12,7,363.97622217872294,0.45051218161683276,0.30726554998399647,0.21715780588677094,132031.50398439908,1011.2656057633187,133042.7695901624,1564,0,231.58139534883722,37,6,20,33.71285874319855,0.638795045045045,43.064692982456144,1027.7412280701758,27.776789947842587,0
4947,4,1,1,43,0.022727272727272728,0.022727272727272728,0.9772727272727273,44,1450,1000,450,0.6896551724137931,19,10,9,357.7777390461432,0.4498546511627907,0.31327931608830495,0.2153861233416725,132371.2036132811,671.8939887152637,133043.09760199636,1565,0,227.29545454545453,39,5,21,33.52998363532072,0.6386217948717949,42.73437499999999,1029.0624999999989,26.38621794871792,0
4948,4,0,0,43,0.0,0.0,1.0,43,1250,900,350,0.72,16,9,7,364.8912695532154,0.44781284606866006,0.3116402728008323,0.22090093582259387,132581.84700963716,1075.6025457057826,133657.44955534293,1566,1,232.32558139534885,34,9,22,33.13489769968789,0.6504289215686274,42.529761904761905,1029.8809523809523,30.290616246498598,0
4949,4,0,2,41,0.0,0.046511627906976744,0.9534883720930233,43,1100,800,300,0.7272727272727273,14,8,6,361.93585870120717,0.4473975636766334,0.30902047650517606,0.2199532389089999,132725.77649444874,1007.6435774605649,133733.42007190932,1567,2,233.32558139534885,35,8,19,33.066218315923464,0.649702380952381,42.3900462962963,1030.439814814815,29.44113756613757,0
4950,4,0,1,40,0.0,0.024390243902439025,0.975609756097561,41,1200,900,300,0.75,15,9,6,382.5363764710666,0.44629065040650406,0.32070427808883584,0.23142211457785292,132555.70461180815,1941.4757845540455,134497.1803963622,1568,3,243.9268292682927,33,8,22,32.7069449402991,0.6524621212121212,42.55514705882354,1029.7794117647074,31.20543672014265,0
4951,4,1,1,40,0.024390243902439025,0.024390243902439025,0.975609756097561,41,1000,700,300,0.7,13,7,6,384.2658429565148,0.445655487804878,0.31491810458596925,0.23364363509915664,132745.0698799742,2001.879235149964,134746.94911512418,1569,0,243.8780487804878,33,8,20,32.471533476037585,0.6543560606060606,42.371323529411775,1030.5147058823543,31.227718360071343,0
4952,4,0,0,40,0.0,0.0,1.0,40,1200,800,400,0.6666666666666666,16,8,8,391.46267672236405,0.4442040598290598,0.3206221746371638,0.2374195714666808,132650.3703503462,2385.5338091119033,135035.9041594581,1570,5,250.975,33,7,20,32.38163216749941,0.6534090909090908,42.46323529411766,1030.1470588235309,31.216577540106996,0
4953,4,0,0,40,0.0,0.0,1.0,40,900,600,300,0.6666666666666666,12,6,6,390.1692086030269,0.4437900641025641,0.3236370986370989,0.23755872068108366,132796.49234693887,2362.620464852618,135159.11281179148,1571,6,251.975,34,6,20,32.26760414260415,0.6525735294117647,42.32142857142858,1030.7142857142865,30.31512605042019,0
4954,4,1,0,41,0.024390243902439025,0.0,1.0,41,1300,900,400,0.6923076923076923,17,9,8,382.6653068839901,0.445604674796748,0.3197977874798934,0.23497547356595433,133113.6670524691,1987.596450617278,135101.26350308637,1572,0,246.8048780487805,35,6,21,32.14165545087482,0.6535714285714286,42.013888888888886,1031.9444444444443,29.48412698412698,0
4955,4,0,0,41,0.0,0.0,1.0,41,900,700,200,0.7777777777777778,11,7,4,380.2328621126507,0.4452235772357724,0.3146232090123591,0.23423184599757202,133233.1318587105,1931.9230109739322,135165.05486968442,1573,1,247.8048780487805,35,6,21,32.084267563527646,0.6547619047619048,41.898148148148145,1032.407407407407,29.497354497354483,0
4956,4,0,0,41,0.0,0.0,1.0,41,1250,1100,150,0.88,14,11,3,380.59053830801724,0.4447408536585366,0.31439959322256295,0.2348290997776024,133292.8843557099,1946.0021219135822,135238.88647762348,1574,2,248.8048780487805,35,6,21,32.014963012777415,0.6553571428571429,41.84027777777778,1032.638888888889,29.503968253968253,0
4957,4,0,0,41,0.0,0.0,1.0,41,950,600,350,0.631578947368421,13,6,7,383.67070776460463,0.4443089430894309,0.3099267814130071,0.23750304136521472,133414.04537983926,2037.4122433243974,135451.45762316365,1575,3,249.8048780487805,36,5,21,31.813639997093222,0.6545138888888888,41.72297297297297,1033.1081081081077,28.697447447447434,0
4958,4,0,0,41,0.0,0.0,1.0,41,1100,800,300,0.7272727272727273,14,8,6,387.3975393384058,0.44334349593495936,0.3162389087853743,0.2406097311854466,133537.46588358312,2146.4678649593443,135683.93374854248,1576,4,250.8048780487805,32,9,22,31.593319895756988,0.6647135416666667,41.60353535353534,1033.585858585857,32.29955808080803,0
4959,4,0,0,41,0.0,0.0,1.0,41,1000,600,400,0.6,14,6,8,360.89246994118105,0.4424288617886179,0.2134095315848561,0.21155329439789627,131359.5300635573,1352.5191863333348,132712.04924989064,1577,5,251.8048780487805,33,8,22,34.470387527395886,0.6404671717171717,43.71936274509804,1025.1225490196077,31.06431966726084,7
4960,4,0,0,41,0.0,0.0,1.0,41,1300,1000,300,0.7692307692307693,16,10,6,362.42763633852877,0.4419461382113821,0.21794718604373298,0.21315227607288453,131485.18786344188,1330.7731701749267,132815.9610336168,1578,6,252.8048780487805,33,8,23,34.30405365037641,0.641729797979798,43.59681372549019,1025.6127450980387,31.07917409387996,0
4961,4,0,0,41,0.0,0.0,1.0,41,1050,600,450,0.5714285714285714,15,6,9,360.3296423543912,0.44143800813008127,0.212289233153949,0.2122673776318513,131548.0392907775,1280.1315900134489,132828.17088079095,1579,7,253.8048780487805,33,8,23,34.294364472583936,0.6423611111111112,43.53553921568627,1025.8578431372543,31.086601307189525,0
4962,4,0,0,41,0.0,0.0,1.0,41,1000,600,400,0.6,14,6,8,363.15725377186317,0.44039634146341466,0.2148880657861021,0.2148167484175934,131705.2335640137,1365.9421856977947,133071.1757497115,1580,8,254.8048780487805,33,8,17,34.06309694364853,0.6439393939393939,43.382352941176464,1026.470588235293,31.105169340463423,0
4963,4,0,0,41,0.0,0.0,1.0,41,1250,1000,250,0.8,15,10,5,363.9088453567175,0.4395071138211382,0.21812129359661547,0.21633219445248264,131893.99059256047,1399.4779652056839,133293.46855776614,1581,9,255.8048780487805,33,8,17,33.85329674699754,0.6458333333333333,43.1985294117647,1027.2058823529405,31.127450980392137,0
4964,4,1,0,42,0.023809523809523808,0.0,1.0,42,1600,1200,400,0.75,20,12,8,353.52649720516024,0.44118999225706546,0.2101262837417721,0.21163944751823752,132159.87761488341,944.4037208504841,133104.2813357339,1582,0,250.6904761904762,35,7,18,33.85205613087198,0.644047619047619,42.93981481481482,1028.2407407407409,29.378306878306883,0
4965,4,2,0,44,0.045454545454545456,0.0,1.0,44,1250,900,350,0.72,16,9,7,328.63433576426837,0.4442829457364341,0.1771836889862639,0.190331434613761,130895.62694028503,-119.05135396906792,130776.57558631596,1583,0,240.25,36,8,19,35.76492058251717,0.6293402777777778,44.172297297297305,1023.310810810812,28.425300300300332,8
4966,4,0,1,43,0.0,0.022727272727272728,0.9772727272727273,44,1200,1000,200,0.8333333333333334,14,10,4,349.8125285503233,0.4436002466525722,0.12990538451509526,0.19424743479569145,129254.34570312501,394.8866439285574,129649.23234705358,1584,1,241.25,39,5,18,36.888359625759755,0.6073717948717949,45.78125,1016.8750000000001,26.073717948717952,8
4967,4,2,2,43,0.044444444444444446,0.044444444444444446,0.9555555555555556,45,1450,1000,450,0.6896551724137931,19,10,9,336.6771908426884,0.44469696969696965,0.1504600988935454,0.1889237853653653,129666.74619108994,-268.8328293343935,129397.91336175555,1585,0,236.57777777777778,40,5,14,36.803407503492316,0.6098958333333333,45.3760162601626,1018.4959349593495,25.46239837398374,0
4968,4,0,0,43,0.0,0.0,1.0,43,1350,900,450,0.6666666666666666,18,9,9,348.2533136872568,0.4416297526762643,0.14986591638457858,0.19392210835848284,129364.36760355008,410.31393819853133,129774.68154174862,1586,3,248.58139534883722,38,5,18,36.81605755093468,0.6101973684210527,45.67307692307691,1017.3076923076906,26.7712550607287,0
4969,4,0,1,42,0.0,0.023255813953488372,0.9767441860465116,43,1250,800,450,0.64,17,8,9,346.38713988188846,0.4418143226282761,0.14613407785779953,0.19381814773543832,129554.6392746913,375.2121913580156,129929.85146604932,1587,4,249.58139534883722,38,5,16,36.670077307867196,0.6121162280701755,45.48611111111111,1018.0555555555552,26.79093567251461,0
4970,4,1,0,43,0.023255813953488372,0.0,1.0,43,1450,900,550,0.6206896551724138,20,9,11,332.77442488826017,0.4433139534883721,0.08114526118966925,0.1782080477738531,127810.33631601573,-81.54144037204935,127728.79487564368,1588,0,240.58139534883722,40,3,18,38.792922948073695,0.5911458333333333,47.205284552845534,1011.178861788619,25.279471544715474,8
4971,4,1,0,44,0.022727272727272728,0.0,1.0,44,1300,700,600,0.5384615384615384,19,7,12,313.623316282857,0.4449105884425652,0.16364171752864265,0.16746301605292205,127692.92091836753,-790.0681836039884,126902.85273476354,1589,0,236.0909090909091,41,3,17,39.3968394189242,0.5884146341463414,47.32142857142858,1010.7142857142871,24.651567944250907,8
4972,4,1,0,45,0.022222222222222223,0.0,1.0,45,1450,1000,450,0.6896551724137931,19,10,9,314.104843196939,0.4455808080808081,0.1818580211457861,0.16930542786559497,128070.9589643053,-954.4583032870378,127116.50066101826,1590,0,231.82222222222222,42,3,18,38.999178313868136,0.5907738095238095,46.94767441860466,1012.2093023255836,24.100221483942466,0
4973,4,4,1,48,0.08163265306122448,0.02040816326530612,0.9795918367346939,49,1000,800,200,0.8,12,8,4,298.2553205903783,0.4489087301587302,0.21579017441086368,0.16479297579478708,129057.01636392364,-2101.5482631345935,126955.46810078905,1591,0,213.81632653061226,43,6,19,38.398959304131715,0.5993217054263567,45.9753787878788,1016.0984848484875,23.63019732205785,0
4974,4,0,0,48,0.0,0.0,1.0,48,1300,800,500,0.6153846153846154,18,8,10,301.99351900987597,0.44769503546099293,0.2210291010223422,0.16655447189814648,128984.86036680771,-1809.4816237660223,127175.37874304169,1592,1,219.20833333333334,43,5,19,38.377167427985476,0.5985949612403101,46.04640151515154,1015.8143939393974,23.62359055673017,0
4975,4,1,0,49,0.02040816326530612,0.0,1.0,49,1400,1000,400,0.7142857142857143,18,10,8,305.9355759870201,0.4480406746031746,0.25845277645942133,0.17111381071074244,129538.57197687119,-1873.7268817435431,127664.84509512765,1593,0,215.71428571428572,43,6,14,37.715891472868236,0.6041666666666667,45.50189393939395,1017.9924242424258,23.67424242424246,0
4976,4,1,1,49,0.02,0.02,0.98,50,1150,800,350,0.6956521739130435,15,8,7,304.1393193553107,0.4495833333333333,0.26824202780049,0.17141123851223294,129837.5868055558,-2102.2569444444266,127735.32986111137,1594,0,212.38,44,6,15,37.459116925592795,0.6058238636363636,45.20833333333334,1019.1666666666686,23.16287878787883,0
4977,4,1,2,48,0.02,0.04,0.96,50,1650,1300,350,0.7878787878787878,20,13,7,315.81426092493746,0.45010204081632654,0.2901952783445063,0.18029263381588337,130338.55273880358,-1765.3619260204346,128573.19081278316,1595,0,211.74,41,9,17,36.65506897891771,0.6150914634146342,44.71726190476189,1021.1309523809502,24.905632984901224,0
4978,4,1,2,47,0.02040816326530612,0.04081632653061224,0.9591836734693877,49,1400,1000,400,0.7142857142857143,18,10,8,326.5945851963744,0.45016652494331066,0.3035886857727579,0.1869549413663981,130444.20070725071,-1279.5260757485862,129164.67463150213,1596,0,216.87755102040816,40,9,19,36.2730468231861,0.6177083333333333,44.61382113821137,1021.5447154471524,25.53861788617881,0
4979,4,0,0,47,0.0,0.0,1.0,47,1950,1100,850,0.5641025641025641,28,11,17,332.862247330179,0.44885137218624727,0.2961111099350755,0.19041539259622256,130418.24811826629,-717.7377676977956,129700.5103505685,1597,1,207.06382978723406,40,7,19,36.139231585580205,0.6174479166666667,44.639227642276424,1021.4430894308946,25.536077235772364,0
4980,4,0,0,47,0.0,0.0,1.0,47,1100,800,300,0.7272727272727273,14,8,6,328.414148030902,0.4486971939562134,0.28688923393255306,0.1887536857654176,130599.97046235691,-821.8243935488301,129778.14606880808,1598,2,208.06382978723406,40,7,14,36.069132365612774,0.6192708333333333,44.46138211382113,1022.1544715447142,25.553861788617855,0
4981,4,0,0,47,0.0,0.0,1.0,47,1300,1000,300,0.7692307692307693,16,10,6,332.00458094025,0.4481768424298489,0.2948527639274805,0.19133047499546338,130703.86860499682,-721.1433753057215,129982.7252296911,1599,3,209.06382978723406,40,7,16,35.87238289273173,0.6203125,44.35975609756097,1022.5609756097545,25.564024390243862,0
4982,4,0,0,47,0.0,0.0,1.0,47,1850,1500,350,0.8108108108108109,22,15,7,329.5454853931315,0.44808048103607767,0.2858272293919313,0.1902969197063606,130781.81932257568,-780.2883741490059,130001.53094842668,1600,4,210.06382978723406,40,7,16,35.8565159794668,0.62109375,44.283536585365844,1022.8658536585353,25.571646341463385,0
4983,4,0,0,47,0.0,0.0,1.0,47,1350,900,450,0.6666666666666666,18,9,9,333.3138576618154,0.44717468393462845,0.2893344799638693,0.1932995542156799,130947.07739866765,-670.7048965419651,130276.37250212568,1601,5,211.06382978723406,41,6,16,35.593256276049246,0.6211890243902439,44.1220238095238,1023.5119047619036,24.96370499419277,0
4984,4,1,2,46,0.020833333333333332,0.041666666666666664,0.9583333333333334,48,1200,800,400,0.6666666666666666,16,8,8,332.18748159758024,0.44770427009456265,0.30129687023676466,0.19470262098879038,131354.8190646703,-871.4538712620254,130483.36519340827,1602,0,207.64583333333334,39,9,17,35.21078904582868,0.6284722222222222,43.72395833333334,1025.104166666668,26.28472222222226,0
4985,4,0,0,46,0.0,0.0,1.0,46,1500,1100,400,0.7333333333333333,19,11,8,339.45680843241075,0.4460648148148148,0.29629588721542066,0.1989633384028206,131354.8190646703,-282.1424696180352,131072.67659505227,1603,1,216.2173913043478,39,7,19,35.02449361514752,0.6284722222222222,43.72395833333334,1025.104166666668,26.28472222222226,0
4986,4,0,0,46,0.0,0.0,1.0,46,1550,1100,450,0.7096774193548387,20,11,9,338.57669006683255,0.4456622383252818,0.2988231189072055,0.19925682407256834,131510.47992473096,-294.72339959677333,131215.75652513417,1604,2,217.2173913043478,40,6,19,34.89010535354536,0.6283854166666667,43.57215447154473,1025.7113821138234,25.642784552845587,0
4987,4,0,1,45,0.0,0.021739130434782608,0.9782608695652174,46,1300,1000,300,0.7692307692307693,16,10,6,337.0109311936627,0.4451388888888889,0.2994341280231514,0.19874196035813219,131588.67076475662,-330.63590620660233,131258.03485855003,1605,3,218.2173913043478,40,6,13,34.851467577918655,0.6291666666666667,43.495934959349604,1026.0162601626032,25.65040650406508,0
4988,4,0,0,45,0.0,0.0,1.0,45,1550,900,650,0.5806451612903226,22,9,13,342.71265137525023,0.44457070707070706,0.30639190606706546,0.20228054695611716,131621.9089084204,21.698676215302044,131643.6075846357,1606,4,222.6888888888889,39,6,14,34.67171268568335,0.6311431623931624,43.46354166666668,1026.1458333333353,26.311431623931675,0
4989,4,0,1,44,0.0,0.022222222222222223,0.9777777777777777,45,1650,1300,350,0.7878787878787878,20,13,7,343.49355491929396,0.4436658249158249,0.30665674804445375,0.20374003997559573,131809.033203125,55.110677083332575,131864.14388020834,1607,5,223.6888888888889,39,6,16,34.46312639480625,0.6330128205128205,43.28125,1026.875,26.330128205128204,0
4990,4,0,0,44,0.0,0.0,1.0,44,1500,1000,500,0.6666666666666666,20,10,10,351.2842778068831,0.44255417547568715,0.3132278766978023,0.2085076276278185,131835.7760959203,462.3670789930751,132298.14317491336,1608,6,229.20454545454547,39,5,16,34.23616746120297,0.6332799145299146,43.25520833333334,1026.979166666668,26.332799145299184,0
4991,4,0,0,44,0.0,0.0,1.0,44,1500,1200,300,0.8,18,12,6,351.7387231740153,0.44199260042283295,0.30741384236770997,0.20936626594238475,131942.7747938369,481.8766276041783,132424.65142144109,1609,7,230.20454545454547,39,5,17,34.11666920139241,0.6343482905982907,43.15104166666667,1027.3958333333342,26.343482905982928,0
4992,4,0,0,44,0.0,0.0,1.0,44,1300,1000,300,0.7692307692307693,16,10,6,353.6447022311053,0.44168428470754056,0.3075447452537332,0.21139428021313,132103.35422092007,543.5302734374957,132646.88449435757,1610,8,231.20454545454547,39,5,18,33.9059386293782,0.6359508547008548,42.994791666666664,1028.0208333333328,26.359508547008534,0
4993,4,0,0,44,0.0,0.0,1.0,44,1050,800,250,0.7619047619047619,13,8,5,354.41603273896186,0.44110068710359407,0.31097593847149096,0.21218824965992994,132162.78029777252,568.1216537775168,132730.90195155004,1611,9,232.20454545454547,40,4,19,33.82626671937799,0.6348958333333333,42.9369918699187,1028.2520325203254,25.706300813008134,0
4994,4,0,0,44,0.0,0.0,1.0,44,1350,800,550,0.5925925925925926,19,8,11,353.36574302697767,0.4408033826638478,0.3015600448933784,0.2125863427301336,132345.71358194525,553.2882832639278,132899.00186520917,1612,10,233.20454545454547,40,4,20,33.669135802469135,0.63671875,42.75914634146341,1028.9634146341461,25.724085365853654,0
4995,4,0,0,44,0.0,0.0,1.0,44,1250,1000,250,0.8,15,10,5,349.4798295486329,0.44053911205074,0.30417095097493596,0.2111559321228949,132507.9800044743,461.79390885382156,132969.7739133281,1613,11,234.20454545454547,38,6,21,33.60593718653801,0.6417214912280702,42.60149572649572,1029.5940170940162,27.094579397210953,0
4996,4,0,0,44,0.0,0.0,1.0,44,1650,1400,250,0.8484848484848485,19,14,5,347.26787381111365,0.43970225510923183,0.30551980880595697,0.21070424981545452,132666.1512586804,414.13845486109443,133080.28971354148,1614,12,235.20454545454547,39,5,16,33.503960229187726,0.641559829059829,42.44791666666666,1030.208333333332,26.415598290598254,0
4997,4,0,0,44,0.0,0.0,1.0,44,1100,900,200,0.8181818181818182,13,9,4,346.4331053277857,0.4389424770965469,0.30390404601968335,0.21064921395253738,132746.6484917534,397.56673177082877,133144.21522352425,1615,13,236.20454545454547,39,5,16,33.444628356750556,0.6423611111111112,42.369791666666664,1030.520833333333,26.423611111111104,0
4998,4,0,0,44,0.0,0.0,1.0,44,750,400,350,0.5333333333333333,11,4,7,348.88563366587124,0.4386782064834391,0.3030111626625014,0.21244451354608007,132800.32687717033,466.4252387152979,133266.75211588564,1616,14,237.20454545454547,39,5,16,33.327543372073436,0.6428952991452992,42.31770833333334,1030.7291666666683,26.428952991453034,0
4999,4,0,1,43,0.0,0.022727272727272728,0.9772727272727273,44,1350,1100,250,0.8148148148148148,16,11,5,345.60878110182034,0.43823775546159266,0.2967090819481162,0.21083590404557856,132869.07723783804,384.1439660585766,133253.22120389662,1617,15,238.20454545454547,40,4,16,33.34298505010679,0.6419270833333333,42.25101626016261,1030.9959349593505,25.774898373983763,0
5000,4,0,0,43,0.0,0.0,1.0,43,1700,1400,300,0.8235294117647058,20,14,6,349.1148670304288,0.43747692875599853,0.29763772127482957,0.21305641885186383,132883.42195964014,678.3156375976101,133561.73759723775,1365,16,207.13953488372093,41,2,16,33.238217229545526,0.6404979674796748,42.23710317460316,1031.0515873015856,25.147599690282576,0
